NODE_1_length_25698_cov_36.651041	315	395	0	16	80	0.2000000
NODE_1_length_25698_cov_36.651041	315	395	13	64	80	0.8000000
NODE_1_length_25698_cov_36.651041	368	403	13	34	35	0.9714286
NODE_1_length_25698_cov_36.651041	368	403	20	1	35	0.0285714
NODE_1_length_25698_cov_36.651041	24448	24494	0	22	46	0.4782609
NODE_1_length_25698_cov_36.651041	24448	24494	6	24	46	0.5217391
NODE_2_length_24307_cov_15.119712	2613	2689	0	72	76	0.9473684
NODE_2_length_24307_cov_15.119712	2613	2689	1	4	76	0.0526316
NODE_2_length_24307_cov_15.119712	2662	2716	0	54	54	1.0000000
NODE_2_length_24307_cov_15.119712	11257	11320	0	63	63	1.0000000
NODE_2_length_24307_cov_15.119712	20621	20701	6	5	80	0.0625000
NODE_2_length_24307_cov_15.119712	20621	20701	11	1	80	0.0125000
NODE_2_length_24307_cov_15.119712	20621	20701	20	13	80	0.1625000
NODE_2_length_24307_cov_15.119712	20621	20701	24	16	80	0.2000000
NODE_2_length_24307_cov_15.119712	20621	20701	26	8	80	0.1000000
NODE_2_length_24307_cov_15.119712	20621	20701	28	37	80	0.4625000
NODE_2_length_24307_cov_15.119712	20674	20754	0	13	80	0.1625000
NODE_2_length_24307_cov_15.119712	20674	20754	10	4	80	0.0500000
NODE_2_length_24307_cov_15.119712	20674	20754	18	1	80	0.0125000
NODE_2_length_24307_cov_15.119712	20674	20754	22	4	80	0.0500000
NODE_2_length_24307_cov_15.119712	20674	20754	28	58	80	0.7250000
NODE_7_length_12349_cov_28.144571	12251	12310	26	5	59	0.0847458
NODE_7_length_12349_cov_28.144571	12251	12310	28	7	59	0.1186441
NODE_7_length_12349_cov_28.144571	12251	12310	36	4	59	0.0677966
NODE_7_length_12349_cov_28.144571	12251	12310	38	1	59	0.0169492
NODE_7_length_12349_cov_28.144571	12251	12310	40	2	59	0.0338983
NODE_7_length_12349_cov_28.144571	12251	12310	42	1	59	0.0169492
NODE_7_length_12349_cov_28.144571	12251	12310	43	2	59	0.0338983
NODE_7_length_12349_cov_28.144571	12251	12310	52	4	59	0.0677966
NODE_7_length_12349_cov_28.144571	12251	12310	56	1	59	0.0169492
NODE_7_length_12349_cov_28.144571	12251	12310	60	1	59	0.0169492
NODE_7_length_12349_cov_28.144571	12251	12310	64	1	59	0.0169492
NODE_7_length_12349_cov_28.144571	12251	12310	66	5	59	0.0847458
NODE_7_length_12349_cov_28.144571	12251	12310	72	3	59	0.0508475
NODE_7_length_12349_cov_28.144571	12251	12310	76	1	59	0.0169492
NODE_7_length_12349_cov_28.144571	12251	12310	93	5	59	0.0847458
NODE_7_length_12349_cov_28.144571	12251	12310	97	2	59	0.0338983
NODE_7_length_12349_cov_28.144571	12251	12310	99	4	59	0.0677966
NODE_7_length_12349_cov_28.144571	12251	12310	104	1	59	0.0169492
NODE_7_length_12349_cov_28.144571	12251	12310	105	1	59	0.0169492
NODE_7_length_12349_cov_28.144571	12251	12310	113	2	59	0.0338983
NODE_7_length_12349_cov_28.144571	12251	12310	116	1	59	0.0169492
NODE_7_length_12349_cov_28.144571	12251	12310	119	1	59	0.0169492
NODE_7_length_12349_cov_28.144571	12251	12310	121	1	59	0.0169492
NODE_7_length_12349_cov_28.144571	12251	12310	123	1	59	0.0169492
NODE_7_length_12349_cov_28.144571	12251	12310	127	2	59	0.0338983
NODE_7_length_12349_cov_28.144571	12284	12310	26	5	26	0.1923077
NODE_7_length_12349_cov_28.144571	12284	12310	28	7	26	0.2692308
NODE_7_length_12349_cov_28.144571	12284	12310	36	4	26	0.1538462
NODE_7_length_12349_cov_28.144571	12284	12310	38	1	26	0.0384615
NODE_7_length_12349_cov_28.144571	12284	12310	40	2	26	0.0769231
NODE_7_length_12349_cov_28.144571	12284	12310	42	1	26	0.0384615
NODE_7_length_12349_cov_28.144571	12284	12310	43	2	26	0.0769231
NODE_7_length_12349_cov_28.144571	12284	12310	52	4	26	0.1538462
NODE_10_length_11096_cov_14.154679	6455	6535	0	80	80	1.0000000
NODE_10_length_11096_cov_14.154679	6508	6588	0	80	80	1.0000000
NODE_10_length_11096_cov_14.154679	6584	6664	0	48	80	0.6000000
NODE_10_length_11096_cov_14.154679	6584	6664	4	32	80	0.4000000
NODE_10_length_11096_cov_14.154679	6637	6717	4	28	80	0.3500000
NODE_10_length_11096_cov_14.154679	6637	6717	6	32	80	0.4000000
NODE_10_length_11096_cov_14.154679	6637	6717	8	20	80	0.2500000
NODE_10_length_11096_cov_14.154679	7182	7229	145	1	47	0.0212766
NODE_10_length_11096_cov_14.154679	7182	7229	146	2	47	0.0425532
NODE_10_length_11096_cov_14.154679	7182	7229	148	1	47	0.0212766
NODE_10_length_11096_cov_14.154679	7182	7229	149	1	47	0.0212766
NODE_10_length_11096_cov_14.154679	7182	7229	150	4	47	0.0851064
NODE_10_length_11096_cov_14.154679	7182	7229	151	4	47	0.0851064
NODE_10_length_11096_cov_14.154679	7182	7229	152	1	47	0.0212766
NODE_10_length_11096_cov_14.154679	7182	7229	153	1	47	0.0212766
NODE_10_length_11096_cov_14.154679	7182	7229	155	1	47	0.0212766
NODE_10_length_11096_cov_14.154679	7182	7229	156	2	47	0.0425532
NODE_10_length_11096_cov_14.154679	7182	7229	157	2	47	0.0425532
NODE_10_length_11096_cov_14.154679	7182	7229	159	1	47	0.0212766
NODE_10_length_11096_cov_14.154679	7182	7229	161	2	47	0.0425532
NODE_10_length_11096_cov_14.154679	7182	7229	171	1	47	0.0212766
NODE_10_length_11096_cov_14.154679	7182	7229	173	3	47	0.0638298
NODE_10_length_11096_cov_14.154679	7182	7229	175	1	47	0.0212766
NODE_10_length_11096_cov_14.154679	7182	7229	181	1	47	0.0212766
NODE_10_length_11096_cov_14.154679	7182	7229	183	2	47	0.0425532
NODE_10_length_11096_cov_14.154679	7182	7229	187	2	47	0.0425532
NODE_10_length_11096_cov_14.154679	7182	7229	191	1	47	0.0212766
NODE_10_length_11096_cov_14.154679	7182	7229	193	1	47	0.0212766
NODE_10_length_11096_cov_14.154679	7182	7229	195	2	47	0.0425532
NODE_10_length_11096_cov_14.154679	7182	7229	197	1	47	0.0212766
NODE_10_length_11096_cov_14.154679	7182	7229	199	1	47	0.0212766
NODE_10_length_11096_cov_14.154679	7182	7229	203	1	47	0.0212766
NODE_10_length_11096_cov_14.154679	7182	7229	205	1	47	0.0212766
NODE_10_length_11096_cov_14.154679	7182	7229	207	2	47	0.0425532
NODE_10_length_11096_cov_14.154679	7182	7229	209	1	47	0.0212766
NODE_10_length_11096_cov_14.154679	7182	7229	213	3	47	0.0638298
NODE_10_length_11096_cov_14.154679	7218	7282	94	1	64	0.0156250
NODE_10_length_11096_cov_14.154679	7218	7282	96	7	64	0.1093750
NODE_10_length_11096_cov_14.154679	7218	7282	98	9	64	0.1406250
NODE_10_length_11096_cov_14.154679	7218	7282	99	1	64	0.0156250
NODE_10_length_11096_cov_14.154679	7218	7282	105	2	64	0.0312500
NODE_10_length_11096_cov_14.154679	7218	7282	107	1	64	0.0156250
NODE_10_length_11096_cov_14.154679	7218	7282	109	2	64	0.0312500
NODE_10_length_11096_cov_14.154679	7218	7282	111	3	64	0.0468750
NODE_10_length_11096_cov_14.154679	7218	7282	112	1	64	0.0156250
NODE_10_length_11096_cov_14.154679	7218	7282	113	1	64	0.0156250
NODE_10_length_11096_cov_14.154679	7218	7282	114	2	64	0.0312500
NODE_10_length_11096_cov_14.154679	7218	7282	115	1	64	0.0156250
NODE_10_length_11096_cov_14.154679	7218	7282	116	2	64	0.0312500
NODE_10_length_11096_cov_14.154679	7218	7282	118	1	64	0.0156250
NODE_10_length_11096_cov_14.154679	7218	7282	120	1	64	0.0156250
NODE_10_length_11096_cov_14.154679	7218	7282	122	1	64	0.0156250
NODE_10_length_11096_cov_14.154679	7218	7282	125	1	64	0.0156250
NODE_10_length_11096_cov_14.154679	7218	7282	129	1	64	0.0156250
NODE_10_length_11096_cov_14.154679	7218	7282	130	3	64	0.0468750
NODE_10_length_11096_cov_14.154679	7218	7282	132	6	64	0.0937500
NODE_10_length_11096_cov_14.154679	7218	7282	136	3	64	0.0468750
NODE_10_length_11096_cov_14.154679	7218	7282	137	1	64	0.0156250
NODE_10_length_11096_cov_14.154679	7218	7282	138	1	64	0.0156250
NODE_10_length_11096_cov_14.154679	7218	7282	144	1	64	0.0156250
NODE_10_length_11096_cov_14.154679	7218	7282	145	1	64	0.0156250
NODE_10_length_11096_cov_14.154679	7218	7282	146	2	64	0.0312500
NODE_10_length_11096_cov_14.154679	7218	7282	148	1	64	0.0156250
NODE_10_length_11096_cov_14.154679	7218	7282	149	1	64	0.0156250
NODE_10_length_11096_cov_14.154679	7218	7282	150	2	64	0.0312500
NODE_10_length_11096_cov_14.154679	7218	7282	151	4	64	0.0625000
NODE_13_length_10749_cov_34.330235	3589	3669	0	80	80	1.0000000
NODE_13_length_10749_cov_34.330235	3642	3722	0	80	80	1.0000000
NODE_13_length_10749_cov_34.330235	3718	3798	0	80	80	1.0000000
NODE_13_length_10749_cov_34.330235	3771	3851	0	74	80	0.9250000
NODE_13_length_10749_cov_34.330235	3771	3851	1	3	80	0.0375000
NODE_13_length_10749_cov_34.330235	3771	3851	2	3	80	0.0375000
NODE_14_length_10557_cov_50.055938	423	503	0	1	80	0.0125000
NODE_14_length_10557_cov_50.055938	423	503	4	14	80	0.1750000
NODE_14_length_10557_cov_50.055938	423	503	6	31	80	0.3875000
NODE_14_length_10557_cov_50.055938	423	503	8	34	80	0.4250000
NODE_14_length_10557_cov_50.055938	476	556	0	8	80	0.1000000
NODE_14_length_10557_cov_50.055938	476	556	2	32	80	0.4000000
NODE_14_length_10557_cov_50.055938	476	556	6	5	80	0.0625000
NODE_14_length_10557_cov_50.055938	476	556	8	35	80	0.4375000
NODE_14_length_10557_cov_50.055938	1625	1696	6	16	71	0.2253521
NODE_14_length_10557_cov_50.055938	1625	1696	8	46	71	0.6478873
NODE_14_length_10557_cov_50.055938	1625	1696	10	9	71	0.1267606
NODE_14_length_10557_cov_50.055938	1678	1733	6	19	55	0.3454545
NODE_14_length_10557_cov_50.055938	1678	1733	8	8	55	0.1454545
NODE_14_length_10557_cov_50.055938	1678	1733	10	25	55	0.4545455
NODE_14_length_10557_cov_50.055938	1678	1733	12	3	55	0.0545455
NODE_14_length_10557_cov_50.055938	2428	2488	18	4	60	0.0666667
NODE_14_length_10557_cov_50.055938	2428	2488	22	6	60	0.1000000
NODE_14_length_10557_cov_50.055938	2428	2488	24	10	60	0.1666667
NODE_14_length_10557_cov_50.055938	2428	2488	26	2	60	0.0333333
NODE_14_length_10557_cov_50.055938	2428	2488	27	12	60	0.2000000
NODE_14_length_10557_cov_50.055938	2428	2488	28	8	60	0.1333333
NODE_14_length_10557_cov_50.055938	2428	2488	30	3	60	0.0500000
NODE_14_length_10557_cov_50.055938	2428	2488	34	1	60	0.0166667
NODE_14_length_10557_cov_50.055938	2428	2488	36	9	60	0.1500000
NODE_14_length_10557_cov_50.055938	2428	2488	38	4	60	0.0666667
NODE_14_length_10557_cov_50.055938	2428	2488	40	1	60	0.0166667
NODE_17_length_10101_cov_12.236253	923	966	0	43	43	1.0000000
NODE_17_length_10101_cov_12.236253	943	1007	0	64	64	1.0000000
NODE_17_length_10101_cov_12.236253	1715	1795	0	80	80	1.0000000
NODE_17_length_10101_cov_12.236253	1768	1820	0	51	52	0.9807692
NODE_17_length_10101_cov_12.236253	1768	1820	2	1	52	0.0192308
NODE_20_length_9442_cov_109.961147	2108	2188	15	4	80	0.0500000
NODE_20_length_9442_cov_109.961147	2108	2188	19	1	80	0.0125000
NODE_20_length_9442_cov_109.961147	2108	2188	20	12	80	0.1500000
NODE_20_length_9442_cov_109.961147	2108	2188	21	6	80	0.0750000
NODE_20_length_9442_cov_109.961147	2108	2188	25	5	80	0.0625000
NODE_20_length_9442_cov_109.961147	2108	2188	28	5	80	0.0625000
NODE_20_length_9442_cov_109.961147	2108	2188	30	7	80	0.0875000
NODE_20_length_9442_cov_109.961147	2108	2188	31	3	80	0.0375000
NODE_20_length_9442_cov_109.961147	2108	2188	32	10	80	0.1250000
NODE_20_length_9442_cov_109.961147	2108	2188	34	1	80	0.0125000
NODE_20_length_9442_cov_109.961147	2108	2188	36	17	80	0.2125000
NODE_20_length_9442_cov_109.961147	2108	2188	38	9	80	0.1125000
NODE_20_length_9442_cov_109.961147	2161	2241	7	4	80	0.0500000
NODE_20_length_9442_cov_109.961147	2161	2241	9	10	80	0.1250000
NODE_20_length_9442_cov_109.961147	2161	2241	11	1	80	0.0125000
NODE_20_length_9442_cov_109.961147	2161	2241	15	9	80	0.1125000
NODE_20_length_9442_cov_109.961147	2161	2241	21	2	80	0.0250000
NODE_20_length_9442_cov_109.961147	2161	2241	24	1	80	0.0125000
NODE_20_length_9442_cov_109.961147	2161	2241	26	3	80	0.0375000
NODE_20_length_9442_cov_109.961147	2161	2241	28	2	80	0.0250000
NODE_20_length_9442_cov_109.961147	2161	2241	32	8	80	0.1000000
NODE_20_length_9442_cov_109.961147	2161	2241	34	1	80	0.0125000
NODE_20_length_9442_cov_109.961147	2161	2241	36	17	80	0.2125000
NODE_20_length_9442_cov_109.961147	2161	2241	37	1	80	0.0125000
NODE_20_length_9442_cov_109.961147	2161	2241	38	21	80	0.2625000
NODE_21_length_9414_cov_34.165217	2363	2443	32	1	80	0.0125000
NODE_21_length_9414_cov_34.165217	2363	2443	36	1	80	0.0125000
NODE_21_length_9414_cov_34.165217	2363	2443	38	9	80	0.1125000
NODE_21_length_9414_cov_34.165217	2363	2443	40	2	80	0.0250000
NODE_21_length_9414_cov_34.165217	2363	2443	42	4	80	0.0500000
NODE_21_length_9414_cov_34.165217	2363	2443	44	7	80	0.0875000
NODE_21_length_9414_cov_34.165217	2363	2443	45	1	80	0.0125000
NODE_21_length_9414_cov_34.165217	2363	2443	47	3	80	0.0375000
NODE_21_length_9414_cov_34.165217	2363	2443	48	8	80	0.1000000
NODE_21_length_9414_cov_34.165217	2363	2443	50	6	80	0.0750000
NODE_21_length_9414_cov_34.165217	2363	2443	52	2	80	0.0250000
NODE_21_length_9414_cov_34.165217	2363	2443	54	7	80	0.0875000
NODE_21_length_9414_cov_34.165217	2363	2443	55	1	80	0.0125000
NODE_21_length_9414_cov_34.165217	2363	2443	56	15	80	0.1875000
NODE_21_length_9414_cov_34.165217	2363	2443	58	13	80	0.1625000
NODE_21_length_9414_cov_34.165217	2416	2484	14	12	68	0.1764706
NODE_21_length_9414_cov_34.165217	2416	2484	16	1	68	0.0147059
NODE_21_length_9414_cov_34.165217	2416	2484	20	6	68	0.0882353
NODE_21_length_9414_cov_34.165217	2416	2484	26	14	68	0.2058824
NODE_21_length_9414_cov_34.165217	2416	2484	28	1	68	0.0147059
NODE_21_length_9414_cov_34.165217	2416	2484	30	5	68	0.0735294
NODE_21_length_9414_cov_34.165217	2416	2484	32	3	68	0.0441176
NODE_21_length_9414_cov_34.165217	2416	2484	36	1	68	0.0147059
NODE_21_length_9414_cov_34.165217	2416	2484	38	9	68	0.1323529
NODE_21_length_9414_cov_34.165217	2416	2484	40	2	68	0.0294118
NODE_21_length_9414_cov_34.165217	2416	2484	44	1	68	0.0147059
NODE_21_length_9414_cov_34.165217	2416	2484	45	1	68	0.0147059
NODE_21_length_9414_cov_34.165217	2416	2484	47	3	68	0.0441176
NODE_21_length_9414_cov_34.165217	2416	2484	48	8	68	0.1176471
NODE_21_length_9414_cov_34.165217	2416	2484	50	1	68	0.0147059
NODE_21_length_9414_cov_34.165217	5899	5975	80	2	76	0.0263158
NODE_21_length_9414_cov_34.165217	5899	5975	81	1	76	0.0131579
NODE_21_length_9414_cov_34.165217	5899	5975	82	2	76	0.0263158
NODE_21_length_9414_cov_34.165217	5899	5975	84	2	76	0.0263158
NODE_21_length_9414_cov_34.165217	5899	5975	85	2	76	0.0263158
NODE_21_length_9414_cov_34.165217	5899	5975	86	1	76	0.0131579
NODE_21_length_9414_cov_34.165217	5899	5975	88	2	76	0.0263158
NODE_21_length_9414_cov_34.165217	5899	5975	90	4	76	0.0526316
NODE_21_length_9414_cov_34.165217	5899	5975	91	1	76	0.0131579
NODE_21_length_9414_cov_34.165217	5899	5975	92	3	76	0.0394737
NODE_21_length_9414_cov_34.165217	5899	5975	93	5	76	0.0657895
NODE_21_length_9414_cov_34.165217	5899	5975	94	1	76	0.0131579
NODE_21_length_9414_cov_34.165217	5899	5975	96	7	76	0.0921053
NODE_21_length_9414_cov_34.165217	5899	5975	97	4	76	0.0526316
NODE_21_length_9414_cov_34.165217	5899	5975	98	9	76	0.1184211
NODE_21_length_9414_cov_34.165217	5899	5975	99	5	76	0.0657895
NODE_21_length_9414_cov_34.165217	5899	5975	100	4	76	0.0526316
NODE_21_length_9414_cov_34.165217	5899	5975	101	2	76	0.0263158
NODE_21_length_9414_cov_34.165217	5899	5975	102	4	76	0.0526316
NODE_21_length_9414_cov_34.165217	5899	5975	103	6	76	0.0789474
NODE_21_length_9414_cov_34.165217	5899	5975	104	4	76	0.0526316
NODE_21_length_9414_cov_34.165217	5899	5975	105	2	76	0.0263158
NODE_21_length_9414_cov_34.165217	5899	5975	106	3	76	0.0394737
NODE_24_length_9168_cov_47.407542	470	550	52	1	80	0.0125000
NODE_24_length_9168_cov_47.407542	470	550	54	1	80	0.0125000
NODE_24_length_9168_cov_47.407542	470	550	56	2	80	0.0250000
NODE_24_length_9168_cov_47.407542	470	550	58	9	80	0.1125000
NODE_24_length_9168_cov_47.407542	470	550	61	1	80	0.0125000
NODE_24_length_9168_cov_47.407542	470	550	67	2	80	0.0250000
NODE_24_length_9168_cov_47.407542	470	550	70	1	80	0.0125000
NODE_24_length_9168_cov_47.407542	470	550	72	8	80	0.1000000
NODE_24_length_9168_cov_47.407542	470	550	74	1	80	0.0125000
NODE_24_length_9168_cov_47.407542	470	550	75	2	80	0.0250000
NODE_24_length_9168_cov_47.407542	470	550	76	2	80	0.0250000
NODE_24_length_9168_cov_47.407542	470	550	79	1	80	0.0125000
NODE_24_length_9168_cov_47.407542	470	550	80	8	80	0.1000000
NODE_24_length_9168_cov_47.407542	470	550	82	2	80	0.0250000
NODE_24_length_9168_cov_47.407542	470	550	86	3	80	0.0375000
NODE_24_length_9168_cov_47.407542	470	550	88	2	80	0.0250000
NODE_24_length_9168_cov_47.407542	470	550	94	7	80	0.0875000
NODE_24_length_9168_cov_47.407542	470	550	96	10	80	0.1250000
NODE_24_length_9168_cov_47.407542	470	550	97	1	80	0.0125000
NODE_24_length_9168_cov_47.407542	470	550	98	16	80	0.2000000
NODE_24_length_9168_cov_47.407542	523	603	34	11	80	0.1375000
NODE_24_length_9168_cov_47.407542	523	603	35	10	80	0.1250000
NODE_24_length_9168_cov_47.407542	523	603	36	7	80	0.0875000
NODE_24_length_9168_cov_47.407542	523	603	37	1	80	0.0125000
NODE_24_length_9168_cov_47.407542	523	603	42	6	80	0.0750000
NODE_24_length_9168_cov_47.407542	523	603	43	3	80	0.0375000
NODE_24_length_9168_cov_47.407542	523	603	44	1	80	0.0125000
NODE_24_length_9168_cov_47.407542	523	603	45	1	80	0.0125000
NODE_24_length_9168_cov_47.407542	523	603	46	1	80	0.0125000
NODE_24_length_9168_cov_47.407542	523	603	47	1	80	0.0125000
NODE_24_length_9168_cov_47.407542	523	603	48	10	80	0.1250000
NODE_24_length_9168_cov_47.407542	523	603	51	1	80	0.0125000
NODE_24_length_9168_cov_47.407542	523	603	52	1	80	0.0125000
NODE_24_length_9168_cov_47.407542	523	603	54	1	80	0.0125000
NODE_24_length_9168_cov_47.407542	523	603	56	2	80	0.0250000
NODE_24_length_9168_cov_47.407542	523	603	58	9	80	0.1125000
NODE_24_length_9168_cov_47.407542	523	603	61	1	80	0.0125000
NODE_24_length_9168_cov_47.407542	523	603	67	2	80	0.0250000
NODE_24_length_9168_cov_47.407542	523	603	70	1	80	0.0125000
NODE_24_length_9168_cov_47.407542	523	603	72	8	80	0.1000000
NODE_24_length_9168_cov_47.407542	523	603	74	1	80	0.0125000
NODE_24_length_9168_cov_47.407542	523	603	76	1	80	0.0125000
NODE_27_length_9108_cov_47.430347	4786	4866	231	2	80	0.0250000
NODE_27_length_9108_cov_47.430347	4786	4866	232	2	80	0.0250000
NODE_27_length_9108_cov_47.430347	4786	4866	233	2	80	0.0250000
NODE_27_length_9108_cov_47.430347	4786	4866	235	1	80	0.0125000
NODE_27_length_9108_cov_47.430347	4786	4866	237	1	80	0.0125000
NODE_27_length_9108_cov_47.430347	4786	4866	238	1	80	0.0125000
NODE_27_length_9108_cov_47.430347	4786	4866	239	1	80	0.0125000
NODE_27_length_9108_cov_47.430347	4786	4866	241	1	80	0.0125000
NODE_27_length_9108_cov_47.430347	4786	4866	242	5	80	0.0625000
NODE_27_length_9108_cov_47.430347	4786	4866	243	2	80	0.0250000
NODE_27_length_9108_cov_47.430347	4786	4866	244	2	80	0.0250000
NODE_27_length_9108_cov_47.430347	4786	4866	245	2	80	0.0250000
NODE_27_length_9108_cov_47.430347	4786	4866	246	4	80	0.0500000
NODE_27_length_9108_cov_47.430347	4786	4866	248	4	80	0.0500000
NODE_27_length_9108_cov_47.430347	4786	4866	249	2	80	0.0250000
NODE_27_length_9108_cov_47.430347	4786	4866	250	1	80	0.0125000
NODE_27_length_9108_cov_47.430347	4786	4866	251	2	80	0.0250000
NODE_27_length_9108_cov_47.430347	4786	4866	252	2	80	0.0250000
NODE_27_length_9108_cov_47.430347	4786	4866	253	1	80	0.0125000
NODE_27_length_9108_cov_47.430347	4786	4866	254	7	80	0.0875000
NODE_27_length_9108_cov_47.430347	4786	4866	255	4	80	0.0500000
NODE_27_length_9108_cov_47.430347	4786	4866	256	8	80	0.1000000
NODE_27_length_9108_cov_47.430347	4786	4866	257	5	80	0.0625000
NODE_27_length_9108_cov_47.430347	4786	4866	258	5	80	0.0625000
NODE_27_length_9108_cov_47.430347	4786	4866	259	4	80	0.0500000
NODE_27_length_9108_cov_47.430347	4786	4866	260	1	80	0.0125000
NODE_27_length_9108_cov_47.430347	4786	4866	262	4	80	0.0500000
NODE_27_length_9108_cov_47.430347	4786	4866	263	2	80	0.0250000
NODE_27_length_9108_cov_47.430347	4786	4866	264	2	80	0.0250000
NODE_27_length_9108_cov_47.430347	4839	4902	235	2	63	0.0317460
NODE_27_length_9108_cov_47.430347	4839	4902	236	1	63	0.0158730
NODE_27_length_9108_cov_47.430347	4839	4902	237	1	63	0.0158730
NODE_27_length_9108_cov_47.430347	4839	4902	238	1	63	0.0158730
NODE_27_length_9108_cov_47.430347	4839	4902	240	1	63	0.0158730
NODE_27_length_9108_cov_47.430347	4839	4902	241	1	63	0.0158730
NODE_27_length_9108_cov_47.430347	4839	4902	243	1	63	0.0158730
NODE_27_length_9108_cov_47.430347	4839	4902	245	2	63	0.0317460
NODE_27_length_9108_cov_47.430347	4839	4902	246	1	63	0.0158730
NODE_27_length_9108_cov_47.430347	4839	4902	247	1	63	0.0158730
NODE_27_length_9108_cov_47.430347	4839	4902	248	1	63	0.0158730
NODE_27_length_9108_cov_47.430347	4839	4902	249	2	63	0.0317460
NODE_27_length_9108_cov_47.430347	4839	4902	251	3	63	0.0476190
NODE_27_length_9108_cov_47.430347	4839	4902	253	1	63	0.0158730
NODE_27_length_9108_cov_47.430347	4839	4902	254	7	63	0.1111111
NODE_27_length_9108_cov_47.430347	4839	4902	255	6	63	0.0952381
NODE_27_length_9108_cov_47.430347	4839	4902	256	9	63	0.1428571
NODE_27_length_9108_cov_47.430347	4839	4902	257	6	63	0.0952381
NODE_27_length_9108_cov_47.430347	4839	4902	258	4	63	0.0634921
NODE_27_length_9108_cov_47.430347	4839	4902	259	2	63	0.0317460
NODE_27_length_9108_cov_47.430347	4839	4902	262	1	63	0.0158730
NODE_27_length_9108_cov_47.430347	4839	4902	264	2	63	0.0317460
NODE_27_length_9108_cov_47.430347	4839	4902	265	1	63	0.0158730
NODE_27_length_9108_cov_47.430347	4839	4902	266	3	63	0.0476190
NODE_27_length_9108_cov_47.430347	4839	4902	268	2	63	0.0317460
NODE_27_length_9108_cov_47.430347	4839	4902	270	1	63	0.0158730
NODE_27_length_9108_cov_47.430347	4895	4963	190	2	68	0.0294118
NODE_27_length_9108_cov_47.430347	4895	4963	194	3	68	0.0441176
NODE_27_length_9108_cov_47.430347	4895	4963	196	2	68	0.0294118
NODE_27_length_9108_cov_47.430347	4895	4963	200	1	68	0.0147059
NODE_27_length_9108_cov_47.430347	4895	4963	211	1	68	0.0147059
NODE_27_length_9108_cov_47.430347	4895	4963	212	3	68	0.0441176
NODE_27_length_9108_cov_47.430347	4895	4963	225	1	68	0.0147059
NODE_27_length_9108_cov_47.430347	4895	4963	227	2	68	0.0294118
NODE_27_length_9108_cov_47.430347	4895	4963	230	1	68	0.0147059
NODE_27_length_9108_cov_47.430347	4895	4963	231	1	68	0.0147059
NODE_27_length_9108_cov_47.430347	4895	4963	233	8	68	0.1176471
NODE_27_length_9108_cov_47.430347	4895	4963	236	2	68	0.0294118
NODE_27_length_9108_cov_47.430347	4895	4963	238	1	68	0.0147059
NODE_27_length_9108_cov_47.430347	4895	4963	239	3	68	0.0441176
NODE_27_length_9108_cov_47.430347	4895	4963	242	3	68	0.0441176
NODE_27_length_9108_cov_47.430347	4895	4963	245	3	68	0.0441176
NODE_27_length_9108_cov_47.430347	4895	4963	246	1	68	0.0147059
NODE_27_length_9108_cov_47.430347	4895	4963	247	1	68	0.0147059
NODE_27_length_9108_cov_47.430347	4895	4963	251	1	68	0.0147059
NODE_27_length_9108_cov_47.430347	4895	4963	252	1	68	0.0147059
NODE_27_length_9108_cov_47.430347	4895	4963	254	5	68	0.0735294
NODE_27_length_9108_cov_47.430347	4895	4963	255	4	68	0.0588235
NODE_27_length_9108_cov_47.430347	4895	4963	256	6	68	0.0882353
NODE_27_length_9108_cov_47.430347	4895	4963	257	3	68	0.0441176
NODE_27_length_9108_cov_47.430347	4895	4963	258	4	68	0.0588235
NODE_27_length_9108_cov_47.430347	4895	4963	259	1	68	0.0147059
NODE_27_length_9108_cov_47.430347	4895	4963	260	1	68	0.0147059
NODE_27_length_9108_cov_47.430347	4895	4963	262	2	68	0.0294118
NODE_27_length_9108_cov_47.430347	4895	4963	264	1	68	0.0147059
NODE_27_length_9108_cov_47.430347	4936	5016	37	3	80	0.0375000
NODE_27_length_9108_cov_47.430347	4936	5016	38	2	80	0.0250000
NODE_27_length_9108_cov_47.430347	4936	5016	54	1	80	0.0125000
NODE_27_length_9108_cov_47.430347	4936	5016	60	1	80	0.0125000
NODE_27_length_9108_cov_47.430347	4936	5016	70	2	80	0.0250000
NODE_27_length_9108_cov_47.430347	4936	5016	71	1	80	0.0125000
NODE_27_length_9108_cov_47.430347	4936	5016	85	1	80	0.0125000
NODE_27_length_9108_cov_47.430347	4936	5016	91	1	80	0.0125000
NODE_27_length_9108_cov_47.430347	4936	5016	95	1	80	0.0125000
NODE_27_length_9108_cov_47.430347	4936	5016	96	1	80	0.0125000
NODE_27_length_9108_cov_47.430347	4936	5016	97	1	80	0.0125000
NODE_27_length_9108_cov_47.430347	4936	5016	99	1	80	0.0125000
NODE_27_length_9108_cov_47.430347	4936	5016	102	1	80	0.0125000
NODE_27_length_9108_cov_47.430347	4936	5016	104	1	80	0.0125000
NODE_27_length_9108_cov_47.430347	4936	5016	107	1	80	0.0125000
NODE_27_length_9108_cov_47.430347	4936	5016	109	1	80	0.0125000
NODE_27_length_9108_cov_47.430347	4936	5016	113	2	80	0.0250000
NODE_27_length_9108_cov_47.430347	4936	5016	115	1	80	0.0125000
NODE_27_length_9108_cov_47.430347	4936	5016	121	4	80	0.0500000
NODE_27_length_9108_cov_47.430347	4936	5016	125	4	80	0.0500000
NODE_27_length_9108_cov_47.430347	4936	5016	127	2	80	0.0250000
NODE_27_length_9108_cov_47.430347	4936	5016	129	1	80	0.0125000
NODE_27_length_9108_cov_47.430347	4936	5016	131	1	80	0.0125000
NODE_27_length_9108_cov_47.430347	4936	5016	133	1	80	0.0125000
NODE_27_length_9108_cov_47.430347	4936	5016	136	1	80	0.0125000
NODE_27_length_9108_cov_47.430347	4936	5016	143	1	80	0.0125000
NODE_27_length_9108_cov_47.430347	4936	5016	149	1	80	0.0125000
NODE_27_length_9108_cov_47.430347	4936	5016	151	1	80	0.0125000
NODE_27_length_9108_cov_47.430347	4936	5016	160	2	80	0.0250000
NODE_27_length_9108_cov_47.430347	4936	5016	165	2	80	0.0250000
NODE_27_length_9108_cov_47.430347	4936	5016	169	1	80	0.0125000
NODE_27_length_9108_cov_47.430347	4936	5016	175	1	80	0.0125000
NODE_27_length_9108_cov_47.430347	4936	5016	179	1	80	0.0125000
NODE_27_length_9108_cov_47.430347	4936	5016	181	1	80	0.0125000
NODE_27_length_9108_cov_47.430347	4936	5016	183	1	80	0.0125000
NODE_27_length_9108_cov_47.430347	4936	5016	185	2	80	0.0250000
NODE_27_length_9108_cov_47.430347	4936	5016	187	1	80	0.0125000
NODE_27_length_9108_cov_47.430347	4936	5016	189	1	80	0.0125000
NODE_27_length_9108_cov_47.430347	4936	5016	190	2	80	0.0250000
NODE_27_length_9108_cov_47.430347	4936	5016	194	3	80	0.0375000
NODE_27_length_9108_cov_47.430347	4936	5016	196	2	80	0.0250000
NODE_27_length_9108_cov_47.430347	4936	5016	200	1	80	0.0125000
NODE_27_length_9108_cov_47.430347	4936	5016	211	1	80	0.0125000
NODE_27_length_9108_cov_47.430347	4936	5016	212	3	80	0.0375000
NODE_27_length_9108_cov_47.430347	4936	5016	225	1	80	0.0125000
NODE_27_length_9108_cov_47.430347	4936	5016	227	2	80	0.0250000
NODE_27_length_9108_cov_47.430347	4936	5016	230	1	80	0.0125000
NODE_27_length_9108_cov_47.430347	4936	5016	231	1	80	0.0125000
NODE_27_length_9108_cov_47.430347	4936	5016	233	8	80	0.1000000
NODE_27_length_9108_cov_47.430347	4936	5016	236	2	80	0.0250000
NODE_28_length_9108_cov_26.469974	44	120	0	76	76	1.0000000
NODE_28_length_9108_cov_26.469974	7711	7791	6	1	80	0.0125000
NODE_28_length_9108_cov_26.469974	7711	7791	13	1	80	0.0125000
NODE_28_length_9108_cov_26.469974	7711	7791	14	3	80	0.0375000
NODE_28_length_9108_cov_26.469974	7711	7791	16	4	80	0.0500000
NODE_28_length_9108_cov_26.469974	7711	7791	18	2	80	0.0250000
NODE_28_length_9108_cov_26.469974	7711	7791	20	5	80	0.0625000
NODE_28_length_9108_cov_26.469974	7711	7791	22	3	80	0.0375000
NODE_28_length_9108_cov_26.469974	7711	7791	24	11	80	0.1375000
NODE_28_length_9108_cov_26.469974	7711	7791	25	11	80	0.1375000
NODE_28_length_9108_cov_26.469974	7711	7791	27	6	80	0.0750000
NODE_28_length_9108_cov_26.469974	7711	7791	28	4	80	0.0500000
NODE_28_length_9108_cov_26.469974	7711	7791	30	2	80	0.0250000
NODE_28_length_9108_cov_26.469974	7711	7791	32	2	80	0.0250000
NODE_28_length_9108_cov_26.469974	7711	7791	33	1	80	0.0125000
NODE_28_length_9108_cov_26.469974	7711	7791	34	1	80	0.0125000
NODE_28_length_9108_cov_26.469974	7711	7791	38	1	80	0.0125000
NODE_28_length_9108_cov_26.469974	7711	7791	40	3	80	0.0375000
NODE_28_length_9108_cov_26.469974	7711	7791	42	1	80	0.0125000
NODE_28_length_9108_cov_26.469974	7711	7791	44	2	80	0.0250000
NODE_28_length_9108_cov_26.469974	7711	7791	52	1	80	0.0125000
NODE_28_length_9108_cov_26.469974	7711	7791	53	1	80	0.0125000
NODE_28_length_9108_cov_26.469974	7711	7791	57	4	80	0.0500000
NODE_28_length_9108_cov_26.469974	7711	7791	58	1	80	0.0125000
NODE_28_length_9108_cov_26.469974	7711	7791	62	2	80	0.0250000
NODE_28_length_9108_cov_26.469974	7711	7791	64	2	80	0.0250000
NODE_28_length_9108_cov_26.469974	7711	7791	66	1	80	0.0125000
NODE_28_length_9108_cov_26.469974	7711	7791	68	2	80	0.0250000
NODE_28_length_9108_cov_26.469974	7711	7791	70	1	80	0.0125000
NODE_28_length_9108_cov_26.469974	7711	7791	71	1	80	0.0125000
NODE_28_length_9108_cov_26.469974	8144	8224	6	3	80	0.0375000
NODE_28_length_9108_cov_26.469974	8144	8224	8	1	80	0.0125000
NODE_28_length_9108_cov_26.469974	8144	8224	12	1	80	0.0125000
NODE_28_length_9108_cov_26.469974	8144	8224	14	12	80	0.1500000
NODE_28_length_9108_cov_26.469974	8144	8224	16	2	80	0.0250000
NODE_28_length_9108_cov_26.469974	8144	8224	18	1	80	0.0125000
NODE_28_length_9108_cov_26.469974	8144	8224	22	3	80	0.0375000
NODE_28_length_9108_cov_26.469974	8144	8224	26	3	80	0.0375000
NODE_28_length_9108_cov_26.469974	8144	8224	28	9	80	0.1125000
NODE_28_length_9108_cov_26.469974	8144	8224	34	6	80	0.0750000
NODE_28_length_9108_cov_26.469974	8144	8224	40	15	80	0.1875000
NODE_28_length_9108_cov_26.469974	8144	8224	41	6	80	0.0750000
NODE_28_length_9108_cov_26.469974	8144	8224	43	7	80	0.0875000
NODE_28_length_9108_cov_26.469974	8144	8224	47	1	80	0.0125000
NODE_28_length_9108_cov_26.469974	8144	8224	49	2	80	0.0250000
NODE_28_length_9108_cov_26.469974	8144	8224	50	4	80	0.0500000
NODE_28_length_9108_cov_26.469974	8144	8224	51	2	80	0.0250000
NODE_28_length_9108_cov_26.469974	8144	8224	53	2	80	0.0250000
NODE_28_length_9108_cov_26.469974	8568	8648	0	75	80	0.9375000
NODE_28_length_9108_cov_26.469974	8568	8648	2	5	80	0.0625000
NODE_28_length_9108_cov_26.469974	8621	8701	0	22	80	0.2750000
NODE_28_length_9108_cov_26.469974	8621	8701	2	58	80	0.7250000
NODE_30_length_8743_cov_14.172721	7849	7929	14	5	80	0.0625000
NODE_30_length_8743_cov_14.172721	7849	7929	16	8	80	0.1000000
NODE_30_length_8743_cov_14.172721	7849	7929	18	1	80	0.0125000
NODE_30_length_8743_cov_14.172721	7849	7929	20	1	80	0.0125000
NODE_30_length_8743_cov_14.172721	7849	7929	22	1	80	0.0125000
NODE_30_length_8743_cov_14.172721	7849	7929	24	1	80	0.0125000
NODE_30_length_8743_cov_14.172721	7849	7929	26	15	80	0.1875000
NODE_30_length_8743_cov_14.172721	7849	7929	28	14	80	0.1750000
NODE_30_length_8743_cov_14.172721	7849	7929	32	2	80	0.0250000
NODE_30_length_8743_cov_14.172721	7849	7929	34	20	80	0.2500000
NODE_30_length_8743_cov_14.172721	7849	7929	36	12	80	0.1500000
NODE_30_length_8743_cov_14.172721	7902	7964	2	10	62	0.1612903
NODE_30_length_8743_cov_14.172721	7902	7964	4	2	62	0.0322581
NODE_30_length_8743_cov_14.172721	7902	7964	6	13	62	0.2096774
NODE_30_length_8743_cov_14.172721	7902	7964	8	7	62	0.1129032
NODE_30_length_8743_cov_14.172721	7902	7964	12	3	62	0.0483871
NODE_30_length_8743_cov_14.172721	7902	7964	14	5	62	0.0806452
NODE_30_length_8743_cov_14.172721	7902	7964	16	8	62	0.1290323
NODE_30_length_8743_cov_14.172721	7902	7964	18	1	62	0.0161290
NODE_30_length_8743_cov_14.172721	7902	7964	20	1	62	0.0161290
NODE_30_length_8743_cov_14.172721	7902	7964	22	1	62	0.0161290
NODE_30_length_8743_cov_14.172721	7902	7964	24	1	62	0.0161290
NODE_30_length_8743_cov_14.172721	7902	7964	26	10	62	0.1612903
NODE_32_length_8707_cov_6.353044	8541	8621	2	5	80	0.0625000
NODE_32_length_8707_cov_6.353044	8541	8621	3	9	80	0.1125000
NODE_32_length_8707_cov_6.353044	8541	8621	12	1	80	0.0125000
NODE_32_length_8707_cov_6.353044	8541	8621	16	1	80	0.0125000
NODE_32_length_8707_cov_6.353044	8541	8621	24	10	80	0.1250000
NODE_32_length_8707_cov_6.353044	8541	8621	25	5	80	0.0625000
NODE_32_length_8707_cov_6.353044	8541	8621	29	7	80	0.0875000
NODE_32_length_8707_cov_6.353044	8541	8621	30	1	80	0.0125000
NODE_32_length_8707_cov_6.353044	8541	8621	32	19	80	0.2375000
NODE_32_length_8707_cov_6.353044	8541	8621	34	2	80	0.0250000
NODE_32_length_8707_cov_6.353044	8541	8621	36	20	80	0.2500000
NODE_32_length_8707_cov_6.353044	8541	8621	2	5	80	0.0625000
NODE_32_length_8707_cov_6.353044	8541	8621	3	9	80	0.1125000
NODE_32_length_8707_cov_6.353044	8541	8621	12	1	80	0.0125000
NODE_32_length_8707_cov_6.353044	8541	8621	16	1	80	0.0125000
NODE_32_length_8707_cov_6.353044	8541	8621	24	10	80	0.1250000
NODE_32_length_8707_cov_6.353044	8541	8621	25	5	80	0.0625000
NODE_32_length_8707_cov_6.353044	8541	8621	29	7	80	0.0875000
NODE_32_length_8707_cov_6.353044	8541	8621	30	1	80	0.0125000
NODE_32_length_8707_cov_6.353044	8541	8621	32	19	80	0.2375000
NODE_32_length_8707_cov_6.353044	8541	8621	34	2	80	0.0250000
NODE_32_length_8707_cov_6.353044	8541	8621	36	20	80	0.2500000
NODE_32_length_8707_cov_6.353044	8541	8621	2	5	80	0.0625000
NODE_32_length_8707_cov_6.353044	8541	8621	3	9	80	0.1125000
NODE_32_length_8707_cov_6.353044	8541	8621	12	1	80	0.0125000
NODE_32_length_8707_cov_6.353044	8541	8621	16	1	80	0.0125000
NODE_32_length_8707_cov_6.353044	8541	8621	24	10	80	0.1250000
NODE_32_length_8707_cov_6.353044	8541	8621	25	5	80	0.0625000
NODE_32_length_8707_cov_6.353044	8541	8621	29	7	80	0.0875000
NODE_32_length_8707_cov_6.353044	8541	8621	30	1	80	0.0125000
NODE_32_length_8707_cov_6.353044	8541	8621	32	19	80	0.2375000
NODE_32_length_8707_cov_6.353044	8541	8621	34	2	80	0.0250000
NODE_32_length_8707_cov_6.353044	8541	8621	36	20	80	0.2500000
NODE_32_length_8707_cov_6.353044	8594	8674	32	5	80	0.0625000
NODE_32_length_8707_cov_6.353044	8594	8674	34	17	80	0.2125000
NODE_32_length_8707_cov_6.353044	8594	8674	36	58	80	0.7250000
NODE_32_length_8707_cov_6.353044	8594	8674	32	5	80	0.0625000
NODE_32_length_8707_cov_6.353044	8594	8674	34	17	80	0.2125000
NODE_32_length_8707_cov_6.353044	8594	8674	36	58	80	0.7250000
NODE_32_length_8707_cov_6.353044	8594	8673	32	5	79	0.0632911
NODE_32_length_8707_cov_6.353044	8594	8673	34	16	79	0.2025317
NODE_32_length_8707_cov_6.353044	8594	8673	36	58	79	0.7341772
NODE_32_length_8707_cov_6.353044	8599	8674	34	17	75	0.2266667
NODE_32_length_8707_cov_6.353044	8599	8674	36	58	75	0.7733333
NODE_38_length_8281_cov_13.025177	7108	7188	0	80	80	1.0000000
NODE_38_length_8281_cov_13.025177	7161	7199	0	38	38	1.0000000
NODE_38_length_8281_cov_13.025177	7175	7255	0	56	80	0.7000000
NODE_38_length_8281_cov_13.025177	7175	7255	2	24	80	0.3000000
NODE_38_length_8281_cov_13.025177	7228	7308	0	3	80	0.0375000
NODE_38_length_8281_cov_13.025177	7228	7308	2	25	80	0.3125000
NODE_38_length_8281_cov_13.025177	7228	7308	3	37	80	0.4625000
NODE_38_length_8281_cov_13.025177	7228	7308	4	15	80	0.1875000
NODE_38_length_8281_cov_13.025177	7749	7829	0	50	80	0.6250000
NODE_38_length_8281_cov_13.025177	7749	7829	2	8	80	0.1000000
NODE_38_length_8281_cov_13.025177	7749	7829	3	1	80	0.0125000
NODE_38_length_8281_cov_13.025177	7749	7829	4	6	80	0.0750000
NODE_38_length_8281_cov_13.025177	7749	7829	6	15	80	0.1875000
NODE_38_length_8281_cov_13.025177	7802	7882	2	5	80	0.0625000
NODE_38_length_8281_cov_13.025177	7802	7882	3	1	80	0.0125000
NODE_38_length_8281_cov_13.025177	7802	7882	4	11	80	0.1375000
NODE_38_length_8281_cov_13.025177	7802	7882	6	63	80	0.7875000
NODE_38_length_8281_cov_13.025177	7878	7958	2	1	80	0.0125000
NODE_38_length_8281_cov_13.025177	7878	7958	4	79	80	0.9875000
NODE_38_length_8281_cov_13.025177	7931	8011	0	47	80	0.5875000
NODE_38_length_8281_cov_13.025177	7931	8011	2	7	80	0.0875000
NODE_38_length_8281_cov_13.025177	7931	8011	4	26	80	0.3250000
NODE_39_length_8259_cov_60.011152	1424	1504	2	1	80	0.0125000
NODE_39_length_8259_cov_60.011152	1424	1504	3	2	80	0.0250000
NODE_39_length_8259_cov_60.011152	1424	1504	11	17	80	0.2125000
NODE_39_length_8259_cov_60.011152	1424	1504	13	29	80	0.3625000
NODE_39_length_8259_cov_60.011152	1424	1504	15	20	80	0.2500000
NODE_39_length_8259_cov_60.011152	1424	1504	16	11	80	0.1375000
NODE_39_length_8259_cov_60.011152	1477	1549	15	61	72	0.8472222
NODE_39_length_8259_cov_60.011152	1477	1549	16	11	72	0.1527778
NODE_40_length_8228_cov_17.079592	314	394	2	8	80	0.1000000
NODE_40_length_8228_cov_17.079592	314	394	4	2	80	0.0250000
NODE_40_length_8228_cov_17.079592	314	394	6	8	80	0.1000000
NODE_40_length_8228_cov_17.079592	314	394	8	15	80	0.1875000
NODE_40_length_8228_cov_17.079592	314	394	10	2	80	0.0250000
NODE_40_length_8228_cov_17.079592	314	394	12	45	80	0.5625000
NODE_40_length_8228_cov_17.079592	367	447	0	6	80	0.0750000
NODE_40_length_8228_cov_17.079592	367	447	2	8	80	0.1000000
NODE_40_length_8228_cov_17.079592	367	447	4	7	80	0.0875000
NODE_40_length_8228_cov_17.079592	367	447	6	11	80	0.1375000
NODE_40_length_8228_cov_17.079592	367	447	8	4	80	0.0500000
NODE_40_length_8228_cov_17.079592	367	447	10	12	80	0.1500000
NODE_40_length_8228_cov_17.079592	367	447	12	32	80	0.4000000
NODE_40_length_8228_cov_17.079592	443	523	0	15	80	0.1875000
NODE_40_length_8228_cov_17.079592	443	523	2	31	80	0.3875000
NODE_40_length_8228_cov_17.079592	443	523	12	2	80	0.0250000
NODE_40_length_8228_cov_17.079592	443	523	14	4	80	0.0500000
NODE_40_length_8228_cov_17.079592	443	523	18	3	80	0.0375000
NODE_40_length_8228_cov_17.079592	443	523	24	1	80	0.0125000
NODE_40_length_8228_cov_17.079592	443	523	26	7	80	0.0875000
NODE_40_length_8228_cov_17.079592	443	523	30	7	80	0.0875000
NODE_40_length_8228_cov_17.079592	443	523	34	1	80	0.0125000
NODE_40_length_8228_cov_17.079592	443	523	36	9	80	0.1125000
NODE_40_length_8228_cov_17.079592	496	576	18	2	80	0.0250000
NODE_40_length_8228_cov_17.079592	496	576	24	1	80	0.0125000
NODE_40_length_8228_cov_17.079592	496	576	26	7	80	0.0875000
NODE_40_length_8228_cov_17.079592	496	576	30	7	80	0.0875000
NODE_40_length_8228_cov_17.079592	496	576	32	19	80	0.2375000
NODE_40_length_8228_cov_17.079592	496	576	34	5	80	0.0625000
NODE_40_length_8228_cov_17.079592	496	576	36	39	80	0.4875000
NODE_40_length_8228_cov_17.079592	3154	3217	33	1	63	0.0158730
NODE_40_length_8228_cov_17.079592	3154	3217	42	1	63	0.0158730
NODE_40_length_8228_cov_17.079592	3154	3217	43	1	63	0.0158730
NODE_40_length_8228_cov_17.079592	3154	3217	48	1	63	0.0158730
NODE_40_length_8228_cov_17.079592	3154	3217	54	1	63	0.0158730
NODE_40_length_8228_cov_17.079592	3154	3217	56	1	63	0.0158730
NODE_40_length_8228_cov_17.079592	3154	3217	58	1	63	0.0158730
NODE_40_length_8228_cov_17.079592	3154	3217	64	2	63	0.0317460
NODE_40_length_8228_cov_17.079592	3154	3217	72	3	63	0.0476190
NODE_40_length_8228_cov_17.079592	3154	3217	74	1	63	0.0158730
NODE_40_length_8228_cov_17.079592	3154	3217	76	2	63	0.0317460
NODE_40_length_8228_cov_17.079592	3154	3217	80	5	63	0.0793651
NODE_40_length_8228_cov_17.079592	3154	3217	82	5	63	0.0793651
NODE_40_length_8228_cov_17.079592	3154	3217	88	3	63	0.0476190
NODE_40_length_8228_cov_17.079592	3154	3217	90	1	63	0.0158730
NODE_40_length_8228_cov_17.079592	3154	3217	96	1	63	0.0158730
NODE_40_length_8228_cov_17.079592	3154	3217	104	1	63	0.0158730
NODE_40_length_8228_cov_17.079592	3154	3217	108	2	63	0.0317460
NODE_40_length_8228_cov_17.079592	3154	3217	112	2	63	0.0317460
NODE_40_length_8228_cov_17.079592	3154	3217	124	2	63	0.0317460
NODE_40_length_8228_cov_17.079592	3154	3217	130	1	63	0.0158730
NODE_40_length_8228_cov_17.079592	3154	3217	134	3	63	0.0476190
NODE_40_length_8228_cov_17.079592	3154	3217	136	5	63	0.0793651
NODE_40_length_8228_cov_17.079592	3154	3217	138	2	63	0.0317460
NODE_40_length_8228_cov_17.079592	3154	3217	140	6	63	0.0952381
NODE_40_length_8228_cov_17.079592	3154	3217	142	1	63	0.0158730
NODE_40_length_8228_cov_17.079592	3154	3217	146	6	63	0.0952381
NODE_40_length_8228_cov_17.079592	3154	3217	147	2	63	0.0317460
NODE_43_length_8100_cov_32.115236	501	581	46	2	80	0.0250000
NODE_43_length_8100_cov_32.115236	501	581	48	3	80	0.0375000
NODE_43_length_8100_cov_32.115236	501	581	50	6	80	0.0750000
NODE_43_length_8100_cov_32.115236	501	581	52	2	80	0.0250000
NODE_43_length_8100_cov_32.115236	501	581	54	6	80	0.0750000
NODE_43_length_8100_cov_32.115236	501	581	55	4	80	0.0500000
NODE_43_length_8100_cov_32.115236	501	581	57	5	80	0.0625000
NODE_43_length_8100_cov_32.115236	501	581	58	1	80	0.0125000
NODE_43_length_8100_cov_32.115236	501	581	59	12	80	0.1500000
NODE_43_length_8100_cov_32.115236	501	581	61	18	80	0.2250000
NODE_43_length_8100_cov_32.115236	501	581	63	17	80	0.2125000
NODE_43_length_8100_cov_32.115236	501	581	65	4	80	0.0500000
NODE_43_length_8100_cov_32.115236	554	634	16	7	80	0.0875000
NODE_43_length_8100_cov_32.115236	554	634	18	8	80	0.1000000
NODE_43_length_8100_cov_32.115236	554	634	19	3	80	0.0375000
NODE_43_length_8100_cov_32.115236	554	634	20	4	80	0.0500000
NODE_43_length_8100_cov_32.115236	554	634	22	3	80	0.0375000
NODE_43_length_8100_cov_32.115236	554	634	24	1	80	0.0125000
NODE_43_length_8100_cov_32.115236	554	634	28	2	80	0.0250000
NODE_43_length_8100_cov_32.115236	554	634	35	1	80	0.0125000
NODE_43_length_8100_cov_32.115236	554	634	36	8	80	0.1000000
NODE_43_length_8100_cov_32.115236	554	634	40	1	80	0.0125000
NODE_43_length_8100_cov_32.115236	554	634	42	12	80	0.1500000
NODE_43_length_8100_cov_32.115236	554	634	44	2	80	0.0250000
NODE_43_length_8100_cov_32.115236	554	634	46	3	80	0.0375000
NODE_43_length_8100_cov_32.115236	554	634	48	3	80	0.0375000
NODE_43_length_8100_cov_32.115236	554	634	50	6	80	0.0750000
NODE_43_length_8100_cov_32.115236	554	634	52	2	80	0.0250000
NODE_43_length_8100_cov_32.115236	554	634	54	2	80	0.0250000
NODE_43_length_8100_cov_32.115236	554	634	58	1	80	0.0125000
NODE_43_length_8100_cov_32.115236	554	634	59	5	80	0.0625000
NODE_43_length_8100_cov_32.115236	554	634	61	2	80	0.0250000
NODE_43_length_8100_cov_32.115236	554	634	63	3	80	0.0375000
NODE_43_length_8100_cov_32.115236	554	634	65	1	80	0.0125000
NODE_43_length_8100_cov_32.115236	1383	1463	0	80	80	1.0000000
NODE_43_length_8100_cov_32.115236	1436	1516	0	80	80	1.0000000
NODE_43_length_8100_cov_32.115236	3391	3462	364	1	71	0.0140845
NODE_43_length_8100_cov_32.115236	3391	3462	381	1	71	0.0140845
NODE_43_length_8100_cov_32.115236	3391	3462	394	1	71	0.0140845
NODE_43_length_8100_cov_32.115236	3391	3462	395	1	71	0.0140845
NODE_43_length_8100_cov_32.115236	3391	3462	411	1	71	0.0140845
NODE_43_length_8100_cov_32.115236	3391	3462	419	1	71	0.0140845
NODE_43_length_8100_cov_32.115236	3391	3462	423	1	71	0.0140845
NODE_43_length_8100_cov_32.115236	3391	3462	431	2	71	0.0281690
NODE_43_length_8100_cov_32.115236	3391	3462	446	3	71	0.0422535
NODE_43_length_8100_cov_32.115236	3391	3462	451	1	71	0.0140845
NODE_43_length_8100_cov_32.115236	3391	3462	453	2	71	0.0281690
NODE_43_length_8100_cov_32.115236	3391	3462	455	1	71	0.0140845
NODE_43_length_8100_cov_32.115236	3391	3462	462	1	71	0.0140845
NODE_43_length_8100_cov_32.115236	3391	3462	480	1	71	0.0140845
NODE_43_length_8100_cov_32.115236	3391	3462	492	1	71	0.0140845
NODE_43_length_8100_cov_32.115236	3391	3462	499	1	71	0.0140845
NODE_43_length_8100_cov_32.115236	3391	3462	517	1	71	0.0140845
NODE_43_length_8100_cov_32.115236	3391	3462	525	1	71	0.0140845
NODE_43_length_8100_cov_32.115236	3391	3462	542	1	71	0.0140845
NODE_43_length_8100_cov_32.115236	3391	3462	553	2	71	0.0281690
NODE_43_length_8100_cov_32.115236	3391	3462	559	1	71	0.0140845
NODE_43_length_8100_cov_32.115236	3391	3462	563	2	71	0.0281690
NODE_43_length_8100_cov_32.115236	3391	3462	564	1	71	0.0140845
NODE_43_length_8100_cov_32.115236	3391	3462	566	2	71	0.0281690
NODE_43_length_8100_cov_32.115236	3391	3462	568	2	71	0.0281690
NODE_43_length_8100_cov_32.115236	3391	3462	569	4	71	0.0563380
NODE_43_length_8100_cov_32.115236	3391	3462	570	3	71	0.0422535
NODE_43_length_8100_cov_32.115236	3391	3462	571	1	71	0.0140845
NODE_43_length_8100_cov_32.115236	3391	3462	572	3	71	0.0422535
NODE_43_length_8100_cov_32.115236	3391	3462	573	2	71	0.0281690
NODE_43_length_8100_cov_32.115236	3391	3462	574	1	71	0.0140845
NODE_43_length_8100_cov_32.115236	3391	3462	575	1	71	0.0140845
NODE_43_length_8100_cov_32.115236	3391	3462	577	3	71	0.0422535
NODE_43_length_8100_cov_32.115236	3391	3462	578	1	71	0.0140845
NODE_43_length_8100_cov_32.115236	3391	3462	588	1	71	0.0140845
NODE_43_length_8100_cov_32.115236	3391	3462	590	1	71	0.0140845
NODE_43_length_8100_cov_32.115236	3391	3462	592	4	71	0.0563380
NODE_43_length_8100_cov_32.115236	3391	3462	593	1	71	0.0140845
NODE_43_length_8100_cov_32.115236	3391	3462	594	4	71	0.0563380
NODE_43_length_8100_cov_32.115236	3391	3462	595	2	71	0.0281690
NODE_43_length_8100_cov_32.115236	3391	3462	596	3	71	0.0422535
NODE_43_length_8100_cov_32.115236	3391	3462	598	2	71	0.0281690
NODE_43_length_8100_cov_32.115236	3391	3462	601	1	71	0.0140845
NODE_43_length_8100_cov_32.115236	3435	3483	246	1	48	0.0208333
NODE_43_length_8100_cov_32.115236	3435	3483	264	1	48	0.0208333
NODE_43_length_8100_cov_32.115236	3435	3483	265	2	48	0.0416667
NODE_43_length_8100_cov_32.115236	3435	3483	266	1	48	0.0208333
NODE_43_length_8100_cov_32.115236	3435	3483	272	1	48	0.0208333
NODE_43_length_8100_cov_32.115236	3435	3483	284	1	48	0.0208333
NODE_43_length_8100_cov_32.115236	3435	3483	286	1	48	0.0208333
NODE_43_length_8100_cov_32.115236	3435	3483	290	1	48	0.0208333
NODE_43_length_8100_cov_32.115236	3435	3483	298	1	48	0.0208333
NODE_43_length_8100_cov_32.115236	3435	3483	306	1	48	0.0208333
NODE_43_length_8100_cov_32.115236	3435	3483	318	1	48	0.0208333
NODE_43_length_8100_cov_32.115236	3435	3483	321	1	48	0.0208333
NODE_43_length_8100_cov_32.115236	3435	3483	323	1	48	0.0208333
NODE_43_length_8100_cov_32.115236	3435	3483	325	2	48	0.0416667
NODE_43_length_8100_cov_32.115236	3435	3483	337	1	48	0.0208333
NODE_43_length_8100_cov_32.115236	3435	3483	339	1	48	0.0208333
NODE_43_length_8100_cov_32.115236	3435	3483	348	1	48	0.0208333
NODE_43_length_8100_cov_32.115236	3435	3483	364	1	48	0.0208333
NODE_43_length_8100_cov_32.115236	3435	3483	366	1	48	0.0208333
NODE_43_length_8100_cov_32.115236	3435	3483	367	1	48	0.0208333
NODE_43_length_8100_cov_32.115236	3435	3483	381	1	48	0.0208333
NODE_43_length_8100_cov_32.115236	3435	3483	394	1	48	0.0208333
NODE_43_length_8100_cov_32.115236	3435	3483	395	1	48	0.0208333
NODE_43_length_8100_cov_32.115236	3435	3483	411	1	48	0.0208333
NODE_43_length_8100_cov_32.115236	3435	3483	419	1	48	0.0208333
NODE_43_length_8100_cov_32.115236	3435	3483	423	1	48	0.0208333
NODE_43_length_8100_cov_32.115236	3435	3483	431	2	48	0.0416667
NODE_43_length_8100_cov_32.115236	3435	3483	446	3	48	0.0625000
NODE_43_length_8100_cov_32.115236	3435	3483	451	1	48	0.0208333
NODE_43_length_8100_cov_32.115236	3435	3483	453	2	48	0.0416667
NODE_43_length_8100_cov_32.115236	3435	3483	455	1	48	0.0208333
NODE_43_length_8100_cov_32.115236	3435	3483	462	1	48	0.0208333
NODE_43_length_8100_cov_32.115236	3435	3483	480	1	48	0.0208333
NODE_43_length_8100_cov_32.115236	3435	3483	492	1	48	0.0208333
NODE_43_length_8100_cov_32.115236	3435	3483	499	1	48	0.0208333
NODE_43_length_8100_cov_32.115236	3435	3483	517	1	48	0.0208333
NODE_43_length_8100_cov_32.115236	3435	3483	525	1	48	0.0208333
NODE_43_length_8100_cov_32.115236	3435	3483	542	1	48	0.0208333
NODE_43_length_8100_cov_32.115236	3435	3483	553	2	48	0.0416667
NODE_43_length_8100_cov_32.115236	3435	3483	559	1	48	0.0208333
NODE_43_length_8100_cov_32.115236	3435	3483	563	1	48	0.0208333
NODE_46_length_7962_cov_31.622790	6281	6363	120	2	82	0.0243902
NODE_46_length_7962_cov_31.622790	6281	6363	122	1	82	0.0121951
NODE_46_length_7962_cov_31.622790	6281	6363	123	1	82	0.0121951
NODE_46_length_7962_cov_31.622790	6281	6363	124	10	82	0.1219512
NODE_46_length_7962_cov_31.622790	6281	6363	125	3	82	0.0365854
NODE_46_length_7962_cov_31.622790	6281	6363	126	4	82	0.0487805
NODE_46_length_7962_cov_31.622790	6281	6363	127	1	82	0.0121951
NODE_46_length_7962_cov_31.622790	6281	6363	128	4	82	0.0487805
NODE_46_length_7962_cov_31.622790	6281	6363	129	2	82	0.0243902
NODE_46_length_7962_cov_31.622790	6281	6363	130	4	82	0.0487805
NODE_46_length_7962_cov_31.622790	6281	6363	131	4	82	0.0487805
NODE_46_length_7962_cov_31.622790	6281	6363	132	1	82	0.0121951
NODE_46_length_7962_cov_31.622790	6281	6363	133	2	82	0.0243902
NODE_46_length_7962_cov_31.622790	6281	6363	135	4	82	0.0487805
NODE_46_length_7962_cov_31.622790	6281	6363	136	16	82	0.1951219
NODE_46_length_7962_cov_31.622790	6281	6363	137	7	82	0.0853659
NODE_46_length_7962_cov_31.622790	6281	6363	138	4	82	0.0487805
NODE_46_length_7962_cov_31.622790	6281	6363	139	5	82	0.0609756
NODE_46_length_7962_cov_31.622790	6281	6363	140	5	82	0.0609756
NODE_46_length_7962_cov_31.622790	6281	6363	141	1	82	0.0121951
NODE_46_length_7962_cov_31.622790	6281	6363	142	1	82	0.0121951
NODE_47_length_7944_cov_12.238496	348	419	0	29	71	0.4084507
NODE_47_length_7944_cov_12.238496	348	419	8	29	71	0.4084507
NODE_47_length_7944_cov_12.238496	348	419	10	5	71	0.0704225
NODE_47_length_7944_cov_12.238496	348	419	15	1	71	0.0140845
NODE_47_length_7944_cov_12.238496	348	419	17	7	71	0.0985916
NODE_48_length_7919_cov_14.554859	2380	2460	18	1	80	0.0125000
NODE_48_length_7919_cov_14.554859	2380	2460	20	3	80	0.0375000
NODE_48_length_7919_cov_14.554859	2380	2460	22	6	80	0.0750000
NODE_48_length_7919_cov_14.554859	2380	2460	24	8	80	0.1000000
NODE_48_length_7919_cov_14.554859	2380	2460	26	2	80	0.0250000
NODE_48_length_7919_cov_14.554859	2380	2460	30	2	80	0.0250000
NODE_48_length_7919_cov_14.554859	2380	2460	32	2	80	0.0250000
NODE_48_length_7919_cov_14.554859	2380	2460	34	1	80	0.0125000
NODE_48_length_7919_cov_14.554859	2380	2460	36	6	80	0.0750000
NODE_48_length_7919_cov_14.554859	2380	2460	40	3	80	0.0375000
NODE_48_length_7919_cov_14.554859	2380	2460	42	2	80	0.0250000
NODE_48_length_7919_cov_14.554859	2380	2460	46	4	80	0.0500000
NODE_48_length_7919_cov_14.554859	2380	2460	48	1	80	0.0125000
NODE_48_length_7919_cov_14.554859	2380	2460	50	5	80	0.0625000
NODE_48_length_7919_cov_14.554859	2380	2460	52	2	80	0.0250000
NODE_48_length_7919_cov_14.554859	2380	2460	56	8	80	0.1000000
NODE_48_length_7919_cov_14.554859	2380	2460	58	2	80	0.0250000
NODE_48_length_7919_cov_14.554859	2380	2460	60	2	80	0.0250000
NODE_48_length_7919_cov_14.554859	2380	2460	62	9	80	0.1125000
NODE_48_length_7919_cov_14.554859	2380	2460	64	11	80	0.1375000
NODE_50_length_7830_cov_4.211098	0	52	0	52	52	1.0000000
NODE_50_length_7830_cov_4.211098	30	105	0	75	75	1.0000000
NODE_52_length_7779_cov_20.230859	7691	7771	6	72	80	0.9000000
NODE_52_length_7779_cov_20.230859	7691	7771	8	8	80	0.1000000
NODE_52_length_7779_cov_20.230859	7691	7771	6	72	80	0.9000000
NODE_52_length_7779_cov_20.230859	7691	7771	8	8	80	0.1000000
NODE_52_length_7779_cov_20.230859	7691	7761	6	62	70	0.8857143
NODE_52_length_7779_cov_20.230859	7691	7761	8	8	70	0.1142857
NODE_52_length_7779_cov_20.230859	7744	7779	5	4	35	0.1142857
NODE_52_length_7779_cov_20.230859	7744	7779	6	31	35	0.8857143
NODE_53_length_7765_cov_18.871119	254	322	1	2	68	0.0294118
NODE_53_length_7765_cov_18.871119	254	322	2	13	68	0.1911765
NODE_53_length_7765_cov_18.871119	254	322	3	1	68	0.0147059
NODE_53_length_7765_cov_18.871119	254	322	4	1	68	0.0147059
NODE_53_length_7765_cov_18.871119	254	322	5	2	68	0.0294118
NODE_53_length_7765_cov_18.871119	254	322	6	24	68	0.3529412
NODE_53_length_7765_cov_18.871119	254	322	7	2	68	0.0294118
NODE_53_length_7765_cov_18.871119	254	322	8	10	68	0.1470588
NODE_53_length_7765_cov_18.871119	254	322	9	1	68	0.0147059
NODE_53_length_7765_cov_18.871119	254	322	11	8	68	0.1176471
NODE_53_length_7765_cov_18.871119	254	322	13	1	68	0.0147059
NODE_53_length_7765_cov_18.871119	254	322	15	3	68	0.0441176
NODE_53_length_7765_cov_18.871119	353	433	14	4	80	0.0500000
NODE_53_length_7765_cov_18.871119	353	433	16	1	80	0.0125000
NODE_53_length_7765_cov_18.871119	353	433	17	2	80	0.0250000
NODE_53_length_7765_cov_18.871119	353	433	18	4	80	0.0500000
NODE_53_length_7765_cov_18.871119	353	433	19	5	80	0.0625000
NODE_53_length_7765_cov_18.871119	353	433	21	3	80	0.0375000
NODE_53_length_7765_cov_18.871119	353	433	25	3	80	0.0375000
NODE_53_length_7765_cov_18.871119	353	433	26	22	80	0.2750000
NODE_53_length_7765_cov_18.871119	353	433	27	7	80	0.0875000
NODE_53_length_7765_cov_18.871119	353	433	28	21	80	0.2625000
NODE_53_length_7765_cov_18.871119	353	433	30	8	80	0.1000000
NODE_61_length_7411_cov_74.967314	2283	2347	0	64	64	1.0000000
NODE_61_length_7411_cov_74.967314	4725	4789	0	64	64	1.0000000
NODE_64_length_7305_cov_3.696087	971	1019	0	20	48	0.4166667
NODE_64_length_7305_cov_3.696087	971	1019	2	1	48	0.0208333
NODE_64_length_7305_cov_3.696087	971	1019	3	8	48	0.1666667
NODE_64_length_7305_cov_3.696087	971	1019	4	15	48	0.3125000
NODE_64_length_7305_cov_3.696087	971	1019	6	4	48	0.0833333
NODE_64_length_7305_cov_3.696087	7142	7190	0	34	48	0.7083333
NODE_64_length_7305_cov_3.696087	7142	7190	2	14	48	0.2916667
NODE_66_length_7261_cov_12.433398	2313	2395	175	1	82	0.0121951
NODE_66_length_7261_cov_12.433398	2313	2395	177	1	82	0.0121951
NODE_66_length_7261_cov_12.433398	2313	2395	178	3	82	0.0365854
NODE_66_length_7261_cov_12.433398	2313	2395	179	1	82	0.0121951
NODE_66_length_7261_cov_12.433398	2313	2395	180	2	82	0.0243902
NODE_66_length_7261_cov_12.433398	2313	2395	182	7	82	0.0853659
NODE_66_length_7261_cov_12.433398	2313	2395	183	6	82	0.0731707
NODE_66_length_7261_cov_12.433398	2313	2395	184	3	82	0.0365854
NODE_66_length_7261_cov_12.433398	2313	2395	185	3	82	0.0365854
NODE_66_length_7261_cov_12.433398	2313	2395	187	1	82	0.0121951
NODE_66_length_7261_cov_12.433398	2313	2395	188	3	82	0.0365854
NODE_66_length_7261_cov_12.433398	2313	2395	189	2	82	0.0243902
NODE_66_length_7261_cov_12.433398	2313	2395	191	3	82	0.0365854
NODE_66_length_7261_cov_12.433398	2313	2395	192	1	82	0.0121951
NODE_66_length_7261_cov_12.433398	2313	2395	193	1	82	0.0121951
NODE_66_length_7261_cov_12.433398	2313	2395	195	1	82	0.0121951
NODE_66_length_7261_cov_12.433398	2313	2395	196	2	82	0.0243902
NODE_66_length_7261_cov_12.433398	2313	2395	198	1	82	0.0121951
NODE_66_length_7261_cov_12.433398	2313	2395	199	2	82	0.0243902
NODE_66_length_7261_cov_12.433398	2313	2395	201	4	82	0.0487805
NODE_66_length_7261_cov_12.433398	2313	2395	202	1	82	0.0121951
NODE_66_length_7261_cov_12.433398	2313	2395	206	1	82	0.0121951
NODE_66_length_7261_cov_12.433398	2313	2395	208	1	82	0.0121951
NODE_66_length_7261_cov_12.433398	2313	2395	212	1	82	0.0121951
NODE_66_length_7261_cov_12.433398	2313	2395	214	1	82	0.0121951
NODE_66_length_7261_cov_12.433398	2313	2395	226	1	82	0.0121951
NODE_66_length_7261_cov_12.433398	2313	2395	232	1	82	0.0121951
NODE_66_length_7261_cov_12.433398	2313	2395	234	1	82	0.0121951
NODE_66_length_7261_cov_12.433398	2313	2395	240	1	82	0.0121951
NODE_66_length_7261_cov_12.433398	2313	2395	243	2	82	0.0243902
NODE_66_length_7261_cov_12.433398	2313	2395	245	1	82	0.0121951
NODE_66_length_7261_cov_12.433398	2313	2395	247	1	82	0.0121951
NODE_66_length_7261_cov_12.433398	2313	2395	253	1	82	0.0121951
NODE_66_length_7261_cov_12.433398	2313	2395	256	1	82	0.0121951
NODE_66_length_7261_cov_12.433398	2313	2395	257	2	82	0.0243902
NODE_66_length_7261_cov_12.433398	2313	2395	258	1	82	0.0121951
NODE_66_length_7261_cov_12.433398	2313	2395	259	3	82	0.0365854
NODE_66_length_7261_cov_12.433398	2313	2395	261	1	82	0.0121951
NODE_66_length_7261_cov_12.433398	2313	2395	263	1	82	0.0121951
NODE_66_length_7261_cov_12.433398	2313	2395	265	4	82	0.0487805
NODE_66_length_7261_cov_12.433398	2313	2395	268	1	82	0.0121951
NODE_66_length_7261_cov_12.433398	2313	2395	269	2	82	0.0243902
NODE_66_length_7261_cov_12.433398	2313	2395	270	1	82	0.0121951
NODE_66_length_7261_cov_12.433398	2313	2395	271	1	82	0.0121951
NODE_66_length_7261_cov_12.433398	2313	2395	272	1	82	0.0121951
NODE_66_length_7261_cov_12.433398	2313	2395	279	1	82	0.0121951
NODE_73_length_7036_cov_65.961943	4375	4455	0	9	80	0.1125000
NODE_73_length_7036_cov_65.961943	4375	4455	2	2	80	0.0250000
NODE_73_length_7036_cov_65.961943	4375	4455	4	6	80	0.0750000
NODE_73_length_7036_cov_65.961943	4375	4455	6	24	80	0.3000000
NODE_73_length_7036_cov_65.961943	4375	4455	7	39	80	0.4875000
NODE_73_length_7036_cov_65.961943	5538	5618	254	1	80	0.0125000
NODE_73_length_7036_cov_65.961943	5538	5618	257	1	80	0.0125000
NODE_73_length_7036_cov_65.961943	5538	5618	271	2	80	0.0250000
NODE_73_length_7036_cov_65.961943	5538	5618	277	1	80	0.0125000
NODE_73_length_7036_cov_65.961943	5538	5618	287	1	80	0.0125000
NODE_73_length_7036_cov_65.961943	5538	5618	289	1	80	0.0125000
NODE_73_length_7036_cov_65.961943	5538	5618	301	1	80	0.0125000
NODE_73_length_7036_cov_65.961943	5538	5618	308	1	80	0.0125000
NODE_73_length_7036_cov_65.961943	5538	5618	327	1	80	0.0125000
NODE_73_length_7036_cov_65.961943	5538	5618	336	1	80	0.0125000
NODE_73_length_7036_cov_65.961943	5538	5618	351	1	80	0.0125000
NODE_73_length_7036_cov_65.961943	5538	5618	360	1	80	0.0125000
NODE_73_length_7036_cov_65.961943	5538	5618	369	1	80	0.0125000
NODE_73_length_7036_cov_65.961943	5538	5618	387	1	80	0.0125000
NODE_73_length_7036_cov_65.961943	5538	5618	405	1	80	0.0125000
NODE_73_length_7036_cov_65.961943	5538	5618	421	1	80	0.0125000
NODE_73_length_7036_cov_65.961943	5538	5618	425	1	80	0.0125000
NODE_73_length_7036_cov_65.961943	5538	5618	428	1	80	0.0125000
NODE_73_length_7036_cov_65.961943	5538	5618	439	1	80	0.0125000
NODE_73_length_7036_cov_65.961943	5538	5618	446	1	80	0.0125000
NODE_73_length_7036_cov_65.961943	5538	5618	454	1	80	0.0125000
NODE_73_length_7036_cov_65.961943	5538	5618	465	1	80	0.0125000
NODE_73_length_7036_cov_65.961943	5538	5618	473	1	80	0.0125000
NODE_73_length_7036_cov_65.961943	5538	5618	479	1	80	0.0125000
NODE_73_length_7036_cov_65.961943	5538	5618	492	1	80	0.0125000
NODE_73_length_7036_cov_65.961943	5538	5618	501	1	80	0.0125000
NODE_73_length_7036_cov_65.961943	5538	5618	503	1	80	0.0125000
NODE_73_length_7036_cov_65.961943	5538	5618	519	1	80	0.0125000
NODE_73_length_7036_cov_65.961943	5538	5618	536	1	80	0.0125000
NODE_73_length_7036_cov_65.961943	5538	5618	543	1	80	0.0125000
NODE_73_length_7036_cov_65.961943	5538	5618	547	1	80	0.0125000
NODE_73_length_7036_cov_65.961943	5538	5618	577	1	80	0.0125000
NODE_73_length_7036_cov_65.961943	5538	5618	592	1	80	0.0125000
NODE_73_length_7036_cov_65.961943	5538	5618	625	1	80	0.0125000
NODE_73_length_7036_cov_65.961943	5538	5618	658	1	80	0.0125000
NODE_73_length_7036_cov_65.961943	5538	5618	662	1	80	0.0125000
NODE_73_length_7036_cov_65.961943	5538	5618	671	1	80	0.0125000
NODE_73_length_7036_cov_65.961943	5538	5618	677	1	80	0.0125000
NODE_73_length_7036_cov_65.961943	5538	5618	687	1	80	0.0125000
NODE_73_length_7036_cov_65.961943	5538	5618	707	1	80	0.0125000
NODE_73_length_7036_cov_65.961943	5538	5618	708	1	80	0.0125000
NODE_73_length_7036_cov_65.961943	5538	5618	710	1	80	0.0125000
NODE_73_length_7036_cov_65.961943	5538	5618	723	1	80	0.0125000
NODE_73_length_7036_cov_65.961943	5538	5618	726	1	80	0.0125000
NODE_73_length_7036_cov_65.961943	5538	5618	736	1	80	0.0125000
NODE_73_length_7036_cov_65.961943	5538	5618	746	1	80	0.0125000
NODE_73_length_7036_cov_65.961943	5538	5618	762	1	80	0.0125000
NODE_73_length_7036_cov_65.961943	5538	5618	771	1	80	0.0125000
NODE_73_length_7036_cov_65.961943	5538	5618	776	2	80	0.0250000
NODE_73_length_7036_cov_65.961943	5538	5618	777	1	80	0.0125000
NODE_73_length_7036_cov_65.961943	5538	5618	779	1	80	0.0125000
NODE_73_length_7036_cov_65.961943	5538	5618	787	1	80	0.0125000
NODE_73_length_7036_cov_65.961943	5538	5618	794	1	80	0.0125000
NODE_73_length_7036_cov_65.961943	5538	5618	801	1	80	0.0125000
NODE_73_length_7036_cov_65.961943	5538	5618	806	1	80	0.0125000
NODE_73_length_7036_cov_65.961943	5538	5618	834	1	80	0.0125000
NODE_73_length_7036_cov_65.961943	5538	5618	851	2	80	0.0250000
NODE_73_length_7036_cov_65.961943	5538	5618	862	1	80	0.0125000
NODE_73_length_7036_cov_65.961943	5538	5618	877	1	80	0.0125000
NODE_73_length_7036_cov_65.961943	5538	5618	886	1	80	0.0125000
NODE_73_length_7036_cov_65.961943	5538	5618	890	1	80	0.0125000
NODE_73_length_7036_cov_65.961943	5538	5618	893	1	80	0.0125000
NODE_73_length_7036_cov_65.961943	5538	5618	894	1	80	0.0125000
NODE_73_length_7036_cov_65.961943	5538	5618	907	1	80	0.0125000
NODE_73_length_7036_cov_65.961943	5538	5618	918	1	80	0.0125000
NODE_73_length_7036_cov_65.961943	5538	5618	920	2	80	0.0250000
NODE_73_length_7036_cov_65.961943	5538	5618	926	1	80	0.0125000
NODE_73_length_7036_cov_65.961943	5538	5618	928	1	80	0.0125000
NODE_73_length_7036_cov_65.961943	5538	5618	930	1	80	0.0125000
NODE_73_length_7036_cov_65.961943	5538	5618	932	1	80	0.0125000
NODE_73_length_7036_cov_65.961943	5538	5618	935	1	80	0.0125000
NODE_73_length_7036_cov_65.961943	5538	5618	938	1	80	0.0125000
NODE_73_length_7036_cov_65.961943	5538	5618	943	1	80	0.0125000
NODE_73_length_7036_cov_65.961943	5538	5618	945	1	80	0.0125000
NODE_73_length_7036_cov_65.961943	5538	5618	951	1	80	0.0125000
NODE_73_length_7036_cov_65.961943	5538	5618	952	1	80	0.0125000
NODE_73_length_7036_cov_65.961943	5591	5666	787	1	75	0.0133333
NODE_73_length_7036_cov_65.961943	5591	5666	794	1	75	0.0133333
NODE_73_length_7036_cov_65.961943	5591	5666	801	1	75	0.0133333
NODE_73_length_7036_cov_65.961943	5591	5666	806	1	75	0.0133333
NODE_73_length_7036_cov_65.961943	5591	5666	834	1	75	0.0133333
NODE_73_length_7036_cov_65.961943	5591	5666	851	2	75	0.0266667
NODE_73_length_7036_cov_65.961943	5591	5666	862	1	75	0.0133333
NODE_73_length_7036_cov_65.961943	5591	5666	877	1	75	0.0133333
NODE_73_length_7036_cov_65.961943	5591	5666	886	1	75	0.0133333
NODE_73_length_7036_cov_65.961943	5591	5666	890	1	75	0.0133333
NODE_73_length_7036_cov_65.961943	5591	5666	893	1	75	0.0133333
NODE_73_length_7036_cov_65.961943	5591	5666	894	1	75	0.0133333
NODE_73_length_7036_cov_65.961943	5591	5666	907	1	75	0.0133333
NODE_73_length_7036_cov_65.961943	5591	5666	918	1	75	0.0133333
NODE_73_length_7036_cov_65.961943	5591	5666	920	2	75	0.0266667
NODE_73_length_7036_cov_65.961943	5591	5666	926	1	75	0.0133333
NODE_73_length_7036_cov_65.961943	5591	5666	928	1	75	0.0133333
NODE_73_length_7036_cov_65.961943	5591	5666	930	1	75	0.0133333
NODE_73_length_7036_cov_65.961943	5591	5666	932	1	75	0.0133333
NODE_73_length_7036_cov_65.961943	5591	5666	935	1	75	0.0133333
NODE_73_length_7036_cov_65.961943	5591	5666	938	1	75	0.0133333
NODE_73_length_7036_cov_65.961943	5591	5666	943	1	75	0.0133333
NODE_73_length_7036_cov_65.961943	5591	5666	945	1	75	0.0133333
NODE_73_length_7036_cov_65.961943	5591	5666	951	1	75	0.0133333
NODE_73_length_7036_cov_65.961943	5591	5666	952	1	75	0.0133333
NODE_73_length_7036_cov_65.961943	5591	5666	955	1	75	0.0133333
NODE_73_length_7036_cov_65.961943	5591	5666	970	1	75	0.0133333
NODE_73_length_7036_cov_65.961943	5591	5666	989	1	75	0.0133333
NODE_73_length_7036_cov_65.961943	5591	5666	995	1	75	0.0133333
NODE_73_length_7036_cov_65.961943	5591	5666	997	1	75	0.0133333
NODE_73_length_7036_cov_65.961943	5591	5666	1002	1	75	0.0133333
NODE_73_length_7036_cov_65.961943	5591	5666	1008	1	75	0.0133333
NODE_73_length_7036_cov_65.961943	5591	5666	1014	1	75	0.0133333
NODE_73_length_7036_cov_65.961943	5591	5666	1015	2	75	0.0266667
NODE_73_length_7036_cov_65.961943	5591	5666	1017	1	75	0.0133333
NODE_73_length_7036_cov_65.961943	5591	5666	1022	1	75	0.0133333
NODE_73_length_7036_cov_65.961943	5591	5666	1025	1	75	0.0133333
NODE_73_length_7036_cov_65.961943	5591	5666	1032	1	75	0.0133333
NODE_73_length_7036_cov_65.961943	5591	5666	1034	1	75	0.0133333
NODE_73_length_7036_cov_65.961943	5591	5666	1042	1	75	0.0133333
NODE_73_length_7036_cov_65.961943	5591	5666	1045	2	75	0.0266667
NODE_73_length_7036_cov_65.961943	5591	5666	1046	2	75	0.0266667
NODE_73_length_7036_cov_65.961943	5591	5666	1050	2	75	0.0266667
NODE_73_length_7036_cov_65.961943	5591	5666	1052	1	75	0.0133333
NODE_73_length_7036_cov_65.961943	5591	5666	1054	1	75	0.0133333
NODE_73_length_7036_cov_65.961943	5591	5666	1055	2	75	0.0266667
NODE_73_length_7036_cov_65.961943	5591	5666	1062	1	75	0.0133333
NODE_73_length_7036_cov_65.961943	5591	5666	1066	1	75	0.0133333
NODE_73_length_7036_cov_65.961943	5591	5666	1074	1	75	0.0133333
NODE_73_length_7036_cov_65.961943	5591	5666	1077	1	75	0.0133333
NODE_73_length_7036_cov_65.961943	5591	5666	1086	1	75	0.0133333
NODE_73_length_7036_cov_65.961943	5591	5666	1095	1	75	0.0133333
NODE_73_length_7036_cov_65.961943	5591	5666	1103	1	75	0.0133333
NODE_73_length_7036_cov_65.961943	5591	5666	1114	1	75	0.0133333
NODE_73_length_7036_cov_65.961943	5591	5666	1151	1	75	0.0133333
NODE_73_length_7036_cov_65.961943	5591	5666	1158	2	75	0.0266667
NODE_73_length_7036_cov_65.961943	5591	5666	1171	1	75	0.0133333
NODE_73_length_7036_cov_65.961943	5591	5666	1174	1	75	0.0133333
NODE_73_length_7036_cov_65.961943	5591	5666	1182	1	75	0.0133333
NODE_73_length_7036_cov_65.961943	5591	5666	1190	1	75	0.0133333
NODE_73_length_7036_cov_65.961943	5591	5666	1210	1	75	0.0133333
NODE_73_length_7036_cov_65.961943	5591	5666	1217	1	75	0.0133333
NODE_73_length_7036_cov_65.961943	5591	5666	1235	1	75	0.0133333
NODE_73_length_7036_cov_65.961943	5591	5666	1248	1	75	0.0133333
NODE_73_length_7036_cov_65.961943	5591	5666	1254	1	75	0.0133333
NODE_73_length_7036_cov_65.961943	5591	5666	1263	1	75	0.0133333
NODE_73_length_7036_cov_65.961943	5591	5666	1269	1	75	0.0133333
NODE_73_length_7036_cov_65.961943	5690	5746	1415	1	56	0.0178571
NODE_73_length_7036_cov_65.961943	5690	5746	1419	2	56	0.0357143
NODE_73_length_7036_cov_65.961943	5690	5746	1444	1	56	0.0178571
NODE_73_length_7036_cov_65.961943	5690	5746	1449	1	56	0.0178571
NODE_73_length_7036_cov_65.961943	5690	5746	1460	1	56	0.0178571
NODE_73_length_7036_cov_65.961943	5690	5746	1474	1	56	0.0178571
NODE_73_length_7036_cov_65.961943	5690	5746	1478	1	56	0.0178571
NODE_73_length_7036_cov_65.961943	5690	5746	1487	1	56	0.0178571
NODE_73_length_7036_cov_65.961943	5690	5746	1491	1	56	0.0178571
NODE_73_length_7036_cov_65.961943	5690	5746	1493	1	56	0.0178571
NODE_73_length_7036_cov_65.961943	5690	5746	1494	2	56	0.0357143
NODE_73_length_7036_cov_65.961943	5690	5746	1495	1	56	0.0178571
NODE_73_length_7036_cov_65.961943	5690	5746	1497	1	56	0.0178571
NODE_73_length_7036_cov_65.961943	5690	5746	1498	1	56	0.0178571
NODE_73_length_7036_cov_65.961943	5690	5746	1500	1	56	0.0178571
NODE_73_length_7036_cov_65.961943	5690	5746	1504	1	56	0.0178571
NODE_73_length_7036_cov_65.961943	5690	5746	1506	2	56	0.0357143
NODE_73_length_7036_cov_65.961943	5690	5746	1508	1	56	0.0178571
NODE_73_length_7036_cov_65.961943	5690	5746	1511	1	56	0.0178571
NODE_73_length_7036_cov_65.961943	5690	5746	1512	1	56	0.0178571
NODE_73_length_7036_cov_65.961943	5690	5746	1514	2	56	0.0357143
NODE_73_length_7036_cov_65.961943	5690	5746	1522	2	56	0.0357143
NODE_73_length_7036_cov_65.961943	5690	5746	1523	1	56	0.0178571
NODE_73_length_7036_cov_65.961943	5690	5746	1525	3	56	0.0535714
NODE_73_length_7036_cov_65.961943	5690	5746	1527	1	56	0.0178571
NODE_73_length_7036_cov_65.961943	5690	5746	1528	1	56	0.0178571
NODE_73_length_7036_cov_65.961943	5690	5746	1529	3	56	0.0535714
NODE_73_length_7036_cov_65.961943	5690	5746	1531	2	56	0.0357143
NODE_73_length_7036_cov_65.961943	5690	5746	1533	1	56	0.0178571
NODE_73_length_7036_cov_65.961943	5690	5746	1536	1	56	0.0178571
NODE_73_length_7036_cov_65.961943	5690	5746	1541	2	56	0.0357143
NODE_73_length_7036_cov_65.961943	5690	5746	1548	1	56	0.0178571
NODE_73_length_7036_cov_65.961943	5690	5746	1549	1	56	0.0178571
NODE_73_length_7036_cov_65.961943	5690	5746	1550	1	56	0.0178571
NODE_73_length_7036_cov_65.961943	5690	5746	1551	1	56	0.0178571
NODE_73_length_7036_cov_65.961943	5690	5746	1554	1	56	0.0178571
NODE_73_length_7036_cov_65.961943	5690	5746	1556	2	56	0.0357143
NODE_73_length_7036_cov_65.961943	5690	5746	1557	1	56	0.0178571
NODE_73_length_7036_cov_65.961943	5690	5746	1566	2	56	0.0357143
NODE_73_length_7036_cov_65.961943	5690	5746	1567	2	56	0.0357143
NODE_73_length_7036_cov_65.961943	5690	5746	1573	1	56	0.0178571
NODE_73_length_7036_cov_65.961943	5690	5746	1579	1	56	0.0178571
NODE_73_length_7036_cov_65.961943	6373	6453	0	37	80	0.4625000
NODE_73_length_7036_cov_65.961943	6373	6453	2	43	80	0.5375000
NODE_73_length_7036_cov_65.961943	6426	6506	0	49	80	0.6125000
NODE_73_length_7036_cov_65.961943	6426	6506	2	31	80	0.3875000
NODE_74_length_6974_cov_16.058327	976	1056	6	6	80	0.0750000
NODE_74_length_6974_cov_16.058327	976	1056	8	16	80	0.2000000
NODE_74_length_6974_cov_16.058327	976	1056	9	4	80	0.0500000
NODE_74_length_6974_cov_16.058327	976	1056	10	5	80	0.0625000
NODE_74_length_6974_cov_16.058327	976	1056	12	15	80	0.1875000
NODE_74_length_6974_cov_16.058327	976	1056	14	7	80	0.0875000
NODE_74_length_6974_cov_16.058327	976	1056	16	18	80	0.2250000
NODE_74_length_6974_cov_16.058327	976	1056	18	9	80	0.1125000
NODE_74_length_6974_cov_16.058327	1029	1109	12	4	80	0.0500000
NODE_74_length_6974_cov_16.058327	1029	1109	13	1	80	0.0125000
NODE_74_length_6974_cov_16.058327	1029	1109	14	7	80	0.0875000
NODE_74_length_6974_cov_16.058327	1029	1109	15	7	80	0.0875000
NODE_74_length_6974_cov_16.058327	1029	1109	16	13	80	0.1625000
NODE_74_length_6974_cov_16.058327	1029	1109	17	22	80	0.2750000
NODE_74_length_6974_cov_16.058327	1029	1109	18	13	80	0.1625000
NODE_74_length_6974_cov_16.058327	1029	1109	19	2	80	0.0250000
NODE_74_length_6974_cov_16.058327	1029	1109	21	11	80	0.1375000
NODE_80_length_6826_cov_10.483574	4462	4542	0	10	80	0.1250000
NODE_80_length_6826_cov_10.483574	4462	4542	14	5	80	0.0625000
NODE_80_length_6826_cov_10.483574	4462	4542	16	3	80	0.0375000
NODE_80_length_6826_cov_10.483574	4462	4542	18	1	80	0.0125000
NODE_80_length_6826_cov_10.483574	4462	4542	20	1	80	0.0125000
NODE_80_length_6826_cov_10.483574	4462	4542	22	9	80	0.1125000
NODE_80_length_6826_cov_10.483574	4462	4542	26	4	80	0.0500000
NODE_80_length_6826_cov_10.483574	4462	4542	29	5	80	0.0625000
NODE_80_length_6826_cov_10.483574	4462	4542	33	7	80	0.0875000
NODE_80_length_6826_cov_10.483574	4462	4542	34	7	80	0.0875000
NODE_80_length_6826_cov_10.483574	4462	4542	38	1	80	0.0125000
NODE_80_length_6826_cov_10.483574	4462	4542	42	3	80	0.0375000
NODE_80_length_6826_cov_10.483574	4462	4542	44	3	80	0.0375000
NODE_80_length_6826_cov_10.483574	4462	4542	47	2	80	0.0250000
NODE_80_length_6826_cov_10.483574	4462	4542	49	2	80	0.0250000
NODE_80_length_6826_cov_10.483574	4462	4542	50	5	80	0.0625000
NODE_80_length_6826_cov_10.483574	4462	4542	52	2	80	0.0250000
NODE_80_length_6826_cov_10.483574	4462	4542	54	10	80	0.1250000
NODE_80_length_6826_cov_10.483574	4515	4595	42	3	80	0.0375000
NODE_80_length_6826_cov_10.483574	4515	4595	44	3	80	0.0375000
NODE_80_length_6826_cov_10.483574	4515	4595	47	2	80	0.0250000
NODE_80_length_6826_cov_10.483574	4515	4595	49	2	80	0.0250000
NODE_80_length_6826_cov_10.483574	4515	4595	50	5	80	0.0625000
NODE_80_length_6826_cov_10.483574	4515	4595	51	4	80	0.0500000
NODE_80_length_6826_cov_10.483574	4515	4595	52	2	80	0.0250000
NODE_80_length_6826_cov_10.483574	4515	4595	53	2	80	0.0250000
NODE_80_length_6826_cov_10.483574	4515	4595	54	10	80	0.1250000
NODE_80_length_6826_cov_10.483574	4515	4595	55	3	80	0.0375000
NODE_80_length_6826_cov_10.483574	4515	4595	56	1	80	0.0125000
NODE_80_length_6826_cov_10.483574	4515	4595	57	2	80	0.0250000
NODE_80_length_6826_cov_10.483574	4515	4595	58	9	80	0.1125000
NODE_80_length_6826_cov_10.483574	4515	4595	59	2	80	0.0250000
NODE_80_length_6826_cov_10.483574	4515	4595	61	1	80	0.0125000
NODE_80_length_6826_cov_10.483574	4515	4595	63	12	80	0.1500000
NODE_80_length_6826_cov_10.483574	4515	4595	64	7	80	0.0875000
NODE_80_length_6826_cov_10.483574	4515	4595	65	10	80	0.1250000
NODE_81_length_6816_cov_2.820753	6726	6801	0	75	75	1.0000000
NODE_81_length_6816_cov_2.820753	6774	6816	0	42	42	1.0000000
NODE_84_length_6744_cov_6.222272	5	85	0	63	80	0.7875000
NODE_84_length_6744_cov_6.222272	5	85	2	17	80	0.2125000
NODE_84_length_6744_cov_6.222272	58	138	0	10	80	0.1250000
NODE_84_length_6744_cov_6.222272	58	138	2	37	80	0.4625000
NODE_84_length_6744_cov_6.222272	58	138	4	31	80	0.3875000
NODE_84_length_6744_cov_6.222272	58	138	6	2	80	0.0250000
NODE_84_length_6744_cov_6.222272	6650	6730	8	22	80	0.2750000
NODE_84_length_6744_cov_6.222272	6650	6730	10	48	80	0.6000000
NODE_84_length_6744_cov_6.222272	6650	6730	12	10	80	0.1250000
NODE_84_length_6744_cov_6.222272	6703	6744	0	10	41	0.2439024
NODE_84_length_6744_cov_6.222272	6703	6744	4	1	41	0.0243902
NODE_84_length_6744_cov_6.222272	6703	6744	6	2	41	0.0487805
NODE_84_length_6744_cov_6.222272	6703	6744	8	23	41	0.5609756
NODE_84_length_6744_cov_6.222272	6703	6744	10	5	41	0.1219512
NODE_86_length_6733_cov_88.965029	3141	3221	0	38	80	0.4750000
NODE_86_length_6733_cov_88.965029	3141	3221	2	6	80	0.0750000
NODE_86_length_6733_cov_88.965029	3141	3221	4	21	80	0.2625000
NODE_86_length_6733_cov_88.965029	3141	3221	6	15	80	0.1875000
NODE_86_length_6733_cov_88.965029	3194	3274	2	3	80	0.0375000
NODE_86_length_6733_cov_88.965029	3194	3274	4	25	80	0.3125000
NODE_86_length_6733_cov_88.965029	3194	3274	6	52	80	0.6500000
NODE_86_length_6733_cov_88.965029	3270	3350	2	51	80	0.6375000
NODE_86_length_6733_cov_88.965029	3270	3350	4	29	80	0.3625000
NODE_86_length_6733_cov_88.965029	3323	3403	0	14	80	0.1750000
NODE_86_length_6733_cov_88.965029	3323	3403	1	10	80	0.1250000
NODE_86_length_6733_cov_88.965029	3323	3403	2	56	80	0.7000000
NODE_90_length_6627_cov_9.440564	350	430	0	60	80	0.7500000
NODE_90_length_6627_cov_9.440564	350	430	2	20	80	0.2500000
NODE_90_length_6627_cov_9.440564	403	483	0	80	80	1.0000000
NODE_95_length_6507_cov_95.786049	171	247	0	5	76	0.0657895
NODE_95_length_6507_cov_95.786049	171	247	2	2	76	0.0263158
NODE_95_length_6507_cov_95.786049	171	247	4	65	76	0.8552632
NODE_95_length_6507_cov_95.786049	171	247	6	1	76	0.0131579
NODE_95_length_6507_cov_95.786049	171	247	21	1	76	0.0131579
NODE_95_length_6507_cov_95.786049	171	247	32	1	76	0.0131579
NODE_95_length_6507_cov_95.786049	171	247	94	1	76	0.0131579
NODE_96_length_6497_cov_2.677399	366	436	4	5	70	0.0714286
NODE_96_length_6497_cov_2.677399	366	436	10	16	70	0.2285714
NODE_96_length_6497_cov_2.677399	366	436	12	49	70	0.7000000
NODE_96_length_6497_cov_2.677399	409	444	2	3	35	0.0857143
NODE_96_length_6497_cov_2.677399	409	444	4	10	35	0.2857143
NODE_96_length_6497_cov_2.677399	409	444	12	22	35	0.6285715
NODE_97_length_6450_cov_26.108172	5024	5104	16	2	80	0.0250000
NODE_97_length_6450_cov_26.108172	5024	5104	18	11	80	0.1375000
NODE_97_length_6450_cov_26.108172	5024	5104	22	1	80	0.0125000
NODE_97_length_6450_cov_26.108172	5024	5104	26	12	80	0.1500000
NODE_97_length_6450_cov_26.108172	5024	5104	28	9	80	0.1125000
NODE_97_length_6450_cov_26.108172	5024	5104	32	5	80	0.0625000
NODE_97_length_6450_cov_26.108172	5024	5104	36	4	80	0.0500000
NODE_97_length_6450_cov_26.108172	5024	5104	38	27	80	0.3375000
NODE_97_length_6450_cov_26.108172	5024	5104	40	9	80	0.1125000
NODE_109_length_6171_cov_36.061100	3743	3813	14	3	70	0.0428571
NODE_109_length_6171_cov_36.061100	3743	3813	16	3	70	0.0428571
NODE_109_length_6171_cov_36.061100	3743	3813	18	6	70	0.0857143
NODE_109_length_6171_cov_36.061100	3743	3813	20	16	70	0.2285714
NODE_109_length_6171_cov_36.061100	3743	3813	22	3	70	0.0428571
NODE_109_length_6171_cov_36.061100	3743	3813	23	6	70	0.0857143
NODE_109_length_6171_cov_36.061100	3743	3813	25	3	70	0.0428571
NODE_109_length_6171_cov_36.061100	3743	3813	27	10	70	0.1428571
NODE_109_length_6171_cov_36.061100	3743	3813	28	11	70	0.1571429
NODE_109_length_6171_cov_36.061100	3743	3813	29	9	70	0.1285714
NODE_109_length_6171_cov_36.061100	3798	3851	26	2	53	0.0377358
NODE_109_length_6171_cov_36.061100	3798	3851	27	5	53	0.0943396
NODE_109_length_6171_cov_36.061100	3798	3851	28	7	53	0.1320755
NODE_109_length_6171_cov_36.061100	3798	3851	29	11	53	0.2075472
NODE_109_length_6171_cov_36.061100	3798	3851	30	5	53	0.0943396
NODE_109_length_6171_cov_36.061100	3798	3851	33	1	53	0.0188679
NODE_109_length_6171_cov_36.061100	3798	3851	34	5	53	0.0943396
NODE_109_length_6171_cov_36.061100	3798	3851	35	4	53	0.0754717
NODE_109_length_6171_cov_36.061100	3798	3851	36	1	53	0.0188679
NODE_109_length_6171_cov_36.061100	3798	3851	37	4	53	0.0754717
NODE_109_length_6171_cov_36.061100	3798	3851	38	1	53	0.0188679
NODE_109_length_6171_cov_36.061100	3798	3851	40	7	53	0.1320755
NODE_109_length_6171_cov_36.061100	4552	4596	366	1	44	0.0227273
NODE_109_length_6171_cov_36.061100	4552	4596	368	2	44	0.0454545
NODE_109_length_6171_cov_36.061100	4552	4596	370	1	44	0.0227273
NODE_109_length_6171_cov_36.061100	4552	4596	372	1	44	0.0227273
NODE_109_length_6171_cov_36.061100	4552	4596	373	3	44	0.0681818
NODE_109_length_6171_cov_36.061100	4552	4596	374	1	44	0.0227273
NODE_109_length_6171_cov_36.061100	4552	4596	376	1	44	0.0227273
NODE_109_length_6171_cov_36.061100	4552	4596	378	1	44	0.0227273
NODE_109_length_6171_cov_36.061100	4552	4596	393	1	44	0.0227273
NODE_109_length_6171_cov_36.061100	4552	4596	394	3	44	0.0681818
NODE_109_length_6171_cov_36.061100	4552	4596	395	1	44	0.0227273
NODE_109_length_6171_cov_36.061100	4552	4596	396	4	44	0.0909091
NODE_109_length_6171_cov_36.061100	4552	4596	397	1	44	0.0227273
NODE_109_length_6171_cov_36.061100	4552	4596	398	1	44	0.0227273
NODE_109_length_6171_cov_36.061100	4552	4596	400	1	44	0.0227273
NODE_109_length_6171_cov_36.061100	4552	4596	401	1	44	0.0227273
NODE_109_length_6171_cov_36.061100	4552	4596	402	3	44	0.0681818
NODE_109_length_6171_cov_36.061100	4552	4596	403	2	44	0.0454545
NODE_109_length_6171_cov_36.061100	4552	4596	404	1	44	0.0227273
NODE_109_length_6171_cov_36.061100	4552	4596	406	1	44	0.0227273
NODE_109_length_6171_cov_36.061100	4552	4596	409	1	44	0.0227273
NODE_109_length_6171_cov_36.061100	4552	4596	415	1	44	0.0227273
NODE_109_length_6171_cov_36.061100	4552	4596	417	3	44	0.0681818
NODE_109_length_6171_cov_36.061100	4552	4596	419	1	44	0.0227273
NODE_109_length_6171_cov_36.061100	4552	4596	427	1	44	0.0227273
NODE_109_length_6171_cov_36.061100	4552	4596	430	1	44	0.0227273
NODE_109_length_6171_cov_36.061100	4552	4596	431	1	44	0.0227273
NODE_109_length_6171_cov_36.061100	4552	4596	432	1	44	0.0227273
NODE_109_length_6171_cov_36.061100	4552	4596	433	1	44	0.0227273
NODE_109_length_6171_cov_36.061100	4552	4596	438	2	44	0.0454545
NODE_109_length_6171_cov_36.061100	4569	4649	394	1	80	0.0125000
NODE_109_length_6171_cov_36.061100	4569	4649	395	1	80	0.0125000
NODE_109_length_6171_cov_36.061100	4569	4649	396	2	80	0.0250000
NODE_109_length_6171_cov_36.061100	4569	4649	398	1	80	0.0125000
NODE_109_length_6171_cov_36.061100	4569	4649	400	1	80	0.0125000
NODE_109_length_6171_cov_36.061100	4569	4649	401	1	80	0.0125000
NODE_109_length_6171_cov_36.061100	4569	4649	402	3	80	0.0375000
NODE_109_length_6171_cov_36.061100	4569	4649	403	2	80	0.0250000
NODE_109_length_6171_cov_36.061100	4569	4649	404	1	80	0.0125000
NODE_109_length_6171_cov_36.061100	4569	4649	406	1	80	0.0125000
NODE_109_length_6171_cov_36.061100	4569	4649	409	1	80	0.0125000
NODE_109_length_6171_cov_36.061100	4569	4649	415	1	80	0.0125000
NODE_109_length_6171_cov_36.061100	4569	4649	417	3	80	0.0375000
NODE_109_length_6171_cov_36.061100	4569	4649	419	1	80	0.0125000
NODE_109_length_6171_cov_36.061100	4569	4649	427	1	80	0.0125000
NODE_109_length_6171_cov_36.061100	4569	4649	428	1	80	0.0125000
NODE_109_length_6171_cov_36.061100	4569	4649	429	2	80	0.0250000
NODE_109_length_6171_cov_36.061100	4569	4649	430	1	80	0.0125000
NODE_109_length_6171_cov_36.061100	4569	4649	431	1	80	0.0125000
NODE_109_length_6171_cov_36.061100	4569	4649	432	1	80	0.0125000
NODE_109_length_6171_cov_36.061100	4569	4649	433	1	80	0.0125000
NODE_109_length_6171_cov_36.061100	4569	4649	436	2	80	0.0250000
NODE_109_length_6171_cov_36.061100	4569	4649	437	2	80	0.0250000
NODE_109_length_6171_cov_36.061100	4569	4649	438	2	80	0.0250000
NODE_109_length_6171_cov_36.061100	4569	4649	439	1	80	0.0125000
NODE_109_length_6171_cov_36.061100	4569	4649	440	4	80	0.0500000
NODE_109_length_6171_cov_36.061100	4569	4649	441	1	80	0.0125000
NODE_109_length_6171_cov_36.061100	4569	4649	442	2	80	0.0250000
NODE_109_length_6171_cov_36.061100	4569	4649	443	2	80	0.0250000
NODE_109_length_6171_cov_36.061100	4569	4649	445	2	80	0.0250000
NODE_109_length_6171_cov_36.061100	4569	4649	446	4	80	0.0500000
NODE_109_length_6171_cov_36.061100	4569	4649	448	4	80	0.0500000
NODE_109_length_6171_cov_36.061100	4569	4649	450	1	80	0.0125000
NODE_109_length_6171_cov_36.061100	4569	4649	451	2	80	0.0250000
NODE_109_length_6171_cov_36.061100	4569	4649	453	1	80	0.0125000
NODE_109_length_6171_cov_36.061100	4569	4649	456	1	80	0.0125000
NODE_109_length_6171_cov_36.061100	4569	4649	458	2	80	0.0250000
NODE_109_length_6171_cov_36.061100	4569	4649	459	1	80	0.0125000
NODE_109_length_6171_cov_36.061100	4569	4649	460	1	80	0.0125000
NODE_109_length_6171_cov_36.061100	4569	4649	467	1	80	0.0125000
NODE_109_length_6171_cov_36.061100	4569	4649	468	1	80	0.0125000
NODE_109_length_6171_cov_36.061100	4569	4649	470	2	80	0.0250000
NODE_109_length_6171_cov_36.061100	4569	4649	471	2	80	0.0250000
NODE_109_length_6171_cov_36.061100	4569	4649	472	3	80	0.0375000
NODE_109_length_6171_cov_36.061100	4569	4649	475	1	80	0.0125000
NODE_109_length_6171_cov_36.061100	4569	4649	476	2	80	0.0250000
NODE_109_length_6171_cov_36.061100	4569	4649	478	2	80	0.0250000
NODE_109_length_6171_cov_36.061100	4569	4649	479	1	80	0.0125000
NODE_109_length_6171_cov_36.061100	4569	4649	480	1	80	0.0125000
NODE_109_length_6171_cov_36.061100	4569	4649	481	1	80	0.0125000
NODE_109_length_6171_cov_36.061100	5742	5788	2	46	46	1.0000000
NODE_109_length_6171_cov_36.061100	5761	5841	0	30	80	0.3750000
NODE_109_length_6171_cov_36.061100	5761	5841	2	50	80	0.6250000
NODE_110_length_6148_cov_58.915358	5602	5682	0	80	80	1.0000000
NODE_110_length_6148_cov_58.915358	5655	5735	0	80	80	1.0000000
NODE_112_length_6026_cov_17.775772	4124	4204	4	40	80	0.5000000
NODE_112_length_6026_cov_17.775772	4124	4204	5	9	80	0.1125000
NODE_112_length_6026_cov_17.775772	4124	4204	6	30	80	0.3750000
NODE_112_length_6026_cov_17.775772	4124	4204	8	1	80	0.0125000
NODE_112_length_6026_cov_17.775772	4177	4257	2	16	80	0.2000000
NODE_112_length_6026_cov_17.775772	4177	4257	3	7	80	0.0875000
NODE_112_length_6026_cov_17.775772	4177	4257	4	36	80	0.4500000
NODE_112_length_6026_cov_17.775772	4177	4257	5	21	80	0.2625000
NODE_112_length_6026_cov_17.775772	4253	4333	2	30	80	0.3750000
NODE_112_length_6026_cov_17.775772	4253	4333	4	6	80	0.0750000
NODE_112_length_6026_cov_17.775772	4253	4333	8	29	80	0.3625000
NODE_112_length_6026_cov_17.775772	4253	4333	10	8	80	0.1000000
NODE_112_length_6026_cov_17.775772	4253	4333	12	7	80	0.0875000
NODE_112_length_6026_cov_17.775772	4306	4386	4	1	80	0.0125000
NODE_112_length_6026_cov_17.775772	4306	4386	6	12	80	0.1500000
NODE_112_length_6026_cov_17.775772	4306	4386	7	7	80	0.0875000
NODE_112_length_6026_cov_17.775772	4306	4386	8	12	80	0.1500000
NODE_112_length_6026_cov_17.775772	4306	4386	10	8	80	0.1000000
NODE_112_length_6026_cov_17.775772	4306	4386	11	21	80	0.2625000
NODE_112_length_6026_cov_17.775772	4306	4386	12	19	80	0.2375000
NODE_124_length_5810_cov_24.750657	2064	2144	0	21	80	0.2625000
NODE_124_length_5810_cov_24.750657	2064	2144	2	13	80	0.1625000
NODE_124_length_5810_cov_24.750657	2064	2144	4	4	80	0.0500000
NODE_124_length_5810_cov_24.750657	2064	2144	8	2	80	0.0250000
NODE_124_length_5810_cov_24.750657	2064	2144	11	1	80	0.0125000
NODE_124_length_5810_cov_24.750657	2064	2144	13	1	80	0.0125000
NODE_124_length_5810_cov_24.750657	2064	2144	16	1	80	0.0125000
NODE_124_length_5810_cov_24.750657	2064	2144	18	3	80	0.0375000
NODE_124_length_5810_cov_24.750657	2064	2144	20	5	80	0.0625000
NODE_124_length_5810_cov_24.750657	2064	2144	22	3	80	0.0375000
NODE_124_length_5810_cov_24.750657	2064	2144	34	1	80	0.0125000
NODE_124_length_5810_cov_24.750657	2064	2144	36	3	80	0.0375000
NODE_124_length_5810_cov_24.750657	2064	2144	38	1	80	0.0125000
NODE_124_length_5810_cov_24.750657	2064	2144	49	1	80	0.0125000
NODE_124_length_5810_cov_24.750657	2064	2144	55	1	80	0.0125000
NODE_124_length_5810_cov_24.750657	2064	2144	59	1	80	0.0125000
NODE_124_length_5810_cov_24.750657	2064	2144	65	2	80	0.0250000
NODE_124_length_5810_cov_24.750657	2064	2144	66	1	80	0.0125000
NODE_124_length_5810_cov_24.750657	2064	2144	68	1	80	0.0125000
NODE_124_length_5810_cov_24.750657	2064	2144	74	5	80	0.0625000
NODE_124_length_5810_cov_24.750657	2064	2144	76	1	80	0.0125000
NODE_124_length_5810_cov_24.750657	2064	2144	80	3	80	0.0375000
NODE_124_length_5810_cov_24.750657	2064	2144	81	2	80	0.0250000
NODE_124_length_5810_cov_24.750657	2064	2144	85	1	80	0.0125000
NODE_124_length_5810_cov_24.750657	2064	2144	87	2	80	0.0250000
NODE_124_length_5810_cov_24.750657	2117	2194	0	48	77	0.6233766
NODE_124_length_5810_cov_24.750657	2117	2194	2	29	77	0.3766234
NODE_127_length_5771_cov_10.854549	2814	2883	0	11	69	0.1594203
NODE_127_length_5771_cov_10.854549	2814	2883	2	2	69	0.0289855
NODE_127_length_5771_cov_10.854549	2814	2883	6	56	69	0.8115942
NODE_128_length_5769_cov_6.878483	5701	5731	2	30	30	1.0000000
NODE_133_length_5728_cov_16.351039	63	134	0	71	71	1.0000000
NODE_133_length_5728_cov_16.351039	2960	3040	2	2	80	0.0250000
NODE_133_length_5728_cov_16.351039	2960	3040	4	16	80	0.2000000
NODE_133_length_5728_cov_16.351039	2960	3040	6	62	80	0.7750000
NODE_133_length_5728_cov_16.351039	5106	5172	71	4	66	0.0606061
NODE_133_length_5728_cov_16.351039	5106	5172	73	5	66	0.0757576
NODE_133_length_5728_cov_16.351039	5106	5172	74	1	66	0.0151515
NODE_133_length_5728_cov_16.351039	5106	5172	78	2	66	0.0303030
NODE_133_length_5728_cov_16.351039	5106	5172	84	1	66	0.0151515
NODE_133_length_5728_cov_16.351039	5106	5172	86	1	66	0.0151515
NODE_133_length_5728_cov_16.351039	5106	5172	94	1	66	0.0151515
NODE_133_length_5728_cov_16.351039	5106	5172	95	1	66	0.0151515
NODE_133_length_5728_cov_16.351039	5106	5172	97	8	66	0.1212121
NODE_133_length_5728_cov_16.351039	5106	5172	98	1	66	0.0151515
NODE_133_length_5728_cov_16.351039	5106	5172	99	6	66	0.0909091
NODE_133_length_5728_cov_16.351039	5106	5172	103	1	66	0.0151515
NODE_133_length_5728_cov_16.351039	5106	5172	105	3	66	0.0454545
NODE_133_length_5728_cov_16.351039	5106	5172	107	1	66	0.0151515
NODE_133_length_5728_cov_16.351039	5106	5172	110	4	66	0.0606061
NODE_133_length_5728_cov_16.351039	5106	5172	114	1	66	0.0151515
NODE_133_length_5728_cov_16.351039	5106	5172	118	3	66	0.0454545
NODE_133_length_5728_cov_16.351039	5106	5172	125	3	66	0.0454545
NODE_133_length_5728_cov_16.351039	5106	5172	131	1	66	0.0151515
NODE_133_length_5728_cov_16.351039	5106	5172	133	3	66	0.0454545
NODE_133_length_5728_cov_16.351039	5106	5172	135	4	66	0.0606061
NODE_133_length_5728_cov_16.351039	5106	5172	140	4	66	0.0606061
NODE_133_length_5728_cov_16.351039	5106	5172	143	4	66	0.0606061
NODE_133_length_5728_cov_16.351039	5106	5172	144	2	66	0.0303030
NODE_133_length_5728_cov_16.351039	5106	5172	147	1	66	0.0151515
NODE_133_length_5728_cov_16.351039	5145	5225	110	1	80	0.0125000
NODE_133_length_5728_cov_16.351039	5145	5225	114	1	80	0.0125000
NODE_133_length_5728_cov_16.351039	5145	5225	118	3	80	0.0375000
NODE_133_length_5728_cov_16.351039	5145	5225	125	3	80	0.0375000
NODE_133_length_5728_cov_16.351039	5145	5225	131	1	80	0.0125000
NODE_133_length_5728_cov_16.351039	5145	5225	133	3	80	0.0375000
NODE_133_length_5728_cov_16.351039	5145	5225	135	4	80	0.0500000
NODE_133_length_5728_cov_16.351039	5145	5225	140	4	80	0.0500000
NODE_133_length_5728_cov_16.351039	5145	5225	143	4	80	0.0500000
NODE_133_length_5728_cov_16.351039	5145	5225	144	2	80	0.0250000
NODE_133_length_5728_cov_16.351039	5145	5225	146	1	80	0.0125000
NODE_133_length_5728_cov_16.351039	5145	5225	147	1	80	0.0125000
NODE_133_length_5728_cov_16.351039	5145	5225	148	6	80	0.0750000
NODE_133_length_5728_cov_16.351039	5145	5225	150	1	80	0.0125000
NODE_133_length_5728_cov_16.351039	5145	5225	152	2	80	0.0250000
NODE_133_length_5728_cov_16.351039	5145	5225	156	2	80	0.0250000
NODE_133_length_5728_cov_16.351039	5145	5225	162	3	80	0.0375000
NODE_133_length_5728_cov_16.351039	5145	5225	164	2	80	0.0250000
NODE_133_length_5728_cov_16.351039	5145	5225	165	4	80	0.0500000
NODE_133_length_5728_cov_16.351039	5145	5225	167	4	80	0.0500000
NODE_133_length_5728_cov_16.351039	5145	5225	169	1	80	0.0125000
NODE_133_length_5728_cov_16.351039	5145	5225	170	2	80	0.0250000
NODE_133_length_5728_cov_16.351039	5145	5225	171	1	80	0.0125000
NODE_133_length_5728_cov_16.351039	5145	5225	179	3	80	0.0375000
NODE_133_length_5728_cov_16.351039	5145	5225	181	4	80	0.0500000
NODE_133_length_5728_cov_16.351039	5145	5225	183	8	80	0.1000000
NODE_133_length_5728_cov_16.351039	5145	5225	185	2	80	0.0250000
NODE_133_length_5728_cov_16.351039	5145	5225	187	2	80	0.0250000
NODE_133_length_5728_cov_16.351039	5145	5225	188	1	80	0.0125000
NODE_133_length_5728_cov_16.351039	5145	5225	190	1	80	0.0125000
NODE_133_length_5728_cov_16.351039	5145	5225	191	1	80	0.0125000
NODE_133_length_5728_cov_16.351039	5145	5225	192	1	80	0.0125000
NODE_133_length_5728_cov_16.351039	5145	5225	194	1	80	0.0125000
NODE_137_length_5696_cov_20.656244	179	258	0	30	79	0.3797468
NODE_137_length_5696_cov_20.656244	179	258	2	49	79	0.6202531
NODE_137_length_5696_cov_20.656244	231	311	0	80	80	1.0000000
NODE_137_length_5696_cov_20.656244	307	387	0	45	80	0.5625000
NODE_137_length_5696_cov_20.656244	307	387	4	35	80	0.4375000
NODE_137_length_5696_cov_20.656244	360	440	0	4	80	0.0500000
NODE_137_length_5696_cov_20.656244	360	440	4	76	80	0.9500000
NODE_137_length_5696_cov_20.656244	5100	5180	0	80	80	1.0000000
NODE_137_length_5696_cov_20.656244	5153	5233	0	80	80	1.0000000
NODE_137_length_5696_cov_20.656244	5280	5360	0	80	80	1.0000000
NODE_137_length_5696_cov_20.656244	5333	5413	0	80	80	1.0000000
NODE_139_length_5681_cov_68.065030	253	333	2	4	80	0.0500000
NODE_139_length_5681_cov_68.065030	253	333	4	11	80	0.1375000
NODE_139_length_5681_cov_68.065030	253	333	6	16	80	0.2000000
NODE_139_length_5681_cov_68.065030	253	333	8	2	80	0.0250000
NODE_139_length_5681_cov_68.065030	253	333	10	47	80	0.5875000
NODE_139_length_5681_cov_68.065030	306	386	0	7	80	0.0875000
NODE_139_length_5681_cov_68.065030	306	386	2	1	80	0.0125000
NODE_139_length_5681_cov_68.065030	306	386	4	27	80	0.3375000
NODE_139_length_5681_cov_68.065030	306	386	6	10	80	0.1250000
NODE_139_length_5681_cov_68.065030	306	386	8	9	80	0.1125000
NODE_139_length_5681_cov_68.065030	306	386	10	26	80	0.3250000
NODE_139_length_5681_cov_68.065030	4762	4842	179	1	80	0.0125000
NODE_139_length_5681_cov_68.065030	4762	4842	180	2	80	0.0250000
NODE_139_length_5681_cov_68.065030	4762	4842	185	1	80	0.0125000
NODE_139_length_5681_cov_68.065030	4762	4842	186	2	80	0.0250000
NODE_139_length_5681_cov_68.065030	4762	4842	192	2	80	0.0250000
NODE_139_length_5681_cov_68.065030	4762	4842	193	1	80	0.0125000
NODE_139_length_5681_cov_68.065030	4762	4842	198	3	80	0.0375000
NODE_139_length_5681_cov_68.065030	4762	4842	200	1	80	0.0125000
NODE_139_length_5681_cov_68.065030	4762	4842	201	1	80	0.0125000
NODE_139_length_5681_cov_68.065030	4762	4842	204	2	80	0.0250000
NODE_139_length_5681_cov_68.065030	4762	4842	206	1	80	0.0125000
NODE_139_length_5681_cov_68.065030	4762	4842	215	1	80	0.0125000
NODE_139_length_5681_cov_68.065030	4762	4842	216	1	80	0.0125000
NODE_139_length_5681_cov_68.065030	4762	4842	226	2	80	0.0250000
NODE_139_length_5681_cov_68.065030	4762	4842	228	2	80	0.0250000
NODE_139_length_5681_cov_68.065030	4762	4842	229	1	80	0.0125000
NODE_139_length_5681_cov_68.065030	4762	4842	230	7	80	0.0875000
NODE_139_length_5681_cov_68.065030	4762	4842	232	1	80	0.0125000
NODE_139_length_5681_cov_68.065030	4762	4842	234	4	80	0.0500000
NODE_139_length_5681_cov_68.065030	4762	4842	236	15	80	0.1875000
NODE_139_length_5681_cov_68.065030	4762	4842	237	1	80	0.0125000
NODE_139_length_5681_cov_68.065030	4762	4842	238	4	80	0.0500000
NODE_139_length_5681_cov_68.065030	4762	4842	239	1	80	0.0125000
NODE_139_length_5681_cov_68.065030	4762	4842	240	4	80	0.0500000
NODE_139_length_5681_cov_68.065030	4762	4842	241	4	80	0.0500000
NODE_139_length_5681_cov_68.065030	4762	4842	242	1	80	0.0125000
NODE_139_length_5681_cov_68.065030	4762	4842	243	4	80	0.0500000
NODE_139_length_5681_cov_68.065030	4762	4842	244	3	80	0.0375000
NODE_139_length_5681_cov_68.065030	4762	4842	245	3	80	0.0375000
NODE_139_length_5681_cov_68.065030	4762	4842	246	3	80	0.0375000
NODE_139_length_5681_cov_68.065030	4762	4842	247	1	80	0.0125000
NODE_139_length_5681_cov_68.065030	4762	4842	179	1	80	0.0125000
NODE_139_length_5681_cov_68.065030	4762	4842	180	2	80	0.0250000
NODE_139_length_5681_cov_68.065030	4762	4842	185	1	80	0.0125000
NODE_139_length_5681_cov_68.065030	4762	4842	186	2	80	0.0250000
NODE_139_length_5681_cov_68.065030	4762	4842	192	2	80	0.0250000
NODE_139_length_5681_cov_68.065030	4762	4842	193	1	80	0.0125000
NODE_139_length_5681_cov_68.065030	4762	4842	198	3	80	0.0375000
NODE_139_length_5681_cov_68.065030	4762	4842	200	1	80	0.0125000
NODE_139_length_5681_cov_68.065030	4762	4842	201	1	80	0.0125000
NODE_139_length_5681_cov_68.065030	4762	4842	204	2	80	0.0250000
NODE_139_length_5681_cov_68.065030	4762	4842	206	1	80	0.0125000
NODE_139_length_5681_cov_68.065030	4762	4842	215	1	80	0.0125000
NODE_139_length_5681_cov_68.065030	4762	4842	216	1	80	0.0125000
NODE_139_length_5681_cov_68.065030	4762	4842	226	2	80	0.0250000
NODE_139_length_5681_cov_68.065030	4762	4842	228	2	80	0.0250000
NODE_139_length_5681_cov_68.065030	4762	4842	229	1	80	0.0125000
NODE_139_length_5681_cov_68.065030	4762	4842	230	7	80	0.0875000
NODE_139_length_5681_cov_68.065030	4762	4842	232	1	80	0.0125000
NODE_139_length_5681_cov_68.065030	4762	4842	234	4	80	0.0500000
NODE_139_length_5681_cov_68.065030	4762	4842	236	15	80	0.1875000
NODE_139_length_5681_cov_68.065030	4762	4842	237	1	80	0.0125000
NODE_139_length_5681_cov_68.065030	4762	4842	238	4	80	0.0500000
NODE_139_length_5681_cov_68.065030	4762	4842	239	1	80	0.0125000
NODE_139_length_5681_cov_68.065030	4762	4842	240	4	80	0.0500000
NODE_139_length_5681_cov_68.065030	4762	4842	241	4	80	0.0500000
NODE_139_length_5681_cov_68.065030	4762	4842	242	1	80	0.0125000
NODE_139_length_5681_cov_68.065030	4762	4842	243	4	80	0.0500000
NODE_139_length_5681_cov_68.065030	4762	4842	244	3	80	0.0375000
NODE_139_length_5681_cov_68.065030	4762	4842	245	3	80	0.0375000
NODE_139_length_5681_cov_68.065030	4762	4842	246	3	80	0.0375000
NODE_139_length_5681_cov_68.065030	4762	4842	247	1	80	0.0125000
NODE_139_length_5681_cov_68.065030	4762	4842	179	1	80	0.0125000
NODE_139_length_5681_cov_68.065030	4762	4842	180	2	80	0.0250000
NODE_139_length_5681_cov_68.065030	4762	4842	185	1	80	0.0125000
NODE_139_length_5681_cov_68.065030	4762	4842	186	2	80	0.0250000
NODE_139_length_5681_cov_68.065030	4762	4842	192	2	80	0.0250000
NODE_139_length_5681_cov_68.065030	4762	4842	193	1	80	0.0125000
NODE_139_length_5681_cov_68.065030	4762	4842	198	3	80	0.0375000
NODE_139_length_5681_cov_68.065030	4762	4842	200	1	80	0.0125000
NODE_139_length_5681_cov_68.065030	4762	4842	201	1	80	0.0125000
NODE_139_length_5681_cov_68.065030	4762	4842	204	2	80	0.0250000
NODE_139_length_5681_cov_68.065030	4762	4842	206	1	80	0.0125000
NODE_139_length_5681_cov_68.065030	4762	4842	215	1	80	0.0125000
NODE_139_length_5681_cov_68.065030	4762	4842	216	1	80	0.0125000
NODE_139_length_5681_cov_68.065030	4762	4842	226	2	80	0.0250000
NODE_139_length_5681_cov_68.065030	4762	4842	228	2	80	0.0250000
NODE_139_length_5681_cov_68.065030	4762	4842	229	1	80	0.0125000
NODE_139_length_5681_cov_68.065030	4762	4842	230	7	80	0.0875000
NODE_139_length_5681_cov_68.065030	4762	4842	232	1	80	0.0125000
NODE_139_length_5681_cov_68.065030	4762	4842	234	4	80	0.0500000
NODE_139_length_5681_cov_68.065030	4762	4842	236	15	80	0.1875000
NODE_139_length_5681_cov_68.065030	4762	4842	237	1	80	0.0125000
NODE_139_length_5681_cov_68.065030	4762	4842	238	4	80	0.0500000
NODE_139_length_5681_cov_68.065030	4762	4842	239	1	80	0.0125000
NODE_139_length_5681_cov_68.065030	4762	4842	240	4	80	0.0500000
NODE_139_length_5681_cov_68.065030	4762	4842	241	4	80	0.0500000
NODE_139_length_5681_cov_68.065030	4762	4842	242	1	80	0.0125000
NODE_139_length_5681_cov_68.065030	4762	4842	243	4	80	0.0500000
NODE_139_length_5681_cov_68.065030	4762	4842	244	3	80	0.0375000
NODE_139_length_5681_cov_68.065030	4762	4842	245	3	80	0.0375000
NODE_139_length_5681_cov_68.065030	4762	4842	246	3	80	0.0375000
NODE_139_length_5681_cov_68.065030	4762	4842	247	1	80	0.0125000
NODE_139_length_5681_cov_68.065030	4762	4842	179	1	80	0.0125000
NODE_139_length_5681_cov_68.065030	4762	4842	180	2	80	0.0250000
NODE_139_length_5681_cov_68.065030	4762	4842	185	1	80	0.0125000
NODE_139_length_5681_cov_68.065030	4762	4842	186	2	80	0.0250000
NODE_139_length_5681_cov_68.065030	4762	4842	192	2	80	0.0250000
NODE_139_length_5681_cov_68.065030	4762	4842	193	1	80	0.0125000
NODE_139_length_5681_cov_68.065030	4762	4842	198	3	80	0.0375000
NODE_139_length_5681_cov_68.065030	4762	4842	200	1	80	0.0125000
NODE_139_length_5681_cov_68.065030	4762	4842	201	1	80	0.0125000
NODE_139_length_5681_cov_68.065030	4762	4842	204	2	80	0.0250000
NODE_139_length_5681_cov_68.065030	4762	4842	206	1	80	0.0125000
NODE_139_length_5681_cov_68.065030	4762	4842	215	1	80	0.0125000
NODE_139_length_5681_cov_68.065030	4762	4842	216	1	80	0.0125000
NODE_139_length_5681_cov_68.065030	4762	4842	226	2	80	0.0250000
NODE_139_length_5681_cov_68.065030	4762	4842	228	2	80	0.0250000
NODE_139_length_5681_cov_68.065030	4762	4842	229	1	80	0.0125000
NODE_139_length_5681_cov_68.065030	4762	4842	230	7	80	0.0875000
NODE_139_length_5681_cov_68.065030	4762	4842	232	1	80	0.0125000
NODE_139_length_5681_cov_68.065030	4762	4842	234	4	80	0.0500000
NODE_139_length_5681_cov_68.065030	4762	4842	236	15	80	0.1875000
NODE_139_length_5681_cov_68.065030	4762	4842	237	1	80	0.0125000
NODE_139_length_5681_cov_68.065030	4762	4842	238	4	80	0.0500000
NODE_139_length_5681_cov_68.065030	4762	4842	239	1	80	0.0125000
NODE_139_length_5681_cov_68.065030	4762	4842	240	4	80	0.0500000
NODE_139_length_5681_cov_68.065030	4762	4842	241	4	80	0.0500000
NODE_139_length_5681_cov_68.065030	4762	4842	242	1	80	0.0125000
NODE_139_length_5681_cov_68.065030	4762	4842	243	4	80	0.0500000
NODE_139_length_5681_cov_68.065030	4762	4842	244	3	80	0.0375000
NODE_139_length_5681_cov_68.065030	4762	4842	245	3	80	0.0375000
NODE_139_length_5681_cov_68.065030	4762	4842	246	3	80	0.0375000
NODE_139_length_5681_cov_68.065030	4762	4842	247	1	80	0.0125000
NODE_139_length_5681_cov_68.065030	4762	4842	179	1	80	0.0125000
NODE_139_length_5681_cov_68.065030	4762	4842	180	2	80	0.0250000
NODE_139_length_5681_cov_68.065030	4762	4842	185	1	80	0.0125000
NODE_139_length_5681_cov_68.065030	4762	4842	186	2	80	0.0250000
NODE_139_length_5681_cov_68.065030	4762	4842	192	2	80	0.0250000
NODE_139_length_5681_cov_68.065030	4762	4842	193	1	80	0.0125000
NODE_139_length_5681_cov_68.065030	4762	4842	198	3	80	0.0375000
NODE_139_length_5681_cov_68.065030	4762	4842	200	1	80	0.0125000
NODE_139_length_5681_cov_68.065030	4762	4842	201	1	80	0.0125000
NODE_139_length_5681_cov_68.065030	4762	4842	204	2	80	0.0250000
NODE_139_length_5681_cov_68.065030	4762	4842	206	1	80	0.0125000
NODE_139_length_5681_cov_68.065030	4762	4842	215	1	80	0.0125000
NODE_139_length_5681_cov_68.065030	4762	4842	216	1	80	0.0125000
NODE_139_length_5681_cov_68.065030	4762	4842	226	2	80	0.0250000
NODE_139_length_5681_cov_68.065030	4762	4842	228	2	80	0.0250000
NODE_139_length_5681_cov_68.065030	4762	4842	229	1	80	0.0125000
NODE_139_length_5681_cov_68.065030	4762	4842	230	7	80	0.0875000
NODE_139_length_5681_cov_68.065030	4762	4842	232	1	80	0.0125000
NODE_139_length_5681_cov_68.065030	4762	4842	234	4	80	0.0500000
NODE_139_length_5681_cov_68.065030	4762	4842	236	15	80	0.1875000
NODE_139_length_5681_cov_68.065030	4762	4842	237	1	80	0.0125000
NODE_139_length_5681_cov_68.065030	4762	4842	238	4	80	0.0500000
NODE_139_length_5681_cov_68.065030	4762	4842	239	1	80	0.0125000
NODE_139_length_5681_cov_68.065030	4762	4842	240	4	80	0.0500000
NODE_139_length_5681_cov_68.065030	4762	4842	241	4	80	0.0500000
NODE_139_length_5681_cov_68.065030	4762	4842	242	1	80	0.0125000
NODE_139_length_5681_cov_68.065030	4762	4842	243	4	80	0.0500000
NODE_139_length_5681_cov_68.065030	4762	4842	244	3	80	0.0375000
NODE_139_length_5681_cov_68.065030	4762	4842	245	3	80	0.0375000
NODE_139_length_5681_cov_68.065030	4762	4842	246	3	80	0.0375000
NODE_139_length_5681_cov_68.065030	4762	4842	247	1	80	0.0125000
NODE_139_length_5681_cov_68.065030	4762	4842	179	1	80	0.0125000
NODE_139_length_5681_cov_68.065030	4762	4842	180	2	80	0.0250000
NODE_139_length_5681_cov_68.065030	4762	4842	185	1	80	0.0125000
NODE_139_length_5681_cov_68.065030	4762	4842	186	2	80	0.0250000
NODE_139_length_5681_cov_68.065030	4762	4842	192	2	80	0.0250000
NODE_139_length_5681_cov_68.065030	4762	4842	193	1	80	0.0125000
NODE_139_length_5681_cov_68.065030	4762	4842	198	3	80	0.0375000
NODE_139_length_5681_cov_68.065030	4762	4842	200	1	80	0.0125000
NODE_139_length_5681_cov_68.065030	4762	4842	201	1	80	0.0125000
NODE_139_length_5681_cov_68.065030	4762	4842	204	2	80	0.0250000
NODE_139_length_5681_cov_68.065030	4762	4842	206	1	80	0.0125000
NODE_139_length_5681_cov_68.065030	4762	4842	215	1	80	0.0125000
NODE_139_length_5681_cov_68.065030	4762	4842	216	1	80	0.0125000
NODE_139_length_5681_cov_68.065030	4762	4842	226	2	80	0.0250000
NODE_139_length_5681_cov_68.065030	4762	4842	228	2	80	0.0250000
NODE_139_length_5681_cov_68.065030	4762	4842	229	1	80	0.0125000
NODE_139_length_5681_cov_68.065030	4762	4842	230	7	80	0.0875000
NODE_139_length_5681_cov_68.065030	4762	4842	232	1	80	0.0125000
NODE_139_length_5681_cov_68.065030	4762	4842	234	4	80	0.0500000
NODE_139_length_5681_cov_68.065030	4762	4842	236	15	80	0.1875000
NODE_139_length_5681_cov_68.065030	4762	4842	237	1	80	0.0125000
NODE_139_length_5681_cov_68.065030	4762	4842	238	4	80	0.0500000
NODE_139_length_5681_cov_68.065030	4762	4842	239	1	80	0.0125000
NODE_139_length_5681_cov_68.065030	4762	4842	240	4	80	0.0500000
NODE_139_length_5681_cov_68.065030	4762	4842	241	4	80	0.0500000
NODE_139_length_5681_cov_68.065030	4762	4842	242	1	80	0.0125000
NODE_139_length_5681_cov_68.065030	4762	4842	243	4	80	0.0500000
NODE_139_length_5681_cov_68.065030	4762	4842	244	3	80	0.0375000
NODE_139_length_5681_cov_68.065030	4762	4842	245	3	80	0.0375000
NODE_139_length_5681_cov_68.065030	4762	4842	246	3	80	0.0375000
NODE_139_length_5681_cov_68.065030	4762	4842	247	1	80	0.0125000
NODE_139_length_5681_cov_68.065030	4769	4839	185	1	70	0.0142857
NODE_139_length_5681_cov_68.065030	4769	4839	186	2	70	0.0285714
NODE_139_length_5681_cov_68.065030	4769	4839	192	2	70	0.0285714
NODE_139_length_5681_cov_68.065030	4769	4839	193	1	70	0.0142857
NODE_139_length_5681_cov_68.065030	4769	4839	198	3	70	0.0428571
NODE_139_length_5681_cov_68.065030	4769	4839	200	1	70	0.0142857
NODE_139_length_5681_cov_68.065030	4769	4839	201	1	70	0.0142857
NODE_139_length_5681_cov_68.065030	4769	4839	204	2	70	0.0285714
NODE_139_length_5681_cov_68.065030	4769	4839	206	1	70	0.0142857
NODE_139_length_5681_cov_68.065030	4769	4839	215	1	70	0.0142857
NODE_139_length_5681_cov_68.065030	4769	4839	216	1	70	0.0142857
NODE_139_length_5681_cov_68.065030	4769	4839	226	2	70	0.0285714
NODE_139_length_5681_cov_68.065030	4769	4839	228	2	70	0.0285714
NODE_139_length_5681_cov_68.065030	4769	4839	229	1	70	0.0142857
NODE_139_length_5681_cov_68.065030	4769	4839	232	1	70	0.0142857
NODE_139_length_5681_cov_68.065030	4769	4839	234	4	70	0.0571429
NODE_139_length_5681_cov_68.065030	4769	4839	236	15	70	0.2142857
NODE_139_length_5681_cov_68.065030	4769	4839	237	1	70	0.0142857
NODE_139_length_5681_cov_68.065030	4769	4839	238	4	70	0.0571429
NODE_139_length_5681_cov_68.065030	4769	4839	239	1	70	0.0142857
NODE_139_length_5681_cov_68.065030	4769	4839	240	4	70	0.0571429
NODE_139_length_5681_cov_68.065030	4769	4839	241	4	70	0.0571429
NODE_139_length_5681_cov_68.065030	4769	4839	242	1	70	0.0142857
NODE_139_length_5681_cov_68.065030	4769	4839	243	4	70	0.0571429
NODE_139_length_5681_cov_68.065030	4769	4839	244	3	70	0.0428571
NODE_139_length_5681_cov_68.065030	4769	4839	245	3	70	0.0428571
NODE_139_length_5681_cov_68.065030	4769	4839	246	3	70	0.0428571
NODE_139_length_5681_cov_68.065030	4769	4839	247	1	70	0.0142857
NODE_139_length_5681_cov_68.065030	4771	4842	179	1	71	0.0140845
NODE_139_length_5681_cov_68.065030	4771	4842	180	2	71	0.0281690
NODE_139_length_5681_cov_68.065030	4771	4842	185	1	71	0.0140845
NODE_139_length_5681_cov_68.065030	4771	4842	186	2	71	0.0281690
NODE_139_length_5681_cov_68.065030	4771	4842	192	2	71	0.0281690
NODE_139_length_5681_cov_68.065030	4771	4842	193	1	71	0.0140845
NODE_139_length_5681_cov_68.065030	4771	4842	198	3	71	0.0422535
NODE_139_length_5681_cov_68.065030	4771	4842	200	1	71	0.0140845
NODE_139_length_5681_cov_68.065030	4771	4842	201	1	71	0.0140845
NODE_139_length_5681_cov_68.065030	4771	4842	204	2	71	0.0281690
NODE_139_length_5681_cov_68.065030	4771	4842	206	1	71	0.0140845
NODE_139_length_5681_cov_68.065030	4771	4842	215	1	71	0.0140845
NODE_139_length_5681_cov_68.065030	4771	4842	216	1	71	0.0140845
NODE_139_length_5681_cov_68.065030	4771	4842	226	2	71	0.0281690
NODE_139_length_5681_cov_68.065030	4771	4842	228	1	71	0.0140845
NODE_139_length_5681_cov_68.065030	4771	4842	232	1	71	0.0140845
NODE_139_length_5681_cov_68.065030	4771	4842	234	4	71	0.0563380
NODE_139_length_5681_cov_68.065030	4771	4842	236	15	71	0.2112676
NODE_139_length_5681_cov_68.065030	4771	4842	237	1	71	0.0140845
NODE_139_length_5681_cov_68.065030	4771	4842	238	4	71	0.0563380
NODE_139_length_5681_cov_68.065030	4771	4842	239	1	71	0.0140845
NODE_139_length_5681_cov_68.065030	4771	4842	240	4	71	0.0563380
NODE_139_length_5681_cov_68.065030	4771	4842	241	4	71	0.0563380
NODE_139_length_5681_cov_68.065030	4771	4842	242	1	71	0.0140845
NODE_139_length_5681_cov_68.065030	4771	4842	243	4	71	0.0563380
NODE_139_length_5681_cov_68.065030	4771	4842	244	3	71	0.0422535
NODE_139_length_5681_cov_68.065030	4771	4842	245	3	71	0.0422535
NODE_139_length_5681_cov_68.065030	4771	4842	246	3	71	0.0422535
NODE_139_length_5681_cov_68.065030	4771	4842	247	1	71	0.0140845
NODE_139_length_5681_cov_68.065030	4815	4895	119	3	80	0.0375000
NODE_139_length_5681_cov_68.065030	4815	4895	120	3	80	0.0375000
NODE_139_length_5681_cov_68.065030	4815	4895	121	2	80	0.0250000
NODE_139_length_5681_cov_68.065030	4815	4895	122	7	80	0.0875000
NODE_139_length_5681_cov_68.065030	4815	4895	124	2	80	0.0250000
NODE_139_length_5681_cov_68.065030	4815	4895	135	2	80	0.0250000
NODE_139_length_5681_cov_68.065030	4815	4895	157	1	80	0.0125000
NODE_139_length_5681_cov_68.065030	4815	4895	160	2	80	0.0250000
NODE_139_length_5681_cov_68.065030	4815	4895	171	2	80	0.0250000
NODE_139_length_5681_cov_68.065030	4815	4895	172	4	80	0.0500000
NODE_139_length_5681_cov_68.065030	4815	4895	174	6	80	0.0750000
NODE_139_length_5681_cov_68.065030	4815	4895	175	6	80	0.0750000
NODE_139_length_5681_cov_68.065030	4815	4895	179	3	80	0.0375000
NODE_139_length_5681_cov_68.065030	4815	4895	180	4	80	0.0500000
NODE_139_length_5681_cov_68.065030	4815	4895	181	1	80	0.0125000
NODE_139_length_5681_cov_68.065030	4815	4895	182	3	80	0.0375000
NODE_139_length_5681_cov_68.065030	4815	4895	183	2	80	0.0250000
NODE_139_length_5681_cov_68.065030	4815	4895	184	2	80	0.0250000
NODE_139_length_5681_cov_68.065030	4815	4895	185	2	80	0.0250000
NODE_139_length_5681_cov_68.065030	4815	4895	186	2	80	0.0250000
NODE_139_length_5681_cov_68.065030	4815	4895	192	2	80	0.0250000
NODE_139_length_5681_cov_68.065030	4815	4895	193	1	80	0.0125000
NODE_139_length_5681_cov_68.065030	4815	4895	198	3	80	0.0375000
NODE_139_length_5681_cov_68.065030	4815	4895	200	1	80	0.0125000
NODE_139_length_5681_cov_68.065030	4815	4895	201	1	80	0.0125000
NODE_139_length_5681_cov_68.065030	4815	4895	204	2	80	0.0250000
NODE_139_length_5681_cov_68.065030	4815	4895	206	1	80	0.0125000
NODE_139_length_5681_cov_68.065030	4815	4895	215	1	80	0.0125000
NODE_139_length_5681_cov_68.065030	4815	4895	216	1	80	0.0125000
NODE_139_length_5681_cov_68.065030	4815	4895	226	2	80	0.0250000
NODE_139_length_5681_cov_68.065030	4815	4895	232	1	80	0.0125000
NODE_139_length_5681_cov_68.065030	4815	4895	234	3	80	0.0375000
NODE_139_length_5681_cov_68.065030	4815	4895	239	1	80	0.0125000
NODE_139_length_5681_cov_68.065030	4815	4895	244	1	80	0.0125000
NODE_139_length_5681_cov_68.065030	4815	4895	119	3	80	0.0375000
NODE_139_length_5681_cov_68.065030	4815	4895	120	3	80	0.0375000
NODE_139_length_5681_cov_68.065030	4815	4895	121	2	80	0.0250000
NODE_139_length_5681_cov_68.065030	4815	4895	122	7	80	0.0875000
NODE_139_length_5681_cov_68.065030	4815	4895	124	2	80	0.0250000
NODE_139_length_5681_cov_68.065030	4815	4895	135	2	80	0.0250000
NODE_139_length_5681_cov_68.065030	4815	4895	157	1	80	0.0125000
NODE_139_length_5681_cov_68.065030	4815	4895	160	2	80	0.0250000
NODE_139_length_5681_cov_68.065030	4815	4895	171	2	80	0.0250000
NODE_139_length_5681_cov_68.065030	4815	4895	172	4	80	0.0500000
NODE_139_length_5681_cov_68.065030	4815	4895	174	6	80	0.0750000
NODE_139_length_5681_cov_68.065030	4815	4895	175	6	80	0.0750000
NODE_139_length_5681_cov_68.065030	4815	4895	179	3	80	0.0375000
NODE_139_length_5681_cov_68.065030	4815	4895	180	4	80	0.0500000
NODE_139_length_5681_cov_68.065030	4815	4895	181	1	80	0.0125000
NODE_139_length_5681_cov_68.065030	4815	4895	182	3	80	0.0375000
NODE_139_length_5681_cov_68.065030	4815	4895	183	2	80	0.0250000
NODE_139_length_5681_cov_68.065030	4815	4895	184	2	80	0.0250000
NODE_139_length_5681_cov_68.065030	4815	4895	185	2	80	0.0250000
NODE_139_length_5681_cov_68.065030	4815	4895	186	2	80	0.0250000
NODE_139_length_5681_cov_68.065030	4815	4895	192	2	80	0.0250000
NODE_139_length_5681_cov_68.065030	4815	4895	193	1	80	0.0125000
NODE_139_length_5681_cov_68.065030	4815	4895	198	3	80	0.0375000
NODE_139_length_5681_cov_68.065030	4815	4895	200	1	80	0.0125000
NODE_139_length_5681_cov_68.065030	4815	4895	201	1	80	0.0125000
NODE_139_length_5681_cov_68.065030	4815	4895	204	2	80	0.0250000
NODE_139_length_5681_cov_68.065030	4815	4895	206	1	80	0.0125000
NODE_139_length_5681_cov_68.065030	4815	4895	215	1	80	0.0125000
NODE_139_length_5681_cov_68.065030	4815	4895	216	1	80	0.0125000
NODE_139_length_5681_cov_68.065030	4815	4895	226	2	80	0.0250000
NODE_139_length_5681_cov_68.065030	4815	4895	232	1	80	0.0125000
NODE_139_length_5681_cov_68.065030	4815	4895	234	3	80	0.0375000
NODE_139_length_5681_cov_68.065030	4815	4895	239	1	80	0.0125000
NODE_139_length_5681_cov_68.065030	4815	4895	244	1	80	0.0125000
NODE_139_length_5681_cov_68.065030	4815	4895	119	3	80	0.0375000
NODE_139_length_5681_cov_68.065030	4815	4895	120	3	80	0.0375000
NODE_139_length_5681_cov_68.065030	4815	4895	121	2	80	0.0250000
NODE_139_length_5681_cov_68.065030	4815	4895	122	7	80	0.0875000
NODE_139_length_5681_cov_68.065030	4815	4895	124	2	80	0.0250000
NODE_139_length_5681_cov_68.065030	4815	4895	135	2	80	0.0250000
NODE_139_length_5681_cov_68.065030	4815	4895	157	1	80	0.0125000
NODE_139_length_5681_cov_68.065030	4815	4895	160	2	80	0.0250000
NODE_139_length_5681_cov_68.065030	4815	4895	171	2	80	0.0250000
NODE_139_length_5681_cov_68.065030	4815	4895	172	4	80	0.0500000
NODE_139_length_5681_cov_68.065030	4815	4895	174	6	80	0.0750000
NODE_139_length_5681_cov_68.065030	4815	4895	175	6	80	0.0750000
NODE_139_length_5681_cov_68.065030	4815	4895	179	3	80	0.0375000
NODE_139_length_5681_cov_68.065030	4815	4895	180	4	80	0.0500000
NODE_139_length_5681_cov_68.065030	4815	4895	181	1	80	0.0125000
NODE_139_length_5681_cov_68.065030	4815	4895	182	3	80	0.0375000
NODE_139_length_5681_cov_68.065030	4815	4895	183	2	80	0.0250000
NODE_139_length_5681_cov_68.065030	4815	4895	184	2	80	0.0250000
NODE_139_length_5681_cov_68.065030	4815	4895	185	2	80	0.0250000
NODE_139_length_5681_cov_68.065030	4815	4895	186	2	80	0.0250000
NODE_139_length_5681_cov_68.065030	4815	4895	192	2	80	0.0250000
NODE_139_length_5681_cov_68.065030	4815	4895	193	1	80	0.0125000
NODE_139_length_5681_cov_68.065030	4815	4895	198	3	80	0.0375000
NODE_139_length_5681_cov_68.065030	4815	4895	200	1	80	0.0125000
NODE_139_length_5681_cov_68.065030	4815	4895	201	1	80	0.0125000
NODE_139_length_5681_cov_68.065030	4815	4895	204	2	80	0.0250000
NODE_139_length_5681_cov_68.065030	4815	4895	206	1	80	0.0125000
NODE_139_length_5681_cov_68.065030	4815	4895	215	1	80	0.0125000
NODE_139_length_5681_cov_68.065030	4815	4895	216	1	80	0.0125000
NODE_139_length_5681_cov_68.065030	4815	4895	226	2	80	0.0250000
NODE_139_length_5681_cov_68.065030	4815	4895	232	1	80	0.0125000
NODE_139_length_5681_cov_68.065030	4815	4895	234	3	80	0.0375000
NODE_139_length_5681_cov_68.065030	4815	4895	239	1	80	0.0125000
NODE_139_length_5681_cov_68.065030	4815	4895	244	1	80	0.0125000
NODE_139_length_5681_cov_68.065030	4815	4895	119	3	80	0.0375000
NODE_139_length_5681_cov_68.065030	4815	4895	120	3	80	0.0375000
NODE_139_length_5681_cov_68.065030	4815	4895	121	2	80	0.0250000
NODE_139_length_5681_cov_68.065030	4815	4895	122	7	80	0.0875000
NODE_139_length_5681_cov_68.065030	4815	4895	124	2	80	0.0250000
NODE_139_length_5681_cov_68.065030	4815	4895	135	2	80	0.0250000
NODE_139_length_5681_cov_68.065030	4815	4895	157	1	80	0.0125000
NODE_139_length_5681_cov_68.065030	4815	4895	160	2	80	0.0250000
NODE_139_length_5681_cov_68.065030	4815	4895	171	2	80	0.0250000
NODE_139_length_5681_cov_68.065030	4815	4895	172	4	80	0.0500000
NODE_139_length_5681_cov_68.065030	4815	4895	174	6	80	0.0750000
NODE_139_length_5681_cov_68.065030	4815	4895	175	6	80	0.0750000
NODE_139_length_5681_cov_68.065030	4815	4895	179	3	80	0.0375000
NODE_139_length_5681_cov_68.065030	4815	4895	180	4	80	0.0500000
NODE_139_length_5681_cov_68.065030	4815	4895	181	1	80	0.0125000
NODE_139_length_5681_cov_68.065030	4815	4895	182	3	80	0.0375000
NODE_139_length_5681_cov_68.065030	4815	4895	183	2	80	0.0250000
NODE_139_length_5681_cov_68.065030	4815	4895	184	2	80	0.0250000
NODE_139_length_5681_cov_68.065030	4815	4895	185	2	80	0.0250000
NODE_139_length_5681_cov_68.065030	4815	4895	186	2	80	0.0250000
NODE_139_length_5681_cov_68.065030	4815	4895	192	2	80	0.0250000
NODE_139_length_5681_cov_68.065030	4815	4895	193	1	80	0.0125000
NODE_139_length_5681_cov_68.065030	4815	4895	198	3	80	0.0375000
NODE_139_length_5681_cov_68.065030	4815	4895	200	1	80	0.0125000
NODE_139_length_5681_cov_68.065030	4815	4895	201	1	80	0.0125000
NODE_139_length_5681_cov_68.065030	4815	4895	204	2	80	0.0250000
NODE_139_length_5681_cov_68.065030	4815	4895	206	1	80	0.0125000
NODE_139_length_5681_cov_68.065030	4815	4895	215	1	80	0.0125000
NODE_139_length_5681_cov_68.065030	4815	4895	216	1	80	0.0125000
NODE_139_length_5681_cov_68.065030	4815	4895	226	2	80	0.0250000
NODE_139_length_5681_cov_68.065030	4815	4895	232	1	80	0.0125000
NODE_139_length_5681_cov_68.065030	4815	4895	234	3	80	0.0375000
NODE_139_length_5681_cov_68.065030	4815	4895	239	1	80	0.0125000
NODE_139_length_5681_cov_68.065030	4815	4895	244	1	80	0.0125000
NODE_139_length_5681_cov_68.065030	4815	4895	119	3	80	0.0375000
NODE_139_length_5681_cov_68.065030	4815	4895	120	3	80	0.0375000
NODE_139_length_5681_cov_68.065030	4815	4895	121	2	80	0.0250000
NODE_139_length_5681_cov_68.065030	4815	4895	122	7	80	0.0875000
NODE_139_length_5681_cov_68.065030	4815	4895	124	2	80	0.0250000
NODE_139_length_5681_cov_68.065030	4815	4895	135	2	80	0.0250000
NODE_139_length_5681_cov_68.065030	4815	4895	157	1	80	0.0125000
NODE_139_length_5681_cov_68.065030	4815	4895	160	2	80	0.0250000
NODE_139_length_5681_cov_68.065030	4815	4895	171	2	80	0.0250000
NODE_139_length_5681_cov_68.065030	4815	4895	172	4	80	0.0500000
NODE_139_length_5681_cov_68.065030	4815	4895	174	6	80	0.0750000
NODE_139_length_5681_cov_68.065030	4815	4895	175	6	80	0.0750000
NODE_139_length_5681_cov_68.065030	4815	4895	179	3	80	0.0375000
NODE_139_length_5681_cov_68.065030	4815	4895	180	4	80	0.0500000
NODE_139_length_5681_cov_68.065030	4815	4895	181	1	80	0.0125000
NODE_139_length_5681_cov_68.065030	4815	4895	182	3	80	0.0375000
NODE_139_length_5681_cov_68.065030	4815	4895	183	2	80	0.0250000
NODE_139_length_5681_cov_68.065030	4815	4895	184	2	80	0.0250000
NODE_139_length_5681_cov_68.065030	4815	4895	185	2	80	0.0250000
NODE_139_length_5681_cov_68.065030	4815	4895	186	2	80	0.0250000
NODE_139_length_5681_cov_68.065030	4815	4895	192	2	80	0.0250000
NODE_139_length_5681_cov_68.065030	4815	4895	193	1	80	0.0125000
NODE_139_length_5681_cov_68.065030	4815	4895	198	3	80	0.0375000
NODE_139_length_5681_cov_68.065030	4815	4895	200	1	80	0.0125000
NODE_139_length_5681_cov_68.065030	4815	4895	201	1	80	0.0125000
NODE_139_length_5681_cov_68.065030	4815	4895	204	2	80	0.0250000
NODE_139_length_5681_cov_68.065030	4815	4895	206	1	80	0.0125000
NODE_139_length_5681_cov_68.065030	4815	4895	215	1	80	0.0125000
NODE_139_length_5681_cov_68.065030	4815	4895	216	1	80	0.0125000
NODE_139_length_5681_cov_68.065030	4815	4895	226	2	80	0.0250000
NODE_139_length_5681_cov_68.065030	4815	4895	232	1	80	0.0125000
NODE_139_length_5681_cov_68.065030	4815	4895	234	3	80	0.0375000
NODE_139_length_5681_cov_68.065030	4815	4895	239	1	80	0.0125000
NODE_139_length_5681_cov_68.065030	4815	4895	244	1	80	0.0125000
NODE_139_length_5681_cov_68.065030	4815	4895	119	3	80	0.0375000
NODE_139_length_5681_cov_68.065030	4815	4895	120	3	80	0.0375000
NODE_139_length_5681_cov_68.065030	4815	4895	121	2	80	0.0250000
NODE_139_length_5681_cov_68.065030	4815	4895	122	7	80	0.0875000
NODE_139_length_5681_cov_68.065030	4815	4895	124	2	80	0.0250000
NODE_139_length_5681_cov_68.065030	4815	4895	135	2	80	0.0250000
NODE_139_length_5681_cov_68.065030	4815	4895	157	1	80	0.0125000
NODE_139_length_5681_cov_68.065030	4815	4895	160	2	80	0.0250000
NODE_139_length_5681_cov_68.065030	4815	4895	171	2	80	0.0250000
NODE_139_length_5681_cov_68.065030	4815	4895	172	4	80	0.0500000
NODE_139_length_5681_cov_68.065030	4815	4895	174	6	80	0.0750000
NODE_139_length_5681_cov_68.065030	4815	4895	175	6	80	0.0750000
NODE_139_length_5681_cov_68.065030	4815	4895	179	3	80	0.0375000
NODE_139_length_5681_cov_68.065030	4815	4895	180	4	80	0.0500000
NODE_139_length_5681_cov_68.065030	4815	4895	181	1	80	0.0125000
NODE_139_length_5681_cov_68.065030	4815	4895	182	3	80	0.0375000
NODE_139_length_5681_cov_68.065030	4815	4895	183	2	80	0.0250000
NODE_139_length_5681_cov_68.065030	4815	4895	184	2	80	0.0250000
NODE_139_length_5681_cov_68.065030	4815	4895	185	2	80	0.0250000
NODE_139_length_5681_cov_68.065030	4815	4895	186	2	80	0.0250000
NODE_139_length_5681_cov_68.065030	4815	4895	192	2	80	0.0250000
NODE_139_length_5681_cov_68.065030	4815	4895	193	1	80	0.0125000
NODE_139_length_5681_cov_68.065030	4815	4895	198	3	80	0.0375000
NODE_139_length_5681_cov_68.065030	4815	4895	200	1	80	0.0125000
NODE_139_length_5681_cov_68.065030	4815	4895	201	1	80	0.0125000
NODE_139_length_5681_cov_68.065030	4815	4895	204	2	80	0.0250000
NODE_139_length_5681_cov_68.065030	4815	4895	206	1	80	0.0125000
NODE_139_length_5681_cov_68.065030	4815	4895	215	1	80	0.0125000
NODE_139_length_5681_cov_68.065030	4815	4895	216	1	80	0.0125000
NODE_139_length_5681_cov_68.065030	4815	4895	226	2	80	0.0250000
NODE_139_length_5681_cov_68.065030	4815	4895	232	1	80	0.0125000
NODE_139_length_5681_cov_68.065030	4815	4895	234	3	80	0.0375000
NODE_139_length_5681_cov_68.065030	4815	4895	239	1	80	0.0125000
NODE_139_length_5681_cov_68.065030	4815	4895	244	1	80	0.0125000
NODE_139_length_5681_cov_68.065030	4891	4971	28	7	80	0.0875000
NODE_139_length_5681_cov_68.065030	4891	4971	42	5	80	0.0625000
NODE_139_length_5681_cov_68.065030	4891	4971	44	3	80	0.0375000
NODE_139_length_5681_cov_68.065030	4891	4971	48	26	80	0.3250000
NODE_139_length_5681_cov_68.065030	4891	4971	50	9	80	0.1125000
NODE_139_length_5681_cov_68.065030	4891	4971	56	2	80	0.0250000
NODE_139_length_5681_cov_68.065030	4891	4971	66	3	80	0.0375000
NODE_139_length_5681_cov_68.065030	4891	4971	71	1	80	0.0125000
NODE_139_length_5681_cov_68.065030	4891	4971	72	1	80	0.0125000
NODE_139_length_5681_cov_68.065030	4891	4971	82	4	80	0.0500000
NODE_139_length_5681_cov_68.065030	4891	4971	90	1	80	0.0125000
NODE_139_length_5681_cov_68.065030	4891	4971	97	3	80	0.0375000
NODE_139_length_5681_cov_68.065030	4891	4971	98	1	80	0.0125000
NODE_139_length_5681_cov_68.065030	4891	4971	99	3	80	0.0375000
NODE_139_length_5681_cov_68.065030	4891	4971	105	2	80	0.0250000
NODE_139_length_5681_cov_68.065030	4891	4971	121	6	80	0.0750000
NODE_139_length_5681_cov_68.065030	4891	4971	122	3	80	0.0375000
NODE_139_length_5681_cov_68.065030	4944	5007	12	15	63	0.2380952
NODE_139_length_5681_cov_68.065030	4944	5007	24	1	63	0.0158730
NODE_139_length_5681_cov_68.065030	4944	5007	26	12	63	0.1904762
NODE_139_length_5681_cov_68.065030	4944	5007	28	14	63	0.2222222
NODE_139_length_5681_cov_68.065030	4944	5007	30	1	63	0.0158730
NODE_139_length_5681_cov_68.065030	4944	5007	42	5	63	0.0793651
NODE_139_length_5681_cov_68.065030	4944	5007	44	3	63	0.0476190
NODE_139_length_5681_cov_68.065030	4944	5007	48	3	63	0.0476190
NODE_139_length_5681_cov_68.065030	4944	5007	50	9	63	0.1428571
NODE_139_length_5681_cov_68.065030	4944	5024	8	3	80	0.0375000
NODE_139_length_5681_cov_68.065030	4944	5024	10	10	80	0.1250000
NODE_139_length_5681_cov_68.065030	4944	5024	12	19	80	0.2375000
NODE_139_length_5681_cov_68.065030	4944	5024	24	1	80	0.0125000
NODE_139_length_5681_cov_68.065030	4944	5024	26	12	80	0.1500000
NODE_139_length_5681_cov_68.065030	4944	5024	28	14	80	0.1750000
NODE_139_length_5681_cov_68.065030	4944	5024	30	1	80	0.0125000
NODE_139_length_5681_cov_68.065030	4944	5024	42	5	80	0.0625000
NODE_139_length_5681_cov_68.065030	4944	5024	44	3	80	0.0375000
NODE_139_length_5681_cov_68.065030	4944	5024	48	3	80	0.0375000
NODE_139_length_5681_cov_68.065030	4944	5024	50	9	80	0.1125000
NODE_140_length_5677_cov_21.613482	1792	1863	80	2	71	0.0281690
NODE_140_length_5677_cov_21.613482	1792	1863	81	3	71	0.0422535
NODE_140_length_5677_cov_21.613482	1792	1863	83	2	71	0.0281690
NODE_140_length_5677_cov_21.613482	1792	1863	84	2	71	0.0281690
NODE_140_length_5677_cov_21.613482	1792	1863	86	2	71	0.0281690
NODE_140_length_5677_cov_21.613482	1792	1863	89	1	71	0.0140845
NODE_140_length_5677_cov_21.613482	1792	1863	91	2	71	0.0281690
NODE_140_length_5677_cov_21.613482	1792	1863	93	1	71	0.0140845
NODE_140_length_5677_cov_21.613482	1792	1863	101	1	71	0.0140845
NODE_140_length_5677_cov_21.613482	1792	1863	102	1	71	0.0140845
NODE_140_length_5677_cov_21.613482	1792	1863	105	1	71	0.0140845
NODE_140_length_5677_cov_21.613482	1792	1863	106	3	71	0.0422535
NODE_140_length_5677_cov_21.613482	1792	1863	107	2	71	0.0281690
NODE_140_length_5677_cov_21.613482	1792	1863	108	1	71	0.0140845
NODE_140_length_5677_cov_21.613482	1792	1863	109	4	71	0.0563380
NODE_140_length_5677_cov_21.613482	1792	1863	110	1	71	0.0140845
NODE_140_length_5677_cov_21.613482	1792	1863	112	11	71	0.1549296
NODE_140_length_5677_cov_21.613482	1792	1863	113	2	71	0.0281690
NODE_140_length_5677_cov_21.613482	1792	1863	114	6	71	0.0845070
NODE_140_length_5677_cov_21.613482	1792	1863	118	3	71	0.0422535
NODE_140_length_5677_cov_21.613482	1792	1863	123	1	71	0.0140845
NODE_140_length_5677_cov_21.613482	1792	1863	130	3	71	0.0422535
NODE_140_length_5677_cov_21.613482	1792	1863	132	7	71	0.0985916
NODE_140_length_5677_cov_21.613482	1792	1863	133	2	71	0.0281690
NODE_140_length_5677_cov_21.613482	1792	1863	134	4	71	0.0563380
NODE_140_length_5677_cov_21.613482	1792	1863	136	3	71	0.0422535
NODE_140_length_5677_cov_21.613482	1845	1916	94	9	71	0.1267606
NODE_140_length_5677_cov_21.613482	1845	1916	96	2	71	0.0281690
NODE_140_length_5677_cov_21.613482	1845	1916	100	1	71	0.0140845
NODE_140_length_5677_cov_21.613482	1845	1916	102	1	71	0.0140845
NODE_140_length_5677_cov_21.613482	1845	1916	106	1	71	0.0140845
NODE_140_length_5677_cov_21.613482	1845	1916	108	1	71	0.0140845
NODE_140_length_5677_cov_21.613482	1845	1916	112	1	71	0.0140845
NODE_140_length_5677_cov_21.613482	1845	1916	114	1	71	0.0140845
NODE_140_length_5677_cov_21.613482	1845	1916	121	1	71	0.0140845
NODE_140_length_5677_cov_21.613482	1845	1916	123	3	71	0.0422535
NODE_140_length_5677_cov_21.613482	1845	1916	124	2	71	0.0281690
NODE_140_length_5677_cov_21.613482	1845	1916	125	1	71	0.0140845
NODE_140_length_5677_cov_21.613482	1845	1916	126	6	71	0.0845070
NODE_140_length_5677_cov_21.613482	1845	1916	128	1	71	0.0140845
NODE_140_length_5677_cov_21.613482	1845	1916	129	2	71	0.0281690
NODE_140_length_5677_cov_21.613482	1845	1916	130	6	71	0.0845070
NODE_140_length_5677_cov_21.613482	1845	1916	131	5	71	0.0704225
NODE_140_length_5677_cov_21.613482	1845	1916	132	10	71	0.1408451
NODE_140_length_5677_cov_21.613482	1845	1916	133	5	71	0.0704225
NODE_140_length_5677_cov_21.613482	1845	1916	134	8	71	0.1126761
NODE_140_length_5677_cov_21.613482	1845	1916	136	4	71	0.0563380
NODE_142_length_5631_cov_25.927332	96	176	24	3	80	0.0375000
NODE_142_length_5631_cov_25.927332	96	176	25	7	80	0.0875000
NODE_142_length_5631_cov_25.927332	96	176	30	7	80	0.0875000
NODE_142_length_5631_cov_25.927332	96	176	32	3	80	0.0375000
NODE_142_length_5631_cov_25.927332	96	176	35	10	80	0.1250000
NODE_142_length_5631_cov_25.927332	96	176	36	1	80	0.0125000
NODE_142_length_5631_cov_25.927332	96	176	37	18	80	0.2250000
NODE_142_length_5631_cov_25.927332	96	176	39	23	80	0.2875000
NODE_142_length_5631_cov_25.927332	96	176	41	8	80	0.1000000
NODE_142_length_5631_cov_25.927332	149	229	6	38	80	0.4750000
NODE_142_length_5631_cov_25.927332	149	229	8	5	80	0.0625000
NODE_142_length_5631_cov_25.927332	149	229	12	3	80	0.0375000
NODE_142_length_5631_cov_25.927332	149	229	14	7	80	0.0875000
NODE_142_length_5631_cov_25.927332	149	229	24	3	80	0.0375000
NODE_142_length_5631_cov_25.927332	149	229	25	7	80	0.0875000
NODE_142_length_5631_cov_25.927332	149	229	30	7	80	0.0875000
NODE_142_length_5631_cov_25.927332	149	229	32	3	80	0.0375000
NODE_142_length_5631_cov_25.927332	149	229	35	2	80	0.0250000
NODE_142_length_5631_cov_25.927332	149	229	36	1	80	0.0125000
NODE_142_length_5631_cov_25.927332	149	229	37	4	80	0.0500000
NODE_146_length_5588_cov_40.961377	2793	2873	0	27	80	0.3375000
NODE_146_length_5588_cov_40.961377	2793	2873	2	52	80	0.6500000
NODE_146_length_5588_cov_40.961377	2793	2873	4	1	80	0.0125000
NODE_146_length_5588_cov_40.961377	2846	2926	2	26	80	0.3250000
NODE_146_length_5588_cov_40.961377	2846	2926	4	13	80	0.1625000
NODE_146_length_5588_cov_40.961377	2846	2926	12	14	80	0.1750000
NODE_146_length_5588_cov_40.961377	2846	2926	13	11	80	0.1375000
NODE_146_length_5588_cov_40.961377	2846	2926	14	16	80	0.2000000
NODE_146_length_5588_cov_40.961377	2922	3002	9	60	80	0.7500000
NODE_146_length_5588_cov_40.961377	2922	3002	11	1	80	0.0125000
NODE_146_length_5588_cov_40.961377	2922	3002	12	19	80	0.2375000
NODE_146_length_5588_cov_40.961377	2975	3055	0	3	80	0.0375000
NODE_146_length_5588_cov_40.961377	2975	3055	2	3	80	0.0375000
NODE_146_length_5588_cov_40.961377	2975	3055	4	17	80	0.2125000
NODE_146_length_5588_cov_40.961377	2975	3055	7	12	80	0.1500000
NODE_146_length_5588_cov_40.961377	2975	3055	9	45	80	0.5625000
NODE_149_length_5578_cov_5.173389	331	411	8	4	80	0.0500000
NODE_149_length_5578_cov_5.173389	331	411	9	10	80	0.1250000
NODE_149_length_5578_cov_5.173389	331	411	10	2	80	0.0250000
NODE_149_length_5578_cov_5.173389	331	411	11	2	80	0.0250000
NODE_149_length_5578_cov_5.173389	331	411	12	4	80	0.0500000
NODE_149_length_5578_cov_5.173389	331	411	13	27	80	0.3375000
NODE_149_length_5578_cov_5.173389	331	411	14	17	80	0.2125000
NODE_149_length_5578_cov_5.173389	331	411	15	8	80	0.1000000
NODE_149_length_5578_cov_5.173389	331	411	16	1	80	0.0125000
NODE_149_length_5578_cov_5.173389	331	411	17	5	80	0.0625000
NODE_149_length_5578_cov_5.173389	388	464	2	9	76	0.1184211
NODE_149_length_5578_cov_5.173389	388	464	4	18	76	0.2368421
NODE_149_length_5578_cov_5.173389	388	464	6	23	76	0.3026316
NODE_149_length_5578_cov_5.173389	388	464	8	7	76	0.0921053
NODE_149_length_5578_cov_5.173389	388	464	11	2	76	0.0263158
NODE_149_length_5578_cov_5.173389	388	464	13	17	76	0.2236842
NODE_150_length_5572_cov_79.124246	1555	1627	16	4	72	0.0555556
NODE_150_length_5572_cov_79.124246	1555	1627	17	1	72	0.0138889
NODE_150_length_5572_cov_79.124246	1555	1627	18	1	72	0.0138889
NODE_150_length_5572_cov_79.124246	1555	1627	22	5	72	0.0694444
NODE_150_length_5572_cov_79.124246	1555	1627	27	1	72	0.0138889
NODE_150_length_5572_cov_79.124246	1555	1627	29	3	72	0.0416667
NODE_150_length_5572_cov_79.124246	1555	1627	31	3	72	0.0416667
NODE_150_length_5572_cov_79.124246	1555	1627	33	1	72	0.0138889
NODE_150_length_5572_cov_79.124246	1555	1627	35	2	72	0.0277778
NODE_150_length_5572_cov_79.124246	1555	1627	36	1	72	0.0138889
NODE_150_length_5572_cov_79.124246	1555	1627	37	1	72	0.0138889
NODE_150_length_5572_cov_79.124246	1555	1627	39	3	72	0.0416667
NODE_150_length_5572_cov_79.124246	1555	1627	40	2	72	0.0277778
NODE_150_length_5572_cov_79.124246	1555	1627	45	1	72	0.0138889
NODE_150_length_5572_cov_79.124246	1555	1627	46	4	72	0.0555556
NODE_150_length_5572_cov_79.124246	1555	1627	49	3	72	0.0416667
NODE_150_length_5572_cov_79.124246	1555	1627	54	1	72	0.0138889
NODE_150_length_5572_cov_79.124246	1555	1627	58	1	72	0.0138889
NODE_150_length_5572_cov_79.124246	1555	1627	60	1	72	0.0138889
NODE_150_length_5572_cov_79.124246	1555	1627	72	2	72	0.0277778
NODE_150_length_5572_cov_79.124246	1555	1627	76	1	72	0.0138889
NODE_150_length_5572_cov_79.124246	1555	1627	79	1	72	0.0138889
NODE_150_length_5572_cov_79.124246	1555	1627	85	1	72	0.0138889
NODE_150_length_5572_cov_79.124246	1555	1627	91	1	72	0.0138889
NODE_150_length_5572_cov_79.124246	1555	1627	102	1	72	0.0138889
NODE_150_length_5572_cov_79.124246	1555	1627	104	1	72	0.0138889
NODE_150_length_5572_cov_79.124246	1555	1627	111	1	72	0.0138889
NODE_150_length_5572_cov_79.124246	1555	1627	112	2	72	0.0277778
NODE_150_length_5572_cov_79.124246	1555	1627	114	1	72	0.0138889
NODE_150_length_5572_cov_79.124246	1555	1627	120	1	72	0.0138889
NODE_150_length_5572_cov_79.124246	1555	1627	124	1	72	0.0138889
NODE_150_length_5572_cov_79.124246	1555	1627	131	1	72	0.0138889
NODE_150_length_5572_cov_79.124246	1555	1627	135	1	72	0.0138889
NODE_150_length_5572_cov_79.124246	1555	1627	138	2	72	0.0277778
NODE_150_length_5572_cov_79.124246	1555	1627	148	1	72	0.0138889
NODE_150_length_5572_cov_79.124246	1555	1627	163	2	72	0.0277778
NODE_150_length_5572_cov_79.124246	1555	1627	169	1	72	0.0138889
NODE_150_length_5572_cov_79.124246	1555	1627	172	2	72	0.0277778
NODE_150_length_5572_cov_79.124246	1555	1627	181	1	72	0.0138889
NODE_150_length_5572_cov_79.124246	1555	1627	182	1	72	0.0138889
NODE_150_length_5572_cov_79.124246	1555	1627	188	1	72	0.0138889
NODE_150_length_5572_cov_79.124246	1555	1627	189	1	72	0.0138889
NODE_150_length_5572_cov_79.124246	1555	1627	191	1	72	0.0138889
NODE_150_length_5572_cov_79.124246	1555	1627	199	1	72	0.0138889
NODE_150_length_5572_cov_79.124246	1555	1627	208	1	72	0.0138889
NODE_150_length_5572_cov_79.124246	1555	1627	213	1	72	0.0138889
NODE_150_length_5572_cov_79.124246	1555	1627	220	1	72	0.0138889
NODE_150_length_5572_cov_79.124246	1603	1680	112	2	77	0.0259740
NODE_150_length_5572_cov_79.124246	1603	1680	114	1	77	0.0129870
NODE_150_length_5572_cov_79.124246	1603	1680	120	1	77	0.0129870
NODE_150_length_5572_cov_79.124246	1603	1680	124	1	77	0.0129870
NODE_150_length_5572_cov_79.124246	1603	1680	131	1	77	0.0129870
NODE_150_length_5572_cov_79.124246	1603	1680	135	1	77	0.0129870
NODE_150_length_5572_cov_79.124246	1603	1680	138	2	77	0.0259740
NODE_150_length_5572_cov_79.124246	1603	1680	148	1	77	0.0129870
NODE_150_length_5572_cov_79.124246	1603	1680	163	2	77	0.0259740
NODE_150_length_5572_cov_79.124246	1603	1680	169	1	77	0.0129870
NODE_150_length_5572_cov_79.124246	1603	1680	172	2	77	0.0259740
NODE_150_length_5572_cov_79.124246	1603	1680	181	1	77	0.0129870
NODE_150_length_5572_cov_79.124246	1603	1680	182	1	77	0.0129870
NODE_150_length_5572_cov_79.124246	1603	1680	188	1	77	0.0129870
NODE_150_length_5572_cov_79.124246	1603	1680	189	1	77	0.0129870
NODE_150_length_5572_cov_79.124246	1603	1680	191	1	77	0.0129870
NODE_150_length_5572_cov_79.124246	1603	1680	199	1	77	0.0129870
NODE_150_length_5572_cov_79.124246	1603	1680	208	1	77	0.0129870
NODE_150_length_5572_cov_79.124246	1603	1680	213	1	77	0.0129870
NODE_150_length_5572_cov_79.124246	1603	1680	220	2	77	0.0259740
NODE_150_length_5572_cov_79.124246	1603	1680	222	1	77	0.0129870
NODE_150_length_5572_cov_79.124246	1603	1680	228	1	77	0.0129870
NODE_150_length_5572_cov_79.124246	1603	1680	236	1	77	0.0129870
NODE_150_length_5572_cov_79.124246	1603	1680	237	1	77	0.0129870
NODE_150_length_5572_cov_79.124246	1603	1680	244	1	77	0.0129870
NODE_150_length_5572_cov_79.124246	1603	1680	247	1	77	0.0129870
NODE_150_length_5572_cov_79.124246	1603	1680	250	1	77	0.0129870
NODE_150_length_5572_cov_79.124246	1603	1680	252	1	77	0.0129870
NODE_150_length_5572_cov_79.124246	1603	1680	254	1	77	0.0129870
NODE_150_length_5572_cov_79.124246	1603	1680	259	2	77	0.0259740
NODE_150_length_5572_cov_79.124246	1603	1680	271	1	77	0.0129870
NODE_150_length_5572_cov_79.124246	1603	1680	277	1	77	0.0129870
NODE_150_length_5572_cov_79.124246	1603	1680	289	1	77	0.0129870
NODE_150_length_5572_cov_79.124246	1603	1680	296	1	77	0.0129870
NODE_150_length_5572_cov_79.124246	1603	1680	303	1	77	0.0129870
NODE_150_length_5572_cov_79.124246	1603	1680	308	1	77	0.0129870
NODE_150_length_5572_cov_79.124246	1603	1680	338	1	77	0.0129870
NODE_150_length_5572_cov_79.124246	1603	1680	351	1	77	0.0129870
NODE_150_length_5572_cov_79.124246	1603	1680	379	1	77	0.0129870
NODE_150_length_5572_cov_79.124246	1603	1680	407	1	77	0.0129870
NODE_150_length_5572_cov_79.124246	1603	1680	419	1	77	0.0129870
NODE_150_length_5572_cov_79.124246	1603	1680	437	1	77	0.0129870
NODE_150_length_5572_cov_79.124246	1603	1680	445	1	77	0.0129870
NODE_150_length_5572_cov_79.124246	1603	1680	458	1	77	0.0129870
NODE_150_length_5572_cov_79.124246	1603	1680	469	1	77	0.0129870
NODE_150_length_5572_cov_79.124246	1603	1680	487	1	77	0.0129870
NODE_150_length_5572_cov_79.124246	1603	1680	506	1	77	0.0129870
NODE_150_length_5572_cov_79.124246	1603	1680	508	1	77	0.0129870
NODE_150_length_5572_cov_79.124246	1603	1680	515	1	77	0.0129870
NODE_150_length_5572_cov_79.124246	1603	1680	517	1	77	0.0129870
NODE_150_length_5572_cov_79.124246	1603	1680	523	1	77	0.0129870
NODE_150_length_5572_cov_79.124246	1603	1680	551	1	77	0.0129870
NODE_150_length_5572_cov_79.124246	1603	1680	553	1	77	0.0129870
NODE_150_length_5572_cov_79.124246	1603	1680	577	1	77	0.0129870
NODE_150_length_5572_cov_79.124246	1603	1680	589	1	77	0.0129870
NODE_150_length_5572_cov_79.124246	1603	1680	602	1	77	0.0129870
NODE_150_length_5572_cov_79.124246	1603	1680	609	1	77	0.0129870
NODE_150_length_5572_cov_79.124246	1603	1680	612	1	77	0.0129870
NODE_150_length_5572_cov_79.124246	1603	1680	621	1	77	0.0129870
NODE_150_length_5572_cov_79.124246	1603	1680	639	1	77	0.0129870
NODE_150_length_5572_cov_79.124246	1603	1680	640	1	77	0.0129870
NODE_150_length_5572_cov_79.124246	1603	1680	644	1	77	0.0129870
NODE_150_length_5572_cov_79.124246	1603	1680	650	1	77	0.0129870
NODE_150_length_5572_cov_79.124246	1603	1680	653	1	77	0.0129870
NODE_150_length_5572_cov_79.124246	1603	1680	658	1	77	0.0129870
NODE_150_length_5572_cov_79.124246	1603	1680	688	1	77	0.0129870
NODE_150_length_5572_cov_79.124246	1603	1680	716	1	77	0.0129870
NODE_150_length_5572_cov_79.124246	1603	1680	752	1	77	0.0129870
NODE_150_length_5572_cov_79.124246	1603	1680	787	1	77	0.0129870
NODE_150_length_5572_cov_79.124246	1603	1680	801	1	77	0.0129870
NODE_150_length_5572_cov_79.124246	1603	1680	813	1	77	0.0129870
NODE_150_length_5572_cov_79.124246	1637	1717	259	2	80	0.0250000
NODE_150_length_5572_cov_79.124246	1637	1717	271	1	80	0.0125000
NODE_150_length_5572_cov_79.124246	1637	1717	277	1	80	0.0125000
NODE_150_length_5572_cov_79.124246	1637	1717	289	1	80	0.0125000
NODE_150_length_5572_cov_79.124246	1637	1717	296	1	80	0.0125000
NODE_150_length_5572_cov_79.124246	1637	1717	303	1	80	0.0125000
NODE_150_length_5572_cov_79.124246	1637	1717	308	1	80	0.0125000
NODE_150_length_5572_cov_79.124246	1637	1717	338	1	80	0.0125000
NODE_150_length_5572_cov_79.124246	1637	1717	351	1	80	0.0125000
NODE_150_length_5572_cov_79.124246	1637	1717	379	1	80	0.0125000
NODE_150_length_5572_cov_79.124246	1637	1717	407	1	80	0.0125000
NODE_150_length_5572_cov_79.124246	1637	1717	419	1	80	0.0125000
NODE_150_length_5572_cov_79.124246	1637	1717	437	1	80	0.0125000
NODE_150_length_5572_cov_79.124246	1637	1717	445	1	80	0.0125000
NODE_150_length_5572_cov_79.124246	1637	1717	458	1	80	0.0125000
NODE_150_length_5572_cov_79.124246	1637	1717	469	1	80	0.0125000
NODE_150_length_5572_cov_79.124246	1637	1717	487	1	80	0.0125000
NODE_150_length_5572_cov_79.124246	1637	1717	506	1	80	0.0125000
NODE_150_length_5572_cov_79.124246	1637	1717	508	1	80	0.0125000
NODE_150_length_5572_cov_79.124246	1637	1717	515	1	80	0.0125000
NODE_150_length_5572_cov_79.124246	1637	1717	517	1	80	0.0125000
NODE_150_length_5572_cov_79.124246	1637	1717	523	1	80	0.0125000
NODE_150_length_5572_cov_79.124246	1637	1717	551	1	80	0.0125000
NODE_150_length_5572_cov_79.124246	1637	1717	553	1	80	0.0125000
NODE_150_length_5572_cov_79.124246	1637	1717	577	1	80	0.0125000
NODE_150_length_5572_cov_79.124246	1637	1717	589	1	80	0.0125000
NODE_150_length_5572_cov_79.124246	1637	1717	602	1	80	0.0125000
NODE_150_length_5572_cov_79.124246	1637	1717	609	1	80	0.0125000
NODE_150_length_5572_cov_79.124246	1637	1717	612	1	80	0.0125000
NODE_150_length_5572_cov_79.124246	1637	1717	621	1	80	0.0125000
NODE_150_length_5572_cov_79.124246	1637	1717	639	1	80	0.0125000
NODE_150_length_5572_cov_79.124246	1637	1717	640	1	80	0.0125000
NODE_150_length_5572_cov_79.124246	1637	1717	644	1	80	0.0125000
NODE_150_length_5572_cov_79.124246	1637	1717	650	1	80	0.0125000
NODE_150_length_5572_cov_79.124246	1637	1717	653	1	80	0.0125000
NODE_150_length_5572_cov_79.124246	1637	1717	658	1	80	0.0125000
NODE_150_length_5572_cov_79.124246	1637	1717	688	1	80	0.0125000
NODE_150_length_5572_cov_79.124246	1637	1717	716	1	80	0.0125000
NODE_150_length_5572_cov_79.124246	1637	1717	752	1	80	0.0125000
NODE_150_length_5572_cov_79.124246	1637	1717	787	1	80	0.0125000
NODE_150_length_5572_cov_79.124246	1637	1717	801	1	80	0.0125000
NODE_150_length_5572_cov_79.124246	1637	1717	813	1	80	0.0125000
NODE_150_length_5572_cov_79.124246	1637	1717	820	1	80	0.0125000
NODE_150_length_5572_cov_79.124246	1637	1717	829	1	80	0.0125000
NODE_150_length_5572_cov_79.124246	1637	1717	835	1	80	0.0125000
NODE_150_length_5572_cov_79.124246	1637	1717	850	1	80	0.0125000
NODE_150_length_5572_cov_79.124246	1637	1717	854	1	80	0.0125000
NODE_150_length_5572_cov_79.124246	1637	1717	860	2	80	0.0250000
NODE_150_length_5572_cov_79.124246	1637	1717	866	1	80	0.0125000
NODE_150_length_5572_cov_79.124246	1637	1717	876	1	80	0.0125000
NODE_150_length_5572_cov_79.124246	1637	1717	884	1	80	0.0125000
NODE_150_length_5572_cov_79.124246	1637	1717	892	1	80	0.0125000
NODE_150_length_5572_cov_79.124246	1637	1717	897	1	80	0.0125000
NODE_150_length_5572_cov_79.124246	1637	1717	903	1	80	0.0125000
NODE_150_length_5572_cov_79.124246	1637	1717	906	1	80	0.0125000
NODE_150_length_5572_cov_79.124246	1637	1717	922	1	80	0.0125000
NODE_150_length_5572_cov_79.124246	1637	1717	936	1	80	0.0125000
NODE_150_length_5572_cov_79.124246	1637	1717	941	1	80	0.0125000
NODE_150_length_5572_cov_79.124246	1637	1717	956	2	80	0.0250000
NODE_150_length_5572_cov_79.124246	1637	1717	957	2	80	0.0250000
NODE_150_length_5572_cov_79.124246	1637	1717	959	1	80	0.0125000
NODE_150_length_5572_cov_79.124246	1637	1717	960	2	80	0.0250000
NODE_150_length_5572_cov_79.124246	1637	1717	962	1	80	0.0125000
NODE_150_length_5572_cov_79.124246	1637	1717	968	2	80	0.0250000
NODE_150_length_5572_cov_79.124246	1637	1717	970	1	80	0.0125000
NODE_150_length_5572_cov_79.124246	1637	1717	972	1	80	0.0125000
NODE_150_length_5572_cov_79.124246	1637	1717	974	1	80	0.0125000
NODE_150_length_5572_cov_79.124246	1637	1717	975	1	80	0.0125000
NODE_150_length_5572_cov_79.124246	1637	1717	976	1	80	0.0125000
NODE_150_length_5572_cov_79.124246	1637	1717	977	1	80	0.0125000
NODE_150_length_5572_cov_79.124246	1637	1717	978	1	80	0.0125000
NODE_150_length_5572_cov_79.124246	1637	1717	980	1	80	0.0125000
NODE_150_length_5572_cov_79.124246	1637	1717	981	1	80	0.0125000
NODE_150_length_5572_cov_79.124246	1637	1717	982	1	80	0.0125000
NODE_150_length_5572_cov_79.124246	1690	1770	543	1	80	0.0125000
NODE_150_length_5572_cov_79.124246	1690	1770	561	1	80	0.0125000
NODE_150_length_5572_cov_79.124246	1690	1770	596	1	80	0.0125000
NODE_150_length_5572_cov_79.124246	1690	1770	622	1	80	0.0125000
NODE_150_length_5572_cov_79.124246	1690	1770	659	1	80	0.0125000
NODE_150_length_5572_cov_79.124246	1690	1770	681	1	80	0.0125000
NODE_150_length_5572_cov_79.124246	1690	1770	699	1	80	0.0125000
NODE_150_length_5572_cov_79.124246	1690	1770	720	1	80	0.0125000
NODE_150_length_5572_cov_79.124246	1690	1770	738	1	80	0.0125000
NODE_150_length_5572_cov_79.124246	1690	1770	740	1	80	0.0125000
NODE_150_length_5572_cov_79.124246	1690	1770	763	1	80	0.0125000
NODE_150_length_5572_cov_79.124246	1690	1770	768	1	80	0.0125000
NODE_150_length_5572_cov_79.124246	1690	1770	775	1	80	0.0125000
NODE_150_length_5572_cov_79.124246	1690	1770	785	1	80	0.0125000
NODE_150_length_5572_cov_79.124246	1690	1770	793	1	80	0.0125000
NODE_150_length_5572_cov_79.124246	1690	1770	805	1	80	0.0125000
NODE_150_length_5572_cov_79.124246	1690	1770	809	1	80	0.0125000
NODE_150_length_5572_cov_79.124246	1690	1770	811	1	80	0.0125000
NODE_150_length_5572_cov_79.124246	1690	1770	837	1	80	0.0125000
NODE_150_length_5572_cov_79.124246	1690	1770	844	1	80	0.0125000
NODE_150_length_5572_cov_79.124246	1690	1770	849	1	80	0.0125000
NODE_150_length_5572_cov_79.124246	1690	1770	855	1	80	0.0125000
NODE_150_length_5572_cov_79.124246	1690	1770	859	1	80	0.0125000
NODE_150_length_5572_cov_79.124246	1690	1770	869	1	80	0.0125000
NODE_150_length_5572_cov_79.124246	1690	1770	879	1	80	0.0125000
NODE_150_length_5572_cov_79.124246	1690	1770	889	1	80	0.0125000
NODE_150_length_5572_cov_79.124246	1690	1770	892	1	80	0.0125000
NODE_150_length_5572_cov_79.124246	1690	1770	897	1	80	0.0125000
NODE_150_length_5572_cov_79.124246	1690	1770	903	1	80	0.0125000
NODE_150_length_5572_cov_79.124246	1690	1770	906	1	80	0.0125000
NODE_150_length_5572_cov_79.124246	1690	1770	909	1	80	0.0125000
NODE_150_length_5572_cov_79.124246	1690	1770	915	1	80	0.0125000
NODE_150_length_5572_cov_79.124246	1690	1770	917	1	80	0.0125000
NODE_150_length_5572_cov_79.124246	1690	1770	922	1	80	0.0125000
NODE_150_length_5572_cov_79.124246	1690	1770	931	1	80	0.0125000
NODE_150_length_5572_cov_79.124246	1690	1770	936	3	80	0.0375000
NODE_150_length_5572_cov_79.124246	1690	1770	941	1	80	0.0125000
NODE_150_length_5572_cov_79.124246	1690	1770	946	3	80	0.0375000
NODE_150_length_5572_cov_79.124246	1690	1770	947	2	80	0.0250000
NODE_150_length_5572_cov_79.124246	1690	1770	952	1	80	0.0125000
NODE_150_length_5572_cov_79.124246	1690	1770	956	4	80	0.0500000
NODE_150_length_5572_cov_79.124246	1690	1770	957	2	80	0.0250000
NODE_150_length_5572_cov_79.124246	1690	1770	959	2	80	0.0250000
NODE_150_length_5572_cov_79.124246	1690	1770	960	2	80	0.0250000
NODE_150_length_5572_cov_79.124246	1690	1770	961	3	80	0.0375000
NODE_150_length_5572_cov_79.124246	1690	1770	962	1	80	0.0125000
NODE_150_length_5572_cov_79.124246	1690	1770	968	2	80	0.0250000
NODE_150_length_5572_cov_79.124246	1690	1770	970	1	80	0.0125000
NODE_150_length_5572_cov_79.124246	1690	1770	972	1	80	0.0125000
NODE_150_length_5572_cov_79.124246	1690	1770	974	1	80	0.0125000
NODE_150_length_5572_cov_79.124246	1690	1770	975	2	80	0.0250000
NODE_150_length_5572_cov_79.124246	1690	1770	976	2	80	0.0250000
NODE_150_length_5572_cov_79.124246	1690	1770	977	3	80	0.0375000
NODE_150_length_5572_cov_79.124246	1690	1770	978	1	80	0.0125000
NODE_150_length_5572_cov_79.124246	1690	1770	979	2	80	0.0250000
NODE_150_length_5572_cov_79.124246	1690	1770	980	2	80	0.0250000
NODE_150_length_5572_cov_79.124246	1690	1770	981	2	80	0.0250000
NODE_150_length_5572_cov_79.124246	1690	1770	982	2	80	0.0250000
NODE_150_length_5572_cov_79.124246	5130	5210	0	30	80	0.3750000
NODE_150_length_5572_cov_79.124246	5130	5210	2	50	80	0.6250000
NODE_150_length_5572_cov_79.124246	5183	5263	0	48	80	0.6000000
NODE_150_length_5572_cov_79.124246	5183	5263	2	32	80	0.4000000
NODE_151_length_5557_cov_26.198241	341	414	4	35	73	0.4794520
NODE_151_length_5557_cov_26.198241	341	414	6	18	73	0.2465753
NODE_151_length_5557_cov_26.198241	341	414	8	20	73	0.2739726
NODE_151_length_5557_cov_26.198241	394	460	0	32	66	0.4848485
NODE_151_length_5557_cov_26.198241	394	460	4	34	66	0.5151515
NODE_156_length_5500_cov_35.832438	81	161	0	80	80	1.0000000
NODE_156_length_5500_cov_35.832438	134	214	0	80	80	1.0000000
NODE_159_length_5470_cov_5.987526	5180	5249	0	69	69	1.0000000
NODE_160_length_5434_cov_14.997751	541	621	0	80	80	1.0000000
NODE_160_length_5434_cov_14.997751	594	674	0	62	80	0.7750000
NODE_160_length_5434_cov_14.997751	594	674	2	18	80	0.2250000
NODE_160_length_5434_cov_14.997751	2664	2744	0	30	80	0.3750000
NODE_160_length_5434_cov_14.997751	2664	2744	3	7	80	0.0875000
NODE_160_length_5434_cov_14.997751	2664	2744	5	1	80	0.0125000
NODE_160_length_5434_cov_14.997751	2664	2744	8	42	80	0.5250000
NODE_160_length_5434_cov_14.997751	2717	2797	0	80	80	1.0000000
NODE_160_length_5434_cov_14.997751	3041	3093	2	52	52	1.0000000
NODE_160_length_5434_cov_14.997751	3419	3467	20	3	48	0.0625000
NODE_160_length_5434_cov_14.997751	3419	3467	22	7	48	0.1458333
NODE_160_length_5434_cov_14.997751	3419	3467	24	38	48	0.7916667
NODE_161_length_5425_cov_15.812242	141	218	14	5	77	0.0649351
NODE_161_length_5425_cov_15.812242	141	218	16	5	77	0.0649351
NODE_161_length_5425_cov_15.812242	141	218	18	5	77	0.0649351
NODE_161_length_5425_cov_15.812242	141	218	20	2	77	0.0259740
NODE_161_length_5425_cov_15.812242	141	218	22	1	77	0.0129870
NODE_161_length_5425_cov_15.812242	141	218	24	3	77	0.0389610
NODE_161_length_5425_cov_15.812242	141	218	28	7	77	0.0909091
NODE_161_length_5425_cov_15.812242	141	218	30	3	77	0.0389610
NODE_161_length_5425_cov_15.812242	141	218	32	5	77	0.0649351
NODE_161_length_5425_cov_15.812242	141	218	33	1	77	0.0129870
NODE_161_length_5425_cov_15.812242	141	218	34	9	77	0.1168831
NODE_161_length_5425_cov_15.812242	141	218	35	2	77	0.0259740
NODE_161_length_5425_cov_15.812242	141	218	36	1	77	0.0129870
NODE_161_length_5425_cov_15.812242	141	218	37	8	77	0.1038961
NODE_161_length_5425_cov_15.812242	141	218	38	2	77	0.0259740
NODE_161_length_5425_cov_15.812242	141	218	40	1	77	0.0129870
NODE_161_length_5425_cov_15.812242	141	218	42	4	77	0.0519481
NODE_161_length_5425_cov_15.812242	141	218	43	8	77	0.1038961
NODE_161_length_5425_cov_15.812242	141	218	45	4	77	0.0519481
NODE_161_length_5425_cov_15.812242	141	218	47	1	77	0.0129870
NODE_161_length_5425_cov_15.812242	841	921	0	80	80	1.0000000
NODE_161_length_5425_cov_15.812242	894	974	0	80	80	1.0000000
NODE_163_length_5402_cov_5.397322	191	263	8	7	72	0.0972222
NODE_163_length_5402_cov_5.397322	191	263	10	8	72	0.1111111
NODE_163_length_5402_cov_5.397322	191	263	12	7	72	0.0972222
NODE_163_length_5402_cov_5.397322	191	263	14	50	72	0.6944444
NODE_163_length_5402_cov_5.397322	2305	2385	56	1	80	0.0125000
NODE_163_length_5402_cov_5.397322	2305	2385	58	1	80	0.0125000
NODE_163_length_5402_cov_5.397322	2305	2385	59	4	80	0.0500000
NODE_163_length_5402_cov_5.397322	2305	2385	60	2	80	0.0250000
NODE_163_length_5402_cov_5.397322	2305	2385	61	2	80	0.0250000
NODE_163_length_5402_cov_5.397322	2305	2385	63	2	80	0.0250000
NODE_163_length_5402_cov_5.397322	2305	2385	66	1	80	0.0125000
NODE_163_length_5402_cov_5.397322	2305	2385	74	1	80	0.0125000
NODE_163_length_5402_cov_5.397322	2305	2385	77	2	80	0.0250000
NODE_163_length_5402_cov_5.397322	2305	2385	79	1	80	0.0125000
NODE_163_length_5402_cov_5.397322	2305	2385	81	1	80	0.0125000
NODE_163_length_5402_cov_5.397322	2305	2385	83	3	80	0.0375000
NODE_163_length_5402_cov_5.397322	2305	2385	84	2	80	0.0250000
NODE_163_length_5402_cov_5.397322	2305	2385	86	3	80	0.0375000
NODE_163_length_5402_cov_5.397322	2305	2385	87	1	80	0.0125000
NODE_163_length_5402_cov_5.397322	2305	2385	88	19	80	0.2375000
NODE_163_length_5402_cov_5.397322	2305	2385	90	11	80	0.1375000
NODE_163_length_5402_cov_5.397322	2305	2385	92	4	80	0.0500000
NODE_163_length_5402_cov_5.397322	2305	2385	94	9	80	0.1125000
NODE_163_length_5402_cov_5.397322	2305	2385	96	6	80	0.0750000
NODE_163_length_5402_cov_5.397322	2305	2385	98	4	80	0.0500000
NODE_163_length_5402_cov_5.397322	2358	2438	72	4	80	0.0500000
NODE_163_length_5402_cov_5.397322	2358	2438	74	1	80	0.0125000
NODE_163_length_5402_cov_5.397322	2358	2438	76	3	80	0.0375000
NODE_163_length_5402_cov_5.397322	2358	2438	78	5	80	0.0625000
NODE_163_length_5402_cov_5.397322	2358	2438	80	3	80	0.0375000
NODE_163_length_5402_cov_5.397322	2358	2438	84	2	80	0.0250000
NODE_163_length_5402_cov_5.397322	2358	2438	86	2	80	0.0250000
NODE_163_length_5402_cov_5.397322	2358	2438	88	10	80	0.1250000
NODE_163_length_5402_cov_5.397322	2358	2438	89	1	80	0.0125000
NODE_163_length_5402_cov_5.397322	2358	2438	90	9	80	0.1125000
NODE_163_length_5402_cov_5.397322	2358	2438	92	2	80	0.0250000
NODE_163_length_5402_cov_5.397322	2358	2438	94	10	80	0.1250000
NODE_163_length_5402_cov_5.397322	2358	2438	96	6	80	0.0750000
NODE_163_length_5402_cov_5.397322	2358	2438	98	7	80	0.0875000
NODE_163_length_5402_cov_5.397322	2358	2438	100	7	80	0.0875000
NODE_163_length_5402_cov_5.397322	2358	2438	102	8	80	0.1000000
NODE_164_length_5383_cov_15.680545	205	285	0	41	80	0.5125000
NODE_164_length_5383_cov_15.680545	205	285	2	39	80	0.4875000
NODE_164_length_5383_cov_15.680545	258	317	0	59	59	1.0000000
NODE_164_length_5383_cov_15.680545	2042	2122	38	10	80	0.1250000
NODE_164_length_5383_cov_15.680545	2042	2122	40	1	80	0.0125000
NODE_164_length_5383_cov_15.680545	2042	2122	42	5	80	0.0625000
NODE_164_length_5383_cov_15.680545	2042	2122	46	1	80	0.0125000
NODE_164_length_5383_cov_15.680545	2042	2122	48	9	80	0.1125000
NODE_164_length_5383_cov_15.680545	2042	2122	50	20	80	0.2500000
NODE_164_length_5383_cov_15.680545	2042	2122	52	7	80	0.0875000
NODE_164_length_5383_cov_15.680545	2042	2122	54	17	80	0.2125000
NODE_164_length_5383_cov_15.680545	2042	2122	56	10	80	0.1250000
NODE_164_length_5383_cov_15.680545	2095	2175	0	2	80	0.0250000
NODE_164_length_5383_cov_15.680545	2095	2175	2	4	80	0.0500000
NODE_164_length_5383_cov_15.680545	2095	2175	4	1	80	0.0125000
NODE_164_length_5383_cov_15.680545	2095	2175	6	3	80	0.0375000
NODE_164_length_5383_cov_15.680545	2095	2175	9	2	80	0.0250000
NODE_164_length_5383_cov_15.680545	2095	2175	10	2	80	0.0250000
NODE_164_length_5383_cov_15.680545	2095	2175	13	1	80	0.0125000
NODE_164_length_5383_cov_15.680545	2095	2175	19	1	80	0.0125000
NODE_164_length_5383_cov_15.680545	2095	2175	20	4	80	0.0500000
NODE_164_length_5383_cov_15.680545	2095	2175	22	7	80	0.0875000
NODE_164_length_5383_cov_15.680545	2095	2175	24	1	80	0.0125000
NODE_164_length_5383_cov_15.680545	2095	2175	32	3	80	0.0375000
NODE_164_length_5383_cov_15.680545	2095	2175	34	12	80	0.1500000
NODE_164_length_5383_cov_15.680545	2095	2175	36	4	80	0.0500000
NODE_164_length_5383_cov_15.680545	2095	2175	38	16	80	0.2000000
NODE_164_length_5383_cov_15.680545	2095	2175	40	1	80	0.0125000
NODE_164_length_5383_cov_15.680545	2095	2175	42	5	80	0.0625000
NODE_164_length_5383_cov_15.680545	2095	2175	46	1	80	0.0125000
NODE_164_length_5383_cov_15.680545	2095	2175	48	9	80	0.1125000
NODE_164_length_5383_cov_15.680545	2095	2175	50	1	80	0.0125000
NODE_165_length_5382_cov_16.894378	1301	1347	12	2	46	0.0434783
NODE_165_length_5382_cov_16.894378	1301	1347	14	10	46	0.2173913
NODE_165_length_5382_cov_16.894378	1301	1347	16	7	46	0.1521739
NODE_165_length_5382_cov_16.894378	1301	1347	18	21	46	0.4565217
NODE_165_length_5382_cov_16.894378	1301	1347	20	6	46	0.1304348
NODE_165_length_5382_cov_16.894378	5056	5082	80	4	26	0.1538462
NODE_165_length_5382_cov_16.894378	5056	5082	81	1	26	0.0384615
NODE_165_length_5382_cov_16.894378	5056	5082	83	1	26	0.0384615
NODE_165_length_5382_cov_16.894378	5056	5082	90	3	26	0.1153846
NODE_165_length_5382_cov_16.894378	5056	5082	91	2	26	0.0769231
NODE_165_length_5382_cov_16.894378	5056	5082	92	1	26	0.0384615
NODE_165_length_5382_cov_16.894378	5056	5082	94	1	26	0.0384615
NODE_165_length_5382_cov_16.894378	5056	5082	96	3	26	0.1153846
NODE_165_length_5382_cov_16.894378	5056	5082	97	1	26	0.0384615
NODE_165_length_5382_cov_16.894378	5056	5082	99	1	26	0.0384615
NODE_165_length_5382_cov_16.894378	5056	5082	100	1	26	0.0384615
NODE_165_length_5382_cov_16.894378	5056	5082	103	1	26	0.0384615
NODE_165_length_5382_cov_16.894378	5056	5082	105	1	26	0.0384615
NODE_165_length_5382_cov_16.894378	5056	5082	109	1	26	0.0384615
NODE_165_length_5382_cov_16.894378	5056	5082	121	1	26	0.0384615
NODE_165_length_5382_cov_16.894378	5056	5082	127	1	26	0.0384615
NODE_165_length_5382_cov_16.894378	5056	5082	129	1	26	0.0384615
NODE_165_length_5382_cov_16.894378	5056	5082	146	1	26	0.0384615
NODE_165_length_5382_cov_16.894378	5056	5115	80	4	59	0.0677966
NODE_165_length_5382_cov_16.894378	5056	5115	81	1	59	0.0169492
NODE_165_length_5382_cov_16.894378	5056	5115	83	1	59	0.0169492
NODE_165_length_5382_cov_16.894378	5056	5115	90	3	59	0.0508475
NODE_165_length_5382_cov_16.894378	5056	5115	91	2	59	0.0338983
NODE_165_length_5382_cov_16.894378	5056	5115	92	1	59	0.0169492
NODE_165_length_5382_cov_16.894378	5056	5115	94	1	59	0.0169492
NODE_165_length_5382_cov_16.894378	5056	5115	96	3	59	0.0508475
NODE_165_length_5382_cov_16.894378	5056	5115	97	1	59	0.0169492
NODE_165_length_5382_cov_16.894378	5056	5115	99	1	59	0.0169492
NODE_165_length_5382_cov_16.894378	5056	5115	100	1	59	0.0169492
NODE_165_length_5382_cov_16.894378	5056	5115	103	1	59	0.0169492
NODE_165_length_5382_cov_16.894378	5056	5115	105	1	59	0.0169492
NODE_165_length_5382_cov_16.894378	5056	5115	109	1	59	0.0169492
NODE_165_length_5382_cov_16.894378	5056	5115	121	1	59	0.0169492
NODE_165_length_5382_cov_16.894378	5056	5115	127	1	59	0.0169492
NODE_165_length_5382_cov_16.894378	5056	5115	129	1	59	0.0169492
NODE_165_length_5382_cov_16.894378	5056	5115	146	1	59	0.0169492
NODE_165_length_5382_cov_16.894378	5056	5115	150	2	59	0.0338983
NODE_165_length_5382_cov_16.894378	5056	5115	157	1	59	0.0169492
NODE_165_length_5382_cov_16.894378	5056	5115	161	1	59	0.0169492
NODE_165_length_5382_cov_16.894378	5056	5115	162	1	59	0.0169492
NODE_165_length_5382_cov_16.894378	5056	5115	166	2	59	0.0338983
NODE_165_length_5382_cov_16.894378	5056	5115	168	1	59	0.0169492
NODE_165_length_5382_cov_16.894378	5056	5115	182	1	59	0.0169492
NODE_165_length_5382_cov_16.894378	5056	5115	189	1	59	0.0169492
NODE_165_length_5382_cov_16.894378	5056	5115	190	1	59	0.0169492
NODE_165_length_5382_cov_16.894378	5056	5115	192	1	59	0.0169492
NODE_165_length_5382_cov_16.894378	5056	5115	202	1	59	0.0169492
NODE_165_length_5382_cov_16.894378	5056	5115	213	1	59	0.0169492
NODE_165_length_5382_cov_16.894378	5056	5115	218	1	59	0.0169492
NODE_165_length_5382_cov_16.894378	5056	5115	221	1	59	0.0169492
NODE_165_length_5382_cov_16.894378	5056	5115	226	2	59	0.0338983
NODE_165_length_5382_cov_16.894378	5056	5115	231	1	59	0.0169492
NODE_165_length_5382_cov_16.894378	5056	5115	235	3	59	0.0508475
NODE_165_length_5382_cov_16.894378	5056	5115	240	1	59	0.0169492
NODE_165_length_5382_cov_16.894378	5056	5115	247	1	59	0.0169492
NODE_165_length_5382_cov_16.894378	5056	5115	251	1	59	0.0169492
NODE_165_length_5382_cov_16.894378	5056	5115	272	1	59	0.0169492
NODE_165_length_5382_cov_16.894378	5056	5115	276	1	59	0.0169492
NODE_165_length_5382_cov_16.894378	5056	5115	281	2	59	0.0338983
NODE_165_length_5382_cov_16.894378	5056	5115	283	2	59	0.0338983
NODE_165_length_5382_cov_16.894378	5056	5115	289	1	59	0.0169492
NODE_165_length_5382_cov_16.894378	5056	5115	290	1	59	0.0169492
NODE_167_length_5339_cov_28.708969	3375	3455	14	16	80	0.2000000
NODE_167_length_5339_cov_28.708969	3375	3455	16	8	80	0.1000000
NODE_167_length_5339_cov_28.708969	3375	3455	18	14	80	0.1750000
NODE_167_length_5339_cov_28.708969	3375	3455	29	4	80	0.0500000
NODE_167_length_5339_cov_28.708969	3375	3455	30	1	80	0.0125000
NODE_167_length_5339_cov_28.708969	3375	3455	31	3	80	0.0375000
NODE_167_length_5339_cov_28.708969	3375	3455	32	12	80	0.1500000
NODE_167_length_5339_cov_28.708969	3375	3455	33	15	80	0.1875000
NODE_167_length_5339_cov_28.708969	3375	3455	34	4	80	0.0500000
NODE_167_length_5339_cov_28.708969	3375	3455	35	2	80	0.0250000
NODE_167_length_5339_cov_28.708969	3375	3455	37	1	80	0.0125000
NODE_167_length_5339_cov_28.708969	3428	3508	29	4	80	0.0500000
NODE_167_length_5339_cov_28.708969	3428	3508	31	3	80	0.0375000
NODE_167_length_5339_cov_28.708969	3428	3508	33	15	80	0.1875000
NODE_167_length_5339_cov_28.708969	3428	3508	34	11	80	0.1375000
NODE_167_length_5339_cov_28.708969	3428	3508	35	2	80	0.0250000
NODE_167_length_5339_cov_28.708969	3428	3508	36	20	80	0.2500000
NODE_167_length_5339_cov_28.708969	3428	3508	37	3	80	0.0375000
NODE_167_length_5339_cov_28.708969	3428	3508	38	5	80	0.0625000
NODE_167_length_5339_cov_28.708969	3428	3508	39	5	80	0.0625000
NODE_167_length_5339_cov_28.708969	3428	3508	40	3	80	0.0375000
NODE_167_length_5339_cov_28.708969	3428	3508	41	6	80	0.0750000
NODE_167_length_5339_cov_28.708969	3428	3508	43	2	80	0.0250000
NODE_167_length_5339_cov_28.708969	3428	3508	45	1	80	0.0125000
NODE_168_length_5336_cov_33.036471	3109	3189	20	4	80	0.0500000
NODE_168_length_5336_cov_33.036471	3109	3189	22	1	80	0.0125000
NODE_168_length_5336_cov_33.036471	3109	3189	24	16	80	0.2000000
NODE_168_length_5336_cov_33.036471	3109	3189	26	4	80	0.0500000
NODE_168_length_5336_cov_33.036471	3109	3189	28	3	80	0.0375000
NODE_168_length_5336_cov_33.036471	3109	3189	30	3	80	0.0375000
NODE_168_length_5336_cov_33.036471	3109	3189	32	2	80	0.0250000
NODE_168_length_5336_cov_33.036471	3109	3189	38	9	80	0.1125000
NODE_168_length_5336_cov_33.036471	3109	3189	40	18	80	0.2250000
NODE_168_length_5336_cov_33.036471	3109	3189	42	2	80	0.0250000
NODE_168_length_5336_cov_33.036471	3109	3189	44	2	80	0.0250000
NODE_168_length_5336_cov_33.036471	3109	3189	46	3	80	0.0375000
NODE_168_length_5336_cov_33.036471	3109	3189	47	2	80	0.0250000
NODE_168_length_5336_cov_33.036471	3109	3189	48	11	80	0.1375000
NODE_168_length_5336_cov_33.036471	3162	3242	15	8	80	0.1000000
NODE_168_length_5336_cov_33.036471	3162	3242	17	1	80	0.0125000
NODE_168_length_5336_cov_33.036471	3162	3242	19	10	80	0.1250000
NODE_168_length_5336_cov_33.036471	3162	3242	21	13	80	0.1625000
NODE_168_length_5336_cov_33.036471	3162	3242	22	4	80	0.0500000
NODE_168_length_5336_cov_33.036471	3162	3242	24	6	80	0.0750000
NODE_168_length_5336_cov_33.036471	3162	3242	28	1	80	0.0125000
NODE_168_length_5336_cov_33.036471	3162	3242	32	3	80	0.0375000
NODE_168_length_5336_cov_33.036471	3162	3242	34	1	80	0.0125000
NODE_168_length_5336_cov_33.036471	3162	3242	36	6	80	0.0750000
NODE_168_length_5336_cov_33.036471	3162	3242	38	8	80	0.1000000
NODE_168_length_5336_cov_33.036471	3162	3242	40	6	80	0.0750000
NODE_168_length_5336_cov_33.036471	3162	3242	42	2	80	0.0250000
NODE_168_length_5336_cov_33.036471	3162	3242	44	2	80	0.0250000
NODE_168_length_5336_cov_33.036471	3162	3242	46	3	80	0.0375000
NODE_168_length_5336_cov_33.036471	3162	3242	48	6	80	0.0750000
NODE_179_length_5269_cov_23.392650	1905	1985	0	80	80	1.0000000
NODE_179_length_5269_cov_23.392650	1958	2038	0	80	80	1.0000000
NODE_181_length_5207_cov_31.352780	4588	4668	0	22	80	0.2750000
NODE_181_length_5207_cov_31.352780	4588	4668	8	58	80	0.7250000
NODE_181_length_5207_cov_31.352780	4641	4721	0	19	80	0.2375000
NODE_181_length_5207_cov_31.352780	4641	4721	6	1	80	0.0125000
NODE_181_length_5207_cov_31.352780	4641	4721	7	31	80	0.3875000
NODE_181_length_5207_cov_31.352780	4641	4721	8	29	80	0.3625000
NODE_183_length_5193_cov_14.930506	4659	4739	0	18	80	0.2250000
NODE_183_length_5193_cov_14.930506	4659	4739	9	49	80	0.6125000
NODE_183_length_5193_cov_14.930506	4659	4739	10	13	80	0.1625000
NODE_183_length_5193_cov_14.930506	4712	4792	4	2	80	0.0250000
NODE_183_length_5193_cov_14.930506	4712	4792	9	14	80	0.1750000
NODE_183_length_5193_cov_14.930506	4712	4792	10	64	80	0.8000000
NODE_183_length_5193_cov_14.930506	4788	4868	0	19	80	0.2375000
NODE_183_length_5193_cov_14.930506	4788	4868	2	43	80	0.5375000
NODE_183_length_5193_cov_14.930506	4788	4868	4	16	80	0.2000000
NODE_183_length_5193_cov_14.930506	4788	4868	10	2	80	0.0250000
NODE_183_length_5193_cov_14.930506	4841	4921	2	15	80	0.1875000
NODE_183_length_5193_cov_14.930506	4841	4921	4	39	80	0.4875000
NODE_183_length_5193_cov_14.930506	4841	4921	6	26	80	0.3250000
NODE_186_length_5159_cov_261.593676	158	227	125	1	69	0.0144928
NODE_186_length_5159_cov_261.593676	158	227	127	6	69	0.0869565
NODE_186_length_5159_cov_261.593676	158	227	129	5	69	0.0724638
NODE_186_length_5159_cov_261.593676	158	227	131	5	69	0.0724638
NODE_186_length_5159_cov_261.593676	158	227	132	1	69	0.0144928
NODE_186_length_5159_cov_261.593676	158	227	133	6	69	0.0869565
NODE_186_length_5159_cov_261.593676	158	227	134	1	69	0.0144928
NODE_186_length_5159_cov_261.593676	158	227	135	2	69	0.0289855
NODE_186_length_5159_cov_261.593676	158	227	137	2	69	0.0289855
NODE_186_length_5159_cov_261.593676	158	227	138	1	69	0.0144928
NODE_186_length_5159_cov_261.593676	158	227	140	1	69	0.0144928
NODE_186_length_5159_cov_261.593676	158	227	142	6	69	0.0869565
NODE_186_length_5159_cov_261.593676	158	227	143	3	69	0.0434783
NODE_186_length_5159_cov_261.593676	158	227	144	8	69	0.1159420
NODE_186_length_5159_cov_261.593676	158	227	145	4	69	0.0579710
NODE_186_length_5159_cov_261.593676	158	227	146	4	69	0.0579710
NODE_186_length_5159_cov_261.593676	158	227	147	11	69	0.1594203
NODE_186_length_5159_cov_261.593676	158	227	149	1	69	0.0144928
NODE_186_length_5159_cov_261.593676	158	227	150	1	69	0.0144928
NODE_189_length_5138_cov_31.467355	3004	3075	9	1	71	0.0140845
NODE_189_length_5138_cov_31.467355	3004	3075	10	1	71	0.0140845
NODE_189_length_5138_cov_31.467355	3004	3075	12	10	71	0.1408451
NODE_189_length_5138_cov_31.467355	3004	3075	16	2	71	0.0281690
NODE_189_length_5138_cov_31.467355	3004	3075	17	6	71	0.0845070
NODE_189_length_5138_cov_31.467355	3004	3075	19	9	71	0.1267606
NODE_189_length_5138_cov_31.467355	3004	3075	20	1	71	0.0140845
NODE_189_length_5138_cov_31.467355	3004	3075	21	4	71	0.0563380
NODE_189_length_5138_cov_31.467355	3004	3075	24	2	71	0.0281690
NODE_189_length_5138_cov_31.467355	3004	3075	25	1	71	0.0140845
NODE_189_length_5138_cov_31.467355	3004	3075	26	1	71	0.0140845
NODE_189_length_5138_cov_31.467355	3004	3075	28	4	71	0.0563380
NODE_189_length_5138_cov_31.467355	3004	3075	30	4	71	0.0563380
NODE_189_length_5138_cov_31.467355	3004	3075	32	2	71	0.0281690
NODE_189_length_5138_cov_31.467355	3004	3075	33	1	71	0.0140845
NODE_189_length_5138_cov_31.467355	3004	3075	34	1	71	0.0140845
NODE_189_length_5138_cov_31.467355	3004	3075	35	1	71	0.0140845
NODE_189_length_5138_cov_31.467355	3004	3075	36	1	71	0.0140845
NODE_189_length_5138_cov_31.467355	3004	3075	42	6	71	0.0845070
NODE_189_length_5138_cov_31.467355	3004	3075	44	1	71	0.0140845
NODE_189_length_5138_cov_31.467355	3004	3075	49	5	71	0.0704225
NODE_189_length_5138_cov_31.467355	3004	3075	50	4	71	0.0563380
NODE_189_length_5138_cov_31.467355	3004	3075	52	3	71	0.0422535
NODE_191_length_5126_cov_5.900935	731	811	2	1	80	0.0125000
NODE_191_length_5126_cov_5.900935	731	811	4	1	80	0.0125000
NODE_191_length_5126_cov_5.900935	731	811	6	59	80	0.7375000
NODE_191_length_5126_cov_5.900935	731	811	8	19	80	0.2375000
NODE_191_length_5126_cov_5.900935	784	864	0	4	80	0.0500000
NODE_191_length_5126_cov_5.900935	784	864	2	2	80	0.0250000
NODE_191_length_5126_cov_5.900935	784	864	4	27	80	0.3375000
NODE_191_length_5126_cov_5.900935	784	864	6	16	80	0.2000000
NODE_191_length_5126_cov_5.900935	784	864	8	31	80	0.3875000
NODE_194_length_5102_cov_12.729962	367	447	4	9	80	0.1125000
NODE_194_length_5102_cov_12.729962	367	447	12	2	80	0.0250000
NODE_194_length_5102_cov_12.729962	367	447	14	10	80	0.1250000
NODE_194_length_5102_cov_12.729962	367	447	15	23	80	0.2875000
NODE_194_length_5102_cov_12.729962	367	447	16	36	80	0.4500000
NODE_194_length_5102_cov_12.729962	420	500	0	6	80	0.0750000
NODE_194_length_5102_cov_12.729962	420	500	6	1	80	0.0125000
NODE_194_length_5102_cov_12.729962	420	500	11	22	80	0.2750000
NODE_194_length_5102_cov_12.729962	420	500	12	26	80	0.3250000
NODE_194_length_5102_cov_12.729962	420	500	14	10	80	0.1250000
NODE_194_length_5102_cov_12.729962	420	500	16	15	80	0.1875000
NODE_194_length_5102_cov_12.729962	496	576	0	80	80	1.0000000
NODE_194_length_5102_cov_12.729962	549	629	0	65	80	0.8125000
NODE_194_length_5102_cov_12.729962	549	629	2	6	80	0.0750000
NODE_194_length_5102_cov_12.729962	549	629	4	9	80	0.1125000
NODE_196_length_5079_cov_5.580522	875	940	55	3	65	0.0461538
NODE_196_length_5079_cov_5.580522	875	940	57	10	65	0.1538462
NODE_196_length_5079_cov_5.580522	875	940	59	4	65	0.0615385
NODE_196_length_5079_cov_5.580522	875	940	60	6	65	0.0923077
NODE_196_length_5079_cov_5.580522	875	940	61	3	65	0.0461538
NODE_196_length_5079_cov_5.580522	875	940	62	11	65	0.1692308
NODE_196_length_5079_cov_5.580522	875	940	63	1	65	0.0153846
NODE_196_length_5079_cov_5.580522	875	940	64	6	65	0.0923077
NODE_196_length_5079_cov_5.580522	875	940	65	4	65	0.0615385
NODE_196_length_5079_cov_5.580522	875	940	66	3	65	0.0461538
NODE_196_length_5079_cov_5.580522	875	940	69	14	65	0.2153846
NODE_197_length_5057_cov_16.348729	2929	3000	248	1	71	0.0140845
NODE_197_length_5057_cov_16.348729	2929	3000	256	1	71	0.0140845
NODE_197_length_5057_cov_16.348729	2929	3000	264	1	71	0.0140845
NODE_197_length_5057_cov_16.348729	2929	3000	275	1	71	0.0140845
NODE_197_length_5057_cov_16.348729	2929	3000	283	1	71	0.0140845
NODE_197_length_5057_cov_16.348729	2929	3000	289	1	71	0.0140845
NODE_197_length_5057_cov_16.348729	2929	3000	292	1	71	0.0140845
NODE_197_length_5057_cov_16.348729	2929	3000	299	1	71	0.0140845
NODE_197_length_5057_cov_16.348729	2929	3000	303	1	71	0.0140845
NODE_197_length_5057_cov_16.348729	2929	3000	313	1	71	0.0140845
NODE_197_length_5057_cov_16.348729	2929	3000	326	1	71	0.0140845
NODE_197_length_5057_cov_16.348729	2929	3000	331	2	71	0.0281690
NODE_197_length_5057_cov_16.348729	2929	3000	335	2	71	0.0281690
NODE_197_length_5057_cov_16.348729	2929	3000	349	1	71	0.0140845
NODE_197_length_5057_cov_16.348729	2929	3000	351	1	71	0.0140845
NODE_197_length_5057_cov_16.348729	2929	3000	354	1	71	0.0140845
NODE_197_length_5057_cov_16.348729	2929	3000	370	1	71	0.0140845
NODE_197_length_5057_cov_16.348729	2929	3000	378	1	71	0.0140845
NODE_197_length_5057_cov_16.348729	2929	3000	381	1	71	0.0140845
NODE_197_length_5057_cov_16.348729	2929	3000	391	1	71	0.0140845
NODE_197_length_5057_cov_16.348729	2929	3000	403	1	71	0.0140845
NODE_197_length_5057_cov_16.348729	2929	3000	411	1	71	0.0140845
NODE_197_length_5057_cov_16.348729	2929	3000	420	1	71	0.0140845
NODE_197_length_5057_cov_16.348729	2929	3000	438	1	71	0.0140845
NODE_197_length_5057_cov_16.348729	2929	3000	445	1	71	0.0140845
NODE_197_length_5057_cov_16.348729	2929	3000	451	1	71	0.0140845
NODE_197_length_5057_cov_16.348729	2929	3000	457	2	71	0.0281690
NODE_197_length_5057_cov_16.348729	2929	3000	459	1	71	0.0140845
NODE_197_length_5057_cov_16.348729	2929	3000	460	1	71	0.0140845
NODE_197_length_5057_cov_16.348729	2929	3000	470	1	71	0.0140845
NODE_197_length_5057_cov_16.348729	2929	3000	480	2	71	0.0281690
NODE_197_length_5057_cov_16.348729	2929	3000	484	1	71	0.0140845
NODE_197_length_5057_cov_16.348729	2929	3000	488	1	71	0.0140845
NODE_197_length_5057_cov_16.348729	2929	3000	492	1	71	0.0140845
NODE_197_length_5057_cov_16.348729	2929	3000	497	2	71	0.0281690
NODE_197_length_5057_cov_16.348729	2929	3000	501	1	71	0.0140845
NODE_197_length_5057_cov_16.348729	2929	3000	503	1	71	0.0140845
NODE_197_length_5057_cov_16.348729	2929	3000	513	1	71	0.0140845
NODE_197_length_5057_cov_16.348729	2929	3000	522	1	71	0.0140845
NODE_197_length_5057_cov_16.348729	2929	3000	528	1	71	0.0140845
NODE_197_length_5057_cov_16.348729	2929	3000	530	2	71	0.0281690
NODE_197_length_5057_cov_16.348729	2929	3000	531	1	71	0.0140845
NODE_197_length_5057_cov_16.348729	2929	3000	533	1	71	0.0140845
NODE_197_length_5057_cov_16.348729	2929	3000	535	1	71	0.0140845
NODE_197_length_5057_cov_16.348729	2929	3000	537	1	71	0.0140845
NODE_197_length_5057_cov_16.348729	2929	3000	541	2	71	0.0281690
NODE_197_length_5057_cov_16.348729	2929	3000	543	2	71	0.0281690
NODE_197_length_5057_cov_16.348729	2929	3000	546	1	71	0.0140845
NODE_197_length_5057_cov_16.348729	2929	3000	551	1	71	0.0140845
NODE_197_length_5057_cov_16.348729	2929	3000	552	1	71	0.0140845
NODE_197_length_5057_cov_16.348729	2929	3000	560	2	71	0.0281690
NODE_197_length_5057_cov_16.348729	2929	3000	562	1	71	0.0140845
NODE_197_length_5057_cov_16.348729	2929	3000	568	1	71	0.0140845
NODE_197_length_5057_cov_16.348729	2929	3000	572	2	71	0.0281690
NODE_197_length_5057_cov_16.348729	2929	3000	573	2	71	0.0281690
NODE_197_length_5057_cov_16.348729	2929	3000	575	1	71	0.0140845
NODE_197_length_5057_cov_16.348729	2929	3000	578	2	71	0.0281690
NODE_197_length_5057_cov_16.348729	2929	3000	580	2	71	0.0281690
NODE_197_length_5057_cov_16.348729	2973	3012	528	1	39	0.0256410
NODE_197_length_5057_cov_16.348729	2973	3012	530	2	39	0.0512821
NODE_197_length_5057_cov_16.348729	2973	3012	531	1	39	0.0256410
NODE_197_length_5057_cov_16.348729	2973	3012	533	1	39	0.0256410
NODE_197_length_5057_cov_16.348729	2973	3012	535	1	39	0.0256410
NODE_197_length_5057_cov_16.348729	2973	3012	537	1	39	0.0256410
NODE_197_length_5057_cov_16.348729	2973	3012	541	2	39	0.0512821
NODE_197_length_5057_cov_16.348729	2973	3012	543	2	39	0.0512821
NODE_197_length_5057_cov_16.348729	2973	3012	546	1	39	0.0256410
NODE_197_length_5057_cov_16.348729	2973	3012	551	1	39	0.0256410
NODE_197_length_5057_cov_16.348729	2973	3012	552	1	39	0.0256410
NODE_197_length_5057_cov_16.348729	2973	3012	560	2	39	0.0512821
NODE_197_length_5057_cov_16.348729	2973	3012	562	1	39	0.0256410
NODE_197_length_5057_cov_16.348729	2973	3012	568	1	39	0.0256410
NODE_197_length_5057_cov_16.348729	2973	3012	572	3	39	0.0769231
NODE_197_length_5057_cov_16.348729	2973	3012	573	2	39	0.0512821
NODE_197_length_5057_cov_16.348729	2973	3012	575	1	39	0.0256410
NODE_197_length_5057_cov_16.348729	2973	3012	576	2	39	0.0512821
NODE_197_length_5057_cov_16.348729	2973	3012	578	4	39	0.1025641
NODE_197_length_5057_cov_16.348729	2973	3012	579	2	39	0.0512821
NODE_197_length_5057_cov_16.348729	2973	3012	580	3	39	0.0769231
NODE_197_length_5057_cov_16.348729	2973	3012	582	1	39	0.0256410
NODE_197_length_5057_cov_16.348729	2973	3012	584	1	39	0.0256410
NODE_197_length_5057_cov_16.348729	2973	3012	585	1	39	0.0256410
NODE_197_length_5057_cov_16.348729	2973	3012	588	1	39	0.0256410
NODE_198_length_5053_cov_11.281994	791	834	0	20	43	0.4651163
NODE_198_length_5053_cov_11.281994	791	834	2	23	43	0.5348837
NODE_198_length_5053_cov_11.281994	807	887	0	73	80	0.9125000
NODE_198_length_5053_cov_11.281994	807	887	2	7	80	0.0875000
NODE_198_length_5053_cov_11.281994	883	963	0	80	80	1.0000000
NODE_198_length_5053_cov_11.281994	936	999	0	63	63	1.0000000
NODE_204_length_4906_cov_37.988350	3170	3251	16	1	81	0.0123457
NODE_204_length_4906_cov_37.988350	3170	3251	24	1	81	0.0123457
NODE_204_length_4906_cov_37.988350	3170	3251	25	2	81	0.0246914
NODE_204_length_4906_cov_37.988350	3170	3251	29	1	81	0.0123457
NODE_204_length_4906_cov_37.988350	3170	3251	32	1	81	0.0123457
NODE_204_length_4906_cov_37.988350	3170	3251	35	1	81	0.0123457
NODE_204_length_4906_cov_37.988350	3170	3251	40	1	81	0.0123457
NODE_204_length_4906_cov_37.988350	3170	3251	42	2	81	0.0246914
NODE_204_length_4906_cov_37.988350	3170	3251	46	2	81	0.0246914
NODE_204_length_4906_cov_37.988350	3170	3251	47	1	81	0.0123457
NODE_204_length_4906_cov_37.988350	3170	3251	49	3	81	0.0370370
NODE_204_length_4906_cov_37.988350	3170	3251	51	1	81	0.0123457
NODE_204_length_4906_cov_37.988350	3170	3251	52	1	81	0.0123457
NODE_204_length_4906_cov_37.988350	3170	3251	54	1	81	0.0123457
NODE_204_length_4906_cov_37.988350	3170	3251	56	2	81	0.0246914
NODE_204_length_4906_cov_37.988350	3170	3251	58	1	81	0.0123457
NODE_204_length_4906_cov_37.988350	3170	3251	60	1	81	0.0123457
NODE_204_length_4906_cov_37.988350	3170	3251	67	1	81	0.0123457
NODE_204_length_4906_cov_37.988350	3170	3251	75	1	81	0.0123457
NODE_204_length_4906_cov_37.988350	3170	3251	89	2	81	0.0246914
NODE_204_length_4906_cov_37.988350	3170	3251	91	2	81	0.0246914
NODE_204_length_4906_cov_37.988350	3170	3251	94	6	81	0.0740741
NODE_204_length_4906_cov_37.988350	3170	3251	96	1	81	0.0123457
NODE_204_length_4906_cov_37.988350	3170	3251	97	1	81	0.0123457
NODE_204_length_4906_cov_37.988350	3170	3251	99	2	81	0.0246914
NODE_204_length_4906_cov_37.988350	3170	3251	100	1	81	0.0123457
NODE_204_length_4906_cov_37.988350	3170	3251	103	3	81	0.0370370
NODE_204_length_4906_cov_37.988350	3170	3251	107	1	81	0.0123457
NODE_204_length_4906_cov_37.988350	3170	3251	111	1	81	0.0123457
NODE_204_length_4906_cov_37.988350	3170	3251	112	1	81	0.0123457
NODE_204_length_4906_cov_37.988350	3170	3251	117	1	81	0.0123457
NODE_204_length_4906_cov_37.988350	3170	3251	118	1	81	0.0123457
NODE_204_length_4906_cov_37.988350	3170	3251	120	2	81	0.0246914
NODE_204_length_4906_cov_37.988350	3170	3251	122	1	81	0.0123457
NODE_204_length_4906_cov_37.988350	3170	3251	129	1	81	0.0123457
NODE_204_length_4906_cov_37.988350	3170	3251	134	1	81	0.0123457
NODE_204_length_4906_cov_37.988350	3170	3251	148	1	81	0.0123457
NODE_204_length_4906_cov_37.988350	3170	3251	155	1	81	0.0123457
NODE_204_length_4906_cov_37.988350	3170	3251	160	2	81	0.0246914
NODE_204_length_4906_cov_37.988350	3170	3251	181	1	81	0.0123457
NODE_204_length_4906_cov_37.988350	3170	3251	183	1	81	0.0123457
NODE_204_length_4906_cov_37.988350	3170	3251	185	1	81	0.0123457
NODE_204_length_4906_cov_37.988350	3170	3251	187	1	81	0.0123457
NODE_204_length_4906_cov_37.988350	3170	3251	195	1	81	0.0123457
NODE_204_length_4906_cov_37.988350	3170	3251	204	2	81	0.0246914
NODE_204_length_4906_cov_37.988350	3170	3251	215	1	81	0.0123457
NODE_204_length_4906_cov_37.988350	3170	3251	219	1	81	0.0123457
NODE_204_length_4906_cov_37.988350	3170	3251	226	3	81	0.0370370
NODE_204_length_4906_cov_37.988350	3170	3251	229	1	81	0.0123457
NODE_204_length_4906_cov_37.988350	3170	3251	232	2	81	0.0246914
NODE_204_length_4906_cov_37.988350	3170	3251	235	1	81	0.0123457
NODE_204_length_4906_cov_37.988350	3170	3251	239	2	81	0.0246914
NODE_204_length_4906_cov_37.988350	3170	3251	249	1	81	0.0123457
NODE_204_length_4906_cov_37.988350	3170	3251	250	1	81	0.0123457
NODE_204_length_4906_cov_37.988350	3170	3251	251	1	81	0.0123457
NODE_204_length_4906_cov_37.988350	3170	3251	254	1	81	0.0123457
NODE_204_length_4906_cov_37.988350	3170	3251	261	1	81	0.0123457
NODE_204_length_4906_cov_37.988350	3170	3251	269	1	81	0.0123457
NODE_205_length_4888_cov_60.162247	4029	4068	6	36	39	0.9230769
NODE_205_length_4888_cov_60.162247	4029	4068	14	2	39	0.0512821
NODE_205_length_4888_cov_60.162247	4029	4068	15	1	39	0.0256410
NODE_205_length_4888_cov_60.162247	4041	4121	0	10	80	0.1250000
NODE_205_length_4888_cov_60.162247	4041	4121	2	17	80	0.2125000
NODE_205_length_4888_cov_60.162247	4041	4121	6	53	80	0.6625000
NODE_207_length_4875_cov_63.035176	2905	2985	0	80	80	1.0000000
NODE_207_length_4875_cov_63.035176	2958	3038	0	43	80	0.5375000
NODE_207_length_4875_cov_63.035176	2958	3038	2	1	80	0.0125000
NODE_207_length_4875_cov_63.035176	2958	3038	5	36	80	0.4500000
NODE_208_length_4875_cov_8.996859	4683	4760	0	77	77	1.0000000
NODE_208_length_4875_cov_8.996859	4736	4813	0	77	77	1.0000000
NODE_211_length_4827_cov_15.364636	1803	1865	35	1	62	0.0161290
NODE_211_length_4827_cov_15.364636	1803	1865	40	1	62	0.0161290
NODE_211_length_4827_cov_15.364636	1803	1865	41	4	62	0.0645161
NODE_211_length_4827_cov_15.364636	1803	1865	42	1	62	0.0161290
NODE_211_length_4827_cov_15.364636	1803	1865	44	3	62	0.0483871
NODE_211_length_4827_cov_15.364636	1803	1865	45	1	62	0.0161290
NODE_211_length_4827_cov_15.364636	1803	1865	46	8	62	0.1290323
NODE_211_length_4827_cov_15.364636	1803	1865	47	2	62	0.0322581
NODE_211_length_4827_cov_15.364636	1803	1865	49	1	62	0.0161290
NODE_211_length_4827_cov_15.364636	1803	1865	57	2	62	0.0322581
NODE_211_length_4827_cov_15.364636	1803	1865	59	1	62	0.0161290
NODE_211_length_4827_cov_15.364636	1803	1865	61	2	62	0.0322581
NODE_211_length_4827_cov_15.364636	1803	1865	62	1	62	0.0161290
NODE_211_length_4827_cov_15.364636	1803	1865	63	1	62	0.0161290
NODE_211_length_4827_cov_15.364636	1803	1865	64	2	62	0.0322581
NODE_211_length_4827_cov_15.364636	1803	1865	66	1	62	0.0161290
NODE_211_length_4827_cov_15.364636	1803	1865	67	1	62	0.0161290
NODE_211_length_4827_cov_15.364636	1803	1865	68	2	62	0.0322581
NODE_211_length_4827_cov_15.364636	1803	1865	73	2	62	0.0322581
NODE_211_length_4827_cov_15.364636	1803	1865	75	2	62	0.0322581
NODE_211_length_4827_cov_15.364636	1803	1865	77	2	62	0.0322581
NODE_211_length_4827_cov_15.364636	1803	1865	82	1	62	0.0161290
NODE_211_length_4827_cov_15.364636	1803	1865	83	1	62	0.0161290
NODE_211_length_4827_cov_15.364636	1803	1865	92	1	62	0.0161290
NODE_211_length_4827_cov_15.364636	1803	1865	94	1	62	0.0161290
NODE_211_length_4827_cov_15.364636	1803	1865	102	3	62	0.0483871
NODE_211_length_4827_cov_15.364636	1803	1865	103	1	62	0.0161290
NODE_211_length_4827_cov_15.364636	1803	1865	105	1	62	0.0161290
NODE_211_length_4827_cov_15.364636	1803	1865	109	4	62	0.0645161
NODE_211_length_4827_cov_15.364636	1803	1865	113	2	62	0.0322581
NODE_211_length_4827_cov_15.364636	1803	1865	123	4	62	0.0645161
NODE_211_length_4827_cov_15.364636	1803	1865	133	1	62	0.0161290
NODE_211_length_4827_cov_15.364636	1803	1865	139	1	62	0.0161290
NODE_211_length_4827_cov_15.364636	1899	1979	41	1	80	0.0125000
NODE_211_length_4827_cov_15.364636	1899	1979	46	1	80	0.0125000
NODE_211_length_4827_cov_15.364636	1899	1979	50	3	80	0.0375000
NODE_211_length_4827_cov_15.364636	1899	1979	55	1	80	0.0125000
NODE_211_length_4827_cov_15.364636	1899	1979	56	2	80	0.0250000
NODE_211_length_4827_cov_15.364636	1899	1979	58	2	80	0.0250000
NODE_211_length_4827_cov_15.364636	1899	1979	60	9	80	0.1125000
NODE_211_length_4827_cov_15.364636	1899	1979	62	3	80	0.0375000
NODE_211_length_4827_cov_15.364636	1899	1979	64	18	80	0.2250000
NODE_211_length_4827_cov_15.364636	1899	1979	66	19	80	0.2375000
NODE_211_length_4827_cov_15.364636	1899	1979	68	14	80	0.1750000
NODE_211_length_4827_cov_15.364636	1899	1979	70	7	80	0.0875000
NODE_211_length_4827_cov_15.364636	1952	1996	46	7	44	0.1590909
NODE_211_length_4827_cov_15.364636	1952	1996	50	2	44	0.0454545
NODE_211_length_4827_cov_15.364636	1952	1996	52	6	44	0.1363636
NODE_211_length_4827_cov_15.364636	1952	1996	54	2	44	0.0454545
NODE_211_length_4827_cov_15.364636	1952	1996	55	1	44	0.0227273
NODE_211_length_4827_cov_15.364636	1952	1996	56	2	44	0.0454545
NODE_211_length_4827_cov_15.364636	1952	1996	58	1	44	0.0227273
NODE_211_length_4827_cov_15.364636	1952	1996	60	9	44	0.2045455
NODE_211_length_4827_cov_15.364636	1952	1996	62	2	44	0.0454545
NODE_211_length_4827_cov_15.364636	1952	1996	64	10	44	0.2272727
NODE_211_length_4827_cov_15.364636	1952	1996	68	2	44	0.0454545
NODE_212_length_4821_cov_10.856840	999	1061	2	13	62	0.2096774
NODE_212_length_4821_cov_10.856840	999	1061	5	21	62	0.3387097
NODE_212_length_4821_cov_10.856840	999	1061	8	28	62	0.4516129
NODE_213_length_4819_cov_16.363347	2392	2461	18	2	69	0.0289855
NODE_213_length_4819_cov_16.363347	2392	2461	20	12	69	0.1739130
NODE_213_length_4819_cov_16.363347	2392	2461	22	9	69	0.1304348
NODE_213_length_4819_cov_16.363347	2392	2461	24	6	69	0.0869565
NODE_213_length_4819_cov_16.363347	2392	2461	26	1	69	0.0144928
NODE_213_length_4819_cov_16.363347	2392	2461	28	2	69	0.0289855
NODE_213_length_4819_cov_16.363347	2392	2461	30	2	69	0.0289855
NODE_213_length_4819_cov_16.363347	2392	2461	32	35	69	0.5072464
NODE_217_length_4794_cov_14.912886	657	737	52	1	80	0.0125000
NODE_217_length_4794_cov_14.912886	657	737	54	4	80	0.0500000
NODE_217_length_4794_cov_14.912886	657	737	56	1	80	0.0125000
NODE_217_length_4794_cov_14.912886	657	737	62	7	80	0.0875000
NODE_217_length_4794_cov_14.912886	657	737	64	1	80	0.0125000
NODE_217_length_4794_cov_14.912886	657	737	70	2	80	0.0250000
NODE_217_length_4794_cov_14.912886	657	737	72	5	80	0.0625000
NODE_217_length_4794_cov_14.912886	657	737	74	1	80	0.0125000
NODE_217_length_4794_cov_14.912886	657	737	76	2	80	0.0250000
NODE_217_length_4794_cov_14.912886	657	737	78	3	80	0.0375000
NODE_217_length_4794_cov_14.912886	657	737	80	5	80	0.0625000
NODE_217_length_4794_cov_14.912886	657	737	82	1	80	0.0125000
NODE_217_length_4794_cov_14.912886	657	737	84	5	80	0.0625000
NODE_217_length_4794_cov_14.912886	657	737	86	3	80	0.0375000
NODE_217_length_4794_cov_14.912886	657	737	88	7	80	0.0875000
NODE_217_length_4794_cov_14.912886	657	737	90	2	80	0.0250000
NODE_217_length_4794_cov_14.912886	657	737	91	4	80	0.0500000
NODE_217_length_4794_cov_14.912886	657	737	92	4	80	0.0500000
NODE_217_length_4794_cov_14.912886	657	737	93	4	80	0.0500000
NODE_217_length_4794_cov_14.912886	657	737	94	9	80	0.1125000
NODE_217_length_4794_cov_14.912886	657	737	96	9	80	0.1125000
NODE_217_length_4794_cov_14.912886	4240	4312	2	22	72	0.3055556
NODE_217_length_4794_cov_14.912886	4240	4312	4	50	72	0.6944444
NODE_217_length_4794_cov_14.912886	4293	4312	4	19	19	1.0000000
NODE_217_length_4794_cov_14.912886	4345	4408	7	9	63	0.1428571
NODE_217_length_4794_cov_14.912886	4345	4408	8	9	63	0.1428571
NODE_217_length_4794_cov_14.912886	4345	4408	9	30	63	0.4761905
NODE_217_length_4794_cov_14.912886	4345	4408	11	1	63	0.0158730
NODE_217_length_4794_cov_14.912886	4345	4408	13	14	63	0.2222222
NODE_218_length_4791_cov_16.126172	2438	2518	0	80	80	1.0000000
NODE_218_length_4791_cov_16.126172	2491	2571	0	80	80	1.0000000
NODE_218_length_4791_cov_16.126172	2567	2647	0	80	80	1.0000000
NODE_218_length_4791_cov_16.126172	2620	2700	0	80	80	1.0000000
NODE_218_length_4791_cov_16.126172	4607	4687	0	35	80	0.4375000
NODE_218_length_4791_cov_16.126172	4607	4687	2	8	80	0.1000000
NODE_218_length_4791_cov_16.126172	4607	4687	4	37	80	0.4625000
NODE_219_length_4790_cov_9.713494	2159	2239	42	4	80	0.0500000
NODE_219_length_4790_cov_9.713494	2159	2239	44	6	80	0.0750000
NODE_219_length_4790_cov_9.713494	2159	2239	46	10	80	0.1250000
NODE_219_length_4790_cov_9.713494	2159	2239	50	1	80	0.0125000
NODE_219_length_4790_cov_9.713494	2159	2239	52	4	80	0.0500000
NODE_219_length_4790_cov_9.713494	2159	2239	54	8	80	0.1000000
NODE_219_length_4790_cov_9.713494	2159	2239	56	13	80	0.1625000
NODE_219_length_4790_cov_9.713494	2159	2239	57	8	80	0.1000000
NODE_219_length_4790_cov_9.713494	2159	2239	58	8	80	0.1000000
NODE_219_length_4790_cov_9.713494	2159	2239	59	1	80	0.0125000
NODE_219_length_4790_cov_9.713494	2159	2239	60	1	80	0.0125000
NODE_219_length_4790_cov_9.713494	2159	2239	61	8	80	0.1000000
NODE_219_length_4790_cov_9.713494	2159	2239	62	4	80	0.0500000
NODE_219_length_4790_cov_9.713494	2159	2239	63	2	80	0.0250000
NODE_219_length_4790_cov_9.713494	2159	2239	64	2	80	0.0250000
NODE_219_length_4790_cov_9.713494	4273	4353	14	1	80	0.0125000
NODE_219_length_4790_cov_9.713494	4273	4353	16	2	80	0.0250000
NODE_219_length_4790_cov_9.713494	4273	4353	17	27	80	0.3375000
NODE_219_length_4790_cov_9.713494	4273	4353	18	30	80	0.3750000
NODE_219_length_4790_cov_9.713494	4273	4353	20	20	80	0.2500000
NODE_219_length_4790_cov_9.713494	4273	4335	14	1	62	0.0161290
NODE_219_length_4790_cov_9.713494	4273	4335	16	2	62	0.0322581
NODE_219_length_4790_cov_9.713494	4273	4335	17	27	62	0.4354839
NODE_219_length_4790_cov_9.713494	4273	4335	18	20	62	0.3225806
NODE_219_length_4790_cov_9.713494	4273	4335	20	12	62	0.1935484
NODE_219_length_4790_cov_9.713494	4326	4406	6	18	80	0.2250000
NODE_219_length_4790_cov_9.713494	4326	4406	7	1	80	0.0125000
NODE_219_length_4790_cov_9.713494	4326	4406	8	19	80	0.2375000
NODE_219_length_4790_cov_9.713494	4326	4406	12	1	80	0.0125000
NODE_219_length_4790_cov_9.713494	4326	4406	14	5	80	0.0625000
NODE_219_length_4790_cov_9.713494	4326	4406	16	6	80	0.0750000
NODE_219_length_4790_cov_9.713494	4326	4406	18	20	80	0.2500000
NODE_219_length_4790_cov_9.713494	4326	4406	20	10	80	0.1250000
NODE_221_length_4772_cov_10.560454	4281	4367	0	86	86	1.0000000
NODE_222_length_4770_cov_106.953543	2778	2858	52	8	80	0.1000000
NODE_222_length_4770_cov_106.953543	2778	2858	54	7	80	0.0875000
NODE_222_length_4770_cov_106.953543	2778	2858	55	1	80	0.0125000
NODE_222_length_4770_cov_106.953543	2778	2858	56	6	80	0.0750000
NODE_222_length_4770_cov_106.953543	2778	2858	57	3	80	0.0375000
NODE_222_length_4770_cov_106.953543	2778	2858	58	12	80	0.1500000
NODE_222_length_4770_cov_106.953543	2778	2858	59	5	80	0.0625000
NODE_222_length_4770_cov_106.953543	2778	2858	60	16	80	0.2000000
NODE_222_length_4770_cov_106.953543	2778	2858	61	2	80	0.0250000
NODE_222_length_4770_cov_106.953543	2778	2858	62	3	80	0.0375000
NODE_222_length_4770_cov_106.953543	2778	2858	63	1	80	0.0125000
NODE_222_length_4770_cov_106.953543	2778	2858	64	4	80	0.0500000
NODE_222_length_4770_cov_106.953543	2778	2858	65	3	80	0.0375000
NODE_222_length_4770_cov_106.953543	2778	2858	66	5	80	0.0625000
NODE_222_length_4770_cov_106.953543	2778	2858	68	4	80	0.0500000
NODE_222_length_4770_cov_106.953543	2831	2911	48	1	80	0.0125000
NODE_222_length_4770_cov_106.953543	2831	2911	50	6	80	0.0750000
NODE_222_length_4770_cov_106.953543	2831	2911	52	4	80	0.0500000
NODE_222_length_4770_cov_106.953543	2831	2911	54	5	80	0.0625000
NODE_222_length_4770_cov_106.953543	2831	2911	55	9	80	0.1125000
NODE_222_length_4770_cov_106.953543	2831	2911	56	7	80	0.0875000
NODE_222_length_4770_cov_106.953543	2831	2911	57	5	80	0.0625000
NODE_222_length_4770_cov_106.953543	2831	2911	58	4	80	0.0500000
NODE_222_length_4770_cov_106.953543	2831	2911	59	5	80	0.0625000
NODE_222_length_4770_cov_106.953543	2831	2911	60	3	80	0.0375000
NODE_222_length_4770_cov_106.953543	2831	2911	61	12	80	0.1500000
NODE_222_length_4770_cov_106.953543	2831	2911	63	4	80	0.0500000
NODE_222_length_4770_cov_106.953543	2831	2911	67	1	80	0.0125000
NODE_222_length_4770_cov_106.953543	2831	2911	68	1	80	0.0125000
NODE_222_length_4770_cov_106.953543	2831	2911	70	3	80	0.0375000
NODE_222_length_4770_cov_106.953543	2831	2911	76	3	80	0.0375000
NODE_222_length_4770_cov_106.953543	2831	2911	78	7	80	0.0875000
NODE_222_length_4770_cov_106.953543	2907	2987	78	5	80	0.0625000
NODE_222_length_4770_cov_106.953543	2907	2987	81	1	80	0.0125000
NODE_222_length_4770_cov_106.953543	2907	2987	82	1	80	0.0125000
NODE_222_length_4770_cov_106.953543	2907	2987	84	1	80	0.0125000
NODE_222_length_4770_cov_106.953543	2907	2987	86	1	80	0.0125000
NODE_222_length_4770_cov_106.953543	2907	2987	87	3	80	0.0375000
NODE_222_length_4770_cov_106.953543	2907	2987	93	1	80	0.0125000
NODE_222_length_4770_cov_106.953543	2907	2987	97	2	80	0.0250000
NODE_222_length_4770_cov_106.953543	2907	2987	101	1	80	0.0125000
NODE_222_length_4770_cov_106.953543	2907	2987	103	1	80	0.0125000
NODE_222_length_4770_cov_106.953543	2907	2987	105	1	80	0.0125000
NODE_222_length_4770_cov_106.953543	2907	2987	109	2	80	0.0250000
NODE_222_length_4770_cov_106.953543	2907	2987	111	1	80	0.0125000
NODE_222_length_4770_cov_106.953543	2907	2987	117	1	80	0.0125000
NODE_222_length_4770_cov_106.953543	2907	2987	125	1	80	0.0125000
NODE_222_length_4770_cov_106.953543	2907	2987	130	1	80	0.0125000
NODE_222_length_4770_cov_106.953543	2907	2987	138	1	80	0.0125000
NODE_222_length_4770_cov_106.953543	2907	2987	141	3	80	0.0375000
NODE_222_length_4770_cov_106.953543	2907	2987	143	2	80	0.0250000
NODE_222_length_4770_cov_106.953543	2907	2987	147	1	80	0.0125000
NODE_222_length_4770_cov_106.953543	2907	2987	149	1	80	0.0125000
NODE_222_length_4770_cov_106.953543	2907	2987	151	2	80	0.0250000
NODE_222_length_4770_cov_106.953543	2907	2987	153	1	80	0.0125000
NODE_222_length_4770_cov_106.953543	2907	2987	166	1	80	0.0125000
NODE_222_length_4770_cov_106.953543	2907	2987	170	2	80	0.0250000
NODE_222_length_4770_cov_106.953543	2907	2987	172	5	80	0.0625000
NODE_222_length_4770_cov_106.953543	2907	2987	176	3	80	0.0375000
NODE_222_length_4770_cov_106.953543	2907	2987	178	2	80	0.0250000
NODE_222_length_4770_cov_106.953543	2907	2987	180	3	80	0.0375000
NODE_222_length_4770_cov_106.953543	2907	2987	182	3	80	0.0375000
NODE_222_length_4770_cov_106.953543	2907	2987	183	1	80	0.0125000
NODE_222_length_4770_cov_106.953543	2907	2987	185	2	80	0.0250000
NODE_222_length_4770_cov_106.953543	2907	2987	186	1	80	0.0125000
NODE_222_length_4770_cov_106.953543	2907	2987	187	2	80	0.0250000
NODE_222_length_4770_cov_106.953543	2907	2987	188	2	80	0.0250000
NODE_222_length_4770_cov_106.953543	2907	2987	190	1	80	0.0125000
NODE_222_length_4770_cov_106.953543	2907	2987	192	2	80	0.0250000
NODE_222_length_4770_cov_106.953543	2907	2987	194	1	80	0.0125000
NODE_222_length_4770_cov_106.953543	2907	2987	195	1	80	0.0125000
NODE_222_length_4770_cov_106.953543	2907	2987	196	2	80	0.0250000
NODE_222_length_4770_cov_106.953543	2907	2987	197	1	80	0.0125000
NODE_222_length_4770_cov_106.953543	2907	2987	198	6	80	0.0750000
NODE_222_length_4770_cov_106.953543	2907	2987	199	1	80	0.0125000
NODE_222_length_4770_cov_106.953543	2907	2987	202	3	80	0.0375000
NODE_222_length_4770_cov_106.953543	2960	3040	159	1	80	0.0125000
NODE_222_length_4770_cov_106.953543	2960	3040	162	2	80	0.0250000
NODE_222_length_4770_cov_106.953543	2960	3040	163	2	80	0.0250000
NODE_222_length_4770_cov_106.953543	2960	3040	164	1	80	0.0125000
NODE_222_length_4770_cov_106.953543	2960	3040	166	1	80	0.0125000
NODE_222_length_4770_cov_106.953543	2960	3040	169	1	80	0.0125000
NODE_222_length_4770_cov_106.953543	2960	3040	170	3	80	0.0375000
NODE_222_length_4770_cov_106.953543	2960	3040	172	1	80	0.0125000
NODE_222_length_4770_cov_106.953543	2960	3040	176	2	80	0.0250000
NODE_222_length_4770_cov_106.953543	2960	3040	178	2	80	0.0250000
NODE_222_length_4770_cov_106.953543	2960	3040	179	3	80	0.0375000
NODE_222_length_4770_cov_106.953543	2960	3040	180	2	80	0.0250000
NODE_222_length_4770_cov_106.953543	2960	3040	182	3	80	0.0375000
NODE_222_length_4770_cov_106.953543	2960	3040	183	1	80	0.0125000
NODE_222_length_4770_cov_106.953543	2960	3040	184	1	80	0.0125000
NODE_222_length_4770_cov_106.953543	2960	3040	185	3	80	0.0375000
NODE_222_length_4770_cov_106.953543	2960	3040	186	1	80	0.0125000
NODE_222_length_4770_cov_106.953543	2960	3040	187	2	80	0.0250000
NODE_222_length_4770_cov_106.953543	2960	3040	188	2	80	0.0250000
NODE_222_length_4770_cov_106.953543	2960	3040	190	1	80	0.0125000
NODE_222_length_4770_cov_106.953543	2960	3040	192	3	80	0.0375000
NODE_222_length_4770_cov_106.953543	2960	3040	194	1	80	0.0125000
NODE_222_length_4770_cov_106.953543	2960	3040	195	2	80	0.0250000
NODE_222_length_4770_cov_106.953543	2960	3040	196	2	80	0.0250000
NODE_222_length_4770_cov_106.953543	2960	3040	197	4	80	0.0500000
NODE_222_length_4770_cov_106.953543	2960	3040	198	6	80	0.0750000
NODE_222_length_4770_cov_106.953543	2960	3040	199	6	80	0.0750000
NODE_222_length_4770_cov_106.953543	2960	3040	201	6	80	0.0750000
NODE_222_length_4770_cov_106.953543	2960	3040	202	4	80	0.0500000
NODE_222_length_4770_cov_106.953543	2960	3040	203	2	80	0.0250000
NODE_222_length_4770_cov_106.953543	2960	3040	205	5	80	0.0625000
NODE_222_length_4770_cov_106.953543	2960	3040	206	3	80	0.0375000
NODE_222_length_4770_cov_106.953543	2960	3040	207	1	80	0.0125000
NODE_223_length_4768_cov_15.447205	1237	1317	30	1	80	0.0125000
NODE_223_length_4768_cov_15.447205	1237	1317	31	1	80	0.0125000
NODE_223_length_4768_cov_15.447205	1237	1317	34	6	80	0.0750000
NODE_223_length_4768_cov_15.447205	1237	1317	38	1	80	0.0125000
NODE_223_length_4768_cov_15.447205	1237	1317	40	2	80	0.0250000
NODE_223_length_4768_cov_15.447205	1237	1317	42	8	80	0.1000000
NODE_223_length_4768_cov_15.447205	1237	1317	44	8	80	0.1000000
NODE_223_length_4768_cov_15.447205	1237	1317	46	3	80	0.0375000
NODE_223_length_4768_cov_15.447205	1237	1317	48	1	80	0.0125000
NODE_223_length_4768_cov_15.447205	1237	1317	49	9	80	0.1125000
NODE_223_length_4768_cov_15.447205	1237	1317	50	9	80	0.1125000
NODE_223_length_4768_cov_15.447205	1237	1317	52	4	80	0.0500000
NODE_223_length_4768_cov_15.447205	1237	1317	54	9	80	0.1125000
NODE_223_length_4768_cov_15.447205	1237	1317	56	4	80	0.0500000
NODE_223_length_4768_cov_15.447205	1237	1317	57	1	80	0.0125000
NODE_223_length_4768_cov_15.447205	1237	1317	58	1	80	0.0125000
NODE_223_length_4768_cov_15.447205	1237	1317	59	1	80	0.0125000
NODE_223_length_4768_cov_15.447205	1237	1317	60	11	80	0.1375000
NODE_228_length_4730_cov_30.142734	256	336	0	64	80	0.8000000
NODE_228_length_4730_cov_30.142734	256	336	2	16	80	0.2000000
NODE_228_length_4730_cov_30.142734	309	389	0	11	80	0.1375000
NODE_228_length_4730_cov_30.142734	309	389	2	69	80	0.8625000
NODE_228_length_4730_cov_30.142734	4052	4132	4	13	80	0.1625000
NODE_228_length_4730_cov_30.142734	4052	4132	6	43	80	0.5375000
NODE_228_length_4730_cov_30.142734	4052	4132	8	13	80	0.1625000
NODE_228_length_4730_cov_30.142734	4052	4132	10	11	80	0.1375000
NODE_228_length_4730_cov_30.142734	4105	4185	4	23	80	0.2875000
NODE_228_length_4730_cov_30.142734	4105	4185	6	49	80	0.6125000
NODE_228_length_4730_cov_30.142734	4105	4185	8	8	80	0.1000000
NODE_231_length_4706_cov_25.522683	2181	2261	7	11	80	0.1375000
NODE_231_length_4706_cov_25.522683	2181	2261	9	4	80	0.0500000
NODE_231_length_4706_cov_25.522683	2181	2261	12	2	80	0.0250000
NODE_231_length_4706_cov_25.522683	2181	2261	14	6	80	0.0750000
NODE_231_length_4706_cov_25.522683	2181	2261	20	13	80	0.1625000
NODE_231_length_4706_cov_25.522683	2181	2261	21	2	80	0.0250000
NODE_231_length_4706_cov_25.522683	2181	2261	25	1	80	0.0125000
NODE_231_length_4706_cov_25.522683	2181	2261	30	1	80	0.0125000
NODE_231_length_4706_cov_25.522683	2181	2261	35	1	80	0.0125000
NODE_231_length_4706_cov_25.522683	2181	2261	38	3	80	0.0375000
NODE_231_length_4706_cov_25.522683	2181	2261	41	4	80	0.0500000
NODE_231_length_4706_cov_25.522683	2181	2261	42	2	80	0.0250000
NODE_231_length_4706_cov_25.522683	2181	2261	43	1	80	0.0125000
NODE_231_length_4706_cov_25.522683	2181	2261	46	1	80	0.0125000
NODE_231_length_4706_cov_25.522683	2181	2261	48	4	80	0.0500000
NODE_231_length_4706_cov_25.522683	2181	2261	52	1	80	0.0125000
NODE_231_length_4706_cov_25.522683	2181	2261	58	3	80	0.0375000
NODE_231_length_4706_cov_25.522683	2181	2261	62	1	80	0.0125000
NODE_231_length_4706_cov_25.522683	2181	2261	64	1	80	0.0125000
NODE_231_length_4706_cov_25.522683	2181	2261	66	2	80	0.0250000
NODE_231_length_4706_cov_25.522683	2181	2261	70	1	80	0.0125000
NODE_231_length_4706_cov_25.522683	2181	2261	72	4	80	0.0500000
NODE_231_length_4706_cov_25.522683	2181	2261	78	1	80	0.0125000
NODE_231_length_4706_cov_25.522683	2181	2261	79	2	80	0.0250000
NODE_231_length_4706_cov_25.522683	2181	2261	81	1	80	0.0125000
NODE_231_length_4706_cov_25.522683	2181	2261	85	1	80	0.0125000
NODE_231_length_4706_cov_25.522683	2181	2261	87	1	80	0.0125000
NODE_231_length_4706_cov_25.522683	2181	2261	90	5	80	0.0625000
NODE_231_length_4706_cov_25.522683	2234	2288	0	3	54	0.0555556
NODE_231_length_4706_cov_25.522683	2234	2288	1	4	54	0.0740741
NODE_231_length_4706_cov_25.522683	2234	2288	4	1	54	0.0185185
NODE_231_length_4706_cov_25.522683	2234	2288	5	10	54	0.1851852
NODE_231_length_4706_cov_25.522683	2234	2288	7	20	54	0.3703704
NODE_231_length_4706_cov_25.522683	2234	2288	9	4	54	0.0740741
NODE_231_length_4706_cov_25.522683	2234	2288	12	2	54	0.0370370
NODE_231_length_4706_cov_25.522683	2234	2288	14	6	54	0.1111111
NODE_231_length_4706_cov_25.522683	2234	2288	20	4	54	0.0740741
NODE_231_length_4706_cov_25.522683	3943	4026	24	4	83	0.0481928
NODE_231_length_4706_cov_25.522683	3943	4026	25	2	83	0.0240964
NODE_231_length_4706_cov_25.522683	3943	4026	26	3	83	0.0361446
NODE_231_length_4706_cov_25.522683	3943	4026	27	3	83	0.0361446
NODE_231_length_4706_cov_25.522683	3943	4026	28	7	83	0.0843373
NODE_231_length_4706_cov_25.522683	3943	4026	29	1	83	0.0120482
NODE_231_length_4706_cov_25.522683	3943	4026	30	8	83	0.0963855
NODE_231_length_4706_cov_25.522683	3943	4026	31	3	83	0.0361446
NODE_231_length_4706_cov_25.522683	3943	4026	32	2	83	0.0240964
NODE_231_length_4706_cov_25.522683	3943	4026	33	5	83	0.0602410
NODE_231_length_4706_cov_25.522683	3943	4026	34	4	83	0.0481928
NODE_231_length_4706_cov_25.522683	3943	4026	36	2	83	0.0240964
NODE_231_length_4706_cov_25.522683	3943	4026	38	7	83	0.0843373
NODE_231_length_4706_cov_25.522683	3943	4026	39	1	83	0.0120482
NODE_231_length_4706_cov_25.522683	3943	4026	40	2	83	0.0240964
NODE_231_length_4706_cov_25.522683	3943	4026	46	1	83	0.0120482
NODE_231_length_4706_cov_25.522683	3943	4026	48	2	83	0.0240964
NODE_231_length_4706_cov_25.522683	3943	4026	50	9	83	0.1084337
NODE_231_length_4706_cov_25.522683	3943	4026	58	3	83	0.0361446
NODE_231_length_4706_cov_25.522683	3943	4026	59	1	83	0.0120482
NODE_231_length_4706_cov_25.522683	3943	4026	60	5	83	0.0602410
NODE_231_length_4706_cov_25.522683	3943	4026	62	6	83	0.0722892
NODE_231_length_4706_cov_25.522683	3943	4026	64	1	83	0.0120482
NODE_231_length_4706_cov_25.522683	3943	4026	66	1	83	0.0120482
NODE_235_length_4693_cov_16.973008	374	454	8	7	80	0.0875000
NODE_235_length_4693_cov_16.973008	374	454	9	2	80	0.0250000
NODE_235_length_4693_cov_16.973008	374	454	10	16	80	0.2000000
NODE_235_length_4693_cov_16.973008	374	454	12	4	80	0.0500000
NODE_235_length_4693_cov_16.973008	374	454	14	9	80	0.1125000
NODE_235_length_4693_cov_16.973008	374	454	16	8	80	0.1000000
NODE_235_length_4693_cov_16.973008	374	454	18	2	80	0.0250000
NODE_235_length_4693_cov_16.973008	374	454	20	1	80	0.0125000
NODE_235_length_4693_cov_16.973008	374	454	23	2	80	0.0250000
NODE_235_length_4693_cov_16.973008	374	454	24	6	80	0.0750000
NODE_235_length_4693_cov_16.973008	374	454	26	7	80	0.0875000
NODE_235_length_4693_cov_16.973008	374	454	28	15	80	0.1875000
NODE_235_length_4693_cov_16.973008	374	454	30	1	80	0.0125000
NODE_235_length_4693_cov_16.973008	427	507	22	4	80	0.0500000
NODE_235_length_4693_cov_16.973008	427	507	24	7	80	0.0875000
NODE_235_length_4693_cov_16.973008	427	507	26	13	80	0.1625000
NODE_235_length_4693_cov_16.973008	427	507	28	33	80	0.4125000
NODE_235_length_4693_cov_16.973008	427	507	29	1	80	0.0125000
NODE_235_length_4693_cov_16.973008	427	507	30	17	80	0.2125000
NODE_235_length_4693_cov_16.973008	427	507	32	5	80	0.0625000
NODE_240_length_4672_cov_39.029084	1391	1470	103	1	79	0.0126582
NODE_240_length_4672_cov_39.029084	1391	1470	109	1	79	0.0126582
NODE_240_length_4672_cov_39.029084	1391	1470	129	1	79	0.0126582
NODE_240_length_4672_cov_39.029084	1391	1470	181	1	79	0.0126582
NODE_240_length_4672_cov_39.029084	1391	1470	193	1	79	0.0126582
NODE_240_length_4672_cov_39.029084	1391	1470	201	1	79	0.0126582
NODE_240_length_4672_cov_39.029084	1391	1470	205	2	79	0.0253165
NODE_240_length_4672_cov_39.029084	1391	1470	209	1	79	0.0126582
NODE_240_length_4672_cov_39.029084	1391	1470	211	1	79	0.0126582
NODE_240_length_4672_cov_39.029084	1391	1470	221	1	79	0.0126582
NODE_240_length_4672_cov_39.029084	1391	1470	233	1	79	0.0126582
NODE_240_length_4672_cov_39.029084	1391	1470	243	1	79	0.0126582
NODE_240_length_4672_cov_39.029084	1391	1470	251	3	79	0.0379747
NODE_240_length_4672_cov_39.029084	1391	1470	255	1	79	0.0126582
NODE_240_length_4672_cov_39.029084	1391	1470	257	1	79	0.0126582
NODE_240_length_4672_cov_39.029084	1391	1470	261	1	79	0.0126582
NODE_240_length_4672_cov_39.029084	1391	1470	269	1	79	0.0126582
NODE_240_length_4672_cov_39.029084	1391	1470	276	1	79	0.0126582
NODE_240_length_4672_cov_39.029084	1391	1470	280	1	79	0.0126582
NODE_240_length_4672_cov_39.029084	1391	1470	284	1	79	0.0126582
NODE_240_length_4672_cov_39.029084	1391	1470	288	1	79	0.0126582
NODE_240_length_4672_cov_39.029084	1391	1470	299	1	79	0.0126582
NODE_240_length_4672_cov_39.029084	1391	1470	305	2	79	0.0253165
NODE_240_length_4672_cov_39.029084	1391	1470	313	1	79	0.0126582
NODE_240_length_4672_cov_39.029084	1391	1470	319	1	79	0.0126582
NODE_240_length_4672_cov_39.029084	1391	1470	323	1	79	0.0126582
NODE_240_length_4672_cov_39.029084	1391	1470	340	1	79	0.0126582
NODE_240_length_4672_cov_39.029084	1391	1470	355	1	79	0.0126582
NODE_240_length_4672_cov_39.029084	1391	1470	359	1	79	0.0126582
NODE_240_length_4672_cov_39.029084	1391	1470	360	1	79	0.0126582
NODE_240_length_4672_cov_39.029084	1391	1470	366	1	79	0.0126582
NODE_240_length_4672_cov_39.029084	1391	1470	372	1	79	0.0126582
NODE_240_length_4672_cov_39.029084	1391	1470	378	1	79	0.0126582
NODE_240_length_4672_cov_39.029084	1391	1470	380	1	79	0.0126582
NODE_240_length_4672_cov_39.029084	1391	1470	383	1	79	0.0126582
NODE_240_length_4672_cov_39.029084	1391	1470	388	2	79	0.0253165
NODE_240_length_4672_cov_39.029084	1391	1470	392	2	79	0.0253165
NODE_240_length_4672_cov_39.029084	1391	1470	396	2	79	0.0253165
NODE_240_length_4672_cov_39.029084	1391	1470	400	1	79	0.0126582
NODE_240_length_4672_cov_39.029084	1391	1470	404	1	79	0.0126582
NODE_240_length_4672_cov_39.029084	1391	1470	406	1	79	0.0126582
NODE_240_length_4672_cov_39.029084	1391	1470	409	1	79	0.0126582
NODE_240_length_4672_cov_39.029084	1391	1470	410	1	79	0.0126582
NODE_240_length_4672_cov_39.029084	1391	1470	421	1	79	0.0126582
NODE_240_length_4672_cov_39.029084	1391	1470	422	2	79	0.0253165
NODE_240_length_4672_cov_39.029084	1391	1470	423	1	79	0.0126582
NODE_240_length_4672_cov_39.029084	1391	1470	425	1	79	0.0126582
NODE_240_length_4672_cov_39.029084	1391	1470	428	2	79	0.0253165
NODE_240_length_4672_cov_39.029084	1391	1470	431	1	79	0.0126582
NODE_240_length_4672_cov_39.029084	1391	1470	437	3	79	0.0379747
NODE_240_length_4672_cov_39.029084	1391	1470	439	2	79	0.0253165
NODE_240_length_4672_cov_39.029084	1391	1470	444	1	79	0.0126582
NODE_240_length_4672_cov_39.029084	1391	1470	446	3	79	0.0379747
NODE_240_length_4672_cov_39.029084	1391	1470	447	2	79	0.0253165
NODE_240_length_4672_cov_39.029084	1391	1470	448	2	79	0.0253165
NODE_240_length_4672_cov_39.029084	1391	1470	449	2	79	0.0253165
NODE_240_length_4672_cov_39.029084	1391	1470	450	1	79	0.0126582
NODE_240_length_4672_cov_39.029084	1391	1470	451	4	79	0.0506329
NODE_240_length_4672_cov_39.029084	1391	1470	452	1	79	0.0126582
NODE_240_length_4672_cov_39.029084	1444	1523	154	1	79	0.0126582
NODE_240_length_4672_cov_39.029084	1444	1523	156	1	79	0.0126582
NODE_240_length_4672_cov_39.029084	1444	1523	180	1	79	0.0126582
NODE_240_length_4672_cov_39.029084	1444	1523	190	1	79	0.0126582
NODE_240_length_4672_cov_39.029084	1444	1523	206	1	79	0.0126582
NODE_240_length_4672_cov_39.029084	1444	1523	214	1	79	0.0126582
NODE_240_length_4672_cov_39.029084	1444	1523	226	1	79	0.0126582
NODE_240_length_4672_cov_39.029084	1444	1523	234	1	79	0.0126582
NODE_240_length_4672_cov_39.029084	1444	1523	243	1	79	0.0126582
NODE_240_length_4672_cov_39.029084	1444	1523	249	1	79	0.0126582
NODE_240_length_4672_cov_39.029084	1444	1523	255	1	79	0.0126582
NODE_240_length_4672_cov_39.029084	1444	1523	262	1	79	0.0126582
NODE_240_length_4672_cov_39.029084	1444	1523	276	1	79	0.0126582
NODE_240_length_4672_cov_39.029084	1444	1523	286	1	79	0.0126582
NODE_240_length_4672_cov_39.029084	1444	1523	288	1	79	0.0126582
NODE_240_length_4672_cov_39.029084	1444	1523	302	1	79	0.0126582
NODE_240_length_4672_cov_39.029084	1444	1523	312	1	79	0.0126582
NODE_240_length_4672_cov_39.029084	1444	1523	331	1	79	0.0126582
NODE_240_length_4672_cov_39.029084	1444	1523	344	4	79	0.0506329
NODE_240_length_4672_cov_39.029084	1444	1523	346	1	79	0.0126582
NODE_240_length_4672_cov_39.029084	1444	1523	354	1	79	0.0126582
NODE_240_length_4672_cov_39.029084	1444	1523	356	1	79	0.0126582
NODE_240_length_4672_cov_39.029084	1444	1523	368	1	79	0.0126582
NODE_240_length_4672_cov_39.029084	1444	1523	371	1	79	0.0126582
NODE_240_length_4672_cov_39.029084	1444	1523	376	1	79	0.0126582
NODE_240_length_4672_cov_39.029084	1444	1523	377	1	79	0.0126582
NODE_240_length_4672_cov_39.029084	1444	1523	379	1	79	0.0126582
NODE_240_length_4672_cov_39.029084	1444	1523	395	1	79	0.0126582
NODE_240_length_4672_cov_39.029084	1444	1523	399	2	79	0.0253165
NODE_240_length_4672_cov_39.029084	1444	1523	401	1	79	0.0126582
NODE_240_length_4672_cov_39.029084	1444	1523	404	1	79	0.0126582
NODE_240_length_4672_cov_39.029084	1444	1523	405	1	79	0.0126582
NODE_240_length_4672_cov_39.029084	1444	1523	407	1	79	0.0126582
NODE_240_length_4672_cov_39.029084	1444	1523	409	1	79	0.0126582
NODE_240_length_4672_cov_39.029084	1444	1523	420	2	79	0.0253165
NODE_240_length_4672_cov_39.029084	1444	1523	422	2	79	0.0253165
NODE_240_length_4672_cov_39.029084	1444	1523	427	1	79	0.0126582
NODE_240_length_4672_cov_39.029084	1444	1523	428	2	79	0.0253165
NODE_240_length_4672_cov_39.029084	1444	1523	431	1	79	0.0126582
NODE_240_length_4672_cov_39.029084	1444	1523	437	3	79	0.0379747
NODE_240_length_4672_cov_39.029084	1444	1523	438	2	79	0.0253165
NODE_240_length_4672_cov_39.029084	1444	1523	439	2	79	0.0253165
NODE_240_length_4672_cov_39.029084	1444	1523	442	2	79	0.0253165
NODE_240_length_4672_cov_39.029084	1444	1523	444	1	79	0.0126582
NODE_240_length_4672_cov_39.029084	1444	1523	445	1	79	0.0126582
NODE_240_length_4672_cov_39.029084	1444	1523	446	6	79	0.0759494
NODE_240_length_4672_cov_39.029084	1444	1523	447	2	79	0.0253165
NODE_240_length_4672_cov_39.029084	1444	1523	448	5	79	0.0632911
NODE_240_length_4672_cov_39.029084	1444	1523	449	3	79	0.0379747
NODE_240_length_4672_cov_39.029084	1444	1523	450	1	79	0.0126582
NODE_240_length_4672_cov_39.029084	1444	1523	451	4	79	0.0506329
NODE_240_length_4672_cov_39.029084	1444	1523	452	1	79	0.0126582
NODE_246_length_4602_cov_17.281368	3106	3186	0	44	80	0.5500000
NODE_246_length_4602_cov_17.281368	3106	3186	8	13	80	0.1625000
NODE_246_length_4602_cov_17.281368	3106	3186	10	23	80	0.2875000
NODE_246_length_4602_cov_17.281368	3159	3239	8	13	80	0.1625000
NODE_246_length_4602_cov_17.281368	3159	3239	10	67	80	0.8375000
NODE_248_length_4587_cov_14.431150	1294	1370	96	1	76	0.0131579
NODE_248_length_4587_cov_14.431150	1294	1370	99	1	76	0.0131579
NODE_248_length_4587_cov_14.431150	1294	1370	102	2	76	0.0263158
NODE_248_length_4587_cov_14.431150	1294	1370	104	1	76	0.0131579
NODE_248_length_4587_cov_14.431150	1294	1370	108	2	76	0.0263158
NODE_248_length_4587_cov_14.431150	1294	1370	111	1	76	0.0131579
NODE_248_length_4587_cov_14.431150	1294	1370	112	5	76	0.0657895
NODE_248_length_4587_cov_14.431150	1294	1370	114	1	76	0.0131579
NODE_248_length_4587_cov_14.431150	1294	1370	120	1	76	0.0131579
NODE_248_length_4587_cov_14.431150	1294	1370	122	2	76	0.0263158
NODE_248_length_4587_cov_14.431150	1294	1370	124	4	76	0.0526316
NODE_248_length_4587_cov_14.431150	1294	1370	128	1	76	0.0131579
NODE_248_length_4587_cov_14.431150	1294	1370	129	1	76	0.0131579
NODE_248_length_4587_cov_14.431150	1294	1370	130	1	76	0.0131579
NODE_248_length_4587_cov_14.431150	1294	1370	134	4	76	0.0526316
NODE_248_length_4587_cov_14.431150	1294	1370	136	2	76	0.0263158
NODE_248_length_4587_cov_14.431150	1294	1370	139	8	76	0.1052632
NODE_248_length_4587_cov_14.431150	1294	1370	140	7	76	0.0921053
NODE_248_length_4587_cov_14.431150	1294	1370	141	10	76	0.1315790
NODE_248_length_4587_cov_14.431150	1294	1370	142	6	76	0.0789474
NODE_248_length_4587_cov_14.431150	1294	1370	143	6	76	0.0789474
NODE_248_length_4587_cov_14.431150	1294	1370	144	7	76	0.0921053
NODE_248_length_4587_cov_14.431150	1294	1370	146	2	76	0.0263158
NODE_248_length_4587_cov_14.431150	1347	1427	134	4	80	0.0500000
NODE_248_length_4587_cov_14.431150	1347	1427	136	1	80	0.0125000
NODE_248_length_4587_cov_14.431150	1347	1427	140	6	80	0.0750000
NODE_248_length_4587_cov_14.431150	1347	1427	141	1	80	0.0125000
NODE_248_length_4587_cov_14.431150	1347	1427	142	1	80	0.0125000
NODE_248_length_4587_cov_14.431150	1347	1427	143	4	80	0.0500000
NODE_248_length_4587_cov_14.431150	1347	1427	144	5	80	0.0625000
NODE_248_length_4587_cov_14.431150	1347	1427	145	3	80	0.0375000
NODE_248_length_4587_cov_14.431150	1347	1427	146	2	80	0.0250000
NODE_248_length_4587_cov_14.431150	1347	1427	148	1	80	0.0125000
NODE_248_length_4587_cov_14.431150	1347	1427	149	1	80	0.0125000
NODE_248_length_4587_cov_14.431150	1347	1427	152	1	80	0.0125000
NODE_248_length_4587_cov_14.431150	1347	1427	156	4	80	0.0500000
NODE_248_length_4587_cov_14.431150	1347	1427	157	2	80	0.0250000
NODE_248_length_4587_cov_14.431150	1347	1427	158	12	80	0.1500000
NODE_248_length_4587_cov_14.431150	1347	1427	160	4	80	0.0500000
NODE_248_length_4587_cov_14.431150	1347	1427	161	6	80	0.0750000
NODE_248_length_4587_cov_14.431150	1347	1427	162	5	80	0.0625000
NODE_248_length_4587_cov_14.431150	1347	1427	163	5	80	0.0625000
NODE_248_length_4587_cov_14.431150	1347	1427	164	1	80	0.0125000
NODE_248_length_4587_cov_14.431150	1347	1427	165	4	80	0.0500000
NODE_248_length_4587_cov_14.431150	1347	1427	167	4	80	0.0500000
NODE_248_length_4587_cov_14.431150	1347	1427	169	1	80	0.0125000
NODE_248_length_4587_cov_14.431150	1347	1427	170	2	80	0.0250000
NODE_248_length_4587_cov_14.431150	1466	1533	136	1	67	0.0149254
NODE_248_length_4587_cov_14.431150	1466	1533	138	1	67	0.0149254
NODE_248_length_4587_cov_14.431150	1466	1533	140	2	67	0.0298507
NODE_248_length_4587_cov_14.431150	1466	1533	142	1	67	0.0149254
NODE_248_length_4587_cov_14.431150	1466	1533	143	1	67	0.0149254
NODE_248_length_4587_cov_14.431150	1466	1533	144	1	67	0.0149254
NODE_248_length_4587_cov_14.431150	1466	1533	146	1	67	0.0149254
NODE_248_length_4587_cov_14.431150	1466	1533	148	1	67	0.0149254
NODE_248_length_4587_cov_14.431150	1466	1533	150	1	67	0.0149254
NODE_248_length_4587_cov_14.431150	1466	1533	152	1	67	0.0149254
NODE_248_length_4587_cov_14.431150	1466	1533	154	1	67	0.0149254
NODE_248_length_4587_cov_14.431150	1466	1533	161	1	67	0.0149254
NODE_248_length_4587_cov_14.431150	1466	1533	162	2	67	0.0298507
NODE_248_length_4587_cov_14.431150	1466	1533	163	3	67	0.0447761
NODE_248_length_4587_cov_14.431150	1466	1533	164	4	67	0.0597015
NODE_248_length_4587_cov_14.431150	1466	1533	165	10	67	0.1492537
NODE_248_length_4587_cov_14.431150	1466	1533	166	1	67	0.0149254
NODE_248_length_4587_cov_14.431150	1466	1533	167	3	67	0.0447761
NODE_248_length_4587_cov_14.431150	1466	1533	168	1	67	0.0149254
NODE_248_length_4587_cov_14.431150	1466	1533	169	1	67	0.0149254
NODE_248_length_4587_cov_14.431150	1466	1533	170	3	67	0.0447761
NODE_248_length_4587_cov_14.431150	1466	1533	171	5	67	0.0746269
NODE_248_length_4587_cov_14.431150	1466	1533	172	2	67	0.0298507
NODE_248_length_4587_cov_14.431150	1466	1533	174	1	67	0.0149254
NODE_248_length_4587_cov_14.431150	1466	1533	175	9	67	0.1343284
NODE_248_length_4587_cov_14.431150	1466	1533	178	1	67	0.0149254
NODE_248_length_4587_cov_14.431150	1466	1533	179	3	67	0.0447761
NODE_248_length_4587_cov_14.431150	1466	1533	180	1	67	0.0149254
NODE_248_length_4587_cov_14.431150	1466	1533	181	3	67	0.0447761
NODE_248_length_4587_cov_14.431150	1466	1533	182	1	67	0.0149254
NODE_248_length_4587_cov_14.431150	4316	4382	236	1	66	0.0151515
NODE_248_length_4587_cov_14.431150	4316	4382	239	1	66	0.0151515
NODE_248_length_4587_cov_14.431150	4316	4382	243	1	66	0.0151515
NODE_248_length_4587_cov_14.431150	4316	4382	246	1	66	0.0151515
NODE_248_length_4587_cov_14.431150	4316	4382	251	1	66	0.0151515
NODE_248_length_4587_cov_14.431150	4316	4382	255	1	66	0.0151515
NODE_248_length_4587_cov_14.431150	4316	4382	259	1	66	0.0151515
NODE_248_length_4587_cov_14.431150	4316	4382	263	1	66	0.0151515
NODE_248_length_4587_cov_14.431150	4316	4382	273	1	66	0.0151515
NODE_248_length_4587_cov_14.431150	4316	4382	278	1	66	0.0151515
NODE_248_length_4587_cov_14.431150	4316	4382	280	1	66	0.0151515
NODE_248_length_4587_cov_14.431150	4316	4382	288	1	66	0.0151515
NODE_248_length_4587_cov_14.431150	4316	4382	291	1	66	0.0151515
NODE_248_length_4587_cov_14.431150	4316	4382	310	1	66	0.0151515
NODE_248_length_4587_cov_14.431150	4316	4382	312	1	66	0.0151515
NODE_248_length_4587_cov_14.431150	4316	4382	319	1	66	0.0151515
NODE_248_length_4587_cov_14.431150	4316	4382	321	1	66	0.0151515
NODE_248_length_4587_cov_14.431150	4316	4382	322	3	66	0.0454545
NODE_248_length_4587_cov_14.431150	4316	4382	323	1	66	0.0151515
NODE_248_length_4587_cov_14.431150	4316	4382	327	1	66	0.0151515
NODE_248_length_4587_cov_14.431150	4316	4382	328	1	66	0.0151515
NODE_248_length_4587_cov_14.431150	4316	4382	340	2	66	0.0303030
NODE_248_length_4587_cov_14.431150	4316	4382	345	1	66	0.0151515
NODE_248_length_4587_cov_14.431150	4316	4382	353	2	66	0.0303030
NODE_248_length_4587_cov_14.431150	4316	4382	356	1	66	0.0151515
NODE_248_length_4587_cov_14.431150	4316	4382	363	1	66	0.0151515
NODE_248_length_4587_cov_14.431150	4316	4382	372	1	66	0.0151515
NODE_248_length_4587_cov_14.431150	4316	4382	386	2	66	0.0303030
NODE_248_length_4587_cov_14.431150	4316	4382	388	1	66	0.0151515
NODE_248_length_4587_cov_14.431150	4316	4382	392	2	66	0.0303030
NODE_248_length_4587_cov_14.431150	4316	4382	393	1	66	0.0151515
NODE_248_length_4587_cov_14.431150	4316	4382	401	1	66	0.0151515
NODE_248_length_4587_cov_14.431150	4316	4382	405	1	66	0.0151515
NODE_248_length_4587_cov_14.431150	4316	4382	411	1	66	0.0151515
NODE_248_length_4587_cov_14.431150	4316	4382	418	1	66	0.0151515
NODE_248_length_4587_cov_14.431150	4316	4382	421	1	66	0.0151515
NODE_248_length_4587_cov_14.431150	4316	4382	424	1	66	0.0151515
NODE_248_length_4587_cov_14.431150	4316	4382	426	1	66	0.0151515
NODE_248_length_4587_cov_14.431150	4316	4382	430	1	66	0.0151515
NODE_248_length_4587_cov_14.431150	4316	4382	432	1	66	0.0151515
NODE_248_length_4587_cov_14.431150	4316	4382	440	2	66	0.0303030
NODE_248_length_4587_cov_14.431150	4316	4382	441	1	66	0.0151515
NODE_248_length_4587_cov_14.431150	4316	4382	442	1	66	0.0151515
NODE_248_length_4587_cov_14.431150	4316	4382	444	1	66	0.0151515
NODE_248_length_4587_cov_14.431150	4316	4382	447	1	66	0.0151515
NODE_248_length_4587_cov_14.431150	4316	4382	448	4	66	0.0606061
NODE_248_length_4587_cov_14.431150	4316	4382	449	2	66	0.0303030
NODE_248_length_4587_cov_14.431150	4316	4382	450	2	66	0.0303030
NODE_248_length_4587_cov_14.431150	4316	4382	451	2	66	0.0303030
NODE_248_length_4587_cov_14.431150	4316	4382	452	4	66	0.0606061
NODE_248_length_4587_cov_14.431150	4355	4435	340	1	80	0.0125000
NODE_248_length_4587_cov_14.431150	4355	4435	363	1	80	0.0125000
NODE_248_length_4587_cov_14.431150	4355	4435	368	1	80	0.0125000
NODE_248_length_4587_cov_14.431150	4355	4435	379	1	80	0.0125000
NODE_248_length_4587_cov_14.431150	4355	4435	386	1	80	0.0125000
NODE_248_length_4587_cov_14.431150	4355	4435	390	1	80	0.0125000
NODE_248_length_4587_cov_14.431150	4355	4435	396	1	80	0.0125000
NODE_248_length_4587_cov_14.431150	4355	4435	403	1	80	0.0125000
NODE_248_length_4587_cov_14.431150	4355	4435	411	1	80	0.0125000
NODE_248_length_4587_cov_14.431150	4355	4435	418	1	80	0.0125000
NODE_248_length_4587_cov_14.431150	4355	4435	421	1	80	0.0125000
NODE_248_length_4587_cov_14.431150	4355	4435	424	1	80	0.0125000
NODE_248_length_4587_cov_14.431150	4355	4435	426	1	80	0.0125000
NODE_248_length_4587_cov_14.431150	4355	4435	428	1	80	0.0125000
NODE_248_length_4587_cov_14.431150	4355	4435	430	1	80	0.0125000
NODE_248_length_4587_cov_14.431150	4355	4435	432	1	80	0.0125000
NODE_248_length_4587_cov_14.431150	4355	4435	433	1	80	0.0125000
NODE_248_length_4587_cov_14.431150	4355	4435	440	3	80	0.0375000
NODE_248_length_4587_cov_14.431150	4355	4435	441	1	80	0.0125000
NODE_248_length_4587_cov_14.431150	4355	4435	442	1	80	0.0125000
NODE_248_length_4587_cov_14.431150	4355	4435	444	2	80	0.0250000
NODE_248_length_4587_cov_14.431150	4355	4435	446	1	80	0.0125000
NODE_248_length_4587_cov_14.431150	4355	4435	447	3	80	0.0375000
NODE_248_length_4587_cov_14.431150	4355	4435	448	8	80	0.1000000
NODE_248_length_4587_cov_14.431150	4355	4435	449	2	80	0.0250000
NODE_248_length_4587_cov_14.431150	4355	4435	450	2	80	0.0250000
NODE_248_length_4587_cov_14.431150	4355	4435	451	2	80	0.0250000
NODE_248_length_4587_cov_14.431150	4355	4435	452	4	80	0.0500000
NODE_248_length_4587_cov_14.431150	4355	4435	453	1	80	0.0125000
NODE_248_length_4587_cov_14.431150	4355	4435	454	1	80	0.0125000
NODE_248_length_4587_cov_14.431150	4355	4435	455	1	80	0.0125000
NODE_248_length_4587_cov_14.431150	4355	4435	458	1	80	0.0125000
NODE_248_length_4587_cov_14.431150	4355	4435	461	1	80	0.0125000
NODE_248_length_4587_cov_14.431150	4355	4435	464	3	80	0.0375000
NODE_248_length_4587_cov_14.431150	4355	4435	466	3	80	0.0375000
NODE_248_length_4587_cov_14.431150	4355	4435	468	1	80	0.0125000
NODE_248_length_4587_cov_14.431150	4355	4435	471	1	80	0.0125000
NODE_248_length_4587_cov_14.431150	4355	4435	473	1	80	0.0125000
NODE_248_length_4587_cov_14.431150	4355	4435	475	1	80	0.0125000
NODE_248_length_4587_cov_14.431150	4355	4435	477	1	80	0.0125000
NODE_248_length_4587_cov_14.431150	4355	4435	478	2	80	0.0250000
NODE_248_length_4587_cov_14.431150	4355	4435	480	2	80	0.0250000
NODE_248_length_4587_cov_14.431150	4355	4435	481	3	80	0.0375000
NODE_248_length_4587_cov_14.431150	4355	4435	482	1	80	0.0125000
NODE_248_length_4587_cov_14.431150	4355	4435	485	1	80	0.0125000
NODE_248_length_4587_cov_14.431150	4355	4435	490	2	80	0.0250000
NODE_248_length_4587_cov_14.431150	4355	4435	491	2	80	0.0250000
NODE_248_length_4587_cov_14.431150	4355	4435	492	4	80	0.0500000
NODE_248_length_4587_cov_14.431150	4355	4435	493	1	80	0.0125000
NODE_249_length_4572_cov_50.244579	2406	2483	6	3	77	0.0389610
NODE_249_length_4572_cov_50.244579	2406	2483	8	12	77	0.1558442
NODE_249_length_4572_cov_50.244579	2406	2483	12	5	77	0.0649351
NODE_249_length_4572_cov_50.244579	2406	2483	18	13	77	0.1688312
NODE_249_length_4572_cov_50.244579	2406	2483	19	1	77	0.0129870
NODE_249_length_4572_cov_50.244579	2406	2483	20	16	77	0.2077922
NODE_249_length_4572_cov_50.244579	2406	2483	23	12	77	0.1558442
NODE_249_length_4572_cov_50.244579	2406	2483	25	15	77	0.1948052
NODE_249_length_4572_cov_50.244579	2406	2483	6	3	77	0.0389610
NODE_249_length_4572_cov_50.244579	2406	2483	8	12	77	0.1558442
NODE_249_length_4572_cov_50.244579	2406	2483	12	5	77	0.0649351
NODE_249_length_4572_cov_50.244579	2406	2483	18	13	77	0.1688312
NODE_249_length_4572_cov_50.244579	2406	2483	19	1	77	0.0129870
NODE_249_length_4572_cov_50.244579	2406	2483	20	16	77	0.2077922
NODE_249_length_4572_cov_50.244579	2406	2483	23	12	77	0.1558442
NODE_249_length_4572_cov_50.244579	2406	2483	25	15	77	0.1948052
NODE_251_length_4556_cov_14.556652	4229	4288	85	3	59	0.0508475
NODE_251_length_4556_cov_14.556652	4229	4288	87	1	59	0.0169492
NODE_251_length_4556_cov_14.556652	4229	4288	89	8	59	0.1355932
NODE_251_length_4556_cov_14.556652	4229	4288	91	2	59	0.0338983
NODE_251_length_4556_cov_14.556652	4229	4288	93	1	59	0.0169492
NODE_251_length_4556_cov_14.556652	4229	4288	95	3	59	0.0508475
NODE_251_length_4556_cov_14.556652	4229	4288	97	3	59	0.0508475
NODE_251_length_4556_cov_14.556652	4229	4288	99	3	59	0.0508475
NODE_251_length_4556_cov_14.556652	4229	4288	100	6	59	0.1016949
NODE_251_length_4556_cov_14.556652	4229	4288	101	2	59	0.0338983
NODE_251_length_4556_cov_14.556652	4229	4288	102	1	59	0.0169492
NODE_251_length_4556_cov_14.556652	4229	4288	103	1	59	0.0169492
NODE_251_length_4556_cov_14.556652	4229	4288	104	1	59	0.0169492
NODE_251_length_4556_cov_14.556652	4229	4288	106	4	59	0.0677966
NODE_251_length_4556_cov_14.556652	4229	4288	108	5	59	0.0847458
NODE_251_length_4556_cov_14.556652	4229	4288	109	1	59	0.0169492
NODE_251_length_4556_cov_14.556652	4229	4288	111	4	59	0.0677966
NODE_251_length_4556_cov_14.556652	4229	4288	113	3	59	0.0508475
NODE_251_length_4556_cov_14.556652	4229	4288	114	1	59	0.0169492
NODE_251_length_4556_cov_14.556652	4229	4288	115	6	59	0.1016949
NODE_252_length_4550_cov_5.664120	3548	3628	0	80	80	1.0000000
NODE_252_length_4550_cov_5.664120	3601	3681	0	80	80	1.0000000
NODE_253_length_4544_cov_10.690439	353	433	0	36	80	0.4500000
NODE_253_length_4544_cov_10.690439	353	433	2	44	80	0.5500000
NODE_253_length_4544_cov_10.690439	406	486	0	80	80	1.0000000
NODE_253_length_4544_cov_10.690439	4487	4544	0	55	57	0.9649123
NODE_253_length_4544_cov_10.690439	4487	4544	9	2	57	0.0350877
NODE_255_length_4535_cov_24.849188	675	755	0	42	80	0.5250000
NODE_255_length_4535_cov_24.849188	675	755	2	38	80	0.4750000
NODE_255_length_4535_cov_24.849188	728	809	0	81	81	1.0000000
NODE_255_length_4535_cov_24.849188	1319	1399	0	46	80	0.5750000
NODE_255_length_4535_cov_24.849188	1319	1399	2	34	80	0.4250000
NODE_255_length_4535_cov_24.849188	1372	1452	2	33	80	0.4125000
NODE_255_length_4535_cov_24.849188	1372	1452	6	1	80	0.0125000
NODE_255_length_4535_cov_24.849188	1372	1452	7	5	80	0.0625000
NODE_255_length_4535_cov_24.849188	1372	1452	10	3	80	0.0375000
NODE_255_length_4535_cov_24.849188	1372	1452	11	1	80	0.0125000
NODE_255_length_4535_cov_24.849188	1372	1452	12	1	80	0.0125000
NODE_255_length_4535_cov_24.849188	1372	1452	14	1	80	0.0125000
NODE_255_length_4535_cov_24.849188	1372	1452	18	3	80	0.0375000
NODE_255_length_4535_cov_24.849188	1372	1452	19	3	80	0.0375000
NODE_255_length_4535_cov_24.849188	1372	1452	23	2	80	0.0250000
NODE_255_length_4535_cov_24.849188	1372	1452	25	1	80	0.0125000
NODE_255_length_4535_cov_24.849188	1372	1452	38	1	80	0.0125000
NODE_255_length_4535_cov_24.849188	1372	1452	43	1	80	0.0125000
NODE_255_length_4535_cov_24.849188	1372	1452	45	1	80	0.0125000
NODE_255_length_4535_cov_24.849188	1372	1452	54	1	80	0.0125000
NODE_255_length_4535_cov_24.849188	1372	1452	55	2	80	0.0250000
NODE_255_length_4535_cov_24.849188	1372	1452	57	2	80	0.0250000
NODE_255_length_4535_cov_24.849188	1372	1452	61	1	80	0.0125000
NODE_255_length_4535_cov_24.849188	1372	1452	65	1	80	0.0125000
NODE_255_length_4535_cov_24.849188	1372	1452	69	1	80	0.0125000
NODE_255_length_4535_cov_24.849188	1372	1452	71	1	80	0.0125000
NODE_255_length_4535_cov_24.849188	1372	1452	73	1	80	0.0125000
NODE_255_length_4535_cov_24.849188	1372	1452	81	1	80	0.0125000
NODE_255_length_4535_cov_24.849188	1372	1452	82	1	80	0.0125000
NODE_255_length_4535_cov_24.849188	1372	1452	88	3	80	0.0375000
NODE_255_length_4535_cov_24.849188	1372	1452	91	2	80	0.0250000
NODE_255_length_4535_cov_24.849188	1372	1452	92	2	80	0.0250000
NODE_255_length_4535_cov_24.849188	1372	1452	93	1	80	0.0125000
NODE_255_length_4535_cov_24.849188	1372	1452	98	1	80	0.0125000
NODE_255_length_4535_cov_24.849188	1372	1452	99	1	80	0.0125000
NODE_255_length_4535_cov_24.849188	1372	1452	101	1	80	0.0125000
NODE_258_length_4528_cov_19.736509	4295	4366	0	68	71	0.9577465
NODE_258_length_4528_cov_19.736509	4295	4366	2	1	71	0.0140845
NODE_258_length_4528_cov_19.736509	4295	4366	4	1	71	0.0140845
NODE_258_length_4528_cov_19.736509	4295	4366	21	1	71	0.0140845
NODE_259_length_4505_cov_10.409215	3166	3202	10	1	36	0.0277778
NODE_259_length_4505_cov_10.409215	3166	3202	16	3	36	0.0833333
NODE_259_length_4505_cov_10.409215	3166	3202	18	2	36	0.0555556
NODE_259_length_4505_cov_10.409215	3166	3202	22	2	36	0.0555556
NODE_259_length_4505_cov_10.409215	3166	3202	24	7	36	0.1944444
NODE_259_length_4505_cov_10.409215	3166	3202	28	1	36	0.0277778
NODE_259_length_4505_cov_10.409215	3166	3202	30	4	36	0.1111111
NODE_259_length_4505_cov_10.409215	3166	3202	32	3	36	0.0833333
NODE_259_length_4505_cov_10.409215	3166	3202	34	2	36	0.0555556
NODE_259_length_4505_cov_10.409215	3166	3202	36	11	36	0.3055556
NODE_259_length_4505_cov_10.409215	3175	3255	24	6	80	0.0750000
NODE_259_length_4505_cov_10.409215	3175	3255	28	1	80	0.0125000
NODE_259_length_4505_cov_10.409215	3175	3255	30	4	80	0.0500000
NODE_259_length_4505_cov_10.409215	3175	3255	32	3	80	0.0375000
NODE_259_length_4505_cov_10.409215	3175	3255	34	2	80	0.0250000
NODE_259_length_4505_cov_10.409215	3175	3255	36	16	80	0.2000000
NODE_259_length_4505_cov_10.409215	3175	3255	37	6	80	0.0750000
NODE_259_length_4505_cov_10.409215	3175	3255	38	4	80	0.0500000
NODE_259_length_4505_cov_10.409215	3175	3255	42	11	80	0.1375000
NODE_259_length_4505_cov_10.409215	3175	3255	44	27	80	0.3375000
NODE_260_length_4498_cov_8.216185	3161	3219	0	56	58	0.9655172
NODE_260_length_4498_cov_8.216185	3161	3219	2	2	58	0.0344828
NODE_260_length_4498_cov_8.216185	4257	4314	4	57	57	1.0000000
NODE_263_length_4476_cov_29.825451	141	215	0	7	74	0.0945946
NODE_263_length_4476_cov_29.825451	141	215	2	12	74	0.1621622
NODE_263_length_4476_cov_29.825451	141	215	4	4	74	0.0540541
NODE_263_length_4476_cov_29.825451	141	215	6	6	74	0.0810811
NODE_263_length_4476_cov_29.825451	141	215	7	1	74	0.0135135
NODE_263_length_4476_cov_29.825451	141	215	11	6	74	0.0810811
NODE_263_length_4476_cov_29.825451	141	215	12	3	74	0.0405405
NODE_263_length_4476_cov_29.825451	141	215	13	9	74	0.1216216
NODE_263_length_4476_cov_29.825451	141	215	14	6	74	0.0810811
NODE_263_length_4476_cov_29.825451	141	215	16	20	74	0.2702703
NODE_263_length_4476_cov_29.825451	1890	1970	51	4	80	0.0500000
NODE_263_length_4476_cov_29.825451	1890	1970	55	4	80	0.0500000
NODE_263_length_4476_cov_29.825451	1890	1970	57	13	80	0.1625000
NODE_263_length_4476_cov_29.825451	1890	1970	59	4	80	0.0500000
NODE_263_length_4476_cov_29.825451	1890	1970	61	1	80	0.0125000
NODE_263_length_4476_cov_29.825451	1890	1970	63	6	80	0.0750000
NODE_263_length_4476_cov_29.825451	1890	1970	65	2	80	0.0250000
NODE_263_length_4476_cov_29.825451	1890	1970	66	1	80	0.0125000
NODE_263_length_4476_cov_29.825451	1890	1970	67	1	80	0.0125000
NODE_263_length_4476_cov_29.825451	1890	1970	68	7	80	0.0875000
NODE_263_length_4476_cov_29.825451	1890	1970	69	1	80	0.0125000
NODE_263_length_4476_cov_29.825451	1890	1970	70	6	80	0.0750000
NODE_263_length_4476_cov_29.825451	1890	1970	72	5	80	0.0625000
NODE_263_length_4476_cov_29.825451	1890	1970	73	4	80	0.0500000
NODE_263_length_4476_cov_29.825451	1890	1970	74	19	80	0.2375000
NODE_263_length_4476_cov_29.825451	1890	1970	76	2	80	0.0250000
NODE_263_length_4476_cov_29.825451	1943	2023	24	4	80	0.0500000
NODE_263_length_4476_cov_29.825451	1943	2023	26	1	80	0.0125000
NODE_263_length_4476_cov_29.825451	1943	2023	28	1	80	0.0125000
NODE_263_length_4476_cov_29.825451	1943	2023	30	1	80	0.0125000
NODE_263_length_4476_cov_29.825451	1943	2023	32	1	80	0.0125000
NODE_263_length_4476_cov_29.825451	1943	2023	40	2	80	0.0250000
NODE_263_length_4476_cov_29.825451	1943	2023	42	1	80	0.0125000
NODE_263_length_4476_cov_29.825451	1943	2023	46	1	80	0.0125000
NODE_263_length_4476_cov_29.825451	1943	2023	48	3	80	0.0375000
NODE_263_length_4476_cov_29.825451	1943	2023	50	2	80	0.0250000
NODE_263_length_4476_cov_29.825451	1943	2023	52	2	80	0.0250000
NODE_263_length_4476_cov_29.825451	1943	2023	56	5	80	0.0625000
NODE_263_length_4476_cov_29.825451	1943	2023	58	3	80	0.0375000
NODE_263_length_4476_cov_29.825451	1943	2023	60	5	80	0.0625000
NODE_263_length_4476_cov_29.825451	1943	2023	65	1	80	0.0125000
NODE_263_length_4476_cov_29.825451	1943	2023	67	8	80	0.1000000
NODE_263_length_4476_cov_29.825451	1943	2023	68	7	80	0.0875000
NODE_263_length_4476_cov_29.825451	1943	2023	69	7	80	0.0875000
NODE_263_length_4476_cov_29.825451	1943	2023	70	4	80	0.0500000
NODE_263_length_4476_cov_29.825451	1943	2023	71	3	80	0.0375000
NODE_263_length_4476_cov_29.825451	1943	2023	72	3	80	0.0375000
NODE_263_length_4476_cov_29.825451	1943	2023	73	4	80	0.0500000
NODE_263_length_4476_cov_29.825451	1943	2023	74	10	80	0.1250000
NODE_263_length_4476_cov_29.825451	1943	2023	76	1	80	0.0125000
NODE_264_length_4474_cov_17.051886	23	99	14	76	76	1.0000000
NODE_264_length_4474_cov_17.051886	23	98	14	75	75	1.0000000
NODE_264_length_4474_cov_17.051886	23	99	14	76	76	1.0000000
NODE_264_length_4474_cov_17.051886	32	99	14	67	67	1.0000000
NODE_264_length_4474_cov_17.051886	76	140	14	64	64	1.0000000
NODE_264_length_4474_cov_17.051886	1528	1569	71	3	41	0.0731707
NODE_264_length_4474_cov_17.051886	1528	1569	72	2	41	0.0487805
NODE_264_length_4474_cov_17.051886	1528	1569	74	1	41	0.0243902
NODE_264_length_4474_cov_17.051886	1528	1569	78	1	41	0.0243902
NODE_264_length_4474_cov_17.051886	1528	1569	79	1	41	0.0243902
NODE_264_length_4474_cov_17.051886	1528	1569	80	1	41	0.0243902
NODE_264_length_4474_cov_17.051886	1528	1569	81	1	41	0.0243902
NODE_264_length_4474_cov_17.051886	1528	1569	87	1	41	0.0243902
NODE_264_length_4474_cov_17.051886	1528	1569	95	2	41	0.0487805
NODE_264_length_4474_cov_17.051886	1528	1569	101	4	41	0.0975610
NODE_264_length_4474_cov_17.051886	1528	1569	117	1	41	0.0243902
NODE_264_length_4474_cov_17.051886	1528	1569	118	1	41	0.0243902
NODE_264_length_4474_cov_17.051886	1528	1569	123	1	41	0.0243902
NODE_264_length_4474_cov_17.051886	1528	1569	128	1	41	0.0243902
NODE_264_length_4474_cov_17.051886	1528	1569	138	1	41	0.0243902
NODE_264_length_4474_cov_17.051886	1528	1569	142	1	41	0.0243902
NODE_264_length_4474_cov_17.051886	1528	1569	150	1	41	0.0243902
NODE_264_length_4474_cov_17.051886	1528	1569	153	1	41	0.0243902
NODE_264_length_4474_cov_17.051886	1528	1569	157	1	41	0.0243902
NODE_264_length_4474_cov_17.051886	1528	1569	159	1	41	0.0243902
NODE_264_length_4474_cov_17.051886	1528	1569	163	1	41	0.0243902
NODE_264_length_4474_cov_17.051886	1528	1569	174	2	41	0.0487805
NODE_264_length_4474_cov_17.051886	1528	1569	183	1	41	0.0243902
NODE_264_length_4474_cov_17.051886	1528	1569	188	3	41	0.0731707
NODE_264_length_4474_cov_17.051886	1528	1569	190	1	41	0.0243902
NODE_264_length_4474_cov_17.051886	1528	1569	194	1	41	0.0243902
NODE_264_length_4474_cov_17.051886	1528	1569	200	2	41	0.0487805
NODE_264_length_4474_cov_17.051886	1528	1569	205	1	41	0.0243902
NODE_264_length_4474_cov_17.051886	1528	1569	209	1	41	0.0243902
NODE_264_length_4474_cov_17.051886	1528	1569	220	1	41	0.0243902
NODE_264_length_4474_cov_17.051886	1536	1609	18	1	73	0.0136986
NODE_264_length_4474_cov_17.051886	1536	1609	20	1	73	0.0136986
NODE_264_length_4474_cov_17.051886	1536	1609	22	1	73	0.0136986
NODE_264_length_4474_cov_17.051886	1536	1609	24	5	73	0.0684932
NODE_264_length_4474_cov_17.051886	1536	1609	32	1	73	0.0136986
NODE_264_length_4474_cov_17.051886	1536	1609	33	4	73	0.0547945
NODE_264_length_4474_cov_17.051886	1536	1609	34	5	73	0.0684932
NODE_264_length_4474_cov_17.051886	1536	1609	36	3	73	0.0410959
NODE_264_length_4474_cov_17.051886	1536	1609	38	1	73	0.0136986
NODE_264_length_4474_cov_17.051886	1536	1609	39	1	73	0.0136986
NODE_264_length_4474_cov_17.051886	1536	1609	45	1	73	0.0136986
NODE_264_length_4474_cov_17.051886	1536	1609	46	2	73	0.0273973
NODE_264_length_4474_cov_17.051886	1536	1609	48	1	73	0.0136986
NODE_264_length_4474_cov_17.051886	1536	1609	57	2	73	0.0273973
NODE_264_length_4474_cov_17.051886	1536	1609	59	3	73	0.0410959
NODE_264_length_4474_cov_17.051886	1536	1609	64	1	73	0.0136986
NODE_264_length_4474_cov_17.051886	1536	1609	65	1	73	0.0136986
NODE_264_length_4474_cov_17.051886	1536	1609	66	2	73	0.0273973
NODE_264_length_4474_cov_17.051886	1536	1609	67	3	73	0.0410959
NODE_264_length_4474_cov_17.051886	1536	1609	70	1	73	0.0136986
NODE_264_length_4474_cov_17.051886	1536	1609	71	3	73	0.0410959
NODE_264_length_4474_cov_17.051886	1536	1609	72	2	73	0.0273973
NODE_264_length_4474_cov_17.051886	1536	1609	74	1	73	0.0136986
NODE_264_length_4474_cov_17.051886	1536	1609	78	1	73	0.0136986
NODE_264_length_4474_cov_17.051886	1536	1609	79	1	73	0.0136986
NODE_264_length_4474_cov_17.051886	1536	1609	80	1	73	0.0136986
NODE_264_length_4474_cov_17.051886	1536	1609	81	1	73	0.0136986
NODE_264_length_4474_cov_17.051886	1536	1609	87	1	73	0.0136986
NODE_264_length_4474_cov_17.051886	1536	1609	95	2	73	0.0273973
NODE_264_length_4474_cov_17.051886	1536	1609	101	4	73	0.0547945
NODE_264_length_4474_cov_17.051886	1536	1609	117	1	73	0.0136986
NODE_264_length_4474_cov_17.051886	1536	1609	118	1	73	0.0136986
NODE_264_length_4474_cov_17.051886	1536	1609	123	1	73	0.0136986
NODE_264_length_4474_cov_17.051886	1536	1609	128	1	73	0.0136986
NODE_264_length_4474_cov_17.051886	1536	1609	138	1	73	0.0136986
NODE_264_length_4474_cov_17.051886	1536	1609	142	1	73	0.0136986
NODE_264_length_4474_cov_17.051886	1536	1609	150	1	73	0.0136986
NODE_264_length_4474_cov_17.051886	1536	1609	153	1	73	0.0136986
NODE_264_length_4474_cov_17.051886	1536	1609	157	1	73	0.0136986
NODE_264_length_4474_cov_17.051886	1536	1609	159	1	73	0.0136986
NODE_264_length_4474_cov_17.051886	1536	1609	163	1	73	0.0136986
NODE_264_length_4474_cov_17.051886	1536	1609	174	2	73	0.0273973
NODE_264_length_4474_cov_17.051886	1536	1609	183	1	73	0.0136986
NODE_264_length_4474_cov_17.051886	1536	1609	188	2	73	0.0273973
NODE_264_length_4474_cov_17.051886	1618	1643	0	20	25	0.8000000
NODE_264_length_4474_cov_17.051886	1618	1643	6	1	25	0.0400000
NODE_264_length_4474_cov_17.051886	1618	1643	8	4	25	0.1600000
NODE_264_length_4474_cov_17.051886	1618	1696	0	73	78	0.9358974
NODE_264_length_4474_cov_17.051886	1618	1696	6	1	78	0.0128205
NODE_264_length_4474_cov_17.051886	1618	1696	8	4	78	0.0512821
NODE_265_length_4474_cov_14.441829	282	362	0	80	80	1.0000000
NODE_265_length_4474_cov_14.441829	335	415	0	76	80	0.9500000
NODE_265_length_4474_cov_14.441829	335	415	12	1	80	0.0125000
NODE_265_length_4474_cov_14.441829	335	415	34	1	80	0.0125000
NODE_265_length_4474_cov_14.441829	335	415	94	1	80	0.0125000
NODE_265_length_4474_cov_14.441829	335	415	135	1	80	0.0125000
NODE_265_length_4474_cov_14.441829	1522	1575	5	8	53	0.1509434
NODE_265_length_4474_cov_14.441829	1522	1575	6	7	53	0.1320755
NODE_265_length_4474_cov_14.441829	1522	1575	7	34	53	0.6415094
NODE_265_length_4474_cov_14.441829	1522	1575	60	1	53	0.0188679
NODE_265_length_4474_cov_14.441829	1522	1575	62	1	53	0.0188679
NODE_265_length_4474_cov_14.441829	1522	1575	64	1	53	0.0188679
NODE_265_length_4474_cov_14.441829	1522	1575	68	1	53	0.0188679
NODE_265_length_4474_cov_14.441829	1548	1623	4	1	75	0.0133333
NODE_265_length_4474_cov_14.441829	1548	1623	5	1	75	0.0133333
NODE_265_length_4474_cov_14.441829	1548	1623	6	5	75	0.0666667
NODE_265_length_4474_cov_14.441829	1548	1623	7	27	75	0.3600000
NODE_265_length_4474_cov_14.441829	1548	1623	8	6	75	0.0800000
NODE_265_length_4474_cov_14.441829	1548	1623	10	3	75	0.0400000
NODE_265_length_4474_cov_14.441829	1548	1623	12	6	75	0.0800000
NODE_265_length_4474_cov_14.441829	1548	1623	14	3	75	0.0400000
NODE_265_length_4474_cov_14.441829	1548	1623	16	5	75	0.0666667
NODE_265_length_4474_cov_14.441829	1548	1623	18	2	75	0.0266667
NODE_265_length_4474_cov_14.441829	1548	1623	20	4	75	0.0533333
NODE_265_length_4474_cov_14.441829	1548	1623	22	2	75	0.0266667
NODE_265_length_4474_cov_14.441829	1548	1623	26	10	75	0.1333333
NODE_265_length_4474_cov_14.441829	3068	3121	4	26	53	0.4905660
NODE_265_length_4474_cov_14.441829	3068	3121	6	25	53	0.4716981
NODE_265_length_4474_cov_14.441829	3068	3121	40	2	53	0.0377358
NODE_268_length_4463_cov_7.023144	119	168	0	44	49	0.8979592
NODE_268_length_4463_cov_7.023144	119	168	14	2	49	0.0408163
NODE_268_length_4463_cov_7.023144	119	168	16	3	49	0.0612245
NODE_270_length_4453_cov_16.820395	3383	3463	66	1	80	0.0125000
NODE_270_length_4453_cov_16.820395	3383	3463	75	2	80	0.0250000
NODE_270_length_4453_cov_16.820395	3383	3463	83	1	80	0.0125000
NODE_270_length_4453_cov_16.820395	3383	3463	85	3	80	0.0375000
NODE_270_length_4453_cov_16.820395	3383	3463	87	2	80	0.0250000
NODE_270_length_4453_cov_16.820395	3383	3463	89	2	80	0.0250000
NODE_270_length_4453_cov_16.820395	3383	3463	93	1	80	0.0125000
NODE_270_length_4453_cov_16.820395	3383	3463	94	4	80	0.0500000
NODE_270_length_4453_cov_16.820395	3383	3463	95	2	80	0.0250000
NODE_270_length_4453_cov_16.820395	3383	3463	96	2	80	0.0250000
NODE_270_length_4453_cov_16.820395	3383	3463	98	3	80	0.0375000
NODE_270_length_4453_cov_16.820395	3383	3463	100	11	80	0.1375000
NODE_270_length_4453_cov_16.820395	3383	3463	102	3	80	0.0375000
NODE_270_length_4453_cov_16.820395	3383	3463	104	14	80	0.1750000
NODE_270_length_4453_cov_16.820395	3383	3463	106	3	80	0.0375000
NODE_270_length_4453_cov_16.820395	3383	3463	108	3	80	0.0375000
NODE_270_length_4453_cov_16.820395	3383	3463	110	5	80	0.0625000
NODE_270_length_4453_cov_16.820395	3383	3463	111	1	80	0.0125000
NODE_270_length_4453_cov_16.820395	3383	3463	112	8	80	0.1000000
NODE_270_length_4453_cov_16.820395	3383	3463	113	1	80	0.0125000
NODE_270_length_4453_cov_16.820395	3383	3463	114	3	80	0.0375000
NODE_270_length_4453_cov_16.820395	3383	3463	116	2	80	0.0250000
NODE_270_length_4453_cov_16.820395	3383	3463	118	2	80	0.0250000
NODE_270_length_4453_cov_16.820395	3383	3463	120	1	80	0.0125000
NODE_270_length_4453_cov_16.820395	3436	3496	25	2	60	0.0333333
NODE_270_length_4453_cov_16.820395	3436	3496	27	1	60	0.0166667
NODE_270_length_4453_cov_16.820395	3436	3496	28	1	60	0.0166667
NODE_270_length_4453_cov_16.820395	3436	3496	32	1	60	0.0166667
NODE_270_length_4453_cov_16.820395	3436	3496	34	1	60	0.0166667
NODE_270_length_4453_cov_16.820395	3436	3496	38	2	60	0.0333333
NODE_270_length_4453_cov_16.820395	3436	3496	42	4	60	0.0666667
NODE_270_length_4453_cov_16.820395	3436	3496	46	6	60	0.1000000
NODE_270_length_4453_cov_16.820395	3436	3496	48	5	60	0.0833333
NODE_270_length_4453_cov_16.820395	3436	3496	50	4	60	0.0666667
NODE_270_length_4453_cov_16.820395	3436	3496	52	1	60	0.0166667
NODE_270_length_4453_cov_16.820395	3436	3496	59	1	60	0.0166667
NODE_270_length_4453_cov_16.820395	3436	3496	64	4	60	0.0666667
NODE_270_length_4453_cov_16.820395	3436	3496	66	1	60	0.0166667
NODE_270_length_4453_cov_16.820395	3436	3496	75	2	60	0.0333333
NODE_270_length_4453_cov_16.820395	3436	3496	83	1	60	0.0166667
NODE_270_length_4453_cov_16.820395	3436	3496	85	3	60	0.0500000
NODE_270_length_4453_cov_16.820395	3436	3496	87	2	60	0.0333333
NODE_270_length_4453_cov_16.820395	3436	3496	89	2	60	0.0333333
NODE_270_length_4453_cov_16.820395	3436	3496	93	1	60	0.0166667
NODE_270_length_4453_cov_16.820395	3436	3496	94	4	60	0.0666667
NODE_270_length_4453_cov_16.820395	3436	3496	95	2	60	0.0333333
NODE_270_length_4453_cov_16.820395	3436	3496	96	2	60	0.0333333
NODE_270_length_4453_cov_16.820395	3436	3496	98	3	60	0.0500000
NODE_270_length_4453_cov_16.820395	3436	3496	100	4	60	0.0666667
NODE_272_length_4436_cov_31.114595	2807	2871	4	8	64	0.1250000
NODE_272_length_4436_cov_31.114595	2807	2871	6	6	64	0.0937500
NODE_272_length_4436_cov_31.114595	2807	2871	8	2	64	0.0312500
NODE_272_length_4436_cov_31.114595	2807	2871	10	2	64	0.0312500
NODE_272_length_4436_cov_31.114595	2807	2871	12	2	64	0.0312500
NODE_272_length_4436_cov_31.114595	2807	2871	14	10	64	0.1562500
NODE_272_length_4436_cov_31.114595	2807	2871	16	4	64	0.0625000
NODE_272_length_4436_cov_31.114595	2807	2871	18	5	64	0.0781250
NODE_272_length_4436_cov_31.114595	2807	2871	20	4	64	0.0625000
NODE_272_length_4436_cov_31.114595	2807	2871	22	21	64	0.3281250
NODE_272_length_4436_cov_31.114595	2846	2906	0	11	60	0.1833333
NODE_272_length_4436_cov_31.114595	2846	2906	1	2	60	0.0333333
NODE_272_length_4436_cov_31.114595	2846	2906	2	20	60	0.3333333
NODE_272_length_4436_cov_31.114595	2846	2906	4	10	60	0.1666667
NODE_272_length_4436_cov_31.114595	2846	2906	6	6	60	0.1000000
NODE_272_length_4436_cov_31.114595	2846	2906	8	2	60	0.0333333
NODE_272_length_4436_cov_31.114595	2846	2906	10	2	60	0.0333333
NODE_272_length_4436_cov_31.114595	2846	2906	12	2	60	0.0333333
NODE_272_length_4436_cov_31.114595	2846	2906	14	5	60	0.0833333
NODE_272_length_4436_cov_31.114595	2846	2898	0	3	52	0.0576923
NODE_272_length_4436_cov_31.114595	2846	2898	1	2	52	0.0384615
NODE_272_length_4436_cov_31.114595	2846	2898	2	20	52	0.3846154
NODE_272_length_4436_cov_31.114595	2846	2898	4	10	52	0.1923077
NODE_272_length_4436_cov_31.114595	2846	2898	6	6	52	0.1153846
NODE_272_length_4436_cov_31.114595	2846	2898	8	2	52	0.0384615
NODE_272_length_4436_cov_31.114595	2846	2898	10	2	52	0.0384615
NODE_272_length_4436_cov_31.114595	2846	2898	12	2	52	0.0384615
NODE_272_length_4436_cov_31.114595	2846	2898	14	5	52	0.0961538
NODE_278_length_4391_cov_7.711323	66	141	0	75	75	1.0000000
NODE_278_length_4391_cov_7.711323	119	155	0	31	36	0.8611111
NODE_278_length_4391_cov_7.711323	119	155	4	5	36	0.1388889
NODE_279_length_4385_cov_6.067662	1556	1606	0	3	50	0.0600000
NODE_279_length_4385_cov_6.067662	1556	1606	6	1	50	0.0200000
NODE_279_length_4385_cov_6.067662	1556	1606	15	3	50	0.0600000
NODE_279_length_4385_cov_6.067662	1556	1606	17	4	50	0.0800000
NODE_279_length_4385_cov_6.067662	1556	1606	23	2	50	0.0400000
NODE_279_length_4385_cov_6.067662	1556	1606	26	14	50	0.2800000
NODE_279_length_4385_cov_6.067662	1556	1606	28	2	50	0.0400000
NODE_279_length_4385_cov_6.067662	1556	1606	30	5	50	0.1000000
NODE_279_length_4385_cov_6.067662	1556	1606	32	6	50	0.1200000
NODE_279_length_4385_cov_6.067662	1556	1606	34	1	50	0.0200000
NODE_279_length_4385_cov_6.067662	1556	1606	36	2	50	0.0400000
NODE_279_length_4385_cov_6.067662	1556	1606	38	7	50	0.1400000
NODE_286_length_4331_cov_37.938800	1898	1978	4	15	80	0.1875000
NODE_286_length_4331_cov_37.938800	1898	1978	6	14	80	0.1750000
NODE_286_length_4331_cov_37.938800	1898	1978	8	3	80	0.0375000
NODE_286_length_4331_cov_37.938800	1898	1978	10	9	80	0.1125000
NODE_286_length_4331_cov_37.938800	1898	1978	12	1	80	0.0125000
NODE_286_length_4331_cov_37.938800	1898	1978	14	4	80	0.0500000
NODE_286_length_4331_cov_37.938800	1898	1978	15	1	80	0.0125000
NODE_286_length_4331_cov_37.938800	1898	1978	16	15	80	0.1875000
NODE_286_length_4331_cov_37.938800	1898	1978	20	18	80	0.2250000
NODE_286_length_4331_cov_37.938800	1951	2031	14	4	80	0.0500000
NODE_286_length_4331_cov_37.938800	1951	2031	15	1	80	0.0125000
NODE_286_length_4331_cov_37.938800	1951	2031	16	4	80	0.0500000
NODE_286_length_4331_cov_37.938800	1951	2031	20	34	80	0.4250000
NODE_286_length_4331_cov_37.938800	1951	2031	22	4	80	0.0500000
NODE_286_length_4331_cov_37.938800	1951	2031	24	3	80	0.0375000
NODE_286_length_4331_cov_37.938800	1951	2031	26	1	80	0.0125000
NODE_286_length_4331_cov_37.938800	1951	2031	32	3	80	0.0375000
NODE_286_length_4331_cov_37.938800	1951	2031	36	7	80	0.0875000
NODE_286_length_4331_cov_37.938800	1951	2031	38	2	80	0.0250000
NODE_286_length_4331_cov_37.938800	1951	2031	40	1	80	0.0125000
NODE_286_length_4331_cov_37.938800	1951	2031	42	2	80	0.0250000
NODE_286_length_4331_cov_37.938800	1951	2031	46	3	80	0.0375000
NODE_286_length_4331_cov_37.938800	1951	2031	57	1	80	0.0125000
NODE_286_length_4331_cov_37.938800	1951	2031	58	2	80	0.0250000
NODE_286_length_4331_cov_37.938800	1951	2031	60	2	80	0.0250000
NODE_286_length_4331_cov_37.938800	1951	2031	62	3	80	0.0375000
NODE_286_length_4331_cov_37.938800	1951	2031	66	3	80	0.0375000
NODE_286_length_4331_cov_37.938800	2027	2107	62	1	80	0.0125000
NODE_286_length_4331_cov_37.938800	2027	2107	66	4	80	0.0500000
NODE_286_length_4331_cov_37.938800	2027	2107	75	1	80	0.0125000
NODE_286_length_4331_cov_37.938800	2027	2107	82	1	80	0.0125000
NODE_286_length_4331_cov_37.938800	2027	2107	84	4	80	0.0500000
NODE_286_length_4331_cov_37.938800	2027	2107	86	1	80	0.0125000
NODE_286_length_4331_cov_37.938800	2027	2107	88	1	80	0.0125000
NODE_286_length_4331_cov_37.938800	2027	2107	91	1	80	0.0125000
NODE_286_length_4331_cov_37.938800	2027	2107	94	9	80	0.1125000
NODE_286_length_4331_cov_37.938800	2027	2107	99	2	80	0.0250000
NODE_286_length_4331_cov_37.938800	2027	2107	105	1	80	0.0125000
NODE_286_length_4331_cov_37.938800	2027	2107	107	1	80	0.0125000
NODE_286_length_4331_cov_37.938800	2027	2107	112	1	80	0.0125000
NODE_286_length_4331_cov_37.938800	2027	2107	118	1	80	0.0125000
NODE_286_length_4331_cov_37.938800	2027	2107	122	5	80	0.0625000
NODE_286_length_4331_cov_37.938800	2027	2107	124	3	80	0.0375000
NODE_286_length_4331_cov_37.938800	2027	2107	128	2	80	0.0250000
NODE_286_length_4331_cov_37.938800	2027	2107	140	2	80	0.0250000
NODE_286_length_4331_cov_37.938800	2027	2107	144	2	80	0.0250000
NODE_286_length_4331_cov_37.938800	2027	2107	150	3	80	0.0375000
NODE_286_length_4331_cov_37.938800	2027	2107	152	2	80	0.0250000
NODE_286_length_4331_cov_37.938800	2027	2107	154	1	80	0.0125000
NODE_286_length_4331_cov_37.938800	2027	2107	156	1	80	0.0125000
NODE_286_length_4331_cov_37.938800	2027	2107	158	3	80	0.0375000
NODE_286_length_4331_cov_37.938800	2027	2107	160	7	80	0.0875000
NODE_286_length_4331_cov_37.938800	2027	2107	162	1	80	0.0125000
NODE_286_length_4331_cov_37.938800	2027	2107	164	1	80	0.0125000
NODE_286_length_4331_cov_37.938800	2027	2107	170	1	80	0.0125000
NODE_286_length_4331_cov_37.938800	2027	2107	175	6	80	0.0750000
NODE_286_length_4331_cov_37.938800	2027	2107	177	2	80	0.0250000
NODE_286_length_4331_cov_37.938800	2027	2107	183	3	80	0.0375000
NODE_286_length_4331_cov_37.938800	2027	2107	185	6	80	0.0750000
NODE_286_length_4331_cov_37.938800	2080	2160	90	1	80	0.0125000
NODE_286_length_4331_cov_37.938800	2080	2160	94	1	80	0.0125000
NODE_286_length_4331_cov_37.938800	2080	2160	97	1	80	0.0125000
NODE_286_length_4331_cov_37.938800	2080	2160	101	1	80	0.0125000
NODE_286_length_4331_cov_37.938800	2080	2160	116	1	80	0.0125000
NODE_286_length_4331_cov_37.938800	2080	2160	120	1	80	0.0125000
NODE_286_length_4331_cov_37.938800	2080	2160	126	1	80	0.0125000
NODE_286_length_4331_cov_37.938800	2080	2160	127	1	80	0.0125000
NODE_286_length_4331_cov_37.938800	2080	2160	131	1	80	0.0125000
NODE_286_length_4331_cov_37.938800	2080	2160	132	7	80	0.0875000
NODE_286_length_4331_cov_37.938800	2080	2160	137	1	80	0.0125000
NODE_286_length_4331_cov_37.938800	2080	2160	139	1	80	0.0125000
NODE_286_length_4331_cov_37.938800	2080	2160	147	3	80	0.0375000
NODE_286_length_4331_cov_37.938800	2080	2160	157	2	80	0.0250000
NODE_286_length_4331_cov_37.938800	2080	2160	160	7	80	0.0875000
NODE_286_length_4331_cov_37.938800	2080	2160	162	1	80	0.0125000
NODE_286_length_4331_cov_37.938800	2080	2160	164	1	80	0.0125000
NODE_286_length_4331_cov_37.938800	2080	2160	167	2	80	0.0250000
NODE_286_length_4331_cov_37.938800	2080	2160	170	1	80	0.0125000
NODE_286_length_4331_cov_37.938800	2080	2160	173	1	80	0.0125000
NODE_286_length_4331_cov_37.938800	2080	2160	174	3	80	0.0375000
NODE_286_length_4331_cov_37.938800	2080	2160	175	12	80	0.1500000
NODE_286_length_4331_cov_37.938800	2080	2160	176	3	80	0.0375000
NODE_286_length_4331_cov_37.938800	2080	2160	177	2	80	0.0250000
NODE_286_length_4331_cov_37.938800	2080	2160	178	1	80	0.0125000
NODE_286_length_4331_cov_37.938800	2080	2160	179	2	80	0.0250000
NODE_286_length_4331_cov_37.938800	2080	2160	180	1	80	0.0125000
NODE_286_length_4331_cov_37.938800	2080	2160	183	7	80	0.0875000
NODE_286_length_4331_cov_37.938800	2080	2160	185	7	80	0.0875000
NODE_286_length_4331_cov_37.938800	2080	2160	189	1	80	0.0125000
NODE_286_length_4331_cov_37.938800	2080	2160	190	1	80	0.0125000
NODE_286_length_4331_cov_37.938800	2080	2160	191	4	80	0.0500000
NODE_289_length_4320_cov_7.680881	442	522	0	80	80	1.0000000
NODE_289_length_4320_cov_7.680881	495	575	0	80	80	1.0000000
NODE_289_length_4320_cov_7.680881	571	651	0	80	80	1.0000000
NODE_289_length_4320_cov_7.680881	624	704	0	80	80	1.0000000
NODE_290_length_4314_cov_5.311507	1436	1516	0	80	80	1.0000000
NODE_290_length_4314_cov_5.311507	1489	1569	0	80	80	1.0000000
NODE_290_length_4314_cov_5.311507	3331	3400	0	69	69	1.0000000
NODE_290_length_4314_cov_5.311507	3420	3482	0	62	62	1.0000000
NODE_292_length_4311_cov_8.733381	92	171	5	1	79	0.0126582
NODE_292_length_4311_cov_8.733381	92	171	6	4	79	0.0506329
NODE_292_length_4311_cov_8.733381	92	171	9	1	79	0.0126582
NODE_292_length_4311_cov_8.733381	92	171	11	8	79	0.1012658
NODE_292_length_4311_cov_8.733381	92	171	13	30	79	0.3797468
NODE_292_length_4311_cov_8.733381	92	171	15	9	79	0.1139240
NODE_292_length_4311_cov_8.733381	92	171	17	2	79	0.0253165
NODE_292_length_4311_cov_8.733381	92	171	21	24	79	0.3037975
NODE_292_length_4311_cov_8.733381	1925	2005	0	80	80	1.0000000
NODE_292_length_4311_cov_8.733381	1978	2058	0	80	80	1.0000000
NODE_294_length_4293_cov_3.809251	244	326	0	19	82	0.2317073
NODE_294_length_4293_cov_3.809251	244	326	2	63	82	0.7682927
NODE_294_length_4293_cov_3.809251	301	394	0	51	93	0.5483871
NODE_294_length_4293_cov_3.809251	301	394	2	42	93	0.4516129
NODE_295_length_4284_cov_15.940263	3726	3806	2	40	80	0.5000000
NODE_295_length_4284_cov_15.940263	3726	3806	4	40	80	0.5000000
NODE_295_length_4284_cov_15.940263	3779	3858	0	43	79	0.5443038
NODE_295_length_4284_cov_15.940263	3779	3858	2	35	79	0.4430380
NODE_295_length_4284_cov_15.940263	3779	3858	4	1	79	0.0126582
NODE_299_length_4277_cov_5.451173	3818	3898	0	11	80	0.1375000
NODE_299_length_4277_cov_5.451173	3818	3898	2	15	80	0.1875000
NODE_299_length_4277_cov_5.451173	3818	3898	6	54	80	0.6750000
NODE_299_length_4277_cov_5.451173	3927	3995	0	68	68	1.0000000
NODE_299_length_4277_cov_5.451173	3968	4048	0	73	80	0.9125000
NODE_299_length_4277_cov_5.451173	3968	4048	2	7	80	0.0875000
NODE_300_length_4274_cov_18.943234	591	671	0	31	80	0.3875000
NODE_300_length_4274_cov_18.943234	591	671	5	1	80	0.0125000
NODE_300_length_4274_cov_18.943234	591	671	6	23	80	0.2875000
NODE_300_length_4274_cov_18.943234	591	671	7	24	80	0.3000000
NODE_300_length_4274_cov_18.943234	591	671	8	1	80	0.0125000
NODE_300_length_4274_cov_18.943234	644	724	2	6	80	0.0750000
NODE_300_length_4274_cov_18.943234	644	724	6	7	80	0.0875000
NODE_300_length_4274_cov_18.943234	644	724	7	24	80	0.3000000
NODE_300_length_4274_cov_18.943234	644	724	8	43	80	0.5375000
NODE_301_length_4274_cov_16.160958	416	496	0	42	80	0.5250000
NODE_301_length_4274_cov_16.160958	416	496	13	10	80	0.1250000
NODE_301_length_4274_cov_16.160958	416	496	19	6	80	0.0750000
NODE_301_length_4274_cov_16.160958	416	496	21	14	80	0.1750000
NODE_301_length_4274_cov_16.160958	416	496	23	8	80	0.1000000
NODE_301_length_4274_cov_16.160958	1034	1114	0	19	80	0.2375000
NODE_301_length_4274_cov_16.160958	1034	1114	1	1	80	0.0125000
NODE_301_length_4274_cov_16.160958	1034	1114	2	31	80	0.3875000
NODE_301_length_4274_cov_16.160958	1034	1114	4	29	80	0.3625000
NODE_301_length_4274_cov_16.160958	1087	1167	4	80	80	1.0000000
NODE_301_length_4274_cov_16.160958	1163	1243	0	23	80	0.2875000
NODE_301_length_4274_cov_16.160958	1163	1243	2	1	80	0.0125000
NODE_301_length_4274_cov_16.160958	1163	1243	4	56	80	0.7000000
NODE_301_length_4274_cov_16.160958	1216	1296	0	76	80	0.9500000
NODE_301_length_4274_cov_16.160958	1216	1296	2	1	80	0.0125000
NODE_301_length_4274_cov_16.160958	1216	1296	4	3	80	0.0375000
NODE_301_length_4274_cov_16.160958	3411	3491	0	7	80	0.0875000
NODE_301_length_4274_cov_16.160958	3411	3491	6	8	80	0.1000000
NODE_301_length_4274_cov_16.160958	3411	3491	10	23	80	0.2875000
NODE_301_length_4274_cov_16.160958	3411	3491	12	9	80	0.1125000
NODE_301_length_4274_cov_16.160958	3411	3491	14	6	80	0.0750000
NODE_301_length_4274_cov_16.160958	3411	3491	16	14	80	0.1750000
NODE_301_length_4274_cov_16.160958	3411	3491	18	2	80	0.0250000
NODE_301_length_4274_cov_16.160958	3411	3491	20	2	80	0.0250000
NODE_301_length_4274_cov_16.160958	3411	3491	24	1	80	0.0125000
NODE_301_length_4274_cov_16.160958	3411	3491	26	2	80	0.0250000
NODE_301_length_4274_cov_16.160958	3411	3491	28	1	80	0.0125000
NODE_301_length_4274_cov_16.160958	3411	3491	30	1	80	0.0125000
NODE_301_length_4274_cov_16.160958	3411	3491	32	4	80	0.0500000
NODE_302_length_4270_cov_14.045792	3835	3915	172	3	80	0.0375000
NODE_302_length_4270_cov_14.045792	3835	3915	173	2	80	0.0250000
NODE_302_length_4270_cov_14.045792	3835	3915	178	1	80	0.0125000
NODE_302_length_4270_cov_14.045792	3835	3915	180	1	80	0.0125000
NODE_302_length_4270_cov_14.045792	3835	3915	182	1	80	0.0125000
NODE_302_length_4270_cov_14.045792	3835	3915	186	1	80	0.0125000
NODE_302_length_4270_cov_14.045792	3835	3915	188	1	80	0.0125000
NODE_302_length_4270_cov_14.045792	3835	3915	194	1	80	0.0125000
NODE_302_length_4270_cov_14.045792	3835	3915	200	1	80	0.0125000
NODE_302_length_4270_cov_14.045792	3835	3915	202	5	80	0.0625000
NODE_302_length_4270_cov_14.045792	3835	3915	204	1	80	0.0125000
NODE_302_length_4270_cov_14.045792	3835	3915	210	1	80	0.0125000
NODE_302_length_4270_cov_14.045792	3835	3915	214	1	80	0.0125000
NODE_302_length_4270_cov_14.045792	3835	3915	216	1	80	0.0125000
NODE_302_length_4270_cov_14.045792	3835	3915	219	1	80	0.0125000
NODE_302_length_4270_cov_14.045792	3835	3915	222	1	80	0.0125000
NODE_302_length_4270_cov_14.045792	3835	3915	226	4	80	0.0500000
NODE_302_length_4270_cov_14.045792	3835	3915	230	2	80	0.0250000
NODE_302_length_4270_cov_14.045792	3835	3915	232	1	80	0.0125000
NODE_302_length_4270_cov_14.045792	3835	3915	234	2	80	0.0250000
NODE_302_length_4270_cov_14.045792	3835	3915	235	4	80	0.0500000
NODE_302_length_4270_cov_14.045792	3835	3915	236	5	80	0.0625000
NODE_302_length_4270_cov_14.045792	3835	3915	237	9	80	0.1125000
NODE_302_length_4270_cov_14.045792	3835	3915	238	4	80	0.0500000
NODE_302_length_4270_cov_14.045792	3835	3915	239	2	80	0.0250000
NODE_302_length_4270_cov_14.045792	3835	3915	240	8	80	0.1000000
NODE_302_length_4270_cov_14.045792	3835	3915	241	4	80	0.0500000
NODE_302_length_4270_cov_14.045792	3835	3915	242	2	80	0.0250000
NODE_302_length_4270_cov_14.045792	3835	3915	243	4	80	0.0500000
NODE_302_length_4270_cov_14.045792	3835	3915	244	1	80	0.0125000
NODE_302_length_4270_cov_14.045792	3835	3915	245	5	80	0.0625000
NODE_302_length_4270_cov_14.045792	3888	3968	142	1	80	0.0125000
NODE_302_length_4270_cov_14.045792	3888	3968	143	1	80	0.0125000
NODE_302_length_4270_cov_14.045792	3888	3968	144	2	80	0.0250000
NODE_302_length_4270_cov_14.045792	3888	3968	146	1	80	0.0125000
NODE_302_length_4270_cov_14.045792	3888	3968	150	1	80	0.0125000
NODE_302_length_4270_cov_14.045792	3888	3968	151	4	80	0.0500000
NODE_302_length_4270_cov_14.045792	3888	3968	153	1	80	0.0125000
NODE_302_length_4270_cov_14.045792	3888	3968	156	1	80	0.0125000
NODE_302_length_4270_cov_14.045792	3888	3968	159	2	80	0.0250000
NODE_302_length_4270_cov_14.045792	3888	3968	160	2	80	0.0250000
NODE_302_length_4270_cov_14.045792	3888	3968	161	3	80	0.0375000
NODE_302_length_4270_cov_14.045792	3888	3968	162	1	80	0.0125000
NODE_302_length_4270_cov_14.045792	3888	3968	163	1	80	0.0125000
NODE_302_length_4270_cov_14.045792	3888	3968	164	1	80	0.0125000
NODE_302_length_4270_cov_14.045792	3888	3968	165	1	80	0.0125000
NODE_302_length_4270_cov_14.045792	3888	3968	169	1	80	0.0125000
NODE_302_length_4270_cov_14.045792	3888	3968	173	1	80	0.0125000
NODE_302_length_4270_cov_14.045792	3888	3968	181	3	80	0.0375000
NODE_302_length_4270_cov_14.045792	3888	3968	183	1	80	0.0125000
NODE_302_length_4270_cov_14.045792	3888	3968	185	3	80	0.0375000
NODE_302_length_4270_cov_14.045792	3888	3968	187	3	80	0.0375000
NODE_302_length_4270_cov_14.045792	3888	3968	188	1	80	0.0125000
NODE_302_length_4270_cov_14.045792	3888	3968	189	1	80	0.0125000
NODE_302_length_4270_cov_14.045792	3888	3968	195	1	80	0.0125000
NODE_302_length_4270_cov_14.045792	3888	3968	203	1	80	0.0125000
NODE_302_length_4270_cov_14.045792	3888	3968	204	1	80	0.0125000
NODE_302_length_4270_cov_14.045792	3888	3968	205	1	80	0.0125000
NODE_302_length_4270_cov_14.045792	3888	3968	211	1	80	0.0125000
NODE_302_length_4270_cov_14.045792	3888	3968	212	1	80	0.0125000
NODE_302_length_4270_cov_14.045792	3888	3968	216	1	80	0.0125000
NODE_302_length_4270_cov_14.045792	3888	3968	222	2	80	0.0250000
NODE_302_length_4270_cov_14.045792	3888	3968	228	2	80	0.0250000
NODE_302_length_4270_cov_14.045792	3888	3968	233	2	80	0.0250000
NODE_302_length_4270_cov_14.045792	3888	3968	235	6	80	0.0750000
NODE_302_length_4270_cov_14.045792	3888	3968	237	8	80	0.1000000
NODE_302_length_4270_cov_14.045792	3888	3968	238	3	80	0.0375000
NODE_302_length_4270_cov_14.045792	3888	3968	239	1	80	0.0125000
NODE_302_length_4270_cov_14.045792	3888	3968	240	3	80	0.0375000
NODE_302_length_4270_cov_14.045792	3888	3968	241	1	80	0.0125000
NODE_302_length_4270_cov_14.045792	3888	3968	242	1	80	0.0125000
NODE_302_length_4270_cov_14.045792	3888	3968	243	2	80	0.0250000
NODE_302_length_4270_cov_14.045792	3888	3968	244	1	80	0.0125000
NODE_302_length_4270_cov_14.045792	3888	3968	245	4	80	0.0500000
NODE_303_length_4260_cov_24.780822	244	311	0	46	67	0.6865672
NODE_303_length_4260_cov_24.780822	244	311	2	21	67	0.3134328
NODE_303_length_4260_cov_24.780822	244	311	0	46	67	0.6865672
NODE_303_length_4260_cov_24.780822	244	311	2	21	67	0.3134328
NODE_303_length_4260_cov_24.780822	263	311	0	27	48	0.5625000
NODE_303_length_4260_cov_24.780822	263	311	2	21	48	0.4375000
NODE_303_length_4260_cov_24.780822	1605	1633	2	17	28	0.6071429
NODE_303_length_4260_cov_24.780822	1605	1633	3	2	28	0.0714286
NODE_303_length_4260_cov_24.780822	1605	1633	4	8	28	0.2857143
NODE_303_length_4260_cov_24.780822	1605	1633	26	1	28	0.0357143
NODE_303_length_4260_cov_24.780822	1660	1699	30	4	39	0.1025641
NODE_303_length_4260_cov_24.780822	1660	1699	32	1	39	0.0256410
NODE_303_length_4260_cov_24.780822	1660	1699	34	4	39	0.1025641
NODE_303_length_4260_cov_24.780822	1660	1699	36	2	39	0.0512821
NODE_303_length_4260_cov_24.780822	1660	1699	38	10	39	0.2564103
NODE_303_length_4260_cov_24.780822	1660	1699	40	18	39	0.4615385
NODE_310_length_4207_cov_6.923564	3664	3722	23	15	58	0.2586207
NODE_310_length_4207_cov_6.923564	3664	3722	24	11	58	0.1896552
NODE_310_length_4207_cov_6.923564	3664	3722	30	17	58	0.2931035
NODE_310_length_4207_cov_6.923564	3664	3722	32	12	58	0.2068966
NODE_310_length_4207_cov_6.923564	3664	3722	34	3	58	0.0517241
NODE_310_length_4207_cov_6.923564	3695	3775	11	3	80	0.0375000
NODE_310_length_4207_cov_6.923564	3695	3775	12	3	80	0.0375000
NODE_310_length_4207_cov_6.923564	3695	3775	14	6	80	0.0750000
NODE_310_length_4207_cov_6.923564	3695	3775	16	19	80	0.2375000
NODE_310_length_4207_cov_6.923564	3695	3775	18	1	80	0.0125000
NODE_310_length_4207_cov_6.923564	3695	3775	20	1	80	0.0125000
NODE_310_length_4207_cov_6.923564	3695	3775	23	2	80	0.0250000
NODE_310_length_4207_cov_6.923564	3695	3775	24	4	80	0.0500000
NODE_310_length_4207_cov_6.923564	3695	3775	26	12	80	0.1500000
NODE_310_length_4207_cov_6.923564	3695	3775	28	1	80	0.0125000
NODE_310_length_4207_cov_6.923564	3695	3775	30	13	80	0.1625000
NODE_310_length_4207_cov_6.923564	3695	3775	32	12	80	0.1500000
NODE_310_length_4207_cov_6.923564	3695	3775	34	3	80	0.0375000
NODE_311_length_4205_cov_6.121042	592	632	5	13	40	0.3250000
NODE_311_length_4205_cov_6.121042	592	632	6	7	40	0.1750000
NODE_311_length_4205_cov_6.121042	592	632	8	20	40	0.5000000
NODE_311_length_4205_cov_6.121042	605	685	4	12	80	0.1500000
NODE_311_length_4205_cov_6.121042	605	685	6	13	80	0.1625000
NODE_311_length_4205_cov_6.121042	605	685	8	55	80	0.6875000
NODE_311_length_4205_cov_6.121042	681	745	1	34	64	0.5312500
NODE_311_length_4205_cov_6.121042	681	745	3	19	64	0.2968750
NODE_311_length_4205_cov_6.121042	681	745	4	11	64	0.1718750
NODE_312_length_4196_cov_4.170857	340	420	0	5	80	0.0625000
NODE_312_length_4196_cov_4.170857	340	420	2	75	80	0.9375000
NODE_312_length_4196_cov_4.170857	393	473	0	56	80	0.7000000
NODE_312_length_4196_cov_4.170857	393	473	2	24	80	0.3000000
NODE_316_length_4179_cov_6.655882	1	65	2	1	64	0.0156250
NODE_316_length_4179_cov_6.655882	1	65	4	2	64	0.0312500
NODE_316_length_4179_cov_6.655882	1	65	6	9	64	0.1406250
NODE_316_length_4179_cov_6.655882	1	65	10	6	64	0.0937500
NODE_316_length_4179_cov_6.655882	1	65	12	17	64	0.2656250
NODE_316_length_4179_cov_6.655882	1	65	14	29	64	0.4531250
NODE_316_length_4179_cov_6.655882	1087	1140	4	53	53	1.0000000
NODE_316_length_4179_cov_6.655882	1818	1898	0	80	80	1.0000000
NODE_319_length_4150_cov_10.600099	2827	2849	106	1	22	0.0454545
NODE_319_length_4150_cov_10.600099	2827	2849	108	8	22	0.3636364
NODE_319_length_4150_cov_10.600099	2827	2849	109	1	22	0.0454545
NODE_319_length_4150_cov_10.600099	2827	2849	110	5	22	0.2272727
NODE_319_length_4150_cov_10.600099	2827	2849	112	6	22	0.2727273
NODE_319_length_4150_cov_10.600099	2827	2849	113	1	22	0.0454545
NODE_319_length_4150_cov_10.600099	2973	3053	4	6	80	0.0750000
NODE_319_length_4150_cov_10.600099	2973	3053	6	2	80	0.0250000
NODE_319_length_4150_cov_10.600099	2973	3053	8	7	80	0.0875000
NODE_319_length_4150_cov_10.600099	2973	3053	9	1	80	0.0125000
NODE_319_length_4150_cov_10.600099	2973	3053	10	3	80	0.0375000
NODE_319_length_4150_cov_10.600099	2973	3053	12	9	80	0.1125000
NODE_319_length_4150_cov_10.600099	2973	3053	14	4	80	0.0500000
NODE_319_length_4150_cov_10.600099	2973	3053	16	12	80	0.1500000
NODE_319_length_4150_cov_10.600099	2973	3053	17	1	80	0.0125000
NODE_319_length_4150_cov_10.600099	2973	3053	18	7	80	0.0875000
NODE_319_length_4150_cov_10.600099	2973	3053	20	2	80	0.0250000
NODE_319_length_4150_cov_10.600099	2973	3053	22	1	80	0.0125000
NODE_319_length_4150_cov_10.600099	2973	3053	24	1	80	0.0125000
NODE_319_length_4150_cov_10.600099	2973	3053	27	3	80	0.0375000
NODE_319_length_4150_cov_10.600099	2973	3053	29	1	80	0.0125000
NODE_319_length_4150_cov_10.600099	2973	3053	32	2	80	0.0250000
NODE_319_length_4150_cov_10.600099	2973	3053	33	4	80	0.0500000
NODE_319_length_4150_cov_10.600099	2973	3053	34	5	80	0.0625000
NODE_319_length_4150_cov_10.600099	2973	3053	36	1	80	0.0125000
NODE_319_length_4150_cov_10.600099	2973	3053	37	3	80	0.0375000
NODE_319_length_4150_cov_10.600099	2973	3053	38	5	80	0.0625000
NODE_319_length_4150_cov_10.600099	3026	3106	20	1	80	0.0125000
NODE_319_length_4150_cov_10.600099	3026	3106	22	1	80	0.0125000
NODE_319_length_4150_cov_10.600099	3026	3106	24	1	80	0.0125000
NODE_319_length_4150_cov_10.600099	3026	3106	27	3	80	0.0375000
NODE_319_length_4150_cov_10.600099	3026	3106	29	1	80	0.0125000
NODE_319_length_4150_cov_10.600099	3026	3106	32	2	80	0.0250000
NODE_319_length_4150_cov_10.600099	3026	3106	33	4	80	0.0500000
NODE_319_length_4150_cov_10.600099	3026	3106	34	5	80	0.0625000
NODE_319_length_4150_cov_10.600099	3026	3106	36	2	80	0.0250000
NODE_319_length_4150_cov_10.600099	3026	3106	37	3	80	0.0375000
NODE_319_length_4150_cov_10.600099	3026	3106	38	15	80	0.1875000
NODE_319_length_4150_cov_10.600099	3026	3106	40	3	80	0.0375000
NODE_319_length_4150_cov_10.600099	3026	3106	42	5	80	0.0625000
NODE_319_length_4150_cov_10.600099	3026	3106	44	13	80	0.1625000
NODE_319_length_4150_cov_10.600099	3026	3106	46	4	80	0.0500000
NODE_319_length_4150_cov_10.600099	3026	3106	48	8	80	0.1000000
NODE_319_length_4150_cov_10.600099	3026	3106	50	5	80	0.0625000
NODE_319_length_4150_cov_10.600099	3026	3106	52	4	80	0.0500000
NODE_324_length_4119_cov_27.984328	2818	2898	74	2	80	0.0250000
NODE_324_length_4119_cov_27.984328	2818	2898	76	1	80	0.0125000
NODE_324_length_4119_cov_27.984328	2818	2898	81	1	80	0.0125000
NODE_324_length_4119_cov_27.984328	2818	2898	84	1	80	0.0125000
NODE_324_length_4119_cov_27.984328	2818	2898	88	3	80	0.0375000
NODE_324_length_4119_cov_27.984328	2818	2898	94	1	80	0.0125000
NODE_324_length_4119_cov_27.984328	2818	2898	98	1	80	0.0125000
NODE_324_length_4119_cov_27.984328	2818	2898	100	1	80	0.0125000
NODE_324_length_4119_cov_27.984328	2818	2898	102	2	80	0.0250000
NODE_324_length_4119_cov_27.984328	2818	2898	104	3	80	0.0375000
NODE_324_length_4119_cov_27.984328	2818	2898	108	1	80	0.0125000
NODE_324_length_4119_cov_27.984328	2818	2898	110	2	80	0.0250000
NODE_324_length_4119_cov_27.984328	2818	2898	111	1	80	0.0125000
NODE_324_length_4119_cov_27.984328	2818	2898	113	3	80	0.0375000
NODE_324_length_4119_cov_27.984328	2818	2898	114	2	80	0.0250000
NODE_324_length_4119_cov_27.984328	2818	2898	115	1	80	0.0125000
NODE_324_length_4119_cov_27.984328	2818	2898	116	6	80	0.0750000
NODE_324_length_4119_cov_27.984328	2818	2898	118	6	80	0.0750000
NODE_324_length_4119_cov_27.984328	2818	2898	120	2	80	0.0250000
NODE_324_length_4119_cov_27.984328	2818	2898	122	4	80	0.0500000
NODE_324_length_4119_cov_27.984328	2818	2898	123	2	80	0.0250000
NODE_324_length_4119_cov_27.984328	2818	2898	124	6	80	0.0750000
NODE_324_length_4119_cov_27.984328	2818	2898	126	1	80	0.0125000
NODE_324_length_4119_cov_27.984328	2818	2898	128	2	80	0.0250000
NODE_324_length_4119_cov_27.984328	2818	2898	130	1	80	0.0125000
NODE_324_length_4119_cov_27.984328	2818	2898	131	3	80	0.0375000
NODE_324_length_4119_cov_27.984328	2818	2898	132	10	80	0.1250000
NODE_324_length_4119_cov_27.984328	2818	2898	133	4	80	0.0500000
NODE_324_length_4119_cov_27.984328	2818	2898	134	7	80	0.0875000
NODE_325_length_4108_cov_14.755550	378	422	0	44	44	1.0000000
NODE_325_length_4108_cov_14.755550	3537	3617	0	80	80	1.0000000
NODE_325_length_4108_cov_14.755550	3590	3670	0	80	80	1.0000000
NODE_326_length_4107_cov_1.855539	207	287	0	50	80	0.6250000
NODE_326_length_4107_cov_1.855539	207	287	2	30	80	0.3750000
NODE_328_length_4096_cov_31.197648	379	459	2	70	80	0.8750000
NODE_328_length_4096_cov_31.197648	379	459	3	1	80	0.0125000
NODE_328_length_4096_cov_31.197648	379	459	4	9	80	0.1125000
NODE_328_length_4096_cov_31.197648	432	512	2	27	80	0.3375000
NODE_328_length_4096_cov_31.197648	432	512	3	19	80	0.2375000
NODE_328_length_4096_cov_31.197648	432	512	4	34	80	0.4250000
NODE_328_length_4096_cov_31.197648	3305	3385	0	80	80	1.0000000
NODE_328_length_4096_cov_31.197648	3358	3438	0	80	80	1.0000000
NODE_329_length_4081_cov_20.248870	3673	3753	4	30	80	0.3750000
NODE_329_length_4081_cov_20.248870	3673	3753	6	49	80	0.6125000
NODE_329_length_4081_cov_20.248870	3673	3753	8	1	80	0.0125000
NODE_329_length_4081_cov_20.248870	3726	3806	2	41	80	0.5125000
NODE_329_length_4081_cov_20.248870	3726	3806	4	39	80	0.4875000
NODE_330_length_4076_cov_15.138044	1062	1142	2	49	80	0.6125000
NODE_330_length_4076_cov_15.138044	1062	1142	4	14	80	0.1750000
NODE_330_length_4076_cov_15.138044	1062	1142	6	17	80	0.2125000
NODE_330_length_4076_cov_15.138044	1115	1195	4	55	80	0.6875000
NODE_330_length_4076_cov_15.138044	1115	1195	5	6	80	0.0750000
NODE_330_length_4076_cov_15.138044	1115	1195	6	19	80	0.2375000
NODE_331_length_4069_cov_14.261209	3871	3936	0	65	65	1.0000000
NODE_333_length_4050_cov_31.044039	1703	1783	38	7	80	0.0875000
NODE_333_length_4050_cov_31.044039	1703	1783	40	16	80	0.2000000
NODE_333_length_4050_cov_31.044039	1703	1783	41	8	80	0.1000000
NODE_333_length_4050_cov_31.044039	1703	1783	42	5	80	0.0625000
NODE_333_length_4050_cov_31.044039	1703	1783	44	7	80	0.0875000
NODE_333_length_4050_cov_31.044039	1703	1783	45	14	80	0.1750000
NODE_333_length_4050_cov_31.044039	1703	1783	46	1	80	0.0125000
NODE_333_length_4050_cov_31.044039	1703	1783	49	15	80	0.1875000
NODE_333_length_4050_cov_31.044039	1703	1783	51	2	80	0.0250000
NODE_333_length_4050_cov_31.044039	1703	1783	53	5	80	0.0625000
NODE_335_length_4021_cov_34.619072	379	459	6	3	80	0.0375000
NODE_335_length_4021_cov_34.619072	379	459	12	6	80	0.0750000
NODE_335_length_4021_cov_34.619072	379	459	15	1	80	0.0125000
NODE_335_length_4021_cov_34.619072	379	459	16	30	80	0.3750000
NODE_335_length_4021_cov_34.619072	379	459	18	40	80	0.5000000
NODE_335_length_4021_cov_34.619072	432	512	4	42	80	0.5250000
NODE_335_length_4021_cov_34.619072	432	512	6	14	80	0.1750000
NODE_335_length_4021_cov_34.619072	432	512	15	1	80	0.0125000
NODE_335_length_4021_cov_34.619072	432	512	16	10	80	0.1250000
NODE_335_length_4021_cov_34.619072	432	512	18	13	80	0.1625000
NODE_336_length_4020_cov_5.130834	3455	3535	0	9	80	0.1125000
NODE_336_length_4020_cov_5.130834	3455	3535	4	71	80	0.8875000
NODE_336_length_4020_cov_5.130834	3508	3588	4	80	80	1.0000000
NODE_339_length_4004_cov_9.718054	387	467	0	80	80	1.0000000
NODE_339_length_4004_cov_9.718054	440	520	0	80	80	1.0000000
NODE_339_length_4004_cov_9.718054	516	596	0	33	80	0.4125000
NODE_339_length_4004_cov_9.718054	516	596	2	47	80	0.5875000
NODE_339_length_4004_cov_9.718054	569	649	2	80	80	1.0000000
NODE_341_length_3991_cov_18.617934	867	947	0	80	80	1.0000000
NODE_341_length_3991_cov_18.617934	920	1000	0	80	80	1.0000000
NODE_341_length_3991_cov_18.617934	996	1076	0	11	80	0.1375000
NODE_341_length_3991_cov_18.617934	996	1076	17	69	80	0.8625000
NODE_341_length_3991_cov_18.617934	1049	1124	17	73	75	0.9733334
NODE_341_length_3991_cov_18.617934	1049	1124	19	2	75	0.0266667
NODE_348_length_3973_cov_6.906298	17	65	0	41	48	0.8541667
NODE_348_length_3973_cov_6.906298	17	65	2	7	48	0.1458333
NODE_348_length_3973_cov_6.906298	1945	1995	16	9	50	0.1800000
NODE_348_length_3973_cov_6.906298	1945	1995	20	1	50	0.0200000
NODE_348_length_3973_cov_6.906298	1945	1995	22	1	50	0.0200000
NODE_348_length_3973_cov_6.906298	1945	1995	24	17	50	0.3400000
NODE_348_length_3973_cov_6.906298	1945	1995	26	15	50	0.3000000
NODE_348_length_3973_cov_6.906298	1945	1995	30	1	50	0.0200000
NODE_348_length_3973_cov_6.906298	1945	1995	33	1	50	0.0200000
NODE_348_length_3973_cov_6.906298	1945	1995	34	4	50	0.0800000
NODE_348_length_3973_cov_6.906298	1945	1995	36	1	50	0.0200000
NODE_350_length_3960_cov_6.246827	2673	2761	0	88	88	1.0000000
NODE_350_length_3960_cov_6.246827	3520	3600	0	80	80	1.0000000
NODE_350_length_3960_cov_6.246827	3573	3653	0	80	80	1.0000000
NODE_353_length_3952_cov_8.805346	826	906	0	57	80	0.7125000
NODE_353_length_3952_cov_8.805346	826	906	4	23	80	0.2875000
NODE_353_length_3952_cov_8.805346	879	959	0	80	80	1.0000000
NODE_354_length_3928_cov_5.936798	2440	2521	1	1	81	0.0123457
NODE_354_length_3928_cov_5.936798	2440	2521	2	37	81	0.4567901
NODE_354_length_3928_cov_5.936798	2440	2521	3	13	81	0.1604938
NODE_354_length_3928_cov_5.936798	2440	2521	4	30	81	0.3703704
NODE_354_length_3928_cov_5.936798	2493	2574	2	1	81	0.0123457
NODE_354_length_3928_cov_5.936798	2493	2574	4	52	81	0.6419753
NODE_354_length_3928_cov_5.936798	2493	2574	6	28	81	0.3456790
NODE_356_length_3923_cov_14.807793	3759	3800	0	10	41	0.2439024
NODE_356_length_3923_cov_14.807793	3759	3800	2	31	41	0.7560976
NODE_358_length_3922_cov_7.609731	1493	1573	95	1	80	0.0125000
NODE_358_length_3922_cov_7.609731	1493	1573	99	4	80	0.0500000
NODE_358_length_3922_cov_7.609731	1493	1573	101	1	80	0.0125000
NODE_358_length_3922_cov_7.609731	1493	1573	103	1	80	0.0125000
NODE_358_length_3922_cov_7.609731	1493	1573	104	1	80	0.0125000
NODE_358_length_3922_cov_7.609731	1493	1573	106	1	80	0.0125000
NODE_358_length_3922_cov_7.609731	1493	1573	107	1	80	0.0125000
NODE_358_length_3922_cov_7.609731	1493	1573	110	1	80	0.0125000
NODE_358_length_3922_cov_7.609731	1493	1573	112	1	80	0.0125000
NODE_358_length_3922_cov_7.609731	1493	1573	114	1	80	0.0125000
NODE_358_length_3922_cov_7.609731	1493	1573	118	2	80	0.0250000
NODE_358_length_3922_cov_7.609731	1493	1573	120	3	80	0.0375000
NODE_358_length_3922_cov_7.609731	1493	1573	126	1	80	0.0125000
NODE_358_length_3922_cov_7.609731	1493	1573	128	4	80	0.0500000
NODE_358_length_3922_cov_7.609731	1493	1573	129	9	80	0.1125000
NODE_358_length_3922_cov_7.609731	1493	1573	130	10	80	0.1250000
NODE_358_length_3922_cov_7.609731	1493	1573	131	6	80	0.0750000
NODE_358_length_3922_cov_7.609731	1493	1573	132	1	80	0.0125000
NODE_358_length_3922_cov_7.609731	1493	1573	133	5	80	0.0625000
NODE_358_length_3922_cov_7.609731	1493	1573	134	3	80	0.0375000
NODE_358_length_3922_cov_7.609731	1493	1573	135	7	80	0.0875000
NODE_358_length_3922_cov_7.609731	1493	1573	137	2	80	0.0250000
NODE_358_length_3922_cov_7.609731	1493	1573	138	2	80	0.0250000
NODE_358_length_3922_cov_7.609731	1493	1573	139	3	80	0.0375000
NODE_358_length_3922_cov_7.609731	1493	1573	140	2	80	0.0250000
NODE_358_length_3922_cov_7.609731	1493	1573	141	3	80	0.0375000
NODE_358_length_3922_cov_7.609731	1493	1573	142	4	80	0.0500000
NODE_358_length_3922_cov_7.609731	1546	1600	106	1	54	0.0185185
NODE_358_length_3922_cov_7.609731	1546	1600	112	6	54	0.1111111
NODE_358_length_3922_cov_7.609731	1546	1600	114	3	54	0.0555556
NODE_358_length_3922_cov_7.609731	1546	1600	116	1	54	0.0185185
NODE_358_length_3922_cov_7.609731	1546	1600	124	1	54	0.0185185
NODE_358_length_3922_cov_7.609731	1546	1600	126	8	54	0.1481481
NODE_358_length_3922_cov_7.609731	1546	1600	127	1	54	0.0185185
NODE_358_length_3922_cov_7.609731	1546	1600	128	7	54	0.1296296
NODE_358_length_3922_cov_7.609731	1546	1600	133	1	54	0.0185185
NODE_358_length_3922_cov_7.609731	1546	1600	134	2	54	0.0370370
NODE_358_length_3922_cov_7.609731	1546	1600	135	7	54	0.1296296
NODE_358_length_3922_cov_7.609731	1546	1600	137	2	54	0.0370370
NODE_358_length_3922_cov_7.609731	1546	1600	138	2	54	0.0370370
NODE_358_length_3922_cov_7.609731	1546	1600	139	3	54	0.0555556
NODE_358_length_3922_cov_7.609731	1546	1600	140	2	54	0.0370370
NODE_358_length_3922_cov_7.609731	1546	1600	141	3	54	0.0555556
NODE_358_length_3922_cov_7.609731	1546	1600	142	4	54	0.0740741
NODE_359_length_3921_cov_9.943223	2936	3016	274	2	80	0.0250000
NODE_359_length_3921_cov_9.943223	2936	3016	276	1	80	0.0125000
NODE_359_length_3921_cov_9.943223	2936	3016	282	1	80	0.0125000
NODE_359_length_3921_cov_9.943223	2936	3016	285	1	80	0.0125000
NODE_359_length_3921_cov_9.943223	2936	3016	288	2	80	0.0250000
NODE_359_length_3921_cov_9.943223	2936	3016	290	7	80	0.0875000
NODE_359_length_3921_cov_9.943223	2936	3016	295	1	80	0.0125000
NODE_359_length_3921_cov_9.943223	2936	3016	296	2	80	0.0250000
NODE_359_length_3921_cov_9.943223	2936	3016	297	1	80	0.0125000
NODE_359_length_3921_cov_9.943223	2936	3016	298	4	80	0.0500000
NODE_359_length_3921_cov_9.943223	2936	3016	300	1	80	0.0125000
NODE_359_length_3921_cov_9.943223	2936	3016	301	1	80	0.0125000
NODE_359_length_3921_cov_9.943223	2936	3016	303	1	80	0.0125000
NODE_359_length_3921_cov_9.943223	2936	3016	306	2	80	0.0250000
NODE_359_length_3921_cov_9.943223	2936	3016	309	1	80	0.0125000
NODE_359_length_3921_cov_9.943223	2936	3016	310	2	80	0.0250000
NODE_359_length_3921_cov_9.943223	2936	3016	312	3	80	0.0375000
NODE_359_length_3921_cov_9.943223	2936	3016	313	2	80	0.0250000
NODE_359_length_3921_cov_9.943223	2936	3016	314	2	80	0.0250000
NODE_359_length_3921_cov_9.943223	2936	3016	315	1	80	0.0125000
NODE_359_length_3921_cov_9.943223	2936	3016	316	2	80	0.0250000
NODE_359_length_3921_cov_9.943223	2936	3016	320	2	80	0.0250000
NODE_359_length_3921_cov_9.943223	2936	3016	323	1	80	0.0125000
NODE_359_length_3921_cov_9.943223	2936	3016	324	1	80	0.0125000
NODE_359_length_3921_cov_9.943223	2936	3016	325	2	80	0.0250000
NODE_359_length_3921_cov_9.943223	2936	3016	326	2	80	0.0250000
NODE_359_length_3921_cov_9.943223	2936	3016	327	3	80	0.0375000
NODE_359_length_3921_cov_9.943223	2936	3016	328	2	80	0.0250000
NODE_359_length_3921_cov_9.943223	2936	3016	331	2	80	0.0250000
NODE_359_length_3921_cov_9.943223	2936	3016	333	1	80	0.0125000
NODE_359_length_3921_cov_9.943223	2936	3016	334	3	80	0.0375000
NODE_359_length_3921_cov_9.943223	2936	3016	336	1	80	0.0125000
NODE_359_length_3921_cov_9.943223	2936	3016	339	1	80	0.0125000
NODE_359_length_3921_cov_9.943223	2936	3016	342	1	80	0.0125000
NODE_359_length_3921_cov_9.943223	2936	3016	345	1	80	0.0125000
NODE_359_length_3921_cov_9.943223	2936	3016	346	1	80	0.0125000
NODE_359_length_3921_cov_9.943223	2936	3016	347	2	80	0.0250000
NODE_359_length_3921_cov_9.943223	2936	3016	348	1	80	0.0125000
NODE_359_length_3921_cov_9.943223	2936	3016	349	1	80	0.0125000
NODE_359_length_3921_cov_9.943223	2936	3016	350	1	80	0.0125000
NODE_359_length_3921_cov_9.943223	2936	3016	351	8	80	0.1000000
NODE_359_length_3921_cov_9.943223	2936	3016	352	1	80	0.0125000
NODE_359_length_3921_cov_9.943223	2936	3016	353	2	80	0.0250000
NODE_359_length_3921_cov_9.943223	2989	3057	241	2	68	0.0294118
NODE_359_length_3921_cov_9.943223	2989	3057	245	2	68	0.0294118
NODE_359_length_3921_cov_9.943223	2989	3057	247	1	68	0.0147059
NODE_359_length_3921_cov_9.943223	2989	3057	250	3	68	0.0441176
NODE_359_length_3921_cov_9.943223	2989	3057	256	1	68	0.0147059
NODE_359_length_3921_cov_9.943223	2989	3057	263	1	68	0.0147059
NODE_359_length_3921_cov_9.943223	2989	3057	275	1	68	0.0147059
NODE_359_length_3921_cov_9.943223	2989	3057	277	2	68	0.0294118
NODE_359_length_3921_cov_9.943223	2989	3057	283	1	68	0.0147059
NODE_359_length_3921_cov_9.943223	2989	3057	295	1	68	0.0147059
NODE_359_length_3921_cov_9.943223	2989	3057	299	2	68	0.0294118
NODE_359_length_3921_cov_9.943223	2989	3057	301	1	68	0.0147059
NODE_359_length_3921_cov_9.943223	2989	3057	302	1	68	0.0147059
NODE_359_length_3921_cov_9.943223	2989	3057	308	2	68	0.0294118
NODE_359_length_3921_cov_9.943223	2989	3057	312	2	68	0.0294118
NODE_359_length_3921_cov_9.943223	2989	3057	313	1	68	0.0147059
NODE_359_length_3921_cov_9.943223	2989	3057	314	1	68	0.0147059
NODE_359_length_3921_cov_9.943223	2989	3057	316	2	68	0.0294118
NODE_359_length_3921_cov_9.943223	2989	3057	317	1	68	0.0147059
NODE_359_length_3921_cov_9.943223	2989	3057	318	3	68	0.0441176
NODE_359_length_3921_cov_9.943223	2989	3057	319	1	68	0.0147059
NODE_359_length_3921_cov_9.943223	2989	3057	320	1	68	0.0147059
NODE_359_length_3921_cov_9.943223	2989	3057	322	2	68	0.0294118
NODE_359_length_3921_cov_9.943223	2989	3057	323	2	68	0.0294118
NODE_359_length_3921_cov_9.943223	2989	3057	329	2	68	0.0294118
NODE_359_length_3921_cov_9.943223	2989	3057	331	2	68	0.0294118
NODE_359_length_3921_cov_9.943223	2989	3057	333	2	68	0.0294118
NODE_359_length_3921_cov_9.943223	2989	3057	334	3	68	0.0441176
NODE_359_length_3921_cov_9.943223	2989	3057	336	1	68	0.0147059
NODE_359_length_3921_cov_9.943223	2989	3057	339	2	68	0.0294118
NODE_359_length_3921_cov_9.943223	2989	3057	342	1	68	0.0147059
NODE_359_length_3921_cov_9.943223	2989	3057	345	1	68	0.0147059
NODE_359_length_3921_cov_9.943223	2989	3057	346	1	68	0.0147059
NODE_359_length_3921_cov_9.943223	2989	3057	347	2	68	0.0294118
NODE_359_length_3921_cov_9.943223	2989	3057	348	1	68	0.0147059
NODE_359_length_3921_cov_9.943223	2989	3057	349	1	68	0.0147059
NODE_359_length_3921_cov_9.943223	2989	3057	350	1	68	0.0147059
NODE_359_length_3921_cov_9.943223	2989	3057	351	8	68	0.1176471
NODE_359_length_3921_cov_9.943223	2989	3057	352	1	68	0.0147059
NODE_359_length_3921_cov_9.943223	2989	3057	353	2	68	0.0294118
NODE_359_length_3921_cov_9.943223	3047	3066	200	1	19	0.0526316
NODE_359_length_3921_cov_9.943223	3047	3066	207	1	19	0.0526316
NODE_359_length_3921_cov_9.943223	3047	3066	209	1	19	0.0526316
NODE_359_length_3921_cov_9.943223	3047	3066	212	1	19	0.0526316
NODE_359_length_3921_cov_9.943223	3047	3066	220	1	19	0.0526316
NODE_359_length_3921_cov_9.943223	3047	3066	227	1	19	0.0526316
NODE_359_length_3921_cov_9.943223	3047	3066	237	1	19	0.0526316
NODE_359_length_3921_cov_9.943223	3047	3066	239	2	19	0.1052632
NODE_359_length_3921_cov_9.943223	3047	3066	241	2	19	0.1052632
NODE_359_length_3921_cov_9.943223	3047	3066	245	2	19	0.1052632
NODE_359_length_3921_cov_9.943223	3047	3066	247	1	19	0.0526316
NODE_359_length_3921_cov_9.943223	3047	3066	250	3	19	0.1578947
NODE_359_length_3921_cov_9.943223	3047	3066	256	1	19	0.0526316
NODE_359_length_3921_cov_9.943223	3047	3066	263	1	19	0.0526316
NODE_363_length_3898_cov_40.033167	3296	3370	82	8	74	0.1081081
NODE_363_length_3898_cov_40.033167	3296	3370	86	2	74	0.0270270
NODE_363_length_3898_cov_40.033167	3296	3370	91	3	74	0.0405405
NODE_363_length_3898_cov_40.033167	3296	3370	93	5	74	0.0675676
NODE_363_length_3898_cov_40.033167	3296	3370	94	1	74	0.0135135
NODE_363_length_3898_cov_40.033167	3296	3370	95	8	74	0.1081081
NODE_363_length_3898_cov_40.033167	3296	3370	96	15	74	0.2027027
NODE_363_length_3898_cov_40.033167	3296	3370	99	21	74	0.2837838
NODE_363_length_3898_cov_40.033167	3296	3370	103	11	74	0.1486486
NODE_363_length_3898_cov_40.033167	3539	3619	14	9	80	0.1125000
NODE_363_length_3898_cov_40.033167	3539	3619	16	16	80	0.2000000
NODE_363_length_3898_cov_40.033167	3539	3619	17	4	80	0.0500000
NODE_363_length_3898_cov_40.033167	3539	3619	18	11	80	0.1375000
NODE_363_length_3898_cov_40.033167	3539	3619	19	20	80	0.2500000
NODE_363_length_3898_cov_40.033167	3539	3619	21	18	80	0.2250000
NODE_363_length_3898_cov_40.033167	3539	3619	23	2	80	0.0250000
NODE_364_length_3898_cov_7.550145	668	748	0	50	80	0.6250000
NODE_364_length_3898_cov_7.550145	668	748	2	30	80	0.3750000
NODE_364_length_3898_cov_7.550145	721	801	2	74	80	0.9250000
NODE_364_length_3898_cov_7.550145	721	801	6	1	80	0.0125000
NODE_364_length_3898_cov_7.550145	721	801	20	1	80	0.0125000
NODE_364_length_3898_cov_7.550145	721	801	28	1	80	0.0125000
NODE_364_length_3898_cov_7.550145	721	801	38	1	80	0.0125000
NODE_364_length_3898_cov_7.550145	721	801	42	2	80	0.0250000
NODE_367_length_3882_cov_4.166006	3244	3324	0	3	80	0.0375000
NODE_367_length_3882_cov_4.166006	3244	3324	2	4	80	0.0500000
NODE_367_length_3882_cov_4.166006	3244	3324	4	3	80	0.0375000
NODE_367_length_3882_cov_4.166006	3244	3324	6	2	80	0.0250000
NODE_367_length_3882_cov_4.166006	3244	3324	10	68	80	0.8500000
NODE_367_length_3882_cov_4.166006	3282	3324	0	3	42	0.0714286
NODE_367_length_3882_cov_4.166006	3282	3324	2	4	42	0.0952381
NODE_367_length_3882_cov_4.166006	3282	3324	4	3	42	0.0714286
NODE_367_length_3882_cov_4.166006	3282	3324	6	2	42	0.0476190
NODE_367_length_3882_cov_4.166006	3282	3324	10	30	42	0.7142857
NODE_367_length_3882_cov_4.166006	3297	3377	0	56	80	0.7000000
NODE_367_length_3882_cov_4.166006	3297	3377	2	4	80	0.0500000
NODE_367_length_3882_cov_4.166006	3297	3377	4	3	80	0.0375000
NODE_367_length_3882_cov_4.166006	3297	3377	6	2	80	0.0250000
NODE_367_length_3882_cov_4.166006	3297	3377	10	15	80	0.1875000
NODE_367_length_3882_cov_4.166006	3297	3377	0	56	80	0.7000000
NODE_367_length_3882_cov_4.166006	3297	3377	2	4	80	0.0500000
NODE_367_length_3882_cov_4.166006	3297	3377	4	3	80	0.0375000
NODE_367_length_3882_cov_4.166006	3297	3377	6	2	80	0.0250000
NODE_367_length_3882_cov_4.166006	3297	3377	10	15	80	0.1875000
NODE_367_length_3882_cov_4.166006	3373	3450	0	77	77	1.0000000
NODE_374_length_3853_cov_18.816196	524	579	17	9	55	0.1636364
NODE_374_length_3853_cov_18.816196	524	579	18	6	55	0.1090909
NODE_374_length_3853_cov_18.816196	524	579	19	2	55	0.0363636
NODE_374_length_3853_cov_18.816196	524	579	20	23	55	0.4181818
NODE_374_length_3853_cov_18.816196	524	579	21	15	55	0.2727273
NODE_374_length_3853_cov_18.816196	559	639	3	8	80	0.1000000
NODE_374_length_3853_cov_18.816196	559	639	5	3	80	0.0375000
NODE_374_length_3853_cov_18.816196	559	639	16	11	80	0.1375000
NODE_374_length_3853_cov_18.816196	559	639	17	10	80	0.1250000
NODE_374_length_3853_cov_18.816196	559	639	19	9	80	0.1125000
NODE_374_length_3853_cov_18.816196	559	639	20	5	80	0.0625000
NODE_374_length_3853_cov_18.816196	559	639	21	34	80	0.4250000
NODE_379_length_3829_cov_12.697319	515	595	0	7	80	0.0875000
NODE_379_length_3829_cov_12.697319	515	595	2	33	80	0.4125000
NODE_379_length_3829_cov_12.697319	515	595	8	40	80	0.5000000
NODE_379_length_3829_cov_12.697319	568	648	2	11	80	0.1375000
NODE_379_length_3829_cov_12.697319	568	648	6	7	80	0.0875000
NODE_379_length_3829_cov_12.697319	568	648	8	62	80	0.7750000
NODE_379_length_3829_cov_12.697319	644	724	0	30	80	0.3750000
NODE_379_length_3829_cov_12.697319	644	724	2	50	80	0.6250000
NODE_379_length_3829_cov_12.697319	697	777	0	80	80	1.0000000
NODE_381_length_3815_cov_17.218784	399	479	11	14	80	0.1750000
NODE_381_length_3815_cov_17.218784	399	479	13	8	80	0.1000000
NODE_381_length_3815_cov_17.218784	399	479	14	8	80	0.1000000
NODE_381_length_3815_cov_17.218784	399	479	18	14	80	0.1750000
NODE_381_length_3815_cov_17.218784	399	479	20	13	80	0.1625000
NODE_381_length_3815_cov_17.218784	399	479	21	12	80	0.1500000
NODE_381_length_3815_cov_17.218784	399	479	25	11	80	0.1375000
NODE_381_length_3815_cov_17.218784	452	532	0	9	80	0.1125000
NODE_381_length_3815_cov_17.218784	452	532	6	1	80	0.0125000
NODE_381_length_3815_cov_17.218784	452	532	7	1	80	0.0125000
NODE_381_length_3815_cov_17.218784	452	532	8	14	80	0.1750000
NODE_381_length_3815_cov_17.218784	452	532	12	12	80	0.1500000
NODE_381_length_3815_cov_17.218784	452	532	14	24	80	0.3000000
NODE_381_length_3815_cov_17.218784	452	532	18	14	80	0.1750000
NODE_381_length_3815_cov_17.218784	452	532	20	5	80	0.0625000
NODE_383_length_3812_cov_65.007272	840	903	14	1	63	0.0158730
NODE_383_length_3812_cov_65.007272	840	903	19	1	63	0.0158730
NODE_383_length_3812_cov_65.007272	840	903	23	1	63	0.0158730
NODE_383_length_3812_cov_65.007272	840	903	28	1	63	0.0158730
NODE_383_length_3812_cov_65.007272	840	903	36	1	63	0.0158730
NODE_383_length_3812_cov_65.007272	840	903	45	2	63	0.0317460
NODE_383_length_3812_cov_65.007272	840	903	56	2	63	0.0317460
NODE_383_length_3812_cov_65.007272	840	903	67	2	63	0.0317460
NODE_383_length_3812_cov_65.007272	840	903	68	1	63	0.0158730
NODE_383_length_3812_cov_65.007272	840	903	75	2	63	0.0317460
NODE_383_length_3812_cov_65.007272	840	903	79	1	63	0.0158730
NODE_383_length_3812_cov_65.007272	840	903	81	1	63	0.0158730
NODE_383_length_3812_cov_65.007272	840	903	89	1	63	0.0158730
NODE_383_length_3812_cov_65.007272	840	903	94	2	63	0.0317460
NODE_383_length_3812_cov_65.007272	840	903	95	2	63	0.0317460
NODE_383_length_3812_cov_65.007272	840	903	101	1	63	0.0158730
NODE_383_length_3812_cov_65.007272	840	903	103	1	63	0.0158730
NODE_383_length_3812_cov_65.007272	840	903	105	1	63	0.0158730
NODE_383_length_3812_cov_65.007272	840	903	114	1	63	0.0158730
NODE_383_length_3812_cov_65.007272	840	903	116	1	63	0.0158730
NODE_383_length_3812_cov_65.007272	840	903	119	1	63	0.0158730
NODE_383_length_3812_cov_65.007272	840	903	120	1	63	0.0158730
NODE_383_length_3812_cov_65.007272	840	903	126	2	63	0.0317460
NODE_383_length_3812_cov_65.007272	840	903	138	2	63	0.0317460
NODE_383_length_3812_cov_65.007272	840	903	148	1	63	0.0158730
NODE_383_length_3812_cov_65.007272	840	903	152	1	63	0.0158730
NODE_383_length_3812_cov_65.007272	840	903	154	2	63	0.0317460
NODE_383_length_3812_cov_65.007272	840	903	156	1	63	0.0158730
NODE_383_length_3812_cov_65.007272	840	903	160	1	63	0.0158730
NODE_383_length_3812_cov_65.007272	840	903	162	1	63	0.0158730
NODE_383_length_3812_cov_65.007272	840	903	164	2	63	0.0317460
NODE_383_length_3812_cov_65.007272	840	903	170	4	63	0.0634921
NODE_383_length_3812_cov_65.007272	840	903	172	2	63	0.0317460
NODE_383_length_3812_cov_65.007272	840	903	176	1	63	0.0158730
NODE_383_length_3812_cov_65.007272	840	903	178	1	63	0.0158730
NODE_383_length_3812_cov_65.007272	840	903	184	1	63	0.0158730
NODE_383_length_3812_cov_65.007272	840	903	187	3	63	0.0476190
NODE_383_length_3812_cov_65.007272	840	903	192	2	63	0.0317460
NODE_383_length_3812_cov_65.007272	840	903	198	1	63	0.0158730
NODE_383_length_3812_cov_65.007272	840	903	200	1	63	0.0158730
NODE_383_length_3812_cov_65.007272	840	903	201	1	63	0.0158730
NODE_383_length_3812_cov_65.007272	840	903	203	2	63	0.0317460
NODE_383_length_3812_cov_65.007272	840	903	205	1	63	0.0158730
NODE_383_length_3812_cov_65.007272	840	903	210	1	63	0.0158730
NODE_383_length_3812_cov_65.007272	840	903	218	1	63	0.0158730
NODE_384_length_3805_cov_9.533189	145	236	0	91	91	1.0000000
NODE_384_length_3805_cov_9.533189	209	279	0	70	70	1.0000000
NODE_386_length_3799_cov_10.046486	2944	3024	4	11	80	0.1375000
NODE_386_length_3799_cov_10.046486	2944	3024	8	11	80	0.1375000
NODE_386_length_3799_cov_10.046486	2944	3024	9	2	80	0.0250000
NODE_386_length_3799_cov_10.046486	2944	3024	11	16	80	0.2000000
NODE_386_length_3799_cov_10.046486	2944	3024	13	36	80	0.4500000
NODE_386_length_3799_cov_10.046486	2944	3024	23	4	80	0.0500000
NODE_386_length_3799_cov_10.046486	2997	3077	0	18	80	0.2250000
NODE_386_length_3799_cov_10.046486	2997	3077	2	30	80	0.3750000
NODE_386_length_3799_cov_10.046486	2997	3077	4	16	80	0.2000000
NODE_386_length_3799_cov_10.046486	2997	3077	8	11	80	0.1375000
NODE_386_length_3799_cov_10.046486	2997	3077	9	2	80	0.0250000
NODE_386_length_3799_cov_10.046486	2997	3077	11	3	80	0.0375000
NODE_388_length_3795_cov_13.724297	3350	3430	0	80	80	1.0000000
NODE_388_length_3795_cov_13.724297	3403	3483	0	68	80	0.8500000
NODE_388_length_3795_cov_13.724297	3403	3483	6	12	80	0.1500000
NODE_388_length_3795_cov_13.724297	3479	3562	6	13	83	0.1566265
NODE_388_length_3795_cov_13.724297	3479	3562	8	11	83	0.1325301
NODE_388_length_3795_cov_13.724297	3479	3562	9	3	83	0.0361446
NODE_388_length_3795_cov_13.724297	3479	3562	10	12	83	0.1445783
NODE_388_length_3795_cov_13.724297	3479	3562	12	22	83	0.2650602
NODE_388_length_3795_cov_13.724297	3479	3562	14	5	83	0.0602410
NODE_388_length_3795_cov_13.724297	3479	3562	18	17	83	0.2048193
NODE_388_length_3795_cov_13.724297	3479	3562	6	13	83	0.1566265
NODE_388_length_3795_cov_13.724297	3479	3562	8	11	83	0.1325301
NODE_388_length_3795_cov_13.724297	3479	3562	9	3	83	0.0361446
NODE_388_length_3795_cov_13.724297	3479	3562	10	12	83	0.1445783
NODE_388_length_3795_cov_13.724297	3479	3562	12	22	83	0.2650602
NODE_388_length_3795_cov_13.724297	3479	3562	14	5	83	0.0602410
NODE_388_length_3795_cov_13.724297	3479	3562	18	17	83	0.2048193
NODE_388_length_3795_cov_13.724297	3479	3552	6	13	73	0.1780822
NODE_388_length_3795_cov_13.724297	3479	3552	8	11	73	0.1506849
NODE_388_length_3795_cov_13.724297	3479	3552	9	3	73	0.0410959
NODE_388_length_3795_cov_13.724297	3479	3552	10	12	73	0.1643836
NODE_388_length_3795_cov_13.724297	3479	3552	12	22	73	0.3013699
NODE_388_length_3795_cov_13.724297	3479	3552	14	5	73	0.0684932
NODE_388_length_3795_cov_13.724297	3479	3552	18	7	73	0.0958904
NODE_388_length_3795_cov_13.724297	3535	3586	12	5	51	0.0980392
NODE_388_length_3795_cov_13.724297	3535	3586	14	5	51	0.0980392
NODE_388_length_3795_cov_13.724297	3535	3586	16	10	51	0.1960784
NODE_388_length_3795_cov_13.724297	3535	3586	18	31	51	0.6078432
NODE_388_length_3795_cov_13.724297	3535	3584	12	5	49	0.1020408
NODE_388_length_3795_cov_13.724297	3535	3584	14	5	49	0.1020408
NODE_388_length_3795_cov_13.724297	3535	3584	16	8	49	0.1632653
NODE_388_length_3795_cov_13.724297	3535	3584	18	31	49	0.6326531
NODE_388_length_3795_cov_13.724297	3698	3721	66	9	23	0.3913043
NODE_388_length_3795_cov_13.724297	3698	3721	68	14	23	0.6086956
NODE_394_length_3774_cov_7.720544	538	595	6	13	57	0.2280702
NODE_394_length_3774_cov_7.720544	538	595	10	44	57	0.7719298
NODE_404_length_3747_cov_3.328947	2230	2292	0	5	62	0.0806452
NODE_404_length_3747_cov_3.328947	2230	2292	2	24	62	0.3870968
NODE_404_length_3747_cov_3.328947	2230	2292	5	29	62	0.4677419
NODE_404_length_3747_cov_3.328947	2230	2292	7	4	62	0.0645161
NODE_406_length_3743_cov_38.767014	1354	1434	16	5	80	0.0625000
NODE_406_length_3743_cov_38.767014	1354	1434	22	1	80	0.0125000
NODE_406_length_3743_cov_38.767014	1354	1434	23	1	80	0.0125000
NODE_406_length_3743_cov_38.767014	1354	1434	24	2	80	0.0250000
NODE_406_length_3743_cov_38.767014	1354	1434	30	6	80	0.0750000
NODE_406_length_3743_cov_38.767014	1354	1434	34	1	80	0.0125000
NODE_406_length_3743_cov_38.767014	1354	1434	40	8	80	0.1000000
NODE_406_length_3743_cov_38.767014	1354	1434	42	2	80	0.0250000
NODE_406_length_3743_cov_38.767014	1354	1434	44	3	80	0.0375000
NODE_406_length_3743_cov_38.767014	1354	1434	46	1	80	0.0125000
NODE_406_length_3743_cov_38.767014	1354	1434	48	6	80	0.0750000
NODE_406_length_3743_cov_38.767014	1354	1434	49	1	80	0.0125000
NODE_406_length_3743_cov_38.767014	1354	1434	50	29	80	0.3625000
NODE_406_length_3743_cov_38.767014	1354	1434	52	9	80	0.1125000
NODE_406_length_3743_cov_38.767014	1354	1434	55	5	80	0.0625000
NODE_406_length_3743_cov_38.767014	1407	1487	26	11	80	0.1375000
NODE_406_length_3743_cov_38.767014	1407	1487	27	1	80	0.0125000
NODE_406_length_3743_cov_38.767014	1407	1487	34	8	80	0.1000000
NODE_406_length_3743_cov_38.767014	1407	1487	40	1	80	0.0125000
NODE_406_length_3743_cov_38.767014	1407	1487	41	3	80	0.0375000
NODE_406_length_3743_cov_38.767014	1407	1487	45	5	80	0.0625000
NODE_406_length_3743_cov_38.767014	1407	1487	46	1	80	0.0125000
NODE_406_length_3743_cov_38.767014	1407	1487	48	10	80	0.1250000
NODE_406_length_3743_cov_38.767014	1407	1487	50	15	80	0.1875000
NODE_406_length_3743_cov_38.767014	1407	1487	51	2	80	0.0250000
NODE_406_length_3743_cov_38.767014	1407	1487	52	9	80	0.1125000
NODE_406_length_3743_cov_38.767014	1407	1487	53	2	80	0.0250000
NODE_406_length_3743_cov_38.767014	1407	1487	54	1	80	0.0125000
NODE_406_length_3743_cov_38.767014	1407	1487	55	11	80	0.1375000
NODE_408_length_3733_cov_16.204458	186	249	0	51	63	0.8095238
NODE_408_length_3733_cov_16.204458	186	249	1	1	63	0.0158730
NODE_408_length_3733_cov_16.204458	186	249	7	1	63	0.0158730
NODE_408_length_3733_cov_16.204458	186	249	11	2	63	0.0317460
NODE_408_length_3733_cov_16.204458	186	249	13	2	63	0.0317460
NODE_408_length_3733_cov_16.204458	186	249	26	1	63	0.0158730
NODE_408_length_3733_cov_16.204458	186	249	55	1	63	0.0158730
NODE_408_length_3733_cov_16.204458	186	249	57	3	63	0.0476190
NODE_408_length_3733_cov_16.204458	186	249	68	1	63	0.0158730
NODE_413_length_3707_cov_56.575665	2387	2467	13	2	80	0.0250000
NODE_413_length_3707_cov_56.575665	2387	2467	15	36	80	0.4500000
NODE_413_length_3707_cov_56.575665	2387	2467	17	17	80	0.2125000
NODE_413_length_3707_cov_56.575665	2387	2467	20	9	80	0.1125000
NODE_413_length_3707_cov_56.575665	2387	2467	23	16	80	0.2000000
NODE_413_length_3707_cov_56.575665	2440	2520	15	1	80	0.0125000
NODE_413_length_3707_cov_56.575665	2440	2520	17	1	80	0.0125000
NODE_413_length_3707_cov_56.575665	2440	2520	18	7	80	0.0875000
NODE_413_length_3707_cov_56.575665	2440	2520	20	11	80	0.1375000
NODE_413_length_3707_cov_56.575665	2440	2520	22	14	80	0.1750000
NODE_413_length_3707_cov_56.575665	2440	2520	23	16	80	0.2000000
NODE_413_length_3707_cov_56.575665	2440	2520	24	8	80	0.1000000
NODE_413_length_3707_cov_56.575665	2440	2520	27	1	80	0.0125000
NODE_413_length_3707_cov_56.575665	2440	2520	28	1	80	0.0125000
NODE_413_length_3707_cov_56.575665	2440	2520	29	3	80	0.0375000
NODE_413_length_3707_cov_56.575665	2440	2520	30	1	80	0.0125000
NODE_413_length_3707_cov_56.575665	2440	2520	31	2	80	0.0250000
NODE_413_length_3707_cov_56.575665	2440	2520	38	7	80	0.0875000
NODE_413_length_3707_cov_56.575665	2440	2520	41	1	80	0.0125000
NODE_413_length_3707_cov_56.575665	2440	2520	42	6	80	0.0750000
NODE_413_length_3707_cov_56.575665	2516	2596	38	4	80	0.0500000
NODE_413_length_3707_cov_56.575665	2516	2596	59	1	80	0.0125000
NODE_413_length_3707_cov_56.575665	2516	2596	63	1	80	0.0125000
NODE_413_length_3707_cov_56.575665	2516	2596	64	4	80	0.0500000
NODE_413_length_3707_cov_56.575665	2516	2596	66	1	80	0.0125000
NODE_413_length_3707_cov_56.575665	2516	2596	74	3	80	0.0375000
NODE_413_length_3707_cov_56.575665	2516	2596	80	3	80	0.0375000
NODE_413_length_3707_cov_56.575665	2516	2596	82	5	80	0.0625000
NODE_413_length_3707_cov_56.575665	2516	2596	84	5	80	0.0625000
NODE_413_length_3707_cov_56.575665	2516	2596	86	1	80	0.0125000
NODE_413_length_3707_cov_56.575665	2516	2596	88	5	80	0.0625000
NODE_413_length_3707_cov_56.575665	2516	2596	89	3	80	0.0375000
NODE_413_length_3707_cov_56.575665	2516	2596	90	2	80	0.0250000
NODE_413_length_3707_cov_56.575665	2516	2596	91	13	80	0.1625000
NODE_413_length_3707_cov_56.575665	2516	2596	93	2	80	0.0250000
NODE_413_length_3707_cov_56.575665	2516	2596	94	6	80	0.0750000
NODE_413_length_3707_cov_56.575665	2516	2596	95	9	80	0.1125000
NODE_413_length_3707_cov_56.575665	2516	2596	96	3	80	0.0375000
NODE_413_length_3707_cov_56.575665	2516	2596	97	2	80	0.0250000
NODE_413_length_3707_cov_56.575665	2516	2596	99	7	80	0.0875000
NODE_413_length_3707_cov_56.575665	2569	2649	20	1	80	0.0125000
NODE_413_length_3707_cov_56.575665	2569	2649	22	1	80	0.0125000
NODE_413_length_3707_cov_56.575665	2569	2649	50	1	80	0.0125000
NODE_413_length_3707_cov_56.575665	2569	2649	51	3	80	0.0375000
NODE_413_length_3707_cov_56.575665	2569	2649	53	2	80	0.0250000
NODE_413_length_3707_cov_56.575665	2569	2649	57	1	80	0.0125000
NODE_413_length_3707_cov_56.575665	2569	2649	59	2	80	0.0250000
NODE_413_length_3707_cov_56.575665	2569	2649	61	4	80	0.0500000
NODE_413_length_3707_cov_56.575665	2569	2649	65	2	80	0.0250000
NODE_413_length_3707_cov_56.575665	2569	2649	66	9	80	0.1125000
NODE_413_length_3707_cov_56.575665	2569	2649	74	2	80	0.0250000
NODE_413_length_3707_cov_56.575665	2569	2649	80	2	80	0.0250000
NODE_413_length_3707_cov_56.575665	2569	2649	82	5	80	0.0625000
NODE_413_length_3707_cov_56.575665	2569	2649	87	1	80	0.0125000
NODE_413_length_3707_cov_56.575665	2569	2649	88	1	80	0.0125000
NODE_413_length_3707_cov_56.575665	2569	2649	89	3	80	0.0375000
NODE_413_length_3707_cov_56.575665	2569	2649	91	23	80	0.2875000
NODE_413_length_3707_cov_56.575665	2569	2649	93	7	80	0.0875000
NODE_413_length_3707_cov_56.575665	2569	2649	95	6	80	0.0750000
NODE_413_length_3707_cov_56.575665	2569	2649	97	2	80	0.0250000
NODE_413_length_3707_cov_56.575665	2569	2649	99	2	80	0.0250000
NODE_416_length_3690_cov_7.476190	723	792	0	8	69	0.1159420
NODE_416_length_3690_cov_7.476190	723	792	2	61	69	0.8840580
NODE_416_length_3690_cov_7.476190	776	855	0	71	79	0.8987342
NODE_416_length_3690_cov_7.476190	776	855	2	8	79	0.1012658
NODE_419_length_3685_cov_7.011154	1966	2046	101	1	80	0.0125000
NODE_419_length_3685_cov_7.011154	1966	2046	104	1	80	0.0125000
NODE_419_length_3685_cov_7.011154	1966	2046	105	1	80	0.0125000
NODE_419_length_3685_cov_7.011154	1966	2046	107	1	80	0.0125000
NODE_419_length_3685_cov_7.011154	1966	2046	116	2	80	0.0250000
NODE_419_length_3685_cov_7.011154	1966	2046	118	1	80	0.0125000
NODE_419_length_3685_cov_7.011154	1966	2046	122	1	80	0.0125000
NODE_419_length_3685_cov_7.011154	1966	2046	124	2	80	0.0250000
NODE_419_length_3685_cov_7.011154	1966	2046	126	1	80	0.0125000
NODE_419_length_3685_cov_7.011154	1966	2046	128	1	80	0.0125000
NODE_419_length_3685_cov_7.011154	1966	2046	130	1	80	0.0125000
NODE_419_length_3685_cov_7.011154	1966	2046	132	3	80	0.0375000
NODE_419_length_3685_cov_7.011154	1966	2046	133	1	80	0.0125000
NODE_419_length_3685_cov_7.011154	1966	2046	134	5	80	0.0625000
NODE_419_length_3685_cov_7.011154	1966	2046	135	2	80	0.0250000
NODE_419_length_3685_cov_7.011154	1966	2046	136	2	80	0.0250000
NODE_419_length_3685_cov_7.011154	1966	2046	137	1	80	0.0125000
NODE_419_length_3685_cov_7.011154	1966	2046	138	4	80	0.0500000
NODE_419_length_3685_cov_7.011154	1966	2046	139	1	80	0.0125000
NODE_419_length_3685_cov_7.011154	1966	2046	143	1	80	0.0125000
NODE_419_length_3685_cov_7.011154	1966	2046	149	1	80	0.0125000
NODE_419_length_3685_cov_7.011154	1966	2046	153	3	80	0.0375000
NODE_419_length_3685_cov_7.011154	1966	2046	154	6	80	0.0750000
NODE_419_length_3685_cov_7.011154	1966	2046	155	1	80	0.0125000
NODE_419_length_3685_cov_7.011154	1966	2046	156	5	80	0.0625000
NODE_419_length_3685_cov_7.011154	1966	2046	158	1	80	0.0125000
NODE_419_length_3685_cov_7.011154	1966	2046	164	2	80	0.0250000
NODE_419_length_3685_cov_7.011154	1966	2046	166	1	80	0.0125000
NODE_419_length_3685_cov_7.011154	1966	2046	167	1	80	0.0125000
NODE_419_length_3685_cov_7.011154	1966	2046	169	1	80	0.0125000
NODE_419_length_3685_cov_7.011154	1966	2046	175	3	80	0.0375000
NODE_419_length_3685_cov_7.011154	1966	2046	177	2	80	0.0250000
NODE_419_length_3685_cov_7.011154	1966	2046	179	4	80	0.0500000
NODE_419_length_3685_cov_7.011154	1966	2046	181	3	80	0.0375000
NODE_419_length_3685_cov_7.011154	1966	2046	183	3	80	0.0375000
NODE_419_length_3685_cov_7.011154	1966	2046	184	1	80	0.0125000
NODE_419_length_3685_cov_7.011154	1966	2046	185	8	80	0.1000000
NODE_419_length_3685_cov_7.011154	1966	2046	187	1	80	0.0125000
NODE_419_length_3685_cov_7.011154	2019	2086	118	1	67	0.0149254
NODE_419_length_3685_cov_7.011154	2019	2086	120	1	67	0.0149254
NODE_419_length_3685_cov_7.011154	2019	2086	122	4	67	0.0597015
NODE_419_length_3685_cov_7.011154	2019	2086	130	1	67	0.0149254
NODE_419_length_3685_cov_7.011154	2019	2086	132	1	67	0.0149254
NODE_419_length_3685_cov_7.011154	2019	2086	140	1	67	0.0149254
NODE_419_length_3685_cov_7.011154	2019	2086	144	1	67	0.0149254
NODE_419_length_3685_cov_7.011154	2019	2086	145	1	67	0.0149254
NODE_419_length_3685_cov_7.011154	2019	2086	147	1	67	0.0149254
NODE_419_length_3685_cov_7.011154	2019	2086	154	5	67	0.0746269
NODE_419_length_3685_cov_7.011154	2019	2086	158	4	67	0.0597015
NODE_419_length_3685_cov_7.011154	2019	2086	160	3	67	0.0447761
NODE_419_length_3685_cov_7.011154	2019	2086	162	1	67	0.0149254
NODE_419_length_3685_cov_7.011154	2019	2086	164	2	67	0.0298507
NODE_419_length_3685_cov_7.011154	2019	2086	165	1	67	0.0149254
NODE_419_length_3685_cov_7.011154	2019	2086	166	2	67	0.0298507
NODE_419_length_3685_cov_7.011154	2019	2086	167	2	67	0.0298507
NODE_419_length_3685_cov_7.011154	2019	2086	169	3	67	0.0447761
NODE_419_length_3685_cov_7.011154	2019	2086	171	1	67	0.0149254
NODE_419_length_3685_cov_7.011154	2019	2086	173	2	67	0.0298507
NODE_419_length_3685_cov_7.011154	2019	2086	175	7	67	0.1044776
NODE_419_length_3685_cov_7.011154	2019	2086	177	2	67	0.0298507
NODE_419_length_3685_cov_7.011154	2019	2086	179	4	67	0.0597015
NODE_419_length_3685_cov_7.011154	2019	2086	181	3	67	0.0447761
NODE_419_length_3685_cov_7.011154	2019	2086	183	3	67	0.0447761
NODE_419_length_3685_cov_7.011154	2019	2086	184	1	67	0.0149254
NODE_419_length_3685_cov_7.011154	2019	2086	185	8	67	0.1194030
NODE_419_length_3685_cov_7.011154	2019	2086	187	1	67	0.0149254
NODE_426_length_3667_cov_1089.047365	1634	1705	10	21	71	0.2957746
NODE_426_length_3667_cov_1089.047365	1634	1705	14	1	71	0.0140845
NODE_426_length_3667_cov_1089.047365	1634	1705	15	26	71	0.3661972
NODE_426_length_3667_cov_1089.047365	1634	1705	16	12	71	0.1690141
NODE_426_length_3667_cov_1089.047365	1634	1705	17	11	71	0.1549296
NODE_426_length_3667_cov_1089.047365	1678	1758	0	10	80	0.1250000
NODE_426_length_3667_cov_1089.047365	1678	1758	2	2	80	0.0250000
NODE_426_length_3667_cov_1089.047365	1678	1758	6	1	80	0.0125000
NODE_426_length_3667_cov_1089.047365	1678	1758	7	7	80	0.0875000
NODE_426_length_3667_cov_1089.047365	1678	1758	9	3	80	0.0375000
NODE_426_length_3667_cov_1089.047365	1678	1758	11	13	80	0.1625000
NODE_426_length_3667_cov_1089.047365	1678	1758	13	4	80	0.0500000
NODE_426_length_3667_cov_1089.047365	1678	1758	15	29	80	0.3625000
NODE_426_length_3667_cov_1089.047365	1678	1758	17	11	80	0.1375000
NODE_428_length_3660_cov_79.447627	1806	1870	104	2	64	0.0312500
NODE_428_length_3660_cov_79.447627	1806	1870	106	3	64	0.0468750
NODE_428_length_3660_cov_79.447627	1806	1870	108	1	64	0.0156250
NODE_428_length_3660_cov_79.447627	1806	1870	112	1	64	0.0156250
NODE_428_length_3660_cov_79.447627	1806	1870	116	1	64	0.0156250
NODE_428_length_3660_cov_79.447627	1806	1870	119	2	64	0.0312500
NODE_428_length_3660_cov_79.447627	1806	1870	123	2	64	0.0312500
NODE_428_length_3660_cov_79.447627	1806	1870	126	1	64	0.0156250
NODE_428_length_3660_cov_79.447627	1806	1870	128	1	64	0.0156250
NODE_428_length_3660_cov_79.447627	1806	1870	136	1	64	0.0156250
NODE_428_length_3660_cov_79.447627	1806	1870	138	1	64	0.0156250
NODE_428_length_3660_cov_79.447627	1806	1870	148	2	64	0.0312500
NODE_428_length_3660_cov_79.447627	1806	1870	152	1	64	0.0156250
NODE_428_length_3660_cov_79.447627	1806	1870	154	1	64	0.0156250
NODE_428_length_3660_cov_79.447627	1806	1870	164	1	64	0.0156250
NODE_428_length_3660_cov_79.447627	1806	1870	171	2	64	0.0312500
NODE_428_length_3660_cov_79.447627	1806	1870	176	1	64	0.0156250
NODE_428_length_3660_cov_79.447627	1806	1870	179	1	64	0.0156250
NODE_428_length_3660_cov_79.447627	1806	1870	183	2	64	0.0312500
NODE_428_length_3660_cov_79.447627	1806	1870	185	3	64	0.0468750
NODE_428_length_3660_cov_79.447627	1806	1870	190	1	64	0.0156250
NODE_428_length_3660_cov_79.447627	1806	1870	192	1	64	0.0156250
NODE_428_length_3660_cov_79.447627	1806	1870	196	1	64	0.0156250
NODE_428_length_3660_cov_79.447627	1806	1870	202	1	64	0.0156250
NODE_428_length_3660_cov_79.447627	1806	1870	203	1	64	0.0156250
NODE_428_length_3660_cov_79.447627	1806	1870	209	2	64	0.0312500
NODE_428_length_3660_cov_79.447627	1806	1870	211	4	64	0.0625000
NODE_428_length_3660_cov_79.447627	1806	1870	213	5	64	0.0781250
NODE_428_length_3660_cov_79.447627	1806	1870	214	1	64	0.0156250
NODE_428_length_3660_cov_79.447627	1806	1870	216	1	64	0.0156250
NODE_428_length_3660_cov_79.447627	1806	1870	219	1	64	0.0156250
NODE_428_length_3660_cov_79.447627	1806	1870	223	1	64	0.0156250
NODE_428_length_3660_cov_79.447627	1806	1870	225	1	64	0.0156250
NODE_428_length_3660_cov_79.447627	1806	1870	227	1	64	0.0156250
NODE_428_length_3660_cov_79.447627	1806	1870	229	1	64	0.0156250
NODE_428_length_3660_cov_79.447627	1806	1870	233	1	64	0.0156250
NODE_428_length_3660_cov_79.447627	1806	1870	237	1	64	0.0156250
NODE_428_length_3660_cov_79.447627	1806	1870	238	1	64	0.0156250
NODE_428_length_3660_cov_79.447627	1806	1870	239	3	64	0.0468750
NODE_428_length_3660_cov_79.447627	1806	1870	240	1	64	0.0156250
NODE_428_length_3660_cov_79.447627	1806	1870	245	1	64	0.0156250
NODE_428_length_3660_cov_79.447627	1806	1870	246	1	64	0.0156250
NODE_428_length_3660_cov_79.447627	1806	1870	247	1	64	0.0156250
NODE_428_length_3660_cov_79.447627	1806	1870	256	1	64	0.0156250
NODE_428_length_3660_cov_79.447627	1859	1906	233	1	47	0.0212766
NODE_428_length_3660_cov_79.447627	1859	1906	237	1	47	0.0212766
NODE_428_length_3660_cov_79.447627	1859	1906	238	1	47	0.0212766
NODE_428_length_3660_cov_79.447627	1859	1906	239	3	47	0.0638298
NODE_428_length_3660_cov_79.447627	1859	1906	240	1	47	0.0212766
NODE_428_length_3660_cov_79.447627	1859	1906	245	1	47	0.0212766
NODE_428_length_3660_cov_79.447627	1859	1906	246	1	47	0.0212766
NODE_428_length_3660_cov_79.447627	1859	1906	247	1	47	0.0212766
NODE_428_length_3660_cov_79.447627	1859	1906	253	4	47	0.0851064
NODE_428_length_3660_cov_79.447627	1859	1906	255	3	47	0.0638298
NODE_428_length_3660_cov_79.447627	1859	1906	256	1	47	0.0212766
NODE_428_length_3660_cov_79.447627	1859	1906	257	1	47	0.0212766
NODE_428_length_3660_cov_79.447627	1859	1906	259	1	47	0.0212766
NODE_428_length_3660_cov_79.447627	1859	1906	260	2	47	0.0425532
NODE_428_length_3660_cov_79.447627	1859	1906	268	1	47	0.0212766
NODE_428_length_3660_cov_79.447627	1859	1906	274	1	47	0.0212766
NODE_428_length_3660_cov_79.447627	1859	1906	276	2	47	0.0425532
NODE_428_length_3660_cov_79.447627	1859	1906	278	3	47	0.0638298
NODE_428_length_3660_cov_79.447627	1859	1906	280	1	47	0.0212766
NODE_428_length_3660_cov_79.447627	1859	1906	281	2	47	0.0425532
NODE_428_length_3660_cov_79.447627	1859	1906	282	1	47	0.0212766
NODE_428_length_3660_cov_79.447627	1859	1906	283	3	47	0.0638298
NODE_428_length_3660_cov_79.447627	1859	1906	284	1	47	0.0212766
NODE_428_length_3660_cov_79.447627	1859	1906	285	3	47	0.0638298
NODE_428_length_3660_cov_79.447627	1859	1906	288	6	47	0.1276596
NODE_428_length_3660_cov_79.447627	1859	1906	290	1	47	0.0212766
NODE_428_length_3660_cov_79.447627	2358	2438	0	25	80	0.3125000
NODE_428_length_3660_cov_79.447627	2358	2438	1	55	80	0.6875000
NODE_428_length_3660_cov_79.447627	2411	2491	1	80	80	1.0000000
NODE_428_length_3660_cov_79.447627	2487	2567	0	34	80	0.4250000
NODE_428_length_3660_cov_79.447627	2487	2567	1	46	80	0.5750000
NODE_428_length_3660_cov_79.447627	2540	2620	0	80	80	1.0000000
NODE_430_length_3634_cov_34.913154	1499	1544	103	1	45	0.0222222
NODE_430_length_3634_cov_34.913154	1499	1544	125	1	45	0.0222222
NODE_430_length_3634_cov_34.913154	1499	1544	131	1	45	0.0222222
NODE_430_length_3634_cov_34.913154	1499	1544	139	1	45	0.0222222
NODE_430_length_3634_cov_34.913154	1499	1544	140	1	45	0.0222222
NODE_430_length_3634_cov_34.913154	1499	1544	141	1	45	0.0222222
NODE_430_length_3634_cov_34.913154	1499	1544	148	1	45	0.0222222
NODE_430_length_3634_cov_34.913154	1499	1544	151	1	45	0.0222222
NODE_430_length_3634_cov_34.913154	1499	1544	157	1	45	0.0222222
NODE_430_length_3634_cov_34.913154	1499	1544	159	1	45	0.0222222
NODE_430_length_3634_cov_34.913154	1499	1544	160	1	45	0.0222222
NODE_430_length_3634_cov_34.913154	1499	1544	174	2	45	0.0444444
NODE_430_length_3634_cov_34.913154	1499	1544	180	1	45	0.0222222
NODE_430_length_3634_cov_34.913154	1499	1544	188	1	45	0.0222222
NODE_430_length_3634_cov_34.913154	1499	1544	190	1	45	0.0222222
NODE_430_length_3634_cov_34.913154	1499	1544	202	2	45	0.0444444
NODE_430_length_3634_cov_34.913154	1499	1544	213	1	45	0.0222222
NODE_430_length_3634_cov_34.913154	1499	1544	218	1	45	0.0222222
NODE_430_length_3634_cov_34.913154	1499	1544	229	1	45	0.0222222
NODE_430_length_3634_cov_34.913154	1499	1544	239	1	45	0.0222222
NODE_430_length_3634_cov_34.913154	1499	1544	250	1	45	0.0222222
NODE_430_length_3634_cov_34.913154	1499	1544	260	1	45	0.0222222
NODE_430_length_3634_cov_34.913154	1499	1544	268	1	45	0.0222222
NODE_430_length_3634_cov_34.913154	1499	1544	280	1	45	0.0222222
NODE_430_length_3634_cov_34.913154	1499	1544	303	1	45	0.0222222
NODE_430_length_3634_cov_34.913154	1499	1544	322	1	45	0.0222222
NODE_430_length_3634_cov_34.913154	1499	1544	329	1	45	0.0222222
NODE_430_length_3634_cov_34.913154	1499	1544	331	1	45	0.0222222
NODE_430_length_3634_cov_34.913154	1499	1544	332	1	45	0.0222222
NODE_430_length_3634_cov_34.913154	1499	1544	337	1	45	0.0222222
NODE_430_length_3634_cov_34.913154	1499	1544	343	3	45	0.0666667
NODE_430_length_3634_cov_34.913154	1499	1544	355	1	45	0.0222222
NODE_430_length_3634_cov_34.913154	1499	1544	362	1	45	0.0222222
NODE_430_length_3634_cov_34.913154	1499	1544	375	1	45	0.0222222
NODE_430_length_3634_cov_34.913154	1499	1544	377	1	45	0.0222222
NODE_430_length_3634_cov_34.913154	1499	1544	381	1	45	0.0222222
NODE_430_length_3634_cov_34.913154	1499	1544	383	1	45	0.0222222
NODE_430_length_3634_cov_34.913154	1499	1544	387	1	45	0.0222222
NODE_430_length_3634_cov_34.913154	1499	1544	402	1	45	0.0222222
NODE_430_length_3634_cov_34.913154	1499	1544	411	1	45	0.0222222
NODE_430_length_3634_cov_34.913154	1499	1544	415	1	45	0.0222222
NODE_430_length_3634_cov_34.913154	1517	1597	213	1	80	0.0125000
NODE_430_length_3634_cov_34.913154	1517	1597	218	1	80	0.0125000
NODE_430_length_3634_cov_34.913154	1517	1597	229	1	80	0.0125000
NODE_430_length_3634_cov_34.913154	1517	1597	239	1	80	0.0125000
NODE_430_length_3634_cov_34.913154	1517	1597	250	1	80	0.0125000
NODE_430_length_3634_cov_34.913154	1517	1597	260	1	80	0.0125000
NODE_430_length_3634_cov_34.913154	1517	1597	268	1	80	0.0125000
NODE_430_length_3634_cov_34.913154	1517	1597	280	1	80	0.0125000
NODE_430_length_3634_cov_34.913154	1517	1597	303	1	80	0.0125000
NODE_430_length_3634_cov_34.913154	1517	1597	322	1	80	0.0125000
NODE_430_length_3634_cov_34.913154	1517	1597	329	1	80	0.0125000
NODE_430_length_3634_cov_34.913154	1517	1597	331	1	80	0.0125000
NODE_430_length_3634_cov_34.913154	1517	1597	332	1	80	0.0125000
NODE_430_length_3634_cov_34.913154	1517	1597	337	1	80	0.0125000
NODE_430_length_3634_cov_34.913154	1517	1597	343	3	80	0.0375000
NODE_430_length_3634_cov_34.913154	1517	1597	355	1	80	0.0125000
NODE_430_length_3634_cov_34.913154	1517	1597	362	1	80	0.0125000
NODE_430_length_3634_cov_34.913154	1517	1597	375	1	80	0.0125000
NODE_430_length_3634_cov_34.913154	1517	1597	377	1	80	0.0125000
NODE_430_length_3634_cov_34.913154	1517	1597	381	1	80	0.0125000
NODE_430_length_3634_cov_34.913154	1517	1597	383	1	80	0.0125000
NODE_430_length_3634_cov_34.913154	1517	1597	387	1	80	0.0125000
NODE_430_length_3634_cov_34.913154	1517	1597	402	1	80	0.0125000
NODE_430_length_3634_cov_34.913154	1517	1597	411	1	80	0.0125000
NODE_430_length_3634_cov_34.913154	1517	1597	415	1	80	0.0125000
NODE_430_length_3634_cov_34.913154	1517	1597	419	1	80	0.0125000
NODE_430_length_3634_cov_34.913154	1517	1597	421	1	80	0.0125000
NODE_430_length_3634_cov_34.913154	1517	1597	424	1	80	0.0125000
NODE_430_length_3634_cov_34.913154	1517	1597	429	1	80	0.0125000
NODE_430_length_3634_cov_34.913154	1517	1597	435	1	80	0.0125000
NODE_430_length_3634_cov_34.913154	1517	1597	436	1	80	0.0125000
NODE_430_length_3634_cov_34.913154	1517	1597	437	3	80	0.0375000
NODE_430_length_3634_cov_34.913154	1517	1597	438	1	80	0.0125000
NODE_430_length_3634_cov_34.913154	1517	1597	441	3	80	0.0375000
NODE_430_length_3634_cov_34.913154	1517	1597	448	1	80	0.0125000
NODE_430_length_3634_cov_34.913154	1517	1597	456	1	80	0.0125000
NODE_430_length_3634_cov_34.913154	1517	1597	466	1	80	0.0125000
NODE_430_length_3634_cov_34.913154	1517	1597	471	1	80	0.0125000
NODE_430_length_3634_cov_34.913154	1517	1597	480	1	80	0.0125000
NODE_430_length_3634_cov_34.913154	1517	1597	482	2	80	0.0250000
NODE_430_length_3634_cov_34.913154	1517	1597	490	2	80	0.0250000
NODE_430_length_3634_cov_34.913154	1517	1597	494	1	80	0.0125000
NODE_430_length_3634_cov_34.913154	1517	1597	498	1	80	0.0125000
NODE_430_length_3634_cov_34.913154	1517	1597	511	1	80	0.0125000
NODE_430_length_3634_cov_34.913154	1517	1597	513	1	80	0.0125000
NODE_430_length_3634_cov_34.913154	1517	1597	533	1	80	0.0125000
NODE_430_length_3634_cov_34.913154	1517	1597	536	1	80	0.0125000
NODE_430_length_3634_cov_34.913154	1517	1597	551	1	80	0.0125000
NODE_430_length_3634_cov_34.913154	1517	1597	556	1	80	0.0125000
NODE_430_length_3634_cov_34.913154	1517	1597	570	1	80	0.0125000
NODE_430_length_3634_cov_34.913154	1517	1597	594	1	80	0.0125000
NODE_430_length_3634_cov_34.913154	1517	1597	597	1	80	0.0125000
NODE_430_length_3634_cov_34.913154	1517	1597	609	1	80	0.0125000
NODE_430_length_3634_cov_34.913154	1517	1597	611	1	80	0.0125000
NODE_430_length_3634_cov_34.913154	1517	1597	617	2	80	0.0250000
NODE_430_length_3634_cov_34.913154	1517	1597	620	1	80	0.0125000
NODE_430_length_3634_cov_34.913154	1517	1597	623	1	80	0.0125000
NODE_430_length_3634_cov_34.913154	1517	1597	625	1	80	0.0125000
NODE_430_length_3634_cov_34.913154	1517	1597	627	1	80	0.0125000
NODE_430_length_3634_cov_34.913154	1517	1597	630	1	80	0.0125000
NODE_430_length_3634_cov_34.913154	1517	1597	631	4	80	0.0500000
NODE_430_length_3634_cov_34.913154	1517	1597	633	1	80	0.0125000
NODE_430_length_3634_cov_34.913154	1517	1597	635	3	80	0.0375000
NODE_430_length_3634_cov_34.913154	1517	1597	638	2	80	0.0250000
NODE_430_length_3634_cov_34.913154	1517	1597	640	1	80	0.0125000
NODE_430_length_3634_cov_34.913154	1978	2058	136	1	80	0.0125000
NODE_430_length_3634_cov_34.913154	1978	2058	138	1	80	0.0125000
NODE_430_length_3634_cov_34.913154	1978	2058	140	1	80	0.0125000
NODE_430_length_3634_cov_34.913154	1978	2058	145	2	80	0.0250000
NODE_430_length_3634_cov_34.913154	1978	2058	149	1	80	0.0125000
NODE_430_length_3634_cov_34.913154	1978	2058	152	1	80	0.0125000
NODE_430_length_3634_cov_34.913154	1978	2058	153	3	80	0.0375000
NODE_430_length_3634_cov_34.913154	1978	2058	157	1	80	0.0125000
NODE_430_length_3634_cov_34.913154	1978	2058	162	1	80	0.0125000
NODE_430_length_3634_cov_34.913154	1978	2058	166	1	80	0.0125000
NODE_430_length_3634_cov_34.913154	1978	2058	180	1	80	0.0125000
NODE_430_length_3634_cov_34.913154	1978	2058	182	1	80	0.0125000
NODE_430_length_3634_cov_34.913154	1978	2058	189	1	80	0.0125000
NODE_430_length_3634_cov_34.913154	1978	2058	194	1	80	0.0125000
NODE_430_length_3634_cov_34.913154	1978	2058	197	1	80	0.0125000
NODE_430_length_3634_cov_34.913154	1978	2058	202	1	80	0.0125000
NODE_430_length_3634_cov_34.913154	1978	2058	205	1	80	0.0125000
NODE_430_length_3634_cov_34.913154	1978	2058	211	1	80	0.0125000
NODE_430_length_3634_cov_34.913154	1978	2058	218	1	80	0.0125000
NODE_430_length_3634_cov_34.913154	1978	2058	230	3	80	0.0375000
NODE_430_length_3634_cov_34.913154	1978	2058	231	1	80	0.0125000
NODE_430_length_3634_cov_34.913154	1978	2058	241	1	80	0.0125000
NODE_430_length_3634_cov_34.913154	1978	2058	242	1	80	0.0125000
NODE_430_length_3634_cov_34.913154	1978	2058	248	1	80	0.0125000
NODE_430_length_3634_cov_34.913154	1978	2058	250	1	80	0.0125000
NODE_430_length_3634_cov_34.913154	1978	2058	259	1	80	0.0125000
NODE_430_length_3634_cov_34.913154	1978	2058	267	1	80	0.0125000
NODE_430_length_3634_cov_34.913154	1978	2058	273	3	80	0.0375000
NODE_430_length_3634_cov_34.913154	1978	2058	278	1	80	0.0125000
NODE_430_length_3634_cov_34.913154	1978	2058	289	2	80	0.0250000
NODE_430_length_3634_cov_34.913154	1978	2058	300	1	80	0.0125000
NODE_430_length_3634_cov_34.913154	1978	2058	303	1	80	0.0125000
NODE_430_length_3634_cov_34.913154	1978	2058	308	1	80	0.0125000
NODE_430_length_3634_cov_34.913154	1978	2058	310	1	80	0.0125000
NODE_430_length_3634_cov_34.913154	1978	2058	312	1	80	0.0125000
NODE_430_length_3634_cov_34.913154	1978	2058	320	1	80	0.0125000
NODE_430_length_3634_cov_34.913154	1978	2058	325	1	80	0.0125000
NODE_430_length_3634_cov_34.913154	1978	2058	336	1	80	0.0125000
NODE_430_length_3634_cov_34.913154	1978	2058	341	1	80	0.0125000
NODE_430_length_3634_cov_34.913154	1978	2058	343	2	80	0.0250000
NODE_430_length_3634_cov_34.913154	1978	2058	347	4	80	0.0500000
NODE_430_length_3634_cov_34.913154	1978	2058	352	2	80	0.0250000
NODE_430_length_3634_cov_34.913154	1978	2058	354	1	80	0.0125000
NODE_430_length_3634_cov_34.913154	1978	2058	359	2	80	0.0250000
NODE_430_length_3634_cov_34.913154	1978	2058	363	1	80	0.0125000
NODE_430_length_3634_cov_34.913154	1978	2058	365	1	80	0.0125000
NODE_430_length_3634_cov_34.913154	1978	2058	370	1	80	0.0125000
NODE_430_length_3634_cov_34.913154	1978	2058	372	1	80	0.0125000
NODE_430_length_3634_cov_34.913154	1978	2058	373	1	80	0.0125000
NODE_430_length_3634_cov_34.913154	1978	2058	380	1	80	0.0125000
NODE_430_length_3634_cov_34.913154	1978	2058	388	1	80	0.0125000
NODE_430_length_3634_cov_34.913154	1978	2058	399	1	80	0.0125000
NODE_430_length_3634_cov_34.913154	1978	2058	405	1	80	0.0125000
NODE_430_length_3634_cov_34.913154	1978	2058	406	1	80	0.0125000
NODE_430_length_3634_cov_34.913154	1978	2058	414	1	80	0.0125000
NODE_430_length_3634_cov_34.913154	1978	2058	417	1	80	0.0125000
NODE_430_length_3634_cov_34.913154	1978	2058	427	1	80	0.0125000
NODE_430_length_3634_cov_34.913154	1978	2058	435	1	80	0.0125000
NODE_430_length_3634_cov_34.913154	1978	2058	439	1	80	0.0125000
NODE_430_length_3634_cov_34.913154	1978	2058	447	1	80	0.0125000
NODE_430_length_3634_cov_34.913154	1978	2058	463	1	80	0.0125000
NODE_430_length_3634_cov_34.913154	1978	2058	471	1	80	0.0125000
NODE_430_length_3634_cov_34.913154	1978	2058	480	2	80	0.0250000
NODE_430_length_3634_cov_34.913154	1978	2058	485	1	80	0.0125000
NODE_430_length_3634_cov_34.913154	1978	2058	488	1	80	0.0125000
NODE_430_length_3634_cov_34.913154	2031	2077	44	1	46	0.0217391
NODE_430_length_3634_cov_34.913154	2031	2077	46	2	46	0.0434783
NODE_430_length_3634_cov_34.913154	2031	2077	58	1	46	0.0217391
NODE_430_length_3634_cov_34.913154	2031	2077	62	1	46	0.0217391
NODE_430_length_3634_cov_34.913154	2031	2077	67	1	46	0.0217391
NODE_430_length_3634_cov_34.913154	2031	2077	71	2	46	0.0434783
NODE_430_length_3634_cov_34.913154	2031	2077	75	1	46	0.0217391
NODE_430_length_3634_cov_34.913154	2031	2077	78	1	46	0.0217391
NODE_430_length_3634_cov_34.913154	2031	2077	79	1	46	0.0217391
NODE_430_length_3634_cov_34.913154	2031	2077	84	1	46	0.0217391
NODE_430_length_3634_cov_34.913154	2031	2077	88	2	46	0.0434783
NODE_430_length_3634_cov_34.913154	2031	2077	97	1	46	0.0217391
NODE_430_length_3634_cov_34.913154	2031	2077	102	1	46	0.0217391
NODE_430_length_3634_cov_34.913154	2031	2077	114	1	46	0.0217391
NODE_430_length_3634_cov_34.913154	2031	2077	118	1	46	0.0217391
NODE_430_length_3634_cov_34.913154	2031	2077	124	1	46	0.0217391
NODE_430_length_3634_cov_34.913154	2031	2077	136	1	46	0.0217391
NODE_430_length_3634_cov_34.913154	2031	2077	138	1	46	0.0217391
NODE_430_length_3634_cov_34.913154	2031	2077	140	1	46	0.0217391
NODE_430_length_3634_cov_34.913154	2031	2077	145	2	46	0.0434783
NODE_430_length_3634_cov_34.913154	2031	2077	149	1	46	0.0217391
NODE_430_length_3634_cov_34.913154	2031	2077	152	1	46	0.0217391
NODE_430_length_3634_cov_34.913154	2031	2077	153	3	46	0.0652174
NODE_430_length_3634_cov_34.913154	2031	2077	157	1	46	0.0217391
NODE_430_length_3634_cov_34.913154	2031	2077	162	1	46	0.0217391
NODE_430_length_3634_cov_34.913154	2031	2077	166	1	46	0.0217391
NODE_430_length_3634_cov_34.913154	2031	2077	180	1	46	0.0217391
NODE_430_length_3634_cov_34.913154	2031	2077	182	1	46	0.0217391
NODE_430_length_3634_cov_34.913154	2031	2077	189	1	46	0.0217391
NODE_430_length_3634_cov_34.913154	2031	2077	194	1	46	0.0217391
NODE_430_length_3634_cov_34.913154	2031	2077	197	1	46	0.0217391
NODE_430_length_3634_cov_34.913154	2031	2077	202	1	46	0.0217391
NODE_430_length_3634_cov_34.913154	2031	2077	205	1	46	0.0217391
NODE_430_length_3634_cov_34.913154	2031	2077	211	1	46	0.0217391
NODE_430_length_3634_cov_34.913154	2031	2077	218	1	46	0.0217391
NODE_430_length_3634_cov_34.913154	2031	2077	230	3	46	0.0652174
NODE_430_length_3634_cov_34.913154	2031	2077	231	1	46	0.0217391
NODE_430_length_3634_cov_34.913154	2031	2077	241	1	46	0.0217391
NODE_435_length_3622_cov_29.112120	201	281	0	80	80	1.0000000
NODE_435_length_3622_cov_29.112120	254	334	0	80	80	1.0000000
NODE_435_length_3622_cov_29.112120	2310	2390	173	1	80	0.0125000
NODE_435_length_3622_cov_29.112120	2310	2390	182	1	80	0.0125000
NODE_435_length_3622_cov_29.112120	2310	2390	184	1	80	0.0125000
NODE_435_length_3622_cov_29.112120	2310	2390	186	1	80	0.0125000
NODE_435_length_3622_cov_29.112120	2310	2390	188	6	80	0.0750000
NODE_435_length_3622_cov_29.112120	2310	2390	191	2	80	0.0250000
NODE_435_length_3622_cov_29.112120	2310	2390	193	1	80	0.0125000
NODE_435_length_3622_cov_29.112120	2310	2390	195	1	80	0.0125000
NODE_435_length_3622_cov_29.112120	2310	2390	197	1	80	0.0125000
NODE_435_length_3622_cov_29.112120	2310	2390	199	3	80	0.0375000
NODE_435_length_3622_cov_29.112120	2310	2390	207	1	80	0.0125000
NODE_435_length_3622_cov_29.112120	2310	2390	215	1	80	0.0125000
NODE_435_length_3622_cov_29.112120	2310	2390	217	1	80	0.0125000
NODE_435_length_3622_cov_29.112120	2310	2390	219	1	80	0.0125000
NODE_435_length_3622_cov_29.112120	2310	2390	227	1	80	0.0125000
NODE_435_length_3622_cov_29.112120	2310	2390	230	1	80	0.0125000
NODE_435_length_3622_cov_29.112120	2310	2390	244	3	80	0.0375000
NODE_435_length_3622_cov_29.112120	2310	2390	253	1	80	0.0125000
NODE_435_length_3622_cov_29.112120	2310	2390	260	1	80	0.0125000
NODE_435_length_3622_cov_29.112120	2310	2390	264	1	80	0.0125000
NODE_435_length_3622_cov_29.112120	2310	2390	270	1	80	0.0125000
NODE_435_length_3622_cov_29.112120	2310	2390	274	2	80	0.0250000
NODE_435_length_3622_cov_29.112120	2310	2390	276	1	80	0.0125000
NODE_435_length_3622_cov_29.112120	2310	2390	282	3	80	0.0375000
NODE_435_length_3622_cov_29.112120	2310	2390	290	1	80	0.0125000
NODE_435_length_3622_cov_29.112120	2310	2390	294	1	80	0.0125000
NODE_435_length_3622_cov_29.112120	2310	2390	301	1	80	0.0125000
NODE_435_length_3622_cov_29.112120	2310	2390	317	1	80	0.0125000
NODE_435_length_3622_cov_29.112120	2310	2390	320	2	80	0.0250000
NODE_435_length_3622_cov_29.112120	2310	2390	340	1	80	0.0125000
NODE_435_length_3622_cov_29.112120	2310	2390	342	1	80	0.0125000
NODE_435_length_3622_cov_29.112120	2310	2390	343	1	80	0.0125000
NODE_435_length_3622_cov_29.112120	2310	2390	356	1	80	0.0125000
NODE_435_length_3622_cov_29.112120	2310	2390	357	1	80	0.0125000
NODE_435_length_3622_cov_29.112120	2310	2390	359	2	80	0.0250000
NODE_435_length_3622_cov_29.112120	2310	2390	361	1	80	0.0125000
NODE_435_length_3622_cov_29.112120	2310	2390	365	4	80	0.0500000
NODE_435_length_3622_cov_29.112120	2310	2390	367	1	80	0.0125000
NODE_435_length_3622_cov_29.112120	2310	2390	369	1	80	0.0125000
NODE_435_length_3622_cov_29.112120	2310	2390	374	2	80	0.0250000
NODE_435_length_3622_cov_29.112120	2310	2390	375	1	80	0.0125000
NODE_435_length_3622_cov_29.112120	2310	2390	376	2	80	0.0250000
NODE_435_length_3622_cov_29.112120	2310	2390	378	3	80	0.0375000
NODE_435_length_3622_cov_29.112120	2310	2390	379	1	80	0.0125000
NODE_435_length_3622_cov_29.112120	2310	2390	380	1	80	0.0125000
NODE_435_length_3622_cov_29.112120	2310	2390	381	3	80	0.0375000
NODE_435_length_3622_cov_29.112120	2310	2390	383	1	80	0.0125000
NODE_435_length_3622_cov_29.112120	2310	2390	384	1	80	0.0125000
NODE_435_length_3622_cov_29.112120	2310	2390	387	1	80	0.0125000
NODE_435_length_3622_cov_29.112120	2310	2390	395	1	80	0.0125000
NODE_435_length_3622_cov_29.112120	2310	2390	396	1	80	0.0125000
NODE_435_length_3622_cov_29.112120	2310	2390	397	2	80	0.0250000
NODE_435_length_3622_cov_29.112120	2310	2390	399	2	80	0.0250000
NODE_435_length_3622_cov_29.112120	2310	2390	401	1	80	0.0125000
NODE_435_length_3622_cov_29.112120	2363	2441	27	1	78	0.0128205
NODE_435_length_3622_cov_29.112120	2363	2441	31	2	78	0.0256410
NODE_435_length_3622_cov_29.112120	2363	2441	38	2	78	0.0256410
NODE_435_length_3622_cov_29.112120	2363	2441	54	2	78	0.0256410
NODE_435_length_3622_cov_29.112120	2363	2441	56	2	78	0.0256410
NODE_435_length_3622_cov_29.112120	2363	2441	63	1	78	0.0128205
NODE_435_length_3622_cov_29.112120	2363	2441	65	1	78	0.0128205
NODE_435_length_3622_cov_29.112120	2363	2441	82	1	78	0.0128205
NODE_435_length_3622_cov_29.112120	2363	2441	84	1	78	0.0128205
NODE_435_length_3622_cov_29.112120	2363	2441	86	2	78	0.0256410
NODE_435_length_3622_cov_29.112120	2363	2441	88	1	78	0.0128205
NODE_435_length_3622_cov_29.112120	2363	2441	90	1	78	0.0128205
NODE_435_length_3622_cov_29.112120	2363	2441	92	3	78	0.0384615
NODE_435_length_3622_cov_29.112120	2363	2441	93	3	78	0.0384615
NODE_435_length_3622_cov_29.112120	2363	2441	96	2	78	0.0256410
NODE_435_length_3622_cov_29.112120	2363	2441	98	1	78	0.0128205
NODE_435_length_3622_cov_29.112120	2363	2441	99	1	78	0.0128205
NODE_435_length_3622_cov_29.112120	2363	2441	102	1	78	0.0128205
NODE_435_length_3622_cov_29.112120	2363	2441	108	2	78	0.0256410
NODE_435_length_3622_cov_29.112120	2363	2441	110	2	78	0.0256410
NODE_435_length_3622_cov_29.112120	2363	2441	112	3	78	0.0384615
NODE_435_length_3622_cov_29.112120	2363	2441	119	2	78	0.0256410
NODE_435_length_3622_cov_29.112120	2363	2441	126	1	78	0.0128205
NODE_435_length_3622_cov_29.112120	2363	2441	128	1	78	0.0128205
NODE_435_length_3622_cov_29.112120	2363	2441	134	2	78	0.0256410
NODE_435_length_3622_cov_29.112120	2363	2441	140	3	78	0.0384615
NODE_435_length_3622_cov_29.112120	2363	2441	142	1	78	0.0128205
NODE_435_length_3622_cov_29.112120	2363	2441	149	1	78	0.0128205
NODE_435_length_3622_cov_29.112120	2363	2441	152	1	78	0.0128205
NODE_435_length_3622_cov_29.112120	2363	2441	154	1	78	0.0128205
NODE_435_length_3622_cov_29.112120	2363	2441	163	1	78	0.0128205
NODE_435_length_3622_cov_29.112120	2363	2441	166	1	78	0.0128205
NODE_435_length_3622_cov_29.112120	2363	2441	171	1	78	0.0128205
NODE_435_length_3622_cov_29.112120	2363	2441	173	1	78	0.0128205
NODE_435_length_3622_cov_29.112120	2363	2441	182	1	78	0.0128205
NODE_435_length_3622_cov_29.112120	2363	2441	184	1	78	0.0128205
NODE_435_length_3622_cov_29.112120	2363	2441	186	1	78	0.0128205
NODE_435_length_3622_cov_29.112120	2363	2441	188	6	78	0.0769231
NODE_435_length_3622_cov_29.112120	2363	2441	191	2	78	0.0256410
NODE_435_length_3622_cov_29.112120	2363	2441	193	1	78	0.0128205
NODE_435_length_3622_cov_29.112120	2363	2441	195	1	78	0.0128205
NODE_435_length_3622_cov_29.112120	2363	2441	197	1	78	0.0128205
NODE_435_length_3622_cov_29.112120	2363	2441	199	3	78	0.0384615
NODE_435_length_3622_cov_29.112120	2363	2441	207	1	78	0.0128205
NODE_435_length_3622_cov_29.112120	2363	2441	215	1	78	0.0128205
NODE_435_length_3622_cov_29.112120	2363	2441	217	1	78	0.0128205
NODE_435_length_3622_cov_29.112120	2363	2441	219	1	78	0.0128205
NODE_435_length_3622_cov_29.112120	2363	2441	227	1	78	0.0128205
NODE_435_length_3622_cov_29.112120	2363	2441	230	1	78	0.0128205
NODE_435_length_3622_cov_29.112120	2363	2441	244	3	78	0.0384615
NODE_437_length_3610_cov_8.785816	294	340	9	8	46	0.1739130
NODE_437_length_3610_cov_8.785816	294	340	11	5	46	0.1086956
NODE_437_length_3610_cov_8.785816	294	340	13	33	46	0.7173913
NODE_437_length_3610_cov_8.785816	313	393	8	26	80	0.3250000
NODE_437_length_3610_cov_8.785816	313	393	12	3	80	0.0375000
NODE_437_length_3610_cov_8.785816	313	393	13	51	80	0.6375000
NODE_444_length_3588_cov_16.296360	2421	2501	4	8	80	0.1000000
NODE_444_length_3588_cov_16.296360	2421	2501	10	12	80	0.1500000
NODE_444_length_3588_cov_16.296360	2421	2501	16	2	80	0.0250000
NODE_444_length_3588_cov_16.296360	2421	2501	22	8	80	0.1000000
NODE_444_length_3588_cov_16.296360	2421	2501	26	32	80	0.4000000
NODE_444_length_3588_cov_16.296360	2421	2501	28	18	80	0.2250000
NODE_444_length_3588_cov_16.296360	2474	2539	11	1	65	0.0153846
NODE_444_length_3588_cov_16.296360	2474	2539	16	5	65	0.0769231
NODE_444_length_3588_cov_16.296360	2474	2539	20	17	65	0.2615385
NODE_444_length_3588_cov_16.296360	2474	2539	24	6	65	0.0923077
NODE_444_length_3588_cov_16.296360	2474	2539	25	2	65	0.0307692
NODE_444_length_3588_cov_16.296360	2474	2539	26	9	65	0.1384615
NODE_444_length_3588_cov_16.296360	2474	2539	27	2	65	0.0307692
NODE_444_length_3588_cov_16.296360	2474	2539	28	23	65	0.3538462
NODE_447_length_3585_cov_2.283419	605	668	0	1	63	0.0158730
NODE_447_length_3585_cov_2.283419	605	668	2	24	63	0.3809524
NODE_447_length_3585_cov_2.283419	605	668	6	38	63	0.6031746
NODE_451_length_3567_cov_16.283160	410	429	0	18	19	0.9473684
NODE_451_length_3567_cov_16.283160	410	429	4	1	19	0.0526316
NODE_451_length_3567_cov_16.283160	2259	2339	225	2	80	0.0250000
NODE_451_length_3567_cov_16.283160	2259	2339	230	1	80	0.0125000
NODE_451_length_3567_cov_16.283160	2259	2339	231	1	80	0.0125000
NODE_451_length_3567_cov_16.283160	2259	2339	237	1	80	0.0125000
NODE_451_length_3567_cov_16.283160	2259	2339	238	1	80	0.0125000
NODE_451_length_3567_cov_16.283160	2259	2339	239	1	80	0.0125000
NODE_451_length_3567_cov_16.283160	2259	2339	240	1	80	0.0125000
NODE_451_length_3567_cov_16.283160	2259	2339	244	2	80	0.0250000
NODE_451_length_3567_cov_16.283160	2259	2339	250	1	80	0.0125000
NODE_451_length_3567_cov_16.283160	2259	2339	252	1	80	0.0125000
NODE_451_length_3567_cov_16.283160	2259	2339	256	7	80	0.0875000
NODE_451_length_3567_cov_16.283160	2259	2339	258	1	80	0.0125000
NODE_451_length_3567_cov_16.283160	2259	2339	260	8	80	0.1000000
NODE_451_length_3567_cov_16.283160	2259	2339	261	3	80	0.0375000
NODE_451_length_3567_cov_16.283160	2259	2339	262	6	80	0.0750000
NODE_451_length_3567_cov_16.283160	2259	2339	263	6	80	0.0750000
NODE_451_length_3567_cov_16.283160	2259	2339	264	9	80	0.1125000
NODE_451_length_3567_cov_16.283160	2259	2339	265	1	80	0.0125000
NODE_451_length_3567_cov_16.283160	2259	2339	266	2	80	0.0250000
NODE_451_length_3567_cov_16.283160	2259	2339	267	3	80	0.0375000
NODE_451_length_3567_cov_16.283160	2259	2339	268	1	80	0.0125000
NODE_451_length_3567_cov_16.283160	2259	2339	269	1	80	0.0125000
NODE_451_length_3567_cov_16.283160	2259	2339	270	5	80	0.0625000
NODE_451_length_3567_cov_16.283160	2259	2339	272	2	80	0.0250000
NODE_451_length_3567_cov_16.283160	2259	2339	273	1	80	0.0125000
NODE_451_length_3567_cov_16.283160	2259	2339	275	6	80	0.0750000
NODE_451_length_3567_cov_16.283160	2259	2339	276	3	80	0.0375000
NODE_451_length_3567_cov_16.283160	2259	2339	277	1	80	0.0125000
NODE_451_length_3567_cov_16.283160	2259	2339	278	1	80	0.0125000
NODE_451_length_3567_cov_16.283160	2259	2339	279	1	80	0.0125000
NODE_451_length_3567_cov_16.283160	2312	2379	2	1	67	0.0149254
NODE_451_length_3567_cov_16.283160	2312	2379	16	1	67	0.0149254
NODE_451_length_3567_cov_16.283160	2312	2379	22	2	67	0.0298507
NODE_451_length_3567_cov_16.283160	2312	2379	27	1	67	0.0149254
NODE_451_length_3567_cov_16.283160	2312	2379	43	1	67	0.0149254
NODE_451_length_3567_cov_16.283160	2312	2379	45	1	67	0.0149254
NODE_451_length_3567_cov_16.283160	2312	2379	46	1	67	0.0149254
NODE_451_length_3567_cov_16.283160	2312	2379	48	1	67	0.0149254
NODE_451_length_3567_cov_16.283160	2312	2379	58	1	67	0.0149254
NODE_451_length_3567_cov_16.283160	2312	2379	71	1	67	0.0149254
NODE_451_length_3567_cov_16.283160	2312	2379	88	1	67	0.0149254
NODE_451_length_3567_cov_16.283160	2312	2379	92	1	67	0.0149254
NODE_451_length_3567_cov_16.283160	2312	2379	120	1	67	0.0149254
NODE_451_length_3567_cov_16.283160	2312	2379	122	1	67	0.0149254
NODE_451_length_3567_cov_16.283160	2312	2379	130	1	67	0.0149254
NODE_451_length_3567_cov_16.283160	2312	2379	131	1	67	0.0149254
NODE_451_length_3567_cov_16.283160	2312	2379	147	1	67	0.0149254
NODE_451_length_3567_cov_16.283160	2312	2379	151	1	67	0.0149254
NODE_451_length_3567_cov_16.283160	2312	2379	157	2	67	0.0298507
NODE_451_length_3567_cov_16.283160	2312	2379	163	1	67	0.0149254
NODE_451_length_3567_cov_16.283160	2312	2379	165	1	67	0.0149254
NODE_451_length_3567_cov_16.283160	2312	2379	178	1	67	0.0149254
NODE_451_length_3567_cov_16.283160	2312	2379	181	1	67	0.0149254
NODE_451_length_3567_cov_16.283160	2312	2379	187	1	67	0.0149254
NODE_451_length_3567_cov_16.283160	2312	2379	198	1	67	0.0149254
NODE_451_length_3567_cov_16.283160	2312	2379	202	1	67	0.0149254
NODE_451_length_3567_cov_16.283160	2312	2379	204	1	67	0.0149254
NODE_451_length_3567_cov_16.283160	2312	2379	207	1	67	0.0149254
NODE_451_length_3567_cov_16.283160	2312	2379	209	1	67	0.0149254
NODE_451_length_3567_cov_16.283160	2312	2379	215	1	67	0.0149254
NODE_451_length_3567_cov_16.283160	2312	2379	221	1	67	0.0149254
NODE_451_length_3567_cov_16.283160	2312	2379	224	3	67	0.0447761
NODE_451_length_3567_cov_16.283160	2312	2379	225	1	67	0.0149254
NODE_451_length_3567_cov_16.283160	2312	2379	231	1	67	0.0149254
NODE_451_length_3567_cov_16.283160	2312	2379	233	1	67	0.0149254
NODE_451_length_3567_cov_16.283160	2312	2379	237	2	67	0.0298507
NODE_451_length_3567_cov_16.283160	2312	2379	239	1	67	0.0149254
NODE_451_length_3567_cov_16.283160	2312	2379	244	1	67	0.0149254
NODE_451_length_3567_cov_16.283160	2312	2379	252	1	67	0.0149254
NODE_451_length_3567_cov_16.283160	2312	2379	256	6	67	0.0895522
NODE_451_length_3567_cov_16.283160	2312	2379	258	1	67	0.0149254
NODE_451_length_3567_cov_16.283160	2312	2379	260	8	67	0.1194030
NODE_451_length_3567_cov_16.283160	2312	2379	262	5	67	0.0746269
NODE_451_length_3567_cov_16.283160	2312	2379	264	3	67	0.0447761
NODE_454_length_3557_cov_12.423077	640	718	0	50	78	0.6410257
NODE_454_length_3557_cov_12.423077	640	718	2	2	78	0.0256410
NODE_454_length_3557_cov_12.423077	640	718	6	15	78	0.1923077
NODE_454_length_3557_cov_12.423077	640	718	8	11	78	0.1410256
NODE_454_length_3557_cov_12.423077	640	688	0	48	48	1.0000000
NODE_454_length_3557_cov_12.423077	640	688	0	48	48	1.0000000
NODE_454_length_3557_cov_12.423077	640	688	0	48	48	1.0000000
NODE_454_length_3557_cov_12.423077	640	688	0	48	48	1.0000000
NODE_454_length_3557_cov_12.423077	693	771	6	14	78	0.1794872
NODE_454_length_3557_cov_12.423077	693	771	8	12	78	0.1538462
NODE_454_length_3557_cov_12.423077	693	771	10	52	78	0.6666667
NODE_455_length_3548_cov_7.216295	554	634	8	27	80	0.3375000
NODE_455_length_3548_cov_7.216295	554	634	10	17	80	0.2125000
NODE_455_length_3548_cov_7.216295	554	634	12	4	80	0.0500000
NODE_455_length_3548_cov_7.216295	554	634	14	32	80	0.4000000
NODE_455_length_3548_cov_7.216295	607	687	4	3	80	0.0375000
NODE_455_length_3548_cov_7.216295	607	687	6	21	80	0.2625000
NODE_455_length_3548_cov_7.216295	607	687	8	14	80	0.1750000
NODE_455_length_3548_cov_7.216295	607	687	12	2	80	0.0250000
NODE_455_length_3548_cov_7.216295	607	687	14	40	80	0.5000000
NODE_461_length_3518_cov_40.508336	1320	1400	2	19	80	0.2375000
NODE_461_length_3518_cov_40.508336	1320	1400	12	33	80	0.4125000
NODE_461_length_3518_cov_40.508336	1320	1400	16	20	80	0.2500000
NODE_461_length_3518_cov_40.508336	1320	1400	18	8	80	0.1000000
NODE_461_length_3518_cov_40.508336	1373	1453	16	37	80	0.4625000
NODE_461_length_3518_cov_40.508336	1373	1453	18	12	80	0.1500000
NODE_461_length_3518_cov_40.508336	1373	1453	20	31	80	0.3875000
NODE_465_length_3497_cov_65.791348	3062	3142	570	1	80	0.0125000
NODE_465_length_3497_cov_65.791348	3062	3142	576	1	80	0.0125000
NODE_465_length_3497_cov_65.791348	3062	3142	578	1	80	0.0125000
NODE_465_length_3497_cov_65.791348	3062	3142	579	1	80	0.0125000
NODE_465_length_3497_cov_65.791348	3062	3142	580	1	80	0.0125000
NODE_465_length_3497_cov_65.791348	3062	3142	589	1	80	0.0125000
NODE_465_length_3497_cov_65.791348	3062	3142	592	1	80	0.0125000
NODE_465_length_3497_cov_65.791348	3062	3142	593	2	80	0.0250000
NODE_465_length_3497_cov_65.791348	3062	3142	595	1	80	0.0125000
NODE_465_length_3497_cov_65.791348	3062	3142	608	1	80	0.0125000
NODE_465_length_3497_cov_65.791348	3062	3142	628	1	80	0.0125000
NODE_465_length_3497_cov_65.791348	3062	3142	636	1	80	0.0125000
NODE_465_length_3497_cov_65.791348	3062	3142	660	1	80	0.0125000
NODE_465_length_3497_cov_65.791348	3062	3142	667	1	80	0.0125000
NODE_465_length_3497_cov_65.791348	3062	3142	685	1	80	0.0125000
NODE_465_length_3497_cov_65.791348	3062	3142	699	2	80	0.0250000
NODE_465_length_3497_cov_65.791348	3062	3142	702	2	80	0.0250000
NODE_465_length_3497_cov_65.791348	3062	3142	712	1	80	0.0125000
NODE_465_length_3497_cov_65.791348	3062	3142	734	1	80	0.0125000
NODE_465_length_3497_cov_65.791348	3062	3142	740	1	80	0.0125000
NODE_465_length_3497_cov_65.791348	3062	3142	744	1	80	0.0125000
NODE_465_length_3497_cov_65.791348	3062	3142	746	1	80	0.0125000
NODE_465_length_3497_cov_65.791348	3062	3142	753	1	80	0.0125000
NODE_465_length_3497_cov_65.791348	3062	3142	754	1	80	0.0125000
NODE_465_length_3497_cov_65.791348	3062	3142	756	1	80	0.0125000
NODE_465_length_3497_cov_65.791348	3062	3142	757	2	80	0.0250000
NODE_465_length_3497_cov_65.791348	3062	3142	771	2	80	0.0250000
NODE_465_length_3497_cov_65.791348	3062	3142	772	1	80	0.0125000
NODE_465_length_3497_cov_65.791348	3062	3142	774	1	80	0.0125000
NODE_465_length_3497_cov_65.791348	3062	3142	777	2	80	0.0250000
NODE_465_length_3497_cov_65.791348	3062	3142	778	1	80	0.0125000
NODE_465_length_3497_cov_65.791348	3062	3142	780	1	80	0.0125000
NODE_465_length_3497_cov_65.791348	3062	3142	781	1	80	0.0125000
NODE_465_length_3497_cov_65.791348	3062	3142	782	1	80	0.0125000
NODE_465_length_3497_cov_65.791348	3062	3142	783	1	80	0.0125000
NODE_465_length_3497_cov_65.791348	3062	3142	784	1	80	0.0125000
NODE_465_length_3497_cov_65.791348	3062	3142	786	4	80	0.0500000
NODE_465_length_3497_cov_65.791348	3062	3142	787	1	80	0.0125000
NODE_465_length_3497_cov_65.791348	3062	3142	788	3	80	0.0375000
NODE_465_length_3497_cov_65.791348	3062	3142	790	1	80	0.0125000
NODE_465_length_3497_cov_65.791348	3062	3142	791	1	80	0.0125000
NODE_465_length_3497_cov_65.791348	3062	3142	792	1	80	0.0125000
NODE_465_length_3497_cov_65.791348	3062	3142	794	1	80	0.0125000
NODE_465_length_3497_cov_65.791348	3062	3142	798	2	80	0.0250000
NODE_465_length_3497_cov_65.791348	3062	3142	799	1	80	0.0125000
NODE_465_length_3497_cov_65.791348	3062	3142	800	1	80	0.0125000
NODE_465_length_3497_cov_65.791348	3062	3142	802	1	80	0.0125000
NODE_465_length_3497_cov_65.791348	3062	3142	804	1	80	0.0125000
NODE_465_length_3497_cov_65.791348	3062	3142	805	1	80	0.0125000
NODE_465_length_3497_cov_65.791348	3062	3142	806	1	80	0.0125000
NODE_465_length_3497_cov_65.791348	3062	3142	808	3	80	0.0375000
NODE_465_length_3497_cov_65.791348	3062	3142	811	1	80	0.0125000
NODE_465_length_3497_cov_65.791348	3062	3142	812	4	80	0.0500000
NODE_465_length_3497_cov_65.791348	3062	3142	815	1	80	0.0125000
NODE_465_length_3497_cov_65.791348	3062	3142	818	2	80	0.0250000
NODE_465_length_3497_cov_65.791348	3062	3142	821	1	80	0.0125000
NODE_465_length_3497_cov_65.791348	3062	3142	822	1	80	0.0125000
NODE_465_length_3497_cov_65.791348	3062	3142	824	1	80	0.0125000
NODE_465_length_3497_cov_65.791348	3062	3142	825	1	80	0.0125000
NODE_465_length_3497_cov_65.791348	3062	3142	835	1	80	0.0125000
NODE_465_length_3497_cov_65.791348	3062	3142	839	1	80	0.0125000
NODE_465_length_3497_cov_65.791348	3062	3142	840	1	80	0.0125000
NODE_466_length_3488_cov_2.243730	506	529	2	23	23	1.0000000
NODE_470_length_3483_cov_14.759456	360	440	0	16	80	0.2000000
NODE_470_length_3483_cov_14.759456	360	440	6	62	80	0.7750000
NODE_470_length_3483_cov_14.759456	360	440	8	2	80	0.0250000
NODE_470_length_3483_cov_14.759456	413	493	2	22	80	0.2750000
NODE_470_length_3483_cov_14.759456	413	493	6	25	80	0.3125000
NODE_470_length_3483_cov_14.759456	413	493	8	33	80	0.4125000
NODE_474_length_3471_cov_37.887604	2795	2875	0	45	80	0.5625000
NODE_474_length_3471_cov_37.887604	2795	2875	2	35	80	0.4375000
NODE_474_length_3471_cov_37.887604	2848	2928	0	32	80	0.4000000
NODE_474_length_3471_cov_37.887604	2848	2928	2	48	80	0.6000000
NODE_474_length_3471_cov_37.887604	2924	2943	0	19	19	1.0000000
NODE_474_length_3471_cov_37.887604	2924	3004	0	80	80	1.0000000
NODE_474_length_3471_cov_37.887604	2977	3057	0	80	80	1.0000000
NODE_479_length_3451_cov_29.833234	2973	3053	0	43	80	0.5375000
NODE_479_length_3451_cov_29.833234	2973	3053	2	1	80	0.0125000
NODE_479_length_3451_cov_29.833234	2973	3053	4	35	80	0.4375000
NODE_479_length_3451_cov_29.833234	2973	3053	6	1	80	0.0125000
NODE_479_length_3451_cov_29.833234	3026	3106	0	80	80	1.0000000
NODE_481_length_3446_cov_32.421273	3181	3261	15	2	80	0.0250000
NODE_481_length_3446_cov_32.421273	3181	3261	17	4	80	0.0500000
NODE_481_length_3446_cov_32.421273	3181	3261	18	1	80	0.0125000
NODE_481_length_3446_cov_32.421273	3181	3261	20	15	80	0.1875000
NODE_481_length_3446_cov_32.421273	3181	3261	22	13	80	0.1625000
NODE_481_length_3446_cov_32.421273	3181	3261	24	5	80	0.0625000
NODE_481_length_3446_cov_32.421273	3181	3261	26	38	80	0.4750000
NODE_481_length_3446_cov_32.421273	3181	3261	28	2	80	0.0250000
NODE_482_length_3444_cov_29.954858	792	872	37	4	80	0.0500000
NODE_482_length_3444_cov_29.954858	792	872	38	9	80	0.1125000
NODE_482_length_3444_cov_29.954858	792	872	39	14	80	0.1750000
NODE_482_length_3444_cov_29.954858	792	872	40	5	80	0.0625000
NODE_482_length_3444_cov_29.954858	792	872	41	2	80	0.0250000
NODE_482_length_3444_cov_29.954858	792	872	42	2	80	0.0250000
NODE_482_length_3444_cov_29.954858	792	872	43	6	80	0.0750000
NODE_482_length_3444_cov_29.954858	792	872	47	5	80	0.0625000
NODE_482_length_3444_cov_29.954858	792	872	49	16	80	0.2000000
NODE_482_length_3444_cov_29.954858	792	872	50	10	80	0.1250000
NODE_482_length_3444_cov_29.954858	792	872	52	7	80	0.0875000
NODE_482_length_3444_cov_29.954858	845	925	25	5	80	0.0625000
NODE_482_length_3444_cov_29.954858	845	925	35	2	80	0.0250000
NODE_482_length_3444_cov_29.954858	845	925	37	14	80	0.1750000
NODE_482_length_3444_cov_29.954858	845	925	38	4	80	0.0500000
NODE_482_length_3444_cov_29.954858	845	925	39	24	80	0.3000000
NODE_482_length_3444_cov_29.954858	845	925	40	10	80	0.1250000
NODE_482_length_3444_cov_29.954858	845	925	41	11	80	0.1375000
NODE_482_length_3444_cov_29.954858	845	925	42	2	80	0.0250000
NODE_482_length_3444_cov_29.954858	845	925	43	3	80	0.0375000
NODE_482_length_3444_cov_29.954858	845	925	49	1	80	0.0125000
NODE_482_length_3444_cov_29.954858	845	925	52	4	80	0.0500000
NODE_483_length_3442_cov_17.799880	3155	3220	0	1	65	0.0153846
NODE_483_length_3442_cov_17.799880	3155	3220	5	1	65	0.0153846
NODE_483_length_3442_cov_17.799880	3155	3220	7	2	65	0.0307692
NODE_483_length_3442_cov_17.799880	3155	3220	11	4	65	0.0615385
NODE_483_length_3442_cov_17.799880	3155	3220	13	3	65	0.0461538
NODE_483_length_3442_cov_17.799880	3155	3220	15	2	65	0.0307692
NODE_483_length_3442_cov_17.799880	3155	3220	17	1	65	0.0153846
NODE_483_length_3442_cov_17.799880	3155	3220	19	1	65	0.0153846
NODE_483_length_3442_cov_17.799880	3155	3220	21	2	65	0.0307692
NODE_483_length_3442_cov_17.799880	3155	3220	25	1	65	0.0153846
NODE_483_length_3442_cov_17.799880	3155	3220	29	4	65	0.0615385
NODE_483_length_3442_cov_17.799880	3155	3220	30	1	65	0.0153846
NODE_483_length_3442_cov_17.799880	3155	3220	32	4	65	0.0615385
NODE_483_length_3442_cov_17.799880	3155	3220	34	1	65	0.0153846
NODE_483_length_3442_cov_17.799880	3155	3220	36	2	65	0.0307692
NODE_483_length_3442_cov_17.799880	3155	3220	38	1	65	0.0153846
NODE_483_length_3442_cov_17.799880	3155	3220	42	1	65	0.0153846
NODE_483_length_3442_cov_17.799880	3155	3220	44	1	65	0.0153846
NODE_483_length_3442_cov_17.799880	3155	3220	46	2	65	0.0307692
NODE_483_length_3442_cov_17.799880	3155	3220	48	2	65	0.0307692
NODE_483_length_3442_cov_17.799880	3155	3220	50	1	65	0.0153846
NODE_483_length_3442_cov_17.799880	3155	3220	51	1	65	0.0153846
NODE_483_length_3442_cov_17.799880	3155	3220	55	7	65	0.1076923
NODE_483_length_3442_cov_17.799880	3155	3220	56	1	65	0.0153846
NODE_483_length_3442_cov_17.799880	3155	3220	57	2	65	0.0307692
NODE_483_length_3442_cov_17.799880	3155	3220	58	4	65	0.0615385
NODE_483_length_3442_cov_17.799880	3155	3220	60	3	65	0.0461538
NODE_483_length_3442_cov_17.799880	3155	3220	66	3	65	0.0461538
NODE_483_length_3442_cov_17.799880	3155	3220	68	1	65	0.0153846
NODE_483_length_3442_cov_17.799880	3155	3220	74	5	65	0.0769231
NODE_483_length_3442_cov_17.799880	3208	3273	60	3	65	0.0461538
NODE_483_length_3442_cov_17.799880	3208	3273	66	3	65	0.0461538
NODE_483_length_3442_cov_17.799880	3208	3273	68	1	65	0.0153846
NODE_483_length_3442_cov_17.799880	3208	3273	74	9	65	0.1384615
NODE_483_length_3442_cov_17.799880	3208	3273	76	3	65	0.0461538
NODE_483_length_3442_cov_17.799880	3208	3273	78	1	65	0.0153846
NODE_483_length_3442_cov_17.799880	3208	3273	79	2	65	0.0307692
NODE_483_length_3442_cov_17.799880	3208	3273	82	1	65	0.0153846
NODE_483_length_3442_cov_17.799880	3208	3273	84	1	65	0.0153846
NODE_483_length_3442_cov_17.799880	3208	3273	86	1	65	0.0153846
NODE_483_length_3442_cov_17.799880	3208	3273	90	1	65	0.0153846
NODE_483_length_3442_cov_17.799880	3208	3273	93	2	65	0.0307692
NODE_483_length_3442_cov_17.799880	3208	3273	99	2	65	0.0307692
NODE_483_length_3442_cov_17.799880	3208	3273	109	1	65	0.0153846
NODE_483_length_3442_cov_17.799880	3208	3273	111	1	65	0.0153846
NODE_483_length_3442_cov_17.799880	3208	3273	115	1	65	0.0153846
NODE_483_length_3442_cov_17.799880	3208	3273	117	2	65	0.0307692
NODE_483_length_3442_cov_17.799880	3208	3273	120	1	65	0.0153846
NODE_483_length_3442_cov_17.799880	3208	3273	124	3	65	0.0461538
NODE_483_length_3442_cov_17.799880	3208	3273	128	2	65	0.0307692
NODE_483_length_3442_cov_17.799880	3208	3273	132	1	65	0.0153846
NODE_483_length_3442_cov_17.799880	3208	3273	136	1	65	0.0153846
NODE_483_length_3442_cov_17.799880	3208	3273	144	1	65	0.0153846
NODE_483_length_3442_cov_17.799880	3208	3273	146	1	65	0.0153846
NODE_483_length_3442_cov_17.799880	3208	3273	153	2	65	0.0307692
NODE_483_length_3442_cov_17.799880	3208	3273	160	1	65	0.0153846
NODE_483_length_3442_cov_17.799880	3208	3273	162	4	65	0.0615385
NODE_483_length_3442_cov_17.799880	3208	3273	163	1	65	0.0153846
NODE_483_length_3442_cov_17.799880	3208	3273	164	3	65	0.0461538
NODE_483_length_3442_cov_17.799880	3208	3273	174	1	65	0.0153846
NODE_483_length_3442_cov_17.799880	3208	3273	175	1	65	0.0153846
NODE_483_length_3442_cov_17.799880	3208	3273	182	1	65	0.0153846
NODE_483_length_3442_cov_17.799880	3208	3273	188	2	65	0.0307692
NODE_483_length_3442_cov_17.799880	3208	3273	192	1	65	0.0153846
NODE_483_length_3442_cov_17.799880	3208	3273	195	1	65	0.0153846
NODE_483_length_3442_cov_17.799880	3208	3273	200	1	65	0.0153846
NODE_483_length_3442_cov_17.799880	3208	3273	208	1	65	0.0153846
NODE_486_length_3429_cov_5.070270	125	148	68	2	23	0.0869565
NODE_486_length_3429_cov_5.070270	125	148	70	2	23	0.0869565
NODE_486_length_3429_cov_5.070270	125	148	72	4	23	0.1739130
NODE_486_length_3429_cov_5.070270	125	148	74	3	23	0.1304348
NODE_486_length_3429_cov_5.070270	125	148	76	4	23	0.1739130
NODE_486_length_3429_cov_5.070270	125	148	77	3	23	0.1304348
NODE_486_length_3429_cov_5.070270	125	148	78	1	23	0.0434783
NODE_486_length_3429_cov_5.070270	125	148	79	3	23	0.1304348
NODE_486_length_3429_cov_5.070270	125	148	80	1	23	0.0434783
NODE_493_length_3408_cov_2.406769	0	45	0	45	45	1.0000000
NODE_495_length_3405_cov_44.930127	2683	2759	0	56	76	0.7368421
NODE_495_length_3405_cov_44.930127	2683	2759	2	20	76	0.2631579
NODE_495_length_3405_cov_44.930127	3116	3164	6	31	48	0.6458333
NODE_495_length_3405_cov_44.930127	3116	3164	8	17	48	0.3541667
NODE_496_length_3402_cov_28.961550	128	183	0	3	55	0.0545455
NODE_496_length_3402_cov_28.961550	128	183	6	15	55	0.2727273
NODE_496_length_3402_cov_28.961550	128	183	8	37	55	0.6727273
NODE_496_length_3402_cov_28.961550	3154	3234	35	4	80	0.0500000
NODE_496_length_3402_cov_28.961550	3154	3234	37	9	80	0.1125000
NODE_496_length_3402_cov_28.961550	3154	3234	39	3	80	0.0375000
NODE_496_length_3402_cov_28.961550	3154	3234	40	1	80	0.0125000
NODE_496_length_3402_cov_28.961550	3154	3234	42	2	80	0.0250000
NODE_496_length_3402_cov_28.961550	3154	3234	44	2	80	0.0250000
NODE_496_length_3402_cov_28.961550	3154	3234	45	4	80	0.0500000
NODE_496_length_3402_cov_28.961550	3154	3234	47	2	80	0.0250000
NODE_496_length_3402_cov_28.961550	3154	3234	48	2	80	0.0250000
NODE_496_length_3402_cov_28.961550	3154	3234	52	2	80	0.0250000
NODE_496_length_3402_cov_28.961550	3154	3234	54	1	80	0.0125000
NODE_496_length_3402_cov_28.961550	3154	3234	56	5	80	0.0625000
NODE_496_length_3402_cov_28.961550	3154	3234	58	6	80	0.0750000
NODE_496_length_3402_cov_28.961550	3154	3234	60	18	80	0.2250000
NODE_496_length_3402_cov_28.961550	3154	3234	62	12	80	0.1500000
NODE_496_length_3402_cov_28.961550	3154	3234	65	3	80	0.0375000
NODE_496_length_3402_cov_28.961550	3154	3234	66	4	80	0.0500000
NODE_496_length_3402_cov_28.961550	3207	3287	0	1	80	0.0125000
NODE_496_length_3402_cov_28.961550	3207	3287	6	1	80	0.0125000
NODE_496_length_3402_cov_28.961550	3207	3287	8	3	80	0.0375000
NODE_496_length_3402_cov_28.961550	3207	3287	10	7	80	0.0875000
NODE_496_length_3402_cov_28.961550	3207	3287	12	1	80	0.0125000
NODE_496_length_3402_cov_28.961550	3207	3287	14	18	80	0.2250000
NODE_496_length_3402_cov_28.961550	3207	3287	16	1	80	0.0125000
NODE_496_length_3402_cov_28.961550	3207	3287	20	1	80	0.0125000
NODE_496_length_3402_cov_28.961550	3207	3287	22	1	80	0.0125000
NODE_496_length_3402_cov_28.961550	3207	3287	24	7	80	0.0875000
NODE_496_length_3402_cov_28.961550	3207	3287	26	2	80	0.0250000
NODE_496_length_3402_cov_28.961550	3207	3287	30	4	80	0.0500000
NODE_496_length_3402_cov_28.961550	3207	3287	32	2	80	0.0250000
NODE_496_length_3402_cov_28.961550	3207	3287	34	2	80	0.0250000
NODE_496_length_3402_cov_28.961550	3207	3287	35	6	80	0.0750000
NODE_496_length_3402_cov_28.961550	3207	3287	37	9	80	0.1125000
NODE_496_length_3402_cov_28.961550	3207	3287	39	3	80	0.0375000
NODE_496_length_3402_cov_28.961550	3207	3287	40	1	80	0.0125000
NODE_496_length_3402_cov_28.961550	3207	3287	42	2	80	0.0250000
NODE_496_length_3402_cov_28.961550	3207	3287	44	2	80	0.0250000
NODE_496_length_3402_cov_28.961550	3207	3287	45	4	80	0.0500000
NODE_496_length_3402_cov_28.961550	3207	3287	47	2	80	0.0250000
NODE_498_length_3393_cov_43.623558	1009	1075	196	1	66	0.0151515
NODE_498_length_3393_cov_43.623558	1009	1075	203	1	66	0.0151515
NODE_498_length_3393_cov_43.623558	1009	1075	209	1	66	0.0151515
NODE_498_length_3393_cov_43.623558	1009	1075	224	1	66	0.0151515
NODE_498_length_3393_cov_43.623558	1009	1075	229	1	66	0.0151515
NODE_498_length_3393_cov_43.623558	1009	1075	244	1	66	0.0151515
NODE_498_length_3393_cov_43.623558	1009	1075	252	2	66	0.0303030
NODE_498_length_3393_cov_43.623558	1009	1075	257	1	66	0.0151515
NODE_498_length_3393_cov_43.623558	1009	1075	258	1	66	0.0151515
NODE_498_length_3393_cov_43.623558	1009	1075	260	2	66	0.0303030
NODE_498_length_3393_cov_43.623558	1009	1075	261	1	66	0.0151515
NODE_498_length_3393_cov_43.623558	1009	1075	262	1	66	0.0151515
NODE_498_length_3393_cov_43.623558	1009	1075	263	1	66	0.0151515
NODE_498_length_3393_cov_43.623558	1009	1075	264	2	66	0.0303030
NODE_498_length_3393_cov_43.623558	1009	1075	265	1	66	0.0151515
NODE_498_length_3393_cov_43.623558	1009	1075	268	1	66	0.0151515
NODE_498_length_3393_cov_43.623558	1009	1075	269	2	66	0.0303030
NODE_498_length_3393_cov_43.623558	1009	1075	271	3	66	0.0454545
NODE_498_length_3393_cov_43.623558	1009	1075	272	1	66	0.0151515
NODE_498_length_3393_cov_43.623558	1009	1075	273	1	66	0.0151515
NODE_498_length_3393_cov_43.623558	1009	1075	274	2	66	0.0303030
NODE_498_length_3393_cov_43.623558	1009	1075	275	2	66	0.0303030
NODE_498_length_3393_cov_43.623558	1009	1075	277	1	66	0.0151515
NODE_498_length_3393_cov_43.623558	1009	1075	282	1	66	0.0151515
NODE_498_length_3393_cov_43.623558	1009	1075	284	1	66	0.0151515
NODE_498_length_3393_cov_43.623558	1009	1075	288	1	66	0.0151515
NODE_498_length_3393_cov_43.623558	1009	1075	291	3	66	0.0454545
NODE_498_length_3393_cov_43.623558	1009	1075	294	1	66	0.0151515
NODE_498_length_3393_cov_43.623558	1009	1075	295	1	66	0.0151515
NODE_498_length_3393_cov_43.623558	1009	1075	298	1	66	0.0151515
NODE_498_length_3393_cov_43.623558	1009	1075	299	1	66	0.0151515
NODE_498_length_3393_cov_43.623558	1009	1075	301	4	66	0.0606061
NODE_498_length_3393_cov_43.623558	1009	1075	302	1	66	0.0151515
NODE_498_length_3393_cov_43.623558	1009	1075	304	3	66	0.0454545
NODE_498_length_3393_cov_43.623558	1009	1075	306	2	66	0.0303030
NODE_498_length_3393_cov_43.623558	1009	1075	307	1	66	0.0151515
NODE_498_length_3393_cov_43.623558	1009	1075	308	1	66	0.0151515
NODE_498_length_3393_cov_43.623558	1009	1075	309	9	66	0.1363636
NODE_498_length_3393_cov_43.623558	1009	1075	311	3	66	0.0454545
NODE_498_length_3393_cov_43.623558	1009	1075	312	1	66	0.0151515
NODE_498_length_3393_cov_43.623558	1048	1128	163	2	80	0.0250000
NODE_498_length_3393_cov_43.623558	1048	1128	164	1	80	0.0125000
NODE_498_length_3393_cov_43.623558	1048	1128	165	3	80	0.0375000
NODE_498_length_3393_cov_43.623558	1048	1128	166	1	80	0.0125000
NODE_498_length_3393_cov_43.623558	1048	1128	167	1	80	0.0125000
NODE_498_length_3393_cov_43.623558	1048	1128	168	2	80	0.0250000
NODE_498_length_3393_cov_43.623558	1048	1128	170	2	80	0.0250000
NODE_498_length_3393_cov_43.623558	1048	1128	175	1	80	0.0125000
NODE_498_length_3393_cov_43.623558	1048	1128	176	3	80	0.0375000
NODE_498_length_3393_cov_43.623558	1048	1128	178	2	80	0.0250000
NODE_498_length_3393_cov_43.623558	1048	1128	179	2	80	0.0250000
NODE_498_length_3393_cov_43.623558	1048	1128	183	1	80	0.0125000
NODE_498_length_3393_cov_43.623558	1048	1128	184	1	80	0.0125000
NODE_498_length_3393_cov_43.623558	1048	1128	185	5	80	0.0625000
NODE_498_length_3393_cov_43.623558	1048	1128	186	1	80	0.0125000
NODE_498_length_3393_cov_43.623558	1048	1128	187	4	80	0.0500000
NODE_498_length_3393_cov_43.623558	1048	1128	189	2	80	0.0250000
NODE_498_length_3393_cov_43.623558	1048	1128	190	2	80	0.0250000
NODE_498_length_3393_cov_43.623558	1048	1128	192	9	80	0.1125000
NODE_498_length_3393_cov_43.623558	1048	1128	193	2	80	0.0250000
NODE_498_length_3393_cov_43.623558	1048	1128	194	4	80	0.0500000
NODE_498_length_3393_cov_43.623558	1048	1128	196	2	80	0.0250000
NODE_498_length_3393_cov_43.623558	1048	1128	197	1	80	0.0125000
NODE_498_length_3393_cov_43.623558	1048	1128	203	1	80	0.0125000
NODE_498_length_3393_cov_43.623558	1048	1128	209	1	80	0.0125000
NODE_498_length_3393_cov_43.623558	1048	1128	224	1	80	0.0125000
NODE_498_length_3393_cov_43.623558	1048	1128	229	1	80	0.0125000
NODE_498_length_3393_cov_43.623558	1048	1128	244	1	80	0.0125000
NODE_498_length_3393_cov_43.623558	1048	1128	252	2	80	0.0250000
NODE_498_length_3393_cov_43.623558	1048	1128	257	1	80	0.0125000
NODE_498_length_3393_cov_43.623558	1048	1128	258	1	80	0.0125000
NODE_498_length_3393_cov_43.623558	1048	1128	261	1	80	0.0125000
NODE_498_length_3393_cov_43.623558	1048	1128	263	1	80	0.0125000
NODE_498_length_3393_cov_43.623558	1048	1128	264	1	80	0.0125000
NODE_498_length_3393_cov_43.623558	1048	1128	265	1	80	0.0125000
NODE_498_length_3393_cov_43.623558	1048	1128	269	2	80	0.0250000
NODE_498_length_3393_cov_43.623558	1048	1128	271	1	80	0.0125000
NODE_498_length_3393_cov_43.623558	1048	1128	273	1	80	0.0125000
NODE_498_length_3393_cov_43.623558	1048	1128	275	1	80	0.0125000
NODE_498_length_3393_cov_43.623558	1048	1128	277	1	80	0.0125000
NODE_498_length_3393_cov_43.623558	1048	1128	282	1	80	0.0125000
NODE_498_length_3393_cov_43.623558	1048	1128	284	1	80	0.0125000
NODE_498_length_3393_cov_43.623558	1048	1128	291	2	80	0.0250000
NODE_498_length_3393_cov_43.623558	1048	1128	294	1	80	0.0125000
NODE_498_length_3393_cov_43.623558	1048	1128	295	1	80	0.0125000
NODE_498_length_3393_cov_43.623558	1048	1128	299	1	80	0.0125000
NODE_498_length_3393_cov_43.623558	3086	3128	132	1	42	0.0238095
NODE_498_length_3393_cov_43.623558	3086	3128	200	1	42	0.0238095
NODE_498_length_3393_cov_43.623558	3086	3128	201	1	42	0.0238095
NODE_498_length_3393_cov_43.623558	3086	3128	232	1	42	0.0238095
NODE_498_length_3393_cov_43.623558	3086	3128	235	1	42	0.0238095
NODE_498_length_3393_cov_43.623558	3086	3128	263	1	42	0.0238095
NODE_498_length_3393_cov_43.623558	3086	3128	276	1	42	0.0238095
NODE_498_length_3393_cov_43.623558	3086	3128	282	1	42	0.0238095
NODE_498_length_3393_cov_43.623558	3086	3128	288	1	42	0.0238095
NODE_498_length_3393_cov_43.623558	3086	3128	294	1	42	0.0238095
NODE_498_length_3393_cov_43.623558	3086	3128	296	2	42	0.0476190
NODE_498_length_3393_cov_43.623558	3086	3128	297	1	42	0.0238095
NODE_498_length_3393_cov_43.623558	3086	3128	298	1	42	0.0238095
NODE_498_length_3393_cov_43.623558	3086	3128	300	1	42	0.0238095
NODE_498_length_3393_cov_43.623558	3086	3128	302	1	42	0.0238095
NODE_498_length_3393_cov_43.623558	3086	3128	304	1	42	0.0238095
NODE_498_length_3393_cov_43.623558	3086	3128	305	1	42	0.0238095
NODE_498_length_3393_cov_43.623558	3086	3128	306	1	42	0.0238095
NODE_498_length_3393_cov_43.623558	3086	3128	309	1	42	0.0238095
NODE_498_length_3393_cov_43.623558	3086	3128	314	1	42	0.0238095
NODE_498_length_3393_cov_43.623558	3086	3128	321	1	42	0.0238095
NODE_498_length_3393_cov_43.623558	3086	3128	333	1	42	0.0238095
NODE_498_length_3393_cov_43.623558	3086	3128	338	1	42	0.0238095
NODE_498_length_3393_cov_43.623558	3086	3128	348	1	42	0.0238095
NODE_498_length_3393_cov_43.623558	3086	3128	358	1	42	0.0238095
NODE_498_length_3393_cov_43.623558	3086	3128	361	1	42	0.0238095
NODE_498_length_3393_cov_43.623558	3086	3128	365	1	42	0.0238095
NODE_498_length_3393_cov_43.623558	3086	3128	371	2	42	0.0476190
NODE_498_length_3393_cov_43.623558	3086	3128	374	1	42	0.0238095
NODE_498_length_3393_cov_43.623558	3086	3128	386	1	42	0.0238095
NODE_498_length_3393_cov_43.623558	3086	3128	410	1	42	0.0238095
NODE_498_length_3393_cov_43.623558	3086	3128	413	2	42	0.0476190
NODE_498_length_3393_cov_43.623558	3086	3128	422	1	42	0.0238095
NODE_498_length_3393_cov_43.623558	3086	3128	427	1	42	0.0238095
NODE_498_length_3393_cov_43.623558	3086	3128	450	1	42	0.0238095
NODE_498_length_3393_cov_43.623558	3086	3128	468	1	42	0.0238095
NODE_498_length_3393_cov_43.623558	3086	3128	475	1	42	0.0238095
NODE_498_length_3393_cov_43.623558	3086	3128	482	1	42	0.0238095
NODE_498_length_3393_cov_43.623558	3086	3128	486	1	42	0.0238095
NODE_498_length_3393_cov_43.623558	3293	3373	173	1	80	0.0125000
NODE_498_length_3393_cov_43.623558	3293	3373	185	1	80	0.0125000
NODE_498_length_3393_cov_43.623558	3293	3373	187	1	80	0.0125000
NODE_498_length_3393_cov_43.623558	3293	3373	191	1	80	0.0125000
NODE_498_length_3393_cov_43.623558	3293	3373	213	1	80	0.0125000
NODE_498_length_3393_cov_43.623558	3293	3373	228	1	80	0.0125000
NODE_498_length_3393_cov_43.623558	3293	3373	232	3	80	0.0375000
NODE_498_length_3393_cov_43.623558	3293	3373	234	1	80	0.0125000
NODE_498_length_3393_cov_43.623558	3293	3373	248	1	80	0.0125000
NODE_498_length_3393_cov_43.623558	3293	3373	257	1	80	0.0125000
NODE_498_length_3393_cov_43.623558	3293	3373	270	1	80	0.0125000
NODE_498_length_3393_cov_43.623558	3293	3373	278	1	80	0.0125000
NODE_498_length_3393_cov_43.623558	3293	3373	296	1	80	0.0125000
NODE_498_length_3393_cov_43.623558	3293	3373	311	1	80	0.0125000
NODE_498_length_3393_cov_43.623558	3293	3373	328	1	80	0.0125000
NODE_498_length_3393_cov_43.623558	3293	3373	343	1	80	0.0125000
NODE_498_length_3393_cov_43.623558	3293	3373	366	1	80	0.0125000
NODE_498_length_3393_cov_43.623558	3293	3373	380	1	80	0.0125000
NODE_498_length_3393_cov_43.623558	3293	3373	390	1	80	0.0125000
NODE_498_length_3393_cov_43.623558	3293	3373	407	1	80	0.0125000
NODE_498_length_3393_cov_43.623558	3293	3373	411	1	80	0.0125000
NODE_498_length_3393_cov_43.623558	3293	3373	419	1	80	0.0125000
NODE_498_length_3393_cov_43.623558	3293	3373	436	1	80	0.0125000
NODE_498_length_3393_cov_43.623558	3293	3373	480	1	80	0.0125000
NODE_498_length_3393_cov_43.623558	3293	3373	484	1	80	0.0125000
NODE_498_length_3393_cov_43.623558	3293	3373	492	1	80	0.0125000
NODE_498_length_3393_cov_43.623558	3293	3373	497	2	80	0.0250000
NODE_498_length_3393_cov_43.623558	3293	3373	499	2	80	0.0250000
NODE_498_length_3393_cov_43.623558	3293	3373	503	2	80	0.0250000
NODE_498_length_3393_cov_43.623558	3293	3373	511	2	80	0.0250000
NODE_498_length_3393_cov_43.623558	3293	3373	522	1	80	0.0125000
NODE_498_length_3393_cov_43.623558	3293	3373	532	1	80	0.0125000
NODE_498_length_3393_cov_43.623558	3293	3373	549	1	80	0.0125000
NODE_498_length_3393_cov_43.623558	3293	3373	551	1	80	0.0125000
NODE_498_length_3393_cov_43.623558	3293	3373	559	2	80	0.0250000
NODE_498_length_3393_cov_43.623558	3293	3373	563	1	80	0.0125000
NODE_498_length_3393_cov_43.623558	3293	3373	565	1	80	0.0125000
NODE_498_length_3393_cov_43.623558	3293	3373	566	1	80	0.0125000
NODE_498_length_3393_cov_43.623558	3293	3373	568	1	80	0.0125000
NODE_498_length_3393_cov_43.623558	3293	3373	576	2	80	0.0250000
NODE_498_length_3393_cov_43.623558	3293	3373	578	1	80	0.0125000
NODE_498_length_3393_cov_43.623558	3293	3373	581	2	80	0.0250000
NODE_498_length_3393_cov_43.623558	3293	3373	584	1	80	0.0125000
NODE_498_length_3393_cov_43.623558	3293	3373	588	1	80	0.0125000
NODE_498_length_3393_cov_43.623558	3293	3373	592	1	80	0.0125000
NODE_498_length_3393_cov_43.623558	3293	3373	593	2	80	0.0250000
NODE_498_length_3393_cov_43.623558	3293	3373	599	1	80	0.0125000
NODE_498_length_3393_cov_43.623558	3293	3373	602	1	80	0.0125000
NODE_498_length_3393_cov_43.623558	3293	3373	619	2	80	0.0250000
NODE_498_length_3393_cov_43.623558	3293	3373	622	2	80	0.0250000
NODE_498_length_3393_cov_43.623558	3293	3373	627	1	80	0.0125000
NODE_498_length_3393_cov_43.623558	3293	3373	640	1	80	0.0125000
NODE_498_length_3393_cov_43.623558	3293	3373	644	1	80	0.0125000
NODE_498_length_3393_cov_43.623558	3293	3373	652	1	80	0.0125000
NODE_498_length_3393_cov_43.623558	3293	3373	654	1	80	0.0125000
NODE_498_length_3393_cov_43.623558	3293	3373	663	1	80	0.0125000
NODE_498_length_3393_cov_43.623558	3293	3373	667	1	80	0.0125000
NODE_498_length_3393_cov_43.623558	3293	3373	671	1	80	0.0125000
NODE_498_length_3393_cov_43.623558	3293	3373	673	1	80	0.0125000
NODE_498_length_3393_cov_43.623558	3293	3373	675	1	80	0.0125000
NODE_498_length_3393_cov_43.623558	3293	3373	686	1	80	0.0125000
NODE_498_length_3393_cov_43.623558	3293	3373	694	1	80	0.0125000
NODE_498_length_3393_cov_43.623558	3293	3373	696	1	80	0.0125000
NODE_498_length_3393_cov_43.623558	3293	3373	701	1	80	0.0125000
NODE_498_length_3393_cov_43.623558	3293	3373	703	1	80	0.0125000
NODE_498_length_3393_cov_43.623558	3293	3373	706	1	80	0.0125000
NODE_498_length_3393_cov_43.623558	3293	3373	708	1	80	0.0125000
NODE_498_length_3393_cov_43.623558	3293	3373	710	1	80	0.0125000
NODE_499_length_3392_cov_41.514728	255	335	0	80	80	1.0000000
NODE_499_length_3392_cov_41.514728	308	388	0	80	80	1.0000000
NODE_499_length_3392_cov_41.514728	917	997	238	1	80	0.0125000
NODE_499_length_3392_cov_41.514728	917	997	244	2	80	0.0250000
NODE_499_length_3392_cov_41.514728	917	997	253	1	80	0.0125000
NODE_499_length_3392_cov_41.514728	917	997	268	1	80	0.0125000
NODE_499_length_3392_cov_41.514728	917	997	270	1	80	0.0125000
NODE_499_length_3392_cov_41.514728	917	997	272	1	80	0.0125000
NODE_499_length_3392_cov_41.514728	917	997	277	1	80	0.0125000
NODE_499_length_3392_cov_41.514728	917	997	278	1	80	0.0125000
NODE_499_length_3392_cov_41.514728	917	997	280	1	80	0.0125000
NODE_499_length_3392_cov_41.514728	917	997	289	1	80	0.0125000
NODE_499_length_3392_cov_41.514728	917	997	296	1	80	0.0125000
NODE_499_length_3392_cov_41.514728	917	997	308	1	80	0.0125000
NODE_499_length_3392_cov_41.514728	917	997	315	1	80	0.0125000
NODE_499_length_3392_cov_41.514728	917	997	328	1	80	0.0125000
NODE_499_length_3392_cov_41.514728	917	997	341	1	80	0.0125000
NODE_499_length_3392_cov_41.514728	917	997	345	1	80	0.0125000
NODE_499_length_3392_cov_41.514728	917	997	369	1	80	0.0125000
NODE_499_length_3392_cov_41.514728	917	997	376	1	80	0.0125000
NODE_499_length_3392_cov_41.514728	917	997	401	1	80	0.0125000
NODE_499_length_3392_cov_41.514728	917	997	419	1	80	0.0125000
NODE_499_length_3392_cov_41.514728	917	997	427	1	80	0.0125000
NODE_499_length_3392_cov_41.514728	917	997	430	1	80	0.0125000
NODE_499_length_3392_cov_41.514728	917	997	433	1	80	0.0125000
NODE_499_length_3392_cov_41.514728	917	997	442	2	80	0.0250000
NODE_499_length_3392_cov_41.514728	917	997	444	1	80	0.0125000
NODE_499_length_3392_cov_41.514728	917	997	448	1	80	0.0125000
NODE_499_length_3392_cov_41.514728	917	997	458	1	80	0.0125000
NODE_499_length_3392_cov_41.514728	917	997	462	1	80	0.0125000
NODE_499_length_3392_cov_41.514728	917	997	469	1	80	0.0125000
NODE_499_length_3392_cov_41.514728	917	997	470	1	80	0.0125000
NODE_499_length_3392_cov_41.514728	917	997	488	1	80	0.0125000
NODE_499_length_3392_cov_41.514728	917	997	496	1	80	0.0125000
NODE_499_length_3392_cov_41.514728	917	997	516	1	80	0.0125000
NODE_499_length_3392_cov_41.514728	917	997	520	1	80	0.0125000
NODE_499_length_3392_cov_41.514728	917	997	540	1	80	0.0125000
NODE_499_length_3392_cov_41.514728	917	997	541	1	80	0.0125000
NODE_499_length_3392_cov_41.514728	917	997	543	1	80	0.0125000
NODE_499_length_3392_cov_41.514728	917	997	551	1	80	0.0125000
NODE_499_length_3392_cov_41.514728	917	997	560	1	80	0.0125000
NODE_499_length_3392_cov_41.514728	917	997	561	2	80	0.0250000
NODE_499_length_3392_cov_41.514728	917	997	562	1	80	0.0125000
NODE_499_length_3392_cov_41.514728	917	997	564	1	80	0.0125000
NODE_499_length_3392_cov_41.514728	917	997	566	1	80	0.0125000
NODE_499_length_3392_cov_41.514728	917	997	578	1	80	0.0125000
NODE_499_length_3392_cov_41.514728	917	997	579	1	80	0.0125000
NODE_499_length_3392_cov_41.514728	917	997	586	1	80	0.0125000
NODE_499_length_3392_cov_41.514728	917	997	591	2	80	0.0250000
NODE_499_length_3392_cov_41.514728	917	997	602	1	80	0.0125000
NODE_499_length_3392_cov_41.514728	917	997	610	1	80	0.0125000
NODE_499_length_3392_cov_41.514728	917	997	611	1	80	0.0125000
NODE_499_length_3392_cov_41.514728	917	997	617	1	80	0.0125000
NODE_499_length_3392_cov_41.514728	917	997	632	1	80	0.0125000
NODE_499_length_3392_cov_41.514728	917	997	634	1	80	0.0125000
NODE_499_length_3392_cov_41.514728	917	997	640	1	80	0.0125000
NODE_499_length_3392_cov_41.514728	917	997	646	1	80	0.0125000
NODE_499_length_3392_cov_41.514728	917	997	653	1	80	0.0125000
NODE_499_length_3392_cov_41.514728	917	997	666	1	80	0.0125000
NODE_499_length_3392_cov_41.514728	917	997	673	1	80	0.0125000
NODE_499_length_3392_cov_41.514728	917	997	677	1	80	0.0125000
NODE_499_length_3392_cov_41.514728	917	997	693	2	80	0.0250000
NODE_499_length_3392_cov_41.514728	917	997	695	1	80	0.0125000
NODE_499_length_3392_cov_41.514728	917	997	699	1	80	0.0125000
NODE_499_length_3392_cov_41.514728	917	997	711	1	80	0.0125000
NODE_499_length_3392_cov_41.514728	917	997	712	1	80	0.0125000
NODE_499_length_3392_cov_41.514728	917	997	713	2	80	0.0250000
NODE_499_length_3392_cov_41.514728	917	997	715	1	80	0.0125000
NODE_499_length_3392_cov_41.514728	917	997	717	3	80	0.0375000
NODE_499_length_3392_cov_41.514728	917	997	721	1	80	0.0125000
NODE_499_length_3392_cov_41.514728	917	997	724	1	80	0.0125000
NODE_499_length_3392_cov_41.514728	917	997	725	3	80	0.0375000
NODE_499_length_3392_cov_41.514728	970	1053	114	1	83	0.0120482
NODE_499_length_3392_cov_41.514728	970	1053	115	1	83	0.0120482
NODE_499_length_3392_cov_41.514728	970	1053	122	1	83	0.0120482
NODE_499_length_3392_cov_41.514728	970	1053	124	2	83	0.0240964
NODE_499_length_3392_cov_41.514728	970	1053	128	1	83	0.0120482
NODE_499_length_3392_cov_41.514728	970	1053	135	1	83	0.0120482
NODE_499_length_3392_cov_41.514728	970	1053	139	1	83	0.0120482
NODE_499_length_3392_cov_41.514728	970	1053	141	1	83	0.0120482
NODE_499_length_3392_cov_41.514728	970	1053	142	3	83	0.0361446
NODE_499_length_3392_cov_41.514728	970	1053	148	1	83	0.0120482
NODE_499_length_3392_cov_41.514728	970	1053	149	1	83	0.0120482
NODE_499_length_3392_cov_41.514728	970	1053	151	2	83	0.0240964
NODE_499_length_3392_cov_41.514728	970	1053	153	2	83	0.0240964
NODE_499_length_3392_cov_41.514728	970	1053	155	5	83	0.0602410
NODE_499_length_3392_cov_41.514728	970	1053	156	2	83	0.0240964
NODE_499_length_3392_cov_41.514728	970	1053	157	1	83	0.0120482
NODE_499_length_3392_cov_41.514728	970	1053	159	1	83	0.0120482
NODE_499_length_3392_cov_41.514728	970	1053	161	1	83	0.0120482
NODE_499_length_3392_cov_41.514728	970	1053	163	1	83	0.0120482
NODE_499_length_3392_cov_41.514728	970	1053	165	1	83	0.0120482
NODE_499_length_3392_cov_41.514728	970	1053	166	1	83	0.0120482
NODE_499_length_3392_cov_41.514728	970	1053	169	1	83	0.0120482
NODE_499_length_3392_cov_41.514728	970	1053	171	2	83	0.0240964
NODE_499_length_3392_cov_41.514728	970	1053	176	1	83	0.0120482
NODE_499_length_3392_cov_41.514728	970	1053	182	1	83	0.0120482
NODE_499_length_3392_cov_41.514728	970	1053	183	1	83	0.0120482
NODE_499_length_3392_cov_41.514728	970	1053	186	1	83	0.0120482
NODE_499_length_3392_cov_41.514728	970	1053	191	2	83	0.0240964
NODE_499_length_3392_cov_41.514728	970	1053	192	3	83	0.0361446
NODE_499_length_3392_cov_41.514728	970	1053	195	1	83	0.0120482
NODE_499_length_3392_cov_41.514728	970	1053	199	1	83	0.0120482
NODE_499_length_3392_cov_41.514728	970	1053	206	1	83	0.0120482
NODE_499_length_3392_cov_41.514728	970	1053	208	1	83	0.0120482
NODE_499_length_3392_cov_41.514728	970	1053	214	3	83	0.0361446
NODE_499_length_3392_cov_41.514728	970	1053	217	2	83	0.0240964
NODE_499_length_3392_cov_41.514728	970	1053	220	1	83	0.0120482
NODE_499_length_3392_cov_41.514728	970	1053	222	1	83	0.0120482
NODE_499_length_3392_cov_41.514728	970	1053	234	1	83	0.0120482
NODE_499_length_3392_cov_41.514728	970	1053	235	1	83	0.0120482
NODE_499_length_3392_cov_41.514728	970	1053	238	1	83	0.0120482
NODE_499_length_3392_cov_41.514728	970	1053	244	2	83	0.0240964
NODE_499_length_3392_cov_41.514728	970	1053	253	1	83	0.0120482
NODE_499_length_3392_cov_41.514728	970	1053	268	1	83	0.0120482
NODE_499_length_3392_cov_41.514728	970	1053	270	1	83	0.0120482
NODE_499_length_3392_cov_41.514728	970	1053	272	1	83	0.0120482
NODE_499_length_3392_cov_41.514728	970	1053	277	1	83	0.0120482
NODE_499_length_3392_cov_41.514728	970	1053	278	1	83	0.0120482
NODE_499_length_3392_cov_41.514728	970	1053	280	1	83	0.0120482
NODE_499_length_3392_cov_41.514728	970	1053	289	1	83	0.0120482
NODE_499_length_3392_cov_41.514728	970	1053	296	1	83	0.0120482
NODE_499_length_3392_cov_41.514728	970	1053	308	1	83	0.0120482
NODE_499_length_3392_cov_41.514728	970	1053	315	1	83	0.0120482
NODE_499_length_3392_cov_41.514728	970	1053	328	1	83	0.0120482
NODE_499_length_3392_cov_41.514728	970	1053	341	1	83	0.0120482
NODE_499_length_3392_cov_41.514728	970	1053	345	1	83	0.0120482
NODE_499_length_3392_cov_41.514728	970	1053	369	1	83	0.0120482
NODE_499_length_3392_cov_41.514728	970	1053	376	1	83	0.0120482
NODE_499_length_3392_cov_41.514728	970	1053	401	1	83	0.0120482
NODE_499_length_3392_cov_41.514728	970	1053	419	1	83	0.0120482
NODE_499_length_3392_cov_41.514728	970	1053	427	1	83	0.0120482
NODE_499_length_3392_cov_41.514728	970	1053	430	1	83	0.0120482
NODE_499_length_3392_cov_41.514728	970	1053	433	1	83	0.0120482
NODE_499_length_3392_cov_41.514728	970	1053	442	2	83	0.0240964
NODE_499_length_3392_cov_41.514728	970	1053	444	1	83	0.0120482
NODE_501_length_3389_cov_8.244073	2159	2239	0	80	80	1.0000000
NODE_501_length_3389_cov_8.244073	2212	2292	0	80	80	1.0000000
NODE_506_length_3363_cov_4.412684	56	124	16	2	68	0.0294118
NODE_506_length_3363_cov_4.412684	56	124	20	1	68	0.0147059
NODE_506_length_3363_cov_4.412684	56	124	28	1	68	0.0147059
NODE_506_length_3363_cov_4.412684	56	124	34	1	68	0.0147059
NODE_506_length_3363_cov_4.412684	56	124	36	2	68	0.0294118
NODE_506_length_3363_cov_4.412684	56	124	38	2	68	0.0294118
NODE_506_length_3363_cov_4.412684	56	124	45	1	68	0.0147059
NODE_506_length_3363_cov_4.412684	56	124	50	4	68	0.0588235
NODE_506_length_3363_cov_4.412684	56	124	56	2	68	0.0294118
NODE_506_length_3363_cov_4.412684	56	124	60	52	68	0.7647059
NODE_510_length_3353_cov_2.687462	0	61	0	61	61	1.0000000
NODE_510_length_3353_cov_2.687462	0	61	0	61	61	1.0000000
NODE_510_length_3353_cov_2.687462	34	99	0	65	65	1.0000000
NODE_513_length_3348_cov_243.959372	2473	2553	516	1	80	0.0125000
NODE_513_length_3348_cov_243.959372	2473	2553	518	1	80	0.0125000
NODE_513_length_3348_cov_243.959372	2473	2553	521	1	80	0.0125000
NODE_513_length_3348_cov_243.959372	2473	2553	528	1	80	0.0125000
NODE_513_length_3348_cov_243.959372	2473	2553	537	1	80	0.0125000
NODE_513_length_3348_cov_243.959372	2473	2553	545	1	80	0.0125000
NODE_513_length_3348_cov_243.959372	2473	2553	551	1	80	0.0125000
NODE_513_length_3348_cov_243.959372	2473	2553	554	1	80	0.0125000
NODE_513_length_3348_cov_243.959372	2473	2553	559	1	80	0.0125000
NODE_513_length_3348_cov_243.959372	2473	2553	560	1	80	0.0125000
NODE_513_length_3348_cov_243.959372	2473	2553	561	1	80	0.0125000
NODE_513_length_3348_cov_243.959372	2473	2553	563	2	80	0.0250000
NODE_513_length_3348_cov_243.959372	2473	2553	564	2	80	0.0250000
NODE_513_length_3348_cov_243.959372	2473	2553	568	1	80	0.0125000
NODE_513_length_3348_cov_243.959372	2473	2553	571	1	80	0.0125000
NODE_513_length_3348_cov_243.959372	2473	2553	572	1	80	0.0125000
NODE_513_length_3348_cov_243.959372	2473	2553	573	2	80	0.0250000
NODE_513_length_3348_cov_243.959372	2473	2553	574	1	80	0.0125000
NODE_513_length_3348_cov_243.959372	2473	2553	578	1	80	0.0125000
NODE_513_length_3348_cov_243.959372	2473	2553	580	3	80	0.0375000
NODE_513_length_3348_cov_243.959372	2473	2553	581	1	80	0.0125000
NODE_513_length_3348_cov_243.959372	2473	2553	584	1	80	0.0125000
NODE_513_length_3348_cov_243.959372	2473	2553	588	1	80	0.0125000
NODE_513_length_3348_cov_243.959372	2473	2553	590	3	80	0.0375000
NODE_513_length_3348_cov_243.959372	2473	2553	597	1	80	0.0125000
NODE_513_length_3348_cov_243.959372	2473	2553	601	1	80	0.0125000
NODE_513_length_3348_cov_243.959372	2473	2553	608	1	80	0.0125000
NODE_513_length_3348_cov_243.959372	2473	2553	610	1	80	0.0125000
NODE_513_length_3348_cov_243.959372	2473	2553	614	1	80	0.0125000
NODE_513_length_3348_cov_243.959372	2473	2553	615	1	80	0.0125000
NODE_513_length_3348_cov_243.959372	2473	2553	616	2	80	0.0250000
NODE_513_length_3348_cov_243.959372	2473	2553	618	1	80	0.0125000
NODE_513_length_3348_cov_243.959372	2473	2553	624	2	80	0.0250000
NODE_513_length_3348_cov_243.959372	2473	2553	625	1	80	0.0125000
NODE_513_length_3348_cov_243.959372	2473	2553	627	3	80	0.0375000
NODE_513_length_3348_cov_243.959372	2473	2553	629	1	80	0.0125000
NODE_513_length_3348_cov_243.959372	2473	2553	630	1	80	0.0125000
NODE_513_length_3348_cov_243.959372	2473	2553	633	2	80	0.0250000
NODE_513_length_3348_cov_243.959372	2473	2553	635	1	80	0.0125000
NODE_513_length_3348_cov_243.959372	2473	2553	639	3	80	0.0375000
NODE_513_length_3348_cov_243.959372	2473	2553	647	2	80	0.0250000
NODE_513_length_3348_cov_243.959372	2473	2553	649	1	80	0.0125000
NODE_513_length_3348_cov_243.959372	2473	2553	654	1	80	0.0125000
NODE_513_length_3348_cov_243.959372	2473	2553	659	1	80	0.0125000
NODE_513_length_3348_cov_243.959372	2473	2553	663	1	80	0.0125000
NODE_513_length_3348_cov_243.959372	2473	2553	666	3	80	0.0375000
NODE_513_length_3348_cov_243.959372	2473	2553	672	1	80	0.0125000
NODE_513_length_3348_cov_243.959372	2473	2553	676	1	80	0.0125000
NODE_513_length_3348_cov_243.959372	2473	2553	681	1	80	0.0125000
NODE_513_length_3348_cov_243.959372	2473	2553	703	1	80	0.0125000
NODE_513_length_3348_cov_243.959372	2473	2553	718	1	80	0.0125000
NODE_513_length_3348_cov_243.959372	2473	2553	721	1	80	0.0125000
NODE_513_length_3348_cov_243.959372	2473	2553	722	1	80	0.0125000
NODE_513_length_3348_cov_243.959372	2473	2553	723	1	80	0.0125000
NODE_513_length_3348_cov_243.959372	2473	2553	724	2	80	0.0250000
NODE_513_length_3348_cov_243.959372	2473	2553	725	1	80	0.0125000
NODE_513_length_3348_cov_243.959372	2473	2553	731	1	80	0.0125000
NODE_513_length_3348_cov_243.959372	2473	2553	752	1	80	0.0125000
NODE_513_length_3348_cov_243.959372	2473	2553	753	1	80	0.0125000
NODE_513_length_3348_cov_243.959372	2473	2553	756	1	80	0.0125000
NODE_513_length_3348_cov_243.959372	2473	2553	776	1	80	0.0125000
NODE_513_length_3348_cov_243.959372	2473	2553	781	1	80	0.0125000
NODE_513_length_3348_cov_243.959372	2526	2606	528	1	80	0.0125000
NODE_513_length_3348_cov_243.959372	2526	2606	545	1	80	0.0125000
NODE_513_length_3348_cov_243.959372	2526	2606	551	1	80	0.0125000
NODE_513_length_3348_cov_243.959372	2526	2606	560	1	80	0.0125000
NODE_513_length_3348_cov_243.959372	2526	2606	561	1	80	0.0125000
NODE_513_length_3348_cov_243.959372	2526	2606	563	2	80	0.0250000
NODE_513_length_3348_cov_243.959372	2526	2606	564	1	80	0.0125000
NODE_513_length_3348_cov_243.959372	2526	2606	568	1	80	0.0125000
NODE_513_length_3348_cov_243.959372	2526	2606	573	2	80	0.0250000
NODE_513_length_3348_cov_243.959372	2526	2606	574	1	80	0.0125000
NODE_513_length_3348_cov_243.959372	2526	2606	578	1	80	0.0125000
NODE_513_length_3348_cov_243.959372	2526	2606	580	2	80	0.0250000
NODE_513_length_3348_cov_243.959372	2526	2606	588	1	80	0.0125000
NODE_513_length_3348_cov_243.959372	2526	2606	590	3	80	0.0375000
NODE_513_length_3348_cov_243.959372	2526	2606	597	1	80	0.0125000
NODE_513_length_3348_cov_243.959372	2526	2606	610	1	80	0.0125000
NODE_513_length_3348_cov_243.959372	2526	2606	615	1	80	0.0125000
NODE_513_length_3348_cov_243.959372	2526	2606	618	1	80	0.0125000
NODE_513_length_3348_cov_243.959372	2526	2606	629	1	80	0.0125000
NODE_513_length_3348_cov_243.959372	2526	2606	630	1	80	0.0125000
NODE_513_length_3348_cov_243.959372	2526	2606	633	1	80	0.0125000
NODE_513_length_3348_cov_243.959372	2526	2606	639	1	80	0.0125000
NODE_513_length_3348_cov_243.959372	2526	2606	643	1	80	0.0125000
NODE_513_length_3348_cov_243.959372	2526	2606	652	1	80	0.0125000
NODE_513_length_3348_cov_243.959372	2526	2606	655	1	80	0.0125000
NODE_513_length_3348_cov_243.959372	2526	2606	656	1	80	0.0125000
NODE_513_length_3348_cov_243.959372	2526	2606	658	1	80	0.0125000
NODE_513_length_3348_cov_243.959372	2526	2606	659	2	80	0.0250000
NODE_513_length_3348_cov_243.959372	2526	2606	660	1	80	0.0125000
NODE_513_length_3348_cov_243.959372	2526	2606	664	1	80	0.0125000
NODE_513_length_3348_cov_243.959372	2526	2606	667	1	80	0.0125000
NODE_513_length_3348_cov_243.959372	2526	2606	668	3	80	0.0375000
NODE_513_length_3348_cov_243.959372	2526	2606	673	1	80	0.0125000
NODE_513_length_3348_cov_243.959372	2526	2606	674	1	80	0.0125000
NODE_513_length_3348_cov_243.959372	2526	2606	675	1	80	0.0125000
NODE_513_length_3348_cov_243.959372	2526	2606	677	1	80	0.0125000
NODE_513_length_3348_cov_243.959372	2526	2606	678	4	80	0.0500000
NODE_513_length_3348_cov_243.959372	2526	2606	679	1	80	0.0125000
NODE_513_length_3348_cov_243.959372	2526	2606	680	2	80	0.0250000
NODE_513_length_3348_cov_243.959372	2526	2606	682	1	80	0.0125000
NODE_513_length_3348_cov_243.959372	2526	2606	683	1	80	0.0125000
NODE_513_length_3348_cov_243.959372	2526	2606	684	1	80	0.0125000
NODE_513_length_3348_cov_243.959372	2526	2606	685	1	80	0.0125000
NODE_513_length_3348_cov_243.959372	2526	2606	687	1	80	0.0125000
NODE_513_length_3348_cov_243.959372	2526	2606	688	1	80	0.0125000
NODE_513_length_3348_cov_243.959372	2526	2606	691	2	80	0.0250000
NODE_513_length_3348_cov_243.959372	2526	2606	692	1	80	0.0125000
NODE_513_length_3348_cov_243.959372	2526	2606	695	2	80	0.0250000
NODE_513_length_3348_cov_243.959372	2526	2606	696	2	80	0.0250000
NODE_513_length_3348_cov_243.959372	2526	2606	698	4	80	0.0500000
NODE_513_length_3348_cov_243.959372	2526	2606	699	1	80	0.0125000
NODE_513_length_3348_cov_243.959372	2526	2606	701	1	80	0.0125000
NODE_513_length_3348_cov_243.959372	2526	2606	702	1	80	0.0125000
NODE_513_length_3348_cov_243.959372	2526	2606	704	1	80	0.0125000
NODE_513_length_3348_cov_243.959372	2526	2606	708	1	80	0.0125000
NODE_513_length_3348_cov_243.959372	2526	2606	709	2	80	0.0250000
NODE_513_length_3348_cov_243.959372	2526	2606	711	1	80	0.0125000
NODE_513_length_3348_cov_243.959372	2526	2606	713	2	80	0.0250000
NODE_513_length_3348_cov_243.959372	2526	2606	714	1	80	0.0125000
NODE_513_length_3348_cov_243.959372	2526	2606	717	1	80	0.0125000
NODE_514_length_3348_cov_31.953216	103	183	0	80	80	1.0000000
NODE_514_length_3348_cov_31.953216	105	179	0	74	74	1.0000000
NODE_514_length_3348_cov_31.953216	156	236	0	80	80	1.0000000
NODE_514_length_3348_cov_31.953216	156	236	0	80	80	1.0000000
NODE_514_length_3348_cov_31.953216	2405	2476	115	3	71	0.0422535
NODE_514_length_3348_cov_31.953216	2405	2476	116	2	71	0.0281690
NODE_514_length_3348_cov_31.953216	2405	2476	117	1	71	0.0140845
NODE_514_length_3348_cov_31.953216	2405	2476	118	2	71	0.0281690
NODE_514_length_3348_cov_31.953216	2405	2476	120	1	71	0.0140845
NODE_514_length_3348_cov_31.953216	2405	2476	122	1	71	0.0140845
NODE_514_length_3348_cov_31.953216	2405	2476	125	1	71	0.0140845
NODE_514_length_3348_cov_31.953216	2405	2476	128	4	71	0.0563380
NODE_514_length_3348_cov_31.953216	2405	2476	132	1	71	0.0140845
NODE_514_length_3348_cov_31.953216	2405	2476	135	2	71	0.0281690
NODE_514_length_3348_cov_31.953216	2405	2476	136	3	71	0.0422535
NODE_514_length_3348_cov_31.953216	2405	2476	138	1	71	0.0140845
NODE_514_length_3348_cov_31.953216	2405	2476	140	2	71	0.0281690
NODE_514_length_3348_cov_31.953216	2405	2476	142	3	71	0.0422535
NODE_514_length_3348_cov_31.953216	2405	2476	144	3	71	0.0422535
NODE_514_length_3348_cov_31.953216	2405	2476	146	1	71	0.0140845
NODE_514_length_3348_cov_31.953216	2405	2476	148	4	71	0.0563380
NODE_514_length_3348_cov_31.953216	2405	2476	149	1	71	0.0140845
NODE_514_length_3348_cov_31.953216	2405	2476	150	3	71	0.0422535
NODE_514_length_3348_cov_31.953216	2405	2476	151	1	71	0.0140845
NODE_514_length_3348_cov_31.953216	2405	2476	152	1	71	0.0140845
NODE_514_length_3348_cov_31.953216	2405	2476	153	1	71	0.0140845
NODE_514_length_3348_cov_31.953216	2405	2476	154	1	71	0.0140845
NODE_514_length_3348_cov_31.953216	2405	2476	155	1	71	0.0140845
NODE_514_length_3348_cov_31.953216	2405	2476	156	2	71	0.0281690
NODE_514_length_3348_cov_31.953216	2405	2476	157	2	71	0.0281690
NODE_514_length_3348_cov_31.953216	2405	2476	158	6	71	0.0845070
NODE_514_length_3348_cov_31.953216	2405	2476	160	4	71	0.0563380
NODE_514_length_3348_cov_31.953216	2405	2476	161	1	71	0.0140845
NODE_514_length_3348_cov_31.953216	2405	2476	162	3	71	0.0422535
NODE_514_length_3348_cov_31.953216	2405	2476	164	1	71	0.0140845
NODE_514_length_3348_cov_31.953216	2405	2476	170	1	71	0.0140845
NODE_514_length_3348_cov_31.953216	2405	2476	172	1	71	0.0140845
NODE_514_length_3348_cov_31.953216	2405	2476	174	1	71	0.0140845
NODE_514_length_3348_cov_31.953216	2405	2476	178	1	71	0.0140845
NODE_514_length_3348_cov_31.953216	2405	2476	180	1	71	0.0140845
NODE_514_length_3348_cov_31.953216	2405	2476	186	1	71	0.0140845
NODE_514_length_3348_cov_31.953216	2405	2476	190	1	71	0.0140845
NODE_514_length_3348_cov_31.953216	2405	2476	194	1	71	0.0140845
NODE_514_length_3348_cov_31.953216	2458	2529	158	2	71	0.0281690
NODE_514_length_3348_cov_31.953216	2458	2529	160	3	71	0.0422535
NODE_514_length_3348_cov_31.953216	2458	2529	161	1	71	0.0140845
NODE_514_length_3348_cov_31.953216	2458	2529	162	3	71	0.0422535
NODE_514_length_3348_cov_31.953216	2458	2529	164	1	71	0.0140845
NODE_514_length_3348_cov_31.953216	2458	2529	170	1	71	0.0140845
NODE_514_length_3348_cov_31.953216	2458	2529	172	1	71	0.0140845
NODE_514_length_3348_cov_31.953216	2458	2529	174	1	71	0.0140845
NODE_514_length_3348_cov_31.953216	2458	2529	178	1	71	0.0140845
NODE_514_length_3348_cov_31.953216	2458	2529	180	1	71	0.0140845
NODE_514_length_3348_cov_31.953216	2458	2529	186	1	71	0.0140845
NODE_514_length_3348_cov_31.953216	2458	2529	190	1	71	0.0140845
NODE_514_length_3348_cov_31.953216	2458	2529	194	1	71	0.0140845
NODE_514_length_3348_cov_31.953216	2458	2529	198	1	71	0.0140845
NODE_514_length_3348_cov_31.953216	2458	2529	200	1	71	0.0140845
NODE_514_length_3348_cov_31.953216	2458	2529	204	1	71	0.0140845
NODE_514_length_3348_cov_31.953216	2458	2529	208	2	71	0.0281690
NODE_514_length_3348_cov_31.953216	2458	2529	210	2	71	0.0281690
NODE_514_length_3348_cov_31.953216	2458	2529	211	1	71	0.0140845
NODE_514_length_3348_cov_31.953216	2458	2529	212	4	71	0.0563380
NODE_514_length_3348_cov_31.953216	2458	2529	213	1	71	0.0140845
NODE_514_length_3348_cov_31.953216	2458	2529	214	4	71	0.0563380
NODE_514_length_3348_cov_31.953216	2458	2529	215	2	71	0.0281690
NODE_514_length_3348_cov_31.953216	2458	2529	216	10	71	0.1408451
NODE_514_length_3348_cov_31.953216	2458	2529	217	4	71	0.0563380
NODE_514_length_3348_cov_31.953216	2458	2529	218	12	71	0.1690141
NODE_514_length_3348_cov_31.953216	2458	2529	219	3	71	0.0422535
NODE_514_length_3348_cov_31.953216	2458	2529	220	4	71	0.0563380
NODE_514_length_3348_cov_31.953216	2458	2529	222	1	71	0.0140845
NODE_517_length_3335_cov_19.649567	2100	2180	6	19	80	0.2375000
NODE_517_length_3335_cov_19.649567	2100	2180	8	27	80	0.3375000
NODE_517_length_3335_cov_19.649567	2100	2180	10	31	80	0.3875000
NODE_517_length_3335_cov_19.649567	2100	2180	12	3	80	0.0375000
NODE_517_length_3335_cov_19.649567	2153	2233	4	21	80	0.2625000
NODE_517_length_3335_cov_19.649567	2153	2233	6	15	80	0.1875000
NODE_517_length_3335_cov_19.649567	2153	2233	8	44	80	0.5500000
NODE_517_length_3335_cov_19.649567	2229	2309	0	62	80	0.7750000
NODE_517_length_3335_cov_19.649567	2229	2309	4	18	80	0.2250000
NODE_517_length_3335_cov_19.649567	2282	2362	0	37	80	0.4625000
NODE_517_length_3335_cov_19.649567	2282	2362	2	43	80	0.5375000
NODE_518_length_3333_cov_24.805504	734	814	2	25	80	0.3125000
NODE_518_length_3333_cov_24.805504	734	814	4	18	80	0.2250000
NODE_518_length_3333_cov_24.805504	734	814	8	1	80	0.0125000
NODE_518_length_3333_cov_24.805504	734	814	10	27	80	0.3375000
NODE_518_length_3333_cov_24.805504	734	814	12	9	80	0.1125000
NODE_518_length_3333_cov_24.805504	787	867	10	66	80	0.8250000
NODE_518_length_3333_cov_24.805504	787	867	12	14	80	0.1750000
NODE_523_length_3312_cov_6.996576	85	165	12	10	80	0.1250000
NODE_523_length_3312_cov_6.996576	85	165	16	14	80	0.1750000
NODE_523_length_3312_cov_6.996576	85	165	18	11	80	0.1375000
NODE_523_length_3312_cov_6.996576	85	165	21	38	80	0.4750000
NODE_523_length_3312_cov_6.996576	85	165	25	7	80	0.0875000
NODE_523_length_3312_cov_6.996576	138	218	21	20	80	0.2500000
NODE_523_length_3312_cov_6.996576	138	218	23	2	80	0.0250000
NODE_523_length_3312_cov_6.996576	138	218	24	15	80	0.1875000
NODE_523_length_3312_cov_6.996576	138	218	25	43	80	0.5375000
NODE_525_length_3302_cov_3.859195	3184	3262	0	7	78	0.0897436
NODE_525_length_3302_cov_3.859195	3184	3262	2	50	78	0.6410257
NODE_525_length_3302_cov_3.859195	3184	3262	4	5	78	0.0641026
NODE_525_length_3302_cov_3.859195	3184	3262	6	16	78	0.2051282
NODE_525_length_3302_cov_3.859195	3184	3253	2	48	69	0.6956522
NODE_525_length_3302_cov_3.859195	3184	3253	4	5	69	0.0724638
NODE_525_length_3302_cov_3.859195	3184	3253	6	16	69	0.2318841
NODE_526_length_3299_cov_6.014687	1632	1688	0	7	56	0.1250000
NODE_526_length_3299_cov_6.014687	1632	1688	2	18	56	0.3214286
NODE_526_length_3299_cov_6.014687	1632	1688	4	7	56	0.1250000
NODE_526_length_3299_cov_6.014687	1632	1688	6	24	56	0.4285714
NODE_530_length_3290_cov_17.805390	773	853	7	10	80	0.1250000
NODE_530_length_3290_cov_17.805390	773	853	9	2	80	0.0250000
NODE_530_length_3290_cov_17.805390	773	853	15	1	80	0.0125000
NODE_530_length_3290_cov_17.805390	773	853	16	14	80	0.1750000
NODE_530_length_3290_cov_17.805390	773	853	17	2	80	0.0250000
NODE_530_length_3290_cov_17.805390	773	853	18	27	80	0.3375000
NODE_530_length_3290_cov_17.805390	773	853	19	8	80	0.1000000
NODE_530_length_3290_cov_17.805390	773	853	20	16	80	0.2000000
NODE_530_length_3290_cov_17.805390	826	906	4	4	80	0.0500000
NODE_530_length_3290_cov_17.805390	826	906	11	7	80	0.0875000
NODE_530_length_3290_cov_17.805390	826	906	14	10	80	0.1250000
NODE_530_length_3290_cov_17.805390	826	906	16	4	80	0.0500000
NODE_530_length_3290_cov_17.805390	826	906	18	34	80	0.4250000
NODE_530_length_3290_cov_17.805390	826	906	19	5	80	0.0625000
NODE_530_length_3290_cov_17.805390	826	906	20	16	80	0.2000000
NODE_531_length_3290_cov_12.352554	2749	2829	0	80	80	1.0000000
NODE_531_length_3290_cov_12.352554	2802	2882	0	80	80	1.0000000
NODE_532_length_3286_cov_5.973015	0	50	0	50	50	1.0000000
NODE_532_length_3286_cov_5.973015	0	50	0	50	50	1.0000000
NODE_532_length_3286_cov_5.973015	0	50	0	50	50	1.0000000
NODE_532_length_3286_cov_5.973015	23	89	0	66	66	1.0000000
NODE_532_length_3286_cov_5.973015	23	94	0	71	71	1.0000000
NODE_533_length_3284_cov_6.453689	313	392	2	2	79	0.0253165
NODE_533_length_3284_cov_6.453689	313	392	4	1	79	0.0126582
NODE_533_length_3284_cov_6.453689	313	392	6	48	79	0.6075949
NODE_533_length_3284_cov_6.453689	313	392	8	28	79	0.3544304
NODE_533_length_3284_cov_6.453689	365	445	2	51	80	0.6375000
NODE_533_length_3284_cov_6.453689	365	445	4	4	80	0.0500000
NODE_533_length_3284_cov_6.453689	365	445	6	25	80	0.3125000
NODE_541_length_3267_cov_12.768624	11	91	12	12	80	0.1500000
NODE_541_length_3267_cov_12.768624	11	91	14	6	80	0.0750000
NODE_541_length_3267_cov_12.768624	11	91	17	1	80	0.0125000
NODE_541_length_3267_cov_12.768624	11	91	21	2	80	0.0250000
NODE_541_length_3267_cov_12.768624	11	91	23	14	80	0.1750000
NODE_541_length_3267_cov_12.768624	11	91	25	5	80	0.0625000
NODE_541_length_3267_cov_12.768624	11	91	31	9	80	0.1125000
NODE_541_length_3267_cov_12.768624	11	91	33	31	80	0.3875000
NODE_542_length_3266_cov_14.108304	2620	2684	12	27	64	0.4218750
NODE_542_length_3266_cov_14.108304	2620	2684	14	26	64	0.4062500
NODE_542_length_3266_cov_14.108304	2620	2684	16	11	64	0.1718750
NODE_542_length_3266_cov_14.108304	2620	2684	12	27	64	0.4218750
NODE_542_length_3266_cov_14.108304	2620	2684	14	26	64	0.4062500
NODE_542_length_3266_cov_14.108304	2620	2684	16	11	64	0.1718750
NODE_542_length_3266_cov_14.108304	2620	2684	12	27	64	0.4218750
NODE_542_length_3266_cov_14.108304	2620	2684	14	26	64	0.4062500
NODE_542_length_3266_cov_14.108304	2620	2684	16	11	64	0.1718750
NODE_547_length_3242_cov_12.407891	391	471	2	80	80	1.0000000
NODE_547_length_3242_cov_12.407891	444	524	0	51	80	0.6375000
NODE_547_length_3242_cov_12.407891	444	524	2	29	80	0.3625000
NODE_550_length_3233_cov_19.903957	411	491	0	80	80	1.0000000
NODE_550_length_3233_cov_19.903957	411	491	0	80	80	1.0000000
NODE_550_length_3233_cov_19.903957	464	544	0	80	80	1.0000000
NODE_552_length_3232_cov_11.378870	2586	2621	0	35	35	1.0000000
NODE_555_length_3214_cov_22.853291	2090	2170	46	4	80	0.0500000
NODE_555_length_3214_cov_22.853291	2090	2170	47	7	80	0.0875000
NODE_555_length_3214_cov_22.853291	2090	2170	48	5	80	0.0625000
NODE_555_length_3214_cov_22.853291	2090	2170	49	4	80	0.0500000
NODE_555_length_3214_cov_22.853291	2090	2170	52	1	80	0.0125000
NODE_555_length_3214_cov_22.853291	2090	2170	53	1	80	0.0125000
NODE_555_length_3214_cov_22.853291	2090	2170	56	1	80	0.0125000
NODE_555_length_3214_cov_22.853291	2090	2170	58	2	80	0.0250000
NODE_555_length_3214_cov_22.853291	2090	2170	61	3	80	0.0375000
NODE_555_length_3214_cov_22.853291	2090	2170	63	8	80	0.1000000
NODE_555_length_3214_cov_22.853291	2090	2170	65	1	80	0.0125000
NODE_555_length_3214_cov_22.853291	2090	2170	67	2	80	0.0250000
NODE_555_length_3214_cov_22.853291	2090	2170	68	1	80	0.0125000
NODE_555_length_3214_cov_22.853291	2090	2170	69	1	80	0.0125000
NODE_555_length_3214_cov_22.853291	2090	2170	70	1	80	0.0125000
NODE_555_length_3214_cov_22.853291	2090	2170	71	3	80	0.0375000
NODE_555_length_3214_cov_22.853291	2090	2170	73	5	80	0.0625000
NODE_555_length_3214_cov_22.853291	2090	2170	74	4	80	0.0500000
NODE_555_length_3214_cov_22.853291	2090	2170	75	6	80	0.0750000
NODE_555_length_3214_cov_22.853291	2090	2170	76	2	80	0.0250000
NODE_555_length_3214_cov_22.853291	2090	2170	77	6	80	0.0750000
NODE_555_length_3214_cov_22.853291	2090	2170	78	3	80	0.0375000
NODE_555_length_3214_cov_22.853291	2090	2170	79	2	80	0.0250000
NODE_555_length_3214_cov_22.853291	2090	2170	81	2	80	0.0250000
NODE_555_length_3214_cov_22.853291	2090	2170	83	5	80	0.0625000
NODE_555_length_3214_cov_22.853291	2143	2223	67	8	80	0.1000000
NODE_555_length_3214_cov_22.853291	2143	2223	68	1	80	0.0125000
NODE_555_length_3214_cov_22.853291	2143	2223	69	3	80	0.0375000
NODE_555_length_3214_cov_22.853291	2143	2223	72	1	80	0.0125000
NODE_555_length_3214_cov_22.853291	2143	2223	73	3	80	0.0375000
NODE_555_length_3214_cov_22.853291	2143	2223	74	2	80	0.0250000
NODE_555_length_3214_cov_22.853291	2143	2223	75	6	80	0.0750000
NODE_555_length_3214_cov_22.853291	2143	2223	76	2	80	0.0250000
NODE_555_length_3214_cov_22.853291	2143	2223	77	14	80	0.1750000
NODE_555_length_3214_cov_22.853291	2143	2223	78	1	80	0.0125000
NODE_555_length_3214_cov_22.853291	2143	2223	79	7	80	0.0875000
NODE_555_length_3214_cov_22.853291	2143	2223	80	10	80	0.1250000
NODE_555_length_3214_cov_22.853291	2143	2223	81	6	80	0.0750000
NODE_555_length_3214_cov_22.853291	2143	2223	82	2	80	0.0250000
NODE_555_length_3214_cov_22.853291	2143	2223	83	9	80	0.1125000
NODE_555_length_3214_cov_22.853291	2143	2223	86	5	80	0.0625000
NODE_555_length_3214_cov_22.853291	3028	3086	39	3	58	0.0517241
NODE_555_length_3214_cov_22.853291	3028	3086	41	1	58	0.0172414
NODE_555_length_3214_cov_22.853291	3028	3086	43	5	58	0.0862069
NODE_555_length_3214_cov_22.853291	3028	3086	45	8	58	0.1379310
NODE_555_length_3214_cov_22.853291	3028	3086	47	1	58	0.0172414
NODE_555_length_3214_cov_22.853291	3028	3086	48	4	58	0.0689655
NODE_555_length_3214_cov_22.853291	3028	3086	50	2	58	0.0344828
NODE_555_length_3214_cov_22.853291	3028	3086	51	2	58	0.0344828
NODE_555_length_3214_cov_22.853291	3028	3086	53	2	58	0.0344828
NODE_555_length_3214_cov_22.853291	3028	3086	55	2	58	0.0344828
NODE_555_length_3214_cov_22.853291	3028	3086	57	2	58	0.0344828
NODE_555_length_3214_cov_22.853291	3028	3086	59	1	58	0.0172414
NODE_555_length_3214_cov_22.853291	3028	3086	62	7	58	0.1206897
NODE_555_length_3214_cov_22.853291	3028	3086	63	1	58	0.0172414
NODE_555_length_3214_cov_22.853291	3028	3086	64	2	58	0.0344828
NODE_555_length_3214_cov_22.853291	3028	3086	68	5	58	0.0862069
NODE_555_length_3214_cov_22.853291	3028	3086	71	1	58	0.0172414
NODE_555_length_3214_cov_22.853291	3028	3086	72	1	58	0.0172414
NODE_555_length_3214_cov_22.853291	3028	3086	74	7	58	0.1206897
NODE_555_length_3214_cov_22.853291	3028	3086	78	1	58	0.0172414
NODE_556_length_3211_cov_1.921915	95	175	2	4	80	0.0500000
NODE_556_length_3211_cov_1.921915	95	175	4	13	80	0.1625000
NODE_556_length_3211_cov_1.921915	95	175	6	1	80	0.0125000
NODE_556_length_3211_cov_1.921915	95	175	7	3	80	0.0375000
NODE_556_length_3211_cov_1.921915	95	175	8	7	80	0.0875000
NODE_556_length_3211_cov_1.921915	95	175	12	23	80	0.2875000
NODE_556_length_3211_cov_1.921915	95	175	14	29	80	0.3625000
NODE_556_length_3211_cov_1.921915	148	178	2	4	30	0.1333333
NODE_556_length_3211_cov_1.921915	148	178	4	15	30	0.5000000
NODE_556_length_3211_cov_1.921915	148	178	5	1	30	0.0333333
NODE_556_length_3211_cov_1.921915	148	178	6	1	30	0.0333333
NODE_556_length_3211_cov_1.921915	148	178	7	3	30	0.1000000
NODE_556_length_3211_cov_1.921915	148	178	8	6	30	0.2000000
NODE_557_length_3210_cov_7.428480	2040	2111	2	18	71	0.2535211
NODE_557_length_3210_cov_7.428480	2040	2111	4	10	71	0.1408451
NODE_557_length_3210_cov_7.428480	2040	2111	14	3	71	0.0422535
NODE_557_length_3210_cov_7.428480	2040	2111	20	40	71	0.5633803
NODE_557_length_3210_cov_7.428480	2084	2164	18	33	80	0.4125000
NODE_557_length_3210_cov_7.428480	2084	2164	20	47	80	0.5875000
NODE_557_length_3210_cov_7.428480	2715	2797	0	82	82	1.0000000
NODE_557_length_3210_cov_7.428480	2770	2850	0	80	80	1.0000000
NODE_562_length_3201_cov_3.591231	3120	3200	0	80	80	1.0000000
NODE_566_length_3189_cov_69.446602	137	188	0	46	51	0.9019608
NODE_566_length_3189_cov_69.446602	137	188	2	5	51	0.0980392
NODE_567_length_3188_cov_7.233085	1663	1743	6	24	80	0.3000000
NODE_567_length_3188_cov_7.233085	1663	1743	7	17	80	0.2125000
NODE_567_length_3188_cov_7.233085	1663	1743	8	30	80	0.3750000
NODE_567_length_3188_cov_7.233085	1663	1743	9	9	80	0.1125000
NODE_567_length_3188_cov_7.233085	1716	1796	6	8	80	0.1000000
NODE_567_length_3188_cov_7.233085	1716	1796	7	19	80	0.2375000
NODE_567_length_3188_cov_7.233085	1716	1796	8	11	80	0.1375000
NODE_567_length_3188_cov_7.233085	1716	1796	9	9	80	0.1125000
NODE_567_length_3188_cov_7.233085	1716	1796	10	21	80	0.2625000
NODE_567_length_3188_cov_7.233085	1716	1796	12	12	80	0.1500000
NODE_570_length_3177_cov_2.789474	2021	2042	0	21	21	1.0000000
NODE_575_length_3158_cov_19.018960	840	920	0	8	80	0.1000000
NODE_575_length_3158_cov_19.018960	840	920	6	72	80	0.9000000
NODE_575_length_3158_cov_19.018960	893	973	0	17	80	0.2125000
NODE_575_length_3158_cov_19.018960	893	973	6	63	80	0.7875000
NODE_575_length_3158_cov_19.018960	2833	2915	4	14	82	0.1707317
NODE_575_length_3158_cov_19.018960	2833	2915	6	68	82	0.8292683
NODE_575_length_3158_cov_19.018960	2888	2959	2	11	71	0.1549296
NODE_575_length_3158_cov_19.018960	2888	2959	4	47	71	0.6619718
NODE_575_length_3158_cov_19.018960	2888	2959	6	13	71	0.1830986
NODE_576_length_3150_cov_26.520813	770	850	18	3	80	0.0375000
NODE_576_length_3150_cov_26.520813	770	850	20	3	80	0.0375000
NODE_576_length_3150_cov_26.520813	770	850	22	3	80	0.0375000
NODE_576_length_3150_cov_26.520813	770	850	24	1	80	0.0125000
NODE_576_length_3150_cov_26.520813	770	850	26	1	80	0.0125000
NODE_576_length_3150_cov_26.520813	770	850	30	7	80	0.0875000
NODE_576_length_3150_cov_26.520813	770	850	44	7	80	0.0875000
NODE_576_length_3150_cov_26.520813	770	850	48	5	80	0.0625000
NODE_576_length_3150_cov_26.520813	770	850	50	1	80	0.0125000
NODE_576_length_3150_cov_26.520813	770	850	53	1	80	0.0125000
NODE_576_length_3150_cov_26.520813	770	850	54	4	80	0.0500000
NODE_576_length_3150_cov_26.520813	770	850	55	8	80	0.1000000
NODE_576_length_3150_cov_26.520813	770	850	56	1	80	0.0125000
NODE_576_length_3150_cov_26.520813	770	850	57	1	80	0.0125000
NODE_576_length_3150_cov_26.520813	770	850	59	23	80	0.2875000
NODE_576_length_3150_cov_26.520813	770	850	63	11	80	0.1375000
NODE_576_length_3150_cov_26.520813	823	901	19	3	78	0.0384615
NODE_576_length_3150_cov_26.520813	823	901	28	1	78	0.0128205
NODE_576_length_3150_cov_26.520813	823	901	29	6	78	0.0769231
NODE_576_length_3150_cov_26.520813	823	901	31	5	78	0.0641026
NODE_576_length_3150_cov_26.520813	823	901	33	6	78	0.0769231
NODE_576_length_3150_cov_26.520813	823	901	37	3	78	0.0384615
NODE_576_length_3150_cov_26.520813	823	901	38	7	78	0.0897436
NODE_576_length_3150_cov_26.520813	823	901	40	2	78	0.0256410
NODE_576_length_3150_cov_26.520813	823	901	42	1	78	0.0128205
NODE_576_length_3150_cov_26.520813	823	901	44	4	78	0.0512821
NODE_576_length_3150_cov_26.520813	823	901	45	6	78	0.0769231
NODE_576_length_3150_cov_26.520813	823	901	47	2	78	0.0256410
NODE_576_length_3150_cov_26.520813	823	901	51	4	78	0.0512821
NODE_576_length_3150_cov_26.520813	823	901	53	2	78	0.0256410
NODE_576_length_3150_cov_26.520813	823	901	55	8	78	0.1025641
NODE_576_length_3150_cov_26.520813	823	901	56	1	78	0.0128205
NODE_576_length_3150_cov_26.520813	823	901	57	1	78	0.0128205
NODE_576_length_3150_cov_26.520813	823	901	59	16	78	0.2051282
NODE_576_length_3150_cov_26.520813	2616	2696	0	36	80	0.4500000
NODE_576_length_3150_cov_26.520813	2616	2696	4	44	80	0.5500000
NODE_576_length_3150_cov_26.520813	2669	2749	2	25	80	0.3125000
NODE_576_length_3150_cov_26.520813	2669	2749	4	55	80	0.6875000
NODE_577_length_3150_cov_5.923959	2313	2393	6	6	80	0.0750000
NODE_577_length_3150_cov_5.923959	2313	2393	8	25	80	0.3125000
NODE_577_length_3150_cov_5.923959	2313	2393	10	16	80	0.2000000
NODE_577_length_3150_cov_5.923959	2313	2393	12	33	80	0.4125000
NODE_579_length_3148_cov_2.313873	3053	3105	2	45	52	0.8653846
NODE_579_length_3148_cov_2.313873	3053	3105	4	7	52	0.1346154
NODE_581_length_3146_cov_18.277322	2418	2498	0	26	80	0.3250000
NODE_581_length_3146_cov_18.277322	2418	2498	2	54	80	0.6750000
NODE_581_length_3146_cov_18.277322	2471	2551	2	53	80	0.6625000
NODE_581_length_3146_cov_18.277322	2471	2551	6	19	80	0.2375000
NODE_581_length_3146_cov_18.277322	2471	2551	8	8	80	0.1000000
NODE_581_length_3146_cov_18.277322	2547	2627	8	39	80	0.4875000
NODE_581_length_3146_cov_18.277322	2547	2627	12	12	80	0.1500000
NODE_581_length_3146_cov_18.277322	2547	2627	14	10	80	0.1250000
NODE_581_length_3146_cov_18.277322	2547	2627	16	1	80	0.0125000
NODE_581_length_3146_cov_18.277322	2547	2627	18	5	80	0.0625000
NODE_581_length_3146_cov_18.277322	2547	2627	20	1	80	0.0125000
NODE_581_length_3146_cov_18.277322	2547	2627	23	2	80	0.0250000
NODE_581_length_3146_cov_18.277322	2547	2627	28	10	80	0.1250000
NODE_581_length_3146_cov_18.277322	2600	2680	12	4	80	0.0500000
NODE_581_length_3146_cov_18.277322	2600	2680	14	4	80	0.0500000
NODE_581_length_3146_cov_18.277322	2600	2680	16	1	80	0.0125000
NODE_581_length_3146_cov_18.277322	2600	2680	18	5	80	0.0625000
NODE_581_length_3146_cov_18.277322	2600	2680	20	1	80	0.0125000
NODE_581_length_3146_cov_18.277322	2600	2680	23	2	80	0.0250000
NODE_581_length_3146_cov_18.277322	2600	2680	26	2	80	0.0250000
NODE_581_length_3146_cov_18.277322	2600	2680	28	38	80	0.4750000
NODE_581_length_3146_cov_18.277322	2600	2680	29	5	80	0.0625000
NODE_581_length_3146_cov_18.277322	2600	2680	30	11	80	0.1375000
NODE_581_length_3146_cov_18.277322	2600	2680	31	7	80	0.0875000
NODE_581_length_3146_cov_18.277322	2975	3055	3	18	80	0.2250000
NODE_581_length_3146_cov_18.277322	2975	3055	4	62	80	0.7750000
NODE_585_length_3134_cov_8.717957	1290	1362	8	20	72	0.2777778
NODE_585_length_3134_cov_8.717957	1290	1362	12	4	72	0.0555556
NODE_585_length_3134_cov_8.717957	1290	1362	14	5	72	0.0694444
NODE_585_length_3134_cov_8.717957	1290	1362	16	1	72	0.0138889
NODE_585_length_3134_cov_8.717957	1290	1362	18	6	72	0.0833333
NODE_585_length_3134_cov_8.717957	1290	1362	20	4	72	0.0555556
NODE_585_length_3134_cov_8.717957	1290	1362	22	1	72	0.0138889
NODE_585_length_3134_cov_8.717957	1290	1362	24	2	72	0.0277778
NODE_585_length_3134_cov_8.717957	1290	1362	28	1	72	0.0138889
NODE_585_length_3134_cov_8.717957	1290	1362	30	3	72	0.0416667
NODE_585_length_3134_cov_8.717957	1290	1362	34	25	72	0.3472222
NODE_585_length_3134_cov_8.717957	1335	1415	18	1	80	0.0125000
NODE_585_length_3134_cov_8.717957	1335	1415	20	4	80	0.0500000
NODE_585_length_3134_cov_8.717957	1335	1415	23	2	80	0.0250000
NODE_585_length_3134_cov_8.717957	1335	1415	24	4	80	0.0500000
NODE_585_length_3134_cov_8.717957	1335	1415	28	11	80	0.1375000
NODE_585_length_3134_cov_8.717957	1335	1415	29	3	80	0.0375000
NODE_585_length_3134_cov_8.717957	1335	1415	30	21	80	0.2625000
NODE_585_length_3134_cov_8.717957	1335	1415	32	9	80	0.1125000
NODE_585_length_3134_cov_8.717957	1335	1415	34	25	80	0.3125000
NODE_586_length_3131_cov_26.910620	232	312	0	23	80	0.2875000
NODE_586_length_3131_cov_26.910620	232	312	2	57	80	0.7125000
NODE_586_length_3131_cov_26.910620	285	364	0	12	79	0.1518987
NODE_586_length_3131_cov_26.910620	285	364	2	67	79	0.8481013
NODE_586_length_3131_cov_26.910620	2151	2231	0	80	80	1.0000000
NODE_586_length_3131_cov_26.910620	2155	2227	0	72	72	1.0000000
NODE_586_length_3131_cov_26.910620	2204	2284	0	80	80	1.0000000
NODE_586_length_3131_cov_26.910620	2208	2284	0	76	76	1.0000000
NODE_586_length_3131_cov_26.910620	2280	2360	0	71	80	0.8875000
NODE_586_length_3131_cov_26.910620	2280	2360	2	9	80	0.1125000
NODE_586_length_3131_cov_26.910620	2333	2413	0	18	80	0.2250000
NODE_586_length_3131_cov_26.910620	2333	2413	2	62	80	0.7750000
NODE_590_length_3118_cov_5.059622	367	445	3	31	78	0.3974359
NODE_590_length_3118_cov_5.059622	367	445	4	40	78	0.5128205
NODE_590_length_3118_cov_5.059622	367	445	6	7	78	0.0897436
NODE_590_length_3118_cov_5.059622	418	498	3	1	80	0.0125000
NODE_590_length_3118_cov_5.059622	418	498	4	72	80	0.9000000
NODE_590_length_3118_cov_5.059622	418	498	6	7	80	0.0875000
NODE_591_length_3117_cov_5.938038	2525	2605	0	80	80	1.0000000
NODE_591_length_3117_cov_5.938038	2578	2658	0	80	80	1.0000000
NODE_595_length_3110_cov_31.733643	2864	2923	0	7	59	0.1186441
NODE_595_length_3110_cov_31.733643	2864	2923	6	2	59	0.0338983
NODE_595_length_3110_cov_31.733643	2864	2923	8	7	59	0.1186441
NODE_595_length_3110_cov_31.733643	2864	2923	12	4	59	0.0677966
NODE_595_length_3110_cov_31.733643	2864	2923	13	39	59	0.6610169
NODE_602_length_3093_cov_54.559786	571	651	4	13	80	0.1625000
NODE_602_length_3093_cov_54.559786	571	651	8	19	80	0.2375000
NODE_602_length_3093_cov_54.559786	571	651	10	48	80	0.6000000
NODE_602_length_3093_cov_54.559786	624	704	0	12	80	0.1500000
NODE_602_length_3093_cov_54.559786	624	704	2	5	80	0.0625000
NODE_602_length_3093_cov_54.559786	624	704	4	49	80	0.6125000
NODE_602_length_3093_cov_54.559786	624	704	10	14	80	0.1750000
NODE_602_length_3093_cov_54.559786	2901	2981	125	1	80	0.0125000
NODE_602_length_3093_cov_54.559786	2901	2981	126	1	80	0.0125000
NODE_602_length_3093_cov_54.559786	2901	2981	129	2	80	0.0250000
NODE_602_length_3093_cov_54.559786	2901	2981	133	1	80	0.0125000
NODE_602_length_3093_cov_54.559786	2901	2981	135	1	80	0.0125000
NODE_602_length_3093_cov_54.559786	2901	2981	144	1	80	0.0125000
NODE_602_length_3093_cov_54.559786	2901	2981	148	1	80	0.0125000
NODE_602_length_3093_cov_54.559786	2901	2981	149	2	80	0.0250000
NODE_602_length_3093_cov_54.559786	2901	2981	153	2	80	0.0250000
NODE_602_length_3093_cov_54.559786	2901	2981	157	1	80	0.0125000
NODE_602_length_3093_cov_54.559786	2901	2981	158	1	80	0.0125000
NODE_602_length_3093_cov_54.559786	2901	2981	162	1	80	0.0125000
NODE_602_length_3093_cov_54.559786	2901	2981	164	3	80	0.0375000
NODE_602_length_3093_cov_54.559786	2901	2981	171	2	80	0.0250000
NODE_602_length_3093_cov_54.559786	2901	2981	179	2	80	0.0250000
NODE_602_length_3093_cov_54.559786	2901	2981	180	2	80	0.0250000
NODE_602_length_3093_cov_54.559786	2901	2981	181	4	80	0.0500000
NODE_602_length_3093_cov_54.559786	2901	2981	184	4	80	0.0500000
NODE_602_length_3093_cov_54.559786	2901	2981	185	1	80	0.0125000
NODE_602_length_3093_cov_54.559786	2901	2981	188	8	80	0.1000000
NODE_602_length_3093_cov_54.559786	2901	2981	192	8	80	0.1000000
NODE_602_length_3093_cov_54.559786	2901	2981	194	4	80	0.0500000
NODE_602_length_3093_cov_54.559786	2901	2981	196	7	80	0.0875000
NODE_602_length_3093_cov_54.559786	2901	2981	198	4	80	0.0500000
NODE_602_length_3093_cov_54.559786	2901	2981	200	16	80	0.2000000
NODE_602_length_3093_cov_54.559786	2954	3034	57	6	80	0.0750000
NODE_602_length_3093_cov_54.559786	2954	3034	59	1	80	0.0125000
NODE_602_length_3093_cov_54.559786	2954	3034	65	1	80	0.0125000
NODE_602_length_3093_cov_54.559786	2954	3034	70	5	80	0.0625000
NODE_602_length_3093_cov_54.559786	2954	3034	71	9	80	0.1125000
NODE_602_length_3093_cov_54.559786	2954	3034	75	2	80	0.0250000
NODE_602_length_3093_cov_54.559786	2954	3034	81	1	80	0.0125000
NODE_602_length_3093_cov_54.559786	2954	3034	82	1	80	0.0125000
NODE_602_length_3093_cov_54.559786	2954	3034	95	1	80	0.0125000
NODE_602_length_3093_cov_54.559786	2954	3034	99	1	80	0.0125000
NODE_602_length_3093_cov_54.559786	2954	3034	102	1	80	0.0125000
NODE_602_length_3093_cov_54.559786	2954	3034	109	2	80	0.0250000
NODE_602_length_3093_cov_54.559786	2954	3034	114	1	80	0.0125000
NODE_602_length_3093_cov_54.559786	2954	3034	116	2	80	0.0250000
NODE_602_length_3093_cov_54.559786	2954	3034	122	8	80	0.1000000
NODE_602_length_3093_cov_54.559786	2954	3034	139	1	80	0.0125000
NODE_602_length_3093_cov_54.559786	2954	3034	154	1	80	0.0125000
NODE_602_length_3093_cov_54.559786	2954	3034	160	1	80	0.0125000
NODE_602_length_3093_cov_54.559786	2954	3034	169	2	80	0.0250000
NODE_602_length_3093_cov_54.559786	2954	3034	175	1	80	0.0125000
NODE_602_length_3093_cov_54.559786	2954	3034	176	4	80	0.0500000
NODE_602_length_3093_cov_54.559786	2954	3034	180	3	80	0.0375000
NODE_602_length_3093_cov_54.559786	2954	3034	188	5	80	0.0625000
NODE_602_length_3093_cov_54.559786	2954	3034	192	2	80	0.0250000
NODE_602_length_3093_cov_54.559786	2954	3034	196	5	80	0.0625000
NODE_602_length_3093_cov_54.559786	2954	3034	198	2	80	0.0250000
NODE_602_length_3093_cov_54.559786	2954	3034	200	11	80	0.1375000
NODE_603_length_3091_cov_35.895722	1743	1804	0	60	61	0.9836066
NODE_603_length_3091_cov_35.895722	1743	1804	1	1	61	0.0163934
NODE_603_length_3091_cov_35.895722	1777	1857	0	80	80	1.0000000
NODE_603_length_3091_cov_35.895722	2472	2535	6	9	63	0.1428571
NODE_603_length_3091_cov_35.895722	2472	2535	8	27	63	0.4285714
NODE_603_length_3091_cov_35.895722	2472	2535	10	27	63	0.4285714
NODE_603_length_3091_cov_35.895722	2508	2553	4	1	45	0.0222222
NODE_603_length_3091_cov_35.895722	2508	2553	6	26	45	0.5777778
NODE_603_length_3091_cov_35.895722	2508	2553	8	5	45	0.1111111
NODE_603_length_3091_cov_35.895722	2508	2553	10	13	45	0.2888889
NODE_603_length_3091_cov_35.895722	2534	2604	4	14	70	0.2000000
NODE_603_length_3091_cov_35.895722	2534	2604	6	26	70	0.3714286
NODE_603_length_3091_cov_35.895722	2534	2604	7	2	70	0.0285714
NODE_603_length_3091_cov_35.895722	2534	2604	8	15	70	0.2142857
NODE_603_length_3091_cov_35.895722	2534	2604	9	13	70	0.1857143
NODE_603_length_3091_cov_35.895722	2578	2618	7	16	40	0.4000000
NODE_603_length_3091_cov_35.895722	2578	2618	8	15	40	0.3750000
NODE_603_length_3091_cov_35.895722	2578	2618	9	9	40	0.2250000
NODE_603_length_3091_cov_35.895722	2586	2623	7	21	37	0.5675676
NODE_603_length_3091_cov_35.895722	2586	2623	8	15	37	0.4054054
NODE_603_length_3091_cov_35.895722	2586	2623	9	1	37	0.0270270
NODE_603_length_3091_cov_35.895722	2626	2671	5	45	45	1.0000000
NODE_603_length_3091_cov_35.895722	2682	2730	5	8	48	0.1666667
NODE_603_length_3091_cov_35.895722	2682	2730	6	1	48	0.0208333
NODE_603_length_3091_cov_35.895722	2682	2730	7	25	48	0.5208333
NODE_603_length_3091_cov_35.895722	2682	2730	9	14	48	0.2916667
NODE_603_length_3091_cov_35.895722	2918	2969	0	51	51	1.0000000
NODE_603_length_3091_cov_35.895722	2942	2987	0	45	45	1.0000000
NODE_603_length_3091_cov_35.895722	2994	3039	0	45	45	1.0000000
NODE_607_length_3079_cov_7.081879	2340	2420	6	13	80	0.1625000
NODE_607_length_3079_cov_7.081879	2340	2420	10	15	80	0.1875000
NODE_607_length_3079_cov_7.081879	2340	2420	12	52	80	0.6500000
NODE_607_length_3079_cov_7.081879	2886	2938	10	4	52	0.0769231
NODE_607_length_3079_cov_7.081879	2886	2938	14	13	52	0.2500000
NODE_607_length_3079_cov_7.081879	2886	2938	16	10	52	0.1923077
NODE_607_length_3079_cov_7.081879	2886	2938	19	2	52	0.0384615
NODE_607_length_3079_cov_7.081879	2886	2938	20	6	52	0.1153846
NODE_607_length_3079_cov_7.081879	2886	2938	24	2	52	0.0384615
NODE_607_length_3079_cov_7.081879	2886	2938	26	3	52	0.0576923
NODE_607_length_3079_cov_7.081879	2886	2938	32	1	52	0.0192308
NODE_607_length_3079_cov_7.081879	2886	2938	36	1	52	0.0192308
NODE_607_length_3079_cov_7.081879	2886	2938	40	3	52	0.0576923
NODE_607_length_3079_cov_7.081879	2886	2938	42	1	52	0.0192308
NODE_607_length_3079_cov_7.081879	2886	2938	46	3	52	0.0576923
NODE_607_length_3079_cov_7.081879	2886	2938	49	1	52	0.0192308
NODE_607_length_3079_cov_7.081879	2886	2938	54	2	52	0.0384615
NODE_607_length_3079_cov_7.081879	2893	2959	14	10	66	0.1515152
NODE_607_length_3079_cov_7.081879	2893	2959	16	10	66	0.1515152
NODE_607_length_3079_cov_7.081879	2893	2959	19	2	66	0.0303030
NODE_607_length_3079_cov_7.081879	2893	2959	20	6	66	0.0909091
NODE_607_length_3079_cov_7.081879	2893	2959	24	2	66	0.0303030
NODE_607_length_3079_cov_7.081879	2893	2959	26	3	66	0.0454545
NODE_607_length_3079_cov_7.081879	2893	2959	32	1	66	0.0151515
NODE_607_length_3079_cov_7.081879	2893	2959	36	1	66	0.0151515
NODE_607_length_3079_cov_7.081879	2893	2959	40	3	66	0.0454545
NODE_607_length_3079_cov_7.081879	2893	2959	42	1	66	0.0151515
NODE_607_length_3079_cov_7.081879	2893	2959	46	3	66	0.0454545
NODE_607_length_3079_cov_7.081879	2893	2959	49	1	66	0.0151515
NODE_607_length_3079_cov_7.081879	2893	2959	54	2	66	0.0303030
NODE_607_length_3079_cov_7.081879	2893	2959	56	2	66	0.0303030
NODE_607_length_3079_cov_7.081879	2893	2959	58	4	66	0.0606061
NODE_607_length_3079_cov_7.081879	2893	2959	60	2	66	0.0303030
NODE_607_length_3079_cov_7.081879	2893	2959	64	2	66	0.0303030
NODE_607_length_3079_cov_7.081879	2893	2959	68	1	66	0.0151515
NODE_607_length_3079_cov_7.081879	2893	2959	72	1	66	0.0151515
NODE_607_length_3079_cov_7.081879	2893	2959	74	2	66	0.0303030
NODE_607_length_3079_cov_7.081879	2893	2959	76	1	66	0.0151515
NODE_607_length_3079_cov_7.081879	2893	2959	86	1	66	0.0151515
NODE_607_length_3079_cov_7.081879	2893	2959	88	2	66	0.0303030
NODE_607_length_3079_cov_7.081879	2893	2959	90	1	66	0.0151515
NODE_607_length_3079_cov_7.081879	2893	2959	93	2	66	0.0303030
NODE_607_length_3079_cov_7.081879	2932	2993	46	3	61	0.0491803
NODE_607_length_3079_cov_7.081879	2932	2993	49	1	61	0.0163934
NODE_607_length_3079_cov_7.081879	2932	2993	54	2	61	0.0327869
NODE_607_length_3079_cov_7.081879	2932	2993	56	2	61	0.0327869
NODE_607_length_3079_cov_7.081879	2932	2993	58	4	61	0.0655738
NODE_607_length_3079_cov_7.081879	2932	2993	60	2	61	0.0327869
NODE_607_length_3079_cov_7.081879	2932	2993	64	2	61	0.0327869
NODE_607_length_3079_cov_7.081879	2932	2993	68	1	61	0.0163934
NODE_607_length_3079_cov_7.081879	2932	2993	72	1	61	0.0163934
NODE_607_length_3079_cov_7.081879	2932	2993	74	2	61	0.0327869
NODE_607_length_3079_cov_7.081879	2932	2993	76	1	61	0.0163934
NODE_607_length_3079_cov_7.081879	2932	2993	86	1	61	0.0163934
NODE_607_length_3079_cov_7.081879	2932	2993	88	2	61	0.0327869
NODE_607_length_3079_cov_7.081879	2932	2993	90	1	61	0.0163934
NODE_607_length_3079_cov_7.081879	2932	2993	93	13	61	0.2131148
NODE_607_length_3079_cov_7.081879	2932	2993	95	10	61	0.1639344
NODE_607_length_3079_cov_7.081879	2932	2993	97	13	61	0.2131148
NODE_607_length_3079_cov_7.081879	2932	2995	46	3	63	0.0476190
NODE_607_length_3079_cov_7.081879	2932	2995	49	1	63	0.0158730
NODE_607_length_3079_cov_7.081879	2932	2995	54	2	63	0.0317460
NODE_607_length_3079_cov_7.081879	2932	2995	56	2	63	0.0317460
NODE_607_length_3079_cov_7.081879	2932	2995	58	4	63	0.0634921
NODE_607_length_3079_cov_7.081879	2932	2995	60	2	63	0.0317460
NODE_607_length_3079_cov_7.081879	2932	2995	64	2	63	0.0317460
NODE_607_length_3079_cov_7.081879	2932	2995	68	1	63	0.0158730
NODE_607_length_3079_cov_7.081879	2932	2995	72	1	63	0.0158730
NODE_607_length_3079_cov_7.081879	2932	2995	74	2	63	0.0317460
NODE_607_length_3079_cov_7.081879	2932	2995	76	1	63	0.0158730
NODE_607_length_3079_cov_7.081879	2932	2995	86	1	63	0.0158730
NODE_607_length_3079_cov_7.081879	2932	2995	88	2	63	0.0317460
NODE_607_length_3079_cov_7.081879	2932	2995	90	1	63	0.0158730
NODE_607_length_3079_cov_7.081879	2932	2995	93	13	63	0.2063492
NODE_607_length_3079_cov_7.081879	2932	2995	95	12	63	0.1904762
NODE_607_length_3079_cov_7.081879	2932	2995	97	13	63	0.2063492
NODE_607_length_3079_cov_7.081879	2932	2995	46	3	63	0.0476190
NODE_607_length_3079_cov_7.081879	2932	2995	49	1	63	0.0158730
NODE_607_length_3079_cov_7.081879	2932	2995	54	2	63	0.0317460
NODE_607_length_3079_cov_7.081879	2932	2995	56	2	63	0.0317460
NODE_607_length_3079_cov_7.081879	2932	2995	58	4	63	0.0634921
NODE_607_length_3079_cov_7.081879	2932	2995	60	2	63	0.0317460
NODE_607_length_3079_cov_7.081879	2932	2995	64	2	63	0.0317460
NODE_607_length_3079_cov_7.081879	2932	2995	68	1	63	0.0158730
NODE_607_length_3079_cov_7.081879	2932	2995	72	1	63	0.0158730
NODE_607_length_3079_cov_7.081879	2932	2995	74	2	63	0.0317460
NODE_607_length_3079_cov_7.081879	2932	2995	76	1	63	0.0158730
NODE_607_length_3079_cov_7.081879	2932	2995	86	1	63	0.0158730
NODE_607_length_3079_cov_7.081879	2932	2995	88	2	63	0.0317460
NODE_607_length_3079_cov_7.081879	2932	2995	90	1	63	0.0158730
NODE_607_length_3079_cov_7.081879	2932	2995	93	13	63	0.2063492
NODE_607_length_3079_cov_7.081879	2932	2995	95	12	63	0.1904762
NODE_607_length_3079_cov_7.081879	2932	2995	97	13	63	0.2063492
NODE_608_length_3077_cov_23.535259	1244	1321	6	77	77	1.0000000
NODE_608_length_3077_cov_23.535259	1911	1991	0	24	80	0.3000000
NODE_608_length_3077_cov_23.535259	1911	1991	2	18	80	0.2250000
NODE_608_length_3077_cov_23.535259	1911	1991	6	13	80	0.1625000
NODE_608_length_3077_cov_23.535259	1911	1991	10	25	80	0.3125000
NODE_608_length_3077_cov_23.535259	1964	2016	6	2	52	0.0384615
NODE_608_length_3077_cov_23.535259	1964	2016	10	50	52	0.9615384
NODE_608_length_3077_cov_23.535259	2028	2114	2	13	86	0.1511628
NODE_608_length_3077_cov_23.535259	2028	2114	3	11	86	0.1279070
NODE_608_length_3077_cov_23.535259	2028	2114	4	18	86	0.2093023
NODE_608_length_3077_cov_23.535259	2028	2114	5	13	86	0.1511628
NODE_608_length_3077_cov_23.535259	2028	2114	6	21	86	0.2441860
NODE_608_length_3077_cov_23.535259	2028	2114	7	10	86	0.1162791
NODE_609_length_3077_cov_8.693083	1157	1237	6	2	80	0.0250000
NODE_609_length_3077_cov_8.693083	1157	1237	8	2	80	0.0250000
NODE_609_length_3077_cov_8.693083	1157	1237	10	19	80	0.2375000
NODE_609_length_3077_cov_8.693083	1157	1237	12	7	80	0.0875000
NODE_609_length_3077_cov_8.693083	1157	1237	16	31	80	0.3875000
NODE_609_length_3077_cov_8.693083	1157	1237	18	6	80	0.0750000
NODE_609_length_3077_cov_8.693083	1157	1237	20	11	80	0.1375000
NODE_609_length_3077_cov_8.693083	1157	1237	22	2	80	0.0250000
NODE_609_length_3077_cov_8.693083	1161	1184	10	19	23	0.8260869
NODE_609_length_3077_cov_8.693083	1161	1184	12	4	23	0.1739130
NODE_609_length_3077_cov_8.693083	1233	1313	18	1	80	0.0125000
NODE_609_length_3077_cov_8.693083	1233	1313	20	1	80	0.0125000
NODE_609_length_3077_cov_8.693083	1233	1313	22	5	80	0.0625000
NODE_609_length_3077_cov_8.693083	1233	1313	32	2	80	0.0250000
NODE_609_length_3077_cov_8.693083	1233	1313	36	2	80	0.0250000
NODE_609_length_3077_cov_8.693083	1233	1313	38	3	80	0.0375000
NODE_609_length_3077_cov_8.693083	1233	1313	40	1	80	0.0125000
NODE_609_length_3077_cov_8.693083	1233	1313	42	2	80	0.0250000
NODE_609_length_3077_cov_8.693083	1233	1313	44	1	80	0.0125000
NODE_609_length_3077_cov_8.693083	1233	1313	46	1	80	0.0125000
NODE_609_length_3077_cov_8.693083	1233	1313	48	3	80	0.0375000
NODE_609_length_3077_cov_8.693083	1233	1313	50	1	80	0.0125000
NODE_609_length_3077_cov_8.693083	1233	1313	54	1	80	0.0125000
NODE_609_length_3077_cov_8.693083	1233	1313	56	2	80	0.0250000
NODE_609_length_3077_cov_8.693083	1233	1313	58	4	80	0.0500000
NODE_609_length_3077_cov_8.693083	1233	1313	60	7	80	0.0875000
NODE_609_length_3077_cov_8.693083	1233	1313	68	2	80	0.0250000
NODE_609_length_3077_cov_8.693083	1233	1313	70	1	80	0.0125000
NODE_609_length_3077_cov_8.693083	1233	1313	71	1	80	0.0125000
NODE_609_length_3077_cov_8.693083	1233	1313	72	3	80	0.0375000
NODE_609_length_3077_cov_8.693083	1233	1313	74	2	80	0.0250000
NODE_609_length_3077_cov_8.693083	1233	1313	76	2	80	0.0250000
NODE_609_length_3077_cov_8.693083	1233	1313	78	17	80	0.2125000
NODE_609_length_3077_cov_8.693083	1233	1313	80	5	80	0.0625000
NODE_609_length_3077_cov_8.693083	1233	1313	82	10	80	0.1250000
NODE_609_length_3077_cov_8.693083	1286	1352	72	4	66	0.0606061
NODE_609_length_3077_cov_8.693083	1286	1352	74	2	66	0.0303030
NODE_609_length_3077_cov_8.693083	1286	1352	75	1	66	0.0151515
NODE_609_length_3077_cov_8.693083	1286	1352	76	1	66	0.0151515
NODE_609_length_3077_cov_8.693083	1286	1352	78	15	66	0.2272727
NODE_609_length_3077_cov_8.693083	1286	1352	80	19	66	0.2878788
NODE_609_length_3077_cov_8.693083	1286	1352	82	22	66	0.3333333
NODE_609_length_3077_cov_8.693083	1286	1352	86	2	66	0.0303030
NODE_609_length_3077_cov_8.693083	2672	2757	2	36	85	0.4235294
NODE_609_length_3077_cov_8.693083	2672	2757	9	1	85	0.0117647
NODE_609_length_3077_cov_8.693083	2672	2757	11	8	85	0.0941176
NODE_609_length_3077_cov_8.693083	2672	2757	20	12	85	0.1411765
NODE_609_length_3077_cov_8.693083	2672	2757	24	1	85	0.0117647
NODE_609_length_3077_cov_8.693083	2672	2757	32	3	85	0.0352941
NODE_609_length_3077_cov_8.693083	2672	2757	35	1	85	0.0117647
NODE_609_length_3077_cov_8.693083	2672	2757	36	2	85	0.0235294
NODE_609_length_3077_cov_8.693083	2672	2757	38	20	85	0.2352941
NODE_609_length_3077_cov_8.693083	2672	2757	42	1	85	0.0117647
NODE_611_length_3074_cov_2.996303	2561	2629	51	4	68	0.0588235
NODE_611_length_3074_cov_2.996303	2561	2629	55	1	68	0.0147059
NODE_611_length_3074_cov_2.996303	2561	2629	61	1	68	0.0147059
NODE_611_length_3074_cov_2.996303	2561	2629	65	1	68	0.0147059
NODE_611_length_3074_cov_2.996303	2561	2629	81	2	68	0.0294118
NODE_611_length_3074_cov_2.996303	2561	2629	98	1	68	0.0147059
NODE_611_length_3074_cov_2.996303	2561	2629	108	1	68	0.0147059
NODE_611_length_3074_cov_2.996303	2561	2629	112	3	68	0.0441176
NODE_611_length_3074_cov_2.996303	2561	2629	115	2	68	0.0294118
NODE_611_length_3074_cov_2.996303	2561	2629	116	1	68	0.0147059
NODE_611_length_3074_cov_2.996303	2561	2629	118	1	68	0.0147059
NODE_611_length_3074_cov_2.996303	2561	2629	120	1	68	0.0147059
NODE_611_length_3074_cov_2.996303	2561	2629	126	1	68	0.0147059
NODE_611_length_3074_cov_2.996303	2561	2629	128	1	68	0.0147059
NODE_611_length_3074_cov_2.996303	2561	2629	130	1	68	0.0147059
NODE_611_length_3074_cov_2.996303	2561	2629	134	1	68	0.0147059
NODE_611_length_3074_cov_2.996303	2561	2629	136	2	68	0.0294118
NODE_611_length_3074_cov_2.996303	2561	2629	153	2	68	0.0294118
NODE_611_length_3074_cov_2.996303	2561	2629	155	1	68	0.0147059
NODE_611_length_3074_cov_2.996303	2561	2629	161	1	68	0.0147059
NODE_611_length_3074_cov_2.996303	2561	2629	166	4	68	0.0588235
NODE_611_length_3074_cov_2.996303	2561	2629	168	2	68	0.0294118
NODE_611_length_3074_cov_2.996303	2561	2629	172	2	68	0.0294118
NODE_611_length_3074_cov_2.996303	2561	2629	185	1	68	0.0147059
NODE_611_length_3074_cov_2.996303	2561	2629	196	1	68	0.0147059
NODE_611_length_3074_cov_2.996303	2561	2629	198	1	68	0.0147059
NODE_611_length_3074_cov_2.996303	2561	2629	201	1	68	0.0147059
NODE_611_length_3074_cov_2.996303	2561	2629	208	1	68	0.0147059
NODE_611_length_3074_cov_2.996303	2561	2629	210	1	68	0.0147059
NODE_611_length_3074_cov_2.996303	2561	2629	214	1	68	0.0147059
NODE_611_length_3074_cov_2.996303	2561	2629	224	1	68	0.0147059
NODE_611_length_3074_cov_2.996303	2561	2629	225	1	68	0.0147059
NODE_611_length_3074_cov_2.996303	2561	2629	229	1	68	0.0147059
NODE_611_length_3074_cov_2.996303	2561	2629	231	1	68	0.0147059
NODE_611_length_3074_cov_2.996303	2561	2629	237	1	68	0.0147059
NODE_611_length_3074_cov_2.996303	2561	2629	238	1	68	0.0147059
NODE_611_length_3074_cov_2.996303	2561	2629	246	1	68	0.0147059
NODE_611_length_3074_cov_2.996303	2561	2629	250	1	68	0.0147059
NODE_611_length_3074_cov_2.996303	2561	2629	258	1	68	0.0147059
NODE_611_length_3074_cov_2.996303	2561	2629	262	1	68	0.0147059
NODE_611_length_3074_cov_2.996303	2561	2629	268	1	68	0.0147059
NODE_611_length_3074_cov_2.996303	2561	2629	270	1	68	0.0147059
NODE_611_length_3074_cov_2.996303	2561	2629	277	1	68	0.0147059
NODE_611_length_3074_cov_2.996303	2561	2629	287	1	68	0.0147059
NODE_611_length_3074_cov_2.996303	2561	2629	293	1	68	0.0147059
NODE_611_length_3074_cov_2.996303	2561	2629	303	1	68	0.0147059
NODE_611_length_3074_cov_2.996303	2561	2629	316	1	68	0.0147059
NODE_611_length_3074_cov_2.996303	2561	2629	323	1	68	0.0147059
NODE_611_length_3074_cov_2.996303	2561	2629	327	1	68	0.0147059
NODE_611_length_3074_cov_2.996303	2561	2629	354	1	68	0.0147059
NODE_611_length_3074_cov_2.996303	2561	2629	366	1	68	0.0147059
NODE_611_length_3074_cov_2.996303	2561	2629	376	1	68	0.0147059
NODE_611_length_3074_cov_2.996303	2561	2629	377	1	68	0.0147059
NODE_611_length_3074_cov_2.996303	2561	2629	381	1	68	0.0147059
NODE_615_length_3069_cov_2.448822	2948	2991	0	13	43	0.3023256
NODE_615_length_3069_cov_2.448822	2948	2991	2	28	43	0.6511628
NODE_615_length_3069_cov_2.448822	2948	2991	4	2	43	0.0465116
NODE_616_length_3059_cov_20.037500	346	426	10	3	80	0.0375000
NODE_616_length_3059_cov_20.037500	346	426	18	3	80	0.0375000
NODE_616_length_3059_cov_20.037500	346	426	20	4	80	0.0500000
NODE_616_length_3059_cov_20.037500	346	426	26	9	80	0.1125000
NODE_616_length_3059_cov_20.037500	346	426	28	22	80	0.2750000
NODE_616_length_3059_cov_20.037500	346	426	32	2	80	0.0250000
NODE_616_length_3059_cov_20.037500	346	426	34	14	80	0.1750000
NODE_616_length_3059_cov_20.037500	346	426	36	11	80	0.1375000
NODE_616_length_3059_cov_20.037500	346	426	38	12	80	0.1500000
NODE_616_length_3059_cov_20.037500	399	479	12	3	80	0.0375000
NODE_616_length_3059_cov_20.037500	399	479	14	2	80	0.0250000
NODE_616_length_3059_cov_20.037500	399	479	15	5	80	0.0625000
NODE_616_length_3059_cov_20.037500	399	479	19	12	80	0.1500000
NODE_616_length_3059_cov_20.037500	399	479	21	4	80	0.0500000
NODE_616_length_3059_cov_20.037500	399	479	23	1	80	0.0125000
NODE_616_length_3059_cov_20.037500	399	479	32	20	80	0.2500000
NODE_616_length_3059_cov_20.037500	399	479	33	1	80	0.0125000
NODE_616_length_3059_cov_20.037500	399	479	34	6	80	0.0750000
NODE_616_length_3059_cov_20.037500	399	479	36	11	80	0.1375000
NODE_616_length_3059_cov_20.037500	399	479	38	15	80	0.1875000
NODE_616_length_3059_cov_20.037500	1317	1397	4	1	80	0.0125000
NODE_616_length_3059_cov_20.037500	1317	1397	6	27	80	0.3375000
NODE_616_length_3059_cov_20.037500	1317	1397	7	3	80	0.0375000
NODE_616_length_3059_cov_20.037500	1317	1397	10	19	80	0.2375000
NODE_616_length_3059_cov_20.037500	1317	1397	11	13	80	0.1625000
NODE_616_length_3059_cov_20.037500	1317	1397	12	17	80	0.2125000
NODE_616_length_3059_cov_20.037500	1370	1447	2	47	77	0.6103896
NODE_616_length_3059_cov_20.037500	1370	1447	4	4	77	0.0519481
NODE_616_length_3059_cov_20.037500	1370	1447	6	26	77	0.3376623
NODE_616_length_3059_cov_20.037500	2514	2594	0	80	80	1.0000000
NODE_616_length_3059_cov_20.037500	2567	2647	0	80	80	1.0000000
NODE_617_length_3058_cov_21.767489	2802	2882	0	14	80	0.1750000
NODE_617_length_3058_cov_21.767489	2802	2882	2	20	80	0.2500000
NODE_617_length_3058_cov_21.767489	2802	2882	3	1	80	0.0125000
NODE_617_length_3058_cov_21.767489	2802	2882	6	43	80	0.5375000
NODE_617_length_3058_cov_21.767489	2802	2882	7	1	80	0.0125000
NODE_617_length_3058_cov_21.767489	2802	2882	11	1	80	0.0125000
NODE_617_length_3058_cov_21.767489	2855	2930	2	2	75	0.0266667
NODE_617_length_3058_cov_21.767489	2855	2930	4	2	75	0.0266667
NODE_617_length_3058_cov_21.767489	2855	2930	6	71	75	0.9466667
NODE_621_length_3047_cov_47.232361	418	489	0	71	71	1.0000000
NODE_621_length_3047_cov_47.232361	758	801	14	1	43	0.0232558
NODE_621_length_3047_cov_47.232361	758	801	16	2	43	0.0465116
NODE_621_length_3047_cov_47.232361	758	801	20	1	43	0.0232558
NODE_621_length_3047_cov_47.232361	758	801	22	3	43	0.0697674
NODE_621_length_3047_cov_47.232361	758	801	24	1	43	0.0232558
NODE_621_length_3047_cov_47.232361	758	801	27	2	43	0.0465116
NODE_621_length_3047_cov_47.232361	758	801	31	11	43	0.2558140
NODE_621_length_3047_cov_47.232361	758	801	33	5	43	0.1162791
NODE_621_length_3047_cov_47.232361	758	801	35	2	43	0.0465116
NODE_621_length_3047_cov_47.232361	758	801	37	3	43	0.0697674
NODE_621_length_3047_cov_47.232361	758	801	38	2	43	0.0465116
NODE_621_length_3047_cov_47.232361	758	801	40	5	43	0.1162791
NODE_621_length_3047_cov_47.232361	758	801	42	1	43	0.0232558
NODE_621_length_3047_cov_47.232361	758	801	46	3	43	0.0697674
NODE_621_length_3047_cov_47.232361	758	801	54	1	43	0.0232558
NODE_623_length_3044_cov_38.951783	1702	1782	4	80	80	1.0000000
NODE_623_length_3044_cov_38.951783	1755	1835	0	46	80	0.5750000
NODE_623_length_3044_cov_38.951783	1755	1835	4	34	80	0.4250000
NODE_623_length_3044_cov_38.951783	1831	1911	0	62	80	0.7750000
NODE_623_length_3044_cov_38.951783	1831	1911	2	18	80	0.2250000
NODE_623_length_3044_cov_38.951783	1884	1964	0	9	80	0.1125000
NODE_623_length_3044_cov_38.951783	1884	1964	2	21	80	0.2625000
NODE_623_length_3044_cov_38.951783	1884	1964	4	50	80	0.6250000
NODE_623_length_3044_cov_38.951783	2556	2636	0	80	80	1.0000000
NODE_623_length_3044_cov_38.951783	2609	2689	0	59	80	0.7375000
NODE_623_length_3044_cov_38.951783	2609	2689	2	19	80	0.2375000
NODE_623_length_3044_cov_38.951783	2609	2689	4	2	80	0.0250000
NODE_625_length_3039_cov_3.258163	261	337	4	15	76	0.1973684
NODE_625_length_3039_cov_3.258163	261	337	5	2	76	0.0263158
NODE_625_length_3039_cov_3.258163	261	337	6	19	76	0.2500000
NODE_625_length_3039_cov_3.258163	261	337	8	14	76	0.1842105
NODE_625_length_3039_cov_3.258163	261	337	10	26	76	0.3421053
NODE_625_length_3039_cov_3.258163	261	336	4	14	75	0.1866667
NODE_625_length_3039_cov_3.258163	261	336	5	2	75	0.0266667
NODE_625_length_3039_cov_3.258163	261	336	6	19	75	0.2533333
NODE_625_length_3039_cov_3.258163	261	336	8	14	75	0.1866667
NODE_625_length_3039_cov_3.258163	261	336	10	26	75	0.3466667
NODE_625_length_3039_cov_3.258163	261	337	4	15	76	0.1973684
NODE_625_length_3039_cov_3.258163	261	337	5	2	76	0.0263158
NODE_625_length_3039_cov_3.258163	261	337	6	19	76	0.2500000
NODE_625_length_3039_cov_3.258163	261	337	8	14	76	0.1842105
NODE_625_length_3039_cov_3.258163	261	337	10	26	76	0.3421053
NODE_625_length_3039_cov_3.258163	270	337	4	15	67	0.2238806
NODE_625_length_3039_cov_3.258163	270	337	5	2	67	0.0298507
NODE_625_length_3039_cov_3.258163	270	337	6	12	67	0.1791045
NODE_625_length_3039_cov_3.258163	270	337	8	14	67	0.2089552
NODE_625_length_3039_cov_3.258163	270	337	10	24	67	0.3582090
NODE_627_length_3036_cov_8.968676	2303	2367	2	25	64	0.3906250
NODE_627_length_3036_cov_8.968676	2303	2367	4	39	64	0.6093750
NODE_627_length_3036_cov_8.968676	2340	2420	2	30	80	0.3750000
NODE_627_length_3036_cov_8.968676	2340	2420	4	50	80	0.6250000
NODE_627_length_3036_cov_8.968676	2416	2496	2	36	80	0.4500000
NODE_627_length_3036_cov_8.968676	2416	2496	4	42	80	0.5250000
NODE_627_length_3036_cov_8.968676	2416	2496	8	2	80	0.0250000
NODE_627_length_3036_cov_8.968676	2469	2549	4	38	80	0.4750000
NODE_627_length_3036_cov_8.968676	2469	2549	6	40	80	0.5000000
NODE_627_length_3036_cov_8.968676	2469	2549	8	2	80	0.0250000
NODE_629_length_3032_cov_7.470849	1026	1068	16	4	42	0.0952381
NODE_629_length_3032_cov_7.470849	1026	1068	18	8	42	0.1904762
NODE_629_length_3032_cov_7.470849	1026	1068	20	2	42	0.0476190
NODE_629_length_3032_cov_7.470849	1026	1068	24	7	42	0.1666667
NODE_629_length_3032_cov_7.470849	1026	1068	28	15	42	0.3571429
NODE_629_length_3032_cov_7.470849	1026	1068	30	2	42	0.0476190
NODE_629_length_3032_cov_7.470849	1026	1068	36	4	42	0.0952381
NODE_630_length_3025_cov_11.862611	2371	2451	0	34	80	0.4250000
NODE_630_length_3025_cov_11.862611	2371	2451	1	1	80	0.0125000
NODE_630_length_3025_cov_11.862611	2371	2451	2	3	80	0.0375000
NODE_630_length_3025_cov_11.862611	2371	2451	3	1	80	0.0125000
NODE_630_length_3025_cov_11.862611	2371	2451	4	5	80	0.0625000
NODE_630_length_3025_cov_11.862611	2371	2451	8	36	80	0.4500000
NODE_630_length_3025_cov_11.862611	2424	2504	8	80	80	1.0000000
NODE_630_length_3025_cov_11.862611	2500	2580	8	4	80	0.0500000
NODE_630_length_3025_cov_11.862611	2500	2580	12	24	80	0.3000000
NODE_630_length_3025_cov_11.862611	2500	2580	14	12	80	0.1500000
NODE_630_length_3025_cov_11.862611	2500	2580	16	1	80	0.0125000
NODE_630_length_3025_cov_11.862611	2500	2580	18	39	80	0.4875000
NODE_630_length_3025_cov_11.862611	2553	2633	2	3	80	0.0375000
NODE_630_length_3025_cov_11.862611	2553	2633	8	28	80	0.3500000
NODE_630_length_3025_cov_11.862611	2553	2633	12	44	80	0.5500000
NODE_630_length_3025_cov_11.862611	2553	2633	14	4	80	0.0500000
NODE_630_length_3025_cov_11.862611	2553	2633	16	1	80	0.0125000
NODE_635_length_3012_cov_33.100240	2379	2459	0	60	80	0.7500000
NODE_635_length_3012_cov_33.100240	2379	2459	2	18	80	0.2250000
NODE_635_length_3012_cov_33.100240	2379	2459	4	2	80	0.0250000
NODE_635_length_3012_cov_33.100240	2432	2512	0	7	80	0.0875000
NODE_635_length_3012_cov_33.100240	2432	2512	2	18	80	0.2250000
NODE_635_length_3012_cov_33.100240	2432	2512	4	55	80	0.6875000
NODE_637_length_3007_cov_11.843535	2641	2721	0	1	80	0.0125000
NODE_637_length_3007_cov_11.843535	2641	2721	3	4	80	0.0500000
NODE_637_length_3007_cov_11.843535	2641	2721	4	26	80	0.3250000
NODE_637_length_3007_cov_11.843535	2641	2721	6	11	80	0.1375000
NODE_637_length_3007_cov_11.843535	2641	2721	7	1	80	0.0125000
NODE_637_length_3007_cov_11.843535	2641	2721	8	34	80	0.4250000
NODE_637_length_3007_cov_11.843535	2641	2721	10	3	80	0.0375000
NODE_643_length_2992_cov_2.636709	2032	2112	0	23	80	0.2875000
NODE_643_length_2992_cov_2.636709	2032	2112	2	42	80	0.5250000
NODE_643_length_2992_cov_2.636709	2032	2112	4	15	80	0.1875000
NODE_643_length_2992_cov_2.636709	2085	2165	2	12	80	0.1500000
NODE_643_length_2992_cov_2.636709	2085	2165	4	18	80	0.2250000
NODE_643_length_2992_cov_2.636709	2085	2165	5	5	80	0.0625000
NODE_643_length_2992_cov_2.636709	2085	2165	7	5	80	0.0625000
NODE_643_length_2992_cov_2.636709	2085	2165	11	4	80	0.0500000
NODE_643_length_2992_cov_2.636709	2085	2165	13	2	80	0.0250000
NODE_643_length_2992_cov_2.636709	2085	2165	15	3	80	0.0375000
NODE_643_length_2992_cov_2.636709	2085	2165	16	1	80	0.0125000
NODE_643_length_2992_cov_2.636709	2085	2165	18	6	80	0.0750000
NODE_643_length_2992_cov_2.636709	2085	2165	19	2	80	0.0250000
NODE_643_length_2992_cov_2.636709	2085	2165	21	6	80	0.0750000
NODE_643_length_2992_cov_2.636709	2085	2165	23	2	80	0.0250000
NODE_643_length_2992_cov_2.636709	2085	2165	29	7	80	0.0875000
NODE_643_length_2992_cov_2.636709	2085	2165	30	1	80	0.0125000
NODE_643_length_2992_cov_2.636709	2085	2165	32	6	80	0.0750000
NODE_646_length_2978_cov_4.883293	382	452	0	2	70	0.0285714
NODE_646_length_2978_cov_4.883293	382	452	2	68	70	0.9714286
NODE_646_length_2978_cov_4.883293	1858	1938	0	80	80	1.0000000
NODE_646_length_2978_cov_4.883293	1926	1991	0	18	65	0.2769231
NODE_646_length_2978_cov_4.883293	1926	1991	2	30	65	0.4615385
NODE_646_length_2978_cov_4.883293	1926	1991	4	17	65	0.2615385
NODE_646_length_2978_cov_4.883293	1987	2066	4	6	79	0.0759494
NODE_646_length_2978_cov_4.883293	1987	2066	8	14	79	0.1772152
NODE_646_length_2978_cov_4.883293	1987	2066	10	37	79	0.4683544
NODE_646_length_2978_cov_4.883293	1987	2066	12	22	79	0.2784810
NODE_646_length_2978_cov_4.883293	2040	2079	10	38	39	0.9743590
NODE_646_length_2978_cov_4.883293	2040	2079	12	1	39	0.0256410
NODE_647_length_2976_cov_24.683003	1764	1844	0	80	80	1.0000000
NODE_647_length_2976_cov_24.683003	1817	1897	0	80	80	1.0000000
NODE_647_length_2976_cov_24.683003	1893	1973	0	80	80	1.0000000
NODE_647_length_2976_cov_24.683003	1946	2026	0	80	80	1.0000000
NODE_651_length_2967_cov_16.146095	238	318	2	4	80	0.0500000
NODE_651_length_2967_cov_16.146095	238	318	4	3	80	0.0375000
NODE_651_length_2967_cov_16.146095	238	318	6	59	80	0.7375000
NODE_651_length_2967_cov_16.146095	238	318	8	5	80	0.0625000
NODE_651_length_2967_cov_16.146095	238	318	10	9	80	0.1125000
NODE_651_length_2967_cov_16.146095	291	371	4	3	80	0.0375000
NODE_651_length_2967_cov_16.146095	291	371	6	37	80	0.4625000
NODE_651_length_2967_cov_16.146095	291	371	8	9	80	0.1125000
NODE_651_length_2967_cov_16.146095	291	371	10	31	80	0.3875000
NODE_651_length_2967_cov_16.146095	367	447	2	13	80	0.1625000
NODE_651_length_2967_cov_16.146095	367	447	4	11	80	0.1375000
NODE_651_length_2967_cov_16.146095	367	447	6	13	80	0.1625000
NODE_651_length_2967_cov_16.146095	367	447	8	43	80	0.5375000
NODE_651_length_2967_cov_16.146095	420	500	0	19	80	0.2375000
NODE_651_length_2967_cov_16.146095	420	500	2	47	80	0.5875000
NODE_651_length_2967_cov_16.146095	420	500	4	11	80	0.1375000
NODE_651_length_2967_cov_16.146095	420	500	6	3	80	0.0375000
NODE_653_length_2965_cov_19.913468	92	134	36	8	42	0.1904762
NODE_653_length_2965_cov_19.913468	92	134	42	2	42	0.0476190
NODE_653_length_2965_cov_19.913468	92	134	46	6	42	0.1428571
NODE_653_length_2965_cov_19.913468	92	134	52	1	42	0.0238095
NODE_653_length_2965_cov_19.913468	92	134	70	1	42	0.0238095
NODE_653_length_2965_cov_19.913468	92	134	86	1	42	0.0238095
NODE_653_length_2965_cov_19.913468	92	134	90	2	42	0.0476190
NODE_653_length_2965_cov_19.913468	92	134	92	1	42	0.0238095
NODE_653_length_2965_cov_19.913468	92	134	94	3	42	0.0714286
NODE_653_length_2965_cov_19.913468	92	134	98	3	42	0.0714286
NODE_653_length_2965_cov_19.913468	92	134	100	14	42	0.3333333
NODE_653_length_2965_cov_19.913468	109	178	0	6	69	0.0869565
NODE_653_length_2965_cov_19.913468	109	178	2	4	69	0.0579710
NODE_653_length_2965_cov_19.913468	109	178	6	3	69	0.0434783
NODE_653_length_2965_cov_19.913468	109	178	8	11	69	0.1594203
NODE_653_length_2965_cov_19.913468	109	178	9	1	69	0.0144928
NODE_653_length_2965_cov_19.913468	109	178	10	1	69	0.0144928
NODE_653_length_2965_cov_19.913468	109	178	14	2	69	0.0289855
NODE_653_length_2965_cov_19.913468	109	178	18	5	69	0.0724638
NODE_653_length_2965_cov_19.913468	109	178	20	1	69	0.0144928
NODE_653_length_2965_cov_19.913468	109	178	22	3	69	0.0434783
NODE_653_length_2965_cov_19.913468	109	178	28	2	69	0.0289855
NODE_653_length_2965_cov_19.913468	109	178	32	1	69	0.0144928
NODE_653_length_2965_cov_19.913468	109	178	34	4	69	0.0579710
NODE_653_length_2965_cov_19.913468	109	178	36	8	69	0.1159420
NODE_653_length_2965_cov_19.913468	109	178	42	2	69	0.0289855
NODE_653_length_2965_cov_19.913468	109	178	46	6	69	0.0869565
NODE_653_length_2965_cov_19.913468	109	178	52	1	69	0.0144928
NODE_653_length_2965_cov_19.913468	109	178	70	1	69	0.0144928
NODE_653_length_2965_cov_19.913468	109	178	86	1	69	0.0144928
NODE_653_length_2965_cov_19.913468	109	178	90	2	69	0.0289855
NODE_653_length_2965_cov_19.913468	109	178	92	1	69	0.0144928
NODE_653_length_2965_cov_19.913468	109	178	94	3	69	0.0434783
NODE_653_length_2965_cov_19.913468	109	178	0	6	69	0.0869565
NODE_653_length_2965_cov_19.913468	109	178	2	4	69	0.0579710
NODE_653_length_2965_cov_19.913468	109	178	6	3	69	0.0434783
NODE_653_length_2965_cov_19.913468	109	178	8	11	69	0.1594203
NODE_653_length_2965_cov_19.913468	109	178	9	1	69	0.0144928
NODE_653_length_2965_cov_19.913468	109	178	10	1	69	0.0144928
NODE_653_length_2965_cov_19.913468	109	178	14	2	69	0.0289855
NODE_653_length_2965_cov_19.913468	109	178	18	5	69	0.0724638
NODE_653_length_2965_cov_19.913468	109	178	20	1	69	0.0144928
NODE_653_length_2965_cov_19.913468	109	178	22	3	69	0.0434783
NODE_653_length_2965_cov_19.913468	109	178	28	2	69	0.0289855
NODE_653_length_2965_cov_19.913468	109	178	32	1	69	0.0144928
NODE_653_length_2965_cov_19.913468	109	178	34	4	69	0.0579710
NODE_653_length_2965_cov_19.913468	109	178	36	8	69	0.1159420
NODE_653_length_2965_cov_19.913468	109	178	42	2	69	0.0289855
NODE_653_length_2965_cov_19.913468	109	178	46	6	69	0.0869565
NODE_653_length_2965_cov_19.913468	109	178	52	1	69	0.0144928
NODE_653_length_2965_cov_19.913468	109	178	70	1	69	0.0144928
NODE_653_length_2965_cov_19.913468	109	178	86	1	69	0.0144928
NODE_653_length_2965_cov_19.913468	109	178	90	2	69	0.0289855
NODE_653_length_2965_cov_19.913468	109	178	92	1	69	0.0144928
NODE_653_length_2965_cov_19.913468	109	178	94	3	69	0.0434783
NODE_653_length_2965_cov_19.913468	2298	2378	0	80	80	1.0000000
NODE_653_length_2965_cov_19.913468	2351	2431	0	80	80	1.0000000
NODE_653_length_2965_cov_19.913468	2427	2507	0	6	80	0.0750000
NODE_653_length_2965_cov_19.913468	2427	2507	2	28	80	0.3500000
NODE_653_length_2965_cov_19.913468	2427	2507	8	46	80	0.5750000
NODE_653_length_2965_cov_19.913468	2480	2560	0	9	80	0.1125000
NODE_653_length_2965_cov_19.913468	2480	2560	6	44	80	0.5500000
NODE_653_length_2965_cov_19.913468	2480	2560	8	27	80	0.3375000
NODE_656_length_2960_cov_35.741699	459	539	0	80	80	1.0000000
NODE_656_length_2960_cov_35.741699	512	592	0	80	80	1.0000000
NODE_659_length_2951_cov_7.195652	1100	1141	211	1	41	0.0243902
NODE_659_length_2951_cov_7.195652	1100	1141	213	1	41	0.0243902
NODE_659_length_2951_cov_7.195652	1100	1141	215	1	41	0.0243902
NODE_659_length_2951_cov_7.195652	1100	1141	221	1	41	0.0243902
NODE_659_length_2951_cov_7.195652	1100	1141	223	1	41	0.0243902
NODE_659_length_2951_cov_7.195652	1100	1141	232	1	41	0.0243902
NODE_659_length_2951_cov_7.195652	1100	1141	239	1	41	0.0243902
NODE_659_length_2951_cov_7.195652	1100	1141	241	1	41	0.0243902
NODE_659_length_2951_cov_7.195652	1100	1141	247	1	41	0.0243902
NODE_659_length_2951_cov_7.195652	1100	1141	253	1	41	0.0243902
NODE_659_length_2951_cov_7.195652	1100	1141	256	2	41	0.0487805
NODE_659_length_2951_cov_7.195652	1100	1141	265	1	41	0.0243902
NODE_659_length_2951_cov_7.195652	1100	1141	266	2	41	0.0487805
NODE_659_length_2951_cov_7.195652	1100	1141	268	1	41	0.0243902
NODE_659_length_2951_cov_7.195652	1100	1141	270	2	41	0.0487805
NODE_659_length_2951_cov_7.195652	1100	1141	272	3	41	0.0731707
NODE_659_length_2951_cov_7.195652	1100	1141	281	1	41	0.0243902
NODE_659_length_2951_cov_7.195652	1100	1141	282	1	41	0.0243902
NODE_659_length_2951_cov_7.195652	1100	1141	285	1	41	0.0243902
NODE_659_length_2951_cov_7.195652	1100	1141	287	1	41	0.0243902
NODE_659_length_2951_cov_7.195652	1100	1141	291	1	41	0.0243902
NODE_659_length_2951_cov_7.195652	1100	1141	292	1	41	0.0243902
NODE_659_length_2951_cov_7.195652	1100	1141	293	1	41	0.0243902
NODE_659_length_2951_cov_7.195652	1100	1141	303	1	41	0.0243902
NODE_659_length_2951_cov_7.195652	1100	1141	306	1	41	0.0243902
NODE_659_length_2951_cov_7.195652	1100	1141	307	1	41	0.0243902
NODE_659_length_2951_cov_7.195652	1100	1141	311	2	41	0.0487805
NODE_659_length_2951_cov_7.195652	1100	1141	313	3	41	0.0731707
NODE_659_length_2951_cov_7.195652	1100	1141	314	1	41	0.0243902
NODE_659_length_2951_cov_7.195652	1100	1141	315	1	41	0.0243902
NODE_659_length_2951_cov_7.195652	1100	1141	316	3	41	0.0731707
NODE_665_length_2935_cov_37.693230	1492	1572	16	1	80	0.0125000
NODE_665_length_2935_cov_37.693230	1492	1572	20	1	80	0.0125000
NODE_665_length_2935_cov_37.693230	1492	1572	22	2	80	0.0250000
NODE_665_length_2935_cov_37.693230	1492	1572	30	1	80	0.0125000
NODE_665_length_2935_cov_37.693230	1492	1572	32	2	80	0.0250000
NODE_665_length_2935_cov_37.693230	1492	1572	36	2	80	0.0250000
NODE_665_length_2935_cov_37.693230	1492	1572	38	3	80	0.0375000
NODE_665_length_2935_cov_37.693230	1492	1572	42	5	80	0.0625000
NODE_665_length_2935_cov_37.693230	1492	1572	44	6	80	0.0750000
NODE_665_length_2935_cov_37.693230	1492	1572	46	4	80	0.0500000
NODE_665_length_2935_cov_37.693230	1492	1572	48	40	80	0.5000000
NODE_665_length_2935_cov_37.693230	1492	1572	50	13	80	0.1625000
NODE_665_length_2935_cov_37.693230	1534	1589	26	3	55	0.0545455
NODE_665_length_2935_cov_37.693230	1534	1589	30	1	55	0.0181818
NODE_665_length_2935_cov_37.693230	1534	1589	34	1	55	0.0181818
NODE_665_length_2935_cov_37.693230	1534	1589	36	2	55	0.0363636
NODE_665_length_2935_cov_37.693230	1534	1589	38	6	55	0.1090909
NODE_665_length_2935_cov_37.693230	1534	1589	40	2	55	0.0363636
NODE_665_length_2935_cov_37.693230	1534	1589	42	7	55	0.1272727
NODE_665_length_2935_cov_37.693230	1534	1589	44	3	55	0.0545455
NODE_665_length_2935_cov_37.693230	1534	1589	48	30	55	0.5454546
NODE_665_length_2935_cov_37.693230	1545	1619	2	6	74	0.0810811
NODE_665_length_2935_cov_37.693230	1545	1619	6	3	74	0.0405405
NODE_665_length_2935_cov_37.693230	1545	1619	8	1	74	0.0135135
NODE_665_length_2935_cov_37.693230	1545	1619	12	2	74	0.0270270
NODE_665_length_2935_cov_37.693230	1545	1619	14	3	74	0.0405405
NODE_665_length_2935_cov_37.693230	1545	1619	16	4	74	0.0540541
NODE_665_length_2935_cov_37.693230	1545	1619	18	7	74	0.0945946
NODE_665_length_2935_cov_37.693230	1545	1619	20	1	74	0.0135135
NODE_665_length_2935_cov_37.693230	1545	1619	22	1	74	0.0135135
NODE_665_length_2935_cov_37.693230	1545	1619	26	5	74	0.0675676
NODE_665_length_2935_cov_37.693230	1545	1619	30	1	74	0.0135135
NODE_665_length_2935_cov_37.693230	1545	1619	34	1	74	0.0135135
NODE_665_length_2935_cov_37.693230	1545	1619	36	2	74	0.0270270
NODE_665_length_2935_cov_37.693230	1545	1619	38	6	74	0.0810811
NODE_665_length_2935_cov_37.693230	1545	1619	40	2	74	0.0270270
NODE_665_length_2935_cov_37.693230	1545	1619	42	7	74	0.0945946
NODE_665_length_2935_cov_37.693230	1545	1619	44	3	74	0.0405405
NODE_665_length_2935_cov_37.693230	1545	1619	48	19	74	0.2567568
NODE_665_length_2935_cov_37.693230	1625	1701	0	76	76	1.0000000
NODE_665_length_2935_cov_37.693230	2863	2906	2	43	43	1.0000000
NODE_675_length_2913_cov_4.376688	2664	2739	1	8	75	0.1066667
NODE_675_length_2913_cov_4.376688	2664	2739	2	16	75	0.2133333
NODE_675_length_2913_cov_4.376688	2664	2739	4	46	75	0.6133333
NODE_675_length_2913_cov_4.376688	2664	2739	8	5	75	0.0666667
NODE_675_length_2913_cov_4.376688	2664	2723	2	8	59	0.1355932
NODE_675_length_2913_cov_4.376688	2664	2723	4	46	59	0.7796610
NODE_675_length_2913_cov_4.376688	2664	2723	8	5	59	0.0847458
NODE_675_length_2913_cov_4.376688	2664	2739	1	8	75	0.1066667
NODE_675_length_2913_cov_4.376688	2664	2739	2	16	75	0.2133333
NODE_675_length_2913_cov_4.376688	2664	2739	4	46	75	0.6133333
NODE_675_length_2913_cov_4.376688	2664	2739	8	5	75	0.0666667
NODE_675_length_2913_cov_4.376688	2664	2739	1	8	75	0.1066667
NODE_675_length_2913_cov_4.376688	2664	2739	2	16	75	0.2133333
NODE_675_length_2913_cov_4.376688	2664	2739	4	46	75	0.6133333
NODE_675_length_2913_cov_4.376688	2664	2739	8	5	75	0.0666667
NODE_675_length_2913_cov_4.376688	2673	2739	1	8	66	0.1212121
NODE_675_length_2913_cov_4.376688	2673	2739	2	16	66	0.2424242
NODE_675_length_2913_cov_4.376688	2673	2739	4	42	66	0.6363636
NODE_675_length_2913_cov_4.376688	2717	2780	1	49	63	0.7777778
NODE_675_length_2913_cov_4.376688	2717	2780	2	14	63	0.2222222
NODE_675_length_2913_cov_4.376688	2745	2778	1	33	33	1.0000000
NODE_677_length_2909_cov_71.975089	2090	2174	24	1	84	0.0119048
NODE_677_length_2909_cov_71.975089	2090	2174	25	1	84	0.0119048
NODE_677_length_2909_cov_71.975089	2090	2174	28	2	84	0.0238095
NODE_677_length_2909_cov_71.975089	2090	2174	29	4	84	0.0476190
NODE_677_length_2909_cov_71.975089	2090	2174	30	1	84	0.0119048
NODE_677_length_2909_cov_71.975089	2090	2174	31	3	84	0.0357143
NODE_677_length_2909_cov_71.975089	2090	2174	32	3	84	0.0357143
NODE_677_length_2909_cov_71.975089	2090	2174	33	1	84	0.0119048
NODE_677_length_2909_cov_71.975089	2090	2174	34	10	84	0.1190476
NODE_677_length_2909_cov_71.975089	2090	2174	36	3	84	0.0357143
NODE_677_length_2909_cov_71.975089	2090	2174	39	3	84	0.0357143
NODE_677_length_2909_cov_71.975089	2090	2174	40	2	84	0.0238095
NODE_677_length_2909_cov_71.975089	2090	2174	42	2	84	0.0238095
NODE_677_length_2909_cov_71.975089	2090	2174	44	1	84	0.0119048
NODE_677_length_2909_cov_71.975089	2090	2174	46	2	84	0.0238095
NODE_677_length_2909_cov_71.975089	2090	2174	51	2	84	0.0238095
NODE_677_length_2909_cov_71.975089	2090	2174	55	2	84	0.0238095
NODE_677_length_2909_cov_71.975089	2090	2174	57	4	84	0.0476190
NODE_677_length_2909_cov_71.975089	2090	2174	63	1	84	0.0119048
NODE_677_length_2909_cov_71.975089	2090	2174	67	1	84	0.0119048
NODE_677_length_2909_cov_71.975089	2090	2174	70	1	84	0.0119048
NODE_677_length_2909_cov_71.975089	2090	2174	72	1	84	0.0119048
NODE_677_length_2909_cov_71.975089	2090	2174	75	2	84	0.0238095
NODE_677_length_2909_cov_71.975089	2090	2174	84	2	84	0.0238095
NODE_677_length_2909_cov_71.975089	2090	2174	86	1	84	0.0119048
NODE_677_length_2909_cov_71.975089	2090	2174	90	2	84	0.0238095
NODE_677_length_2909_cov_71.975089	2090	2174	92	1	84	0.0119048
NODE_677_length_2909_cov_71.975089	2090	2174	100	1	84	0.0119048
NODE_677_length_2909_cov_71.975089	2090	2174	109	1	84	0.0119048
NODE_677_length_2909_cov_71.975089	2090	2174	111	1	84	0.0119048
NODE_677_length_2909_cov_71.975089	2090	2174	114	1	84	0.0119048
NODE_677_length_2909_cov_71.975089	2090	2174	120	1	84	0.0119048
NODE_677_length_2909_cov_71.975089	2090	2174	122	3	84	0.0357143
NODE_677_length_2909_cov_71.975089	2090	2174	125	1	84	0.0119048
NODE_677_length_2909_cov_71.975089	2090	2174	127	1	84	0.0119048
NODE_677_length_2909_cov_71.975089	2090	2174	129	1	84	0.0119048
NODE_677_length_2909_cov_71.975089	2090	2174	132	2	84	0.0238095
NODE_677_length_2909_cov_71.975089	2090	2174	135	2	84	0.0238095
NODE_677_length_2909_cov_71.975089	2090	2174	147	2	84	0.0238095
NODE_677_length_2909_cov_71.975089	2090	2174	159	1	84	0.0119048
NODE_677_length_2909_cov_71.975089	2090	2174	161	1	84	0.0119048
NODE_677_length_2909_cov_71.975089	2090	2174	163	3	84	0.0357143
NODE_677_length_2909_cov_71.975089	2090	2174	167	1	84	0.0119048
NODE_677_length_2909_cov_71.975089	2090	2174	169	2	84	0.0238095
NODE_678_length_2908_cov_5.937344	2495	2575	0	73	80	0.9125000
NODE_678_length_2908_cov_5.937344	2495	2575	2	7	80	0.0875000
NODE_678_length_2908_cov_5.937344	2548	2628	0	20	80	0.2500000
NODE_678_length_2908_cov_5.937344	2548	2628	2	56	80	0.7000000
NODE_678_length_2908_cov_5.937344	2548	2628	4	4	80	0.0500000
NODE_678_length_2908_cov_5.937344	2624	2704	0	2	80	0.0250000
NODE_678_length_2908_cov_5.937344	2624	2704	2	31	80	0.3875000
NODE_678_length_2908_cov_5.937344	2624	2704	4	47	80	0.5875000
NODE_678_length_2908_cov_5.937344	2677	2757	0	55	80	0.6875000
NODE_678_length_2908_cov_5.937344	2677	2757	2	25	80	0.3125000
NODE_679_length_2905_cov_12.777619	2358	2419	0	58	61	0.9508197
NODE_679_length_2905_cov_12.777619	2358	2419	2	3	61	0.0491803
NODE_679_length_2905_cov_12.777619	2358	2419	0	58	61	0.9508197
NODE_679_length_2905_cov_12.777619	2358	2419	2	3	61	0.0491803
NODE_679_length_2905_cov_12.777619	2358	2419	0	58	61	0.9508197
NODE_679_length_2905_cov_12.777619	2358	2419	2	3	61	0.0491803
NODE_679_length_2905_cov_12.777619	2392	2472	0	80	80	1.0000000
NODE_680_length_2903_cov_5.474322	2423	2464	26	3	41	0.0731707
NODE_680_length_2903_cov_5.474322	2423	2464	28	2	41	0.0487805
NODE_680_length_2903_cov_5.474322	2423	2464	32	3	41	0.0731707
NODE_680_length_2903_cov_5.474322	2423	2464	33	3	41	0.0731707
NODE_680_length_2903_cov_5.474322	2423	2464	34	2	41	0.0487805
NODE_680_length_2903_cov_5.474322	2423	2464	35	23	41	0.5609756
NODE_680_length_2903_cov_5.474322	2423	2464	37	2	41	0.0487805
NODE_680_length_2903_cov_5.474322	2423	2464	38	3	41	0.0731707
NODE_684_length_2898_cov_5.786352	0	74	0	23	74	0.3108108
NODE_684_length_2898_cov_5.786352	0	74	2	51	74	0.6891892
NODE_684_length_2898_cov_5.786352	47	124	2	44	77	0.5714286
NODE_684_length_2898_cov_5.786352	47	124	4	33	77	0.4285714
NODE_686_length_2895_cov_8.519313	869	949	2	80	80	1.0000000
NODE_686_length_2895_cov_8.519313	922	1002	0	50	80	0.6250000
NODE_686_length_2895_cov_8.519313	922	1002	2	30	80	0.3750000
NODE_688_length_2894_cov_2.036136	2677	2757	14	2	80	0.0250000
NODE_688_length_2894_cov_2.036136	2677	2757	18	2	80	0.0250000
NODE_688_length_2894_cov_2.036136	2677	2757	20	6	80	0.0750000
NODE_688_length_2894_cov_2.036136	2677	2757	22	16	80	0.2000000
NODE_688_length_2894_cov_2.036136	2677	2757	24	15	80	0.1875000
NODE_688_length_2894_cov_2.036136	2677	2757	26	39	80	0.4875000
NODE_689_length_2891_cov_7.938037	193	275	0	52	82	0.6341463
NODE_689_length_2891_cov_7.938037	193	275	4	7	82	0.0853659
NODE_689_length_2891_cov_7.938037	193	275	6	19	82	0.2317073
NODE_689_length_2891_cov_7.938037	193	275	8	3	82	0.0365854
NODE_689_length_2891_cov_7.938037	193	275	14	1	82	0.0121951
NODE_691_length_2889_cov_11.426882	407	487	2	12	80	0.1500000
NODE_691_length_2889_cov_11.426882	407	487	4	23	80	0.2875000
NODE_691_length_2889_cov_11.426882	407	487	6	13	80	0.1625000
NODE_691_length_2889_cov_11.426882	407	487	10	13	80	0.1625000
NODE_691_length_2889_cov_11.426882	407	487	11	1	80	0.0125000
NODE_691_length_2889_cov_11.426882	407	487	12	18	80	0.2250000
NODE_691_length_2889_cov_11.426882	460	540	6	21	80	0.2625000
NODE_691_length_2889_cov_11.426882	460	540	8	11	80	0.1375000
NODE_691_length_2889_cov_11.426882	460	540	10	34	80	0.4250000
NODE_691_length_2889_cov_11.426882	460	540	12	14	80	0.1750000
NODE_691_length_2889_cov_11.426882	1006	1086	12	1	80	0.0125000
NODE_691_length_2889_cov_11.426882	1006	1086	14	2	80	0.0250000
NODE_691_length_2889_cov_11.426882	1006	1086	16	2	80	0.0250000
NODE_691_length_2889_cov_11.426882	1006	1086	20	3	80	0.0375000
NODE_691_length_2889_cov_11.426882	1006	1086	24	2	80	0.0250000
NODE_691_length_2889_cov_11.426882	1006	1086	26	1	80	0.0125000
NODE_691_length_2889_cov_11.426882	1006	1086	28	1	80	0.0125000
NODE_691_length_2889_cov_11.426882	1006	1086	29	5	80	0.0625000
NODE_691_length_2889_cov_11.426882	1006	1086	37	2	80	0.0250000
NODE_691_length_2889_cov_11.426882	1006	1086	39	1	80	0.0125000
NODE_691_length_2889_cov_11.426882	1006	1086	42	1	80	0.0125000
NODE_691_length_2889_cov_11.426882	1006	1086	44	5	80	0.0625000
NODE_691_length_2889_cov_11.426882	1006	1086	46	2	80	0.0250000
NODE_691_length_2889_cov_11.426882	1006	1086	48	7	80	0.0875000
NODE_691_length_2889_cov_11.426882	1006	1086	50	18	80	0.2250000
NODE_691_length_2889_cov_11.426882	1006	1086	52	1	80	0.0125000
NODE_691_length_2889_cov_11.426882	1006	1086	54	14	80	0.1750000
NODE_691_length_2889_cov_11.426882	1006	1086	56	12	80	0.1500000
NODE_691_length_2889_cov_11.426882	1007	1086	12	1	79	0.0126582
NODE_691_length_2889_cov_11.426882	1007	1086	14	2	79	0.0253165
NODE_691_length_2889_cov_11.426882	1007	1086	16	2	79	0.0253165
NODE_691_length_2889_cov_11.426882	1007	1086	20	3	79	0.0379747
NODE_691_length_2889_cov_11.426882	1007	1086	24	2	79	0.0253165
NODE_691_length_2889_cov_11.426882	1007	1086	26	1	79	0.0126582
NODE_691_length_2889_cov_11.426882	1007	1086	28	1	79	0.0126582
NODE_691_length_2889_cov_11.426882	1007	1086	29	5	79	0.0632911
NODE_691_length_2889_cov_11.426882	1007	1086	37	2	79	0.0253165
NODE_691_length_2889_cov_11.426882	1007	1086	39	1	79	0.0126582
NODE_691_length_2889_cov_11.426882	1007	1086	42	1	79	0.0126582
NODE_691_length_2889_cov_11.426882	1007	1086	44	5	79	0.0632911
NODE_691_length_2889_cov_11.426882	1007	1086	46	2	79	0.0253165
NODE_691_length_2889_cov_11.426882	1007	1086	48	7	79	0.0886076
NODE_691_length_2889_cov_11.426882	1007	1086	50	18	79	0.2278481
NODE_691_length_2889_cov_11.426882	1007	1086	52	1	79	0.0126582
NODE_691_length_2889_cov_11.426882	1007	1086	54	14	79	0.1772152
NODE_691_length_2889_cov_11.426882	1007	1086	56	11	79	0.1392405
NODE_691_length_2889_cov_11.426882	1059	1138	0	46	79	0.5822785
NODE_691_length_2889_cov_11.426882	1059	1138	4	2	79	0.0253165
NODE_691_length_2889_cov_11.426882	1059	1138	8	2	79	0.0253165
NODE_691_length_2889_cov_11.426882	1059	1138	10	1	79	0.0126582
NODE_691_length_2889_cov_11.426882	1059	1138	12	2	79	0.0253165
NODE_691_length_2889_cov_11.426882	1059	1138	14	2	79	0.0253165
NODE_691_length_2889_cov_11.426882	1059	1138	16	2	79	0.0253165
NODE_691_length_2889_cov_11.426882	1059	1138	20	3	79	0.0379747
NODE_691_length_2889_cov_11.426882	1059	1138	24	2	79	0.0253165
NODE_691_length_2889_cov_11.426882	1059	1138	26	1	79	0.0126582
NODE_691_length_2889_cov_11.426882	1059	1138	28	1	79	0.0126582
NODE_691_length_2889_cov_11.426882	1059	1138	29	5	79	0.0632911
NODE_691_length_2889_cov_11.426882	1059	1138	37	2	79	0.0253165
NODE_691_length_2889_cov_11.426882	1059	1138	39	1	79	0.0126582
NODE_691_length_2889_cov_11.426882	1059	1138	42	1	79	0.0126582
NODE_691_length_2889_cov_11.426882	1059	1138	44	5	79	0.0632911
NODE_691_length_2889_cov_11.426882	1059	1138	46	1	79	0.0126582
NODE_691_length_2889_cov_11.426882	1059	1138	0	46	79	0.5822785
NODE_691_length_2889_cov_11.426882	1059	1138	4	2	79	0.0253165
NODE_691_length_2889_cov_11.426882	1059	1138	8	2	79	0.0253165
NODE_691_length_2889_cov_11.426882	1059	1138	10	1	79	0.0126582
NODE_691_length_2889_cov_11.426882	1059	1138	12	2	79	0.0253165
NODE_691_length_2889_cov_11.426882	1059	1138	14	2	79	0.0253165
NODE_691_length_2889_cov_11.426882	1059	1138	16	2	79	0.0253165
NODE_691_length_2889_cov_11.426882	1059	1138	20	3	79	0.0379747
NODE_691_length_2889_cov_11.426882	1059	1138	24	2	79	0.0253165
NODE_691_length_2889_cov_11.426882	1059	1138	26	1	79	0.0126582
NODE_691_length_2889_cov_11.426882	1059	1138	28	1	79	0.0126582
NODE_691_length_2889_cov_11.426882	1059	1138	29	5	79	0.0632911
NODE_691_length_2889_cov_11.426882	1059	1138	37	2	79	0.0253165
NODE_691_length_2889_cov_11.426882	1059	1138	39	1	79	0.0126582
NODE_691_length_2889_cov_11.426882	1059	1138	42	1	79	0.0126582
NODE_691_length_2889_cov_11.426882	1059	1138	44	5	79	0.0632911
NODE_691_length_2889_cov_11.426882	1059	1138	46	1	79	0.0126582
NODE_693_length_2888_cov_3.789172	992	1072	10	52	80	0.6500000
NODE_693_length_2888_cov_3.789172	992	1072	12	14	80	0.1750000
NODE_693_length_2888_cov_3.789172	992	1072	14	14	80	0.1750000
NODE_693_length_2888_cov_3.789172	1045	1087	6	15	42	0.3571429
NODE_693_length_2888_cov_3.789172	1045	1087	10	27	42	0.6428571
NODE_697_length_2878_cov_6.277798	2712	2781	2	4	69	0.0579710
NODE_697_length_2878_cov_6.277798	2712	2781	4	35	69	0.5072464
NODE_697_length_2878_cov_6.277798	2712	2781	6	5	69	0.0724638
NODE_697_length_2878_cov_6.277798	2712	2781	8	25	69	0.3623188
NODE_703_length_2862_cov_9.060803	2409	2489	2	6	80	0.0750000
NODE_703_length_2862_cov_9.060803	2409	2489	5	25	80	0.3125000
NODE_703_length_2862_cov_9.060803	2409	2489	8	26	80	0.3250000
NODE_703_length_2862_cov_9.060803	2409	2489	10	5	80	0.0625000
NODE_703_length_2862_cov_9.060803	2409	2489	20	18	80	0.2250000
NODE_703_length_2862_cov_9.060803	2462	2542	8	4	80	0.0500000
NODE_703_length_2862_cov_9.060803	2462	2542	10	5	80	0.0625000
NODE_703_length_2862_cov_9.060803	2462	2542	16	22	80	0.2750000
NODE_703_length_2862_cov_9.060803	2462	2542	17	1	80	0.0125000
NODE_703_length_2862_cov_9.060803	2462	2542	18	1	80	0.0125000
NODE_703_length_2862_cov_9.060803	2462	2542	19	9	80	0.1125000
NODE_703_length_2862_cov_9.060803	2462	2542	20	38	80	0.4750000
NODE_712_length_2840_cov_2.079533	1660	1740	2	64	80	0.8000000
NODE_712_length_2840_cov_2.079533	1660	1740	4	16	80	0.2000000
NODE_713_length_2839_cov_16.762044	327	402	0	41	75	0.5466667
NODE_713_length_2839_cov_16.762044	327	402	2	34	75	0.4533333
NODE_713_length_2839_cov_16.762044	380	468	0	63	88	0.7159091
NODE_713_length_2839_cov_16.762044	380	468	2	25	88	0.2840909
NODE_713_length_2839_cov_16.762044	1021	1101	0	80	80	1.0000000
NODE_713_length_2839_cov_16.762044	1074	1154	0	80	80	1.0000000
NODE_714_length_2835_cov_29.691520	1552	1581	139	1	29	0.0344828
NODE_714_length_2835_cov_29.691520	1552	1581	140	2	29	0.0689655
NODE_714_length_2835_cov_29.691520	1552	1581	142	1	29	0.0344828
NODE_714_length_2835_cov_29.691520	1552	1581	144	3	29	0.1034483
NODE_714_length_2835_cov_29.691520	1552	1581	146	1	29	0.0344828
NODE_714_length_2835_cov_29.691520	1552	1581	148	2	29	0.0689655
NODE_714_length_2835_cov_29.691520	1552	1581	150	3	29	0.1034483
NODE_714_length_2835_cov_29.691520	1552	1581	151	1	29	0.0344828
NODE_714_length_2835_cov_29.691520	1552	1581	153	2	29	0.0689655
NODE_714_length_2835_cov_29.691520	1552	1581	156	3	29	0.1034483
NODE_714_length_2835_cov_29.691520	1552	1581	159	3	29	0.1034483
NODE_714_length_2835_cov_29.691520	1552	1581	161	1	29	0.0344828
NODE_714_length_2835_cov_29.691520	1552	1581	163	1	29	0.0344828
NODE_714_length_2835_cov_29.691520	1552	1581	164	1	29	0.0344828
NODE_714_length_2835_cov_29.691520	1552	1581	165	1	29	0.0344828
NODE_714_length_2835_cov_29.691520	1552	1581	167	1	29	0.0344828
NODE_714_length_2835_cov_29.691520	1552	1581	169	1	29	0.0344828
NODE_714_length_2835_cov_29.691520	1552	1581	172	1	29	0.0344828
NODE_714_length_2835_cov_29.691520	1554	1629	26	1	75	0.0133333
NODE_714_length_2835_cov_29.691520	1554	1629	27	1	75	0.0133333
NODE_714_length_2835_cov_29.691520	1554	1629	31	1	75	0.0133333
NODE_714_length_2835_cov_29.691520	1554	1629	33	1	75	0.0133333
NODE_714_length_2835_cov_29.691520	1554	1629	35	4	75	0.0533333
NODE_714_length_2835_cov_29.691520	1554	1629	37	2	75	0.0266667
NODE_714_length_2835_cov_29.691520	1554	1629	40	1	75	0.0133333
NODE_714_length_2835_cov_29.691520	1554	1629	46	1	75	0.0133333
NODE_714_length_2835_cov_29.691520	1554	1629	52	1	75	0.0133333
NODE_714_length_2835_cov_29.691520	1554	1629	56	1	75	0.0133333
NODE_714_length_2835_cov_29.691520	1554	1629	62	2	75	0.0266667
NODE_714_length_2835_cov_29.691520	1554	1629	66	1	75	0.0133333
NODE_714_length_2835_cov_29.691520	1554	1629	69	2	75	0.0266667
NODE_714_length_2835_cov_29.691520	1554	1629	79	1	75	0.0133333
NODE_714_length_2835_cov_29.691520	1554	1629	82	1	75	0.0133333
NODE_714_length_2835_cov_29.691520	1554	1629	85	1	75	0.0133333
NODE_714_length_2835_cov_29.691520	1554	1629	89	1	75	0.0133333
NODE_714_length_2835_cov_29.691520	1554	1629	91	1	75	0.0133333
NODE_714_length_2835_cov_29.691520	1554	1629	97	1	75	0.0133333
NODE_714_length_2835_cov_29.691520	1554	1629	98	1	75	0.0133333
NODE_714_length_2835_cov_29.691520	1554	1629	102	3	75	0.0400000
NODE_714_length_2835_cov_29.691520	1554	1629	105	4	75	0.0533333
NODE_714_length_2835_cov_29.691520	1554	1629	107	1	75	0.0133333
NODE_714_length_2835_cov_29.691520	1554	1629	109	1	75	0.0133333
NODE_714_length_2835_cov_29.691520	1554	1629	111	1	75	0.0133333
NODE_714_length_2835_cov_29.691520	1554	1629	113	1	75	0.0133333
NODE_714_length_2835_cov_29.691520	1554	1629	115	1	75	0.0133333
NODE_714_length_2835_cov_29.691520	1554	1629	121	1	75	0.0133333
NODE_714_length_2835_cov_29.691520	1554	1629	126	1	75	0.0133333
NODE_714_length_2835_cov_29.691520	1554	1629	129	1	75	0.0133333
NODE_714_length_2835_cov_29.691520	1554	1629	133	1	75	0.0133333
NODE_714_length_2835_cov_29.691520	1554	1629	135	2	75	0.0266667
NODE_714_length_2835_cov_29.691520	1554	1629	137	1	75	0.0133333
NODE_714_length_2835_cov_29.691520	1554	1629	139	4	75	0.0533333
NODE_714_length_2835_cov_29.691520	1554	1629	140	2	75	0.0266667
NODE_714_length_2835_cov_29.691520	1554	1629	142	1	75	0.0133333
NODE_714_length_2835_cov_29.691520	1554	1629	144	3	75	0.0400000
NODE_714_length_2835_cov_29.691520	1554	1629	146	1	75	0.0133333
NODE_714_length_2835_cov_29.691520	1554	1629	148	2	75	0.0266667
NODE_714_length_2835_cov_29.691520	1554	1629	150	3	75	0.0400000
NODE_714_length_2835_cov_29.691520	1554	1629	151	1	75	0.0133333
NODE_714_length_2835_cov_29.691520	1554	1629	153	2	75	0.0266667
NODE_714_length_2835_cov_29.691520	1554	1629	156	3	75	0.0400000
NODE_714_length_2835_cov_29.691520	1554	1629	159	3	75	0.0400000
NODE_714_length_2835_cov_29.691520	1554	1629	161	1	75	0.0133333
NODE_714_length_2835_cov_29.691520	1554	1629	163	1	75	0.0133333
NODE_714_length_2835_cov_29.691520	1554	1629	164	1	75	0.0133333
NODE_714_length_2835_cov_29.691520	1554	1629	165	1	75	0.0133333
NODE_714_length_2835_cov_29.691520	1554	1629	167	1	75	0.0133333
NODE_720_length_2825_cov_9.731108	487	567	2	49	80	0.6125000
NODE_720_length_2825_cov_9.731108	487	567	4	31	80	0.3875000
NODE_720_length_2825_cov_9.731108	540	620	0	42	80	0.5250000
NODE_720_length_2825_cov_9.731108	540	620	2	38	80	0.4750000
NODE_726_length_2810_cov_2.844338	206	289	25	3	83	0.0361446
NODE_726_length_2810_cov_2.844338	206	289	27	1	83	0.0120482
NODE_726_length_2810_cov_2.844338	206	289	30	1	83	0.0120482
NODE_726_length_2810_cov_2.844338	206	289	31	4	83	0.0481928
NODE_726_length_2810_cov_2.844338	206	289	36	2	83	0.0240964
NODE_726_length_2810_cov_2.844338	206	289	38	1	83	0.0120482
NODE_726_length_2810_cov_2.844338	206	289	44	1	83	0.0120482
NODE_726_length_2810_cov_2.844338	206	289	46	6	83	0.0722892
NODE_726_length_2810_cov_2.844338	206	289	50	3	83	0.0361446
NODE_726_length_2810_cov_2.844338	206	289	52	4	83	0.0481928
NODE_726_length_2810_cov_2.844338	206	289	56	2	83	0.0240964
NODE_726_length_2810_cov_2.844338	206	289	58	3	83	0.0361446
NODE_726_length_2810_cov_2.844338	206	289	60	9	83	0.1084337
NODE_726_length_2810_cov_2.844338	206	289	62	4	83	0.0481928
NODE_726_length_2810_cov_2.844338	206	289	65	1	83	0.0120482
NODE_726_length_2810_cov_2.844338	206	289	66	1	83	0.0120482
NODE_726_length_2810_cov_2.844338	206	289	68	1	83	0.0120482
NODE_726_length_2810_cov_2.844338	206	289	79	8	83	0.0963855
NODE_726_length_2810_cov_2.844338	206	289	82	1	83	0.0120482
NODE_726_length_2810_cov_2.844338	206	289	83	2	83	0.0240964
NODE_726_length_2810_cov_2.844338	206	289	84	3	83	0.0361446
NODE_726_length_2810_cov_2.844338	206	289	85	3	83	0.0361446
NODE_726_length_2810_cov_2.844338	206	289	86	3	83	0.0361446
NODE_726_length_2810_cov_2.844338	206	289	87	5	83	0.0602410
NODE_726_length_2810_cov_2.844338	206	289	93	1	83	0.0120482
NODE_726_length_2810_cov_2.844338	206	289	98	2	83	0.0240964
NODE_726_length_2810_cov_2.844338	206	289	105	1	83	0.0120482
NODE_726_length_2810_cov_2.844338	206	289	106	2	83	0.0240964
NODE_726_length_2810_cov_2.844338	206	289	107	2	83	0.0240964
NODE_726_length_2810_cov_2.844338	206	289	108	3	83	0.0361446
NODE_728_length_2808_cov_2.867110	140	163	10	10	23	0.4347826
NODE_728_length_2808_cov_2.867110	140	163	14	13	23	0.5652174
NODE_729_length_2807_cov_8.423191	125	205	4	6	80	0.0750000
NODE_729_length_2807_cov_8.423191	125	205	6	15	80	0.1875000
NODE_729_length_2807_cov_8.423191	125	205	10	2	80	0.0250000
NODE_729_length_2807_cov_8.423191	125	205	12	24	80	0.3000000
NODE_729_length_2807_cov_8.423191	125	205	13	4	80	0.0500000
NODE_729_length_2807_cov_8.423191	125	205	17	29	80	0.3625000
NODE_729_length_2807_cov_8.423191	178	258	8	15	80	0.1875000
NODE_729_length_2807_cov_8.423191	178	258	9	8	80	0.1000000
NODE_729_length_2807_cov_8.423191	178	258	10	22	80	0.2750000
NODE_729_length_2807_cov_8.423191	178	258	12	25	80	0.3125000
NODE_729_length_2807_cov_8.423191	178	258	13	4	80	0.0500000
NODE_729_length_2807_cov_8.423191	178	258	17	6	80	0.0750000
NODE_729_length_2807_cov_8.423191	2451	2515	2	42	64	0.6562500
NODE_729_length_2807_cov_8.423191	2451	2515	4	22	64	0.3437500
NODE_735_length_2801_cov_26.131384	461	521	8	60	60	1.0000000
NODE_735_length_2801_cov_26.131384	494	574	0	48	80	0.6000000
NODE_735_length_2801_cov_26.131384	494	574	8	32	80	0.4000000
NODE_735_length_2801_cov_26.131384	1536	1596	38	2	60	0.0333333
NODE_735_length_2801_cov_26.131384	1536	1596	40	5	60	0.0833333
NODE_735_length_2801_cov_26.131384	1536	1596	41	3	60	0.0500000
NODE_735_length_2801_cov_26.131384	1536	1596	43	2	60	0.0333333
NODE_735_length_2801_cov_26.131384	1536	1596	46	1	60	0.0166667
NODE_735_length_2801_cov_26.131384	1536	1596	50	1	60	0.0166667
NODE_735_length_2801_cov_26.131384	1536	1596	53	1	60	0.0166667
NODE_735_length_2801_cov_26.131384	1536	1596	57	1	60	0.0166667
NODE_735_length_2801_cov_26.131384	1536	1596	63	2	60	0.0333333
NODE_735_length_2801_cov_26.131384	1536	1596	65	1	60	0.0166667
NODE_735_length_2801_cov_26.131384	1536	1596	69	1	60	0.0166667
NODE_735_length_2801_cov_26.131384	1536	1596	78	1	60	0.0166667
NODE_735_length_2801_cov_26.131384	1536	1596	80	1	60	0.0166667
NODE_735_length_2801_cov_26.131384	1536	1596	82	1	60	0.0166667
NODE_735_length_2801_cov_26.131384	1536	1596	83	1	60	0.0166667
NODE_735_length_2801_cov_26.131384	1536	1596	85	3	60	0.0500000
NODE_735_length_2801_cov_26.131384	1536	1596	87	1	60	0.0166667
NODE_735_length_2801_cov_26.131384	1536	1596	89	1	60	0.0166667
NODE_735_length_2801_cov_26.131384	1536	1596	95	2	60	0.0333333
NODE_735_length_2801_cov_26.131384	1536	1596	99	1	60	0.0166667
NODE_735_length_2801_cov_26.131384	1536	1596	106	1	60	0.0166667
NODE_735_length_2801_cov_26.131384	1536	1596	110	1	60	0.0166667
NODE_735_length_2801_cov_26.131384	1536	1596	112	4	60	0.0666667
NODE_735_length_2801_cov_26.131384	1536	1596	116	3	60	0.0500000
NODE_735_length_2801_cov_26.131384	1536	1596	118	3	60	0.0500000
NODE_735_length_2801_cov_26.131384	1536	1596	120	1	60	0.0166667
NODE_735_length_2801_cov_26.131384	1536	1596	121	5	60	0.0833333
NODE_735_length_2801_cov_26.131384	1536	1596	123	1	60	0.0166667
NODE_735_length_2801_cov_26.131384	1536	1596	127	1	60	0.0166667
NODE_735_length_2801_cov_26.131384	1536	1596	130	2	60	0.0333333
NODE_735_length_2801_cov_26.131384	1536	1596	134	2	60	0.0333333
NODE_735_length_2801_cov_26.131384	1536	1596	137	1	60	0.0166667
NODE_735_length_2801_cov_26.131384	1536	1596	140	3	60	0.0500000
NODE_735_length_2801_cov_26.131384	1815	1881	2	13	66	0.1969697
NODE_735_length_2801_cov_26.131384	1815	1881	4	44	66	0.6666667
NODE_735_length_2801_cov_26.131384	1815	1881	5	9	66	0.1363636
NODE_735_length_2801_cov_26.131384	1854	1934	2	4	80	0.0500000
NODE_735_length_2801_cov_26.131384	1854	1934	3	3	80	0.0375000
NODE_735_length_2801_cov_26.131384	1854	1934	4	49	80	0.6125000
NODE_735_length_2801_cov_26.131384	1854	1934	5	24	80	0.3000000
NODE_736_length_2801_cov_3.594375	2589	2645	0	56	56	1.0000000
NODE_738_length_2796_cov_94.511680	1090	1137	37	1	47	0.0212766
NODE_738_length_2796_cov_94.511680	1090	1137	41	1	47	0.0212766
NODE_738_length_2796_cov_94.511680	1090	1137	43	1	47	0.0212766
NODE_738_length_2796_cov_94.511680	1090	1137	44	6	47	0.1276596
NODE_738_length_2796_cov_94.511680	1090	1137	45	1	47	0.0212766
NODE_738_length_2796_cov_94.511680	1090	1137	47	1	47	0.0212766
NODE_738_length_2796_cov_94.511680	1090	1137	52	1	47	0.0212766
NODE_738_length_2796_cov_94.511680	1090	1137	53	1	47	0.0212766
NODE_738_length_2796_cov_94.511680	1090	1137	54	3	47	0.0638298
NODE_738_length_2796_cov_94.511680	1090	1137	56	5	47	0.1063830
NODE_738_length_2796_cov_94.511680	1090	1137	58	1	47	0.0212766
NODE_738_length_2796_cov_94.511680	1090	1137	60	1	47	0.0212766
NODE_738_length_2796_cov_94.511680	1090	1137	71	2	47	0.0425532
NODE_738_length_2796_cov_94.511680	1090	1137	75	1	47	0.0212766
NODE_738_length_2796_cov_94.511680	1090	1137	80	1	47	0.0212766
NODE_738_length_2796_cov_94.511680	1090	1137	82	1	47	0.0212766
NODE_738_length_2796_cov_94.511680	1090	1137	84	1	47	0.0212766
NODE_738_length_2796_cov_94.511680	1090	1137	86	2	47	0.0425532
NODE_738_length_2796_cov_94.511680	1090	1137	88	1	47	0.0212766
NODE_738_length_2796_cov_94.511680	1090	1137	89	1	47	0.0212766
NODE_738_length_2796_cov_94.511680	1090	1137	91	1	47	0.0212766
NODE_738_length_2796_cov_94.511680	1090	1137	92	2	47	0.0425532
NODE_738_length_2796_cov_94.511680	1090	1137	93	1	47	0.0212766
NODE_738_length_2796_cov_94.511680	1090	1137	94	1	47	0.0212766
NODE_738_length_2796_cov_94.511680	1090	1137	98	1	47	0.0212766
NODE_738_length_2796_cov_94.511680	1090	1137	102	1	47	0.0212766
NODE_738_length_2796_cov_94.511680	1090	1137	105	1	47	0.0212766
NODE_738_length_2796_cov_94.511680	1090	1137	109	2	47	0.0425532
NODE_738_length_2796_cov_94.511680	1090	1137	110	1	47	0.0212766
NODE_738_length_2796_cov_94.511680	1090	1137	116	1	47	0.0212766
NODE_738_length_2796_cov_94.511680	1090	1137	119	2	47	0.0425532
NODE_738_length_2796_cov_94.511680	2717	2796	0	79	79	1.0000000
NODE_744_length_2791_cov_9.997028	310	390	0	80	80	1.0000000
NODE_744_length_2791_cov_9.997028	363	443	0	80	80	1.0000000
NODE_752_length_2778_cov_31.340799	2241	2321	0	25	80	0.3125000
NODE_752_length_2778_cov_31.340799	2241	2321	4	6	80	0.0750000
NODE_752_length_2778_cov_31.340799	2241	2321	5	2	80	0.0250000
NODE_752_length_2778_cov_31.340799	2241	2321	6	47	80	0.5875000
NODE_752_length_2778_cov_31.340799	2294	2374	0	53	80	0.6625000
NODE_752_length_2778_cov_31.340799	2294	2374	6	27	80	0.3375000
NODE_752_length_2778_cov_31.340799	2370	2450	0	27	80	0.3375000
NODE_752_length_2778_cov_31.340799	2370	2450	2	53	80	0.6625000
NODE_752_length_2778_cov_31.340799	2423	2503	0	24	80	0.3000000
NODE_752_length_2778_cov_31.340799	2423	2503	2	56	80	0.7000000
NODE_752_length_2778_cov_31.340799	2564	2620	0	56	56	1.0000000
NODE_758_length_2767_cov_12.450150	1941	2021	0	80	80	1.0000000
NODE_758_length_2767_cov_12.450150	1994	2074	0	80	80	1.0000000
NODE_767_length_2745_cov_5.322751	511	583	0	19	72	0.2638889
NODE_767_length_2745_cov_5.322751	511	583	2	53	72	0.7361111
NODE_777_length_2720_cov_25.561618	2213	2293	0	80	80	1.0000000
NODE_777_length_2720_cov_25.561618	2266	2346	0	80	80	1.0000000
NODE_782_length_2716_cov_39.885747	715	795	22	5	80	0.0625000
NODE_782_length_2716_cov_39.885747	715	795	24	2	80	0.0250000
NODE_782_length_2716_cov_39.885747	715	795	26	2	80	0.0250000
NODE_782_length_2716_cov_39.885747	715	795	28	7	80	0.0875000
NODE_782_length_2716_cov_39.885747	715	795	30	10	80	0.1250000
NODE_782_length_2716_cov_39.885747	715	795	32	4	80	0.0500000
NODE_782_length_2716_cov_39.885747	715	795	33	1	80	0.0125000
NODE_782_length_2716_cov_39.885747	715	795	34	27	80	0.3375000
NODE_782_length_2716_cov_39.885747	715	795	36	22	80	0.2750000
NODE_782_length_2716_cov_39.885747	768	848	8	1	80	0.0125000
NODE_782_length_2716_cov_39.885747	768	848	10	7	80	0.0875000
NODE_782_length_2716_cov_39.885747	768	848	12	6	80	0.0750000
NODE_782_length_2716_cov_39.885747	768	848	14	8	80	0.1000000
NODE_782_length_2716_cov_39.885747	768	848	16	1	80	0.0125000
NODE_782_length_2716_cov_39.885747	768	848	18	14	80	0.1750000
NODE_782_length_2716_cov_39.885747	768	848	20	14	80	0.1750000
NODE_782_length_2716_cov_39.885747	768	848	22	7	80	0.0875000
NODE_782_length_2716_cov_39.885747	768	848	26	2	80	0.0250000
NODE_782_length_2716_cov_39.885747	768	848	28	7	80	0.0875000
NODE_782_length_2716_cov_39.885747	768	848	30	1	80	0.0125000
NODE_782_length_2716_cov_39.885747	768	848	32	4	80	0.0500000
NODE_782_length_2716_cov_39.885747	768	848	33	1	80	0.0125000
NODE_782_length_2716_cov_39.885747	768	848	34	6	80	0.0750000
NODE_782_length_2716_cov_39.885747	768	848	36	1	80	0.0125000
NODE_782_length_2716_cov_39.885747	844	924	6	7	80	0.0875000
NODE_782_length_2716_cov_39.885747	844	924	8	1	80	0.0125000
NODE_782_length_2716_cov_39.885747	844	924	9	2	80	0.0250000
NODE_782_length_2716_cov_39.885747	844	924	10	37	80	0.4625000
NODE_782_length_2716_cov_39.885747	844	924	14	20	80	0.2500000
NODE_782_length_2716_cov_39.885747	844	924	16	13	80	0.1625000
NODE_782_length_2716_cov_39.885747	897	977	12	3	80	0.0375000
NODE_782_length_2716_cov_39.885747	897	977	13	9	80	0.1125000
NODE_782_length_2716_cov_39.885747	897	977	14	28	80	0.3500000
NODE_782_length_2716_cov_39.885747	897	977	15	1	80	0.0125000
NODE_782_length_2716_cov_39.885747	897	977	16	38	80	0.4750000
NODE_782_length_2716_cov_39.885747	897	977	17	1	80	0.0125000
NODE_785_length_2710_cov_10.896974	2410	2446	0	14	36	0.3888889
NODE_785_length_2710_cov_10.896974	2410	2446	2	22	36	0.6111111
NODE_785_length_2710_cov_10.896974	2419	2499	0	5	80	0.0625000
NODE_785_length_2710_cov_10.896974	2419	2499	2	75	80	0.9375000
NODE_788_length_2708_cov_25.097355	2289	2369	0	31	80	0.3875000
NODE_788_length_2708_cov_25.097355	2289	2369	2	49	80	0.6125000
NODE_788_length_2708_cov_25.097355	2342	2422	0	22	80	0.2750000
NODE_788_length_2708_cov_25.097355	2342	2422	2	58	80	0.7250000
NODE_789_length_2708_cov_14.569950	18	98	146	2	80	0.0250000
NODE_789_length_2708_cov_14.569950	18	98	148	1	80	0.0125000
NODE_789_length_2708_cov_14.569950	18	98	154	2	80	0.0250000
NODE_789_length_2708_cov_14.569950	18	98	156	2	80	0.0250000
NODE_789_length_2708_cov_14.569950	18	98	158	3	80	0.0375000
NODE_789_length_2708_cov_14.569950	18	98	160	1	80	0.0125000
NODE_789_length_2708_cov_14.569950	18	98	162	2	80	0.0250000
NODE_789_length_2708_cov_14.569950	18	98	163	1	80	0.0125000
NODE_789_length_2708_cov_14.569950	18	98	165	1	80	0.0125000
NODE_789_length_2708_cov_14.569950	18	98	167	5	80	0.0625000
NODE_789_length_2708_cov_14.569950	18	98	169	60	80	0.7500000
NODE_789_length_2708_cov_14.569950	71	134	10	1	63	0.0158730
NODE_789_length_2708_cov_14.569950	71	134	14	1	63	0.0158730
NODE_789_length_2708_cov_14.569950	71	134	36	1	63	0.0158730
NODE_789_length_2708_cov_14.569950	71	134	53	1	63	0.0158730
NODE_789_length_2708_cov_14.569950	71	134	71	1	63	0.0158730
NODE_789_length_2708_cov_14.569950	71	134	84	1	63	0.0158730
NODE_789_length_2708_cov_14.569950	71	134	96	1	63	0.0158730
NODE_789_length_2708_cov_14.569950	71	134	108	1	63	0.0158730
NODE_789_length_2708_cov_14.569950	71	134	112	1	63	0.0158730
NODE_789_length_2708_cov_14.569950	71	134	120	1	63	0.0158730
NODE_789_length_2708_cov_14.569950	71	134	130	1	63	0.0158730
NODE_789_length_2708_cov_14.569950	71	134	136	1	63	0.0158730
NODE_789_length_2708_cov_14.569950	71	134	138	1	63	0.0158730
NODE_789_length_2708_cov_14.569950	71	134	140	3	63	0.0476190
NODE_789_length_2708_cov_14.569950	71	134	142	2	63	0.0317460
NODE_789_length_2708_cov_14.569950	71	134	150	1	63	0.0158730
NODE_789_length_2708_cov_14.569950	71	134	156	1	63	0.0158730
NODE_789_length_2708_cov_14.569950	71	134	158	1	63	0.0158730
NODE_789_length_2708_cov_14.569950	71	134	159	2	63	0.0317460
NODE_789_length_2708_cov_14.569950	71	134	163	1	63	0.0158730
NODE_789_length_2708_cov_14.569950	71	134	167	7	63	0.1111111
NODE_789_length_2708_cov_14.569950	71	134	169	32	63	0.5079365
NODE_797_length_2691_cov_35.457948	401	481	0	80	80	1.0000000
NODE_797_length_2691_cov_35.457948	454	534	0	80	80	1.0000000
NODE_803_length_2684_cov_17.345068	146	194	0	48	48	1.0000000
NODE_803_length_2684_cov_17.345068	146	194	0	48	48	1.0000000
NODE_803_length_2684_cov_17.345068	146	194	0	48	48	1.0000000
NODE_803_length_2684_cov_17.345068	146	194	0	48	48	1.0000000
NODE_803_length_2684_cov_17.345068	146	194	0	48	48	1.0000000
NODE_805_length_2682_cov_43.500581	913	992	392	1	79	0.0126582
NODE_805_length_2682_cov_43.500581	913	992	393	2	79	0.0253165
NODE_805_length_2682_cov_43.500581	913	992	395	2	79	0.0253165
NODE_805_length_2682_cov_43.500581	913	992	397	1	79	0.0126582
NODE_805_length_2682_cov_43.500581	913	992	399	2	79	0.0253165
NODE_805_length_2682_cov_43.500581	913	992	410	1	79	0.0126582
NODE_805_length_2682_cov_43.500581	913	992	412	1	79	0.0126582
NODE_805_length_2682_cov_43.500581	913	992	414	1	79	0.0126582
NODE_805_length_2682_cov_43.500581	913	992	421	1	79	0.0126582
NODE_805_length_2682_cov_43.500581	913	992	423	2	79	0.0253165
NODE_805_length_2682_cov_43.500581	913	992	424	1	79	0.0126582
NODE_805_length_2682_cov_43.500581	913	992	425	1	79	0.0126582
NODE_805_length_2682_cov_43.500581	913	992	426	1	79	0.0126582
NODE_805_length_2682_cov_43.500581	913	992	427	1	79	0.0126582
NODE_805_length_2682_cov_43.500581	913	992	428	1	79	0.0126582
NODE_805_length_2682_cov_43.500581	913	992	431	2	79	0.0253165
NODE_805_length_2682_cov_43.500581	913	992	440	3	79	0.0379747
NODE_805_length_2682_cov_43.500581	913	992	448	1	79	0.0126582
NODE_805_length_2682_cov_43.500581	913	992	453	1	79	0.0126582
NODE_805_length_2682_cov_43.500581	913	992	462	1	79	0.0126582
NODE_805_length_2682_cov_43.500581	913	992	479	1	79	0.0126582
NODE_805_length_2682_cov_43.500581	913	992	498	1	79	0.0126582
NODE_805_length_2682_cov_43.500581	913	992	511	1	79	0.0126582
NODE_805_length_2682_cov_43.500581	913	992	527	1	79	0.0126582
NODE_805_length_2682_cov_43.500581	913	992	534	1	79	0.0126582
NODE_805_length_2682_cov_43.500581	913	992	536	1	79	0.0126582
NODE_805_length_2682_cov_43.500581	913	992	538	2	79	0.0253165
NODE_805_length_2682_cov_43.500581	913	992	542	1	79	0.0126582
NODE_805_length_2682_cov_43.500581	913	992	568	1	79	0.0126582
NODE_805_length_2682_cov_43.500581	913	992	579	1	79	0.0126582
NODE_805_length_2682_cov_43.500581	913	992	581	2	79	0.0253165
NODE_805_length_2682_cov_43.500581	913	992	583	1	79	0.0126582
NODE_805_length_2682_cov_43.500581	913	992	599	1	79	0.0126582
NODE_805_length_2682_cov_43.500581	913	992	604	1	79	0.0126582
NODE_805_length_2682_cov_43.500581	913	992	606	1	79	0.0126582
NODE_805_length_2682_cov_43.500581	913	992	607	1	79	0.0126582
NODE_805_length_2682_cov_43.500581	913	992	611	2	79	0.0253165
NODE_805_length_2682_cov_43.500581	913	992	613	1	79	0.0126582
NODE_805_length_2682_cov_43.500581	913	992	615	3	79	0.0379747
NODE_805_length_2682_cov_43.500581	913	992	616	1	79	0.0126582
NODE_805_length_2682_cov_43.500581	913	992	617	3	79	0.0379747
NODE_805_length_2682_cov_43.500581	913	992	619	1	79	0.0126582
NODE_805_length_2682_cov_43.500581	913	992	622	1	79	0.0126582
NODE_805_length_2682_cov_43.500581	913	992	624	1	79	0.0126582
NODE_805_length_2682_cov_43.500581	913	992	625	1	79	0.0126582
NODE_805_length_2682_cov_43.500581	913	992	626	2	79	0.0253165
NODE_805_length_2682_cov_43.500581	913	992	628	1	79	0.0126582
NODE_805_length_2682_cov_43.500581	913	992	629	1	79	0.0126582
NODE_805_length_2682_cov_43.500581	913	992	630	1	79	0.0126582
NODE_805_length_2682_cov_43.500581	913	992	633	3	79	0.0379747
NODE_805_length_2682_cov_43.500581	913	992	634	1	79	0.0126582
NODE_805_length_2682_cov_43.500581	913	992	635	1	79	0.0126582
NODE_805_length_2682_cov_43.500581	913	992	638	1	79	0.0126582
NODE_805_length_2682_cov_43.500581	913	992	643	1	79	0.0126582
NODE_805_length_2682_cov_43.500581	913	992	653	1	79	0.0126582
NODE_805_length_2682_cov_43.500581	913	992	676	1	79	0.0126582
NODE_805_length_2682_cov_43.500581	913	992	677	1	79	0.0126582
NODE_805_length_2682_cov_43.500581	913	992	679	1	79	0.0126582
NODE_805_length_2682_cov_43.500581	913	992	685	1	79	0.0126582
NODE_805_length_2682_cov_43.500581	913	992	686	2	79	0.0253165
NODE_805_length_2682_cov_43.500581	913	992	691	1	79	0.0126582
NODE_805_length_2682_cov_43.500581	965	1002	366	1	37	0.0270270
NODE_805_length_2682_cov_43.500581	965	1002	372	1	37	0.0270270
NODE_805_length_2682_cov_43.500581	965	1002	374	1	37	0.0270270
NODE_805_length_2682_cov_43.500581	965	1002	381	1	37	0.0270270
NODE_805_length_2682_cov_43.500581	965	1002	383	2	37	0.0540541
NODE_805_length_2682_cov_43.500581	965	1002	385	1	37	0.0270270
NODE_805_length_2682_cov_43.500581	965	1002	386	1	37	0.0270270
NODE_805_length_2682_cov_43.500581	965	1002	388	1	37	0.0270270
NODE_805_length_2682_cov_43.500581	965	1002	390	1	37	0.0270270
NODE_805_length_2682_cov_43.500581	965	1002	392	1	37	0.0270270
NODE_805_length_2682_cov_43.500581	965	1002	393	2	37	0.0540541
NODE_805_length_2682_cov_43.500581	965	1002	395	2	37	0.0540541
NODE_805_length_2682_cov_43.500581	965	1002	397	1	37	0.0270270
NODE_805_length_2682_cov_43.500581	965	1002	399	2	37	0.0540541
NODE_805_length_2682_cov_43.500581	965	1002	410	1	37	0.0270270
NODE_805_length_2682_cov_43.500581	965	1002	412	1	37	0.0270270
NODE_805_length_2682_cov_43.500581	965	1002	414	1	37	0.0270270
NODE_805_length_2682_cov_43.500581	965	1002	421	1	37	0.0270270
NODE_805_length_2682_cov_43.500581	965	1002	423	2	37	0.0540541
NODE_805_length_2682_cov_43.500581	965	1002	424	1	37	0.0270270
NODE_805_length_2682_cov_43.500581	965	1002	425	1	37	0.0270270
NODE_805_length_2682_cov_43.500581	965	1002	426	1	37	0.0270270
NODE_805_length_2682_cov_43.500581	965	1002	427	1	37	0.0270270
NODE_805_length_2682_cov_43.500581	965	1002	428	1	37	0.0270270
NODE_805_length_2682_cov_43.500581	965	1002	431	2	37	0.0540541
NODE_805_length_2682_cov_43.500581	965	1002	440	3	37	0.0810811
NODE_805_length_2682_cov_43.500581	965	1002	448	1	37	0.0270270
NODE_805_length_2682_cov_43.500581	965	1002	453	1	37	0.0270270
NODE_805_length_2682_cov_43.500581	965	1002	462	1	37	0.0270270
NODE_808_length_2675_cov_10.369565	209	289	28	12	80	0.1500000
NODE_808_length_2675_cov_10.369565	209	289	30	17	80	0.2125000
NODE_808_length_2675_cov_10.369565	209	289	32	14	80	0.1750000
NODE_808_length_2675_cov_10.369565	209	289	34	2	80	0.0250000
NODE_808_length_2675_cov_10.369565	209	289	36	6	80	0.0750000
NODE_808_length_2675_cov_10.369565	209	289	38	5	80	0.0625000
NODE_808_length_2675_cov_10.369565	209	289	40	2	80	0.0250000
NODE_808_length_2675_cov_10.369565	209	289	41	4	80	0.0500000
NODE_808_length_2675_cov_10.369565	209	289	42	1	80	0.0125000
NODE_808_length_2675_cov_10.369565	209	289	45	4	80	0.0500000
NODE_808_length_2675_cov_10.369565	209	289	47	7	80	0.0875000
NODE_808_length_2675_cov_10.369565	209	289	48	6	80	0.0750000
NODE_813_length_2670_cov_17.489304	1995	2075	0	80	80	1.0000000
NODE_813_length_2670_cov_17.489304	2048	2128	0	40	80	0.5000000
NODE_813_length_2670_cov_17.489304	2048	2128	8	40	80	0.5000000
NODE_813_length_2670_cov_17.489304	2124	2204	8	28	80	0.3500000
NODE_813_length_2670_cov_17.489304	2124	2204	10	52	80	0.6500000
NODE_813_length_2670_cov_17.489304	2177	2257	0	25	80	0.3125000
NODE_813_length_2670_cov_17.489304	2177	2257	2	17	80	0.2125000
NODE_813_length_2670_cov_17.489304	2177	2257	9	1	80	0.0125000
NODE_813_length_2670_cov_17.489304	2177	2257	10	37	80	0.4625000
NODE_815_length_2665_cov_19.145752	548	628	2	61	80	0.7625000
NODE_815_length_2665_cov_19.145752	548	628	4	19	80	0.2375000
NODE_815_length_2665_cov_19.145752	601	681	0	19	80	0.2375000
NODE_815_length_2665_cov_19.145752	601	681	1	9	80	0.1125000
NODE_815_length_2665_cov_19.145752	601	681	2	52	80	0.6500000
NODE_815_length_2665_cov_19.145752	2099	2176	0	50	77	0.6493506
NODE_815_length_2665_cov_19.145752	2099	2176	2	8	77	0.1038961
NODE_815_length_2665_cov_19.145752	2099	2176	4	19	77	0.2467532
NODE_815_length_2665_cov_19.145752	2172	2252	4	11	80	0.1375000
NODE_815_length_2665_cov_19.145752	2172	2252	6	3	80	0.0375000
NODE_815_length_2665_cov_19.145752	2172	2252	8	6	80	0.0750000
NODE_815_length_2665_cov_19.145752	2172	2252	10	60	80	0.7500000
NODE_815_length_2665_cov_19.145752	2172	2252	4	11	80	0.1375000
NODE_815_length_2665_cov_19.145752	2172	2252	6	3	80	0.0375000
NODE_815_length_2665_cov_19.145752	2172	2252	8	6	80	0.0750000
NODE_815_length_2665_cov_19.145752	2172	2252	10	60	80	0.7500000
NODE_815_length_2665_cov_19.145752	2225	2267	2	4	42	0.0952381
NODE_815_length_2665_cov_19.145752	2225	2267	4	8	42	0.1904762
NODE_815_length_2665_cov_19.145752	2225	2267	6	1	42	0.0238095
NODE_815_length_2665_cov_19.145752	2225	2267	8	4	42	0.0952381
NODE_815_length_2665_cov_19.145752	2225	2267	10	25	42	0.5952381
NODE_816_length_2664_cov_4.175049	2005	2085	8	6	80	0.0750000
NODE_816_length_2664_cov_4.175049	2005	2085	10	37	80	0.4625000
NODE_816_length_2664_cov_4.175049	2005	2085	12	37	80	0.4625000
NODE_816_length_2664_cov_4.175049	2058	2138	0	4	80	0.0500000
NODE_816_length_2664_cov_4.175049	2058	2138	4	42	80	0.5250000
NODE_816_length_2664_cov_4.175049	2058	2138	10	34	80	0.4250000
NODE_822_length_2650_cov_19.800862	800	880	35	1	80	0.0125000
NODE_822_length_2650_cov_19.800862	800	880	37	3	80	0.0375000
NODE_822_length_2650_cov_19.800862	800	880	38	3	80	0.0375000
NODE_822_length_2650_cov_19.800862	800	880	39	1	80	0.0125000
NODE_822_length_2650_cov_19.800862	800	880	43	1	80	0.0125000
NODE_822_length_2650_cov_19.800862	800	880	44	2	80	0.0250000
NODE_822_length_2650_cov_19.800862	800	880	45	14	80	0.1750000
NODE_822_length_2650_cov_19.800862	800	880	46	1	80	0.0125000
NODE_822_length_2650_cov_19.800862	800	880	47	4	80	0.0500000
NODE_822_length_2650_cov_19.800862	800	880	48	1	80	0.0125000
NODE_822_length_2650_cov_19.800862	800	880	49	2	80	0.0250000
NODE_822_length_2650_cov_19.800862	800	880	50	3	80	0.0375000
NODE_822_length_2650_cov_19.800862	800	880	51	2	80	0.0250000
NODE_822_length_2650_cov_19.800862	800	880	53	9	80	0.1125000
NODE_822_length_2650_cov_19.800862	800	880	54	14	80	0.1750000
NODE_822_length_2650_cov_19.800862	800	880	55	4	80	0.0500000
NODE_822_length_2650_cov_19.800862	800	880	56	9	80	0.1125000
NODE_822_length_2650_cov_19.800862	800	880	58	6	80	0.0750000
NODE_824_length_2645_cov_8.618225	931	1011	2	43	80	0.5375000
NODE_824_length_2645_cov_8.618225	931	1011	4	37	80	0.4625000
NODE_824_length_2645_cov_8.618225	984	1064	0	18	80	0.2250000
NODE_824_length_2645_cov_8.618225	984	1064	1	10	80	0.1250000
NODE_824_length_2645_cov_8.618225	984	1064	2	52	80	0.6500000
NODE_827_length_2640_cov_16.462810	94	164	227	1	70	0.0142857
NODE_827_length_2640_cov_16.462810	94	164	230	1	70	0.0142857
NODE_827_length_2640_cov_16.462810	94	164	232	1	70	0.0142857
NODE_827_length_2640_cov_16.462810	94	164	236	1	70	0.0142857
NODE_827_length_2640_cov_16.462810	94	164	240	1	70	0.0142857
NODE_827_length_2640_cov_16.462810	94	164	244	1	70	0.0142857
NODE_827_length_2640_cov_16.462810	94	164	246	2	70	0.0285714
NODE_827_length_2640_cov_16.462810	94	164	250	2	70	0.0285714
NODE_827_length_2640_cov_16.462810	94	164	254	1	70	0.0142857
NODE_827_length_2640_cov_16.462810	94	164	258	3	70	0.0428571
NODE_827_length_2640_cov_16.462810	94	164	267	1	70	0.0142857
NODE_827_length_2640_cov_16.462810	94	164	280	2	70	0.0285714
NODE_827_length_2640_cov_16.462810	94	164	292	3	70	0.0428571
NODE_827_length_2640_cov_16.462810	94	164	296	1	70	0.0142857
NODE_827_length_2640_cov_16.462810	94	164	297	1	70	0.0142857
NODE_827_length_2640_cov_16.462810	94	164	300	1	70	0.0142857
NODE_827_length_2640_cov_16.462810	94	164	308	1	70	0.0142857
NODE_827_length_2640_cov_16.462810	94	164	310	4	70	0.0571429
NODE_827_length_2640_cov_16.462810	94	164	311	1	70	0.0142857
NODE_827_length_2640_cov_16.462810	94	164	312	1	70	0.0142857
NODE_827_length_2640_cov_16.462810	94	164	314	2	70	0.0285714
NODE_827_length_2640_cov_16.462810	94	164	315	1	70	0.0142857
NODE_827_length_2640_cov_16.462810	94	164	316	4	70	0.0571429
NODE_827_length_2640_cov_16.462810	94	164	317	1	70	0.0142857
NODE_827_length_2640_cov_16.462810	94	164	318	1	70	0.0142857
NODE_827_length_2640_cov_16.462810	94	164	319	2	70	0.0285714
NODE_827_length_2640_cov_16.462810	94	164	320	1	70	0.0142857
NODE_827_length_2640_cov_16.462810	94	164	324	1	70	0.0142857
NODE_827_length_2640_cov_16.462810	94	164	332	1	70	0.0142857
NODE_827_length_2640_cov_16.462810	94	164	343	1	70	0.0142857
NODE_827_length_2640_cov_16.462810	94	164	362	1	70	0.0142857
NODE_827_length_2640_cov_16.462810	94	164	374	1	70	0.0142857
NODE_827_length_2640_cov_16.462810	94	164	388	1	70	0.0142857
NODE_827_length_2640_cov_16.462810	94	164	396	1	70	0.0142857
NODE_827_length_2640_cov_16.462810	94	164	406	1	70	0.0142857
NODE_827_length_2640_cov_16.462810	94	164	408	1	70	0.0142857
NODE_827_length_2640_cov_16.462810	94	164	413	2	70	0.0285714
NODE_827_length_2640_cov_16.462810	94	164	421	7	70	0.1000000
NODE_827_length_2640_cov_16.462810	94	164	423	8	70	0.1142857
NODE_827_length_2640_cov_16.462810	94	164	424	1	70	0.0142857
NODE_827_length_2640_cov_16.462810	94	164	425	1	70	0.0142857
NODE_827_length_2640_cov_16.462810	147	209	126	1	62	0.0161290
NODE_827_length_2640_cov_16.462810	147	209	128	1	62	0.0161290
NODE_827_length_2640_cov_16.462810	147	209	132	1	62	0.0161290
NODE_827_length_2640_cov_16.462810	147	209	134	1	62	0.0161290
NODE_827_length_2640_cov_16.462810	147	209	139	6	62	0.0967742
NODE_827_length_2640_cov_16.462810	147	209	140	2	62	0.0322581
NODE_827_length_2640_cov_16.462810	147	209	141	1	62	0.0161290
NODE_827_length_2640_cov_16.462810	147	209	142	4	62	0.0645161
NODE_827_length_2640_cov_16.462810	147	209	144	3	62	0.0483871
NODE_827_length_2640_cov_16.462810	147	209	146	1	62	0.0161290
NODE_827_length_2640_cov_16.462810	147	209	147	1	62	0.0161290
NODE_827_length_2640_cov_16.462810	147	209	150	1	62	0.0161290
NODE_827_length_2640_cov_16.462810	147	209	151	1	62	0.0161290
NODE_827_length_2640_cov_16.462810	147	209	162	1	62	0.0161290
NODE_827_length_2640_cov_16.462810	147	209	167	1	62	0.0161290
NODE_827_length_2640_cov_16.462810	147	209	170	3	62	0.0483871
NODE_827_length_2640_cov_16.462810	147	209	172	3	62	0.0483871
NODE_827_length_2640_cov_16.462810	147	209	174	1	62	0.0161290
NODE_827_length_2640_cov_16.462810	147	209	177	1	62	0.0161290
NODE_827_length_2640_cov_16.462810	147	209	178	1	62	0.0161290
NODE_827_length_2640_cov_16.462810	147	209	179	1	62	0.0161290
NODE_827_length_2640_cov_16.462810	147	209	181	2	62	0.0322581
NODE_827_length_2640_cov_16.462810	147	209	183	2	62	0.0322581
NODE_827_length_2640_cov_16.462810	147	209	191	1	62	0.0161290
NODE_827_length_2640_cov_16.462810	147	209	200	1	62	0.0161290
NODE_827_length_2640_cov_16.462810	147	209	208	1	62	0.0161290
NODE_827_length_2640_cov_16.462810	147	209	215	1	62	0.0161290
NODE_827_length_2640_cov_16.462810	147	209	223	1	62	0.0161290
NODE_827_length_2640_cov_16.462810	147	209	227	1	62	0.0161290
NODE_827_length_2640_cov_16.462810	147	209	230	1	62	0.0161290
NODE_827_length_2640_cov_16.462810	147	209	232	1	62	0.0161290
NODE_827_length_2640_cov_16.462810	147	209	236	1	62	0.0161290
NODE_827_length_2640_cov_16.462810	147	209	240	1	62	0.0161290
NODE_827_length_2640_cov_16.462810	147	209	244	1	62	0.0161290
NODE_827_length_2640_cov_16.462810	147	209	246	2	62	0.0322581
NODE_827_length_2640_cov_16.462810	147	209	250	2	62	0.0322581
NODE_827_length_2640_cov_16.462810	147	209	254	1	62	0.0161290
NODE_827_length_2640_cov_16.462810	147	209	258	3	62	0.0483871
NODE_827_length_2640_cov_16.462810	147	209	267	1	62	0.0161290
NODE_827_length_2640_cov_16.462810	147	209	280	2	62	0.0322581
NODE_828_length_2636_cov_200.191171	561	641	120	2	80	0.0250000
NODE_828_length_2636_cov_200.191171	561	641	122	1	80	0.0125000
NODE_828_length_2636_cov_200.191171	561	641	125	1	80	0.0125000
NODE_828_length_2636_cov_200.191171	561	641	128	1	80	0.0125000
NODE_828_length_2636_cov_200.191171	561	641	130	3	80	0.0375000
NODE_828_length_2636_cov_200.191171	561	641	131	1	80	0.0125000
NODE_828_length_2636_cov_200.191171	561	641	132	2	80	0.0250000
NODE_828_length_2636_cov_200.191171	561	641	133	2	80	0.0250000
NODE_828_length_2636_cov_200.191171	561	641	134	5	80	0.0625000
NODE_828_length_2636_cov_200.191171	561	641	136	1	80	0.0125000
NODE_828_length_2636_cov_200.191171	561	641	137	1	80	0.0125000
NODE_828_length_2636_cov_200.191171	561	641	138	3	80	0.0375000
NODE_828_length_2636_cov_200.191171	561	641	139	1	80	0.0125000
NODE_828_length_2636_cov_200.191171	561	641	140	1	80	0.0125000
NODE_828_length_2636_cov_200.191171	561	641	141	4	80	0.0500000
NODE_828_length_2636_cov_200.191171	561	641	142	1	80	0.0125000
NODE_828_length_2636_cov_200.191171	561	641	144	2	80	0.0250000
NODE_828_length_2636_cov_200.191171	561	641	147	3	80	0.0375000
NODE_828_length_2636_cov_200.191171	561	641	148	4	80	0.0500000
NODE_828_length_2636_cov_200.191171	561	641	149	5	80	0.0625000
NODE_828_length_2636_cov_200.191171	561	641	151	7	80	0.0875000
NODE_828_length_2636_cov_200.191171	561	641	153	1	80	0.0125000
NODE_828_length_2636_cov_200.191171	561	641	154	5	80	0.0625000
NODE_828_length_2636_cov_200.191171	561	641	155	11	80	0.1375000
NODE_828_length_2636_cov_200.191171	561	641	156	1	80	0.0125000
NODE_828_length_2636_cov_200.191171	561	641	157	8	80	0.1000000
NODE_828_length_2636_cov_200.191171	561	641	159	3	80	0.0375000
NODE_828_length_2636_cov_200.191171	614	695	31	4	81	0.0493827
NODE_828_length_2636_cov_200.191171	614	695	33	1	81	0.0123457
NODE_828_length_2636_cov_200.191171	614	695	40	1	81	0.0123457
NODE_828_length_2636_cov_200.191171	614	695	42	5	81	0.0617284
NODE_828_length_2636_cov_200.191171	614	695	47	3	81	0.0370370
NODE_828_length_2636_cov_200.191171	614	695	50	1	81	0.0123457
NODE_828_length_2636_cov_200.191171	614	695	51	2	81	0.0246914
NODE_828_length_2636_cov_200.191171	614	695	52	1	81	0.0123457
NODE_828_length_2636_cov_200.191171	614	695	53	1	81	0.0123457
NODE_828_length_2636_cov_200.191171	614	695	55	1	81	0.0123457
NODE_828_length_2636_cov_200.191171	614	695	62	1	81	0.0123457
NODE_828_length_2636_cov_200.191171	614	695	67	1	81	0.0123457
NODE_828_length_2636_cov_200.191171	614	695	69	3	81	0.0370370
NODE_828_length_2636_cov_200.191171	614	695	71	1	81	0.0123457
NODE_828_length_2636_cov_200.191171	614	695	73	2	81	0.0246914
NODE_828_length_2636_cov_200.191171	614	695	74	1	81	0.0123457
NODE_828_length_2636_cov_200.191171	614	695	78	1	81	0.0123457
NODE_828_length_2636_cov_200.191171	614	695	91	1	81	0.0123457
NODE_828_length_2636_cov_200.191171	614	695	92	2	81	0.0246914
NODE_828_length_2636_cov_200.191171	614	695	93	1	81	0.0123457
NODE_828_length_2636_cov_200.191171	614	695	95	1	81	0.0123457
NODE_828_length_2636_cov_200.191171	614	695	97	1	81	0.0123457
NODE_828_length_2636_cov_200.191171	614	695	99	3	81	0.0370370
NODE_828_length_2636_cov_200.191171	614	695	103	3	81	0.0370370
NODE_828_length_2636_cov_200.191171	614	695	109	1	81	0.0123457
NODE_828_length_2636_cov_200.191171	614	695	113	2	81	0.0246914
NODE_828_length_2636_cov_200.191171	614	695	115	2	81	0.0246914
NODE_828_length_2636_cov_200.191171	614	695	127	1	81	0.0123457
NODE_828_length_2636_cov_200.191171	614	695	130	3	81	0.0370370
NODE_828_length_2636_cov_200.191171	614	695	131	2	81	0.0246914
NODE_828_length_2636_cov_200.191171	614	695	132	2	81	0.0246914
NODE_828_length_2636_cov_200.191171	614	695	133	2	81	0.0246914
NODE_828_length_2636_cov_200.191171	614	695	134	3	81	0.0370370
NODE_828_length_2636_cov_200.191171	614	695	136	1	81	0.0123457
NODE_828_length_2636_cov_200.191171	614	695	138	3	81	0.0370370
NODE_828_length_2636_cov_200.191171	614	695	140	1	81	0.0123457
NODE_828_length_2636_cov_200.191171	614	695	141	1	81	0.0123457
NODE_828_length_2636_cov_200.191171	614	695	142	1	81	0.0123457
NODE_828_length_2636_cov_200.191171	614	695	144	2	81	0.0246914
NODE_828_length_2636_cov_200.191171	614	695	147	3	81	0.0370370
NODE_828_length_2636_cov_200.191171	614	695	148	2	81	0.0246914
NODE_828_length_2636_cov_200.191171	614	695	149	3	81	0.0370370
NODE_828_length_2636_cov_200.191171	614	695	151	4	81	0.0493827
NODE_830_length_2631_cov_10.831754	446	526	0	17	80	0.2125000
NODE_830_length_2631_cov_10.831754	446	526	2	12	80	0.1500000
NODE_830_length_2631_cov_10.831754	446	526	7	2	80	0.0250000
NODE_830_length_2631_cov_10.831754	446	526	8	32	80	0.4000000
NODE_830_length_2631_cov_10.831754	446	526	10	17	80	0.2125000
NODE_830_length_2631_cov_10.831754	499	572	8	36	73	0.4931507
NODE_830_length_2631_cov_10.831754	499	572	10	37	73	0.5068493
NODE_833_length_2622_cov_63.057471	1877	1953	234	1	76	0.0131579
NODE_833_length_2622_cov_63.057471	1877	1953	243	1	76	0.0131579
NODE_833_length_2622_cov_63.057471	1877	1953	247	1	76	0.0131579
NODE_833_length_2622_cov_63.057471	1877	1953	253	4	76	0.0526316
NODE_833_length_2622_cov_63.057471	1877	1953	255	1	76	0.0131579
NODE_833_length_2622_cov_63.057471	1877	1953	258	1	76	0.0131579
NODE_833_length_2622_cov_63.057471	1877	1953	262	2	76	0.0263158
NODE_833_length_2622_cov_63.057471	1877	1953	265	1	76	0.0131579
NODE_833_length_2622_cov_63.057471	1877	1953	267	1	76	0.0131579
NODE_833_length_2622_cov_63.057471	1877	1953	271	1	76	0.0131579
NODE_833_length_2622_cov_63.057471	1877	1953	273	1	76	0.0131579
NODE_833_length_2622_cov_63.057471	1877	1953	275	1	76	0.0131579
NODE_833_length_2622_cov_63.057471	1877	1953	277	1	76	0.0131579
NODE_833_length_2622_cov_63.057471	1877	1953	280	2	76	0.0263158
NODE_833_length_2622_cov_63.057471	1877	1953	281	1	76	0.0131579
NODE_833_length_2622_cov_63.057471	1877	1953	282	1	76	0.0131579
NODE_833_length_2622_cov_63.057471	1877	1953	283	1	76	0.0131579
NODE_833_length_2622_cov_63.057471	1877	1953	284	1	76	0.0131579
NODE_833_length_2622_cov_63.057471	1877	1953	285	1	76	0.0131579
NODE_833_length_2622_cov_63.057471	1877	1953	287	1	76	0.0131579
NODE_833_length_2622_cov_63.057471	1877	1953	289	4	76	0.0526316
NODE_833_length_2622_cov_63.057471	1877	1953	290	1	76	0.0131579
NODE_833_length_2622_cov_63.057471	1877	1953	291	1	76	0.0131579
NODE_833_length_2622_cov_63.057471	1877	1953	293	1	76	0.0131579
NODE_833_length_2622_cov_63.057471	1877	1953	298	1	76	0.0131579
NODE_833_length_2622_cov_63.057471	1877	1953	301	1	76	0.0131579
NODE_833_length_2622_cov_63.057471	1877	1953	303	1	76	0.0131579
NODE_833_length_2622_cov_63.057471	1877	1953	304	1	76	0.0131579
NODE_833_length_2622_cov_63.057471	1877	1953	306	1	76	0.0131579
NODE_833_length_2622_cov_63.057471	1877	1953	307	2	76	0.0263158
NODE_833_length_2622_cov_63.057471	1877	1953	308	1	76	0.0131579
NODE_833_length_2622_cov_63.057471	1877	1953	309	3	76	0.0394737
NODE_833_length_2622_cov_63.057471	1877	1953	311	6	76	0.0789474
NODE_833_length_2622_cov_63.057471	1877	1953	312	7	76	0.0921053
NODE_833_length_2622_cov_63.057471	1877	1953	313	3	76	0.0394737
NODE_833_length_2622_cov_63.057471	1877	1953	322	3	76	0.0394737
NODE_833_length_2622_cov_63.057471	1877	1953	323	1	76	0.0131579
NODE_833_length_2622_cov_63.057471	1877	1953	324	1	76	0.0131579
NODE_833_length_2622_cov_63.057471	1877	1953	325	1	76	0.0131579
NODE_833_length_2622_cov_63.057471	1877	1953	326	1	76	0.0131579
NODE_833_length_2622_cov_63.057471	1877	1953	327	3	76	0.0394737
NODE_833_length_2622_cov_63.057471	1877	1953	328	2	76	0.0263158
NODE_833_length_2622_cov_63.057471	1877	1953	329	1	76	0.0131579
NODE_833_length_2622_cov_63.057471	1877	1953	331	4	76	0.0526316
NODE_833_length_2622_cov_63.057471	2426	2506	80	1	80	0.0125000
NODE_833_length_2622_cov_63.057471	2426	2506	82	3	80	0.0375000
NODE_833_length_2622_cov_63.057471	2426	2506	83	1	80	0.0125000
NODE_833_length_2622_cov_63.057471	2426	2506	84	2	80	0.0250000
NODE_833_length_2622_cov_63.057471	2426	2506	86	2	80	0.0250000
NODE_833_length_2622_cov_63.057471	2426	2506	88	2	80	0.0250000
NODE_833_length_2622_cov_63.057471	2426	2506	89	1	80	0.0125000
NODE_833_length_2622_cov_63.057471	2426	2506	90	3	80	0.0375000
NODE_833_length_2622_cov_63.057471	2426	2506	91	3	80	0.0375000
NODE_833_length_2622_cov_63.057471	2426	2506	92	1	80	0.0125000
NODE_833_length_2622_cov_63.057471	2426	2506	93	8	80	0.1000000
NODE_833_length_2622_cov_63.057471	2426	2506	94	4	80	0.0500000
NODE_833_length_2622_cov_63.057471	2426	2506	95	10	80	0.1250000
NODE_833_length_2622_cov_63.057471	2426	2506	97	5	80	0.0625000
NODE_833_length_2622_cov_63.057471	2426	2506	102	1	80	0.0125000
NODE_833_length_2622_cov_63.057471	2426	2506	104	1	80	0.0125000
NODE_833_length_2622_cov_63.057471	2426	2506	110	1	80	0.0125000
NODE_833_length_2622_cov_63.057471	2426	2506	112	2	80	0.0250000
NODE_833_length_2622_cov_63.057471	2426	2506	116	1	80	0.0125000
NODE_833_length_2622_cov_63.057471	2426	2506	118	2	80	0.0250000
NODE_833_length_2622_cov_63.057471	2426	2506	120	2	80	0.0250000
NODE_833_length_2622_cov_63.057471	2426	2506	122	5	80	0.0625000
NODE_833_length_2622_cov_63.057471	2426	2506	124	5	80	0.0625000
NODE_833_length_2622_cov_63.057471	2426	2506	126	5	80	0.0625000
NODE_833_length_2622_cov_63.057471	2426	2506	128	4	80	0.0500000
NODE_833_length_2622_cov_63.057471	2426	2506	130	3	80	0.0375000
NODE_833_length_2622_cov_63.057471	2426	2506	132	2	80	0.0250000
NODE_833_length_2622_cov_63.057471	2479	2559	92	4	80	0.0500000
NODE_833_length_2622_cov_63.057471	2479	2559	93	1	80	0.0125000
NODE_833_length_2622_cov_63.057471	2479	2559	97	6	80	0.0750000
NODE_833_length_2622_cov_63.057471	2479	2559	98	2	80	0.0250000
NODE_833_length_2622_cov_63.057471	2479	2559	106	1	80	0.0125000
NODE_833_length_2622_cov_63.057471	2479	2559	108	2	80	0.0250000
NODE_833_length_2622_cov_63.057471	2479	2559	110	1	80	0.0125000
NODE_833_length_2622_cov_63.057471	2479	2559	114	6	80	0.0750000
NODE_833_length_2622_cov_63.057471	2479	2559	117	4	80	0.0500000
NODE_833_length_2622_cov_63.057471	2479	2559	118	1	80	0.0125000
NODE_833_length_2622_cov_63.057471	2479	2559	120	2	80	0.0250000
NODE_833_length_2622_cov_63.057471	2479	2559	122	10	80	0.1250000
NODE_833_length_2622_cov_63.057471	2479	2559	124	8	80	0.1000000
NODE_833_length_2622_cov_63.057471	2479	2559	126	5	80	0.0625000
NODE_833_length_2622_cov_63.057471	2479	2559	128	12	80	0.1500000
NODE_833_length_2622_cov_63.057471	2479	2559	130	7	80	0.0875000
NODE_833_length_2622_cov_63.057471	2479	2559	132	3	80	0.0375000
NODE_833_length_2622_cov_63.057471	2479	2559	134	1	80	0.0125000
NODE_833_length_2622_cov_63.057471	2479	2559	136	3	80	0.0375000
NODE_833_length_2622_cov_63.057471	2479	2559	138	1	80	0.0125000
NODE_836_length_2617_cov_16.817315	1404	1448	4	2	44	0.0454545
NODE_836_length_2617_cov_16.817315	1404	1448	6	3	44	0.0681818
NODE_836_length_2617_cov_16.817315	1404	1448	8	7	44	0.1590909
NODE_836_length_2617_cov_16.817315	1404	1448	10	32	44	0.7272727
NODE_836_length_2617_cov_16.817315	1467	1521	2	9	54	0.1666667
NODE_836_length_2617_cov_16.817315	1467	1521	4	11	54	0.2037037
NODE_836_length_2617_cov_16.817315	1467	1521	5	16	54	0.2962963
NODE_836_length_2617_cov_16.817315	1467	1521	6	18	54	0.3333333
NODE_839_length_2610_cov_2.232577	2127	2163	0	36	36	1.0000000
NODE_840_length_2609_cov_13.245418	2066	2146	3	6	80	0.0750000
NODE_840_length_2609_cov_13.245418	2066	2146	4	74	80	0.9250000
NODE_840_length_2609_cov_13.245418	2119	2199	0	26	80	0.3250000
NODE_840_length_2609_cov_13.245418	2119	2199	2	13	80	0.1625000
NODE_840_length_2609_cov_13.245418	2119	2199	4	41	80	0.5125000
NODE_840_length_2609_cov_13.245418	2195	2275	0	25	80	0.3125000
NODE_840_length_2609_cov_13.245418	2195	2275	2	2	80	0.0250000
NODE_840_length_2609_cov_13.245418	2195	2275	5	19	80	0.2375000
NODE_840_length_2609_cov_13.245418	2195	2275	6	29	80	0.3625000
NODE_840_length_2609_cov_13.245418	2195	2275	7	5	80	0.0625000
NODE_840_length_2609_cov_13.245418	2248	2328	6	41	80	0.5125000
NODE_840_length_2609_cov_13.245418	2248	2328	7	8	80	0.1000000
NODE_840_length_2609_cov_13.245418	2248	2328	8	31	80	0.3875000
NODE_845_length_2595_cov_5.638622	2157	2237	0	80	80	1.0000000
NODE_847_length_2594_cov_109.880160	386	450	83	4	64	0.0625000
NODE_847_length_2594_cov_109.880160	386	450	89	2	64	0.0312500
NODE_847_length_2594_cov_109.880160	386	450	91	2	64	0.0312500
NODE_847_length_2594_cov_109.880160	386	450	100	1	64	0.0156250
NODE_847_length_2594_cov_109.880160	386	450	106	2	64	0.0312500
NODE_847_length_2594_cov_109.880160	386	450	112	1	64	0.0156250
NODE_847_length_2594_cov_109.880160	386	450	125	1	64	0.0156250
NODE_847_length_2594_cov_109.880160	386	450	131	1	64	0.0156250
NODE_847_length_2594_cov_109.880160	386	450	137	1	64	0.0156250
NODE_847_length_2594_cov_109.880160	386	450	145	1	64	0.0156250
NODE_847_length_2594_cov_109.880160	386	450	149	1	64	0.0156250
NODE_847_length_2594_cov_109.880160	386	450	163	1	64	0.0156250
NODE_847_length_2594_cov_109.880160	386	450	166	1	64	0.0156250
NODE_847_length_2594_cov_109.880160	386	450	172	1	64	0.0156250
NODE_847_length_2594_cov_109.880160	386	450	186	1	64	0.0156250
NODE_847_length_2594_cov_109.880160	386	450	188	1	64	0.0156250
NODE_847_length_2594_cov_109.880160	386	450	192	1	64	0.0156250
NODE_847_length_2594_cov_109.880160	386	450	199	3	64	0.0468750
NODE_847_length_2594_cov_109.880160	386	450	201	1	64	0.0156250
NODE_847_length_2594_cov_109.880160	386	450	205	2	64	0.0312500
NODE_847_length_2594_cov_109.880160	386	450	212	1	64	0.0156250
NODE_847_length_2594_cov_109.880160	386	450	216	1	64	0.0156250
NODE_847_length_2594_cov_109.880160	386	450	217	1	64	0.0156250
NODE_847_length_2594_cov_109.880160	386	450	223	1	64	0.0156250
NODE_847_length_2594_cov_109.880160	386	450	235	1	64	0.0156250
NODE_847_length_2594_cov_109.880160	386	450	256	4	64	0.0625000
NODE_847_length_2594_cov_109.880160	386	450	258	1	64	0.0156250
NODE_847_length_2594_cov_109.880160	386	450	270	1	64	0.0156250
NODE_847_length_2594_cov_109.880160	386	450	272	1	64	0.0156250
NODE_847_length_2594_cov_109.880160	386	450	275	1	64	0.0156250
NODE_847_length_2594_cov_109.880160	386	450	288	1	64	0.0156250
NODE_847_length_2594_cov_109.880160	386	450	289	1	64	0.0156250
NODE_847_length_2594_cov_109.880160	386	450	293	4	64	0.0625000
NODE_847_length_2594_cov_109.880160	386	450	295	1	64	0.0156250
NODE_847_length_2594_cov_109.880160	386	450	296	1	64	0.0156250
NODE_847_length_2594_cov_109.880160	386	450	298	8	64	0.1250000
NODE_847_length_2594_cov_109.880160	386	450	300	1	64	0.0156250
NODE_847_length_2594_cov_109.880160	386	450	302	1	64	0.0156250
NODE_847_length_2594_cov_109.880160	386	450	304	2	64	0.0312500
NODE_847_length_2594_cov_109.880160	386	450	306	1	64	0.0156250
NODE_847_length_2594_cov_109.880160	386	450	308	1	64	0.0156250
NODE_856_length_2575_cov_4.890549	1860	1912	2	14	52	0.2692308
NODE_856_length_2575_cov_4.890549	1860	1912	6	6	52	0.1153846
NODE_856_length_2575_cov_4.890549	1860	1912	8	9	52	0.1730769
NODE_856_length_2575_cov_4.890549	1860	1912	10	21	52	0.4038461
NODE_856_length_2575_cov_4.890549	1860	1912	12	2	52	0.0384615
NODE_857_length_2572_cov_46.828548	302	382	0	80	80	1.0000000
NODE_857_length_2572_cov_46.828548	355	435	0	80	80	1.0000000
NODE_868_length_2551_cov_40.721860	1104	1150	4	11	46	0.2391304
NODE_868_length_2551_cov_40.721860	1104	1150	9	1	46	0.0217391
NODE_868_length_2551_cov_40.721860	1104	1150	10	34	46	0.7391304
NODE_868_length_2551_cov_40.721860	1199	1259	0	12	60	0.2000000
NODE_868_length_2551_cov_40.721860	1199	1259	2	32	60	0.5333334
NODE_868_length_2551_cov_40.721860	1199	1259	3	9	60	0.1500000
NODE_868_length_2551_cov_40.721860	1199	1259	8	7	60	0.1166667
NODE_870_length_2547_cov_218.062908	436	486	1	9	50	0.1800000
NODE_870_length_2547_cov_218.062908	436	486	2	21	50	0.4200000
NODE_870_length_2547_cov_218.062908	436	486	3	4	50	0.0800000
NODE_870_length_2547_cov_218.062908	436	486	5	1	50	0.0200000
NODE_870_length_2547_cov_218.062908	436	486	6	2	50	0.0400000
NODE_870_length_2547_cov_218.062908	436	486	10	1	50	0.0200000
NODE_870_length_2547_cov_218.062908	436	486	12	1	50	0.0200000
NODE_870_length_2547_cov_218.062908	436	486	13	5	50	0.1000000
NODE_870_length_2547_cov_218.062908	436	486	15	2	50	0.0400000
NODE_870_length_2547_cov_218.062908	436	486	17	4	50	0.0800000
NODE_879_length_2527_cov_27.275947	503	548	114	4	45	0.0888889
NODE_879_length_2527_cov_27.275947	503	548	115	10	45	0.2222222
NODE_879_length_2527_cov_27.275947	503	548	116	5	45	0.1111111
NODE_879_length_2527_cov_27.275947	503	548	120	3	45	0.0666667
NODE_879_length_2527_cov_27.275947	503	548	122	7	45	0.1555556
NODE_879_length_2527_cov_27.275947	503	548	124	3	45	0.0666667
NODE_879_length_2527_cov_27.275947	503	548	125	2	45	0.0444444
NODE_879_length_2527_cov_27.275947	503	548	126	1	45	0.0222222
NODE_879_length_2527_cov_27.275947	503	548	127	3	45	0.0666667
NODE_879_length_2527_cov_27.275947	503	548	128	2	45	0.0444444
NODE_879_length_2527_cov_27.275947	503	548	129	1	45	0.0222222
NODE_879_length_2527_cov_27.275947	503	548	130	4	45	0.0888889
NODE_884_length_2519_cov_15.991322	2122	2202	14	17	80	0.2125000
NODE_884_length_2519_cov_15.991322	2122	2202	15	12	80	0.1500000
NODE_884_length_2519_cov_15.991322	2122	2202	16	22	80	0.2750000
NODE_884_length_2519_cov_15.991322	2122	2202	18	1	80	0.0125000
NODE_884_length_2519_cov_15.991322	2122	2202	20	28	80	0.3500000
NODE_884_length_2519_cov_15.991322	2175	2255	0	25	80	0.3125000
NODE_884_length_2519_cov_15.991322	2175	2255	6	10	80	0.1250000
NODE_884_length_2519_cov_15.991322	2175	2255	12	1	80	0.0125000
NODE_884_length_2519_cov_15.991322	2175	2255	13	15	80	0.1875000
NODE_884_length_2519_cov_15.991322	2175	2255	14	14	80	0.1750000
NODE_884_length_2519_cov_15.991322	2175	2255	16	14	80	0.1750000
NODE_884_length_2519_cov_15.991322	2175	2255	18	1	80	0.0125000
NODE_885_length_2518_cov_7.035965	62	142	39	2	80	0.0250000
NODE_885_length_2518_cov_7.035965	62	142	41	2	80	0.0250000
NODE_885_length_2518_cov_7.035965	62	142	43	1	80	0.0125000
NODE_885_length_2518_cov_7.035965	62	142	45	2	80	0.0250000
NODE_885_length_2518_cov_7.035965	62	142	53	1	80	0.0125000
NODE_885_length_2518_cov_7.035965	62	142	55	11	80	0.1375000
NODE_885_length_2518_cov_7.035965	62	142	57	4	80	0.0500000
NODE_885_length_2518_cov_7.035965	62	142	59	1	80	0.0125000
NODE_885_length_2518_cov_7.035965	62	142	61	4	80	0.0500000
NODE_885_length_2518_cov_7.035965	62	142	63	2	80	0.0250000
NODE_885_length_2518_cov_7.035965	62	142	65	4	80	0.0500000
NODE_885_length_2518_cov_7.035965	62	142	66	6	80	0.0750000
NODE_885_length_2518_cov_7.035965	62	142	68	6	80	0.0750000
NODE_885_length_2518_cov_7.035965	62	142	69	2	80	0.0250000
NODE_885_length_2518_cov_7.035965	62	142	70	2	80	0.0250000
NODE_885_length_2518_cov_7.035965	62	142	72	17	80	0.2125000
NODE_885_length_2518_cov_7.035965	62	142	73	13	80	0.1625000
NODE_885_length_2518_cov_7.035965	2005	2085	0	80	80	1.0000000
NODE_885_length_2518_cov_7.035965	2058	2138	0	80	80	1.0000000
NODE_887_length_2515_cov_37.984272	393	473	2	24	80	0.3000000
NODE_887_length_2515_cov_37.984272	393	473	8	22	80	0.2750000
NODE_887_length_2515_cov_37.984272	393	473	9	19	80	0.2375000
NODE_887_length_2515_cov_37.984272	393	473	10	15	80	0.1875000
NODE_887_length_2515_cov_37.984272	446	526	8	74	80	0.9250000
NODE_887_length_2515_cov_37.984272	446	526	9	6	80	0.0750000
NODE_887_length_2515_cov_37.984272	1896	1976	0	9	80	0.1125000
NODE_887_length_2515_cov_37.984272	1896	1976	2	35	80	0.4375000
NODE_887_length_2515_cov_37.984272	1896	1976	6	36	80	0.4500000
NODE_887_length_2515_cov_37.984272	1949	2029	4	44	80	0.5500000
NODE_887_length_2515_cov_37.984272	1949	2029	6	36	80	0.4500000
NODE_887_length_2515_cov_37.984272	2025	2105	4	11	80	0.1375000
NODE_887_length_2515_cov_37.984272	2025	2105	8	4	80	0.0500000
NODE_887_length_2515_cov_37.984272	2025	2105	10	3	80	0.0375000
NODE_887_length_2515_cov_37.984272	2025	2105	12	17	80	0.2125000
NODE_887_length_2515_cov_37.984272	2025	2105	14	43	80	0.5375000
NODE_887_length_2515_cov_37.984272	2025	2105	16	2	80	0.0250000
NODE_887_length_2515_cov_37.984272	2025	2104	4	11	79	0.1392405
NODE_887_length_2515_cov_37.984272	2025	2104	8	4	79	0.0506329
NODE_887_length_2515_cov_37.984272	2025	2104	10	3	79	0.0379747
NODE_887_length_2515_cov_37.984272	2025	2104	12	17	79	0.2151899
NODE_887_length_2515_cov_37.984272	2025	2104	14	42	79	0.5316456
NODE_887_length_2515_cov_37.984272	2025	2104	16	2	79	0.0253165
NODE_887_length_2515_cov_37.984272	2078	2158	2	19	80	0.2375000
NODE_887_length_2515_cov_37.984272	2078	2158	6	8	80	0.1000000
NODE_887_length_2515_cov_37.984272	2078	2158	10	3	80	0.0375000
NODE_887_length_2515_cov_37.984272	2078	2158	12	5	80	0.0625000
NODE_887_length_2515_cov_37.984272	2078	2158	14	45	80	0.5625000
NODE_888_length_2512_cov_48.259428	1299	1379	20	7	80	0.0875000
NODE_888_length_2512_cov_48.259428	1299	1379	22	4	80	0.0500000
NODE_888_length_2512_cov_48.259428	1299	1379	24	8	80	0.1000000
NODE_888_length_2512_cov_48.259428	1299	1379	26	3	80	0.0375000
NODE_888_length_2512_cov_48.259428	1299	1379	28	17	80	0.2125000
NODE_888_length_2512_cov_48.259428	1299	1379	30	22	80	0.2750000
NODE_888_length_2512_cov_48.259428	1299	1379	32	19	80	0.2375000
NODE_888_length_2512_cov_48.259428	1352	1432	8	2	80	0.0250000
NODE_888_length_2512_cov_48.259428	1352	1432	10	1	80	0.0125000
NODE_888_length_2512_cov_48.259428	1352	1432	16	13	80	0.1625000
NODE_888_length_2512_cov_48.259428	1352	1432	18	25	80	0.3125000
NODE_888_length_2512_cov_48.259428	1352	1432	20	3	80	0.0375000
NODE_888_length_2512_cov_48.259428	1352	1432	21	1	80	0.0125000
NODE_888_length_2512_cov_48.259428	1352	1432	22	4	80	0.0500000
NODE_888_length_2512_cov_48.259428	1352	1432	24	11	80	0.1375000
NODE_888_length_2512_cov_48.259428	1352	1432	26	1	80	0.0125000
NODE_888_length_2512_cov_48.259428	1352	1432	28	7	80	0.0875000
NODE_888_length_2512_cov_48.259428	1352	1432	30	12	80	0.1500000
NODE_888_length_2512_cov_48.259428	1428	1512	8	2	84	0.0238095
NODE_888_length_2512_cov_48.259428	1428	1512	10	4	84	0.0476190
NODE_888_length_2512_cov_48.259428	1428	1512	14	1	84	0.0119048
NODE_888_length_2512_cov_48.259428	1428	1512	16	1	84	0.0119048
NODE_888_length_2512_cov_48.259428	1428	1512	22	2	84	0.0238095
NODE_888_length_2512_cov_48.259428	1428	1512	24	11	84	0.1309524
NODE_888_length_2512_cov_48.259428	1428	1512	26	2	84	0.0238095
NODE_888_length_2512_cov_48.259428	1428	1512	34	4	84	0.0476190
NODE_888_length_2512_cov_48.259428	1428	1512	40	3	84	0.0357143
NODE_888_length_2512_cov_48.259428	1428	1512	42	5	84	0.0595238
NODE_888_length_2512_cov_48.259428	1428	1512	44	3	84	0.0357143
NODE_888_length_2512_cov_48.259428	1428	1512	52	2	84	0.0238095
NODE_888_length_2512_cov_48.259428	1428	1512	62	1	84	0.0119048
NODE_888_length_2512_cov_48.259428	1428	1512	70	5	84	0.0595238
NODE_888_length_2512_cov_48.259428	1428	1512	72	1	84	0.0119048
NODE_888_length_2512_cov_48.259428	1428	1512	82	4	84	0.0476190
NODE_888_length_2512_cov_48.259428	1428	1512	86	2	84	0.0238095
NODE_888_length_2512_cov_48.259428	1428	1512	90	1	84	0.0119048
NODE_888_length_2512_cov_48.259428	1428	1512	99	1	84	0.0119048
NODE_888_length_2512_cov_48.259428	1428	1512	109	1	84	0.0119048
NODE_888_length_2512_cov_48.259428	1428	1512	110	1	84	0.0119048
NODE_888_length_2512_cov_48.259428	1428	1512	118	1	84	0.0119048
NODE_888_length_2512_cov_48.259428	1428	1512	120	3	84	0.0357143
NODE_888_length_2512_cov_48.259428	1428	1512	122	1	84	0.0119048
NODE_888_length_2512_cov_48.259428	1428	1512	124	1	84	0.0119048
NODE_888_length_2512_cov_48.259428	1428	1512	126	5	84	0.0595238
NODE_888_length_2512_cov_48.259428	1428	1512	128	3	84	0.0357143
NODE_888_length_2512_cov_48.259428	1428	1512	130	4	84	0.0476190
NODE_888_length_2512_cov_48.259428	1428	1512	132	2	84	0.0238095
NODE_888_length_2512_cov_48.259428	1428	1512	134	1	84	0.0119048
NODE_888_length_2512_cov_48.259428	1428	1512	136	5	84	0.0595238
NODE_888_length_2512_cov_48.259428	1428	1512	138	1	84	0.0119048
NODE_888_length_2512_cov_48.259428	1485	1565	96	1	80	0.0125000
NODE_888_length_2512_cov_48.259428	1485	1565	105	1	80	0.0125000
NODE_888_length_2512_cov_48.259428	1485	1565	106	1	80	0.0125000
NODE_888_length_2512_cov_48.259428	1485	1565	112	1	80	0.0125000
NODE_888_length_2512_cov_48.259428	1485	1565	118	4	80	0.0500000
NODE_888_length_2512_cov_48.259428	1485	1565	120	3	80	0.0375000
NODE_888_length_2512_cov_48.259428	1485	1565	122	1	80	0.0125000
NODE_888_length_2512_cov_48.259428	1485	1565	124	1	80	0.0125000
NODE_888_length_2512_cov_48.259428	1485	1565	126	6	80	0.0750000
NODE_888_length_2512_cov_48.259428	1485	1565	128	11	80	0.1375000
NODE_888_length_2512_cov_48.259428	1485	1565	130	4	80	0.0500000
NODE_888_length_2512_cov_48.259428	1485	1565	132	7	80	0.0875000
NODE_888_length_2512_cov_48.259428	1485	1565	134	20	80	0.2500000
NODE_888_length_2512_cov_48.259428	1485	1565	136	18	80	0.2250000
NODE_888_length_2512_cov_48.259428	1485	1565	138	1	80	0.0125000
NODE_891_length_2505_cov_102.009975	390	470	0	78	80	0.9750000
NODE_891_length_2505_cov_102.009975	390	470	2	2	80	0.0250000
NODE_891_length_2505_cov_102.009975	443	510	0	67	67	1.0000000
NODE_894_length_2499_cov_2.655417	2325	2375	3	2	50	0.0400000
NODE_894_length_2499_cov_2.655417	2325	2375	5	1	50	0.0200000
NODE_894_length_2499_cov_2.655417	2325	2375	10	1	50	0.0200000
NODE_894_length_2499_cov_2.655417	2325	2375	14	1	50	0.0200000
NODE_894_length_2499_cov_2.655417	2325	2375	15	1	50	0.0200000
NODE_894_length_2499_cov_2.655417	2325	2375	18	1	50	0.0200000
NODE_894_length_2499_cov_2.655417	2325	2375	20	1	50	0.0200000
NODE_894_length_2499_cov_2.655417	2325	2375	22	2	50	0.0400000
NODE_894_length_2499_cov_2.655417	2325	2375	24	2	50	0.0400000
NODE_894_length_2499_cov_2.655417	2325	2375	26	1	50	0.0200000
NODE_894_length_2499_cov_2.655417	2325	2375	30	1	50	0.0200000
NODE_894_length_2499_cov_2.655417	2325	2375	32	2	50	0.0400000
NODE_894_length_2499_cov_2.655417	2325	2375	36	6	50	0.1200000
NODE_894_length_2499_cov_2.655417	2325	2375	38	28	50	0.5600000
NODE_895_length_2498_cov_9.614840	239	281	0	42	42	1.0000000
NODE_895_length_2498_cov_9.614840	254	335	0	59	81	0.7283950
NODE_895_length_2498_cov_9.614840	254	335	2	22	81	0.2716049
NODE_895_length_2498_cov_9.614840	254	335	0	59	81	0.7283950
NODE_895_length_2498_cov_9.614840	254	335	2	22	81	0.2716049
NODE_895_length_2498_cov_9.614840	331	411	2	21	80	0.2625000
NODE_895_length_2498_cov_9.614840	331	411	4	22	80	0.2750000
NODE_895_length_2498_cov_9.614840	331	411	6	37	80	0.4625000
NODE_895_length_2498_cov_9.614840	384	464	0	1	80	0.0125000
NODE_895_length_2498_cov_9.614840	384	464	2	33	80	0.4125000
NODE_895_length_2498_cov_9.614840	384	464	4	10	80	0.1250000
NODE_895_length_2498_cov_9.614840	384	464	6	36	80	0.4500000
NODE_898_length_2495_cov_5.151085	2395	2444	2	6	49	0.1224490
NODE_898_length_2495_cov_5.151085	2395	2444	6	3	49	0.0612245
NODE_898_length_2495_cov_5.151085	2395	2444	8	40	49	0.8163266
NODE_898_length_2495_cov_5.151085	2395	2444	2	6	49	0.1224490
NODE_898_length_2495_cov_5.151085	2395	2444	6	3	49	0.0612245
NODE_898_length_2495_cov_5.151085	2395	2444	8	40	49	0.8163266
NODE_898_length_2495_cov_5.151085	2396	2444	2	6	48	0.1250000
NODE_898_length_2495_cov_5.151085	2396	2444	6	3	48	0.0625000
NODE_898_length_2495_cov_5.151085	2396	2444	8	39	48	0.8125000
NODE_898_length_2495_cov_5.151085	2396	2444	2	6	48	0.1250000
NODE_898_length_2495_cov_5.151085	2396	2444	6	3	48	0.0625000
NODE_898_length_2495_cov_5.151085	2396	2444	8	39	48	0.8125000
NODE_898_length_2495_cov_5.151085	2396	2444	2	6	48	0.1250000
NODE_898_length_2495_cov_5.151085	2396	2444	6	3	48	0.0625000
NODE_898_length_2495_cov_5.151085	2396	2444	8	39	48	0.8125000
NODE_900_length_2492_cov_43.645215	408	488	0	16	80	0.2000000
NODE_900_length_2492_cov_43.645215	408	488	4	64	80	0.8000000
NODE_903_length_2489_cov_15.105021	204	234	22	10	30	0.3333333
NODE_903_length_2489_cov_15.105021	204	234	24	20	30	0.6666667
NODE_905_length_2488_cov_2.434910	2141	2200	22	2	59	0.0338983
NODE_905_length_2488_cov_2.434910	2141	2200	28	6	59	0.1016949
NODE_905_length_2488_cov_2.434910	2141	2200	30	7	59	0.1186441
NODE_905_length_2488_cov_2.434910	2141	2200	32	11	59	0.1864407
NODE_905_length_2488_cov_2.434910	2141	2200	34	21	59	0.3559322
NODE_905_length_2488_cov_2.434910	2141	2200	36	12	59	0.2033898
NODE_906_length_2484_cov_335.301887	224	279	691	1	55	0.0181818
NODE_906_length_2484_cov_335.301887	224	279	700	1	55	0.0181818
NODE_906_length_2484_cov_335.301887	224	279	703	1	55	0.0181818
NODE_906_length_2484_cov_335.301887	224	279	713	1	55	0.0181818
NODE_906_length_2484_cov_335.301887	224	279	722	1	55	0.0181818
NODE_906_length_2484_cov_335.301887	224	279	723	1	55	0.0181818
NODE_906_length_2484_cov_335.301887	224	279	726	1	55	0.0181818
NODE_906_length_2484_cov_335.301887	224	279	735	1	55	0.0181818
NODE_906_length_2484_cov_335.301887	224	279	737	1	55	0.0181818
NODE_906_length_2484_cov_335.301887	224	279	739	1	55	0.0181818
NODE_906_length_2484_cov_335.301887	224	279	740	3	55	0.0545455
NODE_906_length_2484_cov_335.301887	224	279	741	1	55	0.0181818
NODE_906_length_2484_cov_335.301887	224	279	742	3	55	0.0545455
NODE_906_length_2484_cov_335.301887	224	279	744	2	55	0.0363636
NODE_906_length_2484_cov_335.301887	224	279	745	3	55	0.0545455
NODE_906_length_2484_cov_335.301887	224	279	746	2	55	0.0363636
NODE_906_length_2484_cov_335.301887	224	279	747	2	55	0.0363636
NODE_906_length_2484_cov_335.301887	224	279	748	1	55	0.0181818
NODE_906_length_2484_cov_335.301887	224	279	750	3	55	0.0545455
NODE_906_length_2484_cov_335.301887	224	279	751	2	55	0.0363636
NODE_906_length_2484_cov_335.301887	224	279	752	1	55	0.0181818
NODE_906_length_2484_cov_335.301887	224	279	753	1	55	0.0181818
NODE_906_length_2484_cov_335.301887	224	279	754	3	55	0.0545455
NODE_906_length_2484_cov_335.301887	224	279	755	1	55	0.0181818
NODE_906_length_2484_cov_335.301887	224	279	756	2	55	0.0363636
NODE_906_length_2484_cov_335.301887	224	279	757	1	55	0.0181818
NODE_906_length_2484_cov_335.301887	224	279	758	1	55	0.0181818
NODE_906_length_2484_cov_335.301887	224	279	759	1	55	0.0181818
NODE_906_length_2484_cov_335.301887	224	279	762	1	55	0.0181818
NODE_906_length_2484_cov_335.301887	224	279	764	1	55	0.0181818
NODE_906_length_2484_cov_335.301887	224	279	765	3	55	0.0545455
NODE_906_length_2484_cov_335.301887	224	279	766	1	55	0.0181818
NODE_906_length_2484_cov_335.301887	224	279	767	1	55	0.0181818
NODE_906_length_2484_cov_335.301887	224	279	768	1	55	0.0181818
NODE_906_length_2484_cov_335.301887	224	279	769	1	55	0.0181818
NODE_906_length_2484_cov_335.301887	224	279	770	2	55	0.0363636
NODE_906_length_2484_cov_335.301887	224	279	773	1	55	0.0181818
NODE_906_length_2484_cov_335.301887	252	332	573	1	80	0.0125000
NODE_906_length_2484_cov_335.301887	252	332	597	1	80	0.0125000
NODE_906_length_2484_cov_335.301887	252	332	604	1	80	0.0125000
NODE_906_length_2484_cov_335.301887	252	332	606	1	80	0.0125000
NODE_906_length_2484_cov_335.301887	252	332	607	1	80	0.0125000
NODE_906_length_2484_cov_335.301887	252	332	612	1	80	0.0125000
NODE_906_length_2484_cov_335.301887	252	332	614	1	80	0.0125000
NODE_906_length_2484_cov_335.301887	252	332	616	1	80	0.0125000
NODE_906_length_2484_cov_335.301887	252	332	628	1	80	0.0125000
NODE_906_length_2484_cov_335.301887	252	332	641	1	80	0.0125000
NODE_906_length_2484_cov_335.301887	252	332	643	2	80	0.0250000
NODE_906_length_2484_cov_335.301887	252	332	651	1	80	0.0125000
NODE_906_length_2484_cov_335.301887	252	332	667	1	80	0.0125000
NODE_906_length_2484_cov_335.301887	252	332	681	1	80	0.0125000
NODE_906_length_2484_cov_335.301887	252	332	696	1	80	0.0125000
NODE_906_length_2484_cov_335.301887	252	332	698	1	80	0.0125000
NODE_906_length_2484_cov_335.301887	252	332	711	1	80	0.0125000
NODE_906_length_2484_cov_335.301887	252	332	721	1	80	0.0125000
NODE_906_length_2484_cov_335.301887	252	332	725	1	80	0.0125000
NODE_906_length_2484_cov_335.301887	252	332	727	1	80	0.0125000
NODE_906_length_2484_cov_335.301887	252	332	740	2	80	0.0250000
NODE_906_length_2484_cov_335.301887	252	332	742	2	80	0.0250000
NODE_906_length_2484_cov_335.301887	252	332	744	1	80	0.0125000
NODE_906_length_2484_cov_335.301887	252	332	745	2	80	0.0250000
NODE_906_length_2484_cov_335.301887	252	332	746	2	80	0.0250000
NODE_906_length_2484_cov_335.301887	252	332	747	2	80	0.0250000
NODE_906_length_2484_cov_335.301887	252	332	748	1	80	0.0125000
NODE_906_length_2484_cov_335.301887	252	332	749	2	80	0.0250000
NODE_906_length_2484_cov_335.301887	252	332	751	2	80	0.0250000
NODE_906_length_2484_cov_335.301887	252	332	752	1	80	0.0125000
NODE_906_length_2484_cov_335.301887	252	332	754	3	80	0.0375000
NODE_906_length_2484_cov_335.301887	252	332	755	2	80	0.0250000
NODE_906_length_2484_cov_335.301887	252	332	756	1	80	0.0125000
NODE_906_length_2484_cov_335.301887	252	332	762	1	80	0.0125000
NODE_906_length_2484_cov_335.301887	252	332	763	1	80	0.0125000
NODE_906_length_2484_cov_335.301887	252	332	765	5	80	0.0625000
NODE_906_length_2484_cov_335.301887	252	332	766	2	80	0.0250000
NODE_906_length_2484_cov_335.301887	252	332	767	1	80	0.0125000
NODE_906_length_2484_cov_335.301887	252	332	768	3	80	0.0375000
NODE_906_length_2484_cov_335.301887	252	332	769	1	80	0.0125000
NODE_906_length_2484_cov_335.301887	252	332	770	2	80	0.0250000
NODE_906_length_2484_cov_335.301887	252	332	771	2	80	0.0250000
NODE_906_length_2484_cov_335.301887	252	332	772	2	80	0.0250000
NODE_906_length_2484_cov_335.301887	252	332	773	2	80	0.0250000
NODE_906_length_2484_cov_335.301887	252	332	775	1	80	0.0125000
NODE_906_length_2484_cov_335.301887	252	332	779	1	80	0.0125000
NODE_906_length_2484_cov_335.301887	252	332	780	2	80	0.0250000
NODE_906_length_2484_cov_335.301887	252	332	781	3	80	0.0375000
NODE_906_length_2484_cov_335.301887	252	332	782	1	80	0.0125000
NODE_906_length_2484_cov_335.301887	252	332	783	1	80	0.0125000
NODE_906_length_2484_cov_335.301887	252	332	784	2	80	0.0250000
NODE_906_length_2484_cov_335.301887	252	332	786	1	80	0.0125000
NODE_906_length_2484_cov_335.301887	252	332	789	2	80	0.0250000
NODE_912_length_2479_cov_90.381092	369	449	0	20	80	0.2500000
NODE_912_length_2479_cov_90.381092	369	449	6	60	80	0.7500000
NODE_912_length_2479_cov_90.381092	422	499	6	77	77	1.0000000
NODE_912_length_2479_cov_90.381092	1610	1685	87	1	75	0.0133333
NODE_912_length_2479_cov_90.381092	1610	1685	119	1	75	0.0133333
NODE_912_length_2479_cov_90.381092	1610	1685	135	2	75	0.0266667
NODE_912_length_2479_cov_90.381092	1610	1685	155	4	75	0.0533333
NODE_912_length_2479_cov_90.381092	1610	1685	161	2	75	0.0266667
NODE_912_length_2479_cov_90.381092	1610	1685	169	1	75	0.0133333
NODE_912_length_2479_cov_90.381092	1610	1685	173	1	75	0.0133333
NODE_912_length_2479_cov_90.381092	1610	1685	188	1	75	0.0133333
NODE_912_length_2479_cov_90.381092	1610	1685	204	1	75	0.0133333
NODE_912_length_2479_cov_90.381092	1610	1685	206	1	75	0.0133333
NODE_912_length_2479_cov_90.381092	1610	1685	208	1	75	0.0133333
NODE_912_length_2479_cov_90.381092	1610	1685	216	1	75	0.0133333
NODE_912_length_2479_cov_90.381092	1610	1685	225	2	75	0.0266667
NODE_912_length_2479_cov_90.381092	1610	1685	235	1	75	0.0133333
NODE_912_length_2479_cov_90.381092	1610	1685	237	2	75	0.0266667
NODE_912_length_2479_cov_90.381092	1610	1685	239	1	75	0.0133333
NODE_912_length_2479_cov_90.381092	1610	1685	241	1	75	0.0133333
NODE_912_length_2479_cov_90.381092	1610	1685	243	1	75	0.0133333
NODE_912_length_2479_cov_90.381092	1610	1685	245	1	75	0.0133333
NODE_912_length_2479_cov_90.381092	1610	1685	247	1	75	0.0133333
NODE_912_length_2479_cov_90.381092	1610	1685	255	2	75	0.0266667
NODE_912_length_2479_cov_90.381092	1610	1685	263	1	75	0.0133333
NODE_912_length_2479_cov_90.381092	1610	1685	265	1	75	0.0133333
NODE_912_length_2479_cov_90.381092	1610	1685	267	1	75	0.0133333
NODE_912_length_2479_cov_90.381092	1610	1685	269	1	75	0.0133333
NODE_912_length_2479_cov_90.381092	1610	1685	270	1	75	0.0133333
NODE_912_length_2479_cov_90.381092	1610	1685	274	1	75	0.0133333
NODE_912_length_2479_cov_90.381092	1610	1685	282	1	75	0.0133333
NODE_912_length_2479_cov_90.381092	1610	1685	291	1	75	0.0133333
NODE_912_length_2479_cov_90.381092	1610	1685	292	1	75	0.0133333
NODE_912_length_2479_cov_90.381092	1610	1685	296	1	75	0.0133333
NODE_912_length_2479_cov_90.381092	1610	1685	304	1	75	0.0133333
NODE_912_length_2479_cov_90.381092	1610	1685	309	1	75	0.0133333
NODE_912_length_2479_cov_90.381092	1610	1685	314	1	75	0.0133333
NODE_912_length_2479_cov_90.381092	1610	1685	318	2	75	0.0266667
NODE_912_length_2479_cov_90.381092	1610	1685	338	2	75	0.0266667
NODE_912_length_2479_cov_90.381092	1610	1685	345	1	75	0.0133333
NODE_912_length_2479_cov_90.381092	1610	1685	357	1	75	0.0133333
NODE_912_length_2479_cov_90.381092	1610	1685	364	1	75	0.0133333
NODE_912_length_2479_cov_90.381092	1610	1685	370	2	75	0.0266667
NODE_912_length_2479_cov_90.381092	1610	1685	372	2	75	0.0266667
NODE_912_length_2479_cov_90.381092	1610	1685	378	1	75	0.0133333
NODE_912_length_2479_cov_90.381092	1610	1685	381	1	75	0.0133333
NODE_912_length_2479_cov_90.381092	1610	1685	392	1	75	0.0133333
NODE_912_length_2479_cov_90.381092	1610	1685	400	1	75	0.0133333
NODE_912_length_2479_cov_90.381092	1610	1685	413	1	75	0.0133333
NODE_912_length_2479_cov_90.381092	1610	1685	415	1	75	0.0133333
NODE_912_length_2479_cov_90.381092	1610	1685	424	1	75	0.0133333
NODE_912_length_2479_cov_90.381092	1610	1685	425	4	75	0.0533333
NODE_912_length_2479_cov_90.381092	1610	1685	431	1	75	0.0133333
NODE_912_length_2479_cov_90.381092	1610	1685	433	2	75	0.0266667
NODE_912_length_2479_cov_90.381092	1610	1685	434	2	75	0.0266667
NODE_912_length_2479_cov_90.381092	1610	1685	436	5	75	0.0666667
NODE_912_length_2479_cov_90.381092	1610	1685	438	1	75	0.0133333
NODE_912_length_2479_cov_90.381092	1658	1730	364	1	72	0.0138889
NODE_912_length_2479_cov_90.381092	1658	1730	370	2	72	0.0277778
NODE_912_length_2479_cov_90.381092	1658	1730	372	2	72	0.0277778
NODE_912_length_2479_cov_90.381092	1658	1730	378	1	72	0.0138889
NODE_912_length_2479_cov_90.381092	1658	1730	381	1	72	0.0138889
NODE_912_length_2479_cov_90.381092	1658	1730	392	1	72	0.0138889
NODE_912_length_2479_cov_90.381092	1658	1730	400	1	72	0.0138889
NODE_912_length_2479_cov_90.381092	1658	1730	403	2	72	0.0277778
NODE_912_length_2479_cov_90.381092	1658	1730	404	1	72	0.0138889
NODE_912_length_2479_cov_90.381092	1658	1730	408	1	72	0.0138889
NODE_912_length_2479_cov_90.381092	1658	1730	411	1	72	0.0138889
NODE_912_length_2479_cov_90.381092	1658	1730	413	2	72	0.0277778
NODE_912_length_2479_cov_90.381092	1658	1730	414	2	72	0.0277778
NODE_912_length_2479_cov_90.381092	1658	1730	415	1	72	0.0138889
NODE_912_length_2479_cov_90.381092	1658	1730	416	3	72	0.0416667
NODE_912_length_2479_cov_90.381092	1658	1730	418	1	72	0.0138889
NODE_912_length_2479_cov_90.381092	1658	1730	423	2	72	0.0277778
NODE_912_length_2479_cov_90.381092	1658	1730	424	3	72	0.0416667
NODE_912_length_2479_cov_90.381092	1658	1730	425	6	72	0.0833333
NODE_912_length_2479_cov_90.381092	1658	1730	426	3	72	0.0416667
NODE_912_length_2479_cov_90.381092	1658	1730	427	6	72	0.0833333
NODE_912_length_2479_cov_90.381092	1658	1730	429	4	72	0.0555556
NODE_912_length_2479_cov_90.381092	1658	1730	430	1	72	0.0138889
NODE_912_length_2479_cov_90.381092	1658	1730	431	3	72	0.0416667
NODE_912_length_2479_cov_90.381092	1658	1730	432	5	72	0.0694444
NODE_912_length_2479_cov_90.381092	1658	1730	433	2	72	0.0277778
NODE_912_length_2479_cov_90.381092	1658	1730	434	2	72	0.0277778
NODE_912_length_2479_cov_90.381092	1658	1730	436	7	72	0.0972222
NODE_912_length_2479_cov_90.381092	1658	1730	438	1	72	0.0138889
NODE_912_length_2479_cov_90.381092	1658	1730	440	1	72	0.0138889
NODE_912_length_2479_cov_90.381092	1658	1730	444	2	72	0.0277778
NODE_912_length_2479_cov_90.381092	1658	1730	447	1	72	0.0138889
NODE_913_length_2479_cov_3.433193	2379	2426	0	44	47	0.9361702
NODE_913_length_2479_cov_3.433193	2379	2426	2	3	47	0.0638298
NODE_913_length_2479_cov_3.433193	2399	2479	0	80	80	1.0000000
NODE_915_length_2474_cov_7.237895	399	479	0	3	80	0.0375000
NODE_915_length_2474_cov_7.237895	399	479	2	77	80	0.9625000
NODE_915_length_2474_cov_7.237895	452	532	0	56	80	0.7000000
NODE_915_length_2474_cov_7.237895	452	532	2	24	80	0.3000000
NODE_922_length_2465_cov_3.098056	2133	2213	0	80	80	1.0000000
NODE_922_length_2465_cov_3.098056	2191	2253	0	62	62	1.0000000
NODE_923_length_2464_cov_24.562791	331	409	0	58	78	0.7435898
NODE_923_length_2464_cov_24.562791	331	409	2	20	78	0.2564103
NODE_923_length_2464_cov_24.562791	382	462	0	7	80	0.0875000
NODE_923_length_2464_cov_24.562791	382	462	2	73	80	0.9125000
NODE_924_length_2461_cov_2.696444	292	372	0	30	80	0.3750000
NODE_924_length_2461_cov_2.696444	292	372	2	50	80	0.6250000
NODE_924_length_2461_cov_2.696444	345	425	0	80	80	1.0000000
NODE_938_length_2447_cov_16.079216	2344	2424	21	4	80	0.0500000
NODE_938_length_2447_cov_16.079216	2344	2424	27	1	80	0.0125000
NODE_938_length_2447_cov_16.079216	2344	2424	28	1	80	0.0125000
NODE_938_length_2447_cov_16.079216	2344	2424	30	2	80	0.0250000
NODE_938_length_2447_cov_16.079216	2344	2424	31	1	80	0.0125000
NODE_938_length_2447_cov_16.079216	2344	2424	33	7	80	0.0875000
NODE_938_length_2447_cov_16.079216	2344	2424	35	1	80	0.0125000
NODE_938_length_2447_cov_16.079216	2344	2424	36	1	80	0.0125000
NODE_938_length_2447_cov_16.079216	2344	2424	38	4	80	0.0500000
NODE_938_length_2447_cov_16.079216	2344	2424	40	5	80	0.0625000
NODE_938_length_2447_cov_16.079216	2344	2424	42	3	80	0.0375000
NODE_938_length_2447_cov_16.079216	2344	2424	46	1	80	0.0125000
NODE_938_length_2447_cov_16.079216	2344	2424	48	14	80	0.1750000
NODE_938_length_2447_cov_16.079216	2344	2424	50	4	80	0.0500000
NODE_938_length_2447_cov_16.079216	2344	2424	52	3	80	0.0375000
NODE_938_length_2447_cov_16.079216	2344	2424	54	3	80	0.0375000
NODE_938_length_2447_cov_16.079216	2344	2424	55	1	80	0.0125000
NODE_938_length_2447_cov_16.079216	2344	2424	56	3	80	0.0375000
NODE_938_length_2447_cov_16.079216	2344	2424	58	2	80	0.0250000
NODE_938_length_2447_cov_16.079216	2344	2424	60	1	80	0.0125000
NODE_938_length_2447_cov_16.079216	2344	2424	62	10	80	0.1250000
NODE_938_length_2447_cov_16.079216	2344	2424	68	1	80	0.0125000
NODE_938_length_2447_cov_16.079216	2344	2424	70	4	80	0.0500000
NODE_938_length_2447_cov_16.079216	2344	2424	72	3	80	0.0375000
NODE_938_length_2447_cov_16.079216	2397	2447	6	1	50	0.0200000
NODE_938_length_2447_cov_16.079216	2397	2447	8	2	50	0.0400000
NODE_938_length_2447_cov_16.079216	2397	2447	10	1	50	0.0200000
NODE_938_length_2447_cov_16.079216	2397	2447	12	4	50	0.0800000
NODE_938_length_2447_cov_16.079216	2397	2447	13	1	50	0.0200000
NODE_938_length_2447_cov_16.079216	2397	2447	17	8	50	0.1600000
NODE_938_length_2447_cov_16.079216	2397	2447	19	2	50	0.0400000
NODE_938_length_2447_cov_16.079216	2397	2447	21	8	50	0.1600000
NODE_938_length_2447_cov_16.079216	2397	2447	27	1	50	0.0200000
NODE_938_length_2447_cov_16.079216	2397	2447	28	1	50	0.0200000
NODE_938_length_2447_cov_16.079216	2397	2447	30	2	50	0.0400000
NODE_938_length_2447_cov_16.079216	2397	2447	31	1	50	0.0200000
NODE_938_length_2447_cov_16.079216	2397	2447	33	7	50	0.1400000
NODE_938_length_2447_cov_16.079216	2397	2447	35	1	50	0.0200000
NODE_938_length_2447_cov_16.079216	2397	2447	36	1	50	0.0200000
NODE_938_length_2447_cov_16.079216	2397	2447	38	4	50	0.0800000
NODE_938_length_2447_cov_16.079216	2397	2447	40	5	50	0.1000000
NODE_940_length_2446_cov_2.341287	1521	1578	4	5	57	0.0877193
NODE_940_length_2446_cov_2.341287	1521	1578	6	52	57	0.9122807
NODE_940_length_2446_cov_2.341287	1551	1593	4	1	42	0.0238095
NODE_940_length_2446_cov_2.341287	1551	1593	6	41	42	0.9761904
NODE_949_length_2437_cov_13.341745	418	498	0	8	80	0.1000000
NODE_949_length_2437_cov_13.341745	418	498	2	41	80	0.5125000
NODE_949_length_2437_cov_13.341745	418	498	4	31	80	0.3875000
NODE_949_length_2437_cov_13.341745	471	551	0	39	80	0.4875000
NODE_949_length_2437_cov_13.341745	471	551	1	1	80	0.0125000
NODE_949_length_2437_cov_13.341745	471	551	2	22	80	0.2750000
NODE_949_length_2437_cov_13.341745	471	551	4	12	80	0.1500000
NODE_949_length_2437_cov_13.341745	471	551	6	2	80	0.0250000
NODE_949_length_2437_cov_13.341745	471	551	12	2	80	0.0250000
NODE_949_length_2437_cov_13.341745	471	551	17	2	80	0.0250000
NODE_951_length_2432_cov_70.360909	1875	1955	0	35	80	0.4375000
NODE_951_length_2432_cov_70.360909	1875	1955	4	13	80	0.1625000
NODE_951_length_2432_cov_70.360909	1875	1955	6	10	80	0.1250000
NODE_951_length_2432_cov_70.360909	1875	1955	8	22	80	0.2750000
NODE_951_length_2432_cov_70.360909	1928	2008	4	11	80	0.1375000
NODE_951_length_2432_cov_70.360909	1928	2008	6	5	80	0.0625000
NODE_951_length_2432_cov_70.360909	1928	2008	8	64	80	0.8000000
NODE_955_length_2430_cov_19.835264	0	68	27	1	68	0.0147059
NODE_955_length_2430_cov_19.835264	0	68	31	1	68	0.0147059
NODE_955_length_2430_cov_19.835264	0	68	33	1	68	0.0147059
NODE_955_length_2430_cov_19.835264	0	68	53	2	68	0.0294118
NODE_955_length_2430_cov_19.835264	0	68	67	1	68	0.0147059
NODE_955_length_2430_cov_19.835264	0	68	69	1	68	0.0147059
NODE_955_length_2430_cov_19.835264	0	68	71	1	68	0.0147059
NODE_955_length_2430_cov_19.835264	0	68	74	2	68	0.0294118
NODE_955_length_2430_cov_19.835264	0	68	76	1	68	0.0147059
NODE_955_length_2430_cov_19.835264	0	68	78	1	68	0.0147059
NODE_955_length_2430_cov_19.835264	0	68	87	1	68	0.0147059
NODE_955_length_2430_cov_19.835264	0	68	91	2	68	0.0294118
NODE_955_length_2430_cov_19.835264	0	68	93	1	68	0.0147059
NODE_955_length_2430_cov_19.835264	0	68	96	2	68	0.0294118
NODE_955_length_2430_cov_19.835264	0	68	102	1	68	0.0147059
NODE_955_length_2430_cov_19.835264	0	68	108	1	68	0.0147059
NODE_955_length_2430_cov_19.835264	0	68	110	1	68	0.0147059
NODE_955_length_2430_cov_19.835264	0	68	111	1	68	0.0147059
NODE_955_length_2430_cov_19.835264	0	68	113	2	68	0.0294118
NODE_955_length_2430_cov_19.835264	0	68	117	1	68	0.0147059
NODE_955_length_2430_cov_19.835264	0	68	118	1	68	0.0147059
NODE_955_length_2430_cov_19.835264	0	68	122	3	68	0.0441176
NODE_955_length_2430_cov_19.835264	0	68	127	1	68	0.0147059
NODE_955_length_2430_cov_19.835264	0	68	128	3	68	0.0441176
NODE_955_length_2430_cov_19.835264	0	68	132	2	68	0.0294118
NODE_955_length_2430_cov_19.835264	0	68	134	1	68	0.0147059
NODE_955_length_2430_cov_19.835264	0	68	138	1	68	0.0147059
NODE_955_length_2430_cov_19.835264	0	68	145	1	68	0.0147059
NODE_955_length_2430_cov_19.835264	0	68	149	1	68	0.0147059
NODE_955_length_2430_cov_19.835264	0	68	155	3	68	0.0441176
NODE_955_length_2430_cov_19.835264	0	68	157	2	68	0.0294118
NODE_955_length_2430_cov_19.835264	0	68	158	2	68	0.0294118
NODE_955_length_2430_cov_19.835264	0	68	160	1	68	0.0147059
NODE_955_length_2430_cov_19.835264	0	68	166	1	68	0.0147059
NODE_955_length_2430_cov_19.835264	0	68	168	1	68	0.0147059
NODE_955_length_2430_cov_19.835264	0	68	171	1	68	0.0147059
NODE_955_length_2430_cov_19.835264	0	68	173	2	68	0.0294118
NODE_955_length_2430_cov_19.835264	0	68	175	1	68	0.0147059
NODE_955_length_2430_cov_19.835264	0	68	176	2	68	0.0294118
NODE_955_length_2430_cov_19.835264	0	68	180	1	68	0.0147059
NODE_955_length_2430_cov_19.835264	0	68	186	1	68	0.0147059
NODE_955_length_2430_cov_19.835264	0	68	192	1	68	0.0147059
NODE_955_length_2430_cov_19.835264	0	68	196	1	68	0.0147059
NODE_955_length_2430_cov_19.835264	0	68	198	1	68	0.0147059
NODE_955_length_2430_cov_19.835264	0	68	202	1	68	0.0147059
NODE_955_length_2430_cov_19.835264	0	68	213	1	68	0.0147059
NODE_955_length_2430_cov_19.835264	0	68	227	1	68	0.0147059
NODE_955_length_2430_cov_19.835264	0	68	229	2	68	0.0294118
NODE_955_length_2430_cov_19.835264	0	68	232	2	68	0.0294118
NODE_955_length_2430_cov_19.835264	0	68	238	1	68	0.0147059
NODE_955_length_2430_cov_19.835264	0	24	27	1	24	0.0416667
NODE_955_length_2430_cov_19.835264	0	24	31	1	24	0.0416667
NODE_955_length_2430_cov_19.835264	0	24	33	1	24	0.0416667
NODE_955_length_2430_cov_19.835264	0	24	53	2	24	0.0833333
NODE_955_length_2430_cov_19.835264	0	24	67	1	24	0.0416667
NODE_955_length_2430_cov_19.835264	0	24	69	1	24	0.0416667
NODE_955_length_2430_cov_19.835264	0	24	71	1	24	0.0416667
NODE_955_length_2430_cov_19.835264	0	24	74	2	24	0.0833333
NODE_955_length_2430_cov_19.835264	0	24	76	1	24	0.0416667
NODE_955_length_2430_cov_19.835264	0	24	78	1	24	0.0416667
NODE_955_length_2430_cov_19.835264	0	24	87	1	24	0.0416667
NODE_955_length_2430_cov_19.835264	0	24	91	2	24	0.0833333
NODE_955_length_2430_cov_19.835264	0	24	93	1	24	0.0416667
NODE_955_length_2430_cov_19.835264	0	24	96	2	24	0.0833333
NODE_955_length_2430_cov_19.835264	0	24	102	1	24	0.0416667
NODE_955_length_2430_cov_19.835264	0	24	108	1	24	0.0416667
NODE_955_length_2430_cov_19.835264	0	24	110	1	24	0.0416667
NODE_955_length_2430_cov_19.835264	0	24	111	1	24	0.0416667
NODE_955_length_2430_cov_19.835264	0	24	113	2	24	0.0833333
NODE_956_length_2428_cov_179.842422	538	618	0	80	80	1.0000000
NODE_956_length_2428_cov_179.842422	591	671	0	80	80	1.0000000
NODE_956_length_2428_cov_179.842422	667	747	0	80	80	1.0000000
NODE_956_length_2428_cov_179.842422	720	800	0	80	80	1.0000000
NODE_956_length_2428_cov_179.842422	1308	1388	0	12	80	0.1500000
NODE_956_length_2428_cov_179.842422	1308	1388	4	68	80	0.8500000
NODE_956_length_2428_cov_179.842422	1361	1441	0	40	80	0.5000000
NODE_956_length_2428_cov_179.842422	1361	1441	4	40	80	0.5000000
NODE_956_length_2428_cov_179.842422	1437	1517	0	9	80	0.1125000
NODE_956_length_2428_cov_179.842422	1437	1517	2	71	80	0.8875000
NODE_956_length_2428_cov_179.842422	1490	1570	0	53	80	0.6625000
NODE_956_length_2428_cov_179.842422	1490	1570	2	27	80	0.3375000
NODE_956_length_2428_cov_179.842422	1986	2026	768	1	40	0.0250000
NODE_956_length_2428_cov_179.842422	1986	2026	772	1	40	0.0250000
NODE_956_length_2428_cov_179.842422	1986	2026	773	1	40	0.0250000
NODE_956_length_2428_cov_179.842422	1986	2026	774	2	40	0.0500000
NODE_956_length_2428_cov_179.842422	1986	2026	778	1	40	0.0250000
NODE_956_length_2428_cov_179.842422	1986	2026	784	1	40	0.0250000
NODE_956_length_2428_cov_179.842422	1986	2026	786	2	40	0.0500000
NODE_956_length_2428_cov_179.842422	1986	2026	788	1	40	0.0250000
NODE_956_length_2428_cov_179.842422	1986	2026	792	1	40	0.0250000
NODE_956_length_2428_cov_179.842422	1986	2026	794	1	40	0.0250000
NODE_956_length_2428_cov_179.842422	1986	2026	795	1	40	0.0250000
NODE_956_length_2428_cov_179.842422	1986	2026	797	1	40	0.0250000
NODE_956_length_2428_cov_179.842422	1986	2026	798	1	40	0.0250000
NODE_956_length_2428_cov_179.842422	1986	2026	800	2	40	0.0500000
NODE_956_length_2428_cov_179.842422	1986	2026	809	1	40	0.0250000
NODE_956_length_2428_cov_179.842422	1986	2026	813	1	40	0.0250000
NODE_956_length_2428_cov_179.842422	1986	2026	814	2	40	0.0500000
NODE_956_length_2428_cov_179.842422	1986	2026	815	1	40	0.0250000
NODE_956_length_2428_cov_179.842422	1986	2026	819	1	40	0.0250000
NODE_956_length_2428_cov_179.842422	1986	2026	821	1	40	0.0250000
NODE_956_length_2428_cov_179.842422	1986	2026	833	1	40	0.0250000
NODE_956_length_2428_cov_179.842422	1986	2026	835	1	40	0.0250000
NODE_956_length_2428_cov_179.842422	1986	2026	837	1	40	0.0250000
NODE_956_length_2428_cov_179.842422	1986	2026	838	2	40	0.0500000
NODE_956_length_2428_cov_179.842422	1986	2026	840	1	40	0.0250000
NODE_956_length_2428_cov_179.842422	1986	2026	843	1	40	0.0250000
NODE_956_length_2428_cov_179.842422	1986	2026	844	1	40	0.0250000
NODE_956_length_2428_cov_179.842422	1986	2026	851	1	40	0.0250000
NODE_956_length_2428_cov_179.842422	1986	2026	852	1	40	0.0250000
NODE_956_length_2428_cov_179.842422	1986	2026	853	1	40	0.0250000
NODE_956_length_2428_cov_179.842422	1986	2026	854	1	40	0.0250000
NODE_956_length_2428_cov_179.842422	1986	2026	858	1	40	0.0250000
NODE_956_length_2428_cov_179.842422	1986	2026	862	1	40	0.0250000
NODE_956_length_2428_cov_179.842422	1986	2026	863	1	40	0.0250000
NODE_956_length_2428_cov_179.842422	1986	2026	865	1	40	0.0250000
NODE_959_length_2422_cov_6.665088	197	255	0	56	58	0.9655172
NODE_959_length_2422_cov_6.665088	197	255	2	2	58	0.0344828
NODE_963_length_2414_cov_32.871706	411	491	0	80	80	1.0000000
NODE_963_length_2414_cov_32.871706	464	544	0	80	80	1.0000000
NODE_964_length_2414_cov_2.105832	2349	2390	0	41	41	1.0000000
NODE_968_length_2410_cov_9.107313	1874	1954	0	44	80	0.5500000
NODE_968_length_2410_cov_9.107313	1874	1954	6	23	80	0.2875000
NODE_968_length_2410_cov_9.107313	1874	1954	8	13	80	0.1625000
NODE_968_length_2410_cov_9.107313	1927	2007	6	14	80	0.1750000
NODE_968_length_2410_cov_9.107313	1927	2007	8	13	80	0.1625000
NODE_968_length_2410_cov_9.107313	1927	2007	10	3	80	0.0375000
NODE_968_length_2410_cov_9.107313	1927	2007	12	50	80	0.6250000
NODE_977_length_2390_cov_20.371454	1753	1833	0	24	80	0.3000000
NODE_977_length_2390_cov_20.371454	1753	1833	3	1	80	0.0125000
NODE_977_length_2390_cov_20.371454	1753	1833	4	55	80	0.6875000
NODE_977_length_2390_cov_20.371454	1806	1886	0	77	80	0.9625000
NODE_977_length_2390_cov_20.371454	1806	1886	3	1	80	0.0125000
NODE_977_length_2390_cov_20.371454	1806	1886	4	2	80	0.0250000
NODE_979_length_2389_cov_17.904803	1601	1681	3	6	80	0.0750000
NODE_979_length_2389_cov_17.904803	1601	1681	5	3	80	0.0375000
NODE_979_length_2389_cov_17.904803	1601	1681	6	1	80	0.0125000
NODE_979_length_2389_cov_17.904803	1601	1681	7	1	80	0.0125000
NODE_979_length_2389_cov_17.904803	1601	1681	9	45	80	0.5625000
NODE_979_length_2389_cov_17.904803	1601	1681	10	24	80	0.3000000
NODE_979_length_2389_cov_17.904803	1654	1734	0	29	80	0.3625000
NODE_979_length_2389_cov_17.904803	1654	1734	4	24	80	0.3000000
NODE_979_length_2389_cov_17.904803	1654	1734	6	1	80	0.0125000
NODE_979_length_2389_cov_17.904803	1654	1734	7	1	80	0.0125000
NODE_979_length_2389_cov_17.904803	1654	1734	9	25	80	0.3125000
NODE_979_length_2389_cov_17.904803	1730	1810	0	39	80	0.4875000
NODE_979_length_2389_cov_17.904803	1730	1810	2	41	80	0.5125000
NODE_979_length_2389_cov_17.904803	1783	1863	0	11	80	0.1375000
NODE_979_length_2389_cov_17.904803	1783	1863	2	69	80	0.8625000
NODE_988_length_2381_cov_32.280894	398	478	0	80	80	1.0000000
NODE_988_length_2381_cov_32.280894	451	531	0	80	80	1.0000000
NODE_988_length_2381_cov_32.280894	527	607	0	6	80	0.0750000
NODE_988_length_2381_cov_32.280894	527	607	2	67	80	0.8375000
NODE_988_length_2381_cov_32.280894	527	607	4	3	80	0.0375000
NODE_988_length_2381_cov_32.280894	527	607	6	4	80	0.0500000
NODE_988_length_2381_cov_32.280894	580	660	2	20	80	0.2500000
NODE_988_length_2381_cov_32.280894	580	660	4	18	80	0.2250000
NODE_988_length_2381_cov_32.280894	580	660	6	42	80	0.5250000
NODE_988_length_2381_cov_32.280894	2288	2368	0	28	80	0.3500000
NODE_988_length_2381_cov_32.280894	2288	2368	2	14	80	0.1750000
NODE_988_length_2381_cov_32.280894	2288	2368	4	38	80	0.4750000
NODE_997_length_2369_cov_4.896916	241	321	0	80	80	1.0000000
NODE_997_length_2369_cov_4.896916	294	374	0	80	80	1.0000000
NODE_1002_length_2364_cov_2.482561	0	79	0	79	79	1.0000000
NODE_1004_length_2360_cov_8.620080	587	651	2	33	64	0.5156250
NODE_1004_length_2360_cov_8.620080	587	651	4	31	64	0.4843750
NODE_1004_length_2360_cov_8.620080	587	651	2	33	64	0.5156250
NODE_1004_length_2360_cov_8.620080	587	651	4	31	64	0.4843750
NODE_1004_length_2360_cov_8.620080	624	684	2	31	60	0.5166667
NODE_1004_length_2360_cov_8.620080	624	684	4	29	60	0.4833333
NODE_1004_length_2360_cov_8.620080	1827	1907	0	8	80	0.1000000
NODE_1004_length_2360_cov_8.620080	1827	1907	2	72	80	0.9000000
NODE_1004_length_2360_cov_8.620080	1880	1960	0	24	80	0.3000000
NODE_1004_length_2360_cov_8.620080	1880	1960	2	56	80	0.7000000
NODE_1005_length_2359_cov_22.317257	958	1038	0	80	80	1.0000000
NODE_1005_length_2359_cov_22.317257	1011	1091	0	80	80	1.0000000
NODE_1008_length_2357_cov_25.711249	716	796	2	7	80	0.0875000
NODE_1008_length_2357_cov_25.711249	716	796	4	31	80	0.3875000
NODE_1008_length_2357_cov_25.711249	716	796	6	18	80	0.2250000
NODE_1008_length_2357_cov_25.711249	716	796	8	24	80	0.3000000
NODE_1008_length_2357_cov_25.711249	769	849	4	29	80	0.3625000
NODE_1008_length_2357_cov_25.711249	769	849	6	9	80	0.1125000
NODE_1008_length_2357_cov_25.711249	769	849	8	42	80	0.5250000
NODE_1015_length_2345_cov_5.386465	1845	1925	0	80	80	1.0000000
NODE_1015_length_2345_cov_5.386465	1898	1978	0	80	80	1.0000000
NODE_1016_length_2344_cov_6.236526	1208	1269	4	25	61	0.4098361
NODE_1016_length_2344_cov_6.236526	1208	1269	8	3	61	0.0491803
NODE_1016_length_2344_cov_6.236526	1208	1269	9	1	61	0.0163934
NODE_1016_length_2344_cov_6.236526	1208	1269	10	5	61	0.0819672
NODE_1016_length_2344_cov_6.236526	1208	1269	12	27	61	0.4426230
NODE_1016_length_2344_cov_6.236526	1208	1269	4	25	61	0.4098361
NODE_1016_length_2344_cov_6.236526	1208	1269	8	3	61	0.0491803
NODE_1016_length_2344_cov_6.236526	1208	1269	9	1	61	0.0163934
NODE_1016_length_2344_cov_6.236526	1208	1269	10	5	61	0.0819672
NODE_1016_length_2344_cov_6.236526	1208	1269	12	27	61	0.4426230
NODE_1016_length_2344_cov_6.236526	1208	1269	4	25	61	0.4098361
NODE_1016_length_2344_cov_6.236526	1208	1269	8	3	61	0.0491803
NODE_1016_length_2344_cov_6.236526	1208	1269	9	1	61	0.0163934
NODE_1016_length_2344_cov_6.236526	1208	1269	10	5	61	0.0819672
NODE_1016_length_2344_cov_6.236526	1208	1269	12	27	61	0.4426230
NODE_1016_length_2344_cov_6.236526	1208	1267	4	23	59	0.3898305
NODE_1016_length_2344_cov_6.236526	1208	1267	8	3	59	0.0508475
NODE_1016_length_2344_cov_6.236526	1208	1267	9	1	59	0.0169492
NODE_1016_length_2344_cov_6.236526	1208	1267	10	5	59	0.0847458
NODE_1016_length_2344_cov_6.236526	1208	1267	12	27	59	0.4576271
NODE_1023_length_2332_cov_4.725929	34	101	4	8	67	0.1194030
NODE_1023_length_2332_cov_4.725929	34	101	8	55	67	0.8208955
NODE_1023_length_2332_cov_4.725929	34	101	10	2	67	0.0298507
NODE_1023_length_2332_cov_4.725929	34	101	25	2	67	0.0298507
NODE_1027_length_2327_cov_18.210952	2213	2293	0	9	80	0.1125000
NODE_1027_length_2327_cov_18.210952	2213	2293	6	71	80	0.8875000
NODE_1027_length_2327_cov_18.210952	2266	2327	0	8	61	0.1311475
NODE_1027_length_2327_cov_18.210952	2266	2327	6	53	61	0.8688524
NODE_1028_length_2326_cov_15.583745	1709	1789	0	22	80	0.2750000
NODE_1028_length_2326_cov_15.583745	1709	1789	2	42	80	0.5250000
NODE_1028_length_2326_cov_15.583745	1709	1789	3	1	80	0.0125000
NODE_1028_length_2326_cov_15.583745	1709	1789	4	7	80	0.0875000
NODE_1028_length_2326_cov_15.583745	1709	1789	6	4	80	0.0500000
NODE_1028_length_2326_cov_15.583745	1709	1789	8	4	80	0.0500000
NODE_1028_length_2326_cov_15.583745	1762	1842	2	11	80	0.1375000
NODE_1028_length_2326_cov_15.583745	1762	1842	3	1	80	0.0125000
NODE_1028_length_2326_cov_15.583745	1762	1842	4	14	80	0.1750000
NODE_1028_length_2326_cov_15.583745	1762	1842	6	35	80	0.4375000
NODE_1028_length_2326_cov_15.583745	1762	1842	8	19	80	0.2375000
NODE_1030_length_2325_cov_14.998652	553	633	0	80	80	1.0000000
NODE_1030_length_2325_cov_14.998652	606	686	0	74	80	0.9250000
NODE_1030_length_2325_cov_14.998652	606	686	2	6	80	0.0750000
NODE_1034_length_2317_cov_11.956718	920	1000	0	80	80	1.0000000
NODE_1034_length_2317_cov_11.956718	973	1053	0	80	80	1.0000000
NODE_1034_length_2317_cov_11.956718	1049	1129	0	74	80	0.9250000
NODE_1034_length_2317_cov_11.956718	1049	1129	2	6	80	0.0750000
NODE_1034_length_2317_cov_11.956718	1102	1184	0	21	82	0.2560976
NODE_1034_length_2317_cov_11.956718	1102	1184	2	61	82	0.7439024
NODE_1037_length_2316_cov_8.556608	168	247	52	1	79	0.0126582
NODE_1037_length_2316_cov_8.556608	168	247	53	2	79	0.0253165
NODE_1037_length_2316_cov_8.556608	168	247	55	2	79	0.0253165
NODE_1037_length_2316_cov_8.556608	168	247	57	4	79	0.0506329
NODE_1037_length_2316_cov_8.556608	168	247	63	1	79	0.0126582
NODE_1037_length_2316_cov_8.556608	168	247	69	1	79	0.0126582
NODE_1037_length_2316_cov_8.556608	168	247	74	1	79	0.0126582
NODE_1037_length_2316_cov_8.556608	168	247	76	1	79	0.0126582
NODE_1037_length_2316_cov_8.556608	168	247	78	3	79	0.0379747
NODE_1037_length_2316_cov_8.556608	168	247	86	2	79	0.0253165
NODE_1037_length_2316_cov_8.556608	168	247	88	2	79	0.0253165
NODE_1037_length_2316_cov_8.556608	168	247	89	3	79	0.0379747
NODE_1037_length_2316_cov_8.556608	168	247	91	2	79	0.0253165
NODE_1037_length_2316_cov_8.556608	168	247	93	1	79	0.0126582
NODE_1037_length_2316_cov_8.556608	168	247	94	1	79	0.0126582
NODE_1037_length_2316_cov_8.556608	168	247	96	1	79	0.0126582
NODE_1037_length_2316_cov_8.556608	168	247	98	3	79	0.0379747
NODE_1037_length_2316_cov_8.556608	168	247	100	2	79	0.0253165
NODE_1037_length_2316_cov_8.556608	168	247	104	2	79	0.0253165
NODE_1037_length_2316_cov_8.556608	168	247	106	1	79	0.0126582
NODE_1037_length_2316_cov_8.556608	168	247	112	2	79	0.0253165
NODE_1037_length_2316_cov_8.556608	168	247	114	5	79	0.0632911
NODE_1037_length_2316_cov_8.556608	168	247	115	4	79	0.0506329
NODE_1037_length_2316_cov_8.556608	168	247	117	8	79	0.1012658
NODE_1037_length_2316_cov_8.556608	168	247	118	6	79	0.0759494
NODE_1037_length_2316_cov_8.556608	168	247	119	5	79	0.0632911
NODE_1037_length_2316_cov_8.556608	168	247	120	9	79	0.1139240
NODE_1037_length_2316_cov_8.556608	168	247	121	4	79	0.0506329
NODE_1037_length_2316_cov_8.556608	1117	1198	42	3	81	0.0370370
NODE_1037_length_2316_cov_8.556608	1117	1198	44	6	81	0.0740741
NODE_1037_length_2316_cov_8.556608	1117	1198	46	1	81	0.0123457
NODE_1037_length_2316_cov_8.556608	1117	1198	48	2	81	0.0246914
NODE_1037_length_2316_cov_8.556608	1117	1198	49	3	81	0.0370370
NODE_1037_length_2316_cov_8.556608	1117	1198	50	4	81	0.0493827
NODE_1037_length_2316_cov_8.556608	1117	1198	51	1	81	0.0123457
NODE_1037_length_2316_cov_8.556608	1117	1198	52	4	81	0.0493827
NODE_1037_length_2316_cov_8.556608	1117	1198	56	13	81	0.1604938
NODE_1037_length_2316_cov_8.556608	1117	1198	57	9	81	0.1111111
NODE_1037_length_2316_cov_8.556608	1117	1198	58	2	81	0.0246914
NODE_1037_length_2316_cov_8.556608	1117	1198	59	11	81	0.1358025
NODE_1037_length_2316_cov_8.556608	1117	1198	61	3	81	0.0370370
NODE_1037_length_2316_cov_8.556608	1117	1198	64	6	81	0.0740741
NODE_1037_length_2316_cov_8.556608	1117	1198	65	1	81	0.0123457
NODE_1037_length_2316_cov_8.556608	1117	1198	66	4	81	0.0493827
NODE_1037_length_2316_cov_8.556608	1117	1198	67	3	81	0.0370370
NODE_1037_length_2316_cov_8.556608	1117	1198	69	5	81	0.0617284
NODE_1037_length_2316_cov_8.556608	1369	1412	110	3	43	0.0697674
NODE_1037_length_2316_cov_8.556608	1369	1412	112	1	43	0.0232558
NODE_1037_length_2316_cov_8.556608	1369	1412	115	1	43	0.0232558
NODE_1037_length_2316_cov_8.556608	1369	1412	116	3	43	0.0697674
NODE_1037_length_2316_cov_8.556608	1369	1412	117	1	43	0.0232558
NODE_1037_length_2316_cov_8.556608	1369	1412	119	2	43	0.0465116
NODE_1037_length_2316_cov_8.556608	1369	1412	121	2	43	0.0465116
NODE_1037_length_2316_cov_8.556608	1369	1412	123	1	43	0.0232558
NODE_1037_length_2316_cov_8.556608	1369	1412	137	2	43	0.0465116
NODE_1037_length_2316_cov_8.556608	1369	1412	142	5	43	0.1162791
NODE_1037_length_2316_cov_8.556608	1369	1412	143	3	43	0.0697674
NODE_1037_length_2316_cov_8.556608	1369	1412	144	3	43	0.0697674
NODE_1037_length_2316_cov_8.556608	1369	1412	145	2	43	0.0465116
NODE_1037_length_2316_cov_8.556608	1369	1412	146	7	43	0.1627907
NODE_1037_length_2316_cov_8.556608	1369	1412	147	2	43	0.0465116
NODE_1037_length_2316_cov_8.556608	1369	1412	150	2	43	0.0465116
NODE_1037_length_2316_cov_8.556608	1369	1412	152	3	43	0.0697674
NODE_1040_length_2311_cov_2.821881	2121	2201	0	80	80	1.0000000
NODE_1040_length_2311_cov_2.821881	2174	2225	0	51	51	1.0000000
NODE_1044_length_2306_cov_17.347984	995	1075	0	16	80	0.2000000
NODE_1044_length_2306_cov_17.347984	995	1075	2	15	80	0.1875000
NODE_1044_length_2306_cov_17.347984	995	1075	6	49	80	0.6125000
NODE_1044_length_2306_cov_17.347984	1048	1128	0	16	80	0.2000000
NODE_1044_length_2306_cov_17.347984	1048	1128	2	64	80	0.8000000
NODE_1052_length_2300_cov_9.803271	934	1014	0	38	80	0.4750000
NODE_1052_length_2300_cov_9.803271	934	1014	2	42	80	0.5250000
NODE_1052_length_2300_cov_9.803271	1892	1965	0	71	73	0.9726027
NODE_1052_length_2300_cov_9.803271	1892	1965	2	2	73	0.0273973
NODE_1059_length_2289_cov_17.807306	968	1026	131	3	58	0.0517241
NODE_1059_length_2289_cov_17.807306	968	1026	133	4	58	0.0689655
NODE_1059_length_2289_cov_17.807306	968	1026	135	1	58	0.0172414
NODE_1059_length_2289_cov_17.807306	968	1026	139	2	58	0.0344828
NODE_1059_length_2289_cov_17.807306	968	1026	141	2	58	0.0344828
NODE_1059_length_2289_cov_17.807306	968	1026	143	2	58	0.0344828
NODE_1059_length_2289_cov_17.807306	968	1026	145	9	58	0.1551724
NODE_1059_length_2289_cov_17.807306	968	1026	147	7	58	0.1206897
NODE_1059_length_2289_cov_17.807306	968	1026	151	1	58	0.0172414
NODE_1059_length_2289_cov_17.807306	968	1026	153	3	58	0.0517241
NODE_1059_length_2289_cov_17.807306	968	1026	155	1	58	0.0172414
NODE_1059_length_2289_cov_17.807306	968	1026	157	2	58	0.0344828
NODE_1059_length_2289_cov_17.807306	968	1026	159	7	58	0.1206897
NODE_1059_length_2289_cov_17.807306	968	1026	161	1	58	0.0172414
NODE_1059_length_2289_cov_17.807306	968	1026	163	3	58	0.0517241
NODE_1059_length_2289_cov_17.807306	968	1026	165	2	58	0.0344828
NODE_1059_length_2289_cov_17.807306	968	1026	167	3	58	0.0517241
NODE_1059_length_2289_cov_17.807306	968	1026	169	4	58	0.0689655
NODE_1059_length_2289_cov_17.807306	968	1026	173	1	58	0.0172414
NODE_1059_length_2289_cov_17.807306	1021	1079	79	1	58	0.0172414
NODE_1059_length_2289_cov_17.807306	1021	1079	84	2	58	0.0344828
NODE_1059_length_2289_cov_17.807306	1021	1079	88	1	58	0.0172414
NODE_1059_length_2289_cov_17.807306	1021	1079	92	3	58	0.0517241
NODE_1059_length_2289_cov_17.807306	1021	1079	93	1	58	0.0172414
NODE_1059_length_2289_cov_17.807306	1021	1079	94	2	58	0.0344828
NODE_1059_length_2289_cov_17.807306	1021	1079	96	1	58	0.0172414
NODE_1059_length_2289_cov_17.807306	1021	1079	98	4	58	0.0689655
NODE_1059_length_2289_cov_17.807306	1021	1079	102	1	58	0.0172414
NODE_1059_length_2289_cov_17.807306	1021	1079	103	2	58	0.0344828
NODE_1059_length_2289_cov_17.807306	1021	1079	104	1	58	0.0172414
NODE_1059_length_2289_cov_17.807306	1021	1079	105	2	58	0.0344828
NODE_1059_length_2289_cov_17.807306	1021	1079	106	2	58	0.0344828
NODE_1059_length_2289_cov_17.807306	1021	1079	107	6	58	0.1034483
NODE_1059_length_2289_cov_17.807306	1021	1079	108	1	58	0.0172414
NODE_1059_length_2289_cov_17.807306	1021	1079	110	1	58	0.0172414
NODE_1059_length_2289_cov_17.807306	1021	1079	111	3	58	0.0517241
NODE_1059_length_2289_cov_17.807306	1021	1079	112	1	58	0.0172414
NODE_1059_length_2289_cov_17.807306	1021	1079	113	1	58	0.0172414
NODE_1059_length_2289_cov_17.807306	1021	1079	114	1	58	0.0172414
NODE_1059_length_2289_cov_17.807306	1021	1079	115	2	58	0.0344828
NODE_1059_length_2289_cov_17.807306	1021	1079	119	1	58	0.0172414
NODE_1059_length_2289_cov_17.807306	1021	1079	131	1	58	0.0172414
NODE_1059_length_2289_cov_17.807306	1021	1079	132	5	58	0.0862069
NODE_1059_length_2289_cov_17.807306	1021	1079	133	7	58	0.1206897
NODE_1059_length_2289_cov_17.807306	1021	1079	134	3	58	0.0517241
NODE_1059_length_2289_cov_17.807306	1021	1079	135	2	58	0.0344828
NODE_1060_length_2289_cov_7.736986	2161	2218	138	1	57	0.0175439
NODE_1060_length_2289_cov_7.736986	2161	2218	156	1	57	0.0175439
NODE_1060_length_2289_cov_7.736986	2161	2218	158	2	57	0.0350877
NODE_1060_length_2289_cov_7.736986	2161	2218	166	1	57	0.0175439
NODE_1060_length_2289_cov_7.736986	2161	2218	178	1	57	0.0175439
NODE_1060_length_2289_cov_7.736986	2161	2218	179	1	57	0.0175439
NODE_1060_length_2289_cov_7.736986	2161	2218	186	1	57	0.0175439
NODE_1060_length_2289_cov_7.736986	2161	2218	202	1	57	0.0175439
NODE_1060_length_2289_cov_7.736986	2161	2218	209	1	57	0.0175439
NODE_1060_length_2289_cov_7.736986	2161	2218	219	2	57	0.0350877
NODE_1060_length_2289_cov_7.736986	2161	2218	220	1	57	0.0175439
NODE_1060_length_2289_cov_7.736986	2161	2218	228	1	57	0.0175439
NODE_1060_length_2289_cov_7.736986	2161	2218	230	2	57	0.0350877
NODE_1060_length_2289_cov_7.736986	2161	2218	234	1	57	0.0175439
NODE_1060_length_2289_cov_7.736986	2161	2218	236	1	57	0.0175439
NODE_1060_length_2289_cov_7.736986	2161	2218	240	1	57	0.0175439
NODE_1060_length_2289_cov_7.736986	2161	2218	244	1	57	0.0175439
NODE_1060_length_2289_cov_7.736986	2161	2218	251	2	57	0.0350877
NODE_1060_length_2289_cov_7.736986	2161	2218	256	1	57	0.0175439
NODE_1060_length_2289_cov_7.736986	2161	2218	260	1	57	0.0175439
NODE_1060_length_2289_cov_7.736986	2161	2218	264	1	57	0.0175439
NODE_1060_length_2289_cov_7.736986	2161	2218	266	2	57	0.0350877
NODE_1060_length_2289_cov_7.736986	2161	2218	268	30	57	0.5263158
NODE_1060_length_2289_cov_7.736986	2191	2271	145	1	80	0.0125000
NODE_1060_length_2289_cov_7.736986	2191	2271	155	2	80	0.0250000
NODE_1060_length_2289_cov_7.736986	2191	2271	173	1	80	0.0125000
NODE_1060_length_2289_cov_7.736986	2191	2271	187	1	80	0.0125000
NODE_1060_length_2289_cov_7.736986	2191	2271	199	1	80	0.0125000
NODE_1060_length_2289_cov_7.736986	2191	2271	202	1	80	0.0125000
NODE_1060_length_2289_cov_7.736986	2191	2271	211	1	80	0.0125000
NODE_1060_length_2289_cov_7.736986	2191	2271	217	1	80	0.0125000
NODE_1060_length_2289_cov_7.736986	2191	2271	233	1	80	0.0125000
NODE_1060_length_2289_cov_7.736986	2191	2271	242	1	80	0.0125000
NODE_1060_length_2289_cov_7.736986	2191	2271	246	1	80	0.0125000
NODE_1060_length_2289_cov_7.736986	2191	2271	248	2	80	0.0250000
NODE_1060_length_2289_cov_7.736986	2191	2271	258	1	80	0.0125000
NODE_1060_length_2289_cov_7.736986	2191	2271	262	1	80	0.0125000
NODE_1060_length_2289_cov_7.736986	2191	2271	266	3	80	0.0375000
NODE_1060_length_2289_cov_7.736986	2191	2271	267	1	80	0.0125000
NODE_1060_length_2289_cov_7.736986	2191	2271	268	60	80	0.7500000
NODE_1061_length_2288_cov_8.539973	340	420	1	3	80	0.0375000
NODE_1061_length_2288_cov_8.539973	340	420	2	5	80	0.0625000
NODE_1061_length_2288_cov_8.539973	340	420	4	3	80	0.0375000
NODE_1061_length_2288_cov_8.539973	340	420	6	13	80	0.1625000
NODE_1061_length_2288_cov_8.539973	340	420	8	29	80	0.3625000
NODE_1061_length_2288_cov_8.539973	340	420	11	4	80	0.0500000
NODE_1061_length_2288_cov_8.539973	340	420	12	3	80	0.0375000
NODE_1061_length_2288_cov_8.539973	340	420	14	1	80	0.0125000
NODE_1061_length_2288_cov_8.539973	340	420	16	11	80	0.1375000
NODE_1061_length_2288_cov_8.539973	340	420	18	2	80	0.0250000
NODE_1061_length_2288_cov_8.539973	340	420	22	6	80	0.0750000
NODE_1061_length_2288_cov_8.539973	393	473	0	1	80	0.0125000
NODE_1061_length_2288_cov_8.539973	393	473	2	3	80	0.0375000
NODE_1061_length_2288_cov_8.539973	393	473	4	21	80	0.2625000
NODE_1061_length_2288_cov_8.539973	393	473	7	5	80	0.0625000
NODE_1061_length_2288_cov_8.539973	393	473	8	50	80	0.6250000
NODE_1065_length_2278_cov_19.655805	450	530	4	3	80	0.0375000
NODE_1065_length_2278_cov_19.655805	450	530	7	1	80	0.0125000
NODE_1065_length_2278_cov_19.655805	450	530	8	9	80	0.1125000
NODE_1065_length_2278_cov_19.655805	450	530	10	19	80	0.2375000
NODE_1065_length_2278_cov_19.655805	450	530	12	32	80	0.4000000
NODE_1065_length_2278_cov_19.655805	450	530	14	16	80	0.2000000
NODE_1065_length_2278_cov_19.655805	503	583	0	29	80	0.3625000
NODE_1065_length_2278_cov_19.655805	503	583	2	19	80	0.2375000
NODE_1065_length_2278_cov_19.655805	503	583	4	8	80	0.1000000
NODE_1065_length_2278_cov_19.655805	503	583	7	1	80	0.0125000
NODE_1065_length_2278_cov_19.655805	503	583	8	9	80	0.1125000
NODE_1065_length_2278_cov_19.655805	503	583	10	14	80	0.1750000
NODE_1065_length_2278_cov_19.655805	579	659	0	80	80	1.0000000
NODE_1065_length_2278_cov_19.655805	632	712	0	80	80	1.0000000
NODE_1071_length_2272_cov_26.123792	226	306	0	15	80	0.1875000
NODE_1071_length_2272_cov_26.123792	226	306	4	22	80	0.2750000
NODE_1071_length_2272_cov_26.123792	226	306	6	43	80	0.5375000
NODE_1071_length_2272_cov_26.123792	279	359	2	22	80	0.2750000
NODE_1071_length_2272_cov_26.123792	279	359	6	58	80	0.7250000
NODE_1071_length_2272_cov_26.123792	1684	1731	18	1	47	0.0212766
NODE_1071_length_2272_cov_26.123792	1684	1731	26	1	47	0.0212766
NODE_1071_length_2272_cov_26.123792	1684	1731	39	1	47	0.0212766
NODE_1071_length_2272_cov_26.123792	1684	1731	51	1	47	0.0212766
NODE_1071_length_2272_cov_26.123792	1684	1731	62	1	47	0.0212766
NODE_1071_length_2272_cov_26.123792	1684	1731	66	1	47	0.0212766
NODE_1071_length_2272_cov_26.123792	1684	1731	82	2	47	0.0425532
NODE_1071_length_2272_cov_26.123792	1684	1731	83	1	47	0.0212766
NODE_1071_length_2272_cov_26.123792	1684	1731	89	2	47	0.0425532
NODE_1071_length_2272_cov_26.123792	1684	1731	91	1	47	0.0212766
NODE_1071_length_2272_cov_26.123792	1684	1731	92	2	47	0.0425532
NODE_1071_length_2272_cov_26.123792	1684	1731	96	1	47	0.0212766
NODE_1071_length_2272_cov_26.123792	1684	1731	98	2	47	0.0425532
NODE_1071_length_2272_cov_26.123792	1684	1731	108	2	47	0.0425532
NODE_1071_length_2272_cov_26.123792	1684	1731	110	1	47	0.0212766
NODE_1071_length_2272_cov_26.123792	1684	1731	114	1	47	0.0212766
NODE_1071_length_2272_cov_26.123792	1684	1731	119	1	47	0.0212766
NODE_1071_length_2272_cov_26.123792	1684	1731	136	1	47	0.0212766
NODE_1071_length_2272_cov_26.123792	1684	1731	140	1	47	0.0212766
NODE_1071_length_2272_cov_26.123792	1684	1731	146	1	47	0.0212766
NODE_1071_length_2272_cov_26.123792	1684	1731	147	1	47	0.0212766
NODE_1071_length_2272_cov_26.123792	1684	1731	157	1	47	0.0212766
NODE_1071_length_2272_cov_26.123792	1684	1731	159	1	47	0.0212766
NODE_1071_length_2272_cov_26.123792	1684	1731	163	1	47	0.0212766
NODE_1071_length_2272_cov_26.123792	1684	1731	168	1	47	0.0212766
NODE_1071_length_2272_cov_26.123792	1684	1731	170	1	47	0.0212766
NODE_1071_length_2272_cov_26.123792	1684	1731	179	1	47	0.0212766
NODE_1071_length_2272_cov_26.123792	1684	1731	180	1	47	0.0212766
NODE_1071_length_2272_cov_26.123792	1684	1731	183	1	47	0.0212766
NODE_1071_length_2272_cov_26.123792	1684	1731	189	2	47	0.0425532
NODE_1071_length_2272_cov_26.123792	1684	1731	191	1	47	0.0212766
NODE_1071_length_2272_cov_26.123792	1684	1731	198	1	47	0.0212766
NODE_1071_length_2272_cov_26.123792	1684	1731	207	1	47	0.0212766
NODE_1071_length_2272_cov_26.123792	1684	1731	212	2	47	0.0425532
NODE_1071_length_2272_cov_26.123792	1684	1731	216	1	47	0.0212766
NODE_1071_length_2272_cov_26.123792	1684	1731	220	1	47	0.0212766
NODE_1071_length_2272_cov_26.123792	1684	1731	224	1	47	0.0212766
NODE_1071_length_2272_cov_26.123792	1684	1731	228	1	47	0.0212766
NODE_1071_length_2272_cov_26.123792	1684	1731	245	1	47	0.0212766
NODE_1071_length_2272_cov_26.123792	1684	1731	248	1	47	0.0212766
NODE_1071_length_2272_cov_26.123792	1694	1725	82	2	31	0.0645161
NODE_1071_length_2272_cov_26.123792	1694	1725	83	1	31	0.0322581
NODE_1071_length_2272_cov_26.123792	1694	1725	89	2	31	0.0645161
NODE_1071_length_2272_cov_26.123792	1694	1725	91	1	31	0.0322581
NODE_1071_length_2272_cov_26.123792	1694	1725	92	2	31	0.0645161
NODE_1071_length_2272_cov_26.123792	1694	1725	96	1	31	0.0322581
NODE_1071_length_2272_cov_26.123792	1694	1725	98	2	31	0.0645161
NODE_1071_length_2272_cov_26.123792	1694	1725	108	2	31	0.0645161
NODE_1071_length_2272_cov_26.123792	1694	1725	110	1	31	0.0322581
NODE_1071_length_2272_cov_26.123792	1694	1725	114	1	31	0.0322581
NODE_1071_length_2272_cov_26.123792	1694	1725	119	1	31	0.0322581
NODE_1071_length_2272_cov_26.123792	1694	1725	136	1	31	0.0322581
NODE_1071_length_2272_cov_26.123792	1694	1725	140	1	31	0.0322581
NODE_1071_length_2272_cov_26.123792	1694	1725	146	1	31	0.0322581
NODE_1071_length_2272_cov_26.123792	1694	1725	147	1	31	0.0322581
NODE_1071_length_2272_cov_26.123792	1694	1725	157	1	31	0.0322581
NODE_1071_length_2272_cov_26.123792	1694	1725	159	1	31	0.0322581
NODE_1071_length_2272_cov_26.123792	1694	1725	163	1	31	0.0322581
NODE_1071_length_2272_cov_26.123792	1694	1725	168	1	31	0.0322581
NODE_1071_length_2272_cov_26.123792	1694	1725	170	1	31	0.0322581
NODE_1071_length_2272_cov_26.123792	1694	1725	179	1	31	0.0322581
NODE_1071_length_2272_cov_26.123792	1694	1725	180	1	31	0.0322581
NODE_1071_length_2272_cov_26.123792	1694	1725	183	1	31	0.0322581
NODE_1071_length_2272_cov_26.123792	1694	1725	189	2	31	0.0645161
NODE_1071_length_2272_cov_26.123792	1694	1725	191	1	31	0.0322581
NODE_1071_length_2272_cov_26.123792	1759	1833	6	74	74	1.0000000
NODE_1071_length_2272_cov_26.123792	1812	1892	0	35	80	0.4375000
NODE_1071_length_2272_cov_26.123792	1812	1892	2	12	80	0.1500000
NODE_1071_length_2272_cov_26.123792	1812	1892	6	33	80	0.4125000
NODE_1072_length_2272_cov_8.175334	213	293	98	3	80	0.0375000
NODE_1072_length_2272_cov_8.175334	213	293	99	2	80	0.0250000
NODE_1072_length_2272_cov_8.175334	213	293	100	1	80	0.0125000
NODE_1072_length_2272_cov_8.175334	213	293	102	3	80	0.0375000
NODE_1072_length_2272_cov_8.175334	213	293	104	2	80	0.0250000
NODE_1072_length_2272_cov_8.175334	213	293	105	3	80	0.0375000
NODE_1072_length_2272_cov_8.175334	213	293	107	3	80	0.0375000
NODE_1072_length_2272_cov_8.175334	213	293	109	1	80	0.0125000
NODE_1072_length_2272_cov_8.175334	213	293	113	1	80	0.0125000
NODE_1072_length_2272_cov_8.175334	213	293	114	2	80	0.0250000
NODE_1072_length_2272_cov_8.175334	213	293	116	2	80	0.0250000
NODE_1072_length_2272_cov_8.175334	213	293	118	2	80	0.0250000
NODE_1072_length_2272_cov_8.175334	213	293	119	3	80	0.0375000
NODE_1072_length_2272_cov_8.175334	213	293	120	1	80	0.0125000
NODE_1072_length_2272_cov_8.175334	213	293	121	1	80	0.0125000
NODE_1072_length_2272_cov_8.175334	213	293	128	3	80	0.0375000
NODE_1072_length_2272_cov_8.175334	213	293	129	1	80	0.0125000
NODE_1072_length_2272_cov_8.175334	213	293	130	2	80	0.0250000
NODE_1072_length_2272_cov_8.175334	213	293	134	2	80	0.0250000
NODE_1072_length_2272_cov_8.175334	213	293	136	1	80	0.0125000
NODE_1072_length_2272_cov_8.175334	213	293	142	4	80	0.0500000
NODE_1072_length_2272_cov_8.175334	213	293	143	2	80	0.0250000
NODE_1072_length_2272_cov_8.175334	213	293	144	6	80	0.0750000
NODE_1072_length_2272_cov_8.175334	213	293	145	1	80	0.0125000
NODE_1072_length_2272_cov_8.175334	213	293	146	2	80	0.0250000
NODE_1072_length_2272_cov_8.175334	213	293	147	3	80	0.0375000
NODE_1072_length_2272_cov_8.175334	213	293	148	2	80	0.0250000
NODE_1072_length_2272_cov_8.175334	213	293	149	6	80	0.0750000
NODE_1072_length_2272_cov_8.175334	213	293	150	5	80	0.0625000
NODE_1072_length_2272_cov_8.175334	213	293	151	2	80	0.0250000
NODE_1072_length_2272_cov_8.175334	213	293	152	6	80	0.0750000
NODE_1072_length_2272_cov_8.175334	213	293	153	2	80	0.0250000
NODE_1072_length_2272_cov_8.175334	266	346	14	1	80	0.0125000
NODE_1072_length_2272_cov_8.175334	266	346	20	1	80	0.0125000
NODE_1072_length_2272_cov_8.175334	266	346	30	5	80	0.0625000
NODE_1072_length_2272_cov_8.175334	266	346	33	3	80	0.0375000
NODE_1072_length_2272_cov_8.175334	266	346	41	1	80	0.0125000
NODE_1072_length_2272_cov_8.175334	266	346	45	4	80	0.0500000
NODE_1072_length_2272_cov_8.175334	266	346	55	3	80	0.0375000
NODE_1072_length_2272_cov_8.175334	266	346	57	2	80	0.0250000
NODE_1072_length_2272_cov_8.175334	266	346	58	1	80	0.0125000
NODE_1072_length_2272_cov_8.175334	266	346	60	2	80	0.0250000
NODE_1072_length_2272_cov_8.175334	266	346	62	1	80	0.0125000
NODE_1072_length_2272_cov_8.175334	266	346	64	1	80	0.0125000
NODE_1072_length_2272_cov_8.175334	266	346	65	7	80	0.0875000
NODE_1072_length_2272_cov_8.175334	266	346	67	1	80	0.0125000
NODE_1072_length_2272_cov_8.175334	266	346	75	1	80	0.0125000
NODE_1072_length_2272_cov_8.175334	266	346	78	4	80	0.0500000
NODE_1072_length_2272_cov_8.175334	266	346	82	6	80	0.0750000
NODE_1072_length_2272_cov_8.175334	266	346	86	2	80	0.0250000
NODE_1072_length_2272_cov_8.175334	266	346	92	1	80	0.0125000
NODE_1072_length_2272_cov_8.175334	266	346	94	1	80	0.0125000
NODE_1072_length_2272_cov_8.175334	266	346	96	2	80	0.0250000
NODE_1072_length_2272_cov_8.175334	266	346	97	2	80	0.0250000
NODE_1072_length_2272_cov_8.175334	266	346	98	3	80	0.0375000
NODE_1072_length_2272_cov_8.175334	266	346	99	3	80	0.0375000
NODE_1072_length_2272_cov_8.175334	266	346	100	1	80	0.0125000
NODE_1072_length_2272_cov_8.175334	266	346	102	3	80	0.0375000
NODE_1072_length_2272_cov_8.175334	266	346	104	2	80	0.0250000
NODE_1072_length_2272_cov_8.175334	266	346	105	3	80	0.0375000
NODE_1072_length_2272_cov_8.175334	266	346	107	3	80	0.0375000
NODE_1072_length_2272_cov_8.175334	266	346	109	1	80	0.0125000
NODE_1072_length_2272_cov_8.175334	266	346	113	1	80	0.0125000
NODE_1072_length_2272_cov_8.175334	266	346	119	1	80	0.0125000
NODE_1072_length_2272_cov_8.175334	266	346	121	1	80	0.0125000
NODE_1072_length_2272_cov_8.175334	266	346	129	1	80	0.0125000
NODE_1072_length_2272_cov_8.175334	266	346	142	1	80	0.0125000
NODE_1072_length_2272_cov_8.175334	266	346	144	4	80	0.0500000
NODE_1077_length_2266_cov_13.206276	359	439	0	52	80	0.6500000
NODE_1077_length_2266_cov_13.206276	359	439	2	23	80	0.2875000
NODE_1077_length_2266_cov_13.206276	359	439	4	4	80	0.0500000
NODE_1077_length_2266_cov_13.206276	359	439	6	1	80	0.0125000
NODE_1077_length_2266_cov_13.206276	412	492	0	2	80	0.0250000
NODE_1077_length_2266_cov_13.206276	412	492	2	22	80	0.2750000
NODE_1077_length_2266_cov_13.206276	412	492	4	28	80	0.3500000
NODE_1077_length_2266_cov_13.206276	412	492	8	3	80	0.0375000
NODE_1077_length_2266_cov_13.206276	412	492	11	1	80	0.0125000
NODE_1077_length_2266_cov_13.206276	412	492	12	9	80	0.1125000
NODE_1077_length_2266_cov_13.206276	412	492	16	13	80	0.1625000
NODE_1077_length_2266_cov_13.206276	412	492	18	2	80	0.0250000
NODE_1077_length_2266_cov_13.206276	488	568	16	17	80	0.2125000
NODE_1077_length_2266_cov_13.206276	488	568	18	3	80	0.0375000
NODE_1077_length_2266_cov_13.206276	488	568	20	20	80	0.2500000
NODE_1077_length_2266_cov_13.206276	488	568	22	10	80	0.1250000
NODE_1077_length_2266_cov_13.206276	488	568	24	30	80	0.3750000
NODE_1077_length_2266_cov_13.206276	541	627	6	19	86	0.2209302
NODE_1077_length_2266_cov_13.206276	541	627	8	21	86	0.2441860
NODE_1077_length_2266_cov_13.206276	541	627	12	17	86	0.1976744
NODE_1077_length_2266_cov_13.206276	541	627	16	11	86	0.1279070
NODE_1077_length_2266_cov_13.206276	541	627	20	12	86	0.1395349
NODE_1077_length_2266_cov_13.206276	541	627	22	4	86	0.0465116
NODE_1077_length_2266_cov_13.206276	541	627	24	2	86	0.0232558
NODE_1078_length_2262_cov_11.759131	413	493	0	80	80	1.0000000
NODE_1078_length_2262_cov_11.759131	466	546	0	80	80	1.0000000
NODE_1079_length_2260_cov_37.814901	219	299	0	8	80	0.1000000
NODE_1079_length_2260_cov_37.814901	219	299	4	72	80	0.9000000
NODE_1079_length_2260_cov_37.814901	742	822	6	13	80	0.1625000
NODE_1079_length_2260_cov_37.814901	742	822	8	4	80	0.0500000
NODE_1079_length_2260_cov_37.814901	742	822	10	11	80	0.1375000
NODE_1079_length_2260_cov_37.814901	742	822	12	52	80	0.6500000
NODE_1079_length_2260_cov_37.814901	795	875	6	54	80	0.6750000
NODE_1079_length_2260_cov_37.814901	795	875	8	4	80	0.0500000
NODE_1079_length_2260_cov_37.814901	795	875	10	11	80	0.1375000
NODE_1079_length_2260_cov_37.814901	795	875	12	11	80	0.1375000
NODE_1079_length_2260_cov_37.814901	1533	1613	10	13	80	0.1625000
NODE_1079_length_2260_cov_37.814901	1533	1613	12	6	80	0.0750000
NODE_1079_length_2260_cov_37.814901	1533	1613	14	36	80	0.4500000
NODE_1079_length_2260_cov_37.814901	1533	1613	16	1	80	0.0125000
NODE_1079_length_2260_cov_37.814901	1533	1613	18	24	80	0.3000000
NODE_1079_length_2260_cov_37.814901	1586	1666	2	14	80	0.1750000
NODE_1079_length_2260_cov_37.814901	1586	1666	3	4	80	0.0500000
NODE_1079_length_2260_cov_37.814901	1586	1666	4	28	80	0.3500000
NODE_1079_length_2260_cov_37.814901	1586	1666	6	4	80	0.0500000
NODE_1079_length_2260_cov_37.814901	1586	1666	8	3	80	0.0375000
NODE_1079_length_2260_cov_37.814901	1586	1666	10	13	80	0.1625000
NODE_1079_length_2260_cov_37.814901	1586	1666	12	6	80	0.0750000
NODE_1079_length_2260_cov_37.814901	1586	1666	14	8	80	0.1000000
NODE_1079_length_2260_cov_37.814901	1662	1742	2	66	80	0.8250000
NODE_1079_length_2260_cov_37.814901	1662	1742	4	14	80	0.1750000
NODE_1079_length_2260_cov_37.814901	1715	1795	0	7	80	0.0875000
NODE_1079_length_2260_cov_37.814901	1715	1795	1	4	80	0.0500000
NODE_1079_length_2260_cov_37.814901	1715	1795	2	69	80	0.8625000
NODE_1082_length_2253_cov_8.904828	472	552	21	2	80	0.0250000
NODE_1082_length_2253_cov_8.904828	472	552	25	8	80	0.1000000
NODE_1082_length_2253_cov_8.904828	472	552	26	6	80	0.0750000
NODE_1082_length_2253_cov_8.904828	472	552	32	1	80	0.0125000
NODE_1082_length_2253_cov_8.904828	472	552	41	1	80	0.0125000
NODE_1082_length_2253_cov_8.904828	472	552	43	4	80	0.0500000
NODE_1082_length_2253_cov_8.904828	472	552	47	1	80	0.0125000
NODE_1082_length_2253_cov_8.904828	472	552	48	5	80	0.0625000
NODE_1082_length_2253_cov_8.904828	472	552	50	1	80	0.0125000
NODE_1082_length_2253_cov_8.904828	472	552	51	1	80	0.0125000
NODE_1082_length_2253_cov_8.904828	472	552	52	4	80	0.0500000
NODE_1082_length_2253_cov_8.904828	472	552	56	2	80	0.0250000
NODE_1082_length_2253_cov_8.904828	472	552	58	1	80	0.0125000
NODE_1082_length_2253_cov_8.904828	472	552	61	1	80	0.0125000
NODE_1082_length_2253_cov_8.904828	472	552	66	1	80	0.0125000
NODE_1082_length_2253_cov_8.904828	472	552	68	2	80	0.0250000
NODE_1082_length_2253_cov_8.904828	472	552	69	2	80	0.0250000
NODE_1082_length_2253_cov_8.904828	472	552	71	11	80	0.1375000
NODE_1082_length_2253_cov_8.904828	472	552	73	1	80	0.0125000
NODE_1082_length_2253_cov_8.904828	472	552	75	1	80	0.0125000
NODE_1082_length_2253_cov_8.904828	472	552	76	3	80	0.0375000
NODE_1082_length_2253_cov_8.904828	472	552	77	7	80	0.0875000
NODE_1082_length_2253_cov_8.904828	472	552	80	2	80	0.0250000
NODE_1082_length_2253_cov_8.904828	472	552	81	4	80	0.0500000
NODE_1082_length_2253_cov_8.904828	472	552	87	2	80	0.0250000
NODE_1082_length_2253_cov_8.904828	472	552	91	2	80	0.0250000
NODE_1082_length_2253_cov_8.904828	472	552	93	4	80	0.0500000
NODE_1085_length_2252_cov_2.801208	1128	1170	6	42	42	1.0000000
NODE_1085_length_2252_cov_2.801208	1137	1172	6	35	35	1.0000000
NODE_1086_length_2252_cov_2.078031	13	62	0	49	49	1.0000000
NODE_1086_length_2252_cov_2.078031	13	61	0	48	48	1.0000000
NODE_1086_length_2252_cov_2.078031	13	62	0	49	49	1.0000000
NODE_1086_length_2252_cov_2.078031	13	62	0	49	49	1.0000000
NODE_1086_length_2252_cov_2.078031	13	61	0	48	48	1.0000000
NODE_1087_length_2251_cov_15.458178	1443	1506	4	4	63	0.0634921
NODE_1087_length_2251_cov_15.458178	1443	1506	5	23	63	0.3650794
NODE_1087_length_2251_cov_15.458178	1443	1506	6	12	63	0.1904762
NODE_1087_length_2251_cov_15.458178	1443	1506	7	21	63	0.3333333
NODE_1087_length_2251_cov_15.458178	1443	1506	11	1	63	0.0158730
NODE_1087_length_2251_cov_15.458178	1443	1506	13	1	63	0.0158730
NODE_1087_length_2251_cov_15.458178	1443	1506	19	1	63	0.0158730
NODE_1087_length_2251_cov_15.458178	1496	1550	4	7	54	0.1296296
NODE_1087_length_2251_cov_15.458178	1496	1550	5	12	54	0.2222222
NODE_1087_length_2251_cov_15.458178	1496	1550	6	6	54	0.1111111
NODE_1087_length_2251_cov_15.458178	1496	1550	7	1	54	0.0185185
NODE_1087_length_2251_cov_15.458178	1496	1550	10	3	54	0.0555556
NODE_1087_length_2251_cov_15.458178	1496	1550	11	1	54	0.0185185
NODE_1087_length_2251_cov_15.458178	1496	1550	18	1	54	0.0185185
NODE_1087_length_2251_cov_15.458178	1496	1550	19	1	54	0.0185185
NODE_1087_length_2251_cov_15.458178	1496	1550	27	1	54	0.0185185
NODE_1087_length_2251_cov_15.458178	1496	1550	30	4	54	0.0740741
NODE_1087_length_2251_cov_15.458178	1496	1550	31	4	54	0.0740741
NODE_1087_length_2251_cov_15.458178	1496	1550	35	1	54	0.0185185
NODE_1087_length_2251_cov_15.458178	1496	1550	38	1	54	0.0185185
NODE_1087_length_2251_cov_15.458178	1496	1550	40	1	54	0.0185185
NODE_1087_length_2251_cov_15.458178	1496	1550	41	3	54	0.0555556
NODE_1087_length_2251_cov_15.458178	1496	1550	43	1	54	0.0185185
NODE_1087_length_2251_cov_15.458178	1496	1550	44	1	54	0.0185185
NODE_1087_length_2251_cov_15.458178	1496	1550	48	1	54	0.0185185
NODE_1087_length_2251_cov_15.458178	1496	1550	52	1	54	0.0185185
NODE_1087_length_2251_cov_15.458178	1496	1550	54	1	54	0.0185185
NODE_1087_length_2251_cov_15.458178	1496	1550	57	1	54	0.0185185
NODE_1087_length_2251_cov_15.458178	1496	1550	63	1	54	0.0185185
NODE_1089_length_2250_cov_18.370990	1658	1738	0	80	80	1.0000000
NODE_1089_length_2250_cov_18.370990	1711	1791	0	80	80	1.0000000
NODE_1090_length_2250_cov_5.331474	1844	1924	0	34	80	0.4250000
NODE_1090_length_2250_cov_5.331474	1844	1924	4	34	80	0.4250000
NODE_1090_length_2250_cov_5.331474	1844	1924	6	12	80	0.1500000
NODE_1093_length_2247_cov_7.906890	364	436	0	72	72	1.0000000
NODE_1095_length_2246_cov_7.612948	1992	2055	4	25	63	0.3968254
NODE_1095_length_2246_cov_7.612948	1992	2055	6	7	63	0.1111111
NODE_1095_length_2246_cov_7.612948	1992	2055	8	26	63	0.4126984
NODE_1095_length_2246_cov_7.612948	1992	2055	14	1	63	0.0158730
NODE_1095_length_2246_cov_7.612948	1992	2055	19	4	63	0.0634921
NODE_1095_length_2246_cov_7.612948	2045	2108	4	24	63	0.3809524
NODE_1095_length_2246_cov_7.612948	2045	2108	6	33	63	0.5238096
NODE_1095_length_2246_cov_7.612948	2045	2108	8	6	63	0.0952381
NODE_1104_length_2233_cov_35.127460	1517	1597	0	80	80	1.0000000
NODE_1104_length_2233_cov_35.127460	1570	1650	0	80	80	1.0000000
NODE_1105_length_2231_cov_45.701689	315	396	18	11	81	0.1358025
NODE_1105_length_2231_cov_45.701689	315	396	20	11	81	0.1358025
NODE_1105_length_2231_cov_45.701689	315	396	22	2	81	0.0246914
NODE_1105_length_2231_cov_45.701689	315	396	26	28	81	0.3456790
NODE_1105_length_2231_cov_45.701689	315	396	28	7	81	0.0864198
NODE_1105_length_2231_cov_45.701689	315	396	30	22	81	0.2716049
NODE_1105_length_2231_cov_45.701689	369	449	0	2	80	0.0250000
NODE_1105_length_2231_cov_45.701689	369	449	4	17	80	0.2125000
NODE_1105_length_2231_cov_45.701689	369	449	8	13	80	0.1625000
NODE_1105_length_2231_cov_45.701689	369	449	10	1	80	0.0125000
NODE_1105_length_2231_cov_45.701689	369	449	16	1	80	0.0125000
NODE_1105_length_2231_cov_45.701689	369	449	18	30	80	0.3750000
NODE_1105_length_2231_cov_45.701689	369	449	20	11	80	0.1375000
NODE_1105_length_2231_cov_45.701689	369	449	22	2	80	0.0250000
NODE_1105_length_2231_cov_45.701689	369	449	26	3	80	0.0375000
NODE_1105_length_2231_cov_45.701689	496	576	0	80	80	1.0000000
NODE_1105_length_2231_cov_45.701689	582	662	0	80	80	1.0000000
NODE_1105_length_2231_cov_45.701689	625	705	0	63	80	0.7875000
NODE_1105_length_2231_cov_45.701689	625	705	10	17	80	0.2125000
NODE_1105_length_2231_cov_45.701689	711	791	10	80	80	1.0000000
NODE_1105_length_2231_cov_45.701689	1141	1186	21	1	45	0.0222222
NODE_1105_length_2231_cov_45.701689	1141	1186	27	3	45	0.0666667
NODE_1105_length_2231_cov_45.701689	1141	1186	31	5	45	0.1111111
NODE_1105_length_2231_cov_45.701689	1141	1186	33	1	45	0.0222222
NODE_1105_length_2231_cov_45.701689	1141	1186	35	3	45	0.0666667
NODE_1105_length_2231_cov_45.701689	1141	1186	37	4	45	0.0888889
NODE_1105_length_2231_cov_45.701689	1141	1186	45	1	45	0.0222222
NODE_1105_length_2231_cov_45.701689	1141	1186	51	1	45	0.0222222
NODE_1105_length_2231_cov_45.701689	1141	1186	59	3	45	0.0666667
NODE_1105_length_2231_cov_45.701689	1141	1186	68	1	45	0.0222222
NODE_1105_length_2231_cov_45.701689	1141	1186	70	2	45	0.0444444
NODE_1105_length_2231_cov_45.701689	1141	1186	78	1	45	0.0222222
NODE_1105_length_2231_cov_45.701689	1141	1186	80	2	45	0.0444444
NODE_1105_length_2231_cov_45.701689	1141	1186	84	2	45	0.0444444
NODE_1105_length_2231_cov_45.701689	1141	1186	86	15	45	0.3333333
NODE_1105_length_2231_cov_45.701689	1787	1867	0	80	80	1.0000000
NODE_1105_length_2231_cov_45.701689	1840	1920	0	80	80	1.0000000
NODE_1106_length_2230_cov_12.608634	1520	1600	0	80	80	1.0000000
NODE_1106_length_2230_cov_12.608634	1573	1653	0	80	80	1.0000000
NODE_1112_length_2218_cov_5.292591	1427	1497	4	41	70	0.5857143
NODE_1112_length_2218_cov_5.292591	1427	1497	6	29	70	0.4142857
NODE_1112_length_2218_cov_5.292591	1470	1536	2	35	66	0.5303030
NODE_1112_length_2218_cov_5.292591	1470	1536	6	31	66	0.4696970
NODE_1115_length_2215_cov_51.865784	108	188	0	80	80	1.0000000
NODE_1115_length_2215_cov_51.865784	161	241	0	80	80	1.0000000
NODE_1115_length_2215_cov_51.865784	237	317	0	80	80	1.0000000
NODE_1115_length_2215_cov_51.865784	290	370	0	80	80	1.0000000
NODE_1115_length_2215_cov_51.865784	1030	1102	6	8	72	0.1111111
NODE_1115_length_2215_cov_51.865784	1030	1102	8	11	72	0.1527778
NODE_1115_length_2215_cov_51.865784	1030	1102	12	3	72	0.0416667
NODE_1115_length_2215_cov_51.865784	1030	1102	14	17	72	0.2361111
NODE_1115_length_2215_cov_51.865784	1030	1102	16	3	72	0.0416667
NODE_1115_length_2215_cov_51.865784	1030	1102	24	1	72	0.0138889
NODE_1115_length_2215_cov_51.865784	1030	1102	28	2	72	0.0277778
NODE_1115_length_2215_cov_51.865784	1030	1102	32	3	72	0.0416667
NODE_1115_length_2215_cov_51.865784	1030	1102	34	2	72	0.0277778
NODE_1115_length_2215_cov_51.865784	1030	1102	35	2	72	0.0277778
NODE_1115_length_2215_cov_51.865784	1030	1102	37	1	72	0.0138889
NODE_1115_length_2215_cov_51.865784	1030	1102	41	8	72	0.1111111
NODE_1115_length_2215_cov_51.865784	1030	1102	43	1	72	0.0138889
NODE_1115_length_2215_cov_51.865784	1030	1102	45	1	72	0.0138889
NODE_1115_length_2215_cov_51.865784	1030	1102	46	4	72	0.0555556
NODE_1115_length_2215_cov_51.865784	1030	1102	48	5	72	0.0694444
NODE_1115_length_2215_cov_51.865784	1571	1651	0	75	80	0.9375000
NODE_1115_length_2215_cov_51.865784	1571	1651	2	5	80	0.0625000
NODE_1115_length_2215_cov_51.865784	1624	1704	0	22	80	0.2750000
NODE_1115_length_2215_cov_51.865784	1624	1704	2	58	80	0.7250000
NODE_1117_length_2212_cov_63.988168	459	539	0	17	80	0.2125000
NODE_1117_length_2212_cov_63.988168	459	539	2	8	80	0.1000000
NODE_1117_length_2212_cov_63.988168	459	539	6	55	80	0.6875000
NODE_1117_length_2212_cov_63.988168	512	592	0	2	80	0.0250000
NODE_1117_length_2212_cov_63.988168	512	592	6	78	80	0.9750000
NODE_1117_length_2212_cov_63.988168	588	668	0	78	80	0.9750000
NODE_1117_length_2212_cov_63.988168	588	668	6	2	80	0.0250000
NODE_1117_length_2212_cov_63.988168	641	721	0	80	80	1.0000000
NODE_1119_length_2212_cov_4.632750	1479	1559	0	80	80	1.0000000
NODE_1119_length_2212_cov_4.632750	1532	1612	0	80	80	1.0000000
NODE_1122_length_2211_cov_16.247159	1808	1888	16	1	80	0.0125000
NODE_1122_length_2211_cov_16.247159	1808	1888	18	3	80	0.0375000
NODE_1122_length_2211_cov_16.247159	1808	1888	20	18	80	0.2250000
NODE_1122_length_2211_cov_16.247159	1808	1888	22	1	80	0.0125000
NODE_1122_length_2211_cov_16.247159	1808	1888	24	2	80	0.0250000
NODE_1122_length_2211_cov_16.247159	1808	1888	32	10	80	0.1250000
NODE_1122_length_2211_cov_16.247159	1808	1888	34	19	80	0.2375000
NODE_1122_length_2211_cov_16.247159	1808	1888	38	22	80	0.2750000
NODE_1122_length_2211_cov_16.247159	1808	1888	42	4	80	0.0500000
NODE_1124_length_2207_cov_46.766129	1273	1348	210	2	75	0.0266667
NODE_1124_length_2207_cov_46.766129	1273	1348	211	3	75	0.0400000
NODE_1124_length_2207_cov_46.766129	1273	1348	216	2	75	0.0266667
NODE_1124_length_2207_cov_46.766129	1273	1348	217	1	75	0.0133333
NODE_1124_length_2207_cov_46.766129	1273	1348	218	1	75	0.0133333
NODE_1124_length_2207_cov_46.766129	1273	1348	219	1	75	0.0133333
NODE_1124_length_2207_cov_46.766129	1273	1348	220	2	75	0.0266667
NODE_1124_length_2207_cov_46.766129	1273	1348	222	5	75	0.0666667
NODE_1124_length_2207_cov_46.766129	1273	1348	226	6	75	0.0800000
NODE_1124_length_2207_cov_46.766129	1273	1348	229	2	75	0.0266667
NODE_1124_length_2207_cov_46.766129	1273	1348	232	1	75	0.0133333
NODE_1124_length_2207_cov_46.766129	1273	1348	236	2	75	0.0266667
NODE_1124_length_2207_cov_46.766129	1273	1348	240	7	75	0.0933333
NODE_1124_length_2207_cov_46.766129	1273	1348	242	1	75	0.0133333
NODE_1124_length_2207_cov_46.766129	1273	1348	244	2	75	0.0266667
NODE_1124_length_2207_cov_46.766129	1273	1348	246	1	75	0.0133333
NODE_1124_length_2207_cov_46.766129	1273	1348	247	4	75	0.0533333
NODE_1124_length_2207_cov_46.766129	1273	1348	248	2	75	0.0266667
NODE_1124_length_2207_cov_46.766129	1273	1348	249	5	75	0.0666667
NODE_1124_length_2207_cov_46.766129	1273	1348	251	1	75	0.0133333
NODE_1124_length_2207_cov_46.766129	1273	1348	253	3	75	0.0400000
NODE_1124_length_2207_cov_46.766129	1273	1348	254	3	75	0.0400000
NODE_1124_length_2207_cov_46.766129	1273	1348	255	4	75	0.0533333
NODE_1124_length_2207_cov_46.766129	1273	1348	256	2	75	0.0266667
NODE_1124_length_2207_cov_46.766129	1273	1348	257	1	75	0.0133333
NODE_1124_length_2207_cov_46.766129	1273	1348	258	1	75	0.0133333
NODE_1124_length_2207_cov_46.766129	1273	1348	261	2	75	0.0266667
NODE_1124_length_2207_cov_46.766129	1273	1348	265	6	75	0.0800000
NODE_1124_length_2207_cov_46.766129	1273	1348	267	2	75	0.0266667
NODE_1124_length_2207_cov_46.766129	1324	1401	95	2	77	0.0259740
NODE_1124_length_2207_cov_46.766129	1324	1401	96	2	77	0.0259740
NODE_1124_length_2207_cov_46.766129	1324	1401	98	4	77	0.0519481
NODE_1124_length_2207_cov_46.766129	1324	1401	99	2	77	0.0259740
NODE_1124_length_2207_cov_46.766129	1324	1401	100	1	77	0.0129870
NODE_1124_length_2207_cov_46.766129	1324	1401	101	5	77	0.0649351
NODE_1124_length_2207_cov_46.766129	1324	1401	104	1	77	0.0129870
NODE_1124_length_2207_cov_46.766129	1324	1401	105	1	77	0.0129870
NODE_1124_length_2207_cov_46.766129	1324	1401	106	1	77	0.0129870
NODE_1124_length_2207_cov_46.766129	1324	1401	110	1	77	0.0129870
NODE_1124_length_2207_cov_46.766129	1324	1401	112	2	77	0.0259740
NODE_1124_length_2207_cov_46.766129	1324	1401	113	1	77	0.0129870
NODE_1124_length_2207_cov_46.766129	1324	1401	115	2	77	0.0259740
NODE_1124_length_2207_cov_46.766129	1324	1401	123	1	77	0.0129870
NODE_1124_length_2207_cov_46.766129	1324	1401	125	2	77	0.0259740
NODE_1124_length_2207_cov_46.766129	1324	1401	128	1	77	0.0129870
NODE_1124_length_2207_cov_46.766129	1324	1401	129	1	77	0.0129870
NODE_1124_length_2207_cov_46.766129	1324	1401	130	2	77	0.0259740
NODE_1124_length_2207_cov_46.766129	1324	1401	134	1	77	0.0129870
NODE_1124_length_2207_cov_46.766129	1324	1401	144	2	77	0.0259740
NODE_1124_length_2207_cov_46.766129	1324	1401	150	1	77	0.0129870
NODE_1124_length_2207_cov_46.766129	1324	1401	156	1	77	0.0129870
NODE_1124_length_2207_cov_46.766129	1324	1401	162	2	77	0.0259740
NODE_1124_length_2207_cov_46.766129	1324	1401	163	1	77	0.0129870
NODE_1124_length_2207_cov_46.766129	1324	1401	173	2	77	0.0259740
NODE_1124_length_2207_cov_46.766129	1324	1401	179	1	77	0.0129870
NODE_1124_length_2207_cov_46.766129	1324	1401	182	1	77	0.0129870
NODE_1124_length_2207_cov_46.766129	1324	1401	194	2	77	0.0259740
NODE_1124_length_2207_cov_46.766129	1324	1401	196	4	77	0.0519481
NODE_1124_length_2207_cov_46.766129	1324	1401	198	1	77	0.0129870
NODE_1124_length_2207_cov_46.766129	1324	1401	202	1	77	0.0129870
NODE_1124_length_2207_cov_46.766129	1324	1401	209	1	77	0.0129870
NODE_1124_length_2207_cov_46.766129	1324	1401	210	2	77	0.0259740
NODE_1124_length_2207_cov_46.766129	1324	1401	211	3	77	0.0389610
NODE_1124_length_2207_cov_46.766129	1324	1401	216	2	77	0.0259740
NODE_1124_length_2207_cov_46.766129	1324	1401	217	1	77	0.0129870
NODE_1124_length_2207_cov_46.766129	1324	1401	218	1	77	0.0129870
NODE_1124_length_2207_cov_46.766129	1324	1401	219	1	77	0.0129870
NODE_1124_length_2207_cov_46.766129	1324	1401	220	2	77	0.0259740
NODE_1124_length_2207_cov_46.766129	1324	1401	222	5	77	0.0649351
NODE_1124_length_2207_cov_46.766129	1324	1401	226	6	77	0.0779221
NODE_1124_length_2207_cov_46.766129	1324	1401	229	1	77	0.0129870
NODE_1127_length_2205_cov_12.762108	1818	1898	6	32	80	0.4000000
NODE_1127_length_2205_cov_12.762108	1818	1898	8	4	80	0.0500000
NODE_1127_length_2205_cov_12.762108	1818	1898	12	44	80	0.5500000
NODE_1127_length_2205_cov_12.762108	1871	1951	2	7	80	0.0875000
NODE_1127_length_2205_cov_12.762108	1871	1951	4	7	80	0.0875000
NODE_1127_length_2205_cov_12.762108	1871	1951	6	41	80	0.5125000
NODE_1127_length_2205_cov_12.762108	1871	1951	12	25	80	0.3125000
NODE_1127_length_2205_cov_12.762108	1872	1951	2	7	79	0.0886076
NODE_1127_length_2205_cov_12.762108	1872	1951	4	7	79	0.0886076
NODE_1127_length_2205_cov_12.762108	1872	1951	6	41	79	0.5189874
NODE_1127_length_2205_cov_12.762108	1872	1951	12	24	79	0.3037975
NODE_1127_length_2205_cov_12.762108	1947	2020	2	73	73	1.0000000
NODE_1128_length_2202_cov_8.687114	1848	1912	0	64	64	1.0000000
NODE_1130_length_2200_cov_10.639695	1461	1541	0	80	80	1.0000000
NODE_1130_length_2200_cov_10.639695	1514	1594	0	80	80	1.0000000
NODE_1131_length_2199_cov_10.839524	1709	1789	0	33	80	0.4125000
NODE_1131_length_2199_cov_10.839524	1709	1789	6	47	80	0.5875000
NODE_1131_length_2199_cov_10.839524	1762	1842	0	80	80	1.0000000
NODE_1135_length_2196_cov_64.718646	885	965	31	2	80	0.0250000
NODE_1135_length_2196_cov_64.718646	885	965	32	5	80	0.0625000
NODE_1135_length_2196_cov_64.718646	885	965	36	5	80	0.0625000
NODE_1135_length_2196_cov_64.718646	885	965	38	3	80	0.0375000
NODE_1135_length_2196_cov_64.718646	885	965	43	1	80	0.0125000
NODE_1135_length_2196_cov_64.718646	885	965	46	1	80	0.0125000
NODE_1135_length_2196_cov_64.718646	885	965	54	1	80	0.0125000
NODE_1135_length_2196_cov_64.718646	885	965	56	9	80	0.1125000
NODE_1135_length_2196_cov_64.718646	885	965	63	1	80	0.0125000
NODE_1135_length_2196_cov_64.718646	885	965	68	1	80	0.0125000
NODE_1135_length_2196_cov_64.718646	885	965	73	10	80	0.1250000
NODE_1135_length_2196_cov_64.718646	885	965	74	3	80	0.0375000
NODE_1135_length_2196_cov_64.718646	885	965	79	1	80	0.0125000
NODE_1135_length_2196_cov_64.718646	885	965	80	2	80	0.0250000
NODE_1135_length_2196_cov_64.718646	885	965	90	8	80	0.1000000
NODE_1135_length_2196_cov_64.718646	885	965	94	9	80	0.1125000
NODE_1135_length_2196_cov_64.718646	885	965	96	15	80	0.1875000
NODE_1135_length_2196_cov_64.718646	885	965	98	3	80	0.0375000
NODE_1135_length_2196_cov_64.718646	938	1018	46	1	80	0.0125000
NODE_1135_length_2196_cov_64.718646	938	1018	55	6	80	0.0750000
NODE_1135_length_2196_cov_64.718646	938	1018	59	11	80	0.1375000
NODE_1135_length_2196_cov_64.718646	938	1018	65	2	80	0.0250000
NODE_1135_length_2196_cov_64.718646	938	1018	66	9	80	0.1125000
NODE_1135_length_2196_cov_64.718646	938	1018	67	2	80	0.0250000
NODE_1135_length_2196_cov_64.718646	938	1018	74	7	80	0.0875000
NODE_1135_length_2196_cov_64.718646	938	1018	76	1	80	0.0125000
NODE_1135_length_2196_cov_64.718646	938	1018	80	1	80	0.0125000
NODE_1135_length_2196_cov_64.718646	938	1018	81	2	80	0.0250000
NODE_1135_length_2196_cov_64.718646	938	1018	83	3	80	0.0375000
NODE_1135_length_2196_cov_64.718646	938	1018	86	1	80	0.0125000
NODE_1135_length_2196_cov_64.718646	938	1018	88	3	80	0.0375000
NODE_1135_length_2196_cov_64.718646	938	1018	92	2	80	0.0250000
NODE_1135_length_2196_cov_64.718646	938	1018	94	11	80	0.1375000
NODE_1135_length_2196_cov_64.718646	938	1018	96	15	80	0.1875000
NODE_1135_length_2196_cov_64.718646	938	1018	98	3	80	0.0375000
NODE_1138_length_2195_cov_8.443225	114	136	2	22	22	1.0000000
NODE_1139_length_2195_cov_6.113550	1245	1330	0	33	85	0.3882353
NODE_1139_length_2195_cov_6.113550	1245	1330	3	1	85	0.0117647
NODE_1139_length_2195_cov_6.113550	1245	1330	4	51	85	0.6000000
NODE_1139_length_2195_cov_6.113550	1306	1352	0	46	46	1.0000000
NODE_1141_length_2194_cov_1.366587	15	77	0	9	62	0.1451613
NODE_1141_length_2194_cov_1.366587	15	77	2	53	62	0.8548387
NODE_1142_length_2193_cov_8.320917	374	454	0	10	80	0.1250000
NODE_1142_length_2193_cov_8.320917	374	454	12	70	80	0.8750000
NODE_1142_length_2193_cov_8.320917	427	502	0	41	75	0.5466667
NODE_1142_length_2193_cov_8.320917	427	502	11	1	75	0.0133333
NODE_1142_length_2193_cov_8.320917	427	502	12	33	75	0.4400000
NODE_1146_length_2189_cov_36.884689	383	463	2	27	80	0.3375000
NODE_1146_length_2189_cov_36.884689	383	463	4	16	80	0.2000000
NODE_1146_length_2189_cov_36.884689	383	463	6	37	80	0.4625000
NODE_1146_length_2189_cov_36.884689	436	516	4	10	80	0.1250000
NODE_1146_length_2189_cov_36.884689	436	516	5	1	80	0.0125000
NODE_1146_length_2189_cov_36.884689	436	516	6	40	80	0.5000000
NODE_1146_length_2189_cov_36.884689	436	516	7	15	80	0.1875000
NODE_1146_length_2189_cov_36.884689	436	516	9	10	80	0.1250000
NODE_1146_length_2189_cov_36.884689	436	516	10	4	80	0.0500000
NODE_1146_length_2189_cov_36.884689	1257	1337	0	80	80	1.0000000
NODE_1146_length_2189_cov_36.884689	1310	1390	0	80	80	1.0000000
NODE_1146_length_2189_cov_36.884689	1427	1507	0	80	80	1.0000000
NODE_1146_length_2189_cov_36.884689	1480	1560	0	80	80	1.0000000
NODE_1152_length_2184_cov_9.464748	1536	1616	0	57	80	0.7125000
NODE_1152_length_2184_cov_9.464748	1536	1616	2	23	80	0.2875000
NODE_1152_length_2184_cov_9.464748	1589	1669	0	80	80	1.0000000
NODE_1154_length_2183_cov_45.471209	1632	1712	0	32	80	0.4000000
NODE_1154_length_2183_cov_45.471209	1632	1712	2	48	80	0.6000000
NODE_1154_length_2183_cov_45.471209	1685	1765	0	80	80	1.0000000
NODE_1159_length_2176_cov_47.338950	0	52	0	52	52	1.0000000
NODE_1162_length_2174_cov_40.560964	1638	1718	0	42	80	0.5250000
NODE_1162_length_2174_cov_40.560964	1638	1718	2	38	80	0.4750000
NODE_1162_length_2174_cov_40.560964	1691	1771	0	3	80	0.0375000
NODE_1162_length_2174_cov_40.560964	1691	1771	2	77	80	0.9625000
NODE_1163_length_2174_cov_35.399518	284	364	2	7	80	0.0875000
NODE_1163_length_2174_cov_35.399518	284	364	4	54	80	0.6750000
NODE_1163_length_2174_cov_35.399518	284	364	6	19	80	0.2375000
NODE_1163_length_2174_cov_35.399518	337	414	0	38	77	0.4935065
NODE_1163_length_2174_cov_35.399518	337	414	2	1	77	0.0129870
NODE_1163_length_2174_cov_35.399518	337	414	3	4	77	0.0519481
NODE_1163_length_2174_cov_35.399518	337	414	4	34	77	0.4415585
NODE_1163_length_2174_cov_35.399518	1542	1620	111	1	78	0.0128205
NODE_1163_length_2174_cov_35.399518	1542	1620	112	1	78	0.0128205
NODE_1163_length_2174_cov_35.399518	1542	1620	113	1	78	0.0128205
NODE_1163_length_2174_cov_35.399518	1542	1620	116	2	78	0.0256410
NODE_1163_length_2174_cov_35.399518	1542	1620	117	2	78	0.0256410
NODE_1163_length_2174_cov_35.399518	1542	1620	119	1	78	0.0128205
NODE_1163_length_2174_cov_35.399518	1542	1620	122	2	78	0.0256410
NODE_1163_length_2174_cov_35.399518	1542	1620	123	1	78	0.0128205
NODE_1163_length_2174_cov_35.399518	1542	1620	124	2	78	0.0256410
NODE_1163_length_2174_cov_35.399518	1542	1620	125	1	78	0.0128205
NODE_1163_length_2174_cov_35.399518	1542	1620	127	2	78	0.0256410
NODE_1163_length_2174_cov_35.399518	1542	1620	130	1	78	0.0128205
NODE_1163_length_2174_cov_35.399518	1542	1620	132	4	78	0.0512821
NODE_1163_length_2174_cov_35.399518	1542	1620	133	4	78	0.0512821
NODE_1163_length_2174_cov_35.399518	1542	1620	135	3	78	0.0384615
NODE_1163_length_2174_cov_35.399518	1542	1620	137	1	78	0.0128205
NODE_1163_length_2174_cov_35.399518	1542	1620	138	1	78	0.0128205
NODE_1163_length_2174_cov_35.399518	1542	1620	139	1	78	0.0128205
NODE_1163_length_2174_cov_35.399518	1542	1620	141	1	78	0.0128205
NODE_1163_length_2174_cov_35.399518	1542	1620	145	3	78	0.0384615
NODE_1163_length_2174_cov_35.399518	1542	1620	147	3	78	0.0384615
NODE_1163_length_2174_cov_35.399518	1542	1620	148	1	78	0.0128205
NODE_1163_length_2174_cov_35.399518	1542	1620	150	1	78	0.0128205
NODE_1163_length_2174_cov_35.399518	1542	1620	153	1	78	0.0128205
NODE_1163_length_2174_cov_35.399518	1542	1620	157	1	78	0.0128205
NODE_1163_length_2174_cov_35.399518	1542	1620	159	6	78	0.0769231
NODE_1163_length_2174_cov_35.399518	1542	1620	161	2	78	0.0256410
NODE_1163_length_2174_cov_35.399518	1542	1620	162	1	78	0.0128205
NODE_1163_length_2174_cov_35.399518	1542	1620	163	2	78	0.0256410
NODE_1163_length_2174_cov_35.399518	1542	1620	166	1	78	0.0128205
NODE_1163_length_2174_cov_35.399518	1542	1620	168	2	78	0.0256410
NODE_1163_length_2174_cov_35.399518	1542	1620	179	2	78	0.0256410
NODE_1163_length_2174_cov_35.399518	1542	1620	185	2	78	0.0256410
NODE_1163_length_2174_cov_35.399518	1542	1620	186	2	78	0.0256410
NODE_1163_length_2174_cov_35.399518	1542	1620	187	5	78	0.0641026
NODE_1163_length_2174_cov_35.399518	1542	1620	189	4	78	0.0512821
NODE_1163_length_2174_cov_35.399518	1542	1620	190	2	78	0.0256410
NODE_1163_length_2174_cov_35.399518	1542	1620	191	5	78	0.0641026
NODE_1163_length_2174_cov_35.399518	1593	1673	111	1	80	0.0125000
NODE_1163_length_2174_cov_35.399518	1593	1673	112	1	80	0.0125000
NODE_1163_length_2174_cov_35.399518	1593	1673	113	1	80	0.0125000
NODE_1163_length_2174_cov_35.399518	1593	1673	116	2	80	0.0250000
NODE_1163_length_2174_cov_35.399518	1593	1673	117	2	80	0.0250000
NODE_1163_length_2174_cov_35.399518	1593	1673	119	1	80	0.0125000
NODE_1163_length_2174_cov_35.399518	1593	1673	122	2	80	0.0250000
NODE_1163_length_2174_cov_35.399518	1593	1673	124	2	80	0.0250000
NODE_1163_length_2174_cov_35.399518	1593	1673	125	1	80	0.0125000
NODE_1163_length_2174_cov_35.399518	1593	1673	127	2	80	0.0250000
NODE_1163_length_2174_cov_35.399518	1593	1673	130	1	80	0.0125000
NODE_1163_length_2174_cov_35.399518	1593	1673	132	4	80	0.0500000
NODE_1163_length_2174_cov_35.399518	1593	1673	133	2	80	0.0250000
NODE_1163_length_2174_cov_35.399518	1593	1673	135	2	80	0.0250000
NODE_1163_length_2174_cov_35.399518	1593	1673	137	2	80	0.0250000
NODE_1163_length_2174_cov_35.399518	1593	1673	138	3	80	0.0375000
NODE_1163_length_2174_cov_35.399518	1593	1673	139	1	80	0.0125000
NODE_1163_length_2174_cov_35.399518	1593	1673	140	1	80	0.0125000
NODE_1163_length_2174_cov_35.399518	1593	1673	141	2	80	0.0250000
NODE_1163_length_2174_cov_35.399518	1593	1673	142	1	80	0.0125000
NODE_1163_length_2174_cov_35.399518	1593	1673	149	2	80	0.0250000
NODE_1163_length_2174_cov_35.399518	1593	1673	150	1	80	0.0125000
NODE_1163_length_2174_cov_35.399518	1593	1673	151	1	80	0.0125000
NODE_1163_length_2174_cov_35.399518	1593	1673	153	2	80	0.0250000
NODE_1163_length_2174_cov_35.399518	1593	1673	155	1	80	0.0125000
NODE_1163_length_2174_cov_35.399518	1593	1673	157	1	80	0.0125000
NODE_1163_length_2174_cov_35.399518	1593	1673	159	2	80	0.0250000
NODE_1163_length_2174_cov_35.399518	1593	1673	160	2	80	0.0250000
NODE_1163_length_2174_cov_35.399518	1593	1673	161	1	80	0.0125000
NODE_1163_length_2174_cov_35.399518	1593	1673	162	4	80	0.0500000
NODE_1163_length_2174_cov_35.399518	1593	1673	163	1	80	0.0125000
NODE_1163_length_2174_cov_35.399518	1593	1673	164	3	80	0.0375000
NODE_1163_length_2174_cov_35.399518	1593	1673	165	1	80	0.0125000
NODE_1163_length_2174_cov_35.399518	1593	1673	166	3	80	0.0375000
NODE_1163_length_2174_cov_35.399518	1593	1673	167	1	80	0.0125000
NODE_1163_length_2174_cov_35.399518	1593	1673	168	2	80	0.0250000
NODE_1163_length_2174_cov_35.399518	1593	1673	169	1	80	0.0125000
NODE_1163_length_2174_cov_35.399518	1593	1673	177	1	80	0.0125000
NODE_1163_length_2174_cov_35.399518	1593	1673	181	3	80	0.0375000
NODE_1163_length_2174_cov_35.399518	1593	1673	183	1	80	0.0125000
NODE_1163_length_2174_cov_35.399518	1593	1673	185	1	80	0.0125000
NODE_1163_length_2174_cov_35.399518	1593	1673	186	1	80	0.0125000
NODE_1163_length_2174_cov_35.399518	1593	1673	189	1	80	0.0125000
NODE_1163_length_2174_cov_35.399518	1593	1673	190	1	80	0.0125000
NODE_1163_length_2174_cov_35.399518	1593	1673	191	1	80	0.0125000
NODE_1163_length_2174_cov_35.399518	1593	1673	195	1	80	0.0125000
NODE_1163_length_2174_cov_35.399518	1593	1673	197	3	80	0.0375000
NODE_1163_length_2174_cov_35.399518	1593	1673	199	3	80	0.0375000
NODE_1163_length_2174_cov_35.399518	2075	2152	78	77	77	1.0000000
NODE_1163_length_2174_cov_35.399518	2075	2152	78	77	77	1.0000000
NODE_1163_length_2174_cov_35.399518	2075	2152	78	77	77	1.0000000
NODE_1163_length_2174_cov_35.399518	2125	2174	14	1	49	0.0204082
NODE_1163_length_2174_cov_35.399518	2125	2174	28	2	49	0.0408163
NODE_1163_length_2174_cov_35.399518	2125	2174	40	1	49	0.0204082
NODE_1163_length_2174_cov_35.399518	2125	2174	42	3	49	0.0612245
NODE_1163_length_2174_cov_35.399518	2125	2174	45	1	49	0.0204082
NODE_1163_length_2174_cov_35.399518	2125	2174	55	2	49	0.0408163
NODE_1163_length_2174_cov_35.399518	2125	2174	56	1	49	0.0204082
NODE_1163_length_2174_cov_35.399518	2125	2174	58	2	49	0.0408163
NODE_1163_length_2174_cov_35.399518	2125	2174	73	1	49	0.0204082
NODE_1163_length_2174_cov_35.399518	2125	2174	74	8	49	0.1632653
NODE_1163_length_2174_cov_35.399518	2125	2174	78	27	49	0.5510204
NODE_1163_length_2174_cov_35.399518	2128	2174	14	1	46	0.0217391
NODE_1163_length_2174_cov_35.399518	2128	2174	28	2	46	0.0434783
NODE_1163_length_2174_cov_35.399518	2128	2174	40	1	46	0.0217391
NODE_1163_length_2174_cov_35.399518	2128	2174	42	3	46	0.0652174
NODE_1163_length_2174_cov_35.399518	2128	2174	45	1	46	0.0217391
NODE_1163_length_2174_cov_35.399518	2128	2174	55	2	46	0.0434783
NODE_1163_length_2174_cov_35.399518	2128	2174	56	1	46	0.0217391
NODE_1163_length_2174_cov_35.399518	2128	2174	58	2	46	0.0434783
NODE_1163_length_2174_cov_35.399518	2128	2174	73	1	46	0.0217391
NODE_1163_length_2174_cov_35.399518	2128	2174	74	8	46	0.1739130
NODE_1163_length_2174_cov_35.399518	2128	2174	78	24	46	0.5217391
NODE_1163_length_2174_cov_35.399518	2130	2174	14	1	44	0.0227273
NODE_1163_length_2174_cov_35.399518	2130	2174	28	2	44	0.0454545
NODE_1163_length_2174_cov_35.399518	2130	2174	40	1	44	0.0227273
NODE_1163_length_2174_cov_35.399518	2130	2174	42	3	44	0.0681818
NODE_1163_length_2174_cov_35.399518	2130	2174	45	1	44	0.0227273
NODE_1163_length_2174_cov_35.399518	2130	2174	55	2	44	0.0454545
NODE_1163_length_2174_cov_35.399518	2130	2174	56	1	44	0.0227273
NODE_1163_length_2174_cov_35.399518	2130	2174	58	2	44	0.0454545
NODE_1163_length_2174_cov_35.399518	2130	2174	73	1	44	0.0227273
NODE_1163_length_2174_cov_35.399518	2130	2174	74	8	44	0.1818182
NODE_1163_length_2174_cov_35.399518	2130	2174	78	22	44	0.5000000
NODE_1164_length_2172_cov_44.861553	1110	1190	20	1	80	0.0125000
NODE_1164_length_2172_cov_44.861553	1110	1190	22	3	80	0.0375000
NODE_1164_length_2172_cov_44.861553	1110	1190	24	1	80	0.0125000
NODE_1164_length_2172_cov_44.861553	1110	1190	30	2	80	0.0250000
NODE_1164_length_2172_cov_44.861553	1110	1190	32	17	80	0.2125000
NODE_1164_length_2172_cov_44.861553	1110	1190	34	56	80	0.7000000
NODE_1164_length_2172_cov_44.861553	1163	1243	6	10	80	0.1250000
NODE_1164_length_2172_cov_44.861553	1163	1243	8	2	80	0.0250000
NODE_1164_length_2172_cov_44.861553	1163	1243	10	13	80	0.1625000
NODE_1164_length_2172_cov_44.861553	1163	1243	11	1	80	0.0125000
NODE_1164_length_2172_cov_44.861553	1163	1243	16	1	80	0.0125000
NODE_1164_length_2172_cov_44.861553	1163	1243	18	21	80	0.2625000
NODE_1164_length_2172_cov_44.861553	1163	1243	20	6	80	0.0750000
NODE_1164_length_2172_cov_44.861553	1163	1243	22	3	80	0.0375000
NODE_1164_length_2172_cov_44.861553	1163	1243	32	2	80	0.0250000
NODE_1164_length_2172_cov_44.861553	1163	1243	34	21	80	0.2625000
NODE_1164_length_2172_cov_44.861553	1239	1319	6	14	80	0.1750000
NODE_1164_length_2172_cov_44.861553	1239	1319	8	33	80	0.4125000
NODE_1164_length_2172_cov_44.861553	1239	1319	10	15	80	0.1875000
NODE_1164_length_2172_cov_44.861553	1239	1319	12	17	80	0.2125000
NODE_1164_length_2172_cov_44.861553	1239	1319	14	1	80	0.0125000
NODE_1164_length_2172_cov_44.861553	1292	1372	8	1	80	0.0125000
NODE_1164_length_2172_cov_44.861553	1292	1372	10	17	80	0.2125000
NODE_1164_length_2172_cov_44.861553	1292	1372	12	31	80	0.3875000
NODE_1164_length_2172_cov_44.861553	1292	1372	14	31	80	0.3875000
NODE_1166_length_2167_cov_33.133946	414	494	0	80	80	1.0000000
NODE_1166_length_2167_cov_33.133946	467	547	0	80	80	1.0000000
NODE_1166_length_2167_cov_33.133946	543	623	0	43	80	0.5375000
NODE_1166_length_2167_cov_33.133946	543	623	1	8	80	0.1000000
NODE_1166_length_2167_cov_33.133946	543	623	5	13	80	0.1625000
NODE_1166_length_2167_cov_33.133946	543	623	7	4	80	0.0500000
NODE_1166_length_2167_cov_33.133946	543	623	11	1	80	0.0125000
NODE_1166_length_2167_cov_33.133946	543	623	13	5	80	0.0625000
NODE_1166_length_2167_cov_33.133946	543	623	15	1	80	0.0125000
NODE_1166_length_2167_cov_33.133946	543	623	16	1	80	0.0125000
NODE_1166_length_2167_cov_33.133946	543	623	18	4	80	0.0500000
NODE_1166_length_2167_cov_33.133946	596	676	5	11	80	0.1375000
NODE_1166_length_2167_cov_33.133946	596	676	7	4	80	0.0500000
NODE_1166_length_2167_cov_33.133946	596	676	11	1	80	0.0125000
NODE_1166_length_2167_cov_33.133946	596	676	13	5	80	0.0625000
NODE_1166_length_2167_cov_33.133946	596	676	15	1	80	0.0125000
NODE_1166_length_2167_cov_33.133946	596	676	16	1	80	0.0125000
NODE_1166_length_2167_cov_33.133946	596	676	18	22	80	0.2750000
NODE_1166_length_2167_cov_33.133946	596	676	20	3	80	0.0375000
NODE_1166_length_2167_cov_33.133946	596	676	22	17	80	0.2125000
NODE_1166_length_2167_cov_33.133946	596	676	24	1	80	0.0125000
NODE_1166_length_2167_cov_33.133946	596	676	26	10	80	0.1250000
NODE_1166_length_2167_cov_33.133946	596	676	28	3	80	0.0375000
NODE_1166_length_2167_cov_33.133946	596	676	30	1	80	0.0125000
NODE_1169_length_2165_cov_21.460794	980	1060	0	20	80	0.2500000
NODE_1169_length_2165_cov_21.460794	980	1060	2	60	80	0.7500000
NODE_1169_length_2165_cov_21.460794	1033	1113	0	12	80	0.1500000
NODE_1169_length_2165_cov_21.460794	1033	1113	2	68	80	0.8500000
NODE_1176_length_2157_cov_22.284257	989	1069	0	19	80	0.2375000
NODE_1176_length_2157_cov_22.284257	989	1069	1	50	80	0.6250000
NODE_1176_length_2157_cov_22.284257	989	1069	2	11	80	0.1375000
NODE_1176_length_2157_cov_22.284257	1042	1122	1	16	80	0.2000000
NODE_1176_length_2157_cov_22.284257	1042	1122	2	62	80	0.7750000
NODE_1176_length_2157_cov_22.284257	1042	1122	10	2	80	0.0250000
NODE_1176_length_2157_cov_22.284257	1118	1198	2	2	80	0.0250000
NODE_1176_length_2157_cov_22.284257	1118	1198	9	1	80	0.0125000
NODE_1176_length_2157_cov_22.284257	1118	1198	10	37	80	0.4625000
NODE_1176_length_2157_cov_22.284257	1118	1198	11	27	80	0.3375000
NODE_1176_length_2157_cov_22.284257	1118	1198	13	13	80	0.1625000
NODE_1176_length_2157_cov_22.284257	1171	1251	4	4	80	0.0500000
NODE_1176_length_2157_cov_22.284257	1171	1251	6	6	80	0.0750000
NODE_1176_length_2157_cov_22.284257	1171	1251	11	14	80	0.1750000
NODE_1176_length_2157_cov_22.284257	1171	1251	13	23	80	0.2875000
NODE_1176_length_2157_cov_22.284257	1171	1251	14	33	80	0.4125000
NODE_1177_length_2157_cov_8.830418	867	947	2	42	80	0.5250000
NODE_1177_length_2157_cov_8.830418	867	947	4	38	80	0.4750000
NODE_1177_length_2157_cov_8.830418	920	1000	0	24	80	0.3000000
NODE_1177_length_2157_cov_8.830418	920	1000	2	21	80	0.2625000
NODE_1177_length_2157_cov_8.830418	920	1000	4	35	80	0.4375000
NODE_1177_length_2157_cov_8.830418	996	1076	0	18	80	0.2250000
NODE_1177_length_2157_cov_8.830418	996	1076	2	53	80	0.6625000
NODE_1177_length_2157_cov_8.830418	996	1076	4	9	80	0.1125000
NODE_1177_length_2157_cov_8.830418	1049	1129	2	41	80	0.5125000
NODE_1177_length_2157_cov_8.830418	1049	1129	4	39	80	0.4875000
NODE_1178_length_2156_cov_25.065630	0	41	10	1	41	0.0243902
NODE_1178_length_2156_cov_25.065630	0	41	16	1	41	0.0243902
NODE_1178_length_2156_cov_25.065630	0	41	18	4	41	0.0975610
NODE_1178_length_2156_cov_25.065630	0	41	20	1	41	0.0243902
NODE_1178_length_2156_cov_25.065630	0	41	22	1	41	0.0243902
NODE_1178_length_2156_cov_25.065630	0	41	26	1	41	0.0243902
NODE_1178_length_2156_cov_25.065630	0	41	31	1	41	0.0243902
NODE_1178_length_2156_cov_25.065630	0	41	35	1	41	0.0243902
NODE_1178_length_2156_cov_25.065630	0	41	36	1	41	0.0243902
NODE_1178_length_2156_cov_25.065630	0	41	40	3	41	0.0731707
NODE_1178_length_2156_cov_25.065630	0	41	42	3	41	0.0731707
NODE_1178_length_2156_cov_25.065630	0	41	44	1	41	0.0243902
NODE_1178_length_2156_cov_25.065630	0	41	50	2	41	0.0487805
NODE_1178_length_2156_cov_25.065630	0	41	58	1	41	0.0243902
NODE_1178_length_2156_cov_25.065630	0	41	62	4	41	0.0975610
NODE_1178_length_2156_cov_25.065630	0	41	64	1	41	0.0243902
NODE_1178_length_2156_cov_25.065630	0	41	65	3	41	0.0731707
NODE_1178_length_2156_cov_25.065630	0	41	67	2	41	0.0487805
NODE_1178_length_2156_cov_25.065630	0	41	70	3	41	0.0731707
NODE_1178_length_2156_cov_25.065630	0	41	72	3	41	0.0731707
NODE_1178_length_2156_cov_25.065630	0	41	74	1	41	0.0243902
NODE_1178_length_2156_cov_25.065630	0	41	76	1	41	0.0243902
NODE_1178_length_2156_cov_25.065630	0	41	80	1	41	0.0243902
NODE_1178_length_2156_cov_25.065630	14	94	40	1	80	0.0125000
NODE_1178_length_2156_cov_25.065630	14	94	42	3	80	0.0375000
NODE_1178_length_2156_cov_25.065630	14	94	44	1	80	0.0125000
NODE_1178_length_2156_cov_25.065630	14	94	50	2	80	0.0250000
NODE_1178_length_2156_cov_25.065630	14	94	58	1	80	0.0125000
NODE_1178_length_2156_cov_25.065630	14	94	62	4	80	0.0500000
NODE_1178_length_2156_cov_25.065630	14	94	64	1	80	0.0125000
NODE_1178_length_2156_cov_25.065630	14	94	65	3	80	0.0375000
NODE_1178_length_2156_cov_25.065630	14	94	67	2	80	0.0250000
NODE_1178_length_2156_cov_25.065630	14	94	70	3	80	0.0375000
NODE_1178_length_2156_cov_25.065630	14	94	72	3	80	0.0375000
NODE_1178_length_2156_cov_25.065630	14	94	74	1	80	0.0125000
NODE_1178_length_2156_cov_25.065630	14	94	76	1	80	0.0125000
NODE_1178_length_2156_cov_25.065630	14	94	80	2	80	0.0250000
NODE_1178_length_2156_cov_25.065630	14	94	82	1	80	0.0125000
NODE_1178_length_2156_cov_25.065630	14	94	86	1	80	0.0125000
NODE_1178_length_2156_cov_25.065630	14	94	88	1	80	0.0125000
NODE_1178_length_2156_cov_25.065630	14	94	90	2	80	0.0250000
NODE_1178_length_2156_cov_25.065630	14	94	92	3	80	0.0375000
NODE_1178_length_2156_cov_25.065630	14	94	96	1	80	0.0125000
NODE_1178_length_2156_cov_25.065630	14	94	98	3	80	0.0375000
NODE_1178_length_2156_cov_25.065630	14	94	100	2	80	0.0250000
NODE_1178_length_2156_cov_25.065630	14	94	103	2	80	0.0250000
NODE_1178_length_2156_cov_25.065630	14	94	107	2	80	0.0250000
NODE_1178_length_2156_cov_25.065630	14	94	109	1	80	0.0125000
NODE_1178_length_2156_cov_25.065630	14	94	111	1	80	0.0125000
NODE_1178_length_2156_cov_25.065630	14	94	115	1	80	0.0125000
NODE_1178_length_2156_cov_25.065630	14	94	116	2	80	0.0250000
NODE_1178_length_2156_cov_25.065630	14	94	118	1	80	0.0125000
NODE_1178_length_2156_cov_25.065630	14	94	119	9	80	0.1125000
NODE_1178_length_2156_cov_25.065630	14	94	121	6	80	0.0750000
NODE_1178_length_2156_cov_25.065630	14	94	125	8	80	0.1000000
NODE_1178_length_2156_cov_25.065630	14	94	126	5	80	0.0625000
NODE_1181_length_2156_cov_3.216334	1890	1970	0	80	80	1.0000000
NODE_1181_length_2156_cov_3.216334	1943	2023	0	80	80	1.0000000
NODE_1184_length_2153_cov_11.610029	1968	2048	0	67	80	0.8375000
NODE_1184_length_2153_cov_11.610029	1968	2048	6	1	80	0.0125000
NODE_1184_length_2153_cov_11.610029	1968	2048	8	2	80	0.0250000
NODE_1184_length_2153_cov_11.610029	1968	2048	24	1	80	0.0125000
NODE_1184_length_2153_cov_11.610029	1968	2048	26	2	80	0.0250000
NODE_1184_length_2153_cov_11.610029	1968	2048	28	2	80	0.0250000
NODE_1184_length_2153_cov_11.610029	1968	2048	30	2	80	0.0250000
NODE_1184_length_2153_cov_11.610029	1968	2048	34	1	80	0.0125000
NODE_1184_length_2153_cov_11.610029	1968	2048	36	1	80	0.0125000
NODE_1184_length_2153_cov_11.610029	1968	2048	38	1	80	0.0125000
NODE_1184_length_2153_cov_11.610029	1977	2048	0	58	71	0.8169014
NODE_1184_length_2153_cov_11.610029	1977	2048	6	1	71	0.0140845
NODE_1184_length_2153_cov_11.610029	1977	2048	8	2	71	0.0281690
NODE_1184_length_2153_cov_11.610029	1977	2048	24	1	71	0.0140845
NODE_1184_length_2153_cov_11.610029	1977	2048	26	2	71	0.0281690
NODE_1184_length_2153_cov_11.610029	1977	2048	28	2	71	0.0281690
NODE_1184_length_2153_cov_11.610029	1977	2048	30	2	71	0.0281690
NODE_1184_length_2153_cov_11.610029	1977	2048	34	1	71	0.0140845
NODE_1184_length_2153_cov_11.610029	1977	2048	36	1	71	0.0140845
NODE_1184_length_2153_cov_11.610029	1977	2048	38	1	71	0.0140845
NODE_1190_length_2147_cov_25.116211	814	894	58	4	80	0.0500000
NODE_1190_length_2147_cov_25.116211	814	894	60	8	80	0.1000000
NODE_1190_length_2147_cov_25.116211	814	894	62	3	80	0.0375000
NODE_1190_length_2147_cov_25.116211	814	894	64	1	80	0.0125000
NODE_1190_length_2147_cov_25.116211	814	894	67	6	80	0.0750000
NODE_1190_length_2147_cov_25.116211	814	894	68	15	80	0.1875000
NODE_1190_length_2147_cov_25.116211	814	894	70	7	80	0.0875000
NODE_1190_length_2147_cov_25.116211	814	894	72	7	80	0.0875000
NODE_1190_length_2147_cov_25.116211	814	894	74	1	80	0.0125000
NODE_1190_length_2147_cov_25.116211	814	894	75	7	80	0.0875000
NODE_1190_length_2147_cov_25.116211	814	894	76	2	80	0.0250000
NODE_1190_length_2147_cov_25.116211	814	894	78	3	80	0.0375000
NODE_1190_length_2147_cov_25.116211	814	894	80	7	80	0.0875000
NODE_1190_length_2147_cov_25.116211	814	894	82	7	80	0.0875000
NODE_1190_length_2147_cov_25.116211	814	894	86	2	80	0.0250000
NODE_1190_length_2147_cov_25.116211	867	947	18	9	80	0.1125000
NODE_1190_length_2147_cov_25.116211	867	947	20	5	80	0.0625000
NODE_1190_length_2147_cov_25.116211	867	947	22	3	80	0.0375000
NODE_1190_length_2147_cov_25.116211	867	947	24	4	80	0.0500000
NODE_1190_length_2147_cov_25.116211	867	947	26	2	80	0.0250000
NODE_1190_length_2147_cov_25.116211	867	947	34	1	80	0.0125000
NODE_1190_length_2147_cov_25.116211	867	947	36	1	80	0.0125000
NODE_1190_length_2147_cov_25.116211	867	947	42	1	80	0.0125000
NODE_1190_length_2147_cov_25.116211	867	947	44	2	80	0.0250000
NODE_1190_length_2147_cov_25.116211	867	947	46	4	80	0.0500000
NODE_1190_length_2147_cov_25.116211	867	947	59	1	80	0.0125000
NODE_1190_length_2147_cov_25.116211	867	947	61	1	80	0.0125000
NODE_1190_length_2147_cov_25.116211	867	947	64	6	80	0.0750000
NODE_1190_length_2147_cov_25.116211	867	947	66	6	80	0.0750000
NODE_1190_length_2147_cov_25.116211	867	947	72	9	80	0.1125000
NODE_1190_length_2147_cov_25.116211	867	947	74	1	80	0.0125000
NODE_1190_length_2147_cov_25.116211	867	947	75	3	80	0.0375000
NODE_1190_length_2147_cov_25.116211	867	947	76	2	80	0.0250000
NODE_1190_length_2147_cov_25.116211	867	947	78	3	80	0.0375000
NODE_1190_length_2147_cov_25.116211	867	947	80	7	80	0.0875000
NODE_1190_length_2147_cov_25.116211	867	947	82	7	80	0.0875000
NODE_1190_length_2147_cov_25.116211	867	947	86	2	80	0.0250000
NODE_1197_length_2136_cov_16.947472	279	359	0	80	80	1.0000000
NODE_1197_length_2136_cov_16.947472	332	412	0	80	80	1.0000000
NODE_1197_length_2136_cov_16.947472	408	488	0	80	80	1.0000000
NODE_1197_length_2136_cov_16.947472	461	541	0	60	80	0.7500000
NODE_1197_length_2136_cov_16.947472	461	541	2	20	80	0.2500000
NODE_1199_length_2133_cov_15.038840	498	578	6	16	80	0.2000000
NODE_1199_length_2133_cov_15.038840	498	578	10	30	80	0.3750000
NODE_1199_length_2133_cov_15.038840	498	578	16	34	80	0.4250000
NODE_1199_length_2133_cov_15.038840	551	631	2	9	80	0.1125000
NODE_1199_length_2133_cov_15.038840	551	631	8	3	80	0.0375000
NODE_1199_length_2133_cov_15.038840	551	631	10	4	80	0.0500000
NODE_1199_length_2133_cov_15.038840	551	631	12	18	80	0.2250000
NODE_1199_length_2133_cov_15.038840	551	631	16	46	80	0.5750000
NODE_1199_length_2133_cov_15.038840	627	707	2	80	80	1.0000000
NODE_1199_length_2133_cov_15.038840	680	722	0	14	42	0.3333333
NODE_1199_length_2133_cov_15.038840	680	722	2	28	42	0.6666667
NODE_1204_length_2128_cov_11.799409	1698	1778	4	27	80	0.3375000
NODE_1204_length_2128_cov_11.799409	1698	1778	6	53	80	0.6625000
NODE_1204_length_2128_cov_11.799409	1751	1831	0	29	80	0.3625000
NODE_1204_length_2128_cov_11.799409	1751	1831	2	19	80	0.2375000
NODE_1204_length_2128_cov_11.799409	1751	1831	4	13	80	0.1625000
NODE_1204_length_2128_cov_11.799409	1751	1831	6	19	80	0.2375000
NODE_1206_length_2126_cov_6.854465	1614	1694	0	3	80	0.0375000
NODE_1206_length_2126_cov_6.854465	1614	1694	2	77	80	0.9625000
NODE_1206_length_2126_cov_6.854465	1667	1747	0	25	80	0.3125000
NODE_1206_length_2126_cov_6.854465	1667	1747	2	55	80	0.6875000
NODE_1209_length_2123_cov_12.668478	102	143	6	30	41	0.7317073
NODE_1209_length_2123_cov_12.668478	102	143	8	11	41	0.2682927
NODE_1209_length_2123_cov_12.668478	1474	1500	0	26	26	1.0000000
NODE_1209_length_2123_cov_12.668478	1552	1601	6	2	49	0.0408163
NODE_1209_length_2123_cov_12.668478	1552	1601	12	3	49	0.0612245
NODE_1209_length_2123_cov_12.668478	1552	1601	14	18	49	0.3673469
NODE_1209_length_2123_cov_12.668478	1552	1601	16	22	49	0.4489796
NODE_1209_length_2123_cov_12.668478	1552	1601	18	4	49	0.0816327
NODE_1209_length_2123_cov_12.668478	1574	1654	14	1	80	0.0125000
NODE_1209_length_2123_cov_12.668478	1574	1654	16	45	80	0.5625000
NODE_1209_length_2123_cov_12.668478	1574	1654	18	34	80	0.4250000
NODE_1211_length_2121_cov_10.101879	497	577	0	29	80	0.3625000
NODE_1211_length_2121_cov_10.101879	497	577	4	15	80	0.1875000
NODE_1211_length_2121_cov_10.101879	497	577	8	36	80	0.4500000
NODE_1211_length_2121_cov_10.101879	550	630	0	10	80	0.1250000
NODE_1211_length_2121_cov_10.101879	550	630	4	14	80	0.1750000
NODE_1211_length_2121_cov_10.101879	550	630	8	56	80	0.7000000
NODE_1211_length_2121_cov_10.101879	1935	2008	4	5	73	0.0684932
NODE_1211_length_2121_cov_10.101879	1935	2008	5	33	73	0.4520548
NODE_1211_length_2121_cov_10.101879	1935	2008	7	30	73	0.4109589
NODE_1211_length_2121_cov_10.101879	1935	2008	9	5	73	0.0684932
NODE_1212_length_2121_cov_9.964886	1523	1603	0	8	80	0.1000000
NODE_1212_length_2121_cov_9.964886	1523	1603	2	34	80	0.4250000
NODE_1212_length_2121_cov_9.964886	1523	1603	4	38	80	0.4750000
NODE_1212_length_2121_cov_9.964886	1576	1656	0	61	80	0.7625000
NODE_1212_length_2121_cov_9.964886	1576	1656	2	19	80	0.2375000
NODE_1213_length_2120_cov_24.609599	25	92	0	67	67	1.0000000
NODE_1215_length_2119_cov_18.446040	366	446	2	40	80	0.5000000
NODE_1215_length_2119_cov_18.446040	366	446	4	40	80	0.5000000
NODE_1215_length_2119_cov_18.446040	419	499	0	46	80	0.5750000
NODE_1215_length_2119_cov_18.446040	419	499	2	34	80	0.4250000
NODE_1215_length_2119_cov_18.446040	1239	1319	0	39	80	0.4875000
NODE_1215_length_2119_cov_18.446040	1239	1319	2	4	80	0.0500000
NODE_1215_length_2119_cov_18.446040	1239	1319	4	26	80	0.3250000
NODE_1215_length_2119_cov_18.446040	1239	1319	8	11	80	0.1375000
NODE_1215_length_2119_cov_18.446040	1292	1372	4	16	80	0.2000000
NODE_1215_length_2119_cov_18.446040	1292	1372	6	1	80	0.0125000
NODE_1215_length_2119_cov_18.446040	1292	1372	8	63	80	0.7875000
NODE_1225_length_2110_cov_8.668324	1755	1835	0	70	80	0.8750000
NODE_1225_length_2110_cov_8.668324	1755	1835	2	10	80	0.1250000
NODE_1225_length_2110_cov_8.668324	1808	1888	0	17	80	0.2125000
NODE_1225_length_2110_cov_8.668324	1808	1888	2	63	80	0.7875000
NODE_1227_length_2106_cov_14.643747	1579	1659	0	54	80	0.6750000
NODE_1227_length_2106_cov_14.643747	1579	1659	3	1	80	0.0125000
NODE_1227_length_2106_cov_14.643747	1579	1659	4	25	80	0.3125000
NODE_1227_length_2106_cov_14.643747	1632	1712	0	80	80	1.0000000
NODE_1227_length_2106_cov_14.643747	1708	1786	0	78	78	1.0000000
NODE_1227_length_2106_cov_14.643747	1759	1839	0	80	80	1.0000000
NODE_1228_length_2106_cov_3.173393	48	96	0	48	48	1.0000000
NODE_1228_length_2106_cov_3.173393	48	96	0	48	48	1.0000000
NODE_1228_length_2106_cov_3.173393	48	96	0	48	48	1.0000000
NODE_1228_length_2106_cov_3.173393	48	96	0	48	48	1.0000000
NODE_1228_length_2106_cov_3.173393	48	96	0	48	48	1.0000000
NODE_1229_length_2102_cov_23.872192	390	470	0	80	80	1.0000000
NODE_1229_length_2102_cov_23.872192	443	523	0	80	80	1.0000000
NODE_1229_length_2102_cov_23.872192	519	599	0	32	80	0.4000000
NODE_1229_length_2102_cov_23.872192	519	599	1	2	80	0.0250000
NODE_1229_length_2102_cov_23.872192	519	599	2	8	80	0.1000000
NODE_1229_length_2102_cov_23.872192	519	599	4	14	80	0.1750000
NODE_1229_length_2102_cov_23.872192	519	599	26	24	80	0.3000000
NODE_1229_length_2102_cov_23.872192	572	652	4	3	80	0.0375000
NODE_1229_length_2102_cov_23.872192	572	652	24	22	80	0.2750000
NODE_1229_length_2102_cov_23.872192	572	652	26	55	80	0.6875000
NODE_1229_length_2102_cov_23.872192	1049	1101	343	1	52	0.0192308
NODE_1229_length_2102_cov_23.872192	1049	1101	351	2	52	0.0384615
NODE_1229_length_2102_cov_23.872192	1049	1101	353	2	52	0.0384615
NODE_1229_length_2102_cov_23.872192	1049	1101	356	1	52	0.0192308
NODE_1229_length_2102_cov_23.872192	1049	1101	381	1	52	0.0192308
NODE_1229_length_2102_cov_23.872192	1049	1101	383	1	52	0.0192308
NODE_1229_length_2102_cov_23.872192	1049	1101	385	2	52	0.0384615
NODE_1229_length_2102_cov_23.872192	1049	1101	391	1	52	0.0192308
NODE_1229_length_2102_cov_23.872192	1049	1101	393	1	52	0.0192308
NODE_1229_length_2102_cov_23.872192	1049	1101	399	1	52	0.0192308
NODE_1229_length_2102_cov_23.872192	1049	1101	403	1	52	0.0192308
NODE_1229_length_2102_cov_23.872192	1049	1101	411	1	52	0.0192308
NODE_1229_length_2102_cov_23.872192	1049	1101	415	1	52	0.0192308
NODE_1229_length_2102_cov_23.872192	1049	1101	417	2	52	0.0384615
NODE_1229_length_2102_cov_23.872192	1049	1101	419	1	52	0.0192308
NODE_1229_length_2102_cov_23.872192	1049	1101	421	1	52	0.0192308
NODE_1229_length_2102_cov_23.872192	1049	1101	424	1	52	0.0192308
NODE_1229_length_2102_cov_23.872192	1049	1101	425	1	52	0.0192308
NODE_1229_length_2102_cov_23.872192	1049	1101	427	1	52	0.0192308
NODE_1229_length_2102_cov_23.872192	1049	1101	444	1	52	0.0192308
NODE_1229_length_2102_cov_23.872192	1049	1101	457	1	52	0.0192308
NODE_1229_length_2102_cov_23.872192	1049	1101	461	1	52	0.0192308
NODE_1229_length_2102_cov_23.872192	1049	1101	465	1	52	0.0192308
NODE_1229_length_2102_cov_23.872192	1049	1101	467	2	52	0.0384615
NODE_1229_length_2102_cov_23.872192	1049	1101	471	1	52	0.0192308
NODE_1229_length_2102_cov_23.872192	1049	1101	483	5	52	0.0961538
NODE_1229_length_2102_cov_23.872192	1049	1101	484	1	52	0.0192308
NODE_1229_length_2102_cov_23.872192	1049	1101	485	4	52	0.0769231
NODE_1229_length_2102_cov_23.872192	1049	1101	486	1	52	0.0192308
NODE_1229_length_2102_cov_23.872192	1049	1101	488	2	52	0.0384615
NODE_1229_length_2102_cov_23.872192	1049	1101	491	2	52	0.0384615
NODE_1229_length_2102_cov_23.872192	1049	1101	493	2	52	0.0384615
NODE_1229_length_2102_cov_23.872192	1049	1101	494	1	52	0.0192308
NODE_1229_length_2102_cov_23.872192	1049	1101	497	1	52	0.0192308
NODE_1229_length_2102_cov_23.872192	1049	1101	498	1	52	0.0192308
NODE_1229_length_2102_cov_23.872192	1049	1101	499	1	52	0.0192308
NODE_1229_length_2102_cov_23.872192	1049	1101	501	1	52	0.0192308
NODE_1231_length_2100_cov_21.504248	450	530	0	74	80	0.9250000
NODE_1231_length_2100_cov_21.504248	450	530	2	6	80	0.0750000
NODE_1231_length_2100_cov_21.504248	503	578	0	21	75	0.2800000
NODE_1231_length_2100_cov_21.504248	503	578	2	54	75	0.7200000
NODE_1231_length_2100_cov_21.504248	579	659	3	19	80	0.2375000
NODE_1231_length_2100_cov_21.504248	579	659	4	61	80	0.7625000
NODE_1231_length_2100_cov_21.504248	632	712	2	38	80	0.4750000
NODE_1231_length_2100_cov_21.504248	632	712	3	34	80	0.4250000
NODE_1231_length_2100_cov_21.504248	632	712	4	8	80	0.1000000
NODE_1231_length_2100_cov_21.504248	1420	1500	0	80	80	1.0000000
NODE_1231_length_2100_cov_21.504248	1473	1553	0	80	80	1.0000000
NODE_1232_length_2100_cov_6.399300	1510	1590	0	43	80	0.5375000
NODE_1232_length_2100_cov_6.399300	1510	1590	4	37	80	0.4625000
NODE_1232_length_2100_cov_6.399300	1559	1590	4	31	31	1.0000000
NODE_1232_length_2100_cov_6.399300	1563	1644	0	26	81	0.3209876
NODE_1232_length_2100_cov_6.399300	1563	1644	4	55	81	0.6790124
NODE_1232_length_2100_cov_6.399300	1563	1644	0	26	81	0.3209876
NODE_1232_length_2100_cov_6.399300	1563	1644	4	55	81	0.6790124
NODE_1234_length_2099_cov_40.603500	960	1040	0	17	80	0.2125000
NODE_1234_length_2099_cov_40.603500	960	1040	2	14	80	0.1750000
NODE_1234_length_2099_cov_40.603500	960	1040	6	49	80	0.6125000
NODE_1234_length_2099_cov_40.603500	1013	1093	0	21	80	0.2625000
NODE_1234_length_2099_cov_40.603500	1013	1093	6	59	80	0.7375000
NODE_1234_length_2099_cov_40.603500	1089	1169	0	38	80	0.4750000
NODE_1234_length_2099_cov_40.603500	1089	1169	6	3	80	0.0375000
NODE_1234_length_2099_cov_40.603500	1089	1169	8	39	80	0.4875000
NODE_1234_length_2099_cov_40.603500	1142	1222	8	36	80	0.4500000
NODE_1234_length_2099_cov_40.603500	1142	1222	10	24	80	0.3000000
NODE_1234_length_2099_cov_40.603500	1142	1222	14	20	80	0.2500000
NODE_1235_length_2098_cov_62.733867	1042	1122	2	6	80	0.0750000
NODE_1235_length_2098_cov_62.733867	1042	1122	4	44	80	0.5500000
NODE_1235_length_2098_cov_62.733867	1042	1122	13	1	80	0.0125000
NODE_1235_length_2098_cov_62.733867	1042	1122	14	29	80	0.3625000
NODE_1235_length_2098_cov_62.733867	1095	1175	14	37	80	0.4625000
NODE_1235_length_2098_cov_62.733867	1095	1175	16	30	80	0.3750000
NODE_1235_length_2098_cov_62.733867	1095	1175	18	10	80	0.1250000
NODE_1235_length_2098_cov_62.733867	1095	1175	20	3	80	0.0375000
NODE_1235_length_2098_cov_62.733867	1171	1251	6	15	80	0.1875000
NODE_1235_length_2098_cov_62.733867	1171	1251	8	36	80	0.4500000
NODE_1235_length_2098_cov_62.733867	1171	1251	9	5	80	0.0625000
NODE_1235_length_2098_cov_62.733867	1171	1251	10	4	80	0.0500000
NODE_1235_length_2098_cov_62.733867	1171	1251	13	3	80	0.0375000
NODE_1235_length_2098_cov_62.733867	1171	1251	17	1	80	0.0125000
NODE_1235_length_2098_cov_62.733867	1171	1251	18	16	80	0.2000000
NODE_1235_length_2098_cov_62.733867	1224	1304	6	17	80	0.2125000
NODE_1235_length_2098_cov_62.733867	1224	1304	8	22	80	0.2750000
NODE_1235_length_2098_cov_62.733867	1224	1304	9	5	80	0.0625000
NODE_1235_length_2098_cov_62.733867	1224	1304	10	33	80	0.4125000
NODE_1235_length_2098_cov_62.733867	1224	1304	13	3	80	0.0375000
NODE_1236_length_2098_cov_20.220110	550	630	2	80	80	1.0000000
NODE_1236_length_2098_cov_20.220110	603	683	0	13	80	0.1625000
NODE_1236_length_2098_cov_20.220110	603	683	1	25	80	0.3125000
NODE_1236_length_2098_cov_20.220110	603	683	2	42	80	0.5250000
NODE_1236_length_2098_cov_20.220110	1571	1651	0	8	80	0.1000000
NODE_1236_length_2098_cov_20.220110	1571	1651	4	18	80	0.2250000
NODE_1236_length_2098_cov_20.220110	1571	1651	6	54	80	0.6750000
NODE_1236_length_2098_cov_20.220110	1624	1704	0	61	80	0.7625000
NODE_1236_length_2098_cov_20.220110	1624	1704	4	18	80	0.2250000
NODE_1236_length_2098_cov_20.220110	1624	1704	6	1	80	0.0125000
NODE_1237_length_2098_cov_8.261631	324	404	0	80	80	1.0000000
NODE_1239_length_2095_cov_29.930862	1128	1209	200	1	81	0.0123457
NODE_1239_length_2095_cov_29.930862	1128	1209	211	1	81	0.0123457
NODE_1239_length_2095_cov_29.930862	1128	1209	231	1	81	0.0123457
NODE_1239_length_2095_cov_29.930862	1128	1209	236	1	81	0.0123457
NODE_1239_length_2095_cov_29.930862	1128	1209	245	2	81	0.0246914
NODE_1239_length_2095_cov_29.930862	1128	1209	260	1	81	0.0123457
NODE_1239_length_2095_cov_29.930862	1128	1209	270	1	81	0.0123457
NODE_1239_length_2095_cov_29.930862	1128	1209	278	1	81	0.0123457
NODE_1239_length_2095_cov_29.930862	1128	1209	282	1	81	0.0123457
NODE_1239_length_2095_cov_29.930862	1128	1209	287	1	81	0.0123457
NODE_1239_length_2095_cov_29.930862	1128	1209	298	1	81	0.0123457
NODE_1239_length_2095_cov_29.930862	1128	1209	304	2	81	0.0246914
NODE_1239_length_2095_cov_29.930862	1128	1209	324	1	81	0.0123457
NODE_1239_length_2095_cov_29.930862	1128	1209	335	2	81	0.0246914
NODE_1239_length_2095_cov_29.930862	1128	1209	341	2	81	0.0246914
NODE_1239_length_2095_cov_29.930862	1128	1209	350	1	81	0.0123457
NODE_1239_length_2095_cov_29.930862	1128	1209	353	1	81	0.0123457
NODE_1239_length_2095_cov_29.930862	1128	1209	360	1	81	0.0123457
NODE_1239_length_2095_cov_29.930862	1128	1209	362	1	81	0.0123457
NODE_1239_length_2095_cov_29.930862	1128	1209	369	1	81	0.0123457
NODE_1239_length_2095_cov_29.930862	1128	1209	373	1	81	0.0123457
NODE_1239_length_2095_cov_29.930862	1128	1209	385	1	81	0.0123457
NODE_1239_length_2095_cov_29.930862	1128	1209	389	1	81	0.0123457
NODE_1239_length_2095_cov_29.930862	1128	1209	409	1	81	0.0123457
NODE_1239_length_2095_cov_29.930862	1128	1209	421	1	81	0.0123457
NODE_1239_length_2095_cov_29.930862	1128	1209	426	1	81	0.0123457
NODE_1239_length_2095_cov_29.930862	1128	1209	434	2	81	0.0246914
NODE_1239_length_2095_cov_29.930862	1128	1209	438	1	81	0.0123457
NODE_1239_length_2095_cov_29.930862	1128	1209	452	1	81	0.0123457
NODE_1239_length_2095_cov_29.930862	1128	1209	456	1	81	0.0123457
NODE_1239_length_2095_cov_29.930862	1128	1209	465	1	81	0.0123457
NODE_1239_length_2095_cov_29.930862	1128	1209	475	1	81	0.0123457
NODE_1239_length_2095_cov_29.930862	1128	1209	483	2	81	0.0246914
NODE_1239_length_2095_cov_29.930862	1128	1209	489	1	81	0.0123457
NODE_1239_length_2095_cov_29.930862	1128	1209	501	2	81	0.0246914
NODE_1239_length_2095_cov_29.930862	1128	1209	520	1	81	0.0123457
NODE_1239_length_2095_cov_29.930862	1128	1209	526	1	81	0.0123457
NODE_1239_length_2095_cov_29.930862	1128	1209	533	1	81	0.0123457
NODE_1239_length_2095_cov_29.930862	1128	1209	543	1	81	0.0123457
NODE_1239_length_2095_cov_29.930862	1128	1209	548	1	81	0.0123457
NODE_1239_length_2095_cov_29.930862	1128	1209	565	1	81	0.0123457
NODE_1239_length_2095_cov_29.930862	1128	1209	568	1	81	0.0123457
NODE_1239_length_2095_cov_29.930862	1128	1209	574	1	81	0.0123457
NODE_1239_length_2095_cov_29.930862	1128	1209	581	1	81	0.0123457
NODE_1239_length_2095_cov_29.930862	1128	1209	585	1	81	0.0123457
NODE_1239_length_2095_cov_29.930862	1128	1209	593	1	81	0.0123457
NODE_1239_length_2095_cov_29.930862	1128	1209	600	1	81	0.0123457
NODE_1239_length_2095_cov_29.930862	1128	1209	601	1	81	0.0123457
NODE_1239_length_2095_cov_29.930862	1128	1209	603	1	81	0.0123457
NODE_1239_length_2095_cov_29.930862	1128	1209	604	1	81	0.0123457
NODE_1239_length_2095_cov_29.930862	1128	1209	606	1	81	0.0123457
NODE_1239_length_2095_cov_29.930862	1128	1209	617	1	81	0.0123457
NODE_1239_length_2095_cov_29.930862	1128	1209	637	1	81	0.0123457
NODE_1239_length_2095_cov_29.930862	1128	1209	638	1	81	0.0123457
NODE_1239_length_2095_cov_29.930862	1128	1209	646	1	81	0.0123457
NODE_1239_length_2095_cov_29.930862	1128	1209	651	1	81	0.0123457
NODE_1239_length_2095_cov_29.930862	1128	1209	671	1	81	0.0123457
NODE_1239_length_2095_cov_29.930862	1128	1209	676	1	81	0.0123457
NODE_1239_length_2095_cov_29.930862	1128	1209	688	1	81	0.0123457
NODE_1239_length_2095_cov_29.930862	1128	1209	691	1	81	0.0123457
NODE_1239_length_2095_cov_29.930862	1128	1209	695	1	81	0.0123457
NODE_1239_length_2095_cov_29.930862	1128	1209	699	1	81	0.0123457
NODE_1239_length_2095_cov_29.930862	1128	1209	702	1	81	0.0123457
NODE_1239_length_2095_cov_29.930862	1128	1209	712	1	81	0.0123457
NODE_1239_length_2095_cov_29.930862	1128	1209	713	2	81	0.0246914
NODE_1239_length_2095_cov_29.930862	1128	1209	719	1	81	0.0123457
NODE_1239_length_2095_cov_29.930862	1128	1209	720	2	81	0.0246914
NODE_1239_length_2095_cov_29.930862	1128	1209	724	1	81	0.0123457
NODE_1239_length_2095_cov_29.930862	1128	1209	729	1	81	0.0123457
NODE_1239_length_2095_cov_29.930862	1128	1209	731	1	81	0.0123457
NODE_1239_length_2095_cov_29.930862	1128	1209	739	1	81	0.0123457
NODE_1239_length_2095_cov_29.930862	1128	1209	741	1	81	0.0123457
NODE_1239_length_2095_cov_29.930862	1204	1258	678	1	54	0.0185185
NODE_1239_length_2095_cov_29.930862	1204	1258	680	1	54	0.0185185
NODE_1239_length_2095_cov_29.930862	1204	1258	682	2	54	0.0370370
NODE_1239_length_2095_cov_29.930862	1204	1258	690	1	54	0.0185185
NODE_1239_length_2095_cov_29.930862	1204	1258	692	1	54	0.0185185
NODE_1239_length_2095_cov_29.930862	1204	1258	695	1	54	0.0185185
NODE_1239_length_2095_cov_29.930862	1204	1258	696	2	54	0.0370370
NODE_1239_length_2095_cov_29.930862	1204	1258	700	1	54	0.0185185
NODE_1239_length_2095_cov_29.930862	1204	1258	716	1	54	0.0185185
NODE_1239_length_2095_cov_29.930862	1204	1258	718	1	54	0.0185185
NODE_1239_length_2095_cov_29.930862	1204	1258	720	1	54	0.0185185
NODE_1239_length_2095_cov_29.930862	1204	1258	723	1	54	0.0185185
NODE_1239_length_2095_cov_29.930862	1204	1258	724	1	54	0.0185185
NODE_1239_length_2095_cov_29.930862	1204	1258	727	2	54	0.0370370
NODE_1239_length_2095_cov_29.930862	1204	1258	729	1	54	0.0185185
NODE_1239_length_2095_cov_29.930862	1204	1258	730	1	54	0.0185185
NODE_1239_length_2095_cov_29.930862	1204	1258	731	1	54	0.0185185
NODE_1239_length_2095_cov_29.930862	1204	1258	733	2	54	0.0370370
NODE_1239_length_2095_cov_29.930862	1204	1258	735	1	54	0.0185185
NODE_1239_length_2095_cov_29.930862	1204	1258	737	1	54	0.0185185
NODE_1239_length_2095_cov_29.930862	1204	1258	739	1	54	0.0185185
NODE_1239_length_2095_cov_29.930862	1204	1258	741	1	54	0.0185185
NODE_1239_length_2095_cov_29.930862	1204	1258	745	1	54	0.0185185
NODE_1239_length_2095_cov_29.930862	1204	1258	747	1	54	0.0185185
NODE_1239_length_2095_cov_29.930862	1204	1258	750	2	54	0.0370370
NODE_1239_length_2095_cov_29.930862	1204	1258	751	3	54	0.0555556
NODE_1239_length_2095_cov_29.930862	1204	1258	752	1	54	0.0185185
NODE_1239_length_2095_cov_29.930862	1204	1258	753	1	54	0.0185185
NODE_1239_length_2095_cov_29.930862	1204	1258	754	1	54	0.0185185
NODE_1239_length_2095_cov_29.930862	1204	1258	758	2	54	0.0370370
NODE_1239_length_2095_cov_29.930862	1204	1258	759	1	54	0.0185185
NODE_1239_length_2095_cov_29.930862	1204	1258	760	1	54	0.0185185
NODE_1239_length_2095_cov_29.930862	1204	1258	762	1	54	0.0185185
NODE_1239_length_2095_cov_29.930862	1204	1258	763	1	54	0.0185185
NODE_1239_length_2095_cov_29.930862	1204	1258	764	1	54	0.0185185
NODE_1239_length_2095_cov_29.930862	1204	1258	766	2	54	0.0370370
NODE_1239_length_2095_cov_29.930862	1204	1258	769	2	54	0.0370370
NODE_1239_length_2095_cov_29.930862	1204	1258	771	1	54	0.0185185
NODE_1239_length_2095_cov_29.930862	1204	1258	774	2	54	0.0370370
NODE_1239_length_2095_cov_29.930862	1204	1258	775	1	54	0.0185185
NODE_1239_length_2095_cov_29.930862	1204	1258	776	1	54	0.0185185
NODE_1239_length_2095_cov_29.930862	1204	1258	783	1	54	0.0185185
NODE_1239_length_2095_cov_29.930862	1204	1258	787	1	54	0.0185185
NODE_1251_length_2084_cov_1.720403	959	1039	0	4	80	0.0500000
NODE_1251_length_2084_cov_1.720403	959	1039	2	38	80	0.4750000
NODE_1251_length_2084_cov_1.720403	959	1039	4	35	80	0.4375000
NODE_1251_length_2084_cov_1.720403	959	1039	8	3	80	0.0375000
NODE_1251_length_2084_cov_1.720403	1012	1092	4	24	80	0.3000000
NODE_1251_length_2084_cov_1.720403	1012	1092	6	1	80	0.0125000
NODE_1251_length_2084_cov_1.720403	1012	1092	8	26	80	0.3250000
NODE_1251_length_2084_cov_1.720403	1012	1092	10	23	80	0.2875000
NODE_1251_length_2084_cov_1.720403	1012	1092	11	2	80	0.0250000
NODE_1251_length_2084_cov_1.720403	1012	1092	12	4	80	0.0500000
NODE_1252_length_2083_cov_5.864415	419	499	0	80	80	1.0000000
NODE_1252_length_2083_cov_5.864415	472	552	0	80	80	1.0000000
NODE_1252_length_2083_cov_5.864415	548	628	0	12	80	0.1500000
NODE_1252_length_2083_cov_5.864415	548	628	2	68	80	0.8500000
NODE_1252_length_2083_cov_5.864415	601	681	0	20	80	0.2500000
NODE_1252_length_2083_cov_5.864415	601	681	2	60	80	0.7500000
NODE_1256_length_2078_cov_47.394644	311	391	0	17	80	0.2125000
NODE_1256_length_2078_cov_47.394644	311	391	2	63	80	0.7875000
NODE_1256_length_2078_cov_47.394644	364	444	0	70	80	0.8750000
NODE_1256_length_2078_cov_47.394644	364	444	2	10	80	0.1250000
NODE_1256_length_2078_cov_47.394644	440	520	0	33	80	0.4125000
NODE_1256_length_2078_cov_47.394644	440	520	5	1	80	0.0125000
NODE_1256_length_2078_cov_47.394644	440	520	6	33	80	0.4125000
NODE_1256_length_2078_cov_47.394644	440	520	10	1	80	0.0125000
NODE_1256_length_2078_cov_47.394644	440	520	11	12	80	0.1500000
NODE_1256_length_2078_cov_47.394644	493	573	6	14	80	0.1750000
NODE_1256_length_2078_cov_47.394644	493	573	10	1	80	0.0125000
NODE_1256_length_2078_cov_47.394644	493	573	11	61	80	0.7625000
NODE_1256_length_2078_cov_47.394644	493	573	12	4	80	0.0500000
NODE_1267_length_2067_cov_13.647866	1349	1429	2	9	80	0.1125000
NODE_1267_length_2067_cov_13.647866	1349	1429	4	19	80	0.2375000
NODE_1267_length_2067_cov_13.647866	1349	1429	6	45	80	0.5625000
NODE_1267_length_2067_cov_13.647866	1349	1429	8	6	80	0.0750000
NODE_1267_length_2067_cov_13.647866	1349	1429	10	1	80	0.0125000
NODE_1267_length_2067_cov_13.647866	1402	1482	4	21	80	0.2625000
NODE_1267_length_2067_cov_13.647866	1402	1482	6	45	80	0.5625000
NODE_1267_length_2067_cov_13.647866	1402	1482	8	13	80	0.1625000
NODE_1267_length_2067_cov_13.647866	1402	1482	10	1	80	0.0125000
NODE_1269_length_2066_cov_19.127605	1497	1577	0	7	80	0.0875000
NODE_1269_length_2066_cov_19.127605	1497	1577	4	6	80	0.0750000
NODE_1269_length_2066_cov_19.127605	1497	1577	8	4	80	0.0500000
NODE_1269_length_2066_cov_19.127605	1497	1577	16	1	80	0.0125000
NODE_1269_length_2066_cov_19.127605	1497	1577	17	9	80	0.1125000
NODE_1269_length_2066_cov_19.127605	1497	1577	20	1	80	0.0125000
NODE_1269_length_2066_cov_19.127605	1497	1577	21	14	80	0.1750000
NODE_1269_length_2066_cov_19.127605	1497	1577	27	1	80	0.0125000
NODE_1269_length_2066_cov_19.127605	1497	1577	29	12	80	0.1500000
NODE_1269_length_2066_cov_19.127605	1497	1577	30	20	80	0.2500000
NODE_1269_length_2066_cov_19.127605	1497	1577	31	5	80	0.0625000
NODE_1269_length_2066_cov_19.127605	1550	1630	12	10	80	0.1250000
NODE_1269_length_2066_cov_19.127605	1550	1630	16	16	80	0.2000000
NODE_1269_length_2066_cov_19.127605	1550	1630	18	1	80	0.0125000
NODE_1269_length_2066_cov_19.127605	1550	1630	22	3	80	0.0375000
NODE_1269_length_2066_cov_19.127605	1550	1630	29	5	80	0.0625000
NODE_1269_length_2066_cov_19.127605	1550	1630	30	17	80	0.2125000
NODE_1269_length_2066_cov_19.127605	1550	1630	31	27	80	0.3375000
NODE_1269_length_2066_cov_19.127605	1550	1630	33	1	80	0.0125000
NODE_1274_length_2061_cov_43.187054	364	444	0	11	80	0.1375000
NODE_1274_length_2061_cov_43.187054	364	444	2	10	80	0.1250000
NODE_1274_length_2061_cov_43.187054	364	444	5	4	80	0.0500000
NODE_1274_length_2061_cov_43.187054	364	444	6	55	80	0.6875000
NODE_1274_length_2061_cov_43.187054	417	497	0	11	80	0.1375000
NODE_1274_length_2061_cov_43.187054	417	497	2	63	80	0.7875000
NODE_1274_length_2061_cov_43.187054	417	497	5	4	80	0.0500000
NODE_1274_length_2061_cov_43.187054	417	497	6	2	80	0.0250000
NODE_1275_length_2061_cov_3.251784	981	1033	0	52	52	1.0000000
NODE_1275_length_2061_cov_3.251784	1006	1086	0	80	80	1.0000000
NODE_1277_length_2058_cov_4.531394	1844	1875	0	9	31	0.2903226
NODE_1277_length_2058_cov_4.531394	1844	1875	4	20	31	0.6451613
NODE_1277_length_2058_cov_4.531394	1844	1875	6	2	31	0.0645161
NODE_1277_length_2058_cov_4.531394	1848	1928	0	5	80	0.0625000
NODE_1277_length_2058_cov_4.531394	1848	1928	4	20	80	0.2500000
NODE_1277_length_2058_cov_4.531394	1848	1928	6	14	80	0.1750000
NODE_1277_length_2058_cov_4.531394	1848	1928	8	25	80	0.3125000
NODE_1277_length_2058_cov_4.531394	1848	1928	12	16	80	0.2000000
NODE_1279_length_2056_cov_20.525805	749	829	0	80	80	1.0000000
NODE_1279_length_2056_cov_20.525805	802	882	0	73	80	0.9125000
NODE_1279_length_2056_cov_20.525805	802	882	8	7	80	0.0875000
NODE_1279_length_2056_cov_20.525805	878	958	8	40	80	0.5000000
NODE_1279_length_2056_cov_20.525805	878	958	10	40	80	0.5000000
NODE_1279_length_2056_cov_20.525805	931	1011	0	1	80	0.0125000
NODE_1279_length_2056_cov_20.525805	931	1011	2	35	80	0.4375000
NODE_1279_length_2056_cov_20.525805	931	1011	10	44	80	0.5500000
NODE_1281_length_2055_cov_10.047546	1468	1548	0	80	80	1.0000000
NODE_1281_length_2055_cov_10.047546	1521	1601	0	80	80	1.0000000
NODE_1286_length_2049_cov_6.846154	270	350	0	80	80	1.0000000
NODE_1286_length_2049_cov_6.846154	323	403	0	80	80	1.0000000
NODE_1286_length_2049_cov_6.846154	1595	1674	0	79	79	1.0000000
NODE_1286_length_2049_cov_6.846154	1648	1712	0	64	64	1.0000000
NODE_1293_length_2045_cov_46.790339	876	956	12	4	80	0.0500000
NODE_1293_length_2045_cov_46.790339	876	956	14	3	80	0.0375000
NODE_1293_length_2045_cov_46.790339	876	956	16	5	80	0.0625000
NODE_1293_length_2045_cov_46.790339	876	956	18	7	80	0.0875000
NODE_1293_length_2045_cov_46.790339	876	956	22	1	80	0.0125000
NODE_1293_length_2045_cov_46.790339	876	956	24	39	80	0.4875000
NODE_1293_length_2045_cov_46.790339	876	956	26	21	80	0.2625000
NODE_1293_length_2045_cov_46.790339	929	1009	4	7	80	0.0875000
NODE_1293_length_2045_cov_46.790339	929	1009	6	24	80	0.3000000
NODE_1293_length_2045_cov_46.790339	929	1009	8	3	80	0.0375000
NODE_1293_length_2045_cov_46.790339	929	1009	10	3	80	0.0375000
NODE_1293_length_2045_cov_46.790339	929	1009	12	18	80	0.2250000
NODE_1293_length_2045_cov_46.790339	929	1009	14	4	80	0.0500000
NODE_1293_length_2045_cov_46.790339	929	1009	16	6	80	0.0750000
NODE_1293_length_2045_cov_46.790339	929	1009	18	7	80	0.0875000
NODE_1293_length_2045_cov_46.790339	929	1009	22	1	80	0.0125000
NODE_1293_length_2045_cov_46.790339	929	1009	24	7	80	0.0875000
NODE_1293_length_2045_cov_46.790339	1005	1085	12	2	80	0.0250000
NODE_1293_length_2045_cov_46.790339	1005	1085	14	1	80	0.0125000
NODE_1293_length_2045_cov_46.790339	1005	1085	16	1	80	0.0125000
NODE_1293_length_2045_cov_46.790339	1005	1085	20	14	80	0.1750000
NODE_1293_length_2045_cov_46.790339	1005	1085	22	10	80	0.1250000
NODE_1293_length_2045_cov_46.790339	1005	1085	24	9	80	0.1125000
NODE_1293_length_2045_cov_46.790339	1005	1085	25	12	80	0.1500000
NODE_1293_length_2045_cov_46.790339	1005	1085	26	8	80	0.1000000
NODE_1293_length_2045_cov_46.790339	1005	1085	27	9	80	0.1125000
NODE_1293_length_2045_cov_46.790339	1005	1085	29	9	80	0.1125000
NODE_1293_length_2045_cov_46.790339	1005	1085	31	5	80	0.0625000
NODE_1293_length_2045_cov_46.790339	1058	1138	2	8	80	0.1000000
NODE_1293_length_2045_cov_46.790339	1058	1138	6	6	80	0.0750000
NODE_1293_length_2045_cov_46.790339	1058	1138	8	3	80	0.0375000
NODE_1293_length_2045_cov_46.790339	1058	1138	10	15	80	0.1875000
NODE_1293_length_2045_cov_46.790339	1058	1138	12	3	80	0.0375000
NODE_1293_length_2045_cov_46.790339	1058	1138	16	9	80	0.1125000
NODE_1293_length_2045_cov_46.790339	1058	1138	18	4	80	0.0500000
NODE_1293_length_2045_cov_46.790339	1058	1138	20	8	80	0.1000000
NODE_1293_length_2045_cov_46.790339	1058	1138	22	12	80	0.1500000
NODE_1293_length_2045_cov_46.790339	1058	1138	24	5	80	0.0625000
NODE_1293_length_2045_cov_46.790339	1058	1138	26	2	80	0.0250000
NODE_1293_length_2045_cov_46.790339	1058	1138	27	2	80	0.0250000
NODE_1293_length_2045_cov_46.790339	1058	1138	29	3	80	0.0375000
NODE_1298_length_2042_cov_4.447761	241	315	0	74	74	1.0000000
NODE_1301_length_2040_cov_30.109737	1760	1844	220	1	84	0.0119048
NODE_1301_length_2040_cov_30.109737	1760	1844	221	2	84	0.0238095
NODE_1301_length_2040_cov_30.109737	1760	1844	225	1	84	0.0119048
NODE_1301_length_2040_cov_30.109737	1760	1844	235	3	84	0.0357143
NODE_1301_length_2040_cov_30.109737	1760	1844	237	1	84	0.0119048
NODE_1301_length_2040_cov_30.109737	1760	1844	241	1	84	0.0119048
NODE_1301_length_2040_cov_30.109737	1760	1844	247	1	84	0.0119048
NODE_1301_length_2040_cov_30.109737	1760	1844	251	1	84	0.0119048
NODE_1301_length_2040_cov_30.109737	1760	1844	253	1	84	0.0119048
NODE_1301_length_2040_cov_30.109737	1760	1844	255	1	84	0.0119048
NODE_1301_length_2040_cov_30.109737	1760	1844	256	1	84	0.0119048
NODE_1301_length_2040_cov_30.109737	1760	1844	257	1	84	0.0119048
NODE_1301_length_2040_cov_30.109737	1760	1844	258	1	84	0.0119048
NODE_1301_length_2040_cov_30.109737	1760	1844	260	3	84	0.0357143
NODE_1301_length_2040_cov_30.109737	1760	1844	262	2	84	0.0238095
NODE_1301_length_2040_cov_30.109737	1760	1844	266	4	84	0.0476190
NODE_1301_length_2040_cov_30.109737	1760	1844	268	1	84	0.0119048
NODE_1301_length_2040_cov_30.109737	1760	1844	270	2	84	0.0238095
NODE_1301_length_2040_cov_30.109737	1760	1844	271	4	84	0.0476190
NODE_1301_length_2040_cov_30.109737	1760	1844	272	4	84	0.0476190
NODE_1301_length_2040_cov_30.109737	1760	1844	273	1	84	0.0119048
NODE_1301_length_2040_cov_30.109737	1760	1844	274	3	84	0.0357143
NODE_1301_length_2040_cov_30.109737	1760	1844	276	5	84	0.0595238
NODE_1301_length_2040_cov_30.109737	1760	1844	278	4	84	0.0476190
NODE_1301_length_2040_cov_30.109737	1760	1844	279	1	84	0.0119048
NODE_1301_length_2040_cov_30.109737	1760	1844	283	2	84	0.0238095
NODE_1301_length_2040_cov_30.109737	1760	1844	284	1	84	0.0119048
NODE_1301_length_2040_cov_30.109737	1760	1844	286	1	84	0.0119048
NODE_1301_length_2040_cov_30.109737	1760	1844	289	1	84	0.0119048
NODE_1301_length_2040_cov_30.109737	1760	1844	295	1	84	0.0119048
NODE_1301_length_2040_cov_30.109737	1760	1844	300	1	84	0.0119048
NODE_1301_length_2040_cov_30.109737	1760	1844	303	1	84	0.0119048
NODE_1301_length_2040_cov_30.109737	1760	1844	305	1	84	0.0119048
NODE_1301_length_2040_cov_30.109737	1760	1844	309	1	84	0.0119048
NODE_1301_length_2040_cov_30.109737	1760	1844	310	1	84	0.0119048
NODE_1301_length_2040_cov_30.109737	1760	1844	311	2	84	0.0238095
NODE_1301_length_2040_cov_30.109737	1760	1844	313	2	84	0.0238095
NODE_1301_length_2040_cov_30.109737	1760	1844	315	2	84	0.0238095
NODE_1301_length_2040_cov_30.109737	1760	1844	317	2	84	0.0238095
NODE_1301_length_2040_cov_30.109737	1760	1844	318	1	84	0.0119048
NODE_1301_length_2040_cov_30.109737	1760	1844	319	2	84	0.0238095
NODE_1301_length_2040_cov_30.109737	1760	1844	321	4	84	0.0476190
NODE_1301_length_2040_cov_30.109737	1760	1844	323	1	84	0.0119048
NODE_1301_length_2040_cov_30.109737	1760	1844	324	1	84	0.0119048
NODE_1301_length_2040_cov_30.109737	1760	1844	326	1	84	0.0119048
NODE_1301_length_2040_cov_30.109737	1760	1844	331	1	84	0.0119048
NODE_1301_length_2040_cov_30.109737	1760	1844	332	3	84	0.0357143
NODE_1301_length_2040_cov_30.109737	1760	1844	334	1	84	0.0119048
NODE_1306_length_2036_cov_11.672173	369	449	0	80	80	1.0000000
NODE_1306_length_2036_cov_11.672173	422	502	0	80	80	1.0000000
NODE_1312_length_2032_cov_11.188308	416	496	0	80	80	1.0000000
NODE_1312_length_2032_cov_11.188308	469	549	0	80	80	1.0000000
NODE_1318_length_2027_cov_43.702282	1129	1209	0	32	80	0.4000000
NODE_1318_length_2027_cov_43.702282	1129	1209	9	1	80	0.0125000
NODE_1318_length_2027_cov_43.702282	1129	1209	10	47	80	0.5875000
NODE_1318_length_2027_cov_43.702282	1182	1262	10	80	80	1.0000000
NODE_1318_length_2027_cov_43.702282	1258	1338	10	6	80	0.0750000
NODE_1318_length_2027_cov_43.702282	1258	1338	11	27	80	0.3375000
NODE_1318_length_2027_cov_43.702282	1258	1338	13	5	80	0.0625000
NODE_1318_length_2027_cov_43.702282	1258	1338	14	36	80	0.4500000
NODE_1318_length_2027_cov_43.702282	1258	1338	19	2	80	0.0250000
NODE_1318_length_2027_cov_43.702282	1258	1338	20	4	80	0.0500000
NODE_1318_length_2027_cov_43.702282	1311	1391	7	39	80	0.4875000
NODE_1318_length_2027_cov_43.702282	1311	1391	8	11	80	0.1375000
NODE_1318_length_2027_cov_43.702282	1311	1391	11	30	80	0.3750000
NODE_1319_length_2027_cov_6.558610	229	303	4	74	74	1.0000000
NODE_1319_length_2027_cov_6.558610	229	303	4	74	74	1.0000000
NODE_1319_length_2027_cov_6.558610	276	356	0	44	80	0.5500000
NODE_1319_length_2027_cov_6.558610	276	356	4	36	80	0.4500000
NODE_1320_length_2026_cov_18.457706	688	768	8	2	80	0.0250000
NODE_1320_length_2026_cov_18.457706	688	768	10	43	80	0.5375000
NODE_1320_length_2026_cov_18.457706	688	768	12	35	80	0.4375000
NODE_1320_length_2026_cov_18.457706	741	821	0	21	80	0.2625000
NODE_1320_length_2026_cov_18.457706	741	821	2	4	80	0.0500000
NODE_1320_length_2026_cov_18.457706	741	821	8	30	80	0.3750000
NODE_1320_length_2026_cov_18.457706	741	821	10	22	80	0.2750000
NODE_1320_length_2026_cov_18.457706	741	821	12	3	80	0.0375000
NODE_1324_length_2025_cov_10.711319	617	697	2	7	80	0.0875000
NODE_1324_length_2025_cov_10.711319	617	697	4	15	80	0.1875000
NODE_1324_length_2025_cov_10.711319	617	697	6	56	80	0.7000000
NODE_1324_length_2025_cov_10.711319	617	697	8	2	80	0.0250000
NODE_1324_length_2025_cov_10.711319	712	783	0	11	71	0.1549296
NODE_1324_length_2025_cov_10.711319	712	783	1	1	71	0.0140845
NODE_1324_length_2025_cov_10.711319	712	783	2	20	71	0.2816902
NODE_1324_length_2025_cov_10.711319	712	783	8	12	71	0.1690141
NODE_1324_length_2025_cov_10.711319	712	783	10	27	71	0.3802817
NODE_1324_length_2025_cov_10.711319	756	829	10	73	73	1.0000000
NODE_1325_length_2024_cov_33.891948	1045	1125	0	7	80	0.0875000
NODE_1325_length_2024_cov_33.891948	1045	1125	2	34	80	0.4250000
NODE_1325_length_2024_cov_33.891948	1045	1125	9	1	80	0.0125000
NODE_1325_length_2024_cov_33.891948	1045	1125	10	38	80	0.4750000
NODE_1325_length_2024_cov_33.891948	1098	1178	8	30	80	0.3750000
NODE_1325_length_2024_cov_33.891948	1098	1178	10	50	80	0.6250000
NODE_1331_length_2018_cov_33.742053	1215	1295	173	1	80	0.0125000
NODE_1331_length_2018_cov_33.742053	1215	1295	179	1	80	0.0125000
NODE_1331_length_2018_cov_33.742053	1215	1295	182	1	80	0.0125000
NODE_1331_length_2018_cov_33.742053	1215	1295	183	1	80	0.0125000
NODE_1331_length_2018_cov_33.742053	1215	1295	188	1	80	0.0125000
NODE_1331_length_2018_cov_33.742053	1215	1295	190	2	80	0.0250000
NODE_1331_length_2018_cov_33.742053	1215	1295	198	1	80	0.0125000
NODE_1331_length_2018_cov_33.742053	1215	1295	206	1	80	0.0125000
NODE_1331_length_2018_cov_33.742053	1215	1295	209	1	80	0.0125000
NODE_1331_length_2018_cov_33.742053	1215	1295	215	1	80	0.0125000
NODE_1331_length_2018_cov_33.742053	1215	1295	219	1	80	0.0125000
NODE_1331_length_2018_cov_33.742053	1215	1295	220	1	80	0.0125000
NODE_1331_length_2018_cov_33.742053	1215	1295	221	1	80	0.0125000
NODE_1331_length_2018_cov_33.742053	1215	1295	223	1	80	0.0125000
NODE_1331_length_2018_cov_33.742053	1215	1295	224	3	80	0.0375000
NODE_1331_length_2018_cov_33.742053	1215	1295	225	1	80	0.0125000
NODE_1331_length_2018_cov_33.742053	1215	1295	226	1	80	0.0125000
NODE_1331_length_2018_cov_33.742053	1215	1295	228	2	80	0.0250000
NODE_1331_length_2018_cov_33.742053	1215	1295	230	3	80	0.0375000
NODE_1331_length_2018_cov_33.742053	1215	1295	231	1	80	0.0125000
NODE_1331_length_2018_cov_33.742053	1215	1295	232	1	80	0.0125000
NODE_1331_length_2018_cov_33.742053	1215	1295	233	1	80	0.0125000
NODE_1331_length_2018_cov_33.742053	1215	1295	242	1	80	0.0125000
NODE_1331_length_2018_cov_33.742053	1215	1295	243	3	80	0.0375000
NODE_1331_length_2018_cov_33.742053	1215	1295	245	1	80	0.0125000
NODE_1331_length_2018_cov_33.742053	1215	1295	247	1	80	0.0125000
NODE_1331_length_2018_cov_33.742053	1215	1295	256	1	80	0.0125000
NODE_1331_length_2018_cov_33.742053	1215	1295	262	1	80	0.0125000
NODE_1331_length_2018_cov_33.742053	1215	1295	264	1	80	0.0125000
NODE_1331_length_2018_cov_33.742053	1215	1295	266	2	80	0.0250000
NODE_1331_length_2018_cov_33.742053	1215	1295	268	2	80	0.0250000
NODE_1331_length_2018_cov_33.742053	1215	1295	270	5	80	0.0625000
NODE_1331_length_2018_cov_33.742053	1215	1295	271	1	80	0.0125000
NODE_1331_length_2018_cov_33.742053	1215	1295	272	1	80	0.0125000
NODE_1331_length_2018_cov_33.742053	1215	1295	273	1	80	0.0125000
NODE_1331_length_2018_cov_33.742053	1215	1295	274	4	80	0.0500000
NODE_1331_length_2018_cov_33.742053	1215	1295	275	1	80	0.0125000
NODE_1331_length_2018_cov_33.742053	1215	1295	276	2	80	0.0250000
NODE_1331_length_2018_cov_33.742053	1215	1295	277	1	80	0.0125000
NODE_1331_length_2018_cov_33.742053	1215	1295	278	3	80	0.0375000
NODE_1331_length_2018_cov_33.742053	1215	1295	281	4	80	0.0500000
NODE_1331_length_2018_cov_33.742053	1215	1295	282	1	80	0.0125000
NODE_1331_length_2018_cov_33.742053	1215	1295	289	2	80	0.0250000
NODE_1331_length_2018_cov_33.742053	1215	1295	296	1	80	0.0125000
NODE_1331_length_2018_cov_33.742053	1215	1295	298	1	80	0.0125000
NODE_1331_length_2018_cov_33.742053	1215	1295	303	1	80	0.0125000
NODE_1331_length_2018_cov_33.742053	1215	1295	312	1	80	0.0125000
NODE_1331_length_2018_cov_33.742053	1215	1295	316	3	80	0.0375000
NODE_1331_length_2018_cov_33.742053	1215	1295	318	3	80	0.0375000
NODE_1331_length_2018_cov_33.742053	1215	1295	321	3	80	0.0375000
NODE_1331_length_2018_cov_33.742053	1268	1298	270	1	30	0.0333333
NODE_1331_length_2018_cov_33.742053	1268	1298	272	1	30	0.0333333
NODE_1331_length_2018_cov_33.742053	1268	1298	274	1	30	0.0333333
NODE_1331_length_2018_cov_33.742053	1268	1298	275	1	30	0.0333333
NODE_1331_length_2018_cov_33.742053	1268	1298	276	1	30	0.0333333
NODE_1331_length_2018_cov_33.742053	1268	1298	277	1	30	0.0333333
NODE_1331_length_2018_cov_33.742053	1268	1298	278	3	30	0.1000000
NODE_1331_length_2018_cov_33.742053	1268	1298	281	3	30	0.1000000
NODE_1331_length_2018_cov_33.742053	1268	1298	289	2	30	0.0666667
NODE_1331_length_2018_cov_33.742053	1268	1298	296	1	30	0.0333333
NODE_1331_length_2018_cov_33.742053	1268	1298	298	1	30	0.0333333
NODE_1331_length_2018_cov_33.742053	1268	1298	303	1	30	0.0333333
NODE_1331_length_2018_cov_33.742053	1268	1298	312	1	30	0.0333333
NODE_1331_length_2018_cov_33.742053	1268	1298	314	1	30	0.0333333
NODE_1331_length_2018_cov_33.742053	1268	1298	315	1	30	0.0333333
NODE_1331_length_2018_cov_33.742053	1268	1298	316	3	30	0.1000000
NODE_1331_length_2018_cov_33.742053	1268	1298	318	4	30	0.1333333
NODE_1331_length_2018_cov_33.742053	1268	1298	321	3	30	0.1000000
NODE_1331_length_2018_cov_33.742053	1876	1942	112	1	66	0.0151515
NODE_1331_length_2018_cov_33.742053	1876	1942	114	1	66	0.0151515
NODE_1331_length_2018_cov_33.742053	1876	1942	116	1	66	0.0151515
NODE_1331_length_2018_cov_33.742053	1876	1942	121	1	66	0.0151515
NODE_1331_length_2018_cov_33.742053	1876	1942	125	1	66	0.0151515
NODE_1331_length_2018_cov_33.742053	1876	1942	131	1	66	0.0151515
NODE_1331_length_2018_cov_33.742053	1876	1942	133	1	66	0.0151515
NODE_1331_length_2018_cov_33.742053	1876	1942	148	1	66	0.0151515
NODE_1331_length_2018_cov_33.742053	1876	1942	154	1	66	0.0151515
NODE_1331_length_2018_cov_33.742053	1876	1942	156	1	66	0.0151515
NODE_1331_length_2018_cov_33.742053	1876	1942	158	1	66	0.0151515
NODE_1331_length_2018_cov_33.742053	1876	1942	164	1	66	0.0151515
NODE_1331_length_2018_cov_33.742053	1876	1942	170	1	66	0.0151515
NODE_1331_length_2018_cov_33.742053	1876	1942	173	1	66	0.0151515
NODE_1331_length_2018_cov_33.742053	1876	1942	178	1	66	0.0151515
NODE_1331_length_2018_cov_33.742053	1876	1942	184	1	66	0.0151515
NODE_1331_length_2018_cov_33.742053	1876	1942	188	1	66	0.0151515
NODE_1331_length_2018_cov_33.742053	1876	1942	191	1	66	0.0151515
NODE_1331_length_2018_cov_33.742053	1876	1942	192	2	66	0.0303030
NODE_1331_length_2018_cov_33.742053	1876	1942	194	1	66	0.0151515
NODE_1331_length_2018_cov_33.742053	1876	1942	196	1	66	0.0151515
NODE_1331_length_2018_cov_33.742053	1876	1942	199	1	66	0.0151515
NODE_1331_length_2018_cov_33.742053	1876	1942	205	3	66	0.0454545
NODE_1331_length_2018_cov_33.742053	1876	1942	207	1	66	0.0151515
NODE_1331_length_2018_cov_33.742053	1876	1942	210	1	66	0.0151515
NODE_1331_length_2018_cov_33.742053	1876	1942	239	1	66	0.0151515
NODE_1331_length_2018_cov_33.742053	1876	1942	246	1	66	0.0151515
NODE_1331_length_2018_cov_33.742053	1876	1942	256	1	66	0.0151515
NODE_1331_length_2018_cov_33.742053	1876	1942	285	1	66	0.0151515
NODE_1331_length_2018_cov_33.742053	1876	1942	292	1	66	0.0151515
NODE_1331_length_2018_cov_33.742053	1876	1942	303	1	66	0.0151515
NODE_1331_length_2018_cov_33.742053	1876	1942	309	1	66	0.0151515
NODE_1331_length_2018_cov_33.742053	1876	1942	313	1	66	0.0151515
NODE_1331_length_2018_cov_33.742053	1876	1942	317	1	66	0.0151515
NODE_1331_length_2018_cov_33.742053	1876	1942	327	1	66	0.0151515
NODE_1331_length_2018_cov_33.742053	1876	1942	346	1	66	0.0151515
NODE_1331_length_2018_cov_33.742053	1876	1942	350	1	66	0.0151515
NODE_1331_length_2018_cov_33.742053	1876	1942	372	1	66	0.0151515
NODE_1331_length_2018_cov_33.742053	1876	1942	374	1	66	0.0151515
NODE_1331_length_2018_cov_33.742053	1876	1942	387	1	66	0.0151515
NODE_1331_length_2018_cov_33.742053	1876	1942	389	1	66	0.0151515
NODE_1331_length_2018_cov_33.742053	1876	1942	395	1	66	0.0151515
NODE_1331_length_2018_cov_33.742053	1876	1942	397	1	66	0.0151515
NODE_1331_length_2018_cov_33.742053	1876	1942	417	1	66	0.0151515
NODE_1331_length_2018_cov_33.742053	1876	1942	436	1	66	0.0151515
NODE_1331_length_2018_cov_33.742053	1876	1942	438	1	66	0.0151515
NODE_1331_length_2018_cov_33.742053	1876	1942	443	1	66	0.0151515
NODE_1331_length_2018_cov_33.742053	1876	1942	453	1	66	0.0151515
NODE_1331_length_2018_cov_33.742053	1876	1942	482	3	66	0.0454545
NODE_1331_length_2018_cov_33.742053	1876	1942	483	2	66	0.0303030
NODE_1331_length_2018_cov_33.742053	1876	1942	487	1	66	0.0151515
NODE_1331_length_2018_cov_33.742053	1876	1942	494	1	66	0.0151515
NODE_1331_length_2018_cov_33.742053	1876	1942	501	1	66	0.0151515
NODE_1331_length_2018_cov_33.742053	1876	1942	507	1	66	0.0151515
NODE_1331_length_2018_cov_33.742053	1876	1942	509	1	66	0.0151515
NODE_1331_length_2018_cov_33.742053	1876	1942	512	1	66	0.0151515
NODE_1331_length_2018_cov_33.742053	1876	1942	514	1	66	0.0151515
NODE_1331_length_2018_cov_33.742053	1876	1942	520	1	66	0.0151515
NODE_1331_length_2018_cov_33.742053	1876	1942	523	1	66	0.0151515
NODE_1331_length_2018_cov_33.742053	1876	1942	528	1	66	0.0151515
NODE_1331_length_2018_cov_33.742053	1915	1995	15	3	80	0.0375000
NODE_1331_length_2018_cov_33.742053	1915	1995	17	1	80	0.0125000
NODE_1331_length_2018_cov_33.742053	1915	1995	18	1	80	0.0125000
NODE_1331_length_2018_cov_33.742053	1915	1995	26	1	80	0.0125000
NODE_1331_length_2018_cov_33.742053	1915	1995	30	1	80	0.0125000
NODE_1331_length_2018_cov_33.742053	1915	1995	34	3	80	0.0375000
NODE_1331_length_2018_cov_33.742053	1915	1995	36	3	80	0.0375000
NODE_1331_length_2018_cov_33.742053	1915	1995	42	1	80	0.0125000
NODE_1331_length_2018_cov_33.742053	1915	1995	44	1	80	0.0125000
NODE_1331_length_2018_cov_33.742053	1915	1995	46	1	80	0.0125000
NODE_1331_length_2018_cov_33.742053	1915	1995	47	5	80	0.0625000
NODE_1331_length_2018_cov_33.742053	1915	1995	49	2	80	0.0250000
NODE_1331_length_2018_cov_33.742053	1915	1995	50	1	80	0.0125000
NODE_1331_length_2018_cov_33.742053	1915	1995	51	3	80	0.0375000
NODE_1331_length_2018_cov_33.742053	1915	1995	55	1	80	0.0125000
NODE_1331_length_2018_cov_33.742053	1915	1995	59	1	80	0.0125000
NODE_1331_length_2018_cov_33.742053	1915	1995	63	3	80	0.0375000
NODE_1331_length_2018_cov_33.742053	1915	1995	69	1	80	0.0125000
NODE_1331_length_2018_cov_33.742053	1915	1995	71	3	80	0.0375000
NODE_1331_length_2018_cov_33.742053	1915	1995	77	2	80	0.0250000
NODE_1331_length_2018_cov_33.742053	1915	1995	81	4	80	0.0500000
NODE_1331_length_2018_cov_33.742053	1915	1995	83	1	80	0.0125000
NODE_1331_length_2018_cov_33.742053	1915	1995	87	1	80	0.0125000
NODE_1331_length_2018_cov_33.742053	1915	1995	90	1	80	0.0125000
NODE_1331_length_2018_cov_33.742053	1915	1995	92	1	80	0.0125000
NODE_1331_length_2018_cov_33.742053	1915	1995	98	2	80	0.0250000
NODE_1331_length_2018_cov_33.742053	1915	1995	103	1	80	0.0125000
NODE_1331_length_2018_cov_33.742053	1915	1995	106	3	80	0.0375000
NODE_1331_length_2018_cov_33.742053	1915	1995	110	1	80	0.0125000
NODE_1331_length_2018_cov_33.742053	1915	1995	112	1	80	0.0125000
NODE_1331_length_2018_cov_33.742053	1915	1995	114	1	80	0.0125000
NODE_1331_length_2018_cov_33.742053	1915	1995	116	1	80	0.0125000
NODE_1331_length_2018_cov_33.742053	1915	1995	121	1	80	0.0125000
NODE_1331_length_2018_cov_33.742053	1915	1995	125	1	80	0.0125000
NODE_1331_length_2018_cov_33.742053	1915	1995	131	1	80	0.0125000
NODE_1331_length_2018_cov_33.742053	1915	1995	133	1	80	0.0125000
NODE_1331_length_2018_cov_33.742053	1915	1995	148	1	80	0.0125000
NODE_1331_length_2018_cov_33.742053	1915	1995	154	1	80	0.0125000
NODE_1331_length_2018_cov_33.742053	1915	1995	156	1	80	0.0125000
NODE_1331_length_2018_cov_33.742053	1915	1995	158	1	80	0.0125000
NODE_1331_length_2018_cov_33.742053	1915	1995	164	1	80	0.0125000
NODE_1331_length_2018_cov_33.742053	1915	1995	170	1	80	0.0125000
NODE_1331_length_2018_cov_33.742053	1915	1995	173	1	80	0.0125000
NODE_1331_length_2018_cov_33.742053	1915	1995	178	1	80	0.0125000
NODE_1331_length_2018_cov_33.742053	1915	1995	184	1	80	0.0125000
NODE_1331_length_2018_cov_33.742053	1915	1995	188	1	80	0.0125000
NODE_1331_length_2018_cov_33.742053	1915	1995	191	1	80	0.0125000
NODE_1331_length_2018_cov_33.742053	1915	1995	192	2	80	0.0250000
NODE_1331_length_2018_cov_33.742053	1915	1995	194	1	80	0.0125000
NODE_1331_length_2018_cov_33.742053	1915	1995	196	1	80	0.0125000
NODE_1331_length_2018_cov_33.742053	1915	1995	199	1	80	0.0125000
NODE_1331_length_2018_cov_33.742053	1915	1995	205	3	80	0.0375000
NODE_1331_length_2018_cov_33.742053	1915	1995	207	1	80	0.0125000
NODE_1337_length_2011_cov_22.430439	434	514	6	12	80	0.1500000
NODE_1337_length_2011_cov_22.430439	434	514	9	8	80	0.1000000
NODE_1337_length_2011_cov_22.430439	434	514	10	60	80	0.7500000
NODE_1337_length_2011_cov_22.430439	487	567	3	7	80	0.0875000
NODE_1337_length_2011_cov_22.430439	487	567	4	39	80	0.4875000
NODE_1337_length_2011_cov_22.430439	487	567	6	14	80	0.1750000
NODE_1337_length_2011_cov_22.430439	487	567	8	5	80	0.0625000
NODE_1337_length_2011_cov_22.430439	487	567	10	15	80	0.1875000
NODE_1337_length_2011_cov_22.430439	1124	1204	0	80	80	1.0000000
NODE_1337_length_2011_cov_22.430439	1177	1257	0	42	80	0.5250000
NODE_1337_length_2011_cov_22.430439	1177	1257	2	38	80	0.4750000
NODE_1343_length_2001_cov_10.416404	692	772	2	80	80	1.0000000
NODE_1343_length_2001_cov_10.416404	745	825	0	35	80	0.4375000
NODE_1343_length_2001_cov_10.416404	745	825	2	45	80	0.5625000
NODE_1350_length_1991_cov_112.926533	212	292	267	1	80	0.0125000
NODE_1350_length_1991_cov_112.926533	212	292	269	2	80	0.0250000
NODE_1350_length_1991_cov_112.926533	212	292	273	4	80	0.0500000
NODE_1350_length_1991_cov_112.926533	212	292	281	1	80	0.0125000
NODE_1350_length_1991_cov_112.926533	212	292	282	1	80	0.0125000
NODE_1350_length_1991_cov_112.926533	212	292	285	1	80	0.0125000
NODE_1350_length_1991_cov_112.926533	212	292	287	1	80	0.0125000
NODE_1350_length_1991_cov_112.926533	212	292	290	1	80	0.0125000
NODE_1350_length_1991_cov_112.926533	212	292	296	1	80	0.0125000
NODE_1350_length_1991_cov_112.926533	212	292	297	1	80	0.0125000
NODE_1350_length_1991_cov_112.926533	212	292	300	1	80	0.0125000
NODE_1350_length_1991_cov_112.926533	212	292	302	3	80	0.0375000
NODE_1350_length_1991_cov_112.926533	212	292	306	1	80	0.0125000
NODE_1350_length_1991_cov_112.926533	212	292	310	2	80	0.0250000
NODE_1350_length_1991_cov_112.926533	212	292	312	2	80	0.0250000
NODE_1350_length_1991_cov_112.926533	212	292	316	2	80	0.0250000
NODE_1350_length_1991_cov_112.926533	212	292	317	2	80	0.0250000
NODE_1350_length_1991_cov_112.926533	212	292	318	2	80	0.0250000
NODE_1350_length_1991_cov_112.926533	212	292	319	2	80	0.0250000
NODE_1350_length_1991_cov_112.926533	212	292	323	1	80	0.0125000
NODE_1350_length_1991_cov_112.926533	212	292	324	1	80	0.0125000
NODE_1350_length_1991_cov_112.926533	212	292	327	2	80	0.0250000
NODE_1350_length_1991_cov_112.926533	212	292	328	2	80	0.0250000
NODE_1350_length_1991_cov_112.926533	212	292	330	1	80	0.0125000
NODE_1350_length_1991_cov_112.926533	212	292	334	1	80	0.0125000
NODE_1350_length_1991_cov_112.926533	212	292	335	1	80	0.0125000
NODE_1350_length_1991_cov_112.926533	212	292	336	1	80	0.0125000
NODE_1350_length_1991_cov_112.926533	212	292	338	1	80	0.0125000
NODE_1350_length_1991_cov_112.926533	212	292	339	1	80	0.0125000
NODE_1350_length_1991_cov_112.926533	212	292	340	2	80	0.0250000
NODE_1350_length_1991_cov_112.926533	212	292	341	1	80	0.0125000
NODE_1350_length_1991_cov_112.926533	212	292	344	10	80	0.1250000
NODE_1350_length_1991_cov_112.926533	212	292	348	1	80	0.0125000
NODE_1350_length_1991_cov_112.926533	212	292	350	2	80	0.0250000
NODE_1350_length_1991_cov_112.926533	212	292	351	2	80	0.0250000
NODE_1350_length_1991_cov_112.926533	212	292	352	6	80	0.0750000
NODE_1350_length_1991_cov_112.926533	212	292	354	4	80	0.0500000
NODE_1350_length_1991_cov_112.926533	212	292	355	1	80	0.0125000
NODE_1350_length_1991_cov_112.926533	212	292	356	3	80	0.0375000
NODE_1350_length_1991_cov_112.926533	212	292	357	5	80	0.0625000
NODE_1352_length_1988_cov_13.736368	865	945	6	22	80	0.2750000
NODE_1352_length_1988_cov_13.736368	865	945	8	12	80	0.1500000
NODE_1352_length_1988_cov_13.736368	865	945	10	10	80	0.1250000
NODE_1352_length_1988_cov_13.736368	865	945	12	15	80	0.1875000
NODE_1352_length_1988_cov_13.736368	865	945	14	21	80	0.2625000
NODE_1352_length_1988_cov_13.736368	918	998	6	6	80	0.0750000
NODE_1352_length_1988_cov_13.736368	918	998	8	20	80	0.2500000
NODE_1352_length_1988_cov_13.736368	918	998	10	45	80	0.5625000
NODE_1352_length_1988_cov_13.736368	918	998	12	9	80	0.1125000
NODE_1353_length_1988_cov_9.980413	1616	1696	0	80	80	1.0000000
NODE_1353_length_1988_cov_9.980413	1669	1749	0	80	80	1.0000000
NODE_1356_length_1983_cov_17.332803	494	574	2	62	80	0.7750000
NODE_1356_length_1983_cov_17.332803	494	574	6	13	80	0.1625000
NODE_1356_length_1983_cov_17.332803	494	574	8	5	80	0.0625000
NODE_1356_length_1983_cov_17.332803	547	627	2	9	80	0.1125000
NODE_1356_length_1983_cov_17.332803	547	627	6	66	80	0.8250000
NODE_1356_length_1983_cov_17.332803	547	627	8	5	80	0.0625000
NODE_1356_length_1983_cov_17.332803	1600	1680	0	66	80	0.8250000
NODE_1356_length_1983_cov_17.332803	1600	1680	4	14	80	0.1750000
NODE_1356_length_1983_cov_17.332803	1653	1733	0	13	80	0.1625000
NODE_1356_length_1983_cov_17.332803	1653	1733	4	67	80	0.8375000
NODE_1359_length_1982_cov_17.164100	457	537	0	17	80	0.2125000
NODE_1359_length_1982_cov_17.164100	457	537	2	63	80	0.7875000
NODE_1359_length_1982_cov_17.164100	510	590	0	70	80	0.8750000
NODE_1359_length_1982_cov_17.164100	510	590	2	10	80	0.1250000
NODE_1359_length_1982_cov_17.164100	586	666	0	80	80	1.0000000
NODE_1359_length_1982_cov_17.164100	639	723	0	84	84	1.0000000
NODE_1360_length_1981_cov_46.444208	0	70	0	70	70	1.0000000
NODE_1362_length_1979_cov_1.630851	1554	1634	0	80	80	1.0000000
NODE_1364_length_1976_cov_1.959510	154	215	24	5	61	0.0819672
NODE_1364_length_1976_cov_1.959510	154	215	26	4	61	0.0655738
NODE_1364_length_1976_cov_1.959510	154	215	29	10	61	0.1639344
NODE_1364_length_1976_cov_1.959510	154	215	30	4	61	0.0655738
NODE_1364_length_1976_cov_1.959510	154	215	32	35	61	0.5737705
NODE_1364_length_1976_cov_1.959510	154	215	34	3	61	0.0491803
NODE_1364_length_1976_cov_1.959510	154	215	24	5	61	0.0819672
NODE_1364_length_1976_cov_1.959510	154	215	26	4	61	0.0655738
NODE_1364_length_1976_cov_1.959510	154	215	29	10	61	0.1639344
NODE_1364_length_1976_cov_1.959510	154	215	30	4	61	0.0655738
NODE_1364_length_1976_cov_1.959510	154	215	32	35	61	0.5737705
NODE_1364_length_1976_cov_1.959510	154	215	34	3	61	0.0491803
NODE_1364_length_1976_cov_1.959510	154	213	24	5	59	0.0847458
NODE_1364_length_1976_cov_1.959510	154	213	26	4	59	0.0677966
NODE_1364_length_1976_cov_1.959510	154	213	29	10	59	0.1694915
NODE_1364_length_1976_cov_1.959510	154	213	30	4	59	0.0677966
NODE_1364_length_1976_cov_1.959510	154	213	32	35	59	0.5932204
NODE_1364_length_1976_cov_1.959510	154	213	34	1	59	0.0169492
NODE_1365_length_1974_cov_8.058133	617	697	14	6	80	0.0750000
NODE_1365_length_1974_cov_8.058133	617	697	16	3	80	0.0375000
NODE_1365_length_1974_cov_8.058133	617	697	18	17	80	0.2125000
NODE_1365_length_1974_cov_8.058133	617	697	20	5	80	0.0625000
NODE_1365_length_1974_cov_8.058133	617	697	22	49	80	0.6125000
NODE_1365_length_1974_cov_8.058133	670	750	0	15	80	0.1875000
NODE_1365_length_1974_cov_8.058133	670	750	3	1	80	0.0125000
NODE_1365_length_1974_cov_8.058133	670	750	4	17	80	0.2125000
NODE_1365_length_1974_cov_8.058133	670	750	6	10	80	0.1250000
NODE_1365_length_1974_cov_8.058133	670	750	8	7	80	0.0875000
NODE_1365_length_1974_cov_8.058133	670	750	13	1	80	0.0125000
NODE_1365_length_1974_cov_8.058133	670	750	14	8	80	0.1000000
NODE_1365_length_1974_cov_8.058133	670	750	16	3	80	0.0375000
NODE_1365_length_1974_cov_8.058133	670	750	18	10	80	0.1250000
NODE_1365_length_1974_cov_8.058133	670	750	22	8	80	0.1000000
NODE_1366_length_1973_cov_14.885272	640	726	4	76	86	0.8837209
NODE_1366_length_1973_cov_14.885272	640	726	6	10	86	0.1162791
NODE_1366_length_1973_cov_14.885272	699	779	2	22	80	0.2750000
NODE_1366_length_1973_cov_14.885272	699	779	4	41	80	0.5125000
NODE_1366_length_1973_cov_14.885272	699	779	6	17	80	0.2125000
NODE_1366_length_1973_cov_14.885272	1389	1469	0	10	80	0.1250000
NODE_1366_length_1973_cov_14.885272	1389	1469	2	70	80	0.8750000
NODE_1366_length_1973_cov_14.885272	1442	1522	2	80	80	1.0000000
NODE_1372_length_1971_cov_3.126068	1662	1742	20	5	80	0.0625000
NODE_1372_length_1971_cov_3.126068	1662	1742	22	13	80	0.1625000
NODE_1372_length_1971_cov_3.126068	1662	1742	24	6	80	0.0750000
NODE_1372_length_1971_cov_3.126068	1662	1742	26	18	80	0.2250000
NODE_1372_length_1971_cov_3.126068	1662	1742	28	12	80	0.1500000
NODE_1372_length_1971_cov_3.126068	1662	1742	30	11	80	0.1375000
NODE_1372_length_1971_cov_3.126068	1662	1742	32	12	80	0.1500000
NODE_1372_length_1971_cov_3.126068	1662	1742	34	3	80	0.0375000
NODE_1372_length_1971_cov_3.126068	1715	1799	12	6	84	0.0714286
NODE_1372_length_1971_cov_3.126068	1715	1799	14	4	84	0.0476190
NODE_1372_length_1971_cov_3.126068	1715	1799	19	15	84	0.1785714
NODE_1372_length_1971_cov_3.126068	1715	1799	20	1	84	0.0119048
NODE_1372_length_1971_cov_3.126068	1715	1799	21	5	84	0.0595238
NODE_1372_length_1971_cov_3.126068	1715	1799	22	17	84	0.2023810
NODE_1372_length_1971_cov_3.126068	1715	1799	23	3	84	0.0357143
NODE_1372_length_1971_cov_3.126068	1715	1799	24	9	84	0.1071429
NODE_1372_length_1971_cov_3.126068	1715	1799	26	13	84	0.1547619
NODE_1372_length_1971_cov_3.126068	1715	1799	28	6	84	0.0714286
NODE_1372_length_1971_cov_3.126068	1715	1799	30	5	84	0.0595238
NODE_1386_length_1962_cov_23.774557	281	311	0	30	30	1.0000000
NODE_1386_length_1962_cov_23.774557	329	355	0	26	26	1.0000000
NODE_1386_length_1962_cov_23.774557	408	487	0	79	79	1.0000000
NODE_1386_length_1962_cov_23.774557	460	540	0	80	80	1.0000000
NODE_1386_length_1962_cov_23.774557	1417	1497	0	80	80	1.0000000
NODE_1386_length_1962_cov_23.774557	1470	1550	0	27	80	0.3375000
NODE_1386_length_1962_cov_23.774557	1470	1550	2	53	80	0.6625000
NODE_1386_length_1962_cov_23.774557	1607	1640	2	11	33	0.3333333
NODE_1386_length_1962_cov_23.774557	1607	1640	4	22	33	0.6666667
NODE_1395_length_1953_cov_26.183927	1	81	2	1	80	0.0125000
NODE_1395_length_1953_cov_26.183927	1	81	21	6	80	0.0750000
NODE_1395_length_1953_cov_26.183927	1	81	23	2	80	0.0250000
NODE_1395_length_1953_cov_26.183927	1	81	25	4	80	0.0500000
NODE_1395_length_1953_cov_26.183927	1	81	26	25	80	0.3125000
NODE_1395_length_1953_cov_26.183927	1	81	27	24	80	0.3000000
NODE_1395_length_1953_cov_26.183927	1	81	28	18	80	0.2250000
NODE_1395_length_1953_cov_26.183927	6	28	21	2	22	0.0909091
NODE_1395_length_1953_cov_26.183927	6	28	23	2	22	0.0909091
NODE_1395_length_1953_cov_26.183927	6	28	25	4	22	0.1818182
NODE_1395_length_1953_cov_26.183927	6	28	26	14	22	0.6363636
NODE_1395_length_1953_cov_26.183927	152	232	0	80	80	1.0000000
NODE_1395_length_1953_cov_26.183927	205	257	0	50	52	0.9615384
NODE_1395_length_1953_cov_26.183927	205	257	5	1	52	0.0192308
NODE_1395_length_1953_cov_26.183927	205	257	10	1	52	0.0192308
NODE_1405_length_1943_cov_11.218547	516	596	0	4	80	0.0500000
NODE_1405_length_1943_cov_11.218547	516	596	2	37	80	0.4625000
NODE_1405_length_1943_cov_11.218547	516	596	4	39	80	0.4875000
NODE_1405_length_1943_cov_11.218547	569	649	0	57	80	0.7125000
NODE_1405_length_1943_cov_11.218547	569	649	2	23	80	0.2875000
NODE_1408_length_1941_cov_14.407709	891	921	0	30	30	1.0000000
NODE_1408_length_1941_cov_14.407709	894	964	0	70	70	1.0000000
NODE_1408_length_1941_cov_14.407709	1878	1941	0	63	63	1.0000000
NODE_1409_length_1941_cov_9.632465	139	213	0	74	74	1.0000000
NODE_1409_length_1941_cov_9.632465	139	219	0	80	80	1.0000000
NODE_1409_length_1941_cov_9.632465	139	194	0	55	55	1.0000000
NODE_1409_length_1941_cov_9.632465	192	272	0	80	80	1.0000000
NODE_1414_length_1936_cov_13.338596	679	759	0	80	80	1.0000000
NODE_1414_length_1936_cov_13.338596	732	812	0	80	80	1.0000000
NODE_1414_length_1936_cov_13.338596	738	812	0	74	74	1.0000000
NODE_1414_length_1936_cov_13.338596	738	759	0	21	21	1.0000000
NODE_1415_length_1936_cov_12.592814	102	153	0	38	51	0.7450981
NODE_1415_length_1936_cov_12.592814	102	153	2	2	51	0.0392157
NODE_1415_length_1936_cov_12.592814	102	153	6	11	51	0.2156863
NODE_1415_length_1936_cov_12.592814	154	230	24	2	76	0.0263158
NODE_1415_length_1936_cov_12.592814	154	230	26	1	76	0.0131579
NODE_1415_length_1936_cov_12.592814	154	230	28	1	76	0.0131579
NODE_1415_length_1936_cov_12.592814	154	230	30	1	76	0.0131579
NODE_1415_length_1936_cov_12.592814	154	230	32	1	76	0.0131579
NODE_1415_length_1936_cov_12.592814	154	230	34	6	76	0.0789474
NODE_1415_length_1936_cov_12.592814	154	230	38	3	76	0.0394737
NODE_1415_length_1936_cov_12.592814	154	230	40	2	76	0.0263158
NODE_1415_length_1936_cov_12.592814	154	230	42	6	76	0.0789474
NODE_1415_length_1936_cov_12.592814	154	230	44	2	76	0.0263158
NODE_1415_length_1936_cov_12.592814	154	230	46	13	76	0.1710526
NODE_1415_length_1936_cov_12.592814	154	230	48	25	76	0.3289474
NODE_1415_length_1936_cov_12.592814	154	230	50	13	76	0.1710526
NODE_1415_length_1936_cov_12.592814	211	251	18	1	40	0.0250000
NODE_1415_length_1936_cov_12.592814	211	251	21	1	40	0.0250000
NODE_1415_length_1936_cov_12.592814	211	251	26	1	40	0.0250000
NODE_1415_length_1936_cov_12.592814	211	251	30	9	40	0.2250000
NODE_1415_length_1936_cov_12.592814	211	251	32	1	40	0.0250000
NODE_1415_length_1936_cov_12.592814	211	251	34	1	40	0.0250000
NODE_1415_length_1936_cov_12.592814	211	251	36	4	40	0.1000000
NODE_1415_length_1936_cov_12.592814	211	251	40	2	40	0.0500000
NODE_1415_length_1936_cov_12.592814	211	251	42	2	40	0.0500000
NODE_1415_length_1936_cov_12.592814	211	251	44	1	40	0.0250000
NODE_1415_length_1936_cov_12.592814	211	251	48	8	40	0.2000000
NODE_1415_length_1936_cov_12.592814	211	251	50	9	40	0.2250000
NODE_1416_length_1933_cov_86.724646	1044	1124	0	33	80	0.4125000
NODE_1416_length_1933_cov_86.724646	1044	1124	2	1	80	0.0125000
NODE_1416_length_1933_cov_86.724646	1044	1124	4	36	80	0.4500000
NODE_1416_length_1933_cov_86.724646	1044	1124	6	10	80	0.1250000
NODE_1416_length_1933_cov_86.724646	1097	1177	2	12	80	0.1500000
NODE_1416_length_1933_cov_86.724646	1097	1177	4	23	80	0.2875000
NODE_1416_length_1933_cov_86.724646	1097	1177	6	45	80	0.5625000
NODE_1416_length_1933_cov_86.724646	1173	1253	2	57	80	0.7125000
NODE_1416_length_1933_cov_86.724646	1173	1253	4	23	80	0.2875000
NODE_1416_length_1933_cov_86.724646	1226	1306	0	33	80	0.4125000
NODE_1416_length_1933_cov_86.724646	1226	1306	2	47	80	0.5875000
NODE_1419_length_1932_cov_5.905074	1534	1614	2	24	80	0.3000000
NODE_1419_length_1932_cov_5.905074	1534	1614	6	56	80	0.7000000
NODE_1422_length_1930_cov_3.005461	1700	1780	90	7	80	0.0875000
NODE_1422_length_1930_cov_3.005461	1700	1780	108	6	80	0.0750000
NODE_1422_length_1930_cov_3.005461	1700	1780	111	2	80	0.0250000
NODE_1422_length_1930_cov_3.005461	1700	1780	112	5	80	0.0625000
NODE_1422_length_1930_cov_3.005461	1700	1780	114	2	80	0.0250000
NODE_1422_length_1930_cov_3.005461	1700	1780	117	3	80	0.0375000
NODE_1422_length_1930_cov_3.005461	1700	1780	118	4	80	0.0500000
NODE_1422_length_1930_cov_3.005461	1700	1780	119	9	80	0.1125000
NODE_1422_length_1930_cov_3.005461	1700	1780	120	8	80	0.1000000
NODE_1422_length_1930_cov_3.005461	1700	1780	121	4	80	0.0500000
NODE_1422_length_1930_cov_3.005461	1700	1780	122	30	80	0.3750000
NODE_1427_length_1928_cov_2.580098	74	131	64	1	57	0.0175439
NODE_1427_length_1928_cov_2.580098	74	131	65	31	57	0.5438597
NODE_1427_length_1928_cov_2.580098	74	131	66	25	57	0.4385965
NODE_1427_length_1928_cov_2.580098	127	184	18	5	57	0.0877193
NODE_1427_length_1928_cov_2.580098	127	184	20	2	57	0.0350877
NODE_1427_length_1928_cov_2.580098	127	184	28	12	57	0.2105263
NODE_1427_length_1928_cov_2.580098	127	184	33	1	57	0.0175439
NODE_1427_length_1928_cov_2.580098	127	184	35	4	57	0.0701754
NODE_1427_length_1928_cov_2.580098	127	184	38	4	57	0.0701754
NODE_1427_length_1928_cov_2.580098	127	184	43	1	57	0.0175439
NODE_1427_length_1928_cov_2.580098	127	184	48	1	57	0.0175439
NODE_1427_length_1928_cov_2.580098	127	184	50	1	57	0.0175439
NODE_1427_length_1928_cov_2.580098	127	184	52	4	57	0.0701754
NODE_1427_length_1928_cov_2.580098	127	184	54	1	57	0.0175439
NODE_1427_length_1928_cov_2.580098	127	184	55	2	57	0.0350877
NODE_1427_length_1928_cov_2.580098	127	184	57	1	57	0.0175439
NODE_1427_length_1928_cov_2.580098	127	184	59	6	57	0.1052632
NODE_1427_length_1928_cov_2.580098	127	184	64	9	57	0.1578947
NODE_1427_length_1928_cov_2.580098	127	184	65	3	57	0.0526316
NODE_1434_length_1919_cov_17.901099	454	529	10	18	75	0.2400000
NODE_1434_length_1919_cov_17.901099	454	529	12	1	75	0.0133333
NODE_1434_length_1919_cov_17.901099	454	529	18	2	75	0.0266667
NODE_1434_length_1919_cov_17.901099	454	529	20	54	75	0.7200000
NODE_1434_length_1919_cov_17.901099	507	558	0	11	51	0.2156863
NODE_1434_length_1919_cov_17.901099	507	558	2	9	51	0.1764706
NODE_1434_length_1919_cov_17.901099	507	558	4	8	51	0.1568628
NODE_1434_length_1919_cov_17.901099	507	558	10	19	51	0.3725490
NODE_1434_length_1919_cov_17.901099	507	558	12	1	51	0.0196078
NODE_1434_length_1919_cov_17.901099	507	558	18	2	51	0.0392157
NODE_1434_length_1919_cov_17.901099	507	558	20	1	51	0.0196078
NODE_1436_length_1918_cov_14.876855	314	396	4	3	82	0.0365854
NODE_1436_length_1918_cov_14.876855	314	396	6	3	82	0.0365854
NODE_1436_length_1918_cov_14.876855	314	396	11	1	82	0.0121951
NODE_1436_length_1918_cov_14.876855	314	396	14	13	82	0.1585366
NODE_1436_length_1918_cov_14.876855	314	396	15	1	82	0.0121951
NODE_1436_length_1918_cov_14.876855	314	396	17	26	82	0.3170732
NODE_1436_length_1918_cov_14.876855	314	396	28	6	82	0.0731707
NODE_1436_length_1918_cov_14.876855	314	396	30	1	82	0.0121951
NODE_1436_length_1918_cov_14.876855	314	396	32	28	82	0.3414634
NODE_1438_length_1918_cov_3.493128	9	55	2	28	46	0.6086956
NODE_1438_length_1918_cov_3.493128	9	55	6	2	46	0.0434783
NODE_1438_length_1918_cov_3.493128	9	55	8	12	46	0.2608696
NODE_1438_length_1918_cov_3.493128	9	55	10	4	46	0.0869565
NODE_1438_length_1918_cov_3.493128	1480	1561	0	81	81	1.0000000
NODE_1440_length_1916_cov_4.426527	162	192	4	30	30	1.0000000
NODE_1442_length_1915_cov_35.787996	106	186	20	5	80	0.0625000
NODE_1442_length_1915_cov_35.787996	106	186	22	3	80	0.0375000
NODE_1442_length_1915_cov_35.787996	106	186	24	3	80	0.0375000
NODE_1442_length_1915_cov_35.787996	106	186	26	3	80	0.0375000
NODE_1442_length_1915_cov_35.787996	106	186	28	1	80	0.0125000
NODE_1442_length_1915_cov_35.787996	106	186	32	1	80	0.0125000
NODE_1442_length_1915_cov_35.787996	106	186	34	2	80	0.0250000
NODE_1442_length_1915_cov_35.787996	106	186	45	1	80	0.0125000
NODE_1442_length_1915_cov_35.787996	106	186	47	1	80	0.0125000
NODE_1442_length_1915_cov_35.787996	106	186	57	3	80	0.0375000
NODE_1442_length_1915_cov_35.787996	106	186	66	11	80	0.1375000
NODE_1442_length_1915_cov_35.787996	106	186	69	5	80	0.0625000
NODE_1442_length_1915_cov_35.787996	106	186	71	3	80	0.0375000
NODE_1442_length_1915_cov_35.787996	106	186	74	1	80	0.0125000
NODE_1442_length_1915_cov_35.787996	106	186	76	4	80	0.0500000
NODE_1442_length_1915_cov_35.787996	106	186	80	1	80	0.0125000
NODE_1442_length_1915_cov_35.787996	106	186	82	2	80	0.0250000
NODE_1442_length_1915_cov_35.787996	106	186	84	2	80	0.0250000
NODE_1442_length_1915_cov_35.787996	106	186	88	2	80	0.0250000
NODE_1442_length_1915_cov_35.787996	106	186	90	1	80	0.0125000
NODE_1442_length_1915_cov_35.787996	106	186	92	10	80	0.1250000
NODE_1442_length_1915_cov_35.787996	106	186	96	5	80	0.0625000
NODE_1442_length_1915_cov_35.787996	106	186	98	1	80	0.0125000
NODE_1442_length_1915_cov_35.787996	106	186	100	8	80	0.1000000
NODE_1442_length_1915_cov_35.787996	106	186	102	1	80	0.0125000
NODE_1451_length_1905_cov_18.464563	740	820	0	16	80	0.2000000
NODE_1451_length_1905_cov_18.464563	740	820	2	64	80	0.8000000
NODE_1451_length_1905_cov_18.464563	793	873	2	80	80	1.0000000
NODE_1451_length_1905_cov_18.464563	869	949	0	5	80	0.0625000
NODE_1451_length_1905_cov_18.464563	869	949	2	75	80	0.9375000
NODE_1451_length_1905_cov_18.464563	922	1010	0	34	88	0.3863636
NODE_1451_length_1905_cov_18.464563	922	1010	2	54	88	0.6136364
NODE_1452_length_1905_cov_7.197121	596	676	0	80	80	1.0000000
NODE_1452_length_1905_cov_7.197121	649	682	0	33	33	1.0000000
NODE_1455_length_1902_cov_1.633943	1728	1792	24	2	64	0.0312500
NODE_1455_length_1902_cov_1.633943	1728	1792	26	2	64	0.0312500
NODE_1455_length_1902_cov_1.633943	1728	1792	30	4	64	0.0625000
NODE_1455_length_1902_cov_1.633943	1728	1792	32	1	64	0.0156250
NODE_1455_length_1902_cov_1.633943	1728	1792	34	2	64	0.0312500
NODE_1455_length_1902_cov_1.633943	1728	1792	38	1	64	0.0156250
NODE_1455_length_1902_cov_1.633943	1728	1792	40	5	64	0.0781250
NODE_1455_length_1902_cov_1.633943	1728	1792	48	3	64	0.0468750
NODE_1455_length_1902_cov_1.633943	1728	1792	50	1	64	0.0156250
NODE_1455_length_1902_cov_1.633943	1728	1792	52	5	64	0.0781250
NODE_1455_length_1902_cov_1.633943	1728	1792	54	16	64	0.2500000
NODE_1455_length_1902_cov_1.633943	1728	1792	58	2	64	0.0312500
NODE_1455_length_1902_cov_1.633943	1728	1792	60	4	64	0.0625000
NODE_1455_length_1902_cov_1.633943	1728	1792	62	5	64	0.0781250
NODE_1455_length_1902_cov_1.633943	1728	1792	66	1	64	0.0156250
NODE_1455_length_1902_cov_1.633943	1728	1792	70	2	64	0.0312500
NODE_1455_length_1902_cov_1.633943	1728	1792	71	1	64	0.0156250
NODE_1455_length_1902_cov_1.633943	1728	1792	72	4	64	0.0625000
NODE_1455_length_1902_cov_1.633943	1728	1792	74	3	64	0.0468750
NODE_1458_length_1900_cov_1.081066	1805	1851	0	46	46	1.0000000
NODE_1458_length_1900_cov_1.081066	1824	1900	0	76	76	1.0000000
NODE_1461_length_1895_cov_17.940980	1070	1150	21	4	80	0.0500000
NODE_1461_length_1895_cov_17.940980	1070	1150	27	6	80	0.0750000
NODE_1461_length_1895_cov_17.940980	1070	1150	29	16	80	0.2000000
NODE_1461_length_1895_cov_17.940980	1070	1150	31	20	80	0.2500000
NODE_1461_length_1895_cov_17.940980	1070	1150	32	2	80	0.0250000
NODE_1461_length_1895_cov_17.940980	1070	1150	33	22	80	0.2750000
NODE_1461_length_1895_cov_17.940980	1070	1150	34	1	80	0.0125000
NODE_1461_length_1895_cov_17.940980	1070	1150	35	5	80	0.0625000
NODE_1461_length_1895_cov_17.940980	1070	1150	37	4	80	0.0500000
NODE_1461_length_1895_cov_17.940980	1123	1203	24	2	80	0.0250000
NODE_1461_length_1895_cov_17.940980	1123	1203	28	3	80	0.0375000
NODE_1461_length_1895_cov_17.940980	1123	1203	30	1	80	0.0125000
NODE_1461_length_1895_cov_17.940980	1123	1203	31	1	80	0.0125000
NODE_1461_length_1895_cov_17.940980	1123	1203	32	16	80	0.2000000
NODE_1461_length_1895_cov_17.940980	1123	1203	33	19	80	0.2375000
NODE_1461_length_1895_cov_17.940980	1123	1203	34	1	80	0.0125000
NODE_1461_length_1895_cov_17.940980	1123	1203	35	5	80	0.0625000
NODE_1461_length_1895_cov_17.940980	1123	1203	37	7	80	0.0875000
NODE_1461_length_1895_cov_17.940980	1123	1203	38	25	80	0.3125000
NODE_1466_length_1893_cov_3.299331	918	998	5	28	80	0.3500000
NODE_1466_length_1893_cov_3.299331	918	998	6	15	80	0.1875000
NODE_1466_length_1893_cov_3.299331	918	998	7	8	80	0.1000000
NODE_1466_length_1893_cov_3.299331	918	998	9	8	80	0.1000000
NODE_1466_length_1893_cov_3.299331	918	998	11	1	80	0.0125000
NODE_1466_length_1893_cov_3.299331	918	998	15	20	80	0.2500000
NODE_1467_length_1892_cov_5.158394	317	397	0	80	80	1.0000000
NODE_1467_length_1892_cov_5.158394	370	445	0	75	75	1.0000000
NODE_1469_length_1889_cov_4.049162	1652	1686	2	19	34	0.5588235
NODE_1469_length_1889_cov_4.049162	1652	1686	4	15	34	0.4411765
NODE_1470_length_1889_cov_3.888268	960	1040	4	80	80	1.0000000
NODE_1470_length_1889_cov_3.888268	1013	1093	0	33	80	0.4125000
NODE_1470_length_1889_cov_3.888268	1013	1093	4	47	80	0.5875000
NODE_1472_length_1888_cov_17.106764	15	96	27	4	81	0.0493827
NODE_1472_length_1888_cov_17.106764	15	96	37	2	81	0.0246914
NODE_1472_length_1888_cov_17.106764	15	96	39	1	81	0.0123457
NODE_1472_length_1888_cov_17.106764	15	96	45	1	81	0.0123457
NODE_1472_length_1888_cov_17.106764	15	96	49	1	81	0.0123457
NODE_1472_length_1888_cov_17.106764	15	96	52	1	81	0.0123457
NODE_1472_length_1888_cov_17.106764	15	96	55	1	81	0.0123457
NODE_1472_length_1888_cov_17.106764	15	96	58	1	81	0.0123457
NODE_1472_length_1888_cov_17.106764	15	96	60	1	81	0.0123457
NODE_1472_length_1888_cov_17.106764	15	96	64	22	81	0.2716049
NODE_1472_length_1888_cov_17.106764	15	96	65	9	81	0.1111111
NODE_1472_length_1888_cov_17.106764	15	96	66	3	81	0.0370370
NODE_1472_length_1888_cov_17.106764	15	96	68	24	81	0.2962963
NODE_1472_length_1888_cov_17.106764	15	96	69	1	81	0.0123457
NODE_1472_length_1888_cov_17.106764	15	96	70	6	81	0.0740741
NODE_1472_length_1888_cov_17.106764	15	96	72	3	81	0.0370370
NODE_1472_length_1888_cov_17.106764	68	143	19	4	75	0.0533333
NODE_1472_length_1888_cov_17.106764	68	143	21	6	75	0.0800000
NODE_1472_length_1888_cov_17.106764	68	143	25	1	75	0.0133333
NODE_1472_length_1888_cov_17.106764	68	143	27	1	75	0.0133333
NODE_1472_length_1888_cov_17.106764	68	143	31	1	75	0.0133333
NODE_1472_length_1888_cov_17.106764	68	143	33	1	75	0.0133333
NODE_1472_length_1888_cov_17.106764	68	143	35	1	75	0.0133333
NODE_1472_length_1888_cov_17.106764	68	143	39	1	75	0.0133333
NODE_1472_length_1888_cov_17.106764	68	143	43	3	75	0.0400000
NODE_1472_length_1888_cov_17.106764	68	143	45	3	75	0.0400000
NODE_1472_length_1888_cov_17.106764	68	143	47	2	75	0.0266667
NODE_1472_length_1888_cov_17.106764	68	143	49	2	75	0.0266667
NODE_1472_length_1888_cov_17.106764	68	143	50	1	75	0.0133333
NODE_1472_length_1888_cov_17.106764	68	143	52	2	75	0.0266667
NODE_1472_length_1888_cov_17.106764	68	143	56	1	75	0.0133333
NODE_1472_length_1888_cov_17.106764	68	143	58	1	75	0.0133333
NODE_1472_length_1888_cov_17.106764	68	143	64	1	75	0.0133333
NODE_1472_length_1888_cov_17.106764	68	143	66	1	75	0.0133333
NODE_1472_length_1888_cov_17.106764	68	143	68	18	75	0.2400000
NODE_1472_length_1888_cov_17.106764	68	143	69	1	75	0.0133333
NODE_1472_length_1888_cov_17.106764	68	143	70	7	75	0.0933333
NODE_1472_length_1888_cov_17.106764	68	143	72	16	75	0.2133333
NODE_1477_length_1885_cov_4.439530	441	521	0	50	80	0.6250000
NODE_1477_length_1885_cov_4.439530	441	521	2	30	80	0.3750000
NODE_1477_length_1885_cov_4.439530	494	574	0	80	80	1.0000000
NODE_1483_length_1882_cov_5.884464	1499	1579	2	16	80	0.2000000
NODE_1483_length_1882_cov_5.884464	1499	1579	4	38	80	0.4750000
NODE_1483_length_1882_cov_5.884464	1499	1579	6	26	80	0.3250000
NODE_1483_length_1882_cov_5.884464	1552	1632	2	1	80	0.0125000
NODE_1483_length_1882_cov_5.884464	1552	1632	4	14	80	0.1750000
NODE_1483_length_1882_cov_5.884464	1552	1632	6	65	80	0.8125000
NODE_1493_length_1875_cov_3.974662	1650	1730	12	7	80	0.0875000
NODE_1493_length_1875_cov_3.974662	1650	1730	14	18	80	0.2250000
NODE_1493_length_1875_cov_3.974662	1650	1730	16	12	80	0.1500000
NODE_1493_length_1875_cov_3.974662	1650	1730	18	11	80	0.1375000
NODE_1493_length_1875_cov_3.974662	1650	1730	19	5	80	0.0625000
NODE_1493_length_1875_cov_3.974662	1650	1730	20	1	80	0.0125000
NODE_1493_length_1875_cov_3.974662	1650	1730	22	25	80	0.3125000
NODE_1493_length_1875_cov_3.974662	1650	1730	24	1	80	0.0125000
NODE_1497_length_1872_cov_21.355330	153	201	0	48	48	1.0000000
NODE_1503_length_1868_cov_96.046919	1018	1098	2	4	80	0.0500000
NODE_1503_length_1868_cov_96.046919	1018	1098	4	24	80	0.3000000
NODE_1503_length_1868_cov_96.046919	1018	1098	6	1	80	0.0125000
NODE_1503_length_1868_cov_96.046919	1018	1098	10	3	80	0.0375000
NODE_1503_length_1868_cov_96.046919	1018	1098	18	8	80	0.1000000
NODE_1503_length_1868_cov_96.046919	1018	1098	28	4	80	0.0500000
NODE_1503_length_1868_cov_96.046919	1018	1098	34	8	80	0.1000000
NODE_1503_length_1868_cov_96.046919	1018	1098	38	4	80	0.0500000
NODE_1503_length_1868_cov_96.046919	1018	1098	40	13	80	0.1625000
NODE_1503_length_1868_cov_96.046919	1018	1098	46	11	80	0.1375000
NODE_1503_length_1868_cov_96.046919	1071	1151	30	3	80	0.0375000
NODE_1503_length_1868_cov_96.046919	1071	1151	38	6	80	0.0750000
NODE_1503_length_1868_cov_96.046919	1071	1151	40	34	80	0.4250000
NODE_1503_length_1868_cov_96.046919	1071	1151	44	2	80	0.0250000
NODE_1503_length_1868_cov_96.046919	1071	1151	46	21	80	0.2625000
NODE_1503_length_1868_cov_96.046919	1071	1151	48	14	80	0.1750000
NODE_1508_length_1866_cov_53.869270	1149	1229	0	80	80	1.0000000
NODE_1508_length_1866_cov_53.869270	1202	1282	0	80	80	1.0000000
NODE_1508_length_1866_cov_53.869270	1278	1358	0	80	80	1.0000000
NODE_1508_length_1866_cov_53.869270	1331	1411	0	34	80	0.4250000
NODE_1508_length_1866_cov_53.869270	1331	1411	2	46	80	0.5750000
NODE_1510_length_1866_cov_3.347482	888	966	0	78	78	1.0000000
NODE_1510_length_1866_cov_3.347482	939	1019	0	80	80	1.0000000
NODE_1513_length_1863_cov_11.265306	698	778	0	15	80	0.1875000
NODE_1513_length_1863_cov_11.265306	698	778	2	65	80	0.8125000
NODE_1513_length_1863_cov_11.265306	751	831	0	68	80	0.8500000
NODE_1513_length_1863_cov_11.265306	751	831	2	12	80	0.1500000
NODE_1518_length_1858_cov_19.019329	23	85	2	62	62	1.0000000
NODE_1518_length_1858_cov_19.019329	1125	1205	0	80	80	1.0000000
NODE_1518_length_1858_cov_19.019329	1178	1256	0	62	78	0.7948718
NODE_1518_length_1858_cov_19.019329	1178	1256	2	16	78	0.2051282
NODE_1518_length_1858_cov_19.019329	1387	1464	0	17	77	0.2207792
NODE_1518_length_1858_cov_19.019329	1387	1464	2	60	77	0.7792208
NODE_1518_length_1858_cov_19.019329	1440	1503	0	11	63	0.1746032
NODE_1518_length_1858_cov_19.019329	1440	1503	2	52	63	0.8253968
NODE_1519_length_1857_cov_18.402730	1282	1348	0	66	66	1.0000000
NODE_1519_length_1857_cov_18.402730	1321	1401	0	80	80	1.0000000
NODE_1519_length_1857_cov_18.402730	1397	1477	0	80	80	1.0000000
NODE_1519_length_1857_cov_18.402730	1450	1530	0	77	80	0.9625000
NODE_1519_length_1857_cov_18.402730	1450	1530	2	3	80	0.0375000
NODE_1531_length_1845_cov_12.653494	473	553	2	16	80	0.2000000
NODE_1531_length_1845_cov_12.653494	473	553	4	33	80	0.4125000
NODE_1531_length_1845_cov_12.653494	473	553	6	6	80	0.0750000
NODE_1531_length_1845_cov_12.653494	473	553	8	25	80	0.3125000
NODE_1531_length_1845_cov_12.653494	526	606	4	5	80	0.0625000
NODE_1531_length_1845_cov_12.653494	526	606	6	32	80	0.4000000
NODE_1531_length_1845_cov_12.653494	526	606	8	43	80	0.5375000
NODE_1546_length_1833_cov_31.337947	810	888	4	59	78	0.7564102
NODE_1546_length_1833_cov_31.337947	810	888	6	19	78	0.2435897
NODE_1546_length_1833_cov_31.337947	861	941	0	3	80	0.0375000
NODE_1546_length_1833_cov_31.337947	861	941	2	12	80	0.1500000
NODE_1546_length_1833_cov_31.337947	861	941	4	8	80	0.1000000
NODE_1546_length_1833_cov_31.337947	861	941	6	57	80	0.7125000
NODE_1546_length_1833_cov_31.337947	937	1017	0	38	80	0.4750000
NODE_1546_length_1833_cov_31.337947	937	1017	2	14	80	0.1750000
NODE_1546_length_1833_cov_31.337947	937	1017	4	28	80	0.3500000
NODE_1546_length_1833_cov_31.337947	990	1070	2	9	80	0.1125000
NODE_1546_length_1833_cov_31.337947	990	1070	4	71	80	0.8875000
NODE_1550_length_1831_cov_3.065820	112	154	8	2	42	0.0476190
NODE_1550_length_1831_cov_3.065820	112	154	9	1	42	0.0238095
NODE_1550_length_1831_cov_3.065820	112	154	10	4	42	0.0952381
NODE_1550_length_1831_cov_3.065820	112	154	11	1	42	0.0238095
NODE_1550_length_1831_cov_3.065820	112	154	12	3	42	0.0714286
NODE_1550_length_1831_cov_3.065820	112	154	16	1	42	0.0238095
NODE_1550_length_1831_cov_3.065820	112	154	18	7	42	0.1666667
NODE_1550_length_1831_cov_3.065820	112	154	24	3	42	0.0714286
NODE_1550_length_1831_cov_3.065820	112	154	26	2	42	0.0476190
NODE_1550_length_1831_cov_3.065820	112	154	34	5	42	0.1190476
NODE_1550_length_1831_cov_3.065820	112	154	36	3	42	0.0714286
NODE_1550_length_1831_cov_3.065820	112	154	38	2	42	0.0476190
NODE_1550_length_1831_cov_3.065820	112	154	42	1	42	0.0238095
NODE_1550_length_1831_cov_3.065820	112	154	44	1	42	0.0238095
NODE_1550_length_1831_cov_3.065820	112	154	46	2	42	0.0476190
NODE_1550_length_1831_cov_3.065820	112	154	48	3	42	0.0714286
NODE_1550_length_1831_cov_3.065820	112	154	50	1	42	0.0238095
NODE_1553_length_1830_cov_2.512998	123	203	0	80	80	1.0000000
NODE_1553_length_1830_cov_2.512998	176	256	0	80	80	1.0000000
NODE_1553_length_1830_cov_2.512998	308	357	0	10	49	0.2040816
NODE_1553_length_1830_cov_2.512998	308	357	2	26	49	0.5306122
NODE_1553_length_1830_cov_2.512998	308	357	4	12	49	0.2448980
NODE_1553_length_1830_cov_2.512998	308	357	6	1	49	0.0204082
NODE_1554_length_1828_cov_40.437825	789	869	8	2	80	0.0250000
NODE_1554_length_1828_cov_40.437825	789	869	10	21	80	0.2625000
NODE_1554_length_1828_cov_40.437825	789	869	12	57	80	0.7125000
NODE_1554_length_1828_cov_40.437825	842	922	0	3	80	0.0375000
NODE_1554_length_1828_cov_40.437825	842	922	2	11	80	0.1375000
NODE_1554_length_1828_cov_40.437825	842	922	10	40	80	0.5000000
NODE_1554_length_1828_cov_40.437825	842	922	12	26	80	0.3250000
NODE_1554_length_1828_cov_40.437825	918	998	0	17	80	0.2125000
NODE_1554_length_1828_cov_40.437825	918	998	2	6	80	0.0750000
NODE_1554_length_1828_cov_40.437825	918	998	4	2	80	0.0250000
NODE_1554_length_1828_cov_40.437825	918	998	6	22	80	0.2750000
NODE_1554_length_1828_cov_40.437825	918	998	8	5	80	0.0625000
NODE_1554_length_1828_cov_40.437825	918	998	10	28	80	0.3500000
NODE_1554_length_1828_cov_40.437825	971	1051	6	5	80	0.0625000
NODE_1554_length_1828_cov_40.437825	971	1051	10	44	80	0.5500000
NODE_1554_length_1828_cov_40.437825	971	1051	12	16	80	0.2000000
NODE_1554_length_1828_cov_40.437825	971	1051	14	10	80	0.1250000
NODE_1554_length_1828_cov_40.437825	971	1051	16	5	80	0.0625000
NODE_1559_length_1825_cov_6.652955	641	689	0	15	48	0.3125000
NODE_1559_length_1825_cov_6.652955	641	689	2	14	48	0.2916667
NODE_1559_length_1825_cov_6.652955	641	689	4	1	48	0.0208333
NODE_1559_length_1825_cov_6.652955	641	689	8	17	48	0.3541667
NODE_1559_length_1825_cov_6.652955	641	689	10	1	48	0.0208333
NODE_1559_length_1825_cov_6.652955	694	744	18	50	50	1.0000000
NODE_1562_length_1824_cov_10.152464	685	765	4	2	80	0.0250000
NODE_1562_length_1824_cov_10.152464	685	765	6	8	80	0.1000000
NODE_1562_length_1824_cov_10.152464	685	765	11	24	80	0.3000000
NODE_1562_length_1824_cov_10.152464	685	765	14	6	80	0.0750000
NODE_1562_length_1824_cov_10.152464	685	765	15	35	80	0.4375000
NODE_1562_length_1824_cov_10.152464	685	765	17	4	80	0.0500000
NODE_1562_length_1824_cov_10.152464	685	765	18	1	80	0.0125000
NODE_1562_length_1824_cov_10.152464	738	818	12	7	80	0.0875000
NODE_1562_length_1824_cov_10.152464	738	818	13	3	80	0.0375000
NODE_1562_length_1824_cov_10.152464	738	818	14	48	80	0.6000000
NODE_1562_length_1824_cov_10.152464	738	818	15	16	80	0.2000000
NODE_1562_length_1824_cov_10.152464	738	818	16	1	80	0.0125000
NODE_1562_length_1824_cov_10.152464	738	818	17	4	80	0.0500000
NODE_1562_length_1824_cov_10.152464	738	818	18	1	80	0.0125000
NODE_1562_length_1824_cov_10.152464	1412	1433	4	21	21	1.0000000
NODE_1564_length_1821_cov_7.682346	953	1033	0	80	80	1.0000000
NODE_1564_length_1821_cov_7.682346	1006	1086	0	44	80	0.5500000
NODE_1564_length_1821_cov_7.682346	1006	1086	2	36	80	0.4500000
NODE_1566_length_1820_cov_12.061592	477	557	0	51	80	0.6375000
NODE_1566_length_1820_cov_12.061592	477	557	3	28	80	0.3500000
NODE_1566_length_1820_cov_12.061592	477	557	7	1	80	0.0125000
NODE_1566_length_1820_cov_12.061592	530	610	3	26	80	0.3250000
NODE_1566_length_1820_cov_12.061592	530	610	7	46	80	0.5750000
NODE_1566_length_1820_cov_12.061592	530	610	8	8	80	0.1000000
NODE_1566_length_1820_cov_12.061592	1232	1312	2	42	80	0.5250000
NODE_1566_length_1820_cov_12.061592	1232	1312	4	38	80	0.4750000
NODE_1566_length_1820_cov_12.061592	1285	1365	0	14	80	0.1750000
NODE_1566_length_1820_cov_12.061592	1285	1365	2	52	80	0.6500000
NODE_1566_length_1820_cov_12.061592	1285	1365	4	14	80	0.1750000
NODE_1572_length_1817_cov_8.302095	63	122	0	38	59	0.6440678
NODE_1572_length_1817_cov_8.302095	63	122	4	21	59	0.3559322
NODE_1572_length_1817_cov_8.302095	1195	1275	0	17	80	0.2125000
NODE_1572_length_1817_cov_8.302095	1195	1275	2	63	80	0.7875000
NODE_1572_length_1817_cov_8.302095	1248	1328	0	49	80	0.6125000
NODE_1572_length_1817_cov_8.302095	1248	1328	2	31	80	0.3875000
NODE_1573_length_1816_cov_25.489225	1059	1139	0	80	80	1.0000000
NODE_1573_length_1816_cov_25.489225	1112	1192	0	80	80	1.0000000
NODE_1578_length_1812_cov_11.453006	398	427	0	29	29	1.0000000
NODE_1578_length_1812_cov_11.453006	400	480	0	80	80	1.0000000
NODE_1586_length_1807_cov_3.977752	1743	1807	0	64	64	1.0000000
NODE_1590_length_1806_cov_2.681312	1461	1541	0	6	80	0.0750000
NODE_1590_length_1806_cov_2.681312	1461	1541	2	7	80	0.0875000
NODE_1590_length_1806_cov_2.681312	1461	1541	5	3	80	0.0375000
NODE_1590_length_1806_cov_2.681312	1461	1541	7	2	80	0.0250000
NODE_1590_length_1806_cov_2.681312	1461	1541	11	2	80	0.0250000
NODE_1590_length_1806_cov_2.681312	1461	1541	13	1	80	0.0125000
NODE_1590_length_1806_cov_2.681312	1461	1541	17	1	80	0.0125000
NODE_1590_length_1806_cov_2.681312	1461	1541	18	5	80	0.0625000
NODE_1590_length_1806_cov_2.681312	1461	1541	19	7	80	0.0875000
NODE_1590_length_1806_cov_2.681312	1461	1541	23	1	80	0.0125000
NODE_1590_length_1806_cov_2.681312	1461	1541	24	1	80	0.0125000
NODE_1590_length_1806_cov_2.681312	1461	1541	25	1	80	0.0125000
NODE_1590_length_1806_cov_2.681312	1461	1541	27	1	80	0.0125000
NODE_1590_length_1806_cov_2.681312	1461	1541	28	2	80	0.0250000
NODE_1590_length_1806_cov_2.681312	1461	1541	31	2	80	0.0250000
NODE_1590_length_1806_cov_2.681312	1461	1541	33	5	80	0.0625000
NODE_1590_length_1806_cov_2.681312	1461	1541	35	5	80	0.0625000
NODE_1590_length_1806_cov_2.681312	1461	1541	37	3	80	0.0375000
NODE_1590_length_1806_cov_2.681312	1461	1541	39	3	80	0.0375000
NODE_1590_length_1806_cov_2.681312	1461	1541	41	5	80	0.0625000
NODE_1590_length_1806_cov_2.681312	1461	1541	43	7	80	0.0875000
NODE_1590_length_1806_cov_2.681312	1461	1541	45	7	80	0.0875000
NODE_1590_length_1806_cov_2.681312	1461	1541	47	1	80	0.0125000
NODE_1590_length_1806_cov_2.681312	1461	1541	57	2	80	0.0250000
NODE_1590_length_1806_cov_2.681312	1517	1594	0	59	77	0.7662337
NODE_1590_length_1806_cov_2.681312	1517	1594	2	7	77	0.0909091
NODE_1590_length_1806_cov_2.681312	1517	1594	5	3	77	0.0389610
NODE_1590_length_1806_cov_2.681312	1517	1594	7	2	77	0.0259740
NODE_1590_length_1806_cov_2.681312	1517	1594	11	2	77	0.0259740
NODE_1590_length_1806_cov_2.681312	1517	1594	13	1	77	0.0129870
NODE_1590_length_1806_cov_2.681312	1517	1594	17	1	77	0.0129870
NODE_1590_length_1806_cov_2.681312	1517	1594	18	2	77	0.0259740
NODE_1593_length_1805_cov_10.271395	258	329	0	11	71	0.1549296
NODE_1593_length_1805_cov_10.271395	258	329	2	6	71	0.0845070
NODE_1593_length_1805_cov_10.271395	258	329	6	54	71	0.7605634
NODE_1593_length_1805_cov_10.271395	311	391	0	27	80	0.3375000
NODE_1593_length_1805_cov_10.271395	311	391	4	30	80	0.3750000
NODE_1593_length_1805_cov_10.271395	311	391	6	23	80	0.2875000
NODE_1598_length_1802_cov_11.546682	1284	1364	0	80	80	1.0000000
NODE_1598_length_1802_cov_11.546682	1337	1417	0	80	80	1.0000000
NODE_1600_length_1801_cov_12.145711	85	165	21	6	80	0.0750000
NODE_1600_length_1801_cov_12.145711	85	165	23	17	80	0.2125000
NODE_1600_length_1801_cov_12.145711	85	165	25	1	80	0.0125000
NODE_1600_length_1801_cov_12.145711	85	165	29	2	80	0.0250000
NODE_1600_length_1801_cov_12.145711	85	165	31	2	80	0.0250000
NODE_1600_length_1801_cov_12.145711	85	165	33	4	80	0.0500000
NODE_1600_length_1801_cov_12.145711	85	165	38	2	80	0.0250000
NODE_1600_length_1801_cov_12.145711	85	165	39	3	80	0.0375000
NODE_1600_length_1801_cov_12.145711	85	165	41	5	80	0.0625000
NODE_1600_length_1801_cov_12.145711	85	165	42	17	80	0.2125000
NODE_1600_length_1801_cov_12.145711	85	165	43	21	80	0.2625000
NODE_1600_length_1801_cov_12.145711	138	218	8	2	80	0.0250000
NODE_1600_length_1801_cov_12.145711	138	218	10	3	80	0.0375000
NODE_1600_length_1801_cov_12.145711	138	218	13	3	80	0.0375000
NODE_1600_length_1801_cov_12.145711	138	218	19	2	80	0.0250000
NODE_1600_length_1801_cov_12.145711	138	218	23	2	80	0.0250000
NODE_1600_length_1801_cov_12.145711	138	218	25	9	80	0.1125000
NODE_1600_length_1801_cov_12.145711	138	218	27	3	80	0.0375000
NODE_1600_length_1801_cov_12.145711	138	218	31	5	80	0.0625000
NODE_1600_length_1801_cov_12.145711	138	218	32	2	80	0.0250000
NODE_1600_length_1801_cov_12.145711	138	218	36	4	80	0.0500000
NODE_1600_length_1801_cov_12.145711	138	218	38	20	80	0.2500000
NODE_1600_length_1801_cov_12.145711	138	218	42	17	80	0.2125000
NODE_1600_length_1801_cov_12.145711	138	218	43	8	80	0.1000000
NODE_1601_length_1801_cov_9.793184	1010	1090	10	12	80	0.1500000
NODE_1601_length_1801_cov_9.793184	1010	1090	12	17	80	0.2125000
NODE_1601_length_1801_cov_9.793184	1010	1090	14	41	80	0.5125000
NODE_1601_length_1801_cov_9.793184	1010	1090	16	10	80	0.1250000
NODE_1601_length_1801_cov_9.793184	1063	1143	2	7	80	0.0875000
NODE_1601_length_1801_cov_9.793184	1063	1143	6	43	80	0.5375000
NODE_1601_length_1801_cov_9.793184	1063	1143	7	2	80	0.0250000
NODE_1601_length_1801_cov_9.793184	1063	1143	8	1	80	0.0125000
NODE_1601_length_1801_cov_9.793184	1063	1143	10	12	80	0.1500000
NODE_1601_length_1801_cov_9.793184	1063	1143	12	14	80	0.1750000
NODE_1601_length_1801_cov_9.793184	1063	1143	14	1	80	0.0125000
NODE_1604_length_1800_cov_15.074662	695	775	0	80	80	1.0000000
NODE_1604_length_1800_cov_15.074662	755	826	0	71	71	1.0000000
NODE_1605_length_1800_cov_7.281599	10	74	36	1	64	0.0156250
NODE_1605_length_1800_cov_7.281599	10	74	63	1	64	0.0156250
NODE_1605_length_1800_cov_7.281599	10	74	64	4	64	0.0625000
NODE_1605_length_1800_cov_7.281599	10	74	66	4	64	0.0625000
NODE_1605_length_1800_cov_7.281599	10	74	70	11	64	0.1718750
NODE_1605_length_1800_cov_7.281599	10	74	72	3	64	0.0468750
NODE_1605_length_1800_cov_7.281599	10	74	74	1	64	0.0156250
NODE_1605_length_1800_cov_7.281599	10	74	76	4	64	0.0625000
NODE_1605_length_1800_cov_7.281599	10	74	78	1	64	0.0156250
NODE_1605_length_1800_cov_7.281599	10	74	83	1	64	0.0156250
NODE_1605_length_1800_cov_7.281599	10	74	86	7	64	0.1093750
NODE_1605_length_1800_cov_7.281599	10	74	94	9	64	0.1406250
NODE_1605_length_1800_cov_7.281599	10	74	95	1	64	0.0156250
NODE_1605_length_1800_cov_7.281599	10	74	96	4	64	0.0625000
NODE_1605_length_1800_cov_7.281599	10	74	107	4	64	0.0625000
NODE_1605_length_1800_cov_7.281599	10	74	109	2	64	0.0312500
NODE_1605_length_1800_cov_7.281599	10	74	115	3	64	0.0468750
NODE_1605_length_1800_cov_7.281599	10	74	116	3	64	0.0468750
NODE_1605_length_1800_cov_7.281599	10	74	36	1	64	0.0156250
NODE_1605_length_1800_cov_7.281599	10	74	63	1	64	0.0156250
NODE_1605_length_1800_cov_7.281599	10	74	64	4	64	0.0625000
NODE_1605_length_1800_cov_7.281599	10	74	66	4	64	0.0625000
NODE_1605_length_1800_cov_7.281599	10	74	70	11	64	0.1718750
NODE_1605_length_1800_cov_7.281599	10	74	72	3	64	0.0468750
NODE_1605_length_1800_cov_7.281599	10	74	74	1	64	0.0156250
NODE_1605_length_1800_cov_7.281599	10	74	76	4	64	0.0625000
NODE_1605_length_1800_cov_7.281599	10	74	78	1	64	0.0156250
NODE_1605_length_1800_cov_7.281599	10	74	83	1	64	0.0156250
NODE_1605_length_1800_cov_7.281599	10	74	86	7	64	0.1093750
NODE_1605_length_1800_cov_7.281599	10	74	94	9	64	0.1406250
NODE_1605_length_1800_cov_7.281599	10	74	95	1	64	0.0156250
NODE_1605_length_1800_cov_7.281599	10	74	96	4	64	0.0625000
NODE_1605_length_1800_cov_7.281599	10	74	107	4	64	0.0625000
NODE_1605_length_1800_cov_7.281599	10	74	109	2	64	0.0312500
NODE_1605_length_1800_cov_7.281599	10	74	115	3	64	0.0468750
NODE_1605_length_1800_cov_7.281599	10	74	116	3	64	0.0468750
NODE_1605_length_1800_cov_7.281599	10	74	36	1	64	0.0156250
NODE_1605_length_1800_cov_7.281599	10	74	63	1	64	0.0156250
NODE_1605_length_1800_cov_7.281599	10	74	64	4	64	0.0625000
NODE_1605_length_1800_cov_7.281599	10	74	66	4	64	0.0625000
NODE_1605_length_1800_cov_7.281599	10	74	70	11	64	0.1718750
NODE_1605_length_1800_cov_7.281599	10	74	72	3	64	0.0468750
NODE_1605_length_1800_cov_7.281599	10	74	74	1	64	0.0156250
NODE_1605_length_1800_cov_7.281599	10	74	76	4	64	0.0625000
NODE_1605_length_1800_cov_7.281599	10	74	78	1	64	0.0156250
NODE_1605_length_1800_cov_7.281599	10	74	83	1	64	0.0156250
NODE_1605_length_1800_cov_7.281599	10	74	86	7	64	0.1093750
NODE_1605_length_1800_cov_7.281599	10	74	94	9	64	0.1406250
NODE_1605_length_1800_cov_7.281599	10	74	95	1	64	0.0156250
NODE_1605_length_1800_cov_7.281599	10	74	96	4	64	0.0625000
NODE_1605_length_1800_cov_7.281599	10	74	107	4	64	0.0625000
NODE_1605_length_1800_cov_7.281599	10	74	109	2	64	0.0312500
NODE_1605_length_1800_cov_7.281599	10	74	115	3	64	0.0468750
NODE_1605_length_1800_cov_7.281599	10	74	116	3	64	0.0468750
NODE_1605_length_1800_cov_7.281599	47	127	86	1	80	0.0125000
NODE_1605_length_1800_cov_7.281599	47	127	91	2	80	0.0250000
NODE_1605_length_1800_cov_7.281599	47	127	94	9	80	0.1125000
NODE_1605_length_1800_cov_7.281599	47	127	95	1	80	0.0125000
NODE_1605_length_1800_cov_7.281599	47	127	96	4	80	0.0500000
NODE_1605_length_1800_cov_7.281599	47	127	100	2	80	0.0250000
NODE_1605_length_1800_cov_7.281599	47	127	107	6	80	0.0750000
NODE_1605_length_1800_cov_7.281599	47	127	108	3	80	0.0375000
NODE_1605_length_1800_cov_7.281599	47	127	109	2	80	0.0250000
NODE_1605_length_1800_cov_7.281599	47	127	110	4	80	0.0500000
NODE_1605_length_1800_cov_7.281599	47	127	112	8	80	0.1000000
NODE_1605_length_1800_cov_7.281599	47	127	115	3	80	0.0375000
NODE_1605_length_1800_cov_7.281599	47	127	116	8	80	0.1000000
NODE_1605_length_1800_cov_7.281599	47	127	118	1	80	0.0125000
NODE_1605_length_1800_cov_7.281599	47	127	120	5	80	0.0625000
NODE_1605_length_1800_cov_7.281599	47	127	125	3	80	0.0375000
NODE_1605_length_1800_cov_7.281599	47	127	127	1	80	0.0125000
NODE_1605_length_1800_cov_7.281599	47	127	128	1	80	0.0125000
NODE_1605_length_1800_cov_7.281599	47	127	129	11	80	0.1375000
NODE_1605_length_1800_cov_7.281599	47	127	130	5	80	0.0625000
NODE_1605_length_1800_cov_7.281599	63	126	91	1	63	0.0158730
NODE_1605_length_1800_cov_7.281599	63	126	100	2	63	0.0317460
NODE_1605_length_1800_cov_7.281599	63	126	107	5	63	0.0793651
NODE_1605_length_1800_cov_7.281599	63	126	108	3	63	0.0476190
NODE_1605_length_1800_cov_7.281599	63	126	109	2	63	0.0317460
NODE_1605_length_1800_cov_7.281599	63	126	110	4	63	0.0634921
NODE_1605_length_1800_cov_7.281599	63	126	112	8	63	0.1269841
NODE_1605_length_1800_cov_7.281599	63	126	115	3	63	0.0476190
NODE_1605_length_1800_cov_7.281599	63	126	116	8	63	0.1269841
NODE_1605_length_1800_cov_7.281599	63	126	118	1	63	0.0158730
NODE_1605_length_1800_cov_7.281599	63	126	120	5	63	0.0793651
NODE_1605_length_1800_cov_7.281599	63	126	125	3	63	0.0476190
NODE_1605_length_1800_cov_7.281599	63	126	127	1	63	0.0158730
NODE_1605_length_1800_cov_7.281599	63	126	128	1	63	0.0158730
NODE_1605_length_1800_cov_7.281599	63	126	129	11	63	0.1746032
NODE_1605_length_1800_cov_7.281599	63	126	130	5	63	0.0793651
NODE_1616_length_1793_cov_16.161157	539	619	0	39	80	0.4875000
NODE_1616_length_1793_cov_16.161157	539	619	4	41	80	0.5125000
NODE_1616_length_1793_cov_16.161157	592	672	0	11	80	0.1375000
NODE_1616_length_1793_cov_16.161157	592	672	4	69	80	0.8625000
NODE_1616_length_1793_cov_16.161157	1202	1281	0	15	79	0.1898734
NODE_1616_length_1793_cov_16.161157	1202	1281	2	64	79	0.8101266
NODE_1616_length_1793_cov_16.161157	1254	1335	0	55	81	0.6790124
NODE_1616_length_1793_cov_16.161157	1254	1335	2	26	81	0.3209876
NODE_1617_length_1793_cov_14.322904	521	601	0	80	80	1.0000000
NODE_1617_length_1793_cov_14.322904	574	654	0	80	80	1.0000000
NODE_1617_length_1793_cov_14.322904	1230	1310	0	7	80	0.0875000
NODE_1617_length_1793_cov_14.322904	1230	1310	4	4	80	0.0500000
NODE_1617_length_1793_cov_14.322904	1230	1310	8	1	80	0.0125000
NODE_1617_length_1793_cov_14.322904	1230	1310	9	9	80	0.1125000
NODE_1617_length_1793_cov_14.322904	1230	1310	15	26	80	0.3250000
NODE_1617_length_1793_cov_14.322904	1230	1310	16	33	80	0.4125000
NODE_1618_length_1791_cov_5.516548	1190	1261	0	23	71	0.3239437
NODE_1618_length_1791_cov_5.516548	1190	1261	4	48	71	0.6760563
NODE_1621_length_1790_cov_4.282082	684	764	0	56	80	0.7000000
NODE_1621_length_1790_cov_4.282082	684	764	2	13	80	0.1625000
NODE_1621_length_1790_cov_4.282082	684	764	6	11	80	0.1375000
NODE_1621_length_1790_cov_4.282082	737	817	0	3	80	0.0375000
NODE_1621_length_1790_cov_4.282082	737	817	2	13	80	0.1625000
NODE_1621_length_1790_cov_4.282082	737	817	6	64	80	0.8000000
NODE_1623_length_1788_cov_39.558911	385	465	0	80	80	1.0000000
NODE_1623_length_1788_cov_39.558911	438	518	0	80	80	1.0000000
NODE_1623_length_1788_cov_39.558911	514	594	0	80	80	1.0000000
NODE_1623_length_1788_cov_39.558911	567	647	0	80	80	1.0000000
NODE_1624_length_1787_cov_44.927133	530	610	58	5	80	0.0625000
NODE_1624_length_1787_cov_44.927133	530	610	60	3	80	0.0375000
NODE_1624_length_1787_cov_44.927133	530	610	62	6	80	0.0750000
NODE_1624_length_1787_cov_44.927133	530	610	63	9	80	0.1125000
NODE_1624_length_1787_cov_44.927133	530	610	64	8	80	0.1000000
NODE_1624_length_1787_cov_44.927133	530	610	65	3	80	0.0375000
NODE_1624_length_1787_cov_44.927133	530	610	66	2	80	0.0250000
NODE_1624_length_1787_cov_44.927133	530	610	72	1	80	0.0125000
NODE_1624_length_1787_cov_44.927133	530	610	76	3	80	0.0375000
NODE_1624_length_1787_cov_44.927133	530	610	78	6	80	0.0750000
NODE_1624_length_1787_cov_44.927133	530	610	79	7	80	0.0875000
NODE_1624_length_1787_cov_44.927133	530	610	80	13	80	0.1625000
NODE_1624_length_1787_cov_44.927133	530	610	81	1	80	0.0125000
NODE_1624_length_1787_cov_44.927133	530	610	82	2	80	0.0250000
NODE_1624_length_1787_cov_44.927133	530	610	83	5	80	0.0625000
NODE_1624_length_1787_cov_44.927133	530	610	85	6	80	0.0750000
NODE_1625_length_1787_cov_2.752370	675	755	2	53	80	0.6625000
NODE_1625_length_1787_cov_2.752370	675	755	4	27	80	0.3375000
NODE_1625_length_1787_cov_2.752370	728	806	2	60	78	0.7692308
NODE_1625_length_1787_cov_2.752370	728	806	4	18	78	0.2307692
NODE_1626_length_1786_cov_13.459395	523	603	2	23	80	0.2875000
NODE_1626_length_1786_cov_13.459395	523	603	4	36	80	0.4500000
NODE_1626_length_1786_cov_13.459395	523	603	7	2	80	0.0250000
NODE_1626_length_1786_cov_13.459395	523	603	8	17	80	0.2125000
NODE_1626_length_1786_cov_13.459395	523	603	9	1	80	0.0125000
NODE_1626_length_1786_cov_13.459395	523	603	10	1	80	0.0125000
NODE_1626_length_1786_cov_13.459395	576	656	4	6	80	0.0750000
NODE_1626_length_1786_cov_13.459395	576	656	6	13	80	0.1625000
NODE_1626_length_1786_cov_13.459395	576	656	7	2	80	0.0250000
NODE_1626_length_1786_cov_13.459395	576	656	8	57	80	0.7125000
NODE_1626_length_1786_cov_13.459395	576	656	9	1	80	0.0125000
NODE_1626_length_1786_cov_13.459395	576	656	10	1	80	0.0125000
NODE_1633_length_1784_cov_40.769733	358	438	0	22	80	0.2750000
NODE_1633_length_1784_cov_40.769733	358	438	6	32	80	0.4000000
NODE_1633_length_1784_cov_40.769733	358	438	8	26	80	0.3250000
NODE_1633_length_1784_cov_40.769733	411	491	2	4	80	0.0500000
NODE_1633_length_1784_cov_40.769733	411	491	6	1	80	0.0125000
NODE_1633_length_1784_cov_40.769733	411	491	7	3	80	0.0375000
NODE_1633_length_1784_cov_40.769733	411	491	8	72	80	0.9000000
NODE_1633_length_1784_cov_40.769733	1057	1137	0	80	80	1.0000000
NODE_1633_length_1784_cov_40.769733	1110	1190	0	80	80	1.0000000
NODE_1633_length_1784_cov_40.769733	1186	1266	0	80	80	1.0000000
NODE_1633_length_1784_cov_40.769733	1239	1319	0	80	80	1.0000000
NODE_1634_length_1784_cov_6.049258	1646	1725	0	10	79	0.1265823
NODE_1634_length_1784_cov_6.049258	1646	1725	2	69	79	0.8734177
NODE_1637_length_1783_cov_45.569477	600	680	0	70	80	0.8750000
NODE_1637_length_1783_cov_45.569477	600	680	2	10	80	0.1250000
NODE_1637_length_1783_cov_45.569477	653	733	0	17	80	0.2125000
NODE_1637_length_1783_cov_45.569477	653	733	2	48	80	0.6000000
NODE_1637_length_1783_cov_45.569477	653	733	3	15	80	0.1875000
NODE_1640_length_1780_cov_21.089233	361	441	0	80	80	1.0000000
NODE_1640_length_1780_cov_21.089233	414	494	0	80	80	1.0000000
NODE_1640_length_1780_cov_21.089233	1031	1104	12	13	73	0.1780822
NODE_1640_length_1780_cov_21.089233	1031	1104	14	5	73	0.0684932
NODE_1640_length_1780_cov_21.089233	1031	1104	18	2	73	0.0273973
NODE_1640_length_1780_cov_21.089233	1031	1104	20	1	73	0.0136986
NODE_1640_length_1780_cov_21.089233	1031	1104	21	5	73	0.0684932
NODE_1640_length_1780_cov_21.089233	1031	1104	23	5	73	0.0684932
NODE_1640_length_1780_cov_21.089233	1031	1104	24	4	73	0.0547945
NODE_1640_length_1780_cov_21.089233	1031	1104	31	2	73	0.0273973
NODE_1640_length_1780_cov_21.089233	1031	1104	34	1	73	0.0136986
NODE_1640_length_1780_cov_21.089233	1031	1104	35	1	73	0.0136986
NODE_1640_length_1780_cov_21.089233	1031	1104	38	6	73	0.0821918
NODE_1640_length_1780_cov_21.089233	1031	1104	40	1	73	0.0136986
NODE_1640_length_1780_cov_21.089233	1031	1104	44	7	73	0.0958904
NODE_1640_length_1780_cov_21.089233	1031	1104	48	4	73	0.0547945
NODE_1640_length_1780_cov_21.089233	1031	1104	51	1	73	0.0136986
NODE_1640_length_1780_cov_21.089233	1031	1104	53	3	73	0.0410959
NODE_1640_length_1780_cov_21.089233	1031	1104	63	1	73	0.0136986
NODE_1640_length_1780_cov_21.089233	1031	1104	65	1	73	0.0136986
NODE_1640_length_1780_cov_21.089233	1031	1104	68	1	73	0.0136986
NODE_1640_length_1780_cov_21.089233	1031	1104	70	4	73	0.0547945
NODE_1640_length_1780_cov_21.089233	1031	1104	75	2	73	0.0273973
NODE_1640_length_1780_cov_21.089233	1031	1104	79	1	73	0.0136986
NODE_1640_length_1780_cov_21.089233	1031	1104	81	2	73	0.0273973
NODE_1640_length_1780_cov_21.089233	1071	1112	38	5	41	0.1219512
NODE_1640_length_1780_cov_21.089233	1071	1112	40	1	41	0.0243902
NODE_1640_length_1780_cov_21.089233	1071	1112	44	7	41	0.1707317
NODE_1640_length_1780_cov_21.089233	1071	1112	48	4	41	0.0975610
NODE_1640_length_1780_cov_21.089233	1071	1112	51	1	41	0.0243902
NODE_1640_length_1780_cov_21.089233	1071	1112	53	3	41	0.0731707
NODE_1640_length_1780_cov_21.089233	1071	1112	63	1	41	0.0243902
NODE_1640_length_1780_cov_21.089233	1071	1112	65	1	41	0.0243902
NODE_1640_length_1780_cov_21.089233	1071	1112	68	1	41	0.0243902
NODE_1640_length_1780_cov_21.089233	1071	1112	70	4	41	0.0975610
NODE_1640_length_1780_cov_21.089233	1071	1112	75	2	41	0.0487805
NODE_1640_length_1780_cov_21.089233	1071	1112	79	1	41	0.0243902
NODE_1640_length_1780_cov_21.089233	1071	1112	81	2	41	0.0487805
NODE_1640_length_1780_cov_21.089233	1071	1112	82	4	41	0.0975610
NODE_1640_length_1780_cov_21.089233	1071	1112	84	4	41	0.0975610
NODE_1641_length_1780_cov_7.837597	1682	1747	0	65	65	1.0000000
NODE_1649_length_1778_cov_52.804050	1528	1568	10	1	40	0.0250000
NODE_1649_length_1778_cov_52.804050	1528	1568	22	3	40	0.0750000
NODE_1649_length_1778_cov_52.804050	1528	1568	23	1	40	0.0250000
NODE_1649_length_1778_cov_52.804050	1528	1568	32	3	40	0.0750000
NODE_1649_length_1778_cov_52.804050	1528	1568	36	2	40	0.0500000
NODE_1649_length_1778_cov_52.804050	1528	1568	37	5	40	0.1250000
NODE_1649_length_1778_cov_52.804050	1528	1568	53	2	40	0.0500000
NODE_1649_length_1778_cov_52.804050	1528	1568	57	1	40	0.0250000
NODE_1649_length_1778_cov_52.804050	1528	1568	60	1	40	0.0250000
NODE_1649_length_1778_cov_52.804050	1528	1568	74	2	40	0.0500000
NODE_1649_length_1778_cov_52.804050	1528	1568	76	2	40	0.0500000
NODE_1649_length_1778_cov_52.804050	1528	1568	77	2	40	0.0500000
NODE_1649_length_1778_cov_52.804050	1528	1568	78	4	40	0.1000000
NODE_1649_length_1778_cov_52.804050	1528	1568	80	1	40	0.0250000
NODE_1649_length_1778_cov_52.804050	1528	1568	81	4	40	0.1000000
NODE_1649_length_1778_cov_52.804050	1528	1568	93	6	40	0.1500000
NODE_1649_length_1778_cov_52.804050	1541	1621	37	2	80	0.0250000
NODE_1649_length_1778_cov_52.804050	1541	1621	53	2	80	0.0250000
NODE_1649_length_1778_cov_52.804050	1541	1621	57	1	80	0.0125000
NODE_1649_length_1778_cov_52.804050	1541	1621	60	1	80	0.0125000
NODE_1649_length_1778_cov_52.804050	1541	1621	74	2	80	0.0250000
NODE_1649_length_1778_cov_52.804050	1541	1621	76	2	80	0.0250000
NODE_1649_length_1778_cov_52.804050	1541	1621	77	2	80	0.0250000
NODE_1649_length_1778_cov_52.804050	1541	1621	78	4	80	0.0500000
NODE_1649_length_1778_cov_52.804050	1541	1621	80	1	80	0.0125000
NODE_1649_length_1778_cov_52.804050	1541	1621	81	4	80	0.0500000
NODE_1649_length_1778_cov_52.804050	1541	1621	93	7	80	0.0875000
NODE_1649_length_1778_cov_52.804050	1541	1621	95	4	80	0.0500000
NODE_1649_length_1778_cov_52.804050	1541	1621	103	22	80	0.2750000
NODE_1649_length_1778_cov_52.804050	1541	1621	106	18	80	0.2250000
NODE_1649_length_1778_cov_52.804050	1541	1621	111	1	80	0.0125000
NODE_1649_length_1778_cov_52.804050	1541	1621	112	7	80	0.0875000
NODE_1649_length_1778_cov_52.804050	1541	1621	37	2	80	0.0250000
NODE_1649_length_1778_cov_52.804050	1541	1621	53	2	80	0.0250000
NODE_1649_length_1778_cov_52.804050	1541	1621	57	1	80	0.0125000
NODE_1649_length_1778_cov_52.804050	1541	1621	60	1	80	0.0125000
NODE_1649_length_1778_cov_52.804050	1541	1621	74	2	80	0.0250000
NODE_1649_length_1778_cov_52.804050	1541	1621	76	2	80	0.0250000
NODE_1649_length_1778_cov_52.804050	1541	1621	77	2	80	0.0250000
NODE_1649_length_1778_cov_52.804050	1541	1621	78	4	80	0.0500000
NODE_1649_length_1778_cov_52.804050	1541	1621	80	1	80	0.0125000
NODE_1649_length_1778_cov_52.804050	1541	1621	81	4	80	0.0500000
NODE_1649_length_1778_cov_52.804050	1541	1621	93	7	80	0.0875000
NODE_1649_length_1778_cov_52.804050	1541	1621	95	4	80	0.0500000
NODE_1649_length_1778_cov_52.804050	1541	1621	103	22	80	0.2750000
NODE_1649_length_1778_cov_52.804050	1541	1621	106	18	80	0.2250000
NODE_1649_length_1778_cov_52.804050	1541	1621	111	1	80	0.0125000
NODE_1649_length_1778_cov_52.804050	1541	1621	112	7	80	0.0875000
NODE_1649_length_1778_cov_52.804050	1541	1621	37	2	80	0.0250000
NODE_1649_length_1778_cov_52.804050	1541	1621	53	2	80	0.0250000
NODE_1649_length_1778_cov_52.804050	1541	1621	57	1	80	0.0125000
NODE_1649_length_1778_cov_52.804050	1541	1621	60	1	80	0.0125000
NODE_1649_length_1778_cov_52.804050	1541	1621	74	2	80	0.0250000
NODE_1649_length_1778_cov_52.804050	1541	1621	76	2	80	0.0250000
NODE_1649_length_1778_cov_52.804050	1541	1621	77	2	80	0.0250000
NODE_1649_length_1778_cov_52.804050	1541	1621	78	4	80	0.0500000
NODE_1649_length_1778_cov_52.804050	1541	1621	80	1	80	0.0125000
NODE_1649_length_1778_cov_52.804050	1541	1621	81	4	80	0.0500000
NODE_1649_length_1778_cov_52.804050	1541	1621	93	7	80	0.0875000
NODE_1649_length_1778_cov_52.804050	1541	1621	95	4	80	0.0500000
NODE_1649_length_1778_cov_52.804050	1541	1621	103	22	80	0.2750000
NODE_1649_length_1778_cov_52.804050	1541	1621	106	18	80	0.2250000
NODE_1649_length_1778_cov_52.804050	1541	1621	111	1	80	0.0125000
NODE_1649_length_1778_cov_52.804050	1541	1621	112	7	80	0.0875000
NODE_1649_length_1778_cov_52.804050	1541	1621	37	2	80	0.0250000
NODE_1649_length_1778_cov_52.804050	1541	1621	53	2	80	0.0250000
NODE_1649_length_1778_cov_52.804050	1541	1621	57	1	80	0.0125000
NODE_1649_length_1778_cov_52.804050	1541	1621	60	1	80	0.0125000
NODE_1649_length_1778_cov_52.804050	1541	1621	74	2	80	0.0250000
NODE_1649_length_1778_cov_52.804050	1541	1621	76	2	80	0.0250000
NODE_1649_length_1778_cov_52.804050	1541	1621	77	2	80	0.0250000
NODE_1649_length_1778_cov_52.804050	1541	1621	78	4	80	0.0500000
NODE_1649_length_1778_cov_52.804050	1541	1621	80	1	80	0.0125000
NODE_1649_length_1778_cov_52.804050	1541	1621	81	4	80	0.0500000
NODE_1649_length_1778_cov_52.804050	1541	1621	93	7	80	0.0875000
NODE_1649_length_1778_cov_52.804050	1541	1621	95	4	80	0.0500000
NODE_1649_length_1778_cov_52.804050	1541	1621	103	22	80	0.2750000
NODE_1649_length_1778_cov_52.804050	1541	1621	106	18	80	0.2250000
NODE_1649_length_1778_cov_52.804050	1541	1621	111	1	80	0.0125000
NODE_1649_length_1778_cov_52.804050	1541	1621	112	7	80	0.0875000
NODE_1649_length_1778_cov_52.804050	1541	1621	37	2	80	0.0250000
NODE_1649_length_1778_cov_52.804050	1541	1621	53	2	80	0.0250000
NODE_1649_length_1778_cov_52.804050	1541	1621	57	1	80	0.0125000
NODE_1649_length_1778_cov_52.804050	1541	1621	60	1	80	0.0125000
NODE_1649_length_1778_cov_52.804050	1541	1621	74	2	80	0.0250000
NODE_1649_length_1778_cov_52.804050	1541	1621	76	2	80	0.0250000
NODE_1649_length_1778_cov_52.804050	1541	1621	77	2	80	0.0250000
NODE_1649_length_1778_cov_52.804050	1541	1621	78	4	80	0.0500000
NODE_1649_length_1778_cov_52.804050	1541	1621	80	1	80	0.0125000
NODE_1649_length_1778_cov_52.804050	1541	1621	81	4	80	0.0500000
NODE_1649_length_1778_cov_52.804050	1541	1621	93	7	80	0.0875000
NODE_1649_length_1778_cov_52.804050	1541	1621	95	4	80	0.0500000
NODE_1649_length_1778_cov_52.804050	1541	1621	103	22	80	0.2750000
NODE_1649_length_1778_cov_52.804050	1541	1621	106	18	80	0.2250000
NODE_1649_length_1778_cov_52.804050	1541	1621	111	1	80	0.0125000
NODE_1649_length_1778_cov_52.804050	1541	1621	112	7	80	0.0875000
NODE_1649_length_1778_cov_52.804050	1541	1621	37	2	80	0.0250000
NODE_1649_length_1778_cov_52.804050	1541	1621	53	2	80	0.0250000
NODE_1649_length_1778_cov_52.804050	1541	1621	57	1	80	0.0125000
NODE_1649_length_1778_cov_52.804050	1541	1621	60	1	80	0.0125000
NODE_1649_length_1778_cov_52.804050	1541	1621	74	2	80	0.0250000
NODE_1649_length_1778_cov_52.804050	1541	1621	76	2	80	0.0250000
NODE_1649_length_1778_cov_52.804050	1541	1621	77	2	80	0.0250000
NODE_1649_length_1778_cov_52.804050	1541	1621	78	4	80	0.0500000
NODE_1649_length_1778_cov_52.804050	1541	1621	80	1	80	0.0125000
NODE_1649_length_1778_cov_52.804050	1541	1621	81	4	80	0.0500000
NODE_1649_length_1778_cov_52.804050	1541	1621	93	7	80	0.0875000
NODE_1649_length_1778_cov_52.804050	1541	1621	95	4	80	0.0500000
NODE_1649_length_1778_cov_52.804050	1541	1621	103	22	80	0.2750000
NODE_1649_length_1778_cov_52.804050	1541	1621	106	18	80	0.2250000
NODE_1649_length_1778_cov_52.804050	1541	1621	111	1	80	0.0125000
NODE_1649_length_1778_cov_52.804050	1541	1621	112	7	80	0.0875000
NODE_1649_length_1778_cov_52.804050	1617	1697	88	1	80	0.0125000
NODE_1649_length_1778_cov_52.804050	1617	1697	89	3	80	0.0375000
NODE_1649_length_1778_cov_52.804050	1617	1697	103	5	80	0.0625000
NODE_1649_length_1778_cov_52.804050	1617	1697	104	10	80	0.1250000
NODE_1649_length_1778_cov_52.804050	1617	1697	112	6	80	0.0750000
NODE_1649_length_1778_cov_52.804050	1617	1697	120	2	80	0.0250000
NODE_1649_length_1778_cov_52.804050	1617	1697	125	1	80	0.0125000
NODE_1649_length_1778_cov_52.804050	1617	1697	131	1	80	0.0125000
NODE_1649_length_1778_cov_52.804050	1617	1697	134	1	80	0.0125000
NODE_1649_length_1778_cov_52.804050	1617	1697	136	1	80	0.0125000
NODE_1649_length_1778_cov_52.804050	1617	1697	140	2	80	0.0250000
NODE_1649_length_1778_cov_52.804050	1617	1697	145	2	80	0.0250000
NODE_1649_length_1778_cov_52.804050	1617	1697	148	8	80	0.1000000
NODE_1649_length_1778_cov_52.804050	1617	1697	152	11	80	0.1375000
NODE_1649_length_1778_cov_52.804050	1617	1697	153	1	80	0.0125000
NODE_1649_length_1778_cov_52.804050	1617	1697	154	3	80	0.0375000
NODE_1649_length_1778_cov_52.804050	1617	1697	158	1	80	0.0125000
NODE_1649_length_1778_cov_52.804050	1617	1697	160	3	80	0.0375000
NODE_1649_length_1778_cov_52.804050	1617	1697	161	4	80	0.0500000
NODE_1649_length_1778_cov_52.804050	1617	1697	162	3	80	0.0375000
NODE_1649_length_1778_cov_52.804050	1617	1697	163	2	80	0.0250000
NODE_1649_length_1778_cov_52.804050	1617	1697	164	7	80	0.0875000
NODE_1649_length_1778_cov_52.804050	1617	1697	165	1	80	0.0125000
NODE_1649_length_1778_cov_52.804050	1617	1697	166	1	80	0.0125000
NODE_1649_length_1778_cov_52.804050	1617	1697	88	1	80	0.0125000
NODE_1649_length_1778_cov_52.804050	1617	1697	89	3	80	0.0375000
NODE_1649_length_1778_cov_52.804050	1617	1697	103	5	80	0.0625000
NODE_1649_length_1778_cov_52.804050	1617	1697	104	10	80	0.1250000
NODE_1649_length_1778_cov_52.804050	1617	1697	112	6	80	0.0750000
NODE_1649_length_1778_cov_52.804050	1617	1697	120	2	80	0.0250000
NODE_1649_length_1778_cov_52.804050	1617	1697	125	1	80	0.0125000
NODE_1649_length_1778_cov_52.804050	1617	1697	131	1	80	0.0125000
NODE_1649_length_1778_cov_52.804050	1617	1697	134	1	80	0.0125000
NODE_1649_length_1778_cov_52.804050	1617	1697	136	1	80	0.0125000
NODE_1649_length_1778_cov_52.804050	1617	1697	140	2	80	0.0250000
NODE_1649_length_1778_cov_52.804050	1617	1697	145	2	80	0.0250000
NODE_1649_length_1778_cov_52.804050	1617	1697	148	8	80	0.1000000
NODE_1649_length_1778_cov_52.804050	1617	1697	152	11	80	0.1375000
NODE_1649_length_1778_cov_52.804050	1617	1697	153	1	80	0.0125000
NODE_1649_length_1778_cov_52.804050	1617	1697	154	3	80	0.0375000
NODE_1649_length_1778_cov_52.804050	1617	1697	158	1	80	0.0125000
NODE_1649_length_1778_cov_52.804050	1617	1697	160	3	80	0.0375000
NODE_1649_length_1778_cov_52.804050	1617	1697	161	4	80	0.0500000
NODE_1649_length_1778_cov_52.804050	1617	1697	162	3	80	0.0375000
NODE_1649_length_1778_cov_52.804050	1617	1697	163	2	80	0.0250000
NODE_1649_length_1778_cov_52.804050	1617	1697	164	7	80	0.0875000
NODE_1649_length_1778_cov_52.804050	1617	1697	165	1	80	0.0125000
NODE_1649_length_1778_cov_52.804050	1617	1697	166	1	80	0.0125000
NODE_1649_length_1778_cov_52.804050	1617	1697	88	1	80	0.0125000
NODE_1649_length_1778_cov_52.804050	1617	1697	89	3	80	0.0375000
NODE_1649_length_1778_cov_52.804050	1617	1697	103	5	80	0.0625000
NODE_1649_length_1778_cov_52.804050	1617	1697	104	10	80	0.1250000
NODE_1649_length_1778_cov_52.804050	1617	1697	112	6	80	0.0750000
NODE_1649_length_1778_cov_52.804050	1617	1697	120	2	80	0.0250000
NODE_1649_length_1778_cov_52.804050	1617	1697	125	1	80	0.0125000
NODE_1649_length_1778_cov_52.804050	1617	1697	131	1	80	0.0125000
NODE_1649_length_1778_cov_52.804050	1617	1697	134	1	80	0.0125000
NODE_1649_length_1778_cov_52.804050	1617	1697	136	1	80	0.0125000
NODE_1649_length_1778_cov_52.804050	1617	1697	140	2	80	0.0250000
NODE_1649_length_1778_cov_52.804050	1617	1697	145	2	80	0.0250000
NODE_1649_length_1778_cov_52.804050	1617	1697	148	8	80	0.1000000
NODE_1649_length_1778_cov_52.804050	1617	1697	152	11	80	0.1375000
NODE_1649_length_1778_cov_52.804050	1617	1697	153	1	80	0.0125000
NODE_1649_length_1778_cov_52.804050	1617	1697	154	3	80	0.0375000
NODE_1649_length_1778_cov_52.804050	1617	1697	158	1	80	0.0125000
NODE_1649_length_1778_cov_52.804050	1617	1697	160	3	80	0.0375000
NODE_1649_length_1778_cov_52.804050	1617	1697	161	4	80	0.0500000
NODE_1649_length_1778_cov_52.804050	1617	1697	162	3	80	0.0375000
NODE_1649_length_1778_cov_52.804050	1617	1697	163	2	80	0.0250000
NODE_1649_length_1778_cov_52.804050	1617	1697	164	7	80	0.0875000
NODE_1649_length_1778_cov_52.804050	1617	1697	165	1	80	0.0125000
NODE_1649_length_1778_cov_52.804050	1617	1697	166	1	80	0.0125000
NODE_1649_length_1778_cov_52.804050	1617	1697	88	1	80	0.0125000
NODE_1649_length_1778_cov_52.804050	1617	1697	89	3	80	0.0375000
NODE_1649_length_1778_cov_52.804050	1617	1697	103	5	80	0.0625000
NODE_1649_length_1778_cov_52.804050	1617	1697	104	10	80	0.1250000
NODE_1649_length_1778_cov_52.804050	1617	1697	112	6	80	0.0750000
NODE_1649_length_1778_cov_52.804050	1617	1697	120	2	80	0.0250000
NODE_1649_length_1778_cov_52.804050	1617	1697	125	1	80	0.0125000
NODE_1649_length_1778_cov_52.804050	1617	1697	131	1	80	0.0125000
NODE_1649_length_1778_cov_52.804050	1617	1697	134	1	80	0.0125000
NODE_1649_length_1778_cov_52.804050	1617	1697	136	1	80	0.0125000
NODE_1649_length_1778_cov_52.804050	1617	1697	140	2	80	0.0250000
NODE_1649_length_1778_cov_52.804050	1617	1697	145	2	80	0.0250000
NODE_1649_length_1778_cov_52.804050	1617	1697	148	8	80	0.1000000
NODE_1649_length_1778_cov_52.804050	1617	1697	152	11	80	0.1375000
NODE_1649_length_1778_cov_52.804050	1617	1697	153	1	80	0.0125000
NODE_1649_length_1778_cov_52.804050	1617	1697	154	3	80	0.0375000
NODE_1649_length_1778_cov_52.804050	1617	1697	158	1	80	0.0125000
NODE_1649_length_1778_cov_52.804050	1617	1697	160	3	80	0.0375000
NODE_1649_length_1778_cov_52.804050	1617	1697	161	4	80	0.0500000
NODE_1649_length_1778_cov_52.804050	1617	1697	162	3	80	0.0375000
NODE_1649_length_1778_cov_52.804050	1617	1697	163	2	80	0.0250000
NODE_1649_length_1778_cov_52.804050	1617	1697	164	7	80	0.0875000
NODE_1649_length_1778_cov_52.804050	1617	1697	165	1	80	0.0125000
NODE_1649_length_1778_cov_52.804050	1617	1697	166	1	80	0.0125000
NODE_1649_length_1778_cov_52.804050	1670	1750	47	2	80	0.0250000
NODE_1649_length_1778_cov_52.804050	1670	1750	57	2	80	0.0250000
NODE_1649_length_1778_cov_52.804050	1670	1750	75	1	80	0.0125000
NODE_1649_length_1778_cov_52.804050	1670	1750	78	8	80	0.1000000
NODE_1649_length_1778_cov_52.804050	1670	1750	80	29	80	0.3625000
NODE_1649_length_1778_cov_52.804050	1670	1750	81	5	80	0.0625000
NODE_1649_length_1778_cov_52.804050	1670	1750	82	2	80	0.0250000
NODE_1649_length_1778_cov_52.804050	1670	1750	83	4	80	0.0500000
NODE_1649_length_1778_cov_52.804050	1670	1750	88	1	80	0.0125000
NODE_1649_length_1778_cov_52.804050	1670	1750	89	3	80	0.0375000
NODE_1649_length_1778_cov_52.804050	1670	1750	103	5	80	0.0625000
NODE_1649_length_1778_cov_52.804050	1670	1750	104	10	80	0.1250000
NODE_1649_length_1778_cov_52.804050	1670	1750	125	1	80	0.0125000
NODE_1649_length_1778_cov_52.804050	1670	1750	131	1	80	0.0125000
NODE_1649_length_1778_cov_52.804050	1670	1750	134	1	80	0.0125000
NODE_1649_length_1778_cov_52.804050	1670	1750	140	2	80	0.0250000
NODE_1649_length_1778_cov_52.804050	1670	1750	148	3	80	0.0375000
NODE_1649_length_1778_cov_52.804050	1670	1750	47	2	80	0.0250000
NODE_1649_length_1778_cov_52.804050	1670	1750	57	2	80	0.0250000
NODE_1649_length_1778_cov_52.804050	1670	1750	75	1	80	0.0125000
NODE_1649_length_1778_cov_52.804050	1670	1750	78	8	80	0.1000000
NODE_1649_length_1778_cov_52.804050	1670	1750	80	29	80	0.3625000
NODE_1649_length_1778_cov_52.804050	1670	1750	81	5	80	0.0625000
NODE_1649_length_1778_cov_52.804050	1670	1750	82	2	80	0.0250000
NODE_1649_length_1778_cov_52.804050	1670	1750	83	4	80	0.0500000
NODE_1649_length_1778_cov_52.804050	1670	1750	88	1	80	0.0125000
NODE_1649_length_1778_cov_52.804050	1670	1750	89	3	80	0.0375000
NODE_1649_length_1778_cov_52.804050	1670	1750	103	5	80	0.0625000
NODE_1649_length_1778_cov_52.804050	1670	1750	104	10	80	0.1250000
NODE_1649_length_1778_cov_52.804050	1670	1750	125	1	80	0.0125000
NODE_1649_length_1778_cov_52.804050	1670	1750	131	1	80	0.0125000
NODE_1649_length_1778_cov_52.804050	1670	1750	134	1	80	0.0125000
NODE_1649_length_1778_cov_52.804050	1670	1750	140	2	80	0.0250000
NODE_1649_length_1778_cov_52.804050	1670	1750	148	3	80	0.0375000
NODE_1649_length_1778_cov_52.804050	1670	1750	47	2	80	0.0250000
NODE_1649_length_1778_cov_52.804050	1670	1750	57	2	80	0.0250000
NODE_1649_length_1778_cov_52.804050	1670	1750	75	1	80	0.0125000
NODE_1649_length_1778_cov_52.804050	1670	1750	78	8	80	0.1000000
NODE_1649_length_1778_cov_52.804050	1670	1750	80	29	80	0.3625000
NODE_1649_length_1778_cov_52.804050	1670	1750	81	5	80	0.0625000
NODE_1649_length_1778_cov_52.804050	1670	1750	82	2	80	0.0250000
NODE_1649_length_1778_cov_52.804050	1670	1750	83	4	80	0.0500000
NODE_1649_length_1778_cov_52.804050	1670	1750	88	1	80	0.0125000
NODE_1649_length_1778_cov_52.804050	1670	1750	89	3	80	0.0375000
NODE_1649_length_1778_cov_52.804050	1670	1750	103	5	80	0.0625000
NODE_1649_length_1778_cov_52.804050	1670	1750	104	10	80	0.1250000
NODE_1649_length_1778_cov_52.804050	1670	1750	125	1	80	0.0125000
NODE_1649_length_1778_cov_52.804050	1670	1750	131	1	80	0.0125000
NODE_1649_length_1778_cov_52.804050	1670	1750	134	1	80	0.0125000
NODE_1649_length_1778_cov_52.804050	1670	1750	140	2	80	0.0250000
NODE_1649_length_1778_cov_52.804050	1670	1750	148	3	80	0.0375000
NODE_1649_length_1778_cov_52.804050	1670	1741	78	4	71	0.0563380
NODE_1649_length_1778_cov_52.804050	1670	1741	80	29	71	0.4084507
NODE_1649_length_1778_cov_52.804050	1670	1741	81	5	71	0.0704225
NODE_1649_length_1778_cov_52.804050	1670	1741	82	2	71	0.0281690
NODE_1649_length_1778_cov_52.804050	1670	1741	83	4	71	0.0563380
NODE_1649_length_1778_cov_52.804050	1670	1741	88	1	71	0.0140845
NODE_1649_length_1778_cov_52.804050	1670	1741	89	3	71	0.0422535
NODE_1649_length_1778_cov_52.804050	1670	1741	103	5	71	0.0704225
NODE_1649_length_1778_cov_52.804050	1670	1741	104	10	71	0.1408451
NODE_1649_length_1778_cov_52.804050	1670	1741	125	1	71	0.0140845
NODE_1649_length_1778_cov_52.804050	1670	1741	131	1	71	0.0140845
NODE_1649_length_1778_cov_52.804050	1670	1741	134	1	71	0.0140845
NODE_1649_length_1778_cov_52.804050	1670	1741	140	2	71	0.0281690
NODE_1649_length_1778_cov_52.804050	1670	1741	148	3	71	0.0422535
NODE_1649_length_1778_cov_52.804050	1673	1743	78	6	70	0.0857143
NODE_1649_length_1778_cov_52.804050	1673	1743	80	29	70	0.4142857
NODE_1649_length_1778_cov_52.804050	1673	1743	81	5	70	0.0714286
NODE_1649_length_1778_cov_52.804050	1673	1743	82	2	70	0.0285714
NODE_1649_length_1778_cov_52.804050	1673	1743	83	4	70	0.0571429
NODE_1649_length_1778_cov_52.804050	1673	1743	88	1	70	0.0142857
NODE_1649_length_1778_cov_52.804050	1673	1743	89	3	70	0.0428571
NODE_1649_length_1778_cov_52.804050	1673	1743	103	5	70	0.0714286
NODE_1649_length_1778_cov_52.804050	1673	1743	104	10	70	0.1428571
NODE_1649_length_1778_cov_52.804050	1673	1743	125	1	70	0.0142857
NODE_1649_length_1778_cov_52.804050	1673	1743	131	1	70	0.0142857
NODE_1649_length_1778_cov_52.804050	1673	1743	134	1	70	0.0142857
NODE_1649_length_1778_cov_52.804050	1673	1743	140	2	70	0.0285714
NODE_1649_length_1778_cov_52.804050	1679	1750	47	2	71	0.0281690
NODE_1649_length_1778_cov_52.804050	1679	1750	57	2	71	0.0281690
NODE_1649_length_1778_cov_52.804050	1679	1750	75	1	71	0.0140845
NODE_1649_length_1778_cov_52.804050	1679	1750	78	8	71	0.1126761
NODE_1649_length_1778_cov_52.804050	1679	1750	80	29	71	0.4084507
NODE_1649_length_1778_cov_52.804050	1679	1750	81	5	71	0.0704225
NODE_1649_length_1778_cov_52.804050	1679	1750	82	2	71	0.0281690
NODE_1649_length_1778_cov_52.804050	1679	1750	83	4	71	0.0563380
NODE_1649_length_1778_cov_52.804050	1679	1750	88	1	71	0.0140845
NODE_1649_length_1778_cov_52.804050	1679	1750	89	3	71	0.0422535
NODE_1649_length_1778_cov_52.804050	1679	1750	103	5	71	0.0704225
NODE_1649_length_1778_cov_52.804050	1679	1750	104	9	71	0.1267606
NODE_1651_length_1776_cov_43.081694	1246	1308	0	57	62	0.9193549
NODE_1651_length_1776_cov_43.081694	1246	1308	8	4	62	0.0645161
NODE_1651_length_1776_cov_43.081694	1246	1308	31	1	62	0.0161290
NODE_1651_length_1776_cov_43.081694	1281	1361	0	80	80	1.0000000
NODE_1652_length_1776_cov_9.256410	1120	1200	0	66	80	0.8250000
NODE_1652_length_1776_cov_9.256410	1120	1200	1	14	80	0.1750000
NODE_1652_length_1776_cov_9.256410	1173	1253	0	13	80	0.1625000
NODE_1652_length_1776_cov_9.256410	1173	1253	1	38	80	0.4750000
NODE_1652_length_1776_cov_9.256410	1173	1253	2	29	80	0.3625000
NODE_1652_length_1776_cov_9.256410	1249	1329	2	5	80	0.0625000
NODE_1652_length_1776_cov_9.256410	1249	1329	4	2	80	0.0250000
NODE_1652_length_1776_cov_9.256410	1249	1329	8	73	80	0.9125000
NODE_1652_length_1776_cov_9.256410	1302	1382	1	2	80	0.0250000
NODE_1652_length_1776_cov_9.256410	1302	1382	2	8	80	0.1000000
NODE_1652_length_1776_cov_9.256410	1302	1382	3	9	80	0.1125000
NODE_1652_length_1776_cov_9.256410	1302	1382	7	27	80	0.3375000
NODE_1652_length_1776_cov_9.256410	1302	1382	8	34	80	0.4250000
NODE_1657_length_1775_cov_54.208234	1103	1167	118	1	64	0.0156250
NODE_1657_length_1775_cov_54.208234	1103	1167	122	2	64	0.0312500
NODE_1657_length_1775_cov_54.208234	1103	1167	124	1	64	0.0156250
NODE_1657_length_1775_cov_54.208234	1103	1167	127	1	64	0.0156250
NODE_1657_length_1775_cov_54.208234	1103	1167	128	1	64	0.0156250
NODE_1657_length_1775_cov_54.208234	1103	1167	129	2	64	0.0312500
NODE_1657_length_1775_cov_54.208234	1103	1167	137	2	64	0.0312500
NODE_1657_length_1775_cov_54.208234	1103	1167	138	2	64	0.0312500
NODE_1657_length_1775_cov_54.208234	1103	1167	139	12	64	0.1875000
NODE_1657_length_1775_cov_54.208234	1103	1167	140	5	64	0.0781250
NODE_1657_length_1775_cov_54.208234	1103	1167	141	5	64	0.0781250
NODE_1657_length_1775_cov_54.208234	1103	1167	142	7	64	0.1093750
NODE_1657_length_1775_cov_54.208234	1103	1167	144	4	64	0.0625000
NODE_1657_length_1775_cov_54.208234	1103	1167	145	2	64	0.0312500
NODE_1657_length_1775_cov_54.208234	1103	1167	146	2	64	0.0312500
NODE_1657_length_1775_cov_54.208234	1103	1167	149	1	64	0.0156250
NODE_1657_length_1775_cov_54.208234	1103	1167	150	2	64	0.0312500
NODE_1657_length_1775_cov_54.208234	1103	1167	151	3	64	0.0468750
NODE_1657_length_1775_cov_54.208234	1103	1167	152	2	64	0.0312500
NODE_1657_length_1775_cov_54.208234	1103	1167	154	4	64	0.0625000
NODE_1657_length_1775_cov_54.208234	1103	1167	155	1	64	0.0156250
NODE_1657_length_1775_cov_54.208234	1103	1167	156	2	64	0.0312500
NODE_1657_length_1775_cov_54.208234	1103	1167	118	1	64	0.0156250
NODE_1657_length_1775_cov_54.208234	1103	1167	122	2	64	0.0312500
NODE_1657_length_1775_cov_54.208234	1103	1167	124	1	64	0.0156250
NODE_1657_length_1775_cov_54.208234	1103	1167	127	1	64	0.0156250
NODE_1657_length_1775_cov_54.208234	1103	1167	128	1	64	0.0156250
NODE_1657_length_1775_cov_54.208234	1103	1167	129	2	64	0.0312500
NODE_1657_length_1775_cov_54.208234	1103	1167	137	2	64	0.0312500
NODE_1657_length_1775_cov_54.208234	1103	1167	138	2	64	0.0312500
NODE_1657_length_1775_cov_54.208234	1103	1167	139	12	64	0.1875000
NODE_1657_length_1775_cov_54.208234	1103	1167	140	5	64	0.0781250
NODE_1657_length_1775_cov_54.208234	1103	1167	141	5	64	0.0781250
NODE_1657_length_1775_cov_54.208234	1103	1167	142	7	64	0.1093750
NODE_1657_length_1775_cov_54.208234	1103	1167	144	4	64	0.0625000
NODE_1657_length_1775_cov_54.208234	1103	1167	145	2	64	0.0312500
NODE_1657_length_1775_cov_54.208234	1103	1167	146	2	64	0.0312500
NODE_1657_length_1775_cov_54.208234	1103	1167	149	1	64	0.0156250
NODE_1657_length_1775_cov_54.208234	1103	1167	150	2	64	0.0312500
NODE_1657_length_1775_cov_54.208234	1103	1167	151	3	64	0.0468750
NODE_1657_length_1775_cov_54.208234	1103	1167	152	2	64	0.0312500
NODE_1657_length_1775_cov_54.208234	1103	1167	154	4	64	0.0625000
NODE_1657_length_1775_cov_54.208234	1103	1167	155	1	64	0.0156250
NODE_1657_length_1775_cov_54.208234	1103	1167	156	2	64	0.0312500
NODE_1657_length_1775_cov_54.208234	1140	1200	61	2	60	0.0333333
NODE_1657_length_1775_cov_54.208234	1140	1200	64	2	60	0.0333333
NODE_1657_length_1775_cov_54.208234	1140	1200	67	6	60	0.1000000
NODE_1657_length_1775_cov_54.208234	1140	1200	69	2	60	0.0333333
NODE_1657_length_1775_cov_54.208234	1140	1200	71	2	60	0.0333333
NODE_1657_length_1775_cov_54.208234	1140	1200	75	1	60	0.0166667
NODE_1657_length_1775_cov_54.208234	1140	1200	77	2	60	0.0333333
NODE_1657_length_1775_cov_54.208234	1140	1200	79	1	60	0.0166667
NODE_1657_length_1775_cov_54.208234	1140	1200	88	1	60	0.0166667
NODE_1657_length_1775_cov_54.208234	1140	1200	89	1	60	0.0166667
NODE_1657_length_1775_cov_54.208234	1140	1200	90	2	60	0.0333333
NODE_1657_length_1775_cov_54.208234	1140	1200	92	1	60	0.0166667
NODE_1657_length_1775_cov_54.208234	1140	1200	104	1	60	0.0166667
NODE_1657_length_1775_cov_54.208234	1140	1200	110	2	60	0.0333333
NODE_1657_length_1775_cov_54.208234	1140	1200	111	3	60	0.0500000
NODE_1657_length_1775_cov_54.208234	1140	1200	118	1	60	0.0166667
NODE_1657_length_1775_cov_54.208234	1140	1200	119	1	60	0.0166667
NODE_1657_length_1775_cov_54.208234	1140	1200	122	2	60	0.0333333
NODE_1657_length_1775_cov_54.208234	1140	1200	124	1	60	0.0166667
NODE_1657_length_1775_cov_54.208234	1140	1200	127	1	60	0.0166667
NODE_1657_length_1775_cov_54.208234	1140	1200	128	2	60	0.0333333
NODE_1657_length_1775_cov_54.208234	1140	1200	129	3	60	0.0500000
NODE_1657_length_1775_cov_54.208234	1140	1200	130	1	60	0.0166667
NODE_1657_length_1775_cov_54.208234	1140	1200	138	2	60	0.0333333
NODE_1657_length_1775_cov_54.208234	1140	1200	139	1	60	0.0166667
NODE_1657_length_1775_cov_54.208234	1140	1200	140	1	60	0.0166667
NODE_1657_length_1775_cov_54.208234	1140	1200	141	2	60	0.0333333
NODE_1657_length_1775_cov_54.208234	1140	1200	142	1	60	0.0166667
NODE_1657_length_1775_cov_54.208234	1140	1200	144	1	60	0.0166667
NODE_1657_length_1775_cov_54.208234	1140	1200	145	1	60	0.0166667
NODE_1657_length_1775_cov_54.208234	1140	1200	146	2	60	0.0333333
NODE_1657_length_1775_cov_54.208234	1140	1200	150	2	60	0.0333333
NODE_1657_length_1775_cov_54.208234	1140	1200	151	2	60	0.0333333
NODE_1657_length_1775_cov_54.208234	1140	1200	152	2	60	0.0333333
NODE_1657_length_1775_cov_54.208234	1140	1200	156	2	60	0.0333333
NODE_1658_length_1775_cov_13.181981	1170	1250	0	16	80	0.2000000
NODE_1658_length_1775_cov_13.181981	1170	1250	2	64	80	0.8000000
NODE_1658_length_1775_cov_13.181981	1223	1303	0	69	80	0.8625000
NODE_1658_length_1775_cov_13.181981	1223	1303	2	11	80	0.1375000
NODE_1659_length_1775_cov_4.218974	1304	1384	0	80	80	1.0000000
NODE_1659_length_1775_cov_4.218974	1357	1437	0	80	80	1.0000000
NODE_1660_length_1774_cov_48.617313	345	425	0	9	80	0.1125000
NODE_1660_length_1774_cov_48.617313	345	425	2	33	80	0.4125000
NODE_1660_length_1774_cov_48.617313	345	425	4	38	80	0.4750000
NODE_1660_length_1774_cov_48.617313	398	478	0	1	80	0.0125000
NODE_1660_length_1774_cov_48.617313	398	478	2	42	80	0.5250000
NODE_1660_length_1774_cov_48.617313	398	478	4	37	80	0.4625000
NODE_1660_length_1774_cov_48.617313	474	554	0	6	80	0.0750000
NODE_1660_length_1774_cov_48.617313	474	554	2	74	80	0.9250000
NODE_1660_length_1774_cov_48.617313	527	607	0	39	80	0.4875000
NODE_1660_length_1774_cov_48.617313	527	607	2	41	80	0.5125000
NODE_1660_length_1774_cov_48.617313	1027	1107	0	9	80	0.1125000
NODE_1660_length_1774_cov_48.617313	1027	1107	2	62	80	0.7750000
NODE_1660_length_1774_cov_48.617313	1027	1107	4	9	80	0.1125000
NODE_1660_length_1774_cov_48.617313	1080	1160	0	62	80	0.7750000
NODE_1660_length_1774_cov_48.617313	1080	1160	2	18	80	0.2250000
NODE_1660_length_1774_cov_48.617313	1156	1236	0	68	80	0.8500000
NODE_1660_length_1774_cov_48.617313	1156	1236	2	12	80	0.1500000
NODE_1660_length_1774_cov_48.617313	1209	1289	0	15	80	0.1875000
NODE_1660_length_1774_cov_48.617313	1209	1289	2	65	80	0.8125000
NODE_1662_length_1774_cov_8.011343	1655	1735	0	80	80	1.0000000
NODE_1663_length_1773_cov_5.547192	433	513	0	32	80	0.4000000
NODE_1663_length_1773_cov_5.547192	433	513	1	2	80	0.0250000
NODE_1663_length_1773_cov_5.547192	433	513	4	46	80	0.5750000
NODE_1663_length_1773_cov_5.547192	486	566	0	80	80	1.0000000
NODE_1664_length_1773_cov_3.925329	267	347	0	31	80	0.3875000
NODE_1664_length_1773_cov_3.925329	267	347	4	49	80	0.6125000
NODE_1664_length_1773_cov_3.925329	320	400	0	31	80	0.3875000
NODE_1664_length_1773_cov_3.925329	320	400	4	49	80	0.6125000
NODE_1666_length_1770_cov_9.912029	369	437	0	68	68	1.0000000
NODE_1666_length_1770_cov_9.912029	388	431	0	43	43	1.0000000
NODE_1666_length_1770_cov_9.912029	509	577	0	68	68	1.0000000
NODE_1666_length_1770_cov_9.912029	515	571	0	56	56	1.0000000
NODE_1666_length_1770_cov_9.912029	579	618	0	39	39	1.0000000
NODE_1666_length_1770_cov_9.912029	697	776	0	79	79	1.0000000
NODE_1666_length_1770_cov_9.912029	714	794	0	80	80	1.0000000
NODE_1666_length_1770_cov_9.912029	767	819	0	52	52	1.0000000
NODE_1666_length_1770_cov_9.912029	785	819	0	34	34	1.0000000
NODE_1667_length_1768_cov_9.134811	687	736	74	1	49	0.0204082
NODE_1667_length_1768_cov_9.134811	687	736	77	12	49	0.2448980
NODE_1667_length_1768_cov_9.134811	687	736	79	8	49	0.1632653
NODE_1667_length_1768_cov_9.134811	687	736	81	6	49	0.1224490
NODE_1667_length_1768_cov_9.134811	687	736	83	4	49	0.0816327
NODE_1667_length_1768_cov_9.134811	687	736	84	3	49	0.0612245
NODE_1667_length_1768_cov_9.134811	687	736	85	1	49	0.0204082
NODE_1667_length_1768_cov_9.134811	687	736	86	1	49	0.0204082
NODE_1667_length_1768_cov_9.134811	687	736	89	4	49	0.0816327
NODE_1667_length_1768_cov_9.134811	687	736	91	3	49	0.0612245
NODE_1667_length_1768_cov_9.134811	687	736	93	6	49	0.1224490
NODE_1668_length_1768_cov_6.605153	1207	1287	2	9	80	0.1125000
NODE_1668_length_1768_cov_6.605153	1207	1287	4	43	80	0.5375000
NODE_1668_length_1768_cov_6.605153	1207	1287	6	28	80	0.3500000
NODE_1668_length_1768_cov_6.605153	1260	1340	0	10	80	0.1250000
NODE_1668_length_1768_cov_6.605153	1260	1340	2	52	80	0.6500000
NODE_1668_length_1768_cov_6.605153	1260	1340	6	18	80	0.2250000
NODE_1668_length_1768_cov_6.605153	1336	1416	0	80	80	1.0000000
NODE_1668_length_1768_cov_6.605153	1389	1469	0	80	80	1.0000000
NODE_1669_length_1767_cov_5.475420	508	588	16	5	80	0.0625000
NODE_1669_length_1767_cov_5.475420	508	588	20	1	80	0.0125000
NODE_1669_length_1767_cov_5.475420	508	588	23	1	80	0.0125000
NODE_1669_length_1767_cov_5.475420	508	588	25	2	80	0.0250000
NODE_1669_length_1767_cov_5.475420	508	588	26	2	80	0.0250000
NODE_1669_length_1767_cov_5.475420	508	588	27	5	80	0.0625000
NODE_1669_length_1767_cov_5.475420	508	588	28	2	80	0.0250000
NODE_1669_length_1767_cov_5.475420	508	588	34	1	80	0.0125000
NODE_1669_length_1767_cov_5.475420	508	588	36	3	80	0.0375000
NODE_1669_length_1767_cov_5.475420	508	588	38	7	80	0.0875000
NODE_1669_length_1767_cov_5.475420	508	588	40	13	80	0.1625000
NODE_1669_length_1767_cov_5.475420	508	588	42	38	80	0.4750000
NODE_1680_length_1762_cov_18.673482	606	686	0	80	80	1.0000000
NODE_1680_length_1762_cov_18.673482	659	739	0	80	80	1.0000000
NODE_1680_length_1762_cov_18.673482	735	815	0	56	80	0.7000000
NODE_1680_length_1762_cov_18.673482	735	815	2	24	80	0.3000000
NODE_1680_length_1762_cov_18.673482	788	868	0	3	80	0.0375000
NODE_1680_length_1762_cov_18.673482	788	868	2	77	80	0.9625000
NODE_1681_length_1762_cov_6.760072	1033	1113	0	14	80	0.1750000
NODE_1681_length_1762_cov_6.760072	1033	1113	2	66	80	0.8250000
NODE_1681_length_1762_cov_6.760072	1086	1166	0	67	80	0.8375000
NODE_1681_length_1762_cov_6.760072	1086	1166	2	13	80	0.1625000
NODE_1685_length_1760_cov_8.064419	941	1021	0	29	80	0.3625000
NODE_1685_length_1760_cov_8.064419	941	1021	4	51	80	0.6375000
NODE_1685_length_1760_cov_8.064419	994	1074	4	80	80	1.0000000
NODE_1692_length_1758_cov_99.869198	599	679	8	1	80	0.0125000
NODE_1692_length_1758_cov_99.869198	599	679	9	5	80	0.0625000
NODE_1692_length_1758_cov_99.869198	599	679	10	19	80	0.2375000
NODE_1692_length_1758_cov_99.869198	599	679	11	13	80	0.1625000
NODE_1692_length_1758_cov_99.869198	599	679	12	8	80	0.1000000
NODE_1692_length_1758_cov_99.869198	599	679	13	1	80	0.0125000
NODE_1692_length_1758_cov_99.869198	599	679	14	7	80	0.0875000
NODE_1692_length_1758_cov_99.869198	599	679	16	12	80	0.1500000
NODE_1692_length_1758_cov_99.869198	599	679	24	1	80	0.0125000
NODE_1692_length_1758_cov_99.869198	599	679	26	2	80	0.0250000
NODE_1692_length_1758_cov_99.869198	599	679	28	11	80	0.1375000
NODE_1692_length_1758_cov_99.869198	652	732	14	5	80	0.0625000
NODE_1692_length_1758_cov_99.869198	652	732	16	8	80	0.1000000
NODE_1692_length_1758_cov_99.869198	652	732	24	1	80	0.0125000
NODE_1692_length_1758_cov_99.869198	652	732	26	2	80	0.0250000
NODE_1692_length_1758_cov_99.869198	652	732	28	14	80	0.1750000
NODE_1692_length_1758_cov_99.869198	652	732	30	1	80	0.0125000
NODE_1692_length_1758_cov_99.869198	652	732	32	2	80	0.0250000
NODE_1692_length_1758_cov_99.869198	652	732	34	7	80	0.0875000
NODE_1692_length_1758_cov_99.869198	652	732	41	1	80	0.0125000
NODE_1692_length_1758_cov_99.869198	652	732	42	4	80	0.0500000
NODE_1692_length_1758_cov_99.869198	652	732	50	7	80	0.0875000
NODE_1692_length_1758_cov_99.869198	652	732	52	13	80	0.1625000
NODE_1692_length_1758_cov_99.869198	652	732	54	10	80	0.1250000
NODE_1692_length_1758_cov_99.869198	652	732	60	5	80	0.0625000
NODE_1692_length_1758_cov_99.869198	728	808	32	2	80	0.0250000
NODE_1692_length_1758_cov_99.869198	728	808	34	8	80	0.1000000
NODE_1692_length_1758_cov_99.869198	728	808	38	5	80	0.0625000
NODE_1692_length_1758_cov_99.869198	728	808	48	9	80	0.1125000
NODE_1692_length_1758_cov_99.869198	728	808	50	15	80	0.1875000
NODE_1692_length_1758_cov_99.869198	728	808	51	3	80	0.0375000
NODE_1692_length_1758_cov_99.869198	728	808	53	1	80	0.0125000
NODE_1692_length_1758_cov_99.869198	728	808	55	2	80	0.0250000
NODE_1692_length_1758_cov_99.869198	728	808	56	2	80	0.0250000
NODE_1692_length_1758_cov_99.869198	728	808	57	13	80	0.1625000
NODE_1692_length_1758_cov_99.869198	728	808	60	16	80	0.2000000
NODE_1692_length_1758_cov_99.869198	728	808	62	1	80	0.0125000
NODE_1692_length_1758_cov_99.869198	728	808	64	3	80	0.0375000
NODE_1692_length_1758_cov_99.869198	781	861	2	5	80	0.0625000
NODE_1692_length_1758_cov_99.869198	781	861	4	26	80	0.3250000
NODE_1692_length_1758_cov_99.869198	781	861	14	9	80	0.1125000
NODE_1692_length_1758_cov_99.869198	781	861	22	3	80	0.0375000
NODE_1692_length_1758_cov_99.869198	781	861	30	1	80	0.0125000
NODE_1692_length_1758_cov_99.869198	781	861	32	8	80	0.1000000
NODE_1692_length_1758_cov_99.869198	781	861	34	11	80	0.1375000
NODE_1692_length_1758_cov_99.869198	781	861	38	5	80	0.0625000
NODE_1692_length_1758_cov_99.869198	781	861	48	9	80	0.1125000
NODE_1692_length_1758_cov_99.869198	781	861	50	3	80	0.0375000
NODE_1693_length_1757_cov_3.126659	49	121	2	18	72	0.2500000
NODE_1693_length_1757_cov_3.126659	49	121	4	54	72	0.7500000
NODE_1696_length_1755_cov_9.938406	231	311	0	75	80	0.9375000
NODE_1696_length_1755_cov_9.938406	231	311	2	5	80	0.0625000
NODE_1696_length_1755_cov_9.938406	284	364	0	22	80	0.2750000
NODE_1696_length_1755_cov_9.938406	284	364	2	58	80	0.7250000
NODE_1698_length_1755_cov_3.614130	171	222	4	7	51	0.1372549
NODE_1698_length_1755_cov_3.614130	171	222	8	44	51	0.8627451
NODE_1699_length_1754_cov_8.523263	0	77	0	31	77	0.4025974
NODE_1699_length_1754_cov_8.523263	0	77	2	10	77	0.1298701
NODE_1699_length_1754_cov_8.523263	0	77	4	36	77	0.4675325
NODE_1699_length_1754_cov_8.523263	0	77	0	31	77	0.4025974
NODE_1699_length_1754_cov_8.523263	0	77	2	10	77	0.1298701
NODE_1699_length_1754_cov_8.523263	0	77	4	36	77	0.4675325
NODE_1699_length_1754_cov_8.523263	0	77	0	31	77	0.4025974
NODE_1699_length_1754_cov_8.523263	0	77	2	10	77	0.1298701
NODE_1699_length_1754_cov_8.523263	0	77	4	36	77	0.4675325
NODE_1699_length_1754_cov_8.523263	50	99	4	49	49	1.0000000
NODE_1699_length_1754_cov_8.523263	53	99	4	46	46	1.0000000
NODE_1699_length_1754_cov_8.523263	55	99	4	44	44	1.0000000
NODE_1700_length_1753_cov_26.851874	356	436	0	80	80	1.0000000
NODE_1700_length_1753_cov_26.851874	409	489	0	80	80	1.0000000
NODE_1701_length_1753_cov_12.297461	355	435	0	80	80	1.0000000
NODE_1701_length_1753_cov_12.297461	408	488	0	80	80	1.0000000
NODE_1705_length_1750_cov_90.732283	1191	1254	89	1	63	0.0158730
NODE_1705_length_1750_cov_90.732283	1191	1254	92	1	63	0.0158730
NODE_1705_length_1750_cov_90.732283	1191	1254	93	3	63	0.0476190
NODE_1705_length_1750_cov_90.732283	1191	1254	94	1	63	0.0158730
NODE_1705_length_1750_cov_90.732283	1191	1254	95	2	63	0.0317460
NODE_1705_length_1750_cov_90.732283	1191	1254	96	2	63	0.0317460
NODE_1705_length_1750_cov_90.732283	1191	1254	97	4	63	0.0634921
NODE_1705_length_1750_cov_90.732283	1191	1254	109	1	63	0.0158730
NODE_1705_length_1750_cov_90.732283	1191	1254	113	1	63	0.0158730
NODE_1705_length_1750_cov_90.732283	1191	1254	116	1	63	0.0158730
NODE_1705_length_1750_cov_90.732283	1191	1254	117	1	63	0.0158730
NODE_1705_length_1750_cov_90.732283	1191	1254	118	2	63	0.0317460
NODE_1705_length_1750_cov_90.732283	1191	1254	120	2	63	0.0317460
NODE_1705_length_1750_cov_90.732283	1191	1254	124	1	63	0.0158730
NODE_1705_length_1750_cov_90.732283	1191	1254	126	1	63	0.0158730
NODE_1705_length_1750_cov_90.732283	1191	1254	128	1	63	0.0158730
NODE_1705_length_1750_cov_90.732283	1191	1254	137	1	63	0.0158730
NODE_1705_length_1750_cov_90.732283	1191	1254	139	1	63	0.0158730
NODE_1705_length_1750_cov_90.732283	1191	1254	140	1	63	0.0158730
NODE_1705_length_1750_cov_90.732283	1191	1254	142	1	63	0.0158730
NODE_1705_length_1750_cov_90.732283	1191	1254	144	2	63	0.0317460
NODE_1705_length_1750_cov_90.732283	1191	1254	145	4	63	0.0634921
NODE_1705_length_1750_cov_90.732283	1191	1254	146	1	63	0.0158730
NODE_1705_length_1750_cov_90.732283	1191	1254	147	1	63	0.0158730
NODE_1705_length_1750_cov_90.732283	1191	1254	156	1	63	0.0158730
NODE_1705_length_1750_cov_90.732283	1191	1254	157	1	63	0.0158730
NODE_1705_length_1750_cov_90.732283	1191	1254	159	4	63	0.0634921
NODE_1705_length_1750_cov_90.732283	1191	1254	161	2	63	0.0317460
NODE_1705_length_1750_cov_90.732283	1191	1254	164	1	63	0.0158730
NODE_1705_length_1750_cov_90.732283	1191	1254	171	1	63	0.0158730
NODE_1705_length_1750_cov_90.732283	1191	1254	173	4	63	0.0634921
NODE_1705_length_1750_cov_90.732283	1191	1254	175	1	63	0.0158730
NODE_1705_length_1750_cov_90.732283	1191	1254	176	1	63	0.0158730
NODE_1705_length_1750_cov_90.732283	1191	1254	177	3	63	0.0476190
NODE_1705_length_1750_cov_90.732283	1191	1254	179	2	63	0.0317460
NODE_1705_length_1750_cov_90.732283	1191	1254	185	1	63	0.0158730
NODE_1705_length_1750_cov_90.732283	1191	1254	193	1	63	0.0158730
NODE_1705_length_1750_cov_90.732283	1191	1254	199	1	63	0.0158730
NODE_1705_length_1750_cov_90.732283	1191	1254	200	2	63	0.0317460
NODE_1705_length_1750_cov_90.732283	1239	1310	171	1	71	0.0140845
NODE_1705_length_1750_cov_90.732283	1239	1310	173	3	71	0.0422535
NODE_1705_length_1750_cov_90.732283	1239	1310	176	1	71	0.0140845
NODE_1705_length_1750_cov_90.732283	1239	1310	177	3	71	0.0422535
NODE_1705_length_1750_cov_90.732283	1239	1310	179	2	71	0.0281690
NODE_1705_length_1750_cov_90.732283	1239	1310	185	1	71	0.0140845
NODE_1705_length_1750_cov_90.732283	1239	1310	193	1	71	0.0140845
NODE_1705_length_1750_cov_90.732283	1239	1310	199	1	71	0.0140845
NODE_1705_length_1750_cov_90.732283	1239	1310	200	2	71	0.0281690
NODE_1705_length_1750_cov_90.732283	1239	1310	213	1	71	0.0140845
NODE_1705_length_1750_cov_90.732283	1239	1310	215	1	71	0.0140845
NODE_1705_length_1750_cov_90.732283	1239	1310	217	1	71	0.0140845
NODE_1705_length_1750_cov_90.732283	1239	1310	235	1	71	0.0140845
NODE_1705_length_1750_cov_90.732283	1239	1310	237	2	71	0.0281690
NODE_1705_length_1750_cov_90.732283	1239	1310	245	2	71	0.0281690
NODE_1705_length_1750_cov_90.732283	1239	1310	246	1	71	0.0140845
NODE_1705_length_1750_cov_90.732283	1239	1310	248	3	71	0.0422535
NODE_1705_length_1750_cov_90.732283	1239	1310	249	3	71	0.0422535
NODE_1705_length_1750_cov_90.732283	1239	1310	250	2	71	0.0281690
NODE_1705_length_1750_cov_90.732283	1239	1310	251	1	71	0.0140845
NODE_1705_length_1750_cov_90.732283	1239	1310	253	2	71	0.0281690
NODE_1705_length_1750_cov_90.732283	1239	1310	254	3	71	0.0422535
NODE_1705_length_1750_cov_90.732283	1239	1310	255	1	71	0.0140845
NODE_1705_length_1750_cov_90.732283	1239	1310	256	1	71	0.0140845
NODE_1705_length_1750_cov_90.732283	1239	1310	258	1	71	0.0140845
NODE_1705_length_1750_cov_90.732283	1239	1310	259	1	71	0.0140845
NODE_1705_length_1750_cov_90.732283	1239	1310	260	3	71	0.0422535
NODE_1705_length_1750_cov_90.732283	1239	1310	261	1	71	0.0140845
NODE_1705_length_1750_cov_90.732283	1239	1310	262	3	71	0.0422535
NODE_1705_length_1750_cov_90.732283	1239	1310	266	4	71	0.0563380
NODE_1705_length_1750_cov_90.732283	1239	1310	268	9	71	0.1267606
NODE_1705_length_1750_cov_90.732283	1239	1310	270	4	71	0.0563380
NODE_1705_length_1750_cov_90.732283	1239	1310	274	1	71	0.0140845
NODE_1705_length_1750_cov_90.732283	1239	1310	275	2	71	0.0281690
NODE_1705_length_1750_cov_90.732283	1239	1310	276	1	71	0.0140845
NODE_1705_length_1750_cov_90.732283	1239	1310	279	1	71	0.0140845
NODE_1711_length_1746_cov_3.095932	458	524	0	66	66	1.0000000
NODE_1712_length_1745_cov_7.646416	430	510	0	80	80	1.0000000
NODE_1712_length_1745_cov_7.646416	483	563	0	80	80	1.0000000
NODE_1715_length_1744_cov_10.144681	1213	1289	0	18	76	0.2368421
NODE_1715_length_1744_cov_10.144681	1213	1289	4	3	76	0.0394737
NODE_1715_length_1744_cov_10.144681	1213	1289	6	6	76	0.0789474
NODE_1715_length_1744_cov_10.144681	1213	1289	8	3	76	0.0394737
NODE_1715_length_1744_cov_10.144681	1213	1289	12	46	76	0.6052632
NODE_1715_length_1744_cov_10.144681	1262	1342	12	50	80	0.6250000
NODE_1715_length_1744_cov_10.144681	1262	1342	14	30	80	0.3750000
NODE_1719_length_1742_cov_18.923311	699	776	0	77	77	1.0000000
NODE_1719_length_1742_cov_18.923311	749	829	0	80	80	1.0000000
NODE_1722_length_1741_cov_7.657734	1234	1314	0	80	80	1.0000000
NODE_1722_length_1741_cov_7.657734	1287	1367	0	80	80	1.0000000
NODE_1722_length_1741_cov_7.657734	1363	1443	0	80	80	1.0000000
NODE_1722_length_1741_cov_7.657734	1416	1496	0	80	80	1.0000000
NODE_1726_length_1740_cov_38.411335	517	597	6	46	80	0.5750000
NODE_1726_length_1740_cov_38.411335	517	597	10	2	80	0.0250000
NODE_1726_length_1740_cov_38.411335	517	597	11	2	80	0.0250000
NODE_1726_length_1740_cov_38.411335	517	597	13	29	80	0.3625000
NODE_1726_length_1740_cov_38.411335	517	597	16	1	80	0.0125000
NODE_1726_length_1740_cov_38.411335	570	650	10	2	80	0.0250000
NODE_1726_length_1740_cov_38.411335	570	650	11	4	80	0.0500000
NODE_1726_length_1740_cov_38.411335	570	650	12	51	80	0.6375000
NODE_1726_length_1740_cov_38.411335	570	650	13	23	80	0.2875000
NODE_1726_length_1740_cov_38.411335	646	726	2	7	80	0.0875000
NODE_1726_length_1740_cov_38.411335	646	726	4	16	80	0.2000000
NODE_1726_length_1740_cov_38.411335	646	726	6	43	80	0.5375000
NODE_1726_length_1740_cov_38.411335	646	726	12	14	80	0.1750000
NODE_1726_length_1740_cov_38.411335	699	779	2	17	80	0.2125000
NODE_1726_length_1740_cov_38.411335	699	779	4	13	80	0.1625000
NODE_1726_length_1740_cov_38.411335	699	779	5	4	80	0.0500000
NODE_1726_length_1740_cov_38.411335	699	779	6	46	80	0.5750000
NODE_1727_length_1740_cov_10.843388	552	632	2	33	80	0.4125000
NODE_1727_length_1740_cov_10.843388	552	632	4	47	80	0.5875000
NODE_1727_length_1740_cov_10.843388	708	788	0	21	80	0.2625000
NODE_1727_length_1740_cov_10.843388	708	788	2	9	80	0.1125000
NODE_1727_length_1740_cov_10.843388	708	788	4	50	80	0.6250000
NODE_1727_length_1740_cov_10.843388	708	788	0	21	80	0.2625000
NODE_1727_length_1740_cov_10.843388	708	788	2	9	80	0.1125000
NODE_1727_length_1740_cov_10.843388	708	788	4	50	80	0.6250000
NODE_1727_length_1740_cov_10.843388	708	788	0	21	80	0.2625000
NODE_1727_length_1740_cov_10.843388	708	788	2	9	80	0.1125000
NODE_1727_length_1740_cov_10.843388	708	788	4	50	80	0.6250000
NODE_1727_length_1740_cov_10.843388	761	841	2	37	80	0.4625000
NODE_1727_length_1740_cov_10.843388	761	841	4	43	80	0.5375000
NODE_1727_length_1740_cov_10.843388	761	808	2	4	47	0.0851064
NODE_1727_length_1740_cov_10.843388	761	808	4	43	47	0.9148936
NODE_1727_length_1740_cov_10.843388	761	808	2	4	47	0.0851064
NODE_1727_length_1740_cov_10.843388	761	808	4	43	47	0.9148936
NODE_1737_length_1736_cov_71.959682	841	901	71	6	60	0.1000000
NODE_1737_length_1736_cov_71.959682	841	901	73	6	60	0.1000000
NODE_1737_length_1736_cov_71.959682	841	901	75	1	60	0.0166667
NODE_1737_length_1736_cov_71.959682	841	901	77	15	60	0.2500000
NODE_1737_length_1736_cov_71.959682	841	901	79	3	60	0.0500000
NODE_1737_length_1736_cov_71.959682	841	901	81	12	60	0.2000000
NODE_1737_length_1736_cov_71.959682	841	901	83	9	60	0.1500000
NODE_1737_length_1736_cov_71.959682	841	901	85	8	60	0.1333333
NODE_1738_length_1736_cov_29.174710	1361	1390	157	3	29	0.1034483
NODE_1738_length_1736_cov_29.174710	1361	1390	158	2	29	0.0689655
NODE_1738_length_1736_cov_29.174710	1361	1390	159	2	29	0.0689655
NODE_1738_length_1736_cov_29.174710	1361	1390	161	5	29	0.1724138
NODE_1738_length_1736_cov_29.174710	1361	1390	163	7	29	0.2413793
NODE_1738_length_1736_cov_29.174710	1361	1390	167	1	29	0.0344828
NODE_1738_length_1736_cov_29.174710	1361	1390	169	1	29	0.0344828
NODE_1738_length_1736_cov_29.174710	1361	1390	173	3	29	0.1034483
NODE_1738_length_1736_cov_29.174710	1361	1390	175	2	29	0.0689655
NODE_1738_length_1736_cov_29.174710	1361	1390	177	2	29	0.0689655
NODE_1738_length_1736_cov_29.174710	1361	1390	179	1	29	0.0344828
NODE_1738_length_1736_cov_29.174710	1566	1628	195	2	62	0.0322581
NODE_1738_length_1736_cov_29.174710	1566	1628	199	4	62	0.0645161
NODE_1738_length_1736_cov_29.174710	1566	1628	201	3	62	0.0483871
NODE_1738_length_1736_cov_29.174710	1566	1628	205	1	62	0.0161290
NODE_1738_length_1736_cov_29.174710	1566	1628	211	2	62	0.0322581
NODE_1738_length_1736_cov_29.174710	1566	1628	215	1	62	0.0161290
NODE_1738_length_1736_cov_29.174710	1566	1628	216	2	62	0.0322581
NODE_1738_length_1736_cov_29.174710	1566	1628	217	2	62	0.0322581
NODE_1738_length_1736_cov_29.174710	1566	1628	219	3	62	0.0483871
NODE_1738_length_1736_cov_29.174710	1566	1628	221	1	62	0.0161290
NODE_1738_length_1736_cov_29.174710	1566	1628	222	3	62	0.0483871
NODE_1738_length_1736_cov_29.174710	1566	1628	223	2	62	0.0322581
NODE_1738_length_1736_cov_29.174710	1566	1628	224	3	62	0.0483871
NODE_1738_length_1736_cov_29.174710	1566	1628	225	2	62	0.0322581
NODE_1738_length_1736_cov_29.174710	1566	1628	226	2	62	0.0322581
NODE_1738_length_1736_cov_29.174710	1566	1628	227	1	62	0.0161290
NODE_1738_length_1736_cov_29.174710	1566	1628	228	4	62	0.0645161
NODE_1738_length_1736_cov_29.174710	1566	1628	230	5	62	0.0806452
NODE_1738_length_1736_cov_29.174710	1566	1628	231	1	62	0.0161290
NODE_1738_length_1736_cov_29.174710	1566	1628	232	3	62	0.0483871
NODE_1738_length_1736_cov_29.174710	1566	1628	233	5	62	0.0806452
NODE_1738_length_1736_cov_29.174710	1566	1628	234	2	62	0.0322581
NODE_1738_length_1736_cov_29.174710	1566	1628	235	3	62	0.0483871
NODE_1738_length_1736_cov_29.174710	1566	1628	236	1	62	0.0161290
NODE_1738_length_1736_cov_29.174710	1566	1628	237	1	62	0.0161290
NODE_1738_length_1736_cov_29.174710	1566	1628	238	1	62	0.0161290
NODE_1738_length_1736_cov_29.174710	1566	1628	239	2	62	0.0322581
NODE_1743_length_1732_cov_6.162890	807	887	0	72	80	0.9000000
NODE_1743_length_1732_cov_6.162890	807	887	2	8	80	0.1000000
NODE_1743_length_1732_cov_6.162890	860	940	0	19	80	0.2375000
NODE_1743_length_1732_cov_6.162890	860	940	2	61	80	0.7625000
NODE_1749_length_1729_cov_23.708589	364	443	0	79	79	1.0000000
NODE_1749_length_1729_cov_23.708589	416	496	0	80	80	1.0000000
NODE_1749_length_1729_cov_23.708589	492	572	0	8	80	0.1000000
NODE_1749_length_1729_cov_23.708589	492	572	2	31	80	0.3875000
NODE_1749_length_1729_cov_23.708589	492	572	6	41	80	0.5125000
NODE_1749_length_1729_cov_23.708589	545	625	4	52	80	0.6500000
NODE_1749_length_1729_cov_23.708589	545	625	6	28	80	0.3500000
NODE_1753_length_1728_cov_26.505832	259	339	16	7	80	0.0875000
NODE_1753_length_1728_cov_26.505832	259	339	18	1	80	0.0125000
NODE_1753_length_1728_cov_26.505832	259	339	20	3	80	0.0375000
NODE_1753_length_1728_cov_26.505832	259	339	22	51	80	0.6375000
NODE_1753_length_1728_cov_26.505832	259	339	24	18	80	0.2250000
NODE_1753_length_1728_cov_26.505832	312	392	0	2	80	0.0250000
NODE_1753_length_1728_cov_26.505832	312	392	2	17	80	0.2125000
NODE_1753_length_1728_cov_26.505832	312	392	6	21	80	0.2625000
NODE_1753_length_1728_cov_26.505832	312	392	16	14	80	0.1750000
NODE_1753_length_1728_cov_26.505832	312	392	18	1	80	0.0125000
NODE_1753_length_1728_cov_26.505832	312	392	20	2	80	0.0250000
NODE_1753_length_1728_cov_26.505832	312	392	22	23	80	0.2875000
NODE_1757_length_1725_cov_142.158057	767	814	403	2	47	0.0425532
NODE_1757_length_1725_cov_142.158057	767	814	407	1	47	0.0212766
NODE_1757_length_1725_cov_142.158057	767	814	409	1	47	0.0212766
NODE_1757_length_1725_cov_142.158057	767	814	410	1	47	0.0212766
NODE_1757_length_1725_cov_142.158057	767	814	411	1	47	0.0212766
NODE_1757_length_1725_cov_142.158057	767	814	417	1	47	0.0212766
NODE_1757_length_1725_cov_142.158057	767	814	418	2	47	0.0425532
NODE_1757_length_1725_cov_142.158057	767	814	420	1	47	0.0212766
NODE_1757_length_1725_cov_142.158057	767	814	424	1	47	0.0212766
NODE_1757_length_1725_cov_142.158057	767	814	426	1	47	0.0212766
NODE_1757_length_1725_cov_142.158057	767	814	430	1	47	0.0212766
NODE_1757_length_1725_cov_142.158057	767	814	432	2	47	0.0425532
NODE_1757_length_1725_cov_142.158057	767	814	435	1	47	0.0212766
NODE_1757_length_1725_cov_142.158057	767	814	438	1	47	0.0212766
NODE_1757_length_1725_cov_142.158057	767	814	439	1	47	0.0212766
NODE_1757_length_1725_cov_142.158057	767	814	440	2	47	0.0425532
NODE_1757_length_1725_cov_142.158057	767	814	444	1	47	0.0212766
NODE_1757_length_1725_cov_142.158057	767	814	448	1	47	0.0212766
NODE_1757_length_1725_cov_142.158057	767	814	454	1	47	0.0212766
NODE_1757_length_1725_cov_142.158057	767	814	460	1	47	0.0212766
NODE_1757_length_1725_cov_142.158057	767	814	464	1	47	0.0212766
NODE_1757_length_1725_cov_142.158057	767	814	468	2	47	0.0425532
NODE_1757_length_1725_cov_142.158057	767	814	480	2	47	0.0425532
NODE_1757_length_1725_cov_142.158057	767	814	487	1	47	0.0212766
NODE_1757_length_1725_cov_142.158057	767	814	491	1	47	0.0212766
NODE_1757_length_1725_cov_142.158057	767	814	497	1	47	0.0212766
NODE_1757_length_1725_cov_142.158057	767	814	505	1	47	0.0212766
NODE_1757_length_1725_cov_142.158057	767	814	513	1	47	0.0212766
NODE_1757_length_1725_cov_142.158057	767	814	515	1	47	0.0212766
NODE_1757_length_1725_cov_142.158057	767	814	521	1	47	0.0212766
NODE_1757_length_1725_cov_142.158057	767	814	522	2	47	0.0425532
NODE_1757_length_1725_cov_142.158057	767	814	524	1	47	0.0212766
NODE_1757_length_1725_cov_142.158057	767	814	525	1	47	0.0212766
NODE_1757_length_1725_cov_142.158057	767	814	530	1	47	0.0212766
NODE_1757_length_1725_cov_142.158057	767	814	532	2	47	0.0425532
NODE_1757_length_1725_cov_142.158057	767	814	533	2	47	0.0425532
NODE_1757_length_1725_cov_142.158057	767	814	537	2	47	0.0425532
NODE_1757_length_1725_cov_142.158057	803	867	428	1	64	0.0156250
NODE_1757_length_1725_cov_142.158057	803	867	429	2	64	0.0312500
NODE_1757_length_1725_cov_142.158057	803	867	430	2	64	0.0312500
NODE_1757_length_1725_cov_142.158057	803	867	435	2	64	0.0312500
NODE_1757_length_1725_cov_142.158057	803	867	437	1	64	0.0156250
NODE_1757_length_1725_cov_142.158057	803	867	441	2	64	0.0312500
NODE_1757_length_1725_cov_142.158057	803	867	444	2	64	0.0312500
NODE_1757_length_1725_cov_142.158057	803	867	446	1	64	0.0156250
NODE_1757_length_1725_cov_142.158057	803	867	447	1	64	0.0156250
NODE_1757_length_1725_cov_142.158057	803	867	452	2	64	0.0312500
NODE_1757_length_1725_cov_142.158057	803	867	456	1	64	0.0156250
NODE_1757_length_1725_cov_142.158057	803	867	462	1	64	0.0156250
NODE_1757_length_1725_cov_142.158057	803	867	477	1	64	0.0156250
NODE_1757_length_1725_cov_142.158057	803	867	487	1	64	0.0156250
NODE_1757_length_1725_cov_142.158057	803	867	489	1	64	0.0156250
NODE_1757_length_1725_cov_142.158057	803	867	494	2	64	0.0312500
NODE_1757_length_1725_cov_142.158057	803	867	500	1	64	0.0156250
NODE_1757_length_1725_cov_142.158057	803	867	504	1	64	0.0156250
NODE_1757_length_1725_cov_142.158057	803	867	506	1	64	0.0156250
NODE_1757_length_1725_cov_142.158057	803	867	508	3	64	0.0468750
NODE_1757_length_1725_cov_142.158057	803	867	510	1	64	0.0156250
NODE_1757_length_1725_cov_142.158057	803	867	512	1	64	0.0156250
NODE_1757_length_1725_cov_142.158057	803	867	516	1	64	0.0156250
NODE_1757_length_1725_cov_142.158057	803	867	520	1	64	0.0156250
NODE_1757_length_1725_cov_142.158057	803	867	522	2	64	0.0312500
NODE_1757_length_1725_cov_142.158057	803	867	524	1	64	0.0156250
NODE_1757_length_1725_cov_142.158057	803	867	525	1	64	0.0156250
NODE_1757_length_1725_cov_142.158057	803	867	530	1	64	0.0156250
NODE_1757_length_1725_cov_142.158057	803	867	532	2	64	0.0312500
NODE_1757_length_1725_cov_142.158057	803	867	533	2	64	0.0312500
NODE_1757_length_1725_cov_142.158057	803	867	534	1	64	0.0156250
NODE_1757_length_1725_cov_142.158057	803	867	535	1	64	0.0156250
NODE_1757_length_1725_cov_142.158057	803	867	536	4	64	0.0625000
NODE_1757_length_1725_cov_142.158057	803	867	537	3	64	0.0468750
NODE_1757_length_1725_cov_142.158057	803	867	538	1	64	0.0156250
NODE_1757_length_1725_cov_142.158057	803	867	539	1	64	0.0156250
NODE_1757_length_1725_cov_142.158057	803	867	540	1	64	0.0156250
NODE_1757_length_1725_cov_142.158057	803	867	541	3	64	0.0468750
NODE_1757_length_1725_cov_142.158057	803	867	542	3	64	0.0468750
NODE_1757_length_1725_cov_142.158057	803	867	543	1	64	0.0156250
NODE_1757_length_1725_cov_142.158057	803	867	544	1	64	0.0156250
NODE_1757_length_1725_cov_142.158057	803	867	545	1	64	0.0156250
NODE_1757_length_1725_cov_142.158057	803	867	550	1	64	0.0156250
NODE_1759_length_1724_cov_17.931077	677	746	0	69	69	1.0000000
NODE_1759_length_1724_cov_17.931077	788	850	0	31	62	0.5000000
NODE_1759_length_1724_cov_17.931077	788	850	2	31	62	0.5000000
NODE_1761_length_1723_cov_35.355296	1174	1254	0	22	80	0.2750000
NODE_1761_length_1723_cov_35.355296	1174	1254	2	8	80	0.1000000
NODE_1761_length_1723_cov_35.355296	1174	1254	4	50	80	0.6250000
NODE_1761_length_1723_cov_35.355296	1227	1307	0	15	80	0.1875000
NODE_1761_length_1723_cov_35.355296	1227	1307	2	5	80	0.0625000
NODE_1761_length_1723_cov_35.355296	1227	1307	4	60	80	0.7500000
NODE_1763_length_1722_cov_13.235367	708	788	0	66	80	0.8250000
NODE_1763_length_1722_cov_13.235367	708	788	2	14	80	0.1750000
NODE_1763_length_1722_cov_13.235367	761	841	0	13	80	0.1625000
NODE_1763_length_1722_cov_13.235367	761	841	2	67	80	0.8375000
NODE_1763_length_1722_cov_13.235367	1319	1399	0	80	80	1.0000000
NODE_1763_length_1722_cov_13.235367	1372	1452	0	80	80	1.0000000
NODE_1765_length_1720_cov_27.328192	1248	1307	16	8	59	0.1355932
NODE_1765_length_1720_cov_27.328192	1248	1307	18	10	59	0.1694915
NODE_1765_length_1720_cov_27.328192	1248	1307	24	1	59	0.0169492
NODE_1765_length_1720_cov_27.328192	1248	1307	26	2	59	0.0338983
NODE_1765_length_1720_cov_27.328192	1248	1307	28	6	59	0.1016949
NODE_1765_length_1720_cov_27.328192	1248	1307	30	4	59	0.0677966
NODE_1765_length_1720_cov_27.328192	1248	1307	32	1	59	0.0169492
NODE_1765_length_1720_cov_27.328192	1248	1307	34	21	59	0.3559322
NODE_1765_length_1720_cov_27.328192	1248	1307	36	2	59	0.0338983
NODE_1765_length_1720_cov_27.328192	1248	1307	38	4	59	0.0677966
NODE_1765_length_1720_cov_27.328192	1280	1360	24	2	80	0.0250000
NODE_1765_length_1720_cov_27.328192	1280	1360	26	9	80	0.1125000
NODE_1765_length_1720_cov_27.328192	1280	1360	30	32	80	0.4000000
NODE_1765_length_1720_cov_27.328192	1280	1360	34	31	80	0.3875000
NODE_1765_length_1720_cov_27.328192	1280	1360	36	2	80	0.0250000
NODE_1765_length_1720_cov_27.328192	1280	1360	38	4	80	0.0500000
NODE_1766_length_1720_cov_4.129550	241	321	0	80	80	1.0000000
NODE_1766_length_1720_cov_4.129550	294	374	0	80	80	1.0000000
NODE_1768_length_1719_cov_9.878395	410	490	0	80	80	1.0000000
NODE_1768_length_1719_cov_9.878395	463	543	0	80	80	1.0000000
NODE_1768_length_1719_cov_9.878395	539	619	0	35	80	0.4375000
NODE_1768_length_1719_cov_9.878395	539	619	2	45	80	0.5625000
NODE_1768_length_1719_cov_9.878395	592	672	0	23	80	0.2875000
NODE_1768_length_1719_cov_9.878395	592	672	2	57	80	0.7125000
NODE_1772_length_1717_cov_5.159456	145	219	2	6	74	0.0810811
NODE_1772_length_1717_cov_5.159456	145	219	4	1	74	0.0135135
NODE_1772_length_1717_cov_5.159456	145	219	7	5	74	0.0675676
NODE_1772_length_1717_cov_5.159456	145	219	9	5	74	0.0675676
NODE_1772_length_1717_cov_5.159456	145	219	10	8	74	0.1081081
NODE_1772_length_1717_cov_5.159456	145	219	20	4	74	0.0540541
NODE_1772_length_1717_cov_5.159456	145	219	23	3	74	0.0405405
NODE_1772_length_1717_cov_5.159456	145	219	25	1	74	0.0135135
NODE_1772_length_1717_cov_5.159456	145	219	26	7	74	0.0945946
NODE_1772_length_1717_cov_5.159456	145	219	28	2	74	0.0270270
NODE_1772_length_1717_cov_5.159456	145	219	29	2	74	0.0270270
NODE_1772_length_1717_cov_5.159456	145	219	33	1	74	0.0135135
NODE_1772_length_1717_cov_5.159456	145	219	35	5	74	0.0675676
NODE_1772_length_1717_cov_5.159456	145	219	37	3	74	0.0405405
NODE_1772_length_1717_cov_5.159456	145	219	39	4	74	0.0540541
NODE_1772_length_1717_cov_5.159456	145	219	41	3	74	0.0405405
NODE_1772_length_1717_cov_5.159456	145	219	43	14	74	0.1891892
NODE_1772_length_1717_cov_5.159456	1450	1508	10	12	58	0.2068966
NODE_1772_length_1717_cov_5.159456	1450	1508	12	14	58	0.2413793
NODE_1772_length_1717_cov_5.159456	1450	1508	14	8	58	0.1379310
NODE_1772_length_1717_cov_5.159456	1450	1508	16	24	58	0.4137931
NODE_1772_length_1717_cov_5.159456	1503	1561	4	3	58	0.0517241
NODE_1772_length_1717_cov_5.159456	1503	1561	12	15	58	0.2586207
NODE_1772_length_1717_cov_5.159456	1503	1561	14	36	58	0.6206896
NODE_1772_length_1717_cov_5.159456	1503	1561	16	4	58	0.0689655
NODE_1778_length_1715_cov_12.607054	555	635	0	80	80	1.0000000
NODE_1778_length_1715_cov_12.607054	608	688	0	80	80	1.0000000
NODE_1778_length_1715_cov_12.607054	684	764	0	18	80	0.2250000
NODE_1778_length_1715_cov_12.607054	684	764	6	62	80	0.7750000
NODE_1778_length_1715_cov_12.607054	737	817	0	9	80	0.1125000
NODE_1778_length_1715_cov_12.607054	737	817	4	15	80	0.1875000
NODE_1778_length_1715_cov_12.607054	737	817	6	56	80	0.7000000
NODE_1788_length_1707_cov_16.909204	397	477	0	80	80	1.0000000
NODE_1788_length_1707_cov_16.909204	450	530	0	80	80	1.0000000
NODE_1788_length_1707_cov_16.909204	1151	1231	2	80	80	1.0000000
NODE_1788_length_1707_cov_16.909204	1204	1284	0	25	80	0.3125000
NODE_1788_length_1707_cov_16.909204	1204	1284	2	55	80	0.6875000
NODE_1792_length_1705_cov_19.645081	451	531	4	80	80	1.0000000
NODE_1792_length_1705_cov_19.645081	504	584	0	13	80	0.1625000
NODE_1792_length_1705_cov_19.645081	504	584	2	3	80	0.0375000
NODE_1792_length_1705_cov_19.645081	504	584	4	64	80	0.8000000
NODE_1792_length_1705_cov_19.645081	580	660	0	80	80	1.0000000
NODE_1792_length_1705_cov_19.645081	633	714	0	81	81	1.0000000
NODE_1792_length_1705_cov_19.645081	1315	1395	0	80	80	1.0000000
NODE_1792_length_1705_cov_19.645081	1368	1448	0	80	80	1.0000000
NODE_1796_length_1703_cov_26.016833	1201	1264	0	52	63	0.8253968
NODE_1796_length_1703_cov_26.016833	1201	1264	11	1	63	0.0158730
NODE_1796_length_1703_cov_26.016833	1201	1264	18	2	63	0.0317460
NODE_1796_length_1703_cov_26.016833	1201	1264	33	2	63	0.0317460
NODE_1796_length_1703_cov_26.016833	1201	1264	41	6	63	0.0952381
NODE_1796_length_1703_cov_26.016833	1207	1264	0	52	57	0.9122807
NODE_1796_length_1703_cov_26.016833	1207	1264	11	1	57	0.0175439
NODE_1796_length_1703_cov_26.016833	1207	1264	18	2	57	0.0350877
NODE_1796_length_1703_cov_26.016833	1207	1264	33	2	57	0.0350877
NODE_1796_length_1703_cov_26.016833	1207	1264	0	52	57	0.9122807
NODE_1796_length_1703_cov_26.016833	1207	1264	11	1	57	0.0175439
NODE_1796_length_1703_cov_26.016833	1207	1264	18	2	57	0.0350877
NODE_1796_length_1703_cov_26.016833	1207	1264	33	2	57	0.0350877
NODE_1799_length_1701_cov_15.969413	1490	1565	16	1	75	0.0133333
NODE_1799_length_1701_cov_15.969413	1490	1565	17	1	75	0.0133333
NODE_1799_length_1701_cov_15.969413	1490	1565	19	1	75	0.0133333
NODE_1799_length_1701_cov_15.969413	1490	1565	23	2	75	0.0266667
NODE_1799_length_1701_cov_15.969413	1490	1565	25	2	75	0.0266667
NODE_1799_length_1701_cov_15.969413	1490	1565	27	1	75	0.0133333
NODE_1799_length_1701_cov_15.969413	1490	1565	28	6	75	0.0800000
NODE_1799_length_1701_cov_15.969413	1490	1565	30	1	75	0.0133333
NODE_1799_length_1701_cov_15.969413	1490	1565	34	2	75	0.0266667
NODE_1799_length_1701_cov_15.969413	1490	1565	38	6	75	0.0800000
NODE_1799_length_1701_cov_15.969413	1490	1565	42	5	75	0.0666667
NODE_1799_length_1701_cov_15.969413	1490	1565	45	1	75	0.0133333
NODE_1799_length_1701_cov_15.969413	1490	1565	48	9	75	0.1200000
NODE_1799_length_1701_cov_15.969413	1490	1565	51	5	75	0.0666667
NODE_1799_length_1701_cov_15.969413	1490	1565	53	1	75	0.0133333
NODE_1799_length_1701_cov_15.969413	1490	1565	56	1	75	0.0133333
NODE_1799_length_1701_cov_15.969413	1490	1565	59	3	75	0.0400000
NODE_1799_length_1701_cov_15.969413	1490	1565	61	3	75	0.0400000
NODE_1799_length_1701_cov_15.969413	1490	1565	63	2	75	0.0266667
NODE_1799_length_1701_cov_15.969413	1490	1565	64	8	75	0.1066667
NODE_1799_length_1701_cov_15.969413	1490	1565	66	2	75	0.0266667
NODE_1799_length_1701_cov_15.969413	1490	1565	69	2	75	0.0266667
NODE_1799_length_1701_cov_15.969413	1490	1565	73	1	75	0.0133333
NODE_1799_length_1701_cov_15.969413	1490	1565	74	2	75	0.0266667
NODE_1799_length_1701_cov_15.969413	1490	1565	84	2	75	0.0266667
NODE_1799_length_1701_cov_15.969413	1490	1565	86	1	75	0.0133333
NODE_1799_length_1701_cov_15.969413	1490	1565	88	3	75	0.0400000
NODE_1799_length_1701_cov_15.969413	1490	1565	92	1	75	0.0133333
NODE_1799_length_1701_cov_15.969413	1538	1603	61	3	65	0.0461538
NODE_1799_length_1701_cov_15.969413	1538	1603	63	2	65	0.0307692
NODE_1799_length_1701_cov_15.969413	1538	1603	64	8	65	0.1230769
NODE_1799_length_1701_cov_15.969413	1538	1603	66	2	65	0.0307692
NODE_1799_length_1701_cov_15.969413	1538	1603	69	2	65	0.0307692
NODE_1799_length_1701_cov_15.969413	1538	1603	73	1	65	0.0153846
NODE_1799_length_1701_cov_15.969413	1538	1603	74	2	65	0.0307692
NODE_1799_length_1701_cov_15.969413	1538	1603	84	2	65	0.0307692
NODE_1799_length_1701_cov_15.969413	1538	1603	86	1	65	0.0153846
NODE_1799_length_1701_cov_15.969413	1538	1603	88	3	65	0.0461538
NODE_1799_length_1701_cov_15.969413	1538	1603	92	1	65	0.0153846
NODE_1799_length_1701_cov_15.969413	1538	1603	94	2	65	0.0307692
NODE_1799_length_1701_cov_15.969413	1538	1603	98	13	65	0.2000000
NODE_1799_length_1701_cov_15.969413	1538	1603	100	4	65	0.0615385
NODE_1799_length_1701_cov_15.969413	1538	1603	106	9	65	0.1384615
NODE_1799_length_1701_cov_15.969413	1538	1603	108	1	65	0.0153846
NODE_1799_length_1701_cov_15.969413	1538	1603	110	3	65	0.0461538
NODE_1799_length_1701_cov_15.969413	1538	1603	112	6	65	0.0923077
NODE_1800_length_1701_cov_13.549313	607	687	2	26	80	0.3250000
NODE_1800_length_1701_cov_13.549313	607	687	4	54	80	0.6750000
NODE_1800_length_1701_cov_13.549313	660	740	2	27	80	0.3375000
NODE_1800_length_1701_cov_13.549313	660	740	4	53	80	0.6625000
NODE_1805_length_1700_cov_20.003123	1168	1197	179	2	29	0.0689655
NODE_1805_length_1700_cov_20.003123	1168	1197	180	1	29	0.0344828
NODE_1805_length_1700_cov_20.003123	1168	1197	183	2	29	0.0689655
NODE_1805_length_1700_cov_20.003123	1168	1197	185	2	29	0.0689655
NODE_1805_length_1700_cov_20.003123	1168	1197	186	2	29	0.0689655
NODE_1805_length_1700_cov_20.003123	1168	1197	187	4	29	0.1379310
NODE_1805_length_1700_cov_20.003123	1168	1197	188	1	29	0.0344828
NODE_1805_length_1700_cov_20.003123	1168	1197	189	1	29	0.0344828
NODE_1805_length_1700_cov_20.003123	1168	1197	191	1	29	0.0344828
NODE_1805_length_1700_cov_20.003123	1168	1197	193	1	29	0.0344828
NODE_1805_length_1700_cov_20.003123	1168	1197	195	1	29	0.0344828
NODE_1805_length_1700_cov_20.003123	1168	1197	207	1	29	0.0344828
NODE_1805_length_1700_cov_20.003123	1168	1197	211	1	29	0.0344828
NODE_1805_length_1700_cov_20.003123	1168	1197	219	1	29	0.0344828
NODE_1805_length_1700_cov_20.003123	1168	1197	225	2	29	0.0689655
NODE_1805_length_1700_cov_20.003123	1168	1197	227	1	29	0.0344828
NODE_1805_length_1700_cov_20.003123	1168	1197	229	1	29	0.0344828
NODE_1805_length_1700_cov_20.003123	1168	1197	232	1	29	0.0344828
NODE_1805_length_1700_cov_20.003123	1168	1197	234	1	29	0.0344828
NODE_1805_length_1700_cov_20.003123	1168	1197	242	1	29	0.0344828
NODE_1805_length_1700_cov_20.003123	1168	1197	243	1	29	0.0344828
NODE_1805_length_1700_cov_20.003123	1184	1263	177	1	79	0.0126582
NODE_1805_length_1700_cov_20.003123	1184	1263	179	3	79	0.0379747
NODE_1805_length_1700_cov_20.003123	1184	1263	180	1	79	0.0126582
NODE_1805_length_1700_cov_20.003123	1184	1263	181	1	79	0.0126582
NODE_1805_length_1700_cov_20.003123	1184	1263	183	4	79	0.0506329
NODE_1805_length_1700_cov_20.003123	1184	1263	185	3	79	0.0379747
NODE_1805_length_1700_cov_20.003123	1184	1263	186	2	79	0.0253165
NODE_1805_length_1700_cov_20.003123	1184	1263	187	3	79	0.0379747
NODE_1805_length_1700_cov_20.003123	1184	1263	188	1	79	0.0126582
NODE_1805_length_1700_cov_20.003123	1184	1263	189	2	79	0.0253165
NODE_1805_length_1700_cov_20.003123	1184	1263	190	2	79	0.0253165
NODE_1805_length_1700_cov_20.003123	1184	1263	191	1	79	0.0126582
NODE_1805_length_1700_cov_20.003123	1184	1263	194	1	79	0.0126582
NODE_1805_length_1700_cov_20.003123	1184	1263	195	1	79	0.0126582
NODE_1805_length_1700_cov_20.003123	1184	1263	205	1	79	0.0126582
NODE_1805_length_1700_cov_20.003123	1184	1263	208	1	79	0.0126582
NODE_1805_length_1700_cov_20.003123	1184	1263	212	2	79	0.0253165
NODE_1805_length_1700_cov_20.003123	1184	1263	214	1	79	0.0126582
NODE_1805_length_1700_cov_20.003123	1184	1263	218	1	79	0.0126582
NODE_1805_length_1700_cov_20.003123	1184	1263	222	1	79	0.0126582
NODE_1805_length_1700_cov_20.003123	1184	1263	224	1	79	0.0126582
NODE_1805_length_1700_cov_20.003123	1184	1263	225	1	79	0.0126582
NODE_1805_length_1700_cov_20.003123	1184	1263	236	1	79	0.0126582
NODE_1805_length_1700_cov_20.003123	1184	1263	240	2	79	0.0253165
NODE_1805_length_1700_cov_20.003123	1184	1263	248	2	79	0.0253165
NODE_1805_length_1700_cov_20.003123	1184	1263	250	1	79	0.0126582
NODE_1805_length_1700_cov_20.003123	1184	1263	252	3	79	0.0379747
NODE_1805_length_1700_cov_20.003123	1184	1263	263	2	79	0.0253165
NODE_1805_length_1700_cov_20.003123	1184	1263	265	3	79	0.0379747
NODE_1805_length_1700_cov_20.003123	1184	1263	273	1	79	0.0126582
NODE_1805_length_1700_cov_20.003123	1184	1263	276	1	79	0.0126582
NODE_1805_length_1700_cov_20.003123	1184	1263	277	3	79	0.0379747
NODE_1805_length_1700_cov_20.003123	1184	1263	279	3	79	0.0379747
NODE_1805_length_1700_cov_20.003123	1184	1263	282	1	79	0.0126582
NODE_1805_length_1700_cov_20.003123	1184	1263	283	3	79	0.0379747
NODE_1805_length_1700_cov_20.003123	1184	1263	284	2	79	0.0253165
NODE_1805_length_1700_cov_20.003123	1184	1263	287	2	79	0.0253165
NODE_1805_length_1700_cov_20.003123	1184	1263	291	3	79	0.0379747
NODE_1805_length_1700_cov_20.003123	1184	1263	292	1	79	0.0126582
NODE_1805_length_1700_cov_20.003123	1184	1263	293	4	79	0.0506329
NODE_1805_length_1700_cov_20.003123	1184	1263	294	2	79	0.0253165
NODE_1805_length_1700_cov_20.003123	1184	1263	296	2	79	0.0253165
NODE_1805_length_1700_cov_20.003123	1184	1263	297	2	79	0.0253165
NODE_1810_length_1698_cov_19.175735	1001	1081	0	11	80	0.1375000
NODE_1810_length_1698_cov_19.175735	1001	1081	2	69	80	0.8625000
NODE_1810_length_1698_cov_19.175735	1054	1134	0	64	80	0.8000000
NODE_1810_length_1698_cov_19.175735	1054	1134	2	16	80	0.2000000
NODE_1814_length_1696_cov_11.494678	590	670	2	8	80	0.1000000
NODE_1814_length_1696_cov_11.494678	590	670	4	72	80	0.9000000
NODE_1814_length_1696_cov_11.494678	643	723	0	41	80	0.5125000
NODE_1814_length_1696_cov_11.494678	643	723	2	20	80	0.2500000
NODE_1814_length_1696_cov_11.494678	643	723	4	19	80	0.2375000
NODE_1815_length_1696_cov_6.620539	369	449	0	53	80	0.6625000
NODE_1815_length_1696_cov_6.620539	369	449	2	27	80	0.3375000
NODE_1815_length_1696_cov_6.620539	422	502	0	2	80	0.0250000
NODE_1815_length_1696_cov_6.620539	422	502	2	78	80	0.9750000
NODE_1816_length_1695_cov_27.783208	399	479	6	57	80	0.7125000
NODE_1816_length_1695_cov_27.783208	399	479	8	23	80	0.2875000
NODE_1816_length_1695_cov_27.783208	452	532	0	17	80	0.2125000
NODE_1816_length_1695_cov_27.783208	452	532	2	25	80	0.3125000
NODE_1816_length_1695_cov_27.783208	452	532	6	38	80	0.4750000
NODE_1817_length_1695_cov_12.084586	1047	1127	0	56	80	0.7000000
NODE_1817_length_1695_cov_12.084586	1047	1127	2	24	80	0.3000000
NODE_1817_length_1695_cov_12.084586	1100	1180	0	80	80	1.0000000
NODE_1825_length_1692_cov_4.557439	727	807	0	80	80	1.0000000
NODE_1825_length_1692_cov_4.557439	780	860	0	80	80	1.0000000
NODE_1830_length_1689_cov_5.844025	1210	1285	2	28	75	0.3733333
NODE_1830_length_1689_cov_5.844025	1210	1285	4	47	75	0.6266667
NODE_1830_length_1689_cov_5.844025	1260	1338	2	33	78	0.4230769
NODE_1830_length_1689_cov_5.844025	1260	1338	4	28	78	0.3589744
NODE_1830_length_1689_cov_5.844025	1260	1338	6	17	78	0.2179487
NODE_1837_length_1682_cov_14.416930	1183	1263	0	16	80	0.2000000
NODE_1837_length_1682_cov_14.416930	1183	1263	2	1	80	0.0125000
NODE_1837_length_1682_cov_14.416930	1183	1263	4	1	80	0.0125000
NODE_1837_length_1682_cov_14.416930	1183	1263	6	62	80	0.7750000
NODE_1837_length_1682_cov_14.416930	1236	1315	0	68	79	0.8607595
NODE_1837_length_1682_cov_14.416930	1236	1315	2	1	79	0.0126582
NODE_1837_length_1682_cov_14.416930	1236	1315	6	10	79	0.1265823
NODE_1843_length_1678_cov_23.965168	636	716	0	75	80	0.9375000
NODE_1843_length_1678_cov_23.965168	636	716	1	5	80	0.0625000
NODE_1843_length_1678_cov_23.965168	689	769	0	22	80	0.2750000
NODE_1843_length_1678_cov_23.965168	689	769	1	13	80	0.1625000
NODE_1843_length_1678_cov_23.965168	689	769	2	32	80	0.4000000
NODE_1843_length_1678_cov_23.965168	689	769	4	13	80	0.1625000
NODE_1843_length_1678_cov_23.965168	1145	1225	0	80	80	1.0000000
NODE_1843_length_1678_cov_23.965168	1198	1278	0	80	80	1.0000000
NODE_1846_length_1677_cov_3.578580	407	487	2	6	80	0.0750000
NODE_1846_length_1677_cov_3.578580	407	487	3	74	80	0.9250000
NODE_1846_length_1677_cov_3.578580	460	530	0	20	70	0.2857143
NODE_1846_length_1677_cov_3.578580	460	530	2	29	70	0.4142857
NODE_1846_length_1677_cov_3.578580	460	530	3	21	70	0.3000000
NODE_1846_length_1677_cov_3.578580	666	724	0	17	58	0.2931035
NODE_1846_length_1677_cov_3.578580	666	724	2	21	58	0.3620690
NODE_1846_length_1677_cov_3.578580	666	724	4	20	58	0.3448276
NODE_1856_length_1670_cov_29.264163	741	821	0	80	80	1.0000000
NODE_1856_length_1670_cov_29.264163	794	874	0	80	80	1.0000000
NODE_1857_length_1669_cov_5.913376	246	326	2	75	80	0.9375000
NODE_1857_length_1669_cov_5.913376	246	326	4	5	80	0.0625000
NODE_1857_length_1669_cov_5.913376	299	379	2	75	80	0.9375000
NODE_1857_length_1669_cov_5.913376	299	379	4	5	80	0.0625000
NODE_1860_length_1668_cov_18.372212	1100	1180	0	26	80	0.3250000
NODE_1860_length_1668_cov_18.372212	1100	1180	2	54	80	0.6750000
NODE_1860_length_1668_cov_18.372212	1153	1233	0	21	80	0.2625000
NODE_1860_length_1668_cov_18.372212	1153	1233	2	59	80	0.7375000
NODE_1861_length_1667_cov_15.651786	902	982	16	35	80	0.4375000
NODE_1861_length_1667_cov_15.651786	902	982	18	15	80	0.1875000
NODE_1861_length_1667_cov_15.651786	902	982	20	19	80	0.2375000
NODE_1861_length_1667_cov_15.651786	902	982	22	11	80	0.1375000
NODE_1861_length_1667_cov_15.651786	955	1035	20	69	80	0.8625000
NODE_1861_length_1667_cov_15.651786	955	1035	22	11	80	0.1375000
NODE_1862_length_1667_cov_3.661352	649	679	0	30	30	1.0000000
NODE_1865_length_1666_cov_4.601149	1541	1623	0	82	82	1.0000000
NODE_1865_length_1666_cov_4.601149	1553	1613	0	60	60	1.0000000
NODE_1865_length_1666_cov_4.601149	1553	1613	0	60	60	1.0000000
NODE_1865_length_1666_cov_4.601149	1557	1623	0	66	66	1.0000000
NODE_1865_length_1666_cov_4.601149	1596	1666	0	70	70	1.0000000
NODE_1865_length_1666_cov_4.601149	1596	1666	0	70	70	1.0000000
NODE_1865_length_1666_cov_4.601149	1596	1666	0	70	70	1.0000000
NODE_1872_length_1662_cov_16.638516	538	618	4	62	80	0.7750000
NODE_1872_length_1662_cov_16.638516	538	618	6	18	80	0.2250000
NODE_1872_length_1662_cov_16.638516	591	671	2	45	80	0.5625000
NODE_1872_length_1662_cov_16.638516	591	671	4	9	80	0.1125000
NODE_1872_length_1662_cov_16.638516	591	671	6	25	80	0.3125000
NODE_1872_length_1662_cov_16.638516	591	671	8	1	80	0.0125000
NODE_1872_length_1662_cov_16.638516	667	747	2	1	80	0.0125000
NODE_1872_length_1662_cov_16.638516	667	747	6	2	80	0.0250000
NODE_1872_length_1662_cov_16.638516	667	747	8	7	80	0.0875000
NODE_1872_length_1662_cov_16.638516	667	747	10	9	80	0.1125000
NODE_1872_length_1662_cov_16.638516	667	747	12	7	80	0.0875000
NODE_1872_length_1662_cov_16.638516	667	747	13	1	80	0.0125000
NODE_1872_length_1662_cov_16.638516	667	747	15	13	80	0.1625000
NODE_1872_length_1662_cov_16.638516	667	747	16	40	80	0.5000000
NODE_1872_length_1662_cov_16.638516	720	800	2	18	80	0.2250000
NODE_1872_length_1662_cov_16.638516	720	800	10	5	80	0.0625000
NODE_1872_length_1662_cov_16.638516	720	800	12	2	80	0.0250000
NODE_1872_length_1662_cov_16.638516	720	800	14	14	80	0.1750000
NODE_1872_length_1662_cov_16.638516	720	800	16	41	80	0.5125000
NODE_1876_length_1660_cov_28.297886	415	495	2	61	80	0.7625000
NODE_1876_length_1660_cov_28.297886	415	495	4	19	80	0.2375000
NODE_1876_length_1660_cov_28.297886	468	548	2	46	80	0.5750000
NODE_1876_length_1660_cov_28.297886	468	548	4	34	80	0.4250000
NODE_1886_length_1654_cov_17.245016	631	711	2	2	80	0.0250000
NODE_1886_length_1654_cov_17.245016	631	711	6	47	80	0.5875000
NODE_1886_length_1654_cov_17.245016	631	711	8	31	80	0.3875000
NODE_1886_length_1654_cov_17.245016	684	764	0	2	80	0.0250000
NODE_1886_length_1654_cov_17.245016	684	764	2	37	80	0.4625000
NODE_1886_length_1654_cov_17.245016	684	764	6	33	80	0.4125000
NODE_1886_length_1654_cov_17.245016	684	764	8	8	80	0.1000000
NODE_1888_length_1653_cov_34.827542	0	41	0	41	41	1.0000000
NODE_1888_length_1653_cov_34.827542	14	44	0	30	30	1.0000000
NODE_1888_length_1653_cov_34.827542	1081	1161	6	8	80	0.1000000
NODE_1888_length_1653_cov_34.827542	1081	1161	8	61	80	0.7625000
NODE_1888_length_1653_cov_34.827542	1081	1161	10	11	80	0.1375000
NODE_1888_length_1653_cov_34.827542	1134	1214	8	20	80	0.2500000
NODE_1888_length_1653_cov_34.827542	1134	1214	10	24	80	0.3000000
NODE_1888_length_1653_cov_34.827542	1134	1214	12	10	80	0.1250000
NODE_1888_length_1653_cov_34.827542	1134	1214	16	1	80	0.0125000
NODE_1888_length_1653_cov_34.827542	1134	1214	18	2	80	0.0250000
NODE_1888_length_1653_cov_34.827542	1134	1214	20	3	80	0.0375000
NODE_1888_length_1653_cov_34.827542	1134	1214	22	8	80	0.1000000
NODE_1888_length_1653_cov_34.827542	1134	1214	24	7	80	0.0875000
NODE_1888_length_1653_cov_34.827542	1134	1214	25	1	80	0.0125000
NODE_1888_length_1653_cov_34.827542	1134	1214	26	4	80	0.0500000
NODE_1888_length_1653_cov_34.827542	1210	1290	16	3	80	0.0375000
NODE_1888_length_1653_cov_34.827542	1210	1290	18	1	80	0.0125000
NODE_1888_length_1653_cov_34.827542	1210	1290	20	16	80	0.2000000
NODE_1888_length_1653_cov_34.827542	1210	1290	22	46	80	0.5750000
NODE_1888_length_1653_cov_34.827542	1210	1290	24	14	80	0.1750000
NODE_1888_length_1653_cov_34.827542	1263	1339	8	20	76	0.2631579
NODE_1888_length_1653_cov_34.827542	1263	1339	12	12	76	0.1578947
NODE_1888_length_1653_cov_34.827542	1263	1339	14	8	76	0.1052632
NODE_1888_length_1653_cov_34.827542	1263	1339	16	12	76	0.1578947
NODE_1888_length_1653_cov_34.827542	1263	1339	18	1	76	0.0131579
NODE_1888_length_1653_cov_34.827542	1263	1339	20	13	76	0.1710526
NODE_1888_length_1653_cov_34.827542	1263	1339	22	7	76	0.0921053
NODE_1888_length_1653_cov_34.827542	1263	1339	24	3	76	0.0394737
NODE_1892_length_1652_cov_23.939472	1352	1432	0	80	80	1.0000000
NODE_1892_length_1652_cov_23.939472	1405	1485	0	80	80	1.0000000
NODE_1894_length_1651_cov_3.916881	1552	1617	1	2	65	0.0307692
NODE_1894_length_1651_cov_3.916881	1552	1617	2	1	65	0.0153846
NODE_1894_length_1651_cov_3.916881	1552	1617	4	62	65	0.9538462
NODE_1899_length_1649_cov_7.480000	774	854	5	4	80	0.0500000
NODE_1899_length_1649_cov_7.480000	774	854	6	76	80	0.9500000
NODE_1899_length_1649_cov_7.480000	827	907	0	7	80	0.0875000
NODE_1899_length_1649_cov_7.480000	827	907	2	41	80	0.5125000
NODE_1899_length_1649_cov_7.480000	827	907	6	32	80	0.4000000
NODE_1903_length_1647_cov_3.534238	1012	1075	0	63	63	1.0000000
NODE_1906_length_1645_cov_16.040103	155	235	0	43	80	0.5375000
NODE_1906_length_1645_cov_16.040103	155	235	2	37	80	0.4625000
NODE_1906_length_1645_cov_16.040103	208	288	0	80	80	1.0000000
NODE_1906_length_1645_cov_16.040103	1090	1170	8	8	80	0.1000000
NODE_1906_length_1645_cov_16.040103	1090	1170	10	72	80	0.9000000
NODE_1906_length_1645_cov_16.040103	1143	1222	0	27	79	0.3417721
NODE_1906_length_1645_cov_16.040103	1143	1222	8	33	79	0.4177215
NODE_1906_length_1645_cov_16.040103	1143	1222	10	19	79	0.2405063
NODE_1908_length_1644_cov_2.902913	1160	1240	12	2	80	0.0250000
NODE_1908_length_1644_cov_2.902913	1160	1240	13	1	80	0.0125000
NODE_1908_length_1644_cov_2.902913	1160	1240	14	1	80	0.0125000
NODE_1908_length_1644_cov_2.902913	1160	1240	15	3	80	0.0375000
NODE_1908_length_1644_cov_2.902913	1160	1240	16	44	80	0.5500000
NODE_1908_length_1644_cov_2.902913	1160	1240	17	1	80	0.0125000
NODE_1908_length_1644_cov_2.902913	1160	1240	18	28	80	0.3500000
NODE_1917_length_1641_cov_34.032425	487	567	1	21	80	0.2625000
NODE_1917_length_1641_cov_34.032425	487	567	2	5	80	0.0625000
NODE_1917_length_1641_cov_34.032425	487	567	4	25	80	0.3125000
NODE_1917_length_1641_cov_34.032425	487	567	5	29	80	0.3625000
NODE_1917_length_1641_cov_34.032425	540	620	0	20	80	0.2500000
NODE_1917_length_1641_cov_34.032425	540	620	4	58	80	0.7250000
NODE_1917_length_1641_cov_34.032425	540	620	5	2	80	0.0250000
NODE_1917_length_1641_cov_34.032425	616	696	0	18	80	0.2250000
NODE_1917_length_1641_cov_34.032425	616	696	2	3	80	0.0375000
NODE_1917_length_1641_cov_34.032425	616	696	6	59	80	0.7375000
NODE_1917_length_1641_cov_34.032425	669	749	4	13	80	0.1625000
NODE_1917_length_1641_cov_34.032425	669	749	6	67	80	0.8375000
NODE_1917_length_1641_cov_34.032425	1168	1248	0	58	80	0.7250000
NODE_1917_length_1641_cov_34.032425	1168	1248	4	22	80	0.2750000
NODE_1917_length_1641_cov_34.032425	1219	1301	0	7	82	0.0853659
NODE_1917_length_1641_cov_34.032425	1219	1301	2	2	82	0.0243902
NODE_1917_length_1641_cov_34.032425	1219	1301	4	38	82	0.4634146
NODE_1917_length_1641_cov_34.032425	1219	1301	6	35	82	0.4268293
NODE_1918_length_1641_cov_7.042802	339	390	0	51	51	1.0000000
NODE_1922_length_1640_cov_33.097339	943	1023	0	61	80	0.7625000
NODE_1922_length_1640_cov_33.097339	943	1023	2	9	80	0.1125000
NODE_1922_length_1640_cov_33.097339	943	1023	4	10	80	0.1250000
NODE_1922_length_1640_cov_33.097339	996	1076	0	8	80	0.1000000
NODE_1922_length_1640_cov_33.097339	996	1076	2	9	80	0.1125000
NODE_1922_length_1640_cov_33.097339	996	1076	4	63	80	0.7875000
NODE_1922_length_1640_cov_33.097339	1072	1152	0	22	80	0.2750000
NODE_1922_length_1640_cov_33.097339	1072	1152	2	40	80	0.5000000
NODE_1922_length_1640_cov_33.097339	1072	1152	4	18	80	0.2250000
NODE_1922_length_1640_cov_33.097339	1125	1206	0	2	81	0.0246914
NODE_1922_length_1640_cov_33.097339	1125	1206	2	79	81	0.9753087
NODE_1923_length_1640_cov_18.519143	471	551	0	80	80	1.0000000
NODE_1923_length_1640_cov_18.519143	524	604	0	34	80	0.4250000
NODE_1923_length_1640_cov_18.519143	524	604	2	19	80	0.2375000
NODE_1923_length_1640_cov_18.519143	524	604	4	26	80	0.3250000
NODE_1923_length_1640_cov_18.519143	524	604	6	1	80	0.0125000
NODE_1925_length_1639_cov_6.585714	975	1056	0	81	81	1.0000000
NODE_1925_length_1639_cov_6.585714	1028	1109	0	81	81	1.0000000
NODE_1926_length_1639_cov_2.163636	1260	1334	2	21	74	0.2837838
NODE_1926_length_1639_cov_2.163636	1260	1334	3	23	74	0.3108108
NODE_1926_length_1639_cov_2.163636	1260	1334	4	5	74	0.0675676
NODE_1926_length_1639_cov_2.163636	1260	1334	5	25	74	0.3378378
NODE_1926_length_1639_cov_2.163636	1312	1387	1	32	75	0.4266667
NODE_1926_length_1639_cov_2.163636	1312	1387	3	43	75	0.5733333
NODE_1928_length_1638_cov_18.598441	443	523	0	3	80	0.0375000
NODE_1928_length_1638_cov_18.598441	443	523	2	77	80	0.9625000
NODE_1928_length_1638_cov_18.598441	496	576	0	48	80	0.6000000
NODE_1928_length_1638_cov_18.598441	496	576	2	32	80	0.4000000
NODE_1928_length_1638_cov_18.598441	1157	1237	0	80	80	1.0000000
NODE_1928_length_1638_cov_18.598441	1210	1290	0	80	80	1.0000000
NODE_1932_length_1637_cov_12.048765	410	490	0	5	80	0.0625000
NODE_1932_length_1637_cov_12.048765	410	490	2	75	80	0.9375000
NODE_1932_length_1637_cov_12.048765	463	543	0	17	80	0.2125000
NODE_1932_length_1637_cov_12.048765	463	543	2	63	80	0.7875000
NODE_1932_length_1637_cov_12.048765	1081	1161	0	80	80	1.0000000
NODE_1932_length_1637_cov_12.048765	1134	1214	0	80	80	1.0000000
NODE_1934_length_1635_cov_21.022786	958	1038	0	80	80	1.0000000
NODE_1934_length_1635_cov_21.022786	1011	1091	0	80	80	1.0000000
NODE_1934_length_1635_cov_21.022786	1087	1167	0	80	80	1.0000000
NODE_1934_length_1635_cov_21.022786	1140	1220	0	80	80	1.0000000
NODE_1936_length_1633_cov_16.743807	1067	1147	4	17	80	0.2125000
NODE_1936_length_1633_cov_16.743807	1067	1147	6	15	80	0.1875000
NODE_1936_length_1633_cov_16.743807	1067	1147	8	48	80	0.6000000
NODE_1936_length_1633_cov_16.743807	1120	1200	0	26	80	0.3250000
NODE_1936_length_1633_cov_16.743807	1120	1200	1	1	80	0.0125000
NODE_1936_length_1633_cov_16.743807	1120	1200	4	11	80	0.1375000
NODE_1936_length_1633_cov_16.743807	1120	1200	6	14	80	0.1750000
NODE_1936_length_1633_cov_16.743807	1120	1200	8	28	80	0.3500000
NODE_1937_length_1633_cov_14.271838	977	1057	0	16	80	0.2000000
NODE_1937_length_1633_cov_14.271838	977	1057	2	64	80	0.8000000
NODE_1937_length_1633_cov_14.271838	1030	1110	0	69	80	0.8625000
NODE_1937_length_1633_cov_14.271838	1030	1110	2	11	80	0.1375000
NODE_1937_length_1633_cov_14.271838	1106	1186	0	5	80	0.0625000
NODE_1937_length_1633_cov_14.271838	1106	1186	2	75	80	0.9375000
NODE_1937_length_1633_cov_14.271838	1159	1239	2	80	80	1.0000000
NODE_1939_length_1631_cov_25.881201	424	504	0	19	80	0.2375000
NODE_1939_length_1631_cov_25.881201	424	504	2	17	80	0.2125000
NODE_1939_length_1631_cov_25.881201	424	504	4	8	80	0.1000000
NODE_1939_length_1631_cov_25.881201	424	504	6	36	80	0.4500000
NODE_1939_length_1631_cov_25.881201	477	557	0	4	80	0.0500000
NODE_1939_length_1631_cov_25.881201	477	557	2	22	80	0.2750000
NODE_1939_length_1631_cov_25.881201	477	557	4	4	80	0.0500000
NODE_1939_length_1631_cov_25.881201	477	557	6	50	80	0.6250000
NODE_1939_length_1631_cov_25.881201	553	633	2	74	80	0.9250000
NODE_1939_length_1631_cov_25.881201	553	633	4	6	80	0.0750000
NODE_1939_length_1631_cov_25.881201	606	686	2	47	80	0.5875000
NODE_1939_length_1631_cov_25.881201	606	686	4	33	80	0.4125000
NODE_1943_length_1629_cov_32.733987	518	598	0	80	80	1.0000000
NODE_1943_length_1629_cov_32.733987	635	715	0	27	80	0.3375000
NODE_1943_length_1629_cov_32.733987	635	715	2	18	80	0.2250000
NODE_1943_length_1629_cov_32.733987	635	715	4	2	80	0.0250000
NODE_1943_length_1629_cov_32.733987	635	715	16	23	80	0.2875000
NODE_1943_length_1629_cov_32.733987	635	715	22	10	80	0.1250000
NODE_1943_length_1629_cov_32.733987	688	768	16	17	80	0.2125000
NODE_1943_length_1629_cov_32.733987	688	768	22	56	80	0.7000000
NODE_1943_length_1629_cov_32.733987	688	768	23	1	80	0.0125000
NODE_1943_length_1629_cov_32.733987	688	768	24	6	80	0.0750000
NODE_1946_length_1628_cov_15.551995	1454	1518	212	1	64	0.0156250
NODE_1946_length_1628_cov_15.551995	1454	1518	218	1	64	0.0156250
NODE_1946_length_1628_cov_15.551995	1454	1518	227	1	64	0.0156250
NODE_1946_length_1628_cov_15.551995	1454	1518	237	1	64	0.0156250
NODE_1946_length_1628_cov_15.551995	1454	1518	255	1	64	0.0156250
NODE_1946_length_1628_cov_15.551995	1454	1518	272	1	64	0.0156250
NODE_1946_length_1628_cov_15.551995	1454	1518	275	1	64	0.0156250
NODE_1946_length_1628_cov_15.551995	1454	1518	280	1	64	0.0156250
NODE_1946_length_1628_cov_15.551995	1454	1518	281	1	64	0.0156250
NODE_1946_length_1628_cov_15.551995	1454	1518	291	1	64	0.0156250
NODE_1946_length_1628_cov_15.551995	1454	1518	294	1	64	0.0156250
NODE_1946_length_1628_cov_15.551995	1454	1518	308	1	64	0.0156250
NODE_1946_length_1628_cov_15.551995	1454	1518	312	1	64	0.0156250
NODE_1946_length_1628_cov_15.551995	1454	1518	336	1	64	0.0156250
NODE_1946_length_1628_cov_15.551995	1454	1518	346	1	64	0.0156250
NODE_1946_length_1628_cov_15.551995	1454	1518	350	1	64	0.0156250
NODE_1946_length_1628_cov_15.551995	1454	1518	352	1	64	0.0156250
NODE_1946_length_1628_cov_15.551995	1454	1518	369	1	64	0.0156250
NODE_1946_length_1628_cov_15.551995	1454	1518	373	1	64	0.0156250
NODE_1946_length_1628_cov_15.551995	1454	1518	374	1	64	0.0156250
NODE_1946_length_1628_cov_15.551995	1454	1518	385	2	64	0.0312500
NODE_1946_length_1628_cov_15.551995	1454	1518	399	1	64	0.0156250
NODE_1946_length_1628_cov_15.551995	1454	1518	424	1	64	0.0156250
NODE_1946_length_1628_cov_15.551995	1454	1518	431	2	64	0.0312500
NODE_1946_length_1628_cov_15.551995	1454	1518	451	1	64	0.0156250
NODE_1946_length_1628_cov_15.551995	1454	1518	458	1	64	0.0156250
NODE_1946_length_1628_cov_15.551995	1454	1518	472	1	64	0.0156250
NODE_1946_length_1628_cov_15.551995	1454	1518	475	1	64	0.0156250
NODE_1946_length_1628_cov_15.551995	1454	1518	490	1	64	0.0156250
NODE_1946_length_1628_cov_15.551995	1454	1518	495	1	64	0.0156250
NODE_1946_length_1628_cov_15.551995	1454	1518	501	1	64	0.0156250
NODE_1946_length_1628_cov_15.551995	1454	1518	508	1	64	0.0156250
NODE_1946_length_1628_cov_15.551995	1454	1518	513	1	64	0.0156250
NODE_1946_length_1628_cov_15.551995	1454	1518	514	1	64	0.0156250
NODE_1946_length_1628_cov_15.551995	1454	1518	516	4	64	0.0625000
NODE_1946_length_1628_cov_15.551995	1454	1518	522	1	64	0.0156250
NODE_1946_length_1628_cov_15.551995	1454	1518	528	1	64	0.0156250
NODE_1946_length_1628_cov_15.551995	1454	1518	532	1	64	0.0156250
NODE_1946_length_1628_cov_15.551995	1454	1518	534	1	64	0.0156250
NODE_1946_length_1628_cov_15.551995	1454	1518	542	1	64	0.0156250
NODE_1946_length_1628_cov_15.551995	1454	1518	554	1	64	0.0156250
NODE_1946_length_1628_cov_15.551995	1454	1518	556	1	64	0.0156250
NODE_1946_length_1628_cov_15.551995	1454	1518	568	1	64	0.0156250
NODE_1946_length_1628_cov_15.551995	1454	1518	570	1	64	0.0156250
NODE_1946_length_1628_cov_15.551995	1454	1518	579	2	64	0.0312500
NODE_1946_length_1628_cov_15.551995	1454	1518	587	1	64	0.0156250
NODE_1946_length_1628_cov_15.551995	1454	1518	590	1	64	0.0156250
NODE_1946_length_1628_cov_15.551995	1454	1518	594	2	64	0.0312500
NODE_1946_length_1628_cov_15.551995	1454	1518	598	1	64	0.0156250
NODE_1946_length_1628_cov_15.551995	1454	1518	604	1	64	0.0156250
NODE_1946_length_1628_cov_15.551995	1454	1518	606	2	64	0.0312500
NODE_1946_length_1628_cov_15.551995	1454	1518	608	1	64	0.0156250
NODE_1946_length_1628_cov_15.551995	1454	1518	614	1	64	0.0156250
NODE_1946_length_1628_cov_15.551995	1454	1518	616	3	64	0.0468750
NODE_1947_length_1628_cov_4.852845	81	163	32	3	82	0.0365854
NODE_1947_length_1628_cov_4.852845	81	163	34	13	82	0.1585366
NODE_1947_length_1628_cov_4.852845	81	163	36	8	82	0.0975610
NODE_1947_length_1628_cov_4.852845	81	163	38	7	82	0.0853659
NODE_1947_length_1628_cov_4.852845	81	163	40	14	82	0.1707317
NODE_1947_length_1628_cov_4.852845	81	163	42	13	82	0.1585366
NODE_1947_length_1628_cov_4.852845	81	163	44	11	82	0.1341463
NODE_1947_length_1628_cov_4.852845	81	163	46	13	82	0.1585366
NODE_1952_length_1626_cov_20.549443	495	575	0	20	80	0.2500000
NODE_1952_length_1626_cov_20.549443	495	575	2	60	80	0.7500000
NODE_1952_length_1626_cov_20.549443	548	628	0	25	80	0.3125000
NODE_1952_length_1626_cov_20.549443	548	628	2	55	80	0.6875000
NODE_1953_length_1626_cov_6.552718	1189	1269	0	20	80	0.2500000
NODE_1953_length_1626_cov_6.552718	1189	1269	2	7	80	0.0875000
NODE_1953_length_1626_cov_6.552718	1189	1269	6	1	80	0.0125000
NODE_1953_length_1626_cov_6.552718	1189	1269	8	52	80	0.6500000
NODE_1953_length_1626_cov_6.552718	1242	1321	6	7	79	0.0886076
NODE_1953_length_1626_cov_6.552718	1242	1321	8	72	79	0.9113924
NODE_1954_length_1626_cov_4.728880	247	329	4	18	82	0.2195122
NODE_1954_length_1626_cov_4.728880	247	329	6	4	82	0.0487805
NODE_1954_length_1626_cov_4.728880	247	329	10	32	82	0.3902439
NODE_1954_length_1626_cov_4.728880	247	329	12	3	82	0.0365854
NODE_1954_length_1626_cov_4.728880	247	329	14	15	82	0.1829268
NODE_1954_length_1626_cov_4.728880	247	329	16	10	82	0.1219512
NODE_1954_length_1626_cov_4.728880	302	382	8	30	80	0.3750000
NODE_1954_length_1626_cov_4.728880	302	382	12	7	80	0.0875000
NODE_1954_length_1626_cov_4.728880	302	382	14	30	80	0.3750000
NODE_1954_length_1626_cov_4.728880	302	382	16	13	80	0.1625000
NODE_1956_length_1625_cov_20.598952	938	1018	0	80	80	1.0000000
NODE_1956_length_1625_cov_20.598952	991	1071	0	80	80	1.0000000
NODE_1962_length_1623_cov_28.551181	416	486	51	1	70	0.0142857
NODE_1962_length_1623_cov_28.551181	416	486	52	1	70	0.0142857
NODE_1962_length_1623_cov_28.551181	416	486	60	1	70	0.0142857
NODE_1962_length_1623_cov_28.551181	416	486	64	5	70	0.0714286
NODE_1962_length_1623_cov_28.551181	416	486	66	6	70	0.0857143
NODE_1962_length_1623_cov_28.551181	416	486	68	3	70	0.0428571
NODE_1962_length_1623_cov_28.551181	416	486	70	2	70	0.0285714
NODE_1962_length_1623_cov_28.551181	416	486	72	10	70	0.1428571
NODE_1962_length_1623_cov_28.551181	416	486	76	2	70	0.0285714
NODE_1962_length_1623_cov_28.551181	416	486	78	12	70	0.1714286
NODE_1962_length_1623_cov_28.551181	416	486	80	10	70	0.1428571
NODE_1962_length_1623_cov_28.551181	416	486	82	1	70	0.0142857
NODE_1962_length_1623_cov_28.551181	416	486	84	2	70	0.0285714
NODE_1962_length_1623_cov_28.551181	416	486	86	3	70	0.0428571
NODE_1962_length_1623_cov_28.551181	416	486	90	2	70	0.0285714
NODE_1962_length_1623_cov_28.551181	416	486	94	9	70	0.1285714
NODE_1962_length_1623_cov_28.551181	459	507	13	2	48	0.0416667
NODE_1962_length_1623_cov_28.551181	459	507	19	2	48	0.0416667
NODE_1962_length_1623_cov_28.551181	459	507	20	1	48	0.0208333
NODE_1962_length_1623_cov_28.551181	459	507	21	3	48	0.0625000
NODE_1962_length_1623_cov_28.551181	459	507	33	1	48	0.0208333
NODE_1962_length_1623_cov_28.551181	459	507	35	1	48	0.0208333
NODE_1962_length_1623_cov_28.551181	459	507	44	1	48	0.0208333
NODE_1962_length_1623_cov_28.551181	459	507	45	7	48	0.1458333
NODE_1962_length_1623_cov_28.551181	459	507	47	1	48	0.0208333
NODE_1962_length_1623_cov_28.551181	459	507	50	1	48	0.0208333
NODE_1962_length_1623_cov_28.551181	459	507	51	2	48	0.0416667
NODE_1962_length_1623_cov_28.551181	459	507	52	1	48	0.0208333
NODE_1962_length_1623_cov_28.551181	459	507	60	1	48	0.0208333
NODE_1962_length_1623_cov_28.551181	459	507	64	5	48	0.1041667
NODE_1962_length_1623_cov_28.551181	459	507	66	6	48	0.1250000
NODE_1962_length_1623_cov_28.551181	459	507	68	3	48	0.0625000
NODE_1962_length_1623_cov_28.551181	459	507	70	2	48	0.0416667
NODE_1962_length_1623_cov_28.551181	459	507	72	8	48	0.1666667
NODE_1965_length_1622_cov_7.969140	645	725	0	4	80	0.0500000
NODE_1965_length_1622_cov_7.969140	645	725	6	13	80	0.1625000
NODE_1965_length_1622_cov_7.969140	645	725	8	63	80	0.7875000
NODE_1965_length_1622_cov_7.969140	698	778	0	8	80	0.1000000
NODE_1965_length_1622_cov_7.969140	698	778	2	14	80	0.1750000
NODE_1965_length_1622_cov_7.969140	698	778	7	1	80	0.0125000
NODE_1965_length_1622_cov_7.969140	698	778	8	57	80	0.7125000
NODE_1970_length_1621_cov_2.192510	330	401	0	3	71	0.0422535
NODE_1970_length_1621_cov_2.192510	330	401	2	4	71	0.0563380
NODE_1970_length_1621_cov_2.192510	330	401	6	30	71	0.4225352
NODE_1970_length_1621_cov_2.192510	330	401	8	2	71	0.0281690
NODE_1970_length_1621_cov_2.192510	330	401	12	3	71	0.0422535
NODE_1970_length_1621_cov_2.192510	330	401	14	29	71	0.4084507
NODE_1975_length_1618_cov_44.138907	361	441	0	54	80	0.6750000
NODE_1975_length_1618_cov_44.138907	361	441	2	26	80	0.3250000
NODE_1975_length_1618_cov_44.138907	414	494	0	1	80	0.0125000
NODE_1975_length_1618_cov_44.138907	414	494	2	79	80	0.9875000
NODE_1975_length_1618_cov_44.138907	1063	1143	0	80	80	1.0000000
NODE_1975_length_1618_cov_44.138907	1116	1196	0	30	80	0.3750000
NODE_1975_length_1618_cov_44.138907	1116	1196	2	50	80	0.6250000
NODE_1976_length_1618_cov_5.779460	332	414	0	58	82	0.7073171
NODE_1976_length_1618_cov_5.779460	332	414	2	24	82	0.2926829
NODE_1976_length_1618_cov_5.779460	387	467	0	80	80	1.0000000
NODE_1976_length_1618_cov_5.779460	972	1028	0	15	56	0.2678571
NODE_1976_length_1618_cov_5.779460	972	1028	2	41	56	0.7321429
NODE_1980_length_1616_cov_5.313777	589	669	4	80	80	1.0000000
NODE_1980_length_1616_cov_5.313777	642	722	0	34	80	0.4250000
NODE_1980_length_1616_cov_5.313777	642	722	2	12	80	0.1500000
NODE_1980_length_1616_cov_5.313777	642	722	4	34	80	0.4250000
NODE_1981_length_1615_cov_12.575858	1032	1112	18	5	80	0.0625000
NODE_1981_length_1615_cov_12.575858	1032	1112	19	30	80	0.3750000
NODE_1981_length_1615_cov_12.575858	1032	1112	20	11	80	0.1375000
NODE_1981_length_1615_cov_12.575858	1032	1112	21	34	80	0.4250000
NODE_1981_length_1615_cov_12.575858	1085	1162	0	5	77	0.0649351
NODE_1981_length_1615_cov_12.575858	1085	1162	2	1	77	0.0129870
NODE_1981_length_1615_cov_12.575858	1085	1162	3	5	77	0.0649351
NODE_1981_length_1615_cov_12.575858	1085	1162	4	9	77	0.1168831
NODE_1981_length_1615_cov_12.575858	1085	1162	5	2	77	0.0259740
NODE_1981_length_1615_cov_12.575858	1085	1162	10	8	77	0.1038961
NODE_1981_length_1615_cov_12.575858	1085	1162	13	1	77	0.0129870
NODE_1981_length_1615_cov_12.575858	1085	1162	15	17	77	0.2207792
NODE_1981_length_1615_cov_12.575858	1085	1162	18	1	77	0.0129870
NODE_1981_length_1615_cov_12.575858	1085	1162	19	23	77	0.2987013
NODE_1981_length_1615_cov_12.575858	1085	1162	21	5	77	0.0649351
NODE_1981_length_1615_cov_12.575858	1158	1238	0	12	80	0.1500000
NODE_1981_length_1615_cov_12.575858	1158	1238	2	68	80	0.8500000
NODE_1981_length_1615_cov_12.575858	1211	1291	2	60	80	0.7500000
NODE_1981_length_1615_cov_12.575858	1211	1291	4	20	80	0.2500000
NODE_1983_length_1614_cov_94.900990	0	46	0	6	46	0.1304348
NODE_1983_length_1614_cov_94.900990	0	46	2	7	46	0.1521739
NODE_1983_length_1614_cov_94.900990	0	46	4	33	46	0.7173913
NODE_1983_length_1614_cov_94.900990	23	99	4	76	76	1.0000000
NODE_1984_length_1614_cov_18.799340	655	735	2	21	80	0.2625000
NODE_1984_length_1614_cov_18.799340	655	735	4	11	80	0.1375000
NODE_1984_length_1614_cov_18.799340	655	735	6	48	80	0.6000000
NODE_1984_length_1614_cov_18.799340	708	788	0	2	80	0.0250000
NODE_1984_length_1614_cov_18.799340	708	788	2	70	80	0.8750000
NODE_1984_length_1614_cov_18.799340	708	788	4	8	80	0.1000000
NODE_1986_length_1613_cov_6.865258	1128	1203	2	75	75	1.0000000
NODE_1986_length_1613_cov_6.865258	1176	1256	0	53	80	0.6625000
NODE_1986_length_1613_cov_6.865258	1176	1256	2	27	80	0.3375000
NODE_1993_length_1610_cov_18.014560	1035	1115	0	80	80	1.0000000
NODE_1993_length_1610_cov_18.014560	1088	1168	0	80	80	1.0000000
NODE_2001_length_1603_cov_9.128324	1109	1189	0	42	80	0.5250000
NODE_2001_length_1603_cov_9.128324	1109	1189	4	38	80	0.4750000
NODE_2001_length_1603_cov_9.128324	1162	1242	4	80	80	1.0000000
NODE_2003_length_1602_cov_79.840319	1378	1445	76	3	67	0.0447761
NODE_2003_length_1602_cov_79.840319	1378	1445	78	5	67	0.0746269
NODE_2003_length_1602_cov_79.840319	1378	1445	79	2	67	0.0298507
NODE_2003_length_1602_cov_79.840319	1378	1445	81	6	67	0.0895522
NODE_2003_length_1602_cov_79.840319	1378	1445	83	8	67	0.1194030
NODE_2003_length_1602_cov_79.840319	1378	1445	87	1	67	0.0149254
NODE_2003_length_1602_cov_79.840319	1378	1445	88	1	67	0.0149254
NODE_2003_length_1602_cov_79.840319	1378	1445	92	1	67	0.0149254
NODE_2003_length_1602_cov_79.840319	1378	1445	96	1	67	0.0149254
NODE_2003_length_1602_cov_79.840319	1378	1445	100	1	67	0.0149254
NODE_2003_length_1602_cov_79.840319	1378	1445	104	4	67	0.0597015
NODE_2003_length_1602_cov_79.840319	1378	1445	105	1	67	0.0149254
NODE_2003_length_1602_cov_79.840319	1378	1445	106	1	67	0.0149254
NODE_2003_length_1602_cov_79.840319	1378	1445	109	1	67	0.0149254
NODE_2003_length_1602_cov_79.840319	1378	1445	110	1	67	0.0149254
NODE_2003_length_1602_cov_79.840319	1378	1445	111	2	67	0.0298507
NODE_2003_length_1602_cov_79.840319	1378	1445	112	5	67	0.0746269
NODE_2003_length_1602_cov_79.840319	1378	1445	113	3	67	0.0447761
NODE_2003_length_1602_cov_79.840319	1378	1445	114	1	67	0.0149254
NODE_2003_length_1602_cov_79.840319	1378	1445	115	4	67	0.0597015
NODE_2003_length_1602_cov_79.840319	1378	1445	120	1	67	0.0149254
NODE_2003_length_1602_cov_79.840319	1378	1445	122	1	67	0.0149254
NODE_2003_length_1602_cov_79.840319	1378	1445	124	1	67	0.0149254
NODE_2003_length_1602_cov_79.840319	1378	1445	126	5	67	0.0746269
NODE_2003_length_1602_cov_79.840319	1378	1445	132	2	67	0.0298507
NODE_2003_length_1602_cov_79.840319	1378	1445	134	2	67	0.0298507
NODE_2003_length_1602_cov_79.840319	1378	1445	136	2	67	0.0298507
NODE_2003_length_1602_cov_79.840319	1378	1445	141	1	67	0.0149254
NODE_2003_length_1602_cov_79.840319	1462	1508	34	3	46	0.0652174
NODE_2003_length_1602_cov_79.840319	1462	1508	39	1	46	0.0217391
NODE_2003_length_1602_cov_79.840319	1462	1508	40	7	46	0.1521739
NODE_2003_length_1602_cov_79.840319	1462	1508	41	3	46	0.0652174
NODE_2003_length_1602_cov_79.840319	1462	1508	42	1	46	0.0217391
NODE_2003_length_1602_cov_79.840319	1462	1508	43	6	46	0.1304348
NODE_2003_length_1602_cov_79.840319	1462	1508	44	4	46	0.0869565
NODE_2003_length_1602_cov_79.840319	1462	1508	46	3	46	0.0652174
NODE_2003_length_1602_cov_79.840319	1462	1508	48	1	46	0.0217391
NODE_2003_length_1602_cov_79.840319	1462	1508	49	3	46	0.0652174
NODE_2003_length_1602_cov_79.840319	1462	1508	50	3	46	0.0652174
NODE_2003_length_1602_cov_79.840319	1462	1508	51	2	46	0.0434783
NODE_2003_length_1602_cov_79.840319	1462	1508	52	1	46	0.0217391
NODE_2003_length_1602_cov_79.840319	1462	1508	54	2	46	0.0434783
NODE_2003_length_1602_cov_79.840319	1462	1508	56	3	46	0.0652174
NODE_2003_length_1602_cov_79.840319	1462	1508	58	2	46	0.0434783
NODE_2003_length_1602_cov_79.840319	1462	1508	64	1	46	0.0217391
NODE_2004_length_1602_cov_2.701264	1490	1570	6	21	80	0.2625000
NODE_2004_length_1602_cov_2.701264	1490	1570	9	15	80	0.1875000
NODE_2004_length_1602_cov_2.701264	1490	1570	11	9	80	0.1125000
NODE_2004_length_1602_cov_2.701264	1490	1570	12	35	80	0.4375000
NODE_2009_length_1600_cov_34.988008	785	865	0	80	80	1.0000000
NODE_2009_length_1600_cov_34.988008	838	918	0	69	80	0.8625000
NODE_2009_length_1600_cov_34.988008	838	918	12	11	80	0.1375000
NODE_2009_length_1600_cov_34.988008	914	994	12	80	80	1.0000000
NODE_2009_length_1600_cov_34.988008	967	1047	4	5	80	0.0625000
NODE_2009_length_1600_cov_34.988008	967	1047	12	46	80	0.5750000
NODE_2009_length_1600_cov_34.988008	967	1047	14	19	80	0.2375000
NODE_2009_length_1600_cov_34.988008	967	1047	16	10	80	0.1250000
NODE_2011_length_1600_cov_11.383744	0	72	0	72	72	1.0000000
NODE_2011_length_1600_cov_11.383744	45	99	0	54	54	1.0000000
NODE_2011_length_1600_cov_11.383744	891	971	0	12	80	0.1500000
NODE_2011_length_1600_cov_11.383744	891	971	3	1	80	0.0125000
NODE_2011_length_1600_cov_11.383744	891	971	4	4	80	0.0500000
NODE_2011_length_1600_cov_11.383744	891	971	6	15	80	0.1875000
NODE_2011_length_1600_cov_11.383744	891	971	8	8	80	0.1000000
NODE_2011_length_1600_cov_11.383744	891	971	10	40	80	0.5000000
NODE_2011_length_1600_cov_11.383744	944	1024	4	11	80	0.1375000
NODE_2011_length_1600_cov_11.383744	944	1024	10	64	80	0.8000000
NODE_2011_length_1600_cov_11.383744	944	1024	12	5	80	0.0625000
NODE_2013_length_1600_cov_7.236509	1037	1109	0	56	72	0.7777778
NODE_2013_length_1600_cov_7.236509	1037	1109	2	16	72	0.2222222
NODE_2013_length_1600_cov_7.236509	1090	1160	0	70	70	1.0000000
NODE_2018_length_1598_cov_29.337558	335	415	0	80	80	1.0000000
NODE_2018_length_1598_cov_29.337558	388	468	0	73	80	0.9125000
NODE_2018_length_1598_cov_29.337558	388	468	2	2	80	0.0250000
NODE_2018_length_1598_cov_29.337558	388	468	5	2	80	0.0250000
NODE_2018_length_1598_cov_29.337558	388	468	7	3	80	0.0375000
NODE_2018_length_1598_cov_29.337558	464	516	5	1	52	0.0192308
NODE_2018_length_1598_cov_29.337558	464	516	7	4	52	0.0769231
NODE_2018_length_1598_cov_29.337558	464	516	10	3	52	0.0576923
NODE_2018_length_1598_cov_29.337558	464	516	12	1	52	0.0192308
NODE_2018_length_1598_cov_29.337558	464	516	14	2	52	0.0384615
NODE_2018_length_1598_cov_29.337558	464	516	16	4	52	0.0769231
NODE_2018_length_1598_cov_29.337558	464	516	18	35	52	0.6730769
NODE_2018_length_1598_cov_29.337558	464	516	20	2	52	0.0384615
NODE_2018_length_1598_cov_29.337558	1026	1106	0	65	80	0.8125000
NODE_2018_length_1598_cov_29.337558	1026	1106	4	15	80	0.1875000
NODE_2018_length_1598_cov_29.337558	1079	1159	0	12	80	0.1500000
NODE_2018_length_1598_cov_29.337558	1079	1159	4	68	80	0.8500000
NODE_2019_length_1598_cov_3.730487	1117	1197	0	15	80	0.1875000
NODE_2019_length_1598_cov_3.730487	1117	1197	2	65	80	0.8125000
NODE_2021_length_1597_cov_7.434579	1373	1453	30	2	80	0.0250000
NODE_2021_length_1597_cov_7.434579	1373	1453	32	26	80	0.3250000
NODE_2021_length_1597_cov_7.434579	1373	1453	40	3	80	0.0375000
NODE_2021_length_1597_cov_7.434579	1373	1453	44	3	80	0.0375000
NODE_2021_length_1597_cov_7.434579	1373	1453	45	5	80	0.0625000
NODE_2021_length_1597_cov_7.434579	1373	1453	46	1	80	0.0125000
NODE_2021_length_1597_cov_7.434579	1373	1453	47	2	80	0.0250000
NODE_2021_length_1597_cov_7.434579	1373	1453	54	1	80	0.0125000
NODE_2021_length_1597_cov_7.434579	1373	1453	57	2	80	0.0250000
NODE_2021_length_1597_cov_7.434579	1373	1453	59	2	80	0.0250000
NODE_2021_length_1597_cov_7.434579	1373	1453	62	1	80	0.0125000
NODE_2021_length_1597_cov_7.434579	1373	1453	65	4	80	0.0500000
NODE_2021_length_1597_cov_7.434579	1373	1453	72	1	80	0.0125000
NODE_2021_length_1597_cov_7.434579	1373	1453	74	1	80	0.0125000
NODE_2021_length_1597_cov_7.434579	1373	1453	75	7	80	0.0875000
NODE_2021_length_1597_cov_7.434579	1373	1453	86	1	80	0.0125000
NODE_2021_length_1597_cov_7.434579	1373	1453	87	1	80	0.0125000
NODE_2021_length_1597_cov_7.434579	1373	1453	110	1	80	0.0125000
NODE_2021_length_1597_cov_7.434579	1373	1453	118	1	80	0.0125000
NODE_2021_length_1597_cov_7.434579	1373	1453	122	1	80	0.0125000
NODE_2021_length_1597_cov_7.434579	1373	1453	124	1	80	0.0125000
NODE_2021_length_1597_cov_7.434579	1373	1453	132	1	80	0.0125000
NODE_2021_length_1597_cov_7.434579	1373	1453	136	1	80	0.0125000
NODE_2021_length_1597_cov_7.434579	1373	1453	153	1	80	0.0125000
NODE_2021_length_1597_cov_7.434579	1373	1453	162	2	80	0.0250000
NODE_2021_length_1597_cov_7.434579	1373	1453	175	1	80	0.0125000
NODE_2021_length_1597_cov_7.434579	1373	1453	183	1	80	0.0125000
NODE_2021_length_1597_cov_7.434579	1373	1453	189	1	80	0.0125000
NODE_2021_length_1597_cov_7.434579	1373	1453	195	2	80	0.0250000
NODE_2021_length_1597_cov_7.434579	1373	1453	197	1	80	0.0125000
NODE_2021_length_1597_cov_7.434579	1373	1453	200	2	80	0.0250000
NODE_2021_length_1597_cov_7.434579	1382	1453	32	19	71	0.2676056
NODE_2021_length_1597_cov_7.434579	1382	1453	40	3	71	0.0422535
NODE_2021_length_1597_cov_7.434579	1382	1453	44	3	71	0.0422535
NODE_2021_length_1597_cov_7.434579	1382	1453	45	5	71	0.0704225
NODE_2021_length_1597_cov_7.434579	1382	1453	46	1	71	0.0140845
NODE_2021_length_1597_cov_7.434579	1382	1453	47	2	71	0.0281690
NODE_2021_length_1597_cov_7.434579	1382	1453	54	1	71	0.0140845
NODE_2021_length_1597_cov_7.434579	1382	1453	57	2	71	0.0281690
NODE_2021_length_1597_cov_7.434579	1382	1453	59	2	71	0.0281690
NODE_2021_length_1597_cov_7.434579	1382	1453	62	1	71	0.0140845
NODE_2021_length_1597_cov_7.434579	1382	1453	65	4	71	0.0563380
NODE_2021_length_1597_cov_7.434579	1382	1453	72	1	71	0.0140845
NODE_2021_length_1597_cov_7.434579	1382	1453	74	1	71	0.0140845
NODE_2021_length_1597_cov_7.434579	1382	1453	75	7	71	0.0985916
NODE_2021_length_1597_cov_7.434579	1382	1453	86	1	71	0.0140845
NODE_2021_length_1597_cov_7.434579	1382	1453	87	1	71	0.0140845
NODE_2021_length_1597_cov_7.434579	1382	1453	110	1	71	0.0140845
NODE_2021_length_1597_cov_7.434579	1382	1453	118	1	71	0.0140845
NODE_2021_length_1597_cov_7.434579	1382	1453	122	1	71	0.0140845
NODE_2021_length_1597_cov_7.434579	1382	1453	124	1	71	0.0140845
NODE_2021_length_1597_cov_7.434579	1382	1453	132	1	71	0.0140845
NODE_2021_length_1597_cov_7.434579	1382	1453	136	1	71	0.0140845
NODE_2021_length_1597_cov_7.434579	1382	1453	153	1	71	0.0140845
NODE_2021_length_1597_cov_7.434579	1382	1453	162	2	71	0.0281690
NODE_2021_length_1597_cov_7.434579	1382	1453	175	1	71	0.0140845
NODE_2021_length_1597_cov_7.434579	1382	1453	183	1	71	0.0140845
NODE_2021_length_1597_cov_7.434579	1382	1453	189	1	71	0.0140845
NODE_2021_length_1597_cov_7.434579	1382	1453	195	2	71	0.0281690
NODE_2021_length_1597_cov_7.434579	1382	1453	197	1	71	0.0140845
NODE_2021_length_1597_cov_7.434579	1382	1453	200	2	71	0.0281690
NODE_2022_length_1595_cov_16.788770	215	267	1	9	52	0.1730769
NODE_2022_length_1595_cov_16.788770	215	267	3	1	52	0.0192308
NODE_2022_length_1595_cov_16.788770	215	267	5	14	52	0.2692308
NODE_2022_length_1595_cov_16.788770	215	267	7	14	52	0.2692308
NODE_2022_length_1595_cov_16.788770	215	267	8	14	52	0.2692308
NODE_2022_length_1595_cov_16.788770	614	673	20	6	59	0.1016949
NODE_2022_length_1595_cov_16.788770	614	673	21	5	59	0.0847458
NODE_2022_length_1595_cov_16.788770	614	673	22	18	59	0.3050847
NODE_2022_length_1595_cov_16.788770	614	673	24	30	59	0.5084746
NODE_2025_length_1593_cov_22.412316	144	224	0	67	80	0.8375000
NODE_2025_length_1593_cov_22.412316	144	224	2	9	80	0.1125000
NODE_2025_length_1593_cov_22.412316	144	224	4	4	80	0.0500000
NODE_2025_length_1593_cov_22.412316	197	277	0	80	80	1.0000000
NODE_2025_length_1593_cov_22.412316	1192	1272	2	58	80	0.7250000
NODE_2025_length_1593_cov_22.412316	1192	1272	4	22	80	0.2750000
NODE_2025_length_1593_cov_22.412316	1245	1325	2	72	80	0.9000000
NODE_2025_length_1593_cov_22.412316	1245	1325	4	8	80	0.1000000
NODE_2026_length_1593_cov_14.092369	357	437	2	13	80	0.1625000
NODE_2026_length_1593_cov_14.092369	357	437	4	67	80	0.8375000
NODE_2026_length_1593_cov_14.092369	410	490	0	47	80	0.5875000
NODE_2026_length_1593_cov_14.092369	410	490	2	17	80	0.2125000
NODE_2026_length_1593_cov_14.092369	410	490	4	16	80	0.2000000
NODE_2026_length_1593_cov_14.092369	1061	1141	0	1	80	0.0125000
NODE_2026_length_1593_cov_14.092369	1061	1141	4	79	80	0.9875000
NODE_2026_length_1593_cov_14.092369	1114	1194	0	54	80	0.6750000
NODE_2026_length_1593_cov_14.092369	1114	1194	4	26	80	0.3250000
NODE_2031_length_1592_cov_4.576691	277	357	0	45	80	0.5625000
NODE_2031_length_1592_cov_4.576691	277	357	2	35	80	0.4375000
NODE_2031_length_1592_cov_4.576691	330	410	0	80	80	1.0000000
NODE_2034_length_1591_cov_15.481233	841	921	0	20	80	0.2500000
NODE_2034_length_1591_cov_15.481233	841	921	2	4	80	0.0500000
NODE_2034_length_1591_cov_15.481233	841	921	4	8	80	0.1000000
NODE_2034_length_1591_cov_15.481233	841	921	5	1	80	0.0125000
NODE_2034_length_1591_cov_15.481233	841	921	6	1	80	0.0125000
NODE_2034_length_1591_cov_15.481233	841	921	8	10	80	0.1250000
NODE_2034_length_1591_cov_15.481233	841	921	10	16	80	0.2000000
NODE_2034_length_1591_cov_15.481233	841	921	16	20	80	0.2500000
NODE_2034_length_1591_cov_15.481233	894	974	8	11	80	0.1375000
NODE_2034_length_1591_cov_15.481233	894	974	10	17	80	0.2125000
NODE_2034_length_1591_cov_15.481233	894	974	12	11	80	0.1375000
NODE_2034_length_1591_cov_15.481233	894	974	14	20	80	0.2500000
NODE_2034_length_1591_cov_15.481233	894	974	16	21	80	0.2625000
NODE_2035_length_1591_cov_4.040885	35	65	0	30	30	1.0000000
NODE_2035_length_1591_cov_4.040885	38	99	0	58	61	0.9508197
NODE_2035_length_1591_cov_4.040885	38	99	6	1	61	0.0163934
NODE_2035_length_1591_cov_4.040885	38	99	14	1	61	0.0163934
NODE_2035_length_1591_cov_4.040885	38	99	19	1	61	0.0163934
NODE_2042_length_1589_cov_10.184564	379	459	0	80	80	1.0000000
NODE_2042_length_1589_cov_10.184564	432	512	0	80	80	1.0000000
NODE_2042_length_1589_cov_10.184564	473	512	0	39	39	1.0000000
NODE_2042_length_1589_cov_10.184564	508	588	0	80	80	1.0000000
NODE_2042_length_1589_cov_10.184564	561	641	0	80	80	1.0000000
NODE_2043_length_1588_cov_9.955675	415	495	0	30	80	0.3750000
NODE_2043_length_1588_cov_9.955675	415	495	2	50	80	0.6250000
NODE_2043_length_1588_cov_9.955675	468	548	0	25	80	0.3125000
NODE_2043_length_1588_cov_9.955675	468	548	2	55	80	0.6875000
NODE_2046_length_1587_cov_7.942204	710	790	2	14	80	0.1750000
NODE_2046_length_1587_cov_7.942204	710	790	4	61	80	0.7625000
NODE_2046_length_1587_cov_7.942204	710	790	6	5	80	0.0625000
NODE_2046_length_1587_cov_7.942204	763	843	2	9	80	0.1125000
NODE_2046_length_1587_cov_7.942204	763	843	4	71	80	0.8875000
NODE_2049_length_1586_cov_6.488231	447	474	0	27	27	1.0000000
NODE_2049_length_1586_cov_6.488231	447	527	0	80	80	1.0000000
NODE_2049_length_1586_cov_6.488231	500	580	0	80	80	1.0000000
NODE_2056_length_1583_cov_27.825472	800	880	0	32	80	0.4000000
NODE_2056_length_1583_cov_27.825472	800	880	2	12	80	0.1500000
NODE_2056_length_1583_cov_27.825472	800	880	4	36	80	0.4500000
NODE_2056_length_1583_cov_27.825472	853	933	0	8	80	0.1000000
NODE_2056_length_1583_cov_27.825472	853	933	2	15	80	0.1875000
NODE_2056_length_1583_cov_27.825472	853	933	4	57	80	0.7125000
NODE_2056_length_1583_cov_27.825472	929	1009	0	80	80	1.0000000
NODE_2056_length_1583_cov_27.825472	982	1062	0	80	80	1.0000000
NODE_2060_length_1581_cov_10.610661	457	537	4	49	80	0.6125000
NODE_2060_length_1581_cov_10.610661	457	537	6	31	80	0.3875000
NODE_2060_length_1581_cov_10.610661	510	590	2	22	80	0.2750000
NODE_2060_length_1581_cov_10.610661	510	590	4	52	80	0.6500000
NODE_2060_length_1581_cov_10.610661	510	590	6	6	80	0.0750000
NODE_2065_length_1579_cov_7.395946	5	80	0	75	75	1.0000000
NODE_2065_length_1579_cov_7.395946	58	126	0	50	68	0.7352941
NODE_2065_length_1579_cov_7.395946	58	126	2	18	68	0.2647059
NODE_2066_length_1579_cov_7.152027	1331	1409	2	6	78	0.0769231
NODE_2066_length_1579_cov_7.152027	1331	1409	4	53	78	0.6794872
NODE_2066_length_1579_cov_7.152027	1331	1409	6	19	78	0.2435897
NODE_2066_length_1579_cov_7.152027	1382	1462	4	18	80	0.2250000
NODE_2066_length_1579_cov_7.152027	1382	1462	6	62	80	0.7750000
NODE_2067_length_1579_cov_6.741892	4	52	12	3	48	0.0625000
NODE_2067_length_1579_cov_6.741892	4	52	14	2	48	0.0416667
NODE_2067_length_1579_cov_6.741892	4	52	18	4	48	0.0833333
NODE_2067_length_1579_cov_6.741892	4	52	32	2	48	0.0416667
NODE_2067_length_1579_cov_6.741892	4	52	35	1	48	0.0208333
NODE_2067_length_1579_cov_6.741892	4	52	42	1	48	0.0208333
NODE_2067_length_1579_cov_6.741892	4	52	46	1	48	0.0208333
NODE_2067_length_1579_cov_6.741892	4	52	59	1	48	0.0208333
NODE_2067_length_1579_cov_6.741892	4	52	66	1	48	0.0208333
NODE_2067_length_1579_cov_6.741892	4	52	68	1	48	0.0208333
NODE_2067_length_1579_cov_6.741892	4	52	70	1	48	0.0208333
NODE_2067_length_1579_cov_6.741892	4	52	71	2	48	0.0416667
NODE_2067_length_1579_cov_6.741892	4	52	75	5	48	0.1041667
NODE_2067_length_1579_cov_6.741892	4	52	76	2	48	0.0416667
NODE_2067_length_1579_cov_6.741892	4	52	78	1	48	0.0208333
NODE_2067_length_1579_cov_6.741892	4	52	80	1	48	0.0208333
NODE_2067_length_1579_cov_6.741892	4	52	92	1	48	0.0208333
NODE_2067_length_1579_cov_6.741892	4	52	93	1	48	0.0208333
NODE_2067_length_1579_cov_6.741892	4	52	95	7	48	0.1458333
NODE_2067_length_1579_cov_6.741892	4	52	97	1	48	0.0208333
NODE_2067_length_1579_cov_6.741892	4	52	101	3	48	0.0625000
NODE_2067_length_1579_cov_6.741892	4	52	106	3	48	0.0625000
NODE_2067_length_1579_cov_6.741892	4	52	107	1	48	0.0208333
NODE_2067_length_1579_cov_6.741892	4	52	109	2	48	0.0416667
NODE_2067_length_1579_cov_6.741892	4	52	12	3	48	0.0625000
NODE_2067_length_1579_cov_6.741892	4	52	14	2	48	0.0416667
NODE_2067_length_1579_cov_6.741892	4	52	18	4	48	0.0833333
NODE_2067_length_1579_cov_6.741892	4	52	32	2	48	0.0416667
NODE_2067_length_1579_cov_6.741892	4	52	35	1	48	0.0208333
NODE_2067_length_1579_cov_6.741892	4	52	42	1	48	0.0208333
NODE_2067_length_1579_cov_6.741892	4	52	46	1	48	0.0208333
NODE_2067_length_1579_cov_6.741892	4	52	59	1	48	0.0208333
NODE_2067_length_1579_cov_6.741892	4	52	66	1	48	0.0208333
NODE_2067_length_1579_cov_6.741892	4	52	68	1	48	0.0208333
NODE_2067_length_1579_cov_6.741892	4	52	70	1	48	0.0208333
NODE_2067_length_1579_cov_6.741892	4	52	71	2	48	0.0416667
NODE_2067_length_1579_cov_6.741892	4	52	75	5	48	0.1041667
NODE_2067_length_1579_cov_6.741892	4	52	76	2	48	0.0416667
NODE_2067_length_1579_cov_6.741892	4	52	78	1	48	0.0208333
NODE_2067_length_1579_cov_6.741892	4	52	80	1	48	0.0208333
NODE_2067_length_1579_cov_6.741892	4	52	92	1	48	0.0208333
NODE_2067_length_1579_cov_6.741892	4	52	93	1	48	0.0208333
NODE_2067_length_1579_cov_6.741892	4	52	95	7	48	0.1458333
NODE_2067_length_1579_cov_6.741892	4	52	97	1	48	0.0208333
NODE_2067_length_1579_cov_6.741892	4	52	101	3	48	0.0625000
NODE_2067_length_1579_cov_6.741892	4	52	106	3	48	0.0625000
NODE_2067_length_1579_cov_6.741892	4	52	107	1	48	0.0208333
NODE_2067_length_1579_cov_6.741892	4	52	109	2	48	0.0416667
NODE_2067_length_1579_cov_6.741892	4	52	12	3	48	0.0625000
NODE_2067_length_1579_cov_6.741892	4	52	14	2	48	0.0416667
NODE_2067_length_1579_cov_6.741892	4	52	18	4	48	0.0833333
NODE_2067_length_1579_cov_6.741892	4	52	32	2	48	0.0416667
NODE_2067_length_1579_cov_6.741892	4	52	35	1	48	0.0208333
NODE_2067_length_1579_cov_6.741892	4	52	42	1	48	0.0208333
NODE_2067_length_1579_cov_6.741892	4	52	46	1	48	0.0208333
NODE_2067_length_1579_cov_6.741892	4	52	59	1	48	0.0208333
NODE_2067_length_1579_cov_6.741892	4	52	66	1	48	0.0208333
NODE_2067_length_1579_cov_6.741892	4	52	68	1	48	0.0208333
NODE_2067_length_1579_cov_6.741892	4	52	70	1	48	0.0208333
NODE_2067_length_1579_cov_6.741892	4	52	71	2	48	0.0416667
NODE_2067_length_1579_cov_6.741892	4	52	75	5	48	0.1041667
NODE_2067_length_1579_cov_6.741892	4	52	76	2	48	0.0416667
NODE_2067_length_1579_cov_6.741892	4	52	78	1	48	0.0208333
NODE_2067_length_1579_cov_6.741892	4	52	80	1	48	0.0208333
NODE_2067_length_1579_cov_6.741892	4	52	92	1	48	0.0208333
NODE_2067_length_1579_cov_6.741892	4	52	93	1	48	0.0208333
NODE_2067_length_1579_cov_6.741892	4	52	95	7	48	0.1458333
NODE_2067_length_1579_cov_6.741892	4	52	97	1	48	0.0208333
NODE_2067_length_1579_cov_6.741892	4	52	101	3	48	0.0625000
NODE_2067_length_1579_cov_6.741892	4	52	106	3	48	0.0625000
NODE_2067_length_1579_cov_6.741892	4	52	107	1	48	0.0208333
NODE_2067_length_1579_cov_6.741892	4	52	109	2	48	0.0416667
NODE_2067_length_1579_cov_6.741892	25	105	75	4	80	0.0500000
NODE_2067_length_1579_cov_6.741892	25	105	76	2	80	0.0250000
NODE_2067_length_1579_cov_6.741892	25	105	78	1	80	0.0125000
NODE_2067_length_1579_cov_6.741892	25	105	80	1	80	0.0125000
NODE_2067_length_1579_cov_6.741892	25	105	92	1	80	0.0125000
NODE_2067_length_1579_cov_6.741892	25	105	93	1	80	0.0125000
NODE_2067_length_1579_cov_6.741892	25	105	95	7	80	0.0875000
NODE_2067_length_1579_cov_6.741892	25	105	97	1	80	0.0125000
NODE_2067_length_1579_cov_6.741892	25	105	101	3	80	0.0375000
NODE_2067_length_1579_cov_6.741892	25	105	106	3	80	0.0375000
NODE_2067_length_1579_cov_6.741892	25	105	107	1	80	0.0125000
NODE_2067_length_1579_cov_6.741892	25	105	109	8	80	0.1000000
NODE_2067_length_1579_cov_6.741892	25	105	113	1	80	0.0125000
NODE_2067_length_1579_cov_6.741892	25	105	115	2	80	0.0250000
NODE_2067_length_1579_cov_6.741892	25	105	117	2	80	0.0250000
NODE_2067_length_1579_cov_6.741892	25	105	119	8	80	0.1000000
NODE_2067_length_1579_cov_6.741892	25	105	121	34	80	0.4250000
NODE_2067_length_1579_cov_6.741892	25	91	75	4	66	0.0606061
NODE_2067_length_1579_cov_6.741892	25	91	76	2	66	0.0303030
NODE_2067_length_1579_cov_6.741892	25	91	78	1	66	0.0151515
NODE_2067_length_1579_cov_6.741892	25	91	80	1	66	0.0151515
NODE_2067_length_1579_cov_6.741892	25	91	92	1	66	0.0151515
NODE_2067_length_1579_cov_6.741892	25	91	93	1	66	0.0151515
NODE_2067_length_1579_cov_6.741892	25	91	95	7	66	0.1060606
NODE_2067_length_1579_cov_6.741892	25	91	97	1	66	0.0151515
NODE_2067_length_1579_cov_6.741892	25	91	101	3	66	0.0454545
NODE_2067_length_1579_cov_6.741892	25	91	106	3	66	0.0454545
NODE_2067_length_1579_cov_6.741892	25	91	107	1	66	0.0151515
NODE_2067_length_1579_cov_6.741892	25	91	109	8	66	0.1212121
NODE_2067_length_1579_cov_6.741892	25	91	113	1	66	0.0151515
NODE_2067_length_1579_cov_6.741892	25	91	115	2	66	0.0303030
NODE_2067_length_1579_cov_6.741892	25	91	117	2	66	0.0303030
NODE_2067_length_1579_cov_6.741892	25	91	119	8	66	0.1212121
NODE_2067_length_1579_cov_6.741892	25	91	121	20	66	0.3030303
NODE_2067_length_1579_cov_6.741892	25	96	75	4	71	0.0563380
NODE_2067_length_1579_cov_6.741892	25	96	76	2	71	0.0281690
NODE_2067_length_1579_cov_6.741892	25	96	78	1	71	0.0140845
NODE_2067_length_1579_cov_6.741892	25	96	80	1	71	0.0140845
NODE_2067_length_1579_cov_6.741892	25	96	92	1	71	0.0140845
NODE_2067_length_1579_cov_6.741892	25	96	93	1	71	0.0140845
NODE_2067_length_1579_cov_6.741892	25	96	95	7	71	0.0985916
NODE_2067_length_1579_cov_6.741892	25	96	97	1	71	0.0140845
NODE_2067_length_1579_cov_6.741892	25	96	101	3	71	0.0422535
NODE_2067_length_1579_cov_6.741892	25	96	106	3	71	0.0422535
NODE_2067_length_1579_cov_6.741892	25	96	107	1	71	0.0140845
NODE_2067_length_1579_cov_6.741892	25	96	109	8	71	0.1126761
NODE_2067_length_1579_cov_6.741892	25	96	113	1	71	0.0140845
NODE_2067_length_1579_cov_6.741892	25	96	115	2	71	0.0281690
NODE_2067_length_1579_cov_6.741892	25	96	117	2	71	0.0281690
NODE_2067_length_1579_cov_6.741892	25	96	119	8	71	0.1126761
NODE_2067_length_1579_cov_6.741892	25	96	121	25	71	0.3521127
NODE_2076_length_1575_cov_4.250000	993	1073	0	12	80	0.1500000
NODE_2076_length_1575_cov_4.250000	993	1073	2	5	80	0.0625000
NODE_2076_length_1575_cov_4.250000	993	1073	7	1	80	0.0125000
NODE_2076_length_1575_cov_4.250000	993	1073	8	62	80	0.7750000
NODE_2076_length_1575_cov_4.250000	1046	1126	2	23	80	0.2875000
NODE_2076_length_1575_cov_4.250000	1046	1126	8	57	80	0.7125000
NODE_2078_length_1574_cov_40.682034	551	631	8	37	80	0.4625000
NODE_2078_length_1574_cov_40.682034	551	631	10	17	80	0.2125000
NODE_2078_length_1574_cov_40.682034	551	631	12	26	80	0.3250000
NODE_2078_length_1574_cov_40.682034	604	684	0	12	80	0.1500000
NODE_2078_length_1574_cov_40.682034	604	684	2	17	80	0.2125000
NODE_2078_length_1574_cov_40.682034	604	684	4	3	80	0.0375000
NODE_2078_length_1574_cov_40.682034	604	684	8	32	80	0.4000000
NODE_2078_length_1574_cov_40.682034	604	684	10	12	80	0.1500000
NODE_2078_length_1574_cov_40.682034	604	684	12	4	80	0.0500000
NODE_2078_length_1574_cov_40.682034	680	760	0	80	80	1.0000000
NODE_2078_length_1574_cov_40.682034	733	813	0	80	80	1.0000000
NODE_2079_length_1574_cov_7.572203	1306	1386	2	13	80	0.1625000
NODE_2079_length_1574_cov_7.572203	1306	1386	4	3	80	0.0375000
NODE_2079_length_1574_cov_7.572203	1306	1386	10	64	80	0.8000000
NODE_2079_length_1574_cov_7.572203	1359	1439	0	9	80	0.1125000
NODE_2079_length_1574_cov_7.572203	1359	1439	1	1	80	0.0125000
NODE_2079_length_1574_cov_7.572203	1359	1439	6	15	80	0.1875000
NODE_2079_length_1574_cov_7.572203	1359	1439	8	14	80	0.1750000
NODE_2079_length_1574_cov_7.572203	1359	1439	9	11	80	0.1375000
NODE_2079_length_1574_cov_7.572203	1359	1439	10	30	80	0.3750000
NODE_2081_length_1573_cov_16.107191	437	512	0	75	75	1.0000000
NODE_2081_length_1573_cov_16.107191	485	565	0	80	80	1.0000000
NODE_2081_length_1573_cov_16.107191	561	639	0	78	78	1.0000000
NODE_2081_length_1573_cov_16.107191	612	692	0	80	80	1.0000000
NODE_2085_length_1572_cov_25.966735	359	404	221	1	45	0.0222222
NODE_2085_length_1572_cov_25.966735	359	404	223	2	45	0.0444444
NODE_2085_length_1572_cov_25.966735	359	404	225	3	45	0.0666667
NODE_2085_length_1572_cov_25.966735	359	404	226	1	45	0.0222222
NODE_2085_length_1572_cov_25.966735	359	404	229	1	45	0.0222222
NODE_2085_length_1572_cov_25.966735	359	404	231	1	45	0.0222222
NODE_2085_length_1572_cov_25.966735	359	404	233	2	45	0.0444444
NODE_2085_length_1572_cov_25.966735	359	404	235	1	45	0.0222222
NODE_2085_length_1572_cov_25.966735	359	404	239	1	45	0.0222222
NODE_2085_length_1572_cov_25.966735	359	404	241	1	45	0.0222222
NODE_2085_length_1572_cov_25.966735	359	404	245	1	45	0.0222222
NODE_2085_length_1572_cov_25.966735	359	404	251	1	45	0.0222222
NODE_2085_length_1572_cov_25.966735	359	404	252	1	45	0.0222222
NODE_2085_length_1572_cov_25.966735	359	404	259	2	45	0.0444444
NODE_2085_length_1572_cov_25.966735	359	404	263	1	45	0.0222222
NODE_2085_length_1572_cov_25.966735	359	404	264	1	45	0.0222222
NODE_2085_length_1572_cov_25.966735	359	404	269	2	45	0.0444444
NODE_2085_length_1572_cov_25.966735	359	404	273	1	45	0.0222222
NODE_2085_length_1572_cov_25.966735	359	404	275	1	45	0.0222222
NODE_2085_length_1572_cov_25.966735	359	404	285	1	45	0.0222222
NODE_2085_length_1572_cov_25.966735	359	404	294	2	45	0.0444444
NODE_2085_length_1572_cov_25.966735	359	404	296	2	45	0.0444444
NODE_2085_length_1572_cov_25.966735	359	404	298	1	45	0.0222222
NODE_2085_length_1572_cov_25.966735	359	404	299	1	45	0.0222222
NODE_2085_length_1572_cov_25.966735	359	404	300	4	45	0.0888889
NODE_2085_length_1572_cov_25.966735	359	404	301	1	45	0.0222222
NODE_2085_length_1572_cov_25.966735	359	404	302	2	45	0.0444444
NODE_2085_length_1572_cov_25.966735	359	404	305	1	45	0.0222222
NODE_2085_length_1572_cov_25.966735	359	404	314	1	45	0.0222222
NODE_2085_length_1572_cov_25.966735	359	404	317	1	45	0.0222222
NODE_2085_length_1572_cov_25.966735	359	404	331	1	45	0.0222222
NODE_2085_length_1572_cov_25.966735	359	404	335	1	45	0.0222222
NODE_2085_length_1572_cov_25.966735	359	404	337	1	45	0.0222222
NODE_2085_length_1572_cov_25.966735	405	477	135	3	72	0.0416667
NODE_2085_length_1572_cov_25.966735	405	477	137	2	72	0.0277778
NODE_2085_length_1572_cov_25.966735	405	477	139	1	72	0.0138889
NODE_2085_length_1572_cov_25.966735	405	477	140	1	72	0.0138889
NODE_2085_length_1572_cov_25.966735	405	477	141	5	72	0.0694444
NODE_2085_length_1572_cov_25.966735	405	477	142	1	72	0.0138889
NODE_2085_length_1572_cov_25.966735	405	477	143	2	72	0.0277778
NODE_2085_length_1572_cov_25.966735	405	477	145	1	72	0.0138889
NODE_2085_length_1572_cov_25.966735	405	477	149	1	72	0.0138889
NODE_2085_length_1572_cov_25.966735	405	477	150	4	72	0.0555556
NODE_2085_length_1572_cov_25.966735	405	477	151	1	72	0.0138889
NODE_2085_length_1572_cov_25.966735	405	477	153	2	72	0.0277778
NODE_2085_length_1572_cov_25.966735	405	477	154	2	72	0.0277778
NODE_2085_length_1572_cov_25.966735	405	477	155	3	72	0.0416667
NODE_2085_length_1572_cov_25.966735	405	477	157	1	72	0.0138889
NODE_2085_length_1572_cov_25.966735	405	477	158	1	72	0.0138889
NODE_2085_length_1572_cov_25.966735	405	477	159	1	72	0.0138889
NODE_2085_length_1572_cov_25.966735	405	477	161	1	72	0.0138889
NODE_2085_length_1572_cov_25.966735	405	477	162	1	72	0.0138889
NODE_2085_length_1572_cov_25.966735	405	477	164	2	72	0.0277778
NODE_2085_length_1572_cov_25.966735	405	477	172	4	72	0.0555556
NODE_2085_length_1572_cov_25.966735	405	477	174	7	72	0.0972222
NODE_2085_length_1572_cov_25.966735	405	477	179	2	72	0.0277778
NODE_2085_length_1572_cov_25.966735	405	477	180	1	72	0.0138889
NODE_2085_length_1572_cov_25.966735	405	477	189	1	72	0.0138889
NODE_2085_length_1572_cov_25.966735	405	477	195	1	72	0.0138889
NODE_2085_length_1572_cov_25.966735	405	477	197	3	72	0.0416667
NODE_2085_length_1572_cov_25.966735	405	477	198	2	72	0.0277778
NODE_2085_length_1572_cov_25.966735	405	477	199	1	72	0.0138889
NODE_2085_length_1572_cov_25.966735	405	477	201	4	72	0.0555556
NODE_2085_length_1572_cov_25.966735	405	477	202	1	72	0.0138889
NODE_2085_length_1572_cov_25.966735	405	477	203	2	72	0.0277778
NODE_2085_length_1572_cov_25.966735	405	477	208	1	72	0.0138889
NODE_2085_length_1572_cov_25.966735	405	477	210	2	72	0.0277778
NODE_2085_length_1572_cov_25.966735	405	477	214	2	72	0.0277778
NODE_2085_length_1572_cov_25.966735	405	477	216	2	72	0.0277778
NODE_2085_length_1572_cov_25.966735	1016	1096	0	67	80	0.8375000
NODE_2085_length_1572_cov_25.966735	1016	1096	2	13	80	0.1625000
NODE_2085_length_1572_cov_25.966735	1069	1149	0	14	80	0.1750000
NODE_2085_length_1572_cov_25.966735	1069	1149	2	66	80	0.8250000
NODE_2086_length_1572_cov_3.513238	1386	1462	4	13	76	0.1710526
NODE_2086_length_1572_cov_3.513238	1386	1462	6	2	76	0.0263158
NODE_2086_length_1572_cov_3.513238	1386	1462	7	6	76	0.0789474
NODE_2086_length_1572_cov_3.513238	1386	1462	8	2	76	0.0263158
NODE_2086_length_1572_cov_3.513238	1386	1462	11	8	76	0.1052632
NODE_2086_length_1572_cov_3.513238	1386	1462	15	3	76	0.0394737
NODE_2086_length_1572_cov_3.513238	1386	1462	16	19	76	0.2500000
NODE_2086_length_1572_cov_3.513238	1386	1462	20	2	76	0.0263158
NODE_2086_length_1572_cov_3.513238	1386	1462	22	11	76	0.1447368
NODE_2086_length_1572_cov_3.513238	1386	1462	24	10	76	0.1315790
NODE_2090_length_1570_cov_21.745071	700	780	0	24	80	0.3000000
NODE_2090_length_1570_cov_21.745071	700	780	2	1	80	0.0125000
NODE_2090_length_1570_cov_21.745071	700	780	4	20	80	0.2500000
NODE_2090_length_1570_cov_21.745071	700	780	7	1	80	0.0125000
NODE_2090_length_1570_cov_21.745071	700	780	8	6	80	0.0750000
NODE_2090_length_1570_cov_21.745071	700	780	10	10	80	0.1250000
NODE_2090_length_1570_cov_21.745071	700	780	14	18	80	0.2250000
NODE_2090_length_1570_cov_21.745071	753	833	8	2	80	0.0250000
NODE_2090_length_1570_cov_21.745071	753	833	10	15	80	0.1875000
NODE_2090_length_1570_cov_21.745071	753	833	12	28	80	0.3500000
NODE_2090_length_1570_cov_21.745071	753	833	14	35	80	0.4375000
NODE_2091_length_1570_cov_3.276003	387	467	0	80	80	1.0000000
NODE_2091_length_1570_cov_3.276003	440	520	0	80	80	1.0000000
NODE_2093_length_1569_cov_53.941497	741	821	0	31	80	0.3875000
NODE_2093_length_1569_cov_53.941497	741	821	8	41	80	0.5125000
NODE_2093_length_1569_cov_53.941497	741	821	10	8	80	0.1000000
NODE_2093_length_1569_cov_53.941497	794	874	8	19	80	0.2375000
NODE_2093_length_1569_cov_53.941497	794	874	10	61	80	0.7625000
NODE_2093_length_1569_cov_53.941497	870	950	0	49	80	0.6125000
NODE_2093_length_1569_cov_53.941497	870	950	2	11	80	0.1375000
NODE_2093_length_1569_cov_53.941497	870	950	10	20	80	0.2500000
NODE_2093_length_1569_cov_53.941497	923	1003	0	80	80	1.0000000
NODE_2094_length_1569_cov_12.426531	640	720	0	53	80	0.6625000
NODE_2094_length_1569_cov_12.426531	640	720	2	9	80	0.1125000
NODE_2094_length_1569_cov_12.426531	640	720	4	18	80	0.2250000
NODE_2094_length_1569_cov_12.426531	693	773	0	80	80	1.0000000
NODE_2094_length_1569_cov_12.426531	769	849	0	80	80	1.0000000
NODE_2094_length_1569_cov_12.426531	822	902	0	80	80	1.0000000
NODE_2095_length_1569_cov_12.365986	450	530	6	21	80	0.2625000
NODE_2095_length_1569_cov_12.365986	450	530	10	48	80	0.6000000
NODE_2095_length_1569_cov_12.365986	450	530	12	11	80	0.1375000
NODE_2095_length_1569_cov_12.365986	450	530	6	21	80	0.2625000
NODE_2095_length_1569_cov_12.365986	450	530	10	48	80	0.6000000
NODE_2095_length_1569_cov_12.365986	450	530	12	11	80	0.1375000
NODE_2095_length_1569_cov_12.365986	503	564	9	1	61	0.0163934
NODE_2095_length_1569_cov_12.365986	503	564	10	31	61	0.5081967
NODE_2095_length_1569_cov_12.365986	503	564	12	14	61	0.2295082
NODE_2095_length_1569_cov_12.365986	503	564	13	2	61	0.0327869
NODE_2095_length_1569_cov_12.365986	503	564	14	13	61	0.2131148
NODE_2095_length_1569_cov_12.365986	503	556	10	27	53	0.5094340
NODE_2095_length_1569_cov_12.365986	503	556	12	14	53	0.2641509
NODE_2095_length_1569_cov_12.365986	503	556	14	12	53	0.2264151
NODE_2096_length_1569_cov_11.599320	798	878	2	6	80	0.0750000
NODE_2096_length_1569_cov_11.599320	798	878	4	63	80	0.7875000
NODE_2096_length_1569_cov_11.599320	798	878	6	11	80	0.1375000
NODE_2096_length_1569_cov_11.599320	851	931	2	4	80	0.0500000
NODE_2096_length_1569_cov_11.599320	851	931	4	65	80	0.8125000
NODE_2096_length_1569_cov_11.599320	851	931	6	11	80	0.1375000
NODE_2097_length_1569_cov_10.917687	521	601	0	45	80	0.5625000
NODE_2097_length_1569_cov_10.917687	521	601	2	35	80	0.4375000
NODE_2097_length_1569_cov_10.917687	574	654	2	80	80	1.0000000
NODE_2108_length_1563_cov_15.357240	590	670	0	48	80	0.6000000
NODE_2108_length_1563_cov_15.357240	590	670	2	32	80	0.4000000
NODE_2108_length_1563_cov_15.357240	643	723	2	69	80	0.8625000
NODE_2108_length_1563_cov_15.357240	643	723	4	11	80	0.1375000
NODE_2110_length_1561_cov_18.420657	354	434	0	15	80	0.1875000
NODE_2110_length_1561_cov_18.420657	354	434	2	41	80	0.5125000
NODE_2110_length_1561_cov_18.420657	354	434	6	24	80	0.3000000
NODE_2110_length_1561_cov_18.420657	407	487	2	3	80	0.0375000
NODE_2110_length_1561_cov_18.420657	407	487	4	26	80	0.3250000
NODE_2110_length_1561_cov_18.420657	407	487	6	51	80	0.6375000
NODE_2110_length_1561_cov_18.420657	483	563	0	39	80	0.4875000
NODE_2110_length_1561_cov_18.420657	483	563	2	23	80	0.2875000
NODE_2110_length_1561_cov_18.420657	483	563	4	12	80	0.1500000
NODE_2110_length_1561_cov_18.420657	483	563	6	6	80	0.0750000
NODE_2110_length_1561_cov_18.420657	536	616	2	21	80	0.2625000
NODE_2110_length_1561_cov_18.420657	536	616	6	59	80	0.7375000
NODE_2116_length_1559_cov_7.071233	347	427	2	19	80	0.2375000
NODE_2116_length_1559_cov_7.071233	347	427	4	18	80	0.2250000
NODE_2116_length_1559_cov_7.071233	347	427	6	43	80	0.5375000
NODE_2116_length_1559_cov_7.071233	400	478	2	4	78	0.0512821
NODE_2116_length_1559_cov_7.071233	400	478	4	5	78	0.0641026
NODE_2116_length_1559_cov_7.071233	400	478	6	69	78	0.8846154
NODE_2116_length_1559_cov_7.071233	1187	1238	0	51	51	1.0000000
NODE_2118_length_1558_cov_3.486635	338	418	0	42	80	0.5250000
NODE_2118_length_1558_cov_3.486635	338	418	2	38	80	0.4750000
NODE_2118_length_1558_cov_3.486635	391	471	0	4	80	0.0500000
NODE_2118_length_1558_cov_3.486635	391	471	2	76	80	0.9500000
NODE_2119_length_1557_cov_17.089163	542	622	0	25	80	0.3125000
NODE_2119_length_1557_cov_17.089163	542	622	2	55	80	0.6875000
NODE_2119_length_1557_cov_17.089163	595	675	2	80	80	1.0000000
NODE_2120_length_1557_cov_4.639918	0	56	0	56	56	1.0000000
NODE_2120_length_1557_cov_4.639918	49	112	0	63	63	1.0000000
NODE_2120_length_1557_cov_4.639918	85	161	0	76	76	1.0000000
NODE_2123_length_1556_cov_23.289636	456	536	0	15	80	0.1875000
NODE_2123_length_1556_cov_23.289636	456	536	2	65	80	0.8125000
NODE_2123_length_1556_cov_23.289636	509	589	0	68	80	0.8500000
NODE_2123_length_1556_cov_23.289636	509	589	2	12	80	0.1500000
NODE_2123_length_1556_cov_23.289636	681	761	0	32	80	0.4000000
NODE_2123_length_1556_cov_23.289636	681	761	2	48	80	0.6000000
NODE_2123_length_1556_cov_23.289636	734	814	0	28	80	0.3500000
NODE_2123_length_1556_cov_23.289636	734	814	2	52	80	0.6500000
NODE_2123_length_1556_cov_23.289636	1445	1525	80	2	80	0.0250000
NODE_2123_length_1556_cov_23.289636	1445	1525	82	2	80	0.0250000
NODE_2123_length_1556_cov_23.289636	1445	1525	91	3	80	0.0375000
NODE_2123_length_1556_cov_23.289636	1445	1525	92	73	80	0.9125000
NODE_2124_length_1556_cov_7.494166	300	380	0	22	80	0.2750000
NODE_2124_length_1556_cov_7.494166	300	380	2	15	80	0.1875000
NODE_2124_length_1556_cov_7.494166	300	380	4	43	80	0.5375000
NODE_2124_length_1556_cov_7.494166	353	433	2	35	80	0.4375000
NODE_2124_length_1556_cov_7.494166	353	433	4	45	80	0.5625000
NODE_2126_length_1555_cov_13.461538	666	746	0	80	80	1.0000000
NODE_2126_length_1555_cov_13.461538	719	799	0	80	80	1.0000000
NODE_2127_length_1554_cov_30.239175	144	226	0	13	82	0.1585366
NODE_2127_length_1554_cov_30.239175	144	226	1	9	82	0.1097561
NODE_2127_length_1554_cov_30.239175	144	226	6	13	82	0.1585366
NODE_2127_length_1554_cov_30.239175	144	226	8	47	82	0.5731707
NODE_2127_length_1554_cov_30.239175	199	279	0	13	80	0.1625000
NODE_2127_length_1554_cov_30.239175	199	279	1	11	80	0.1375000
NODE_2127_length_1554_cov_30.239175	199	279	3	8	80	0.1000000
NODE_2127_length_1554_cov_30.239175	199	279	6	5	80	0.0625000
NODE_2127_length_1554_cov_30.239175	199	279	7	17	80	0.2125000
NODE_2127_length_1554_cov_30.239175	199	279	9	2	80	0.0250000
NODE_2127_length_1554_cov_30.239175	199	279	11	5	80	0.0625000
NODE_2127_length_1554_cov_30.239175	199	279	14	1	80	0.0125000
NODE_2127_length_1554_cov_30.239175	199	279	16	2	80	0.0250000
NODE_2127_length_1554_cov_30.239175	199	279	22	1	80	0.0125000
NODE_2127_length_1554_cov_30.239175	199	279	24	1	80	0.0125000
NODE_2127_length_1554_cov_30.239175	199	279	26	6	80	0.0750000
NODE_2127_length_1554_cov_30.239175	199	279	28	2	80	0.0250000
NODE_2127_length_1554_cov_30.239175	199	279	32	2	80	0.0250000
NODE_2127_length_1554_cov_30.239175	199	279	34	2	80	0.0250000
NODE_2127_length_1554_cov_30.239175	199	279	36	2	80	0.0250000
NODE_2127_length_1554_cov_30.239175	877	903	2	1	26	0.0384615
NODE_2127_length_1554_cov_30.239175	877	903	4	1	26	0.0384615
NODE_2127_length_1554_cov_30.239175	877	903	7	1	26	0.0384615
NODE_2127_length_1554_cov_30.239175	877	903	8	13	26	0.5000000
NODE_2127_length_1554_cov_30.239175	877	903	14	10	26	0.3846154
NODE_2127_length_1554_cov_30.239175	930	1010	12	80	80	1.0000000
NODE_2127_length_1554_cov_30.239175	983	1063	0	20	80	0.2500000
NODE_2127_length_1554_cov_30.239175	983	1063	5	1	80	0.0125000
NODE_2127_length_1554_cov_30.239175	983	1063	6	13	80	0.1625000
NODE_2127_length_1554_cov_30.239175	983	1063	12	46	80	0.5750000
NODE_2128_length_1554_cov_5.381443	1494	1554	2	1	60	0.0166667
NODE_2128_length_1554_cov_5.381443	1494	1554	4	1	60	0.0166667
NODE_2128_length_1554_cov_5.381443	1494	1554	8	1	60	0.0166667
NODE_2128_length_1554_cov_5.381443	1494	1554	9	1	60	0.0166667
NODE_2128_length_1554_cov_5.381443	1494	1554	14	3	60	0.0500000
NODE_2128_length_1554_cov_5.381443	1494	1554	28	3	60	0.0500000
NODE_2128_length_1554_cov_5.381443	1494	1554	32	1	60	0.0166667
NODE_2128_length_1554_cov_5.381443	1494	1554	35	1	60	0.0166667
NODE_2128_length_1554_cov_5.381443	1494	1554	37	2	60	0.0333333
NODE_2128_length_1554_cov_5.381443	1494	1554	39	1	60	0.0166667
NODE_2128_length_1554_cov_5.381443	1494	1554	40	45	60	0.7500000
NODE_2132_length_1552_cov_11.367515	379	445	0	66	66	1.0000000
NODE_2132_length_1552_cov_11.367515	418	484	0	66	66	1.0000000
NODE_2138_length_1549_cov_15.480000	1288	1368	0	19	80	0.2375000
NODE_2138_length_1549_cov_15.480000	1288	1368	2	61	80	0.7625000
NODE_2138_length_1549_cov_15.480000	1341	1421	0	20	80	0.2500000
NODE_2138_length_1549_cov_15.480000	1341	1421	2	60	80	0.7500000
NODE_2142_length_1548_cov_12.789510	770	850	0	28	80	0.3500000
NODE_2142_length_1548_cov_12.789510	770	850	2	52	80	0.6500000
NODE_2142_length_1548_cov_12.789510	823	903	2	41	80	0.5125000
NODE_2142_length_1548_cov_12.789510	823	903	4	7	80	0.0875000
NODE_2142_length_1548_cov_12.789510	823	903	6	32	80	0.4000000
NODE_2149_length_1546_cov_24.069800	775	855	0	29	80	0.3625000
NODE_2149_length_1546_cov_24.069800	775	855	4	51	80	0.6375000
NODE_2149_length_1546_cov_24.069800	828	908	0	11	80	0.1375000
NODE_2149_length_1546_cov_24.069800	828	908	4	69	80	0.8625000
NODE_2150_length_1546_cov_10.911541	417	497	0	55	80	0.6875000
NODE_2150_length_1546_cov_10.911541	417	497	2	25	80	0.3125000
NODE_2150_length_1546_cov_10.911541	470	550	0	2	80	0.0250000
NODE_2150_length_1546_cov_10.911541	470	550	2	59	80	0.7375000
NODE_2150_length_1546_cov_10.911541	470	550	4	19	80	0.2375000
NODE_2150_length_1546_cov_10.911541	1065	1145	0	80	80	1.0000000
NODE_2150_length_1546_cov_10.911541	1118	1198	0	80	80	1.0000000
NODE_2155_length_1543_cov_10.400970	480	560	2	25	80	0.3125000
NODE_2155_length_1543_cov_10.400970	480	560	10	55	80	0.6875000
NODE_2155_length_1543_cov_10.400970	533	613	6	38	80	0.4750000
NODE_2155_length_1543_cov_10.400970	533	613	8	3	80	0.0375000
NODE_2155_length_1543_cov_10.400970	533	613	10	39	80	0.4875000
NODE_2156_length_1543_cov_4.532548	43	98	0	55	55	1.0000000
NODE_2162_length_1541_cov_7.316921	523	603	4	11	80	0.1375000
NODE_2162_length_1541_cov_7.316921	523	603	6	69	80	0.8625000
NODE_2162_length_1541_cov_7.316921	576	658	0	20	82	0.2439024
NODE_2162_length_1541_cov_7.316921	576	658	4	36	82	0.4390244
NODE_2162_length_1541_cov_7.316921	576	658	6	26	82	0.3170732
NODE_2165_length_1539_cov_19.067361	334	414	0	80	80	1.0000000
NODE_2165_length_1539_cov_19.067361	387	467	0	80	80	1.0000000
NODE_2165_length_1539_cov_19.067361	463	543	0	80	80	1.0000000
NODE_2165_length_1539_cov_19.067361	516	596	0	80	80	1.0000000
NODE_2171_length_1538_cov_68.273801	604	684	0	64	80	0.8000000
NODE_2171_length_1538_cov_68.273801	604	684	2	16	80	0.2000000
NODE_2171_length_1538_cov_68.273801	657	737	0	12	80	0.1500000
NODE_2171_length_1538_cov_68.273801	657	737	2	68	80	0.8500000
NODE_2172_length_1538_cov_2.402363	1456	1499	2	43	43	1.0000000
NODE_2173_length_1537_cov_39.413074	782	862	0	38	80	0.4750000
NODE_2173_length_1537_cov_39.413074	782	862	2	42	80	0.5250000
NODE_2173_length_1537_cov_39.413074	835	915	0	80	80	1.0000000
NODE_2173_length_1537_cov_39.413074	911	991	0	80	80	1.0000000
NODE_2173_length_1537_cov_39.413074	964	1044	0	80	80	1.0000000
NODE_2174_length_1537_cov_30.412378	739	819	6	33	80	0.4125000
NODE_2174_length_1537_cov_30.412378	739	819	8	47	80	0.5875000
NODE_2174_length_1537_cov_30.412378	792	872	0	35	80	0.4375000
NODE_2174_length_1537_cov_30.412378	792	872	6	21	80	0.2625000
NODE_2174_length_1537_cov_30.412378	792	872	8	24	80	0.3000000
NODE_2174_length_1537_cov_30.412378	868	948	0	48	80	0.6000000
NODE_2174_length_1537_cov_30.412378	868	948	1	4	80	0.0500000
NODE_2174_length_1537_cov_30.412378	868	948	2	28	80	0.3500000
NODE_2174_length_1537_cov_30.412378	921	1001	2	40	80	0.5000000
NODE_2174_length_1537_cov_30.412378	921	1001	4	40	80	0.5000000
NODE_2175_length_1537_cov_18.707232	669	749	3	1	80	0.0125000
NODE_2175_length_1537_cov_18.707232	669	749	5	56	80	0.7000000
NODE_2175_length_1537_cov_18.707232	669	749	7	23	80	0.2875000
NODE_2175_length_1537_cov_18.707232	722	802	2	27	80	0.3375000
NODE_2175_length_1537_cov_18.707232	722	802	3	21	80	0.2625000
NODE_2175_length_1537_cov_18.707232	722	802	4	6	80	0.0750000
NODE_2175_length_1537_cov_18.707232	722	802	5	24	80	0.3000000
NODE_2175_length_1537_cov_18.707232	722	802	7	2	80	0.0250000
NODE_2176_length_1536_cov_24.991649	832	912	0	80	80	1.0000000
NODE_2176_length_1536_cov_24.991649	885	965	0	80	80	1.0000000
NODE_2176_length_1536_cov_24.991649	961	1041	0	78	80	0.9750000
NODE_2176_length_1536_cov_24.991649	961	1041	2	2	80	0.0250000
NODE_2176_length_1536_cov_24.991649	1014	1094	0	25	80	0.3125000
NODE_2176_length_1536_cov_24.991649	1014	1094	2	25	80	0.3125000
NODE_2176_length_1536_cov_24.991649	1014	1094	4	30	80	0.3750000
NODE_2183_length_1535_cov_46.662256	992	1072	0	80	80	1.0000000
NODE_2183_length_1535_cov_46.662256	1045	1125	0	80	80	1.0000000
NODE_2183_length_1535_cov_46.662256	1127	1203	0	39	76	0.5131579
NODE_2183_length_1535_cov_46.662256	1127	1203	1	1	76	0.0131579
NODE_2183_length_1535_cov_46.662256	1127	1203	2	36	76	0.4736842
NODE_2183_length_1535_cov_46.662256	1176	1256	0	3	80	0.0375000
NODE_2183_length_1535_cov_46.662256	1176	1256	2	77	80	0.9625000
NODE_2184_length_1535_cov_32.610724	992	1072	0	80	80	1.0000000
NODE_2184_length_1535_cov_32.610724	1045	1125	0	79	80	0.9875000
NODE_2184_length_1535_cov_32.610724	1045	1125	1	1	80	0.0125000
NODE_2184_length_1535_cov_32.610724	1121	1201	0	3	80	0.0375000
NODE_2184_length_1535_cov_32.610724	1121	1201	1	1	80	0.0125000
NODE_2184_length_1535_cov_32.610724	1121	1201	2	25	80	0.3125000
NODE_2184_length_1535_cov_32.610724	1121	1201	4	51	80	0.6375000
NODE_2184_length_1535_cov_32.610724	1174	1254	4	38	80	0.4750000
NODE_2184_length_1535_cov_32.610724	1174	1254	6	17	80	0.2125000
NODE_2184_length_1535_cov_32.610724	1174	1254	8	11	80	0.1375000
NODE_2184_length_1535_cov_32.610724	1174	1254	10	14	80	0.1750000
NODE_2185_length_1535_cov_25.406685	619	699	0	80	80	1.0000000
NODE_2185_length_1535_cov_25.406685	672	752	0	80	80	1.0000000
NODE_2190_length_1534_cov_13.542857	439	519	0	75	80	0.9375000
NODE_2190_length_1534_cov_13.542857	439	519	3	1	80	0.0125000
NODE_2190_length_1534_cov_13.542857	439	519	4	4	80	0.0500000
NODE_2190_length_1534_cov_13.542857	492	567	0	22	75	0.2933333
NODE_2190_length_1534_cov_13.542857	492	567	3	1	75	0.0133333
NODE_2190_length_1534_cov_13.542857	492	567	4	52	75	0.6933333
NODE_2197_length_1531_cov_17.336592	324	404	0	1	80	0.0125000
NODE_2197_length_1531_cov_17.336592	324	404	2	16	80	0.2000000
NODE_2197_length_1531_cov_17.336592	324	404	4	10	80	0.1250000
NODE_2197_length_1531_cov_17.336592	324	404	6	18	80	0.2250000
NODE_2197_length_1531_cov_17.336592	324	404	8	20	80	0.2500000
NODE_2197_length_1531_cov_17.336592	324	404	12	15	80	0.1875000
NODE_2198_length_1531_cov_6.267458	606	686	0	80	80	1.0000000
NODE_2198_length_1531_cov_6.267458	659	739	0	80	80	1.0000000
NODE_2199_length_1530_cov_13.514326	323	403	0	6	80	0.0750000
NODE_2199_length_1530_cov_13.514326	323	403	14	53	80	0.6625000
NODE_2199_length_1530_cov_13.514326	323	403	15	21	80	0.2625000
NODE_2199_length_1530_cov_13.514326	376	456	0	17	80	0.2125000
NODE_2199_length_1530_cov_13.514326	376	456	14	6	80	0.0750000
NODE_2199_length_1530_cov_13.514326	376	456	15	21	80	0.2625000
NODE_2199_length_1530_cov_13.514326	376	456	16	36	80	0.4500000
NODE_2199_length_1530_cov_13.514326	1465	1513	0	48	48	1.0000000
NODE_2200_length_1530_cov_9.012579	637	717	0	21	80	0.2625000
NODE_2200_length_1530_cov_9.012579	637	717	2	59	80	0.7375000
NODE_2200_length_1530_cov_9.012579	690	770	0	16	80	0.2000000
NODE_2200_length_1530_cov_9.012579	690	770	2	64	80	0.8000000
NODE_2203_length_1529_cov_21.061538	983	1063	0	34	80	0.4250000
NODE_2203_length_1529_cov_21.061538	983	1063	2	46	80	0.5750000
NODE_2203_length_1529_cov_21.061538	1036	1116	0	24	80	0.3000000
NODE_2203_length_1529_cov_21.061538	1036	1116	2	56	80	0.7000000
NODE_2205_length_1529_cov_1.380420	219	282	2	5	63	0.0793651
NODE_2205_length_1529_cov_1.380420	219	282	4	3	63	0.0476190
NODE_2205_length_1529_cov_1.380420	219	282	6	9	63	0.1428571
NODE_2205_length_1529_cov_1.380420	219	282	8	46	63	0.7301587
NODE_2205_length_1529_cov_1.380420	272	323	0	8	51	0.1568628
NODE_2205_length_1529_cov_1.380420	272	323	2	4	51	0.0784314
NODE_2205_length_1529_cov_1.380420	272	323	4	10	51	0.1960784
NODE_2205_length_1529_cov_1.380420	272	323	6	23	51	0.4509804
NODE_2205_length_1529_cov_1.380420	272	323	8	6	51	0.1176471
NODE_2206_length_1528_cov_8.578027	449	529	0	34	80	0.4250000
NODE_2206_length_1528_cov_8.578027	449	529	2	46	80	0.5750000
NODE_2206_length_1528_cov_8.578027	502	582	0	80	80	1.0000000
NODE_2210_length_1526_cov_92.265592	986	1066	0	9	80	0.1125000
NODE_2210_length_1526_cov_92.265592	986	1066	2	6	80	0.0750000
NODE_2210_length_1526_cov_92.265592	986	1066	5	1	80	0.0125000
NODE_2210_length_1526_cov_92.265592	986	1066	6	10	80	0.1250000
NODE_2210_length_1526_cov_92.265592	986	1066	8	9	80	0.1125000
NODE_2210_length_1526_cov_92.265592	986	1066	12	45	80	0.5625000
NODE_2210_length_1526_cov_92.265592	1039	1119	10	13	80	0.1625000
NODE_2210_length_1526_cov_92.265592	1039	1119	12	67	80	0.8375000
NODE_2211_length_1526_cov_4.051857	291	370	0	60	79	0.7594936
NODE_2211_length_1526_cov_4.051857	291	370	2	1	79	0.0126582
NODE_2211_length_1526_cov_4.051857	291	370	4	2	79	0.0253165
NODE_2211_length_1526_cov_4.051857	291	370	6	16	79	0.2025317
NODE_2213_length_1525_cov_20.232118	1014	1090	224	1	76	0.0131579
NODE_2213_length_1525_cov_20.232118	1014	1090	228	1	76	0.0131579
NODE_2213_length_1525_cov_20.232118	1014	1090	231	2	76	0.0263158
NODE_2213_length_1525_cov_20.232118	1014	1090	235	1	76	0.0131579
NODE_2213_length_1525_cov_20.232118	1014	1090	237	1	76	0.0131579
NODE_2213_length_1525_cov_20.232118	1014	1090	241	1	76	0.0131579
NODE_2213_length_1525_cov_20.232118	1014	1090	249	1	76	0.0131579
NODE_2213_length_1525_cov_20.232118	1014	1090	270	1	76	0.0131579
NODE_2213_length_1525_cov_20.232118	1014	1090	272	2	76	0.0263158
NODE_2213_length_1525_cov_20.232118	1014	1090	280	1	76	0.0131579
NODE_2213_length_1525_cov_20.232118	1014	1090	281	2	76	0.0263158
NODE_2213_length_1525_cov_20.232118	1014	1090	283	2	76	0.0263158
NODE_2213_length_1525_cov_20.232118	1014	1090	287	1	76	0.0131579
NODE_2213_length_1525_cov_20.232118	1014	1090	293	1	76	0.0131579
NODE_2213_length_1525_cov_20.232118	1014	1090	296	2	76	0.0263158
NODE_2213_length_1525_cov_20.232118	1014	1090	297	1	76	0.0131579
NODE_2213_length_1525_cov_20.232118	1014	1090	298	2	76	0.0263158
NODE_2213_length_1525_cov_20.232118	1014	1090	300	1	76	0.0131579
NODE_2213_length_1525_cov_20.232118	1014	1090	302	1	76	0.0131579
NODE_2213_length_1525_cov_20.232118	1014	1090	306	1	76	0.0131579
NODE_2213_length_1525_cov_20.232118	1014	1090	307	1	76	0.0131579
NODE_2213_length_1525_cov_20.232118	1014	1090	312	1	76	0.0131579
NODE_2213_length_1525_cov_20.232118	1014	1090	313	3	76	0.0394737
NODE_2213_length_1525_cov_20.232118	1014	1090	315	1	76	0.0131579
NODE_2213_length_1525_cov_20.232118	1014	1090	319	1	76	0.0131579
NODE_2213_length_1525_cov_20.232118	1014	1090	325	1	76	0.0131579
NODE_2213_length_1525_cov_20.232118	1014	1090	326	1	76	0.0131579
NODE_2213_length_1525_cov_20.232118	1014	1090	329	2	76	0.0263158
NODE_2213_length_1525_cov_20.232118	1014	1090	331	1	76	0.0131579
NODE_2213_length_1525_cov_20.232118	1014	1090	334	8	76	0.1052632
NODE_2213_length_1525_cov_20.232118	1014	1090	335	1	76	0.0131579
NODE_2213_length_1525_cov_20.232118	1014	1090	337	1	76	0.0131579
NODE_2213_length_1525_cov_20.232118	1014	1090	343	2	76	0.0263158
NODE_2213_length_1525_cov_20.232118	1014	1090	347	2	76	0.0263158
NODE_2213_length_1525_cov_20.232118	1014	1090	351	2	76	0.0263158
NODE_2213_length_1525_cov_20.232118	1014	1090	353	1	76	0.0131579
NODE_2213_length_1525_cov_20.232118	1014	1090	354	2	76	0.0263158
NODE_2213_length_1525_cov_20.232118	1014	1090	355	8	76	0.1052632
NODE_2213_length_1525_cov_20.232118	1014	1090	359	2	76	0.0263158
NODE_2213_length_1525_cov_20.232118	1014	1090	361	3	76	0.0394737
NODE_2213_length_1525_cov_20.232118	1014	1090	362	1	76	0.0131579
NODE_2213_length_1525_cov_20.232118	1014	1090	363	1	76	0.0131579
NODE_2213_length_1525_cov_20.232118	1014	1090	364	1	76	0.0131579
NODE_2213_length_1525_cov_20.232118	1014	1090	366	3	76	0.0394737
NODE_2213_length_1525_cov_20.232118	1281	1338	0	57	57	1.0000000
NODE_2214_length_1525_cov_11.421459	804	884	0	80	80	1.0000000
NODE_2214_length_1525_cov_11.421459	857	937	0	80	80	1.0000000
NODE_2217_length_1524_cov_130.874386	171	243	305	1	72	0.0138889
NODE_2217_length_1524_cov_130.874386	171	243	307	1	72	0.0138889
NODE_2217_length_1524_cov_130.874386	171	243	313	2	72	0.0277778
NODE_2217_length_1524_cov_130.874386	171	243	315	1	72	0.0138889
NODE_2217_length_1524_cov_130.874386	171	243	316	1	72	0.0138889
NODE_2217_length_1524_cov_130.874386	171	243	317	1	72	0.0138889
NODE_2217_length_1524_cov_130.874386	171	243	318	1	72	0.0138889
NODE_2217_length_1524_cov_130.874386	171	243	322	1	72	0.0138889
NODE_2217_length_1524_cov_130.874386	171	243	334	1	72	0.0138889
NODE_2217_length_1524_cov_130.874386	171	243	343	1	72	0.0138889
NODE_2217_length_1524_cov_130.874386	171	243	360	1	72	0.0138889
NODE_2217_length_1524_cov_130.874386	171	243	361	1	72	0.0138889
NODE_2217_length_1524_cov_130.874386	171	243	363	1	72	0.0138889
NODE_2217_length_1524_cov_130.874386	171	243	369	1	72	0.0138889
NODE_2217_length_1524_cov_130.874386	171	243	375	1	72	0.0138889
NODE_2217_length_1524_cov_130.874386	171	243	383	1	72	0.0138889
NODE_2217_length_1524_cov_130.874386	171	243	385	1	72	0.0138889
NODE_2217_length_1524_cov_130.874386	171	243	393	1	72	0.0138889
NODE_2217_length_1524_cov_130.874386	171	243	405	1	72	0.0138889
NODE_2217_length_1524_cov_130.874386	171	243	409	1	72	0.0138889
NODE_2217_length_1524_cov_130.874386	171	243	424	1	72	0.0138889
NODE_2217_length_1524_cov_130.874386	171	243	431	1	72	0.0138889
NODE_2217_length_1524_cov_130.874386	171	243	434	1	72	0.0138889
NODE_2217_length_1524_cov_130.874386	171	243	437	1	72	0.0138889
NODE_2217_length_1524_cov_130.874386	171	243	439	1	72	0.0138889
NODE_2217_length_1524_cov_130.874386	171	243	440	5	72	0.0694444
NODE_2217_length_1524_cov_130.874386	171	243	442	1	72	0.0138889
NODE_2217_length_1524_cov_130.874386	171	243	445	3	72	0.0416667
NODE_2217_length_1524_cov_130.874386	171	243	447	1	72	0.0138889
NODE_2217_length_1524_cov_130.874386	171	243	451	1	72	0.0138889
NODE_2217_length_1524_cov_130.874386	171	243	453	1	72	0.0138889
NODE_2217_length_1524_cov_130.874386	171	243	455	1	72	0.0138889
NODE_2217_length_1524_cov_130.874386	171	243	460	1	72	0.0138889
NODE_2217_length_1524_cov_130.874386	171	243	461	1	72	0.0138889
NODE_2217_length_1524_cov_130.874386	171	243	462	1	72	0.0138889
NODE_2217_length_1524_cov_130.874386	171	243	466	1	72	0.0138889
NODE_2217_length_1524_cov_130.874386	171	243	468	1	72	0.0138889
NODE_2217_length_1524_cov_130.874386	171	243	472	1	72	0.0138889
NODE_2217_length_1524_cov_130.874386	171	243	473	3	72	0.0416667
NODE_2217_length_1524_cov_130.874386	171	243	478	3	72	0.0416667
NODE_2217_length_1524_cov_130.874386	171	243	480	2	72	0.0277778
NODE_2217_length_1524_cov_130.874386	171	243	481	2	72	0.0277778
NODE_2217_length_1524_cov_130.874386	171	243	482	1	72	0.0138889
NODE_2217_length_1524_cov_130.874386	171	243	483	2	72	0.0277778
NODE_2217_length_1524_cov_130.874386	171	243	484	5	72	0.0694444
NODE_2217_length_1524_cov_130.874386	171	243	486	1	72	0.0138889
NODE_2217_length_1524_cov_130.874386	171	243	487	3	72	0.0416667
NODE_2217_length_1524_cov_130.874386	171	243	489	1	72	0.0138889
NODE_2217_length_1524_cov_130.874386	171	243	492	1	72	0.0138889
NODE_2217_length_1524_cov_130.874386	171	243	493	1	72	0.0138889
NODE_2217_length_1524_cov_130.874386	171	243	495	2	72	0.0277778
NODE_2217_length_1524_cov_130.874386	191	247	409	1	56	0.0178571
NODE_2217_length_1524_cov_130.874386	191	247	420	1	56	0.0178571
NODE_2217_length_1524_cov_130.874386	191	247	424	1	56	0.0178571
NODE_2217_length_1524_cov_130.874386	191	247	430	1	56	0.0178571
NODE_2217_length_1524_cov_130.874386	191	247	431	1	56	0.0178571
NODE_2217_length_1524_cov_130.874386	191	247	432	1	56	0.0178571
NODE_2217_length_1524_cov_130.874386	191	247	434	2	56	0.0357143
NODE_2217_length_1524_cov_130.874386	191	247	437	1	56	0.0178571
NODE_2217_length_1524_cov_130.874386	191	247	439	1	56	0.0178571
NODE_2217_length_1524_cov_130.874386	191	247	440	5	56	0.0892857
NODE_2217_length_1524_cov_130.874386	191	247	442	1	56	0.0178571
NODE_2217_length_1524_cov_130.874386	191	247	445	3	56	0.0535714
NODE_2217_length_1524_cov_130.874386	191	247	447	1	56	0.0178571
NODE_2217_length_1524_cov_130.874386	191	247	451	1	56	0.0178571
NODE_2217_length_1524_cov_130.874386	191	247	453	1	56	0.0178571
NODE_2217_length_1524_cov_130.874386	191	247	455	1	56	0.0178571
NODE_2217_length_1524_cov_130.874386	191	247	460	1	56	0.0178571
NODE_2217_length_1524_cov_130.874386	191	247	461	1	56	0.0178571
NODE_2217_length_1524_cov_130.874386	191	247	462	1	56	0.0178571
NODE_2217_length_1524_cov_130.874386	191	247	466	1	56	0.0178571
NODE_2217_length_1524_cov_130.874386	191	247	468	1	56	0.0178571
NODE_2217_length_1524_cov_130.874386	191	247	472	1	56	0.0178571
NODE_2217_length_1524_cov_130.874386	191	247	473	3	56	0.0535714
NODE_2217_length_1524_cov_130.874386	191	247	478	3	56	0.0535714
NODE_2217_length_1524_cov_130.874386	191	247	480	2	56	0.0357143
NODE_2217_length_1524_cov_130.874386	191	247	481	2	56	0.0357143
NODE_2217_length_1524_cov_130.874386	191	247	482	1	56	0.0178571
NODE_2217_length_1524_cov_130.874386	191	247	483	2	56	0.0357143
NODE_2217_length_1524_cov_130.874386	191	247	484	5	56	0.0892857
NODE_2217_length_1524_cov_130.874386	191	247	486	1	56	0.0178571
NODE_2217_length_1524_cov_130.874386	191	247	487	3	56	0.0535714
NODE_2217_length_1524_cov_130.874386	191	247	489	1	56	0.0178571
NODE_2217_length_1524_cov_130.874386	191	247	492	1	56	0.0178571
NODE_2217_length_1524_cov_130.874386	191	247	493	1	56	0.0178571
NODE_2217_length_1524_cov_130.874386	191	247	495	2	56	0.0357143
NODE_2217_length_1524_cov_130.874386	219	296	224	1	77	0.0129870
NODE_2217_length_1524_cov_130.874386	219	296	235	1	77	0.0129870
NODE_2217_length_1524_cov_130.874386	219	296	242	1	77	0.0129870
NODE_2217_length_1524_cov_130.874386	219	296	253	1	77	0.0129870
NODE_2217_length_1524_cov_130.874386	219	296	256	1	77	0.0129870
NODE_2217_length_1524_cov_130.874386	219	296	265	1	77	0.0129870
NODE_2217_length_1524_cov_130.874386	219	296	268	1	77	0.0129870
NODE_2217_length_1524_cov_130.874386	219	296	269	1	77	0.0129870
NODE_2217_length_1524_cov_130.874386	219	296	275	2	77	0.0259740
NODE_2217_length_1524_cov_130.874386	219	296	283	1	77	0.0129870
NODE_2217_length_1524_cov_130.874386	219	296	289	1	77	0.0129870
NODE_2217_length_1524_cov_130.874386	219	296	291	2	77	0.0259740
NODE_2217_length_1524_cov_130.874386	219	296	293	2	77	0.0259740
NODE_2217_length_1524_cov_130.874386	219	296	299	1	77	0.0129870
NODE_2217_length_1524_cov_130.874386	219	296	305	1	77	0.0129870
NODE_2217_length_1524_cov_130.874386	219	296	307	1	77	0.0129870
NODE_2217_length_1524_cov_130.874386	219	296	311	1	77	0.0129870
NODE_2217_length_1524_cov_130.874386	219	296	315	1	77	0.0129870
NODE_2217_length_1524_cov_130.874386	219	296	319	1	77	0.0129870
NODE_2217_length_1524_cov_130.874386	219	296	333	1	77	0.0129870
NODE_2217_length_1524_cov_130.874386	219	296	335	1	77	0.0129870
NODE_2217_length_1524_cov_130.874386	219	296	337	1	77	0.0129870
NODE_2217_length_1524_cov_130.874386	219	296	339	1	77	0.0129870
NODE_2217_length_1524_cov_130.874386	219	296	343	1	77	0.0129870
NODE_2217_length_1524_cov_130.874386	219	296	356	1	77	0.0129870
NODE_2217_length_1524_cov_130.874386	219	296	364	1	77	0.0129870
NODE_2217_length_1524_cov_130.874386	219	296	365	1	77	0.0129870
NODE_2217_length_1524_cov_130.874386	219	296	368	1	77	0.0129870
NODE_2217_length_1524_cov_130.874386	219	296	370	2	77	0.0259740
NODE_2217_length_1524_cov_130.874386	219	296	375	2	77	0.0259740
NODE_2217_length_1524_cov_130.874386	219	296	380	2	77	0.0259740
NODE_2217_length_1524_cov_130.874386	219	296	390	2	77	0.0259740
NODE_2217_length_1524_cov_130.874386	219	296	394	3	77	0.0389610
NODE_2217_length_1524_cov_130.874386	219	296	397	1	77	0.0129870
NODE_2217_length_1524_cov_130.874386	219	296	399	1	77	0.0129870
NODE_2217_length_1524_cov_130.874386	219	296	408	1	77	0.0129870
NODE_2217_length_1524_cov_130.874386	219	296	413	2	77	0.0259740
NODE_2217_length_1524_cov_130.874386	219	296	414	1	77	0.0129870
NODE_2217_length_1524_cov_130.874386	219	296	417	1	77	0.0129870
NODE_2217_length_1524_cov_130.874386	219	296	420	1	77	0.0129870
NODE_2217_length_1524_cov_130.874386	219	296	430	1	77	0.0129870
NODE_2217_length_1524_cov_130.874386	219	296	432	1	77	0.0129870
NODE_2217_length_1524_cov_130.874386	219	296	434	2	77	0.0259740
NODE_2217_length_1524_cov_130.874386	219	296	440	5	77	0.0649351
NODE_2217_length_1524_cov_130.874386	219	296	442	1	77	0.0129870
NODE_2217_length_1524_cov_130.874386	219	296	445	1	77	0.0129870
NODE_2217_length_1524_cov_130.874386	219	296	447	1	77	0.0129870
NODE_2217_length_1524_cov_130.874386	219	296	451	1	77	0.0129870
NODE_2217_length_1524_cov_130.874386	219	296	453	1	77	0.0129870
NODE_2217_length_1524_cov_130.874386	219	296	460	1	77	0.0129870
NODE_2217_length_1524_cov_130.874386	219	296	462	1	77	0.0129870
NODE_2217_length_1524_cov_130.874386	219	296	466	1	77	0.0129870
NODE_2217_length_1524_cov_130.874386	219	296	468	1	77	0.0129870
NODE_2217_length_1524_cov_130.874386	219	296	472	1	77	0.0129870
NODE_2217_length_1524_cov_130.874386	219	296	473	3	77	0.0389610
NODE_2217_length_1524_cov_130.874386	219	296	478	2	77	0.0259740
NODE_2217_length_1524_cov_130.874386	219	296	480	1	77	0.0129870
NODE_2217_length_1524_cov_130.874386	219	296	481	1	77	0.0129870
NODE_2217_length_1524_cov_130.874386	219	296	482	1	77	0.0129870
NODE_2217_length_1524_cov_130.874386	253	333	69	1	80	0.0125000
NODE_2217_length_1524_cov_130.874386	253	333	76	2	80	0.0250000
NODE_2217_length_1524_cov_130.874386	253	333	79	1	80	0.0125000
NODE_2217_length_1524_cov_130.874386	253	333	83	1	80	0.0125000
NODE_2217_length_1524_cov_130.874386	253	333	84	3	80	0.0375000
NODE_2217_length_1524_cov_130.874386	253	333	88	1	80	0.0125000
NODE_2217_length_1524_cov_130.874386	253	333	90	1	80	0.0125000
NODE_2217_length_1524_cov_130.874386	253	333	92	1	80	0.0125000
NODE_2217_length_1524_cov_130.874386	253	333	98	1	80	0.0125000
NODE_2217_length_1524_cov_130.874386	253	333	102	2	80	0.0250000
NODE_2217_length_1524_cov_130.874386	253	333	107	1	80	0.0125000
NODE_2217_length_1524_cov_130.874386	253	333	114	1	80	0.0125000
NODE_2217_length_1524_cov_130.874386	253	333	116	1	80	0.0125000
NODE_2217_length_1524_cov_130.874386	253	333	122	1	80	0.0125000
NODE_2217_length_1524_cov_130.874386	253	333	126	1	80	0.0125000
NODE_2217_length_1524_cov_130.874386	253	333	136	2	80	0.0250000
NODE_2217_length_1524_cov_130.874386	253	333	140	1	80	0.0125000
NODE_2217_length_1524_cov_130.874386	253	333	146	3	80	0.0375000
NODE_2217_length_1524_cov_130.874386	253	333	150	1	80	0.0125000
NODE_2217_length_1524_cov_130.874386	253	333	166	1	80	0.0125000
NODE_2217_length_1524_cov_130.874386	253	333	173	1	80	0.0125000
NODE_2217_length_1524_cov_130.874386	253	333	187	1	80	0.0125000
NODE_2217_length_1524_cov_130.874386	253	333	199	1	80	0.0125000
NODE_2217_length_1524_cov_130.874386	253	333	200	1	80	0.0125000
NODE_2217_length_1524_cov_130.874386	253	333	204	1	80	0.0125000
NODE_2217_length_1524_cov_130.874386	253	333	206	2	80	0.0250000
NODE_2217_length_1524_cov_130.874386	253	333	216	1	80	0.0125000
NODE_2217_length_1524_cov_130.874386	253	333	218	2	80	0.0250000
NODE_2217_length_1524_cov_130.874386	253	333	224	1	80	0.0125000
NODE_2217_length_1524_cov_130.874386	253	333	235	1	80	0.0125000
NODE_2217_length_1524_cov_130.874386	253	333	242	1	80	0.0125000
NODE_2217_length_1524_cov_130.874386	253	333	253	1	80	0.0125000
NODE_2217_length_1524_cov_130.874386	253	333	256	1	80	0.0125000
NODE_2217_length_1524_cov_130.874386	253	333	265	1	80	0.0125000
NODE_2217_length_1524_cov_130.874386	253	333	268	1	80	0.0125000
NODE_2217_length_1524_cov_130.874386	253	333	269	1	80	0.0125000
NODE_2217_length_1524_cov_130.874386	253	333	275	2	80	0.0250000
NODE_2217_length_1524_cov_130.874386	253	333	283	1	80	0.0125000
NODE_2217_length_1524_cov_130.874386	253	333	289	1	80	0.0125000
NODE_2217_length_1524_cov_130.874386	253	333	291	2	80	0.0250000
NODE_2217_length_1524_cov_130.874386	253	333	293	2	80	0.0250000
NODE_2217_length_1524_cov_130.874386	253	333	299	1	80	0.0125000
NODE_2217_length_1524_cov_130.874386	253	333	305	1	80	0.0125000
NODE_2217_length_1524_cov_130.874386	253	333	307	1	80	0.0125000
NODE_2217_length_1524_cov_130.874386	253	333	311	1	80	0.0125000
NODE_2217_length_1524_cov_130.874386	253	333	315	1	80	0.0125000
NODE_2217_length_1524_cov_130.874386	253	333	319	1	80	0.0125000
NODE_2217_length_1524_cov_130.874386	253	333	333	1	80	0.0125000
NODE_2217_length_1524_cov_130.874386	253	333	335	1	80	0.0125000
NODE_2217_length_1524_cov_130.874386	253	333	337	1	80	0.0125000
NODE_2217_length_1524_cov_130.874386	253	333	339	1	80	0.0125000
NODE_2217_length_1524_cov_130.874386	253	333	343	1	80	0.0125000
NODE_2217_length_1524_cov_130.874386	253	333	356	1	80	0.0125000
NODE_2217_length_1524_cov_130.874386	253	333	364	1	80	0.0125000
NODE_2217_length_1524_cov_130.874386	253	333	365	1	80	0.0125000
NODE_2217_length_1524_cov_130.874386	253	333	368	1	80	0.0125000
NODE_2217_length_1524_cov_130.874386	253	333	370	2	80	0.0250000
NODE_2217_length_1524_cov_130.874386	253	333	375	2	80	0.0250000
NODE_2217_length_1524_cov_130.874386	253	333	380	2	80	0.0250000
NODE_2217_length_1524_cov_130.874386	253	333	390	2	80	0.0250000
NODE_2217_length_1524_cov_130.874386	253	333	394	2	80	0.0250000
NODE_2217_length_1524_cov_130.874386	253	333	397	1	80	0.0125000
NODE_2217_length_1524_cov_130.874386	253	333	399	1	80	0.0125000
NODE_2217_length_1524_cov_130.874386	306	386	20	2	80	0.0250000
NODE_2217_length_1524_cov_130.874386	306	386	23	1	80	0.0125000
NODE_2217_length_1524_cov_130.874386	306	386	25	6	80	0.0750000
NODE_2217_length_1524_cov_130.874386	306	386	26	6	80	0.0750000
NODE_2217_length_1524_cov_130.874386	306	386	28	1	80	0.0125000
NODE_2217_length_1524_cov_130.874386	306	386	29	2	80	0.0250000
NODE_2217_length_1524_cov_130.874386	306	386	31	3	80	0.0375000
NODE_2217_length_1524_cov_130.874386	306	386	32	2	80	0.0250000
NODE_2217_length_1524_cov_130.874386	306	386	38	4	80	0.0500000
NODE_2217_length_1524_cov_130.874386	306	386	40	1	80	0.0125000
NODE_2217_length_1524_cov_130.874386	306	386	42	3	80	0.0375000
NODE_2217_length_1524_cov_130.874386	306	386	43	1	80	0.0125000
NODE_2217_length_1524_cov_130.874386	306	386	48	3	80	0.0375000
NODE_2217_length_1524_cov_130.874386	306	386	51	1	80	0.0125000
NODE_2217_length_1524_cov_130.874386	306	386	54	1	80	0.0125000
NODE_2217_length_1524_cov_130.874386	306	386	59	5	80	0.0625000
NODE_2217_length_1524_cov_130.874386	306	386	63	8	80	0.1000000
NODE_2217_length_1524_cov_130.874386	306	386	64	1	80	0.0125000
NODE_2217_length_1524_cov_130.874386	306	386	65	1	80	0.0125000
NODE_2217_length_1524_cov_130.874386	306	386	68	1	80	0.0125000
NODE_2217_length_1524_cov_130.874386	306	386	69	1	80	0.0125000
NODE_2217_length_1524_cov_130.874386	306	386	76	2	80	0.0250000
NODE_2217_length_1524_cov_130.874386	306	386	79	1	80	0.0125000
NODE_2217_length_1524_cov_130.874386	306	386	83	1	80	0.0125000
NODE_2217_length_1524_cov_130.874386	306	386	84	3	80	0.0375000
NODE_2217_length_1524_cov_130.874386	306	386	88	1	80	0.0125000
NODE_2217_length_1524_cov_130.874386	306	386	90	1	80	0.0125000
NODE_2217_length_1524_cov_130.874386	306	386	92	1	80	0.0125000
NODE_2217_length_1524_cov_130.874386	306	386	98	1	80	0.0125000
NODE_2217_length_1524_cov_130.874386	306	386	102	2	80	0.0250000
NODE_2217_length_1524_cov_130.874386	306	386	107	1	80	0.0125000
NODE_2217_length_1524_cov_130.874386	306	386	114	1	80	0.0125000
NODE_2217_length_1524_cov_130.874386	306	386	116	1	80	0.0125000
NODE_2217_length_1524_cov_130.874386	306	386	122	1	80	0.0125000
NODE_2217_length_1524_cov_130.874386	306	386	126	1	80	0.0125000
NODE_2217_length_1524_cov_130.874386	306	386	136	2	80	0.0250000
NODE_2217_length_1524_cov_130.874386	306	386	140	1	80	0.0125000
NODE_2217_length_1524_cov_130.874386	306	386	146	3	80	0.0375000
NODE_2217_length_1524_cov_130.874386	306	386	150	1	80	0.0125000
NODE_2217_length_1524_cov_130.874386	306	386	166	1	80	0.0125000
NODE_2219_length_1523_cov_24.115169	366	446	0	80	80	1.0000000
NODE_2219_length_1523_cov_24.115169	419	499	0	80	80	1.0000000
NODE_2219_length_1523_cov_24.115169	495	575	0	80	80	1.0000000
NODE_2219_length_1523_cov_24.115169	548	628	0	80	80	1.0000000
NODE_2223_length_1522_cov_13.278988	361	441	0	10	80	0.1250000
NODE_2223_length_1522_cov_13.278988	361	441	2	12	80	0.1500000
NODE_2223_length_1522_cov_13.278988	361	441	5	1	80	0.0125000
NODE_2223_length_1522_cov_13.278988	361	441	6	57	80	0.7125000
NODE_2223_length_1522_cov_13.278988	414	494	0	8	80	0.1000000
NODE_2223_length_1522_cov_13.278988	414	494	4	42	80	0.5250000
NODE_2223_length_1522_cov_13.278988	414	494	6	30	80	0.3750000
NODE_2225_length_1521_cov_20.965541	772	852	0	34	80	0.4250000
NODE_2225_length_1521_cov_20.965541	772	852	5	9	80	0.1125000
NODE_2225_length_1521_cov_20.965541	772	852	10	4	80	0.0500000
NODE_2225_length_1521_cov_20.965541	772	852	12	33	80	0.4125000
NODE_2225_length_1521_cov_20.965541	825	905	10	35	80	0.4375000
NODE_2225_length_1521_cov_20.965541	825	905	12	45	80	0.5625000
NODE_2226_length_1521_cov_15.381153	907	987	0	56	80	0.7000000
NODE_2226_length_1521_cov_15.381153	907	987	2	21	80	0.2625000
NODE_2226_length_1521_cov_15.381153	907	987	4	3	80	0.0375000
NODE_2226_length_1521_cov_15.381153	960	1040	0	3	80	0.0375000
NODE_2226_length_1521_cov_15.381153	960	1040	2	21	80	0.2625000
NODE_2226_length_1521_cov_15.381153	960	1040	4	56	80	0.7000000
NODE_2226_length_1521_cov_15.381153	988	1040	4	52	52	1.0000000
NODE_2227_length_1521_cov_7.682138	525	605	0	80	80	1.0000000
NODE_2227_length_1521_cov_7.682138	578	658	0	80	80	1.0000000
NODE_2236_length_1519_cov_20.792958	714	794	14	7	80	0.0875000
NODE_2236_length_1519_cov_20.792958	714	794	16	1	80	0.0125000
NODE_2236_length_1519_cov_20.792958	714	794	17	1	80	0.0125000
NODE_2236_length_1519_cov_20.792958	714	794	18	25	80	0.3125000
NODE_2236_length_1519_cov_20.792958	714	794	20	5	80	0.0625000
NODE_2236_length_1519_cov_20.792958	714	794	22	12	80	0.1500000
NODE_2236_length_1519_cov_20.792958	714	794	24	29	80	0.3625000
NODE_2236_length_1519_cov_20.792958	767	847	2	18	80	0.2250000
NODE_2236_length_1519_cov_20.792958	767	847	6	22	80	0.2750000
NODE_2236_length_1519_cov_20.792958	767	847	10	9	80	0.1125000
NODE_2236_length_1519_cov_20.792958	767	847	13	1	80	0.0125000
NODE_2236_length_1519_cov_20.792958	767	847	16	4	80	0.0500000
NODE_2236_length_1519_cov_20.792958	767	847	17	1	80	0.0125000
NODE_2236_length_1519_cov_20.792958	767	847	18	14	80	0.1750000
NODE_2236_length_1519_cov_20.792958	767	847	20	1	80	0.0125000
NODE_2236_length_1519_cov_20.792958	767	847	22	10	80	0.1250000
NODE_2239_length_1517_cov_24.074048	413	450	0	37	37	1.0000000
NODE_2239_length_1517_cov_24.074048	842	922	10	59	80	0.7375000
NODE_2239_length_1517_cov_24.074048	842	922	12	21	80	0.2625000
NODE_2239_length_1517_cov_24.074048	895	975	0	18	80	0.2250000
NODE_2239_length_1517_cov_24.074048	895	975	2	9	80	0.1125000
NODE_2239_length_1517_cov_24.074048	895	975	10	36	80	0.4500000
NODE_2239_length_1517_cov_24.074048	895	975	12	17	80	0.2125000
NODE_2240_length_1517_cov_22.897743	383	463	1	38	80	0.4750000
NODE_2240_length_1517_cov_22.897743	383	463	2	3	80	0.0375000
NODE_2240_length_1517_cov_22.897743	383	463	6	27	80	0.3375000
NODE_2240_length_1517_cov_22.897743	383	463	8	12	80	0.1500000
NODE_2240_length_1517_cov_22.897743	436	516	3	8	80	0.1000000
NODE_2240_length_1517_cov_22.897743	436	516	6	15	80	0.1875000
NODE_2240_length_1517_cov_22.897743	436	516	7	2	80	0.0250000
NODE_2240_length_1517_cov_22.897743	436	516	8	55	80	0.6875000
NODE_2241_length_1517_cov_11.781382	381	461	0	11	80	0.1375000
NODE_2241_length_1517_cov_11.781382	381	461	2	68	80	0.8500000
NODE_2241_length_1517_cov_11.781382	381	461	4	1	80	0.0125000
NODE_2241_length_1517_cov_11.781382	434	514	0	30	80	0.3750000
NODE_2241_length_1517_cov_11.781382	434	514	2	50	80	0.6250000
NODE_2243_length_1517_cov_4.944993	393	473	2	80	80	1.0000000
NODE_2243_length_1517_cov_4.944993	446	526	0	28	80	0.3500000
NODE_2243_length_1517_cov_4.944993	446	526	2	52	80	0.6500000
NODE_2247_length_1516_cov_11.177135	230	310	0	80	80	1.0000000
NODE_2247_length_1516_cov_11.177135	283	363	0	80	80	1.0000000
NODE_2248_length_1516_cov_8.608327	580	660	0	64	80	0.8000000
NODE_2248_length_1516_cov_8.608327	580	660	4	16	80	0.2000000
NODE_2248_length_1516_cov_8.608327	633	713	0	11	80	0.1375000
NODE_2248_length_1516_cov_8.608327	633	713	4	69	80	0.8625000
NODE_2250_length_1515_cov_16.990819	333	413	13	2	80	0.0250000
NODE_2250_length_1515_cov_16.990819	333	413	15	19	80	0.2375000
NODE_2250_length_1515_cov_16.990819	333	413	19	10	80	0.1250000
NODE_2250_length_1515_cov_16.990819	333	413	22	1	80	0.0125000
NODE_2250_length_1515_cov_16.990819	333	413	24	1	80	0.0125000
NODE_2250_length_1515_cov_16.990819	333	413	26	6	80	0.0750000
NODE_2250_length_1515_cov_16.990819	333	413	29	2	80	0.0250000
NODE_2250_length_1515_cov_16.990819	333	413	30	4	80	0.0500000
NODE_2250_length_1515_cov_16.990819	333	413	32	2	80	0.0250000
NODE_2250_length_1515_cov_16.990819	333	413	35	1	80	0.0125000
NODE_2250_length_1515_cov_16.990819	333	413	41	6	80	0.0750000
NODE_2250_length_1515_cov_16.990819	333	413	50	2	80	0.0250000
NODE_2250_length_1515_cov_16.990819	333	413	52	8	80	0.1000000
NODE_2250_length_1515_cov_16.990819	333	413	53	8	80	0.1000000
NODE_2250_length_1515_cov_16.990819	333	413	54	2	80	0.0250000
NODE_2250_length_1515_cov_16.990819	333	413	56	2	80	0.0250000
NODE_2250_length_1515_cov_16.990819	333	413	57	4	80	0.0500000
NODE_2250_length_1515_cov_16.990819	386	448	4	22	62	0.3548387
NODE_2250_length_1515_cov_16.990819	386	448	6	1	62	0.0161290
NODE_2250_length_1515_cov_16.990819	386	448	7	7	62	0.1129032
NODE_2250_length_1515_cov_16.990819	386	448	9	2	62	0.0322581
NODE_2250_length_1515_cov_16.990819	386	448	13	5	62	0.0806452
NODE_2250_length_1515_cov_16.990819	386	448	15	19	62	0.3064516
NODE_2250_length_1515_cov_16.990819	386	448	19	6	62	0.0967742
NODE_2258_length_1512_cov_5.111819	506	560	0	1	54	0.0185185
NODE_2258_length_1512_cov_5.111819	506	560	2	53	54	0.9814815
NODE_2258_length_1512_cov_5.111819	677	698	2	21	21	1.0000000
NODE_2258_length_1512_cov_5.111819	677	698	2	21	21	1.0000000
NODE_2258_length_1512_cov_5.111819	1057	1137	0	78	80	0.9750000
NODE_2258_length_1512_cov_5.111819	1057	1137	2	2	80	0.0250000
NODE_2258_length_1512_cov_5.111819	1110	1190	0	80	80	1.0000000
NODE_2258_length_1512_cov_5.111819	1144	1190	0	46	46	1.0000000
NODE_2259_length_1512_cov_4.251946	132	204	0	72	72	1.0000000
NODE_2262_length_1511_cov_30.963173	787	867	0	4	80	0.0500000
NODE_2262_length_1511_cov_30.963173	787	867	4	34	80	0.4250000
NODE_2262_length_1511_cov_30.963173	787	867	6	42	80	0.5250000
NODE_2262_length_1511_cov_30.963173	840	920	0	57	80	0.7125000
NODE_2262_length_1511_cov_30.963173	840	920	4	23	80	0.2875000
NODE_2262_length_1511_cov_30.963173	916	996	0	80	80	1.0000000
NODE_2262_length_1511_cov_30.963173	969	1059	0	90	90	1.0000000
NODE_2265_length_1510_cov_24.184975	434	514	6	11	80	0.1375000
NODE_2265_length_1510_cov_24.184975	434	514	8	69	80	0.8625000
NODE_2265_length_1510_cov_24.184975	487	567	3	15	80	0.1875000
NODE_2265_length_1510_cov_24.184975	487	567	6	46	80	0.5750000
NODE_2265_length_1510_cov_24.184975	487	567	8	17	80	0.2125000
NODE_2265_length_1510_cov_24.184975	487	567	9	2	80	0.0250000
NODE_2265_length_1510_cov_24.184975	563	643	3	6	80	0.0750000
NODE_2265_length_1510_cov_24.184975	563	643	6	74	80	0.9250000
NODE_2265_length_1510_cov_24.184975	616	696	6	80	80	1.0000000
NODE_2269_length_1509_cov_51.836170	655	735	0	5	80	0.0625000
NODE_2269_length_1509_cov_51.836170	655	735	2	2	80	0.0250000
NODE_2269_length_1509_cov_51.836170	655	735	6	9	80	0.1125000
NODE_2269_length_1509_cov_51.836170	655	735	8	31	80	0.3875000
NODE_2269_length_1509_cov_51.836170	655	735	10	33	80	0.4125000
NODE_2269_length_1509_cov_51.836170	708	788	2	14	80	0.1750000
NODE_2269_length_1509_cov_51.836170	708	788	6	15	80	0.1875000
NODE_2269_length_1509_cov_51.836170	708	788	8	26	80	0.3250000
NODE_2269_length_1509_cov_51.836170	708	788	10	25	80	0.3125000
NODE_2269_length_1509_cov_51.836170	784	864	0	21	80	0.2625000
NODE_2269_length_1509_cov_51.836170	784	864	2	59	80	0.7375000
NODE_2269_length_1509_cov_51.836170	837	917	0	39	80	0.4875000
NODE_2269_length_1509_cov_51.836170	837	917	2	6	80	0.0750000
NODE_2269_length_1509_cov_51.836170	837	917	4	35	80	0.4375000
NODE_2270_length_1509_cov_16.010638	497	577	0	80	80	1.0000000
NODE_2270_length_1509_cov_16.010638	550	630	0	80	80	1.0000000
NODE_2270_length_1509_cov_16.010638	626	706	0	80	80	1.0000000
NODE_2270_length_1509_cov_16.010638	679	759	0	80	80	1.0000000
NODE_2271_length_1509_cov_8.883688	252	332	0	80	80	1.0000000
NODE_2271_length_1509_cov_8.883688	305	385	0	80	80	1.0000000
NODE_2271_length_1509_cov_8.883688	327	385	0	58	58	1.0000000
NODE_2271_length_1509_cov_8.883688	381	461	0	57	80	0.7125000
NODE_2271_length_1509_cov_8.883688	381	461	2	23	80	0.2875000
NODE_2271_length_1509_cov_8.883688	434	514	0	16	80	0.2000000
NODE_2271_length_1509_cov_8.883688	434	514	2	64	80	0.8000000
NODE_2272_length_1509_cov_5.826950	1029	1109	2	71	80	0.8875000
NODE_2272_length_1509_cov_5.826950	1029	1109	4	9	80	0.1125000
NODE_2272_length_1509_cov_5.826950	1082	1162	2	71	80	0.8875000
NODE_2272_length_1509_cov_5.826950	1082	1162	4	9	80	0.1125000
NODE_2277_length_1508_cov_24.176011	765	845	6	23	80	0.2875000
NODE_2277_length_1508_cov_24.176011	765	845	8	31	80	0.3875000
NODE_2277_length_1508_cov_24.176011	765	845	10	26	80	0.3250000
NODE_2277_length_1508_cov_24.176011	818	898	0	18	80	0.2250000
NODE_2277_length_1508_cov_24.176011	818	898	2	33	80	0.4125000
NODE_2277_length_1508_cov_24.176011	818	898	6	25	80	0.3125000
NODE_2277_length_1508_cov_24.176011	818	898	8	4	80	0.0500000
NODE_2290_length_1504_cov_17.449822	596	676	0	21	80	0.2625000
NODE_2290_length_1504_cov_17.449822	596	676	2	59	80	0.7375000
NODE_2290_length_1504_cov_17.449822	649	729	0	57	80	0.7125000
NODE_2290_length_1504_cov_17.449822	649	729	2	23	80	0.2875000
NODE_2293_length_1502_cov_42.989309	559	639	0	10	80	0.1250000
NODE_2293_length_1502_cov_42.989309	559	639	2	45	80	0.5625000
NODE_2293_length_1502_cov_42.989309	559	639	4	25	80	0.3125000
NODE_2293_length_1502_cov_42.989309	612	692	2	75	80	0.9375000
NODE_2293_length_1502_cov_42.989309	612	692	4	5	80	0.0625000
NODE_2294_length_1501_cov_22.828816	421	500	0	79	79	1.0000000
NODE_2294_length_1501_cov_22.828816	473	553	0	80	80	1.0000000
NODE_2294_length_1501_cov_22.828816	549	629	0	80	80	1.0000000
NODE_2294_length_1501_cov_22.828816	602	682	0	80	80	1.0000000
NODE_2295_length_1501_cov_14.422254	973	1053	0	79	80	0.9875000
NODE_2295_length_1501_cov_14.422254	973	1053	2	1	80	0.0125000
NODE_2295_length_1501_cov_14.422254	1026	1106	0	26	80	0.3250000
NODE_2295_length_1501_cov_14.422254	1026	1106	2	54	80	0.6750000
NODE_2296_length_1501_cov_14.060628	225	305	0	33	80	0.4125000
NODE_2296_length_1501_cov_14.060628	225	305	2	19	80	0.2375000
NODE_2296_length_1501_cov_14.060628	225	305	4	28	80	0.3500000
NODE_2296_length_1501_cov_14.060628	278	358	0	9	80	0.1125000
NODE_2296_length_1501_cov_14.060628	278	358	2	24	80	0.3000000
NODE_2296_length_1501_cov_14.060628	278	358	7	4	80	0.0500000
NODE_2296_length_1501_cov_14.060628	278	358	8	43	80	0.5375000
NODE_2296_length_1501_cov_14.060628	986	1066	0	29	80	0.3625000
NODE_2296_length_1501_cov_14.060628	986	1066	4	51	80	0.6375000
NODE_2296_length_1501_cov_14.060628	1039	1119	4	80	80	1.0000000
NODE_2300_length_1500_cov_40.056388	619	699	0	80	80	1.0000000
NODE_2300_length_1500_cov_40.056388	672	752	0	80	80	1.0000000
NODE_2305_length_1497_cov_38.344063	1401	1481	8	3	80	0.0375000
NODE_2305_length_1497_cov_38.344063	1401	1481	14	1	80	0.0125000
NODE_2305_length_1497_cov_38.344063	1401	1481	18	1	80	0.0125000
NODE_2305_length_1497_cov_38.344063	1401	1481	20	2	80	0.0250000
NODE_2305_length_1497_cov_38.344063	1401	1481	22	4	80	0.0500000
NODE_2305_length_1497_cov_38.344063	1401	1481	24	1	80	0.0125000
NODE_2305_length_1497_cov_38.344063	1401	1481	28	6	80	0.0750000
NODE_2305_length_1497_cov_38.344063	1401	1481	30	3	80	0.0375000
NODE_2305_length_1497_cov_38.344063	1401	1481	32	1	80	0.0125000
NODE_2305_length_1497_cov_38.344063	1401	1481	33	3	80	0.0375000
NODE_2305_length_1497_cov_38.344063	1401	1481	34	7	80	0.0875000
NODE_2305_length_1497_cov_38.344063	1401	1481	36	3	80	0.0375000
NODE_2305_length_1497_cov_38.344063	1401	1481	42	3	80	0.0375000
NODE_2305_length_1497_cov_38.344063	1401	1481	44	15	80	0.1875000
NODE_2305_length_1497_cov_38.344063	1401	1481	48	1	80	0.0125000
NODE_2305_length_1497_cov_38.344063	1401	1481	54	2	80	0.0250000
NODE_2305_length_1497_cov_38.344063	1401	1481	57	1	80	0.0125000
NODE_2305_length_1497_cov_38.344063	1401	1481	59	1	80	0.0125000
NODE_2305_length_1497_cov_38.344063	1401	1481	60	1	80	0.0125000
NODE_2305_length_1497_cov_38.344063	1401	1481	62	3	80	0.0375000
NODE_2305_length_1497_cov_38.344063	1401	1481	64	3	80	0.0375000
NODE_2305_length_1497_cov_38.344063	1401	1481	72	2	80	0.0250000
NODE_2305_length_1497_cov_38.344063	1401	1481	78	5	80	0.0625000
NODE_2305_length_1497_cov_38.344063	1401	1481	79	1	80	0.0125000
NODE_2305_length_1497_cov_38.344063	1401	1481	81	2	80	0.0250000
NODE_2305_length_1497_cov_38.344063	1401	1481	83	1	80	0.0125000
NODE_2305_length_1497_cov_38.344063	1401	1481	87	1	80	0.0125000
NODE_2305_length_1497_cov_38.344063	1401	1481	89	1	80	0.0125000
NODE_2305_length_1497_cov_38.344063	1401	1481	93	2	80	0.0250000
NODE_2308_length_1496_cov_3.936292	0	44	0	44	44	1.0000000
NODE_2308_length_1496_cov_3.936292	17	97	0	80	80	1.0000000
NODE_2311_length_1496_cov_1.103794	405	428	2	23	23	1.0000000
NODE_2313_length_1494_cov_65.437276	460	540	10	51	80	0.6375000
NODE_2313_length_1494_cov_65.437276	460	540	12	29	80	0.3625000
NODE_2313_length_1494_cov_65.437276	513	594	0	5	81	0.0617284
NODE_2313_length_1494_cov_65.437276	513	594	2	27	81	0.3333333
NODE_2313_length_1494_cov_65.437276	513	594	10	1	81	0.0123457
NODE_2313_length_1494_cov_65.437276	513	594	11	4	81	0.0493827
NODE_2313_length_1494_cov_65.437276	513	594	12	44	81	0.5432099
NODE_2313_length_1494_cov_65.437276	787	854	6	20	67	0.2985075
NODE_2313_length_1494_cov_65.437276	787	854	8	47	67	0.7014925
NODE_2313_length_1494_cov_65.437276	827	907	0	25	80	0.3125000
NODE_2313_length_1494_cov_65.437276	827	907	1	4	80	0.0500000
NODE_2313_length_1494_cov_65.437276	827	907	2	14	80	0.1750000
NODE_2313_length_1494_cov_65.437276	827	907	4	3	80	0.0375000
NODE_2313_length_1494_cov_65.437276	827	907	6	9	80	0.1125000
NODE_2313_length_1494_cov_65.437276	827	907	8	25	80	0.3125000
NODE_2316_length_1493_cov_100.467719	947	1028	71	1	81	0.0123457
NODE_2316_length_1493_cov_100.467719	947	1028	72	3	81	0.0370370
NODE_2316_length_1493_cov_100.467719	947	1028	74	2	81	0.0246914
NODE_2316_length_1493_cov_100.467719	947	1028	75	2	81	0.0246914
NODE_2316_length_1493_cov_100.467719	947	1028	81	1	81	0.0123457
NODE_2316_length_1493_cov_100.467719	947	1028	82	1	81	0.0123457
NODE_2316_length_1493_cov_100.467719	947	1028	85	1	81	0.0123457
NODE_2316_length_1493_cov_100.467719	947	1028	87	1	81	0.0123457
NODE_2316_length_1493_cov_100.467719	947	1028	91	1	81	0.0123457
NODE_2316_length_1493_cov_100.467719	947	1028	93	2	81	0.0246914
NODE_2316_length_1493_cov_100.467719	947	1028	95	1	81	0.0123457
NODE_2316_length_1493_cov_100.467719	947	1028	97	1	81	0.0123457
NODE_2316_length_1493_cov_100.467719	947	1028	99	2	81	0.0246914
NODE_2316_length_1493_cov_100.467719	947	1028	101	2	81	0.0246914
NODE_2316_length_1493_cov_100.467719	947	1028	108	1	81	0.0123457
NODE_2316_length_1493_cov_100.467719	947	1028	113	1	81	0.0123457
NODE_2316_length_1493_cov_100.467719	947	1028	118	1	81	0.0123457
NODE_2316_length_1493_cov_100.467719	947	1028	120	1	81	0.0123457
NODE_2316_length_1493_cov_100.467719	947	1028	127	1	81	0.0123457
NODE_2316_length_1493_cov_100.467719	947	1028	133	1	81	0.0123457
NODE_2316_length_1493_cov_100.467719	947	1028	141	1	81	0.0123457
NODE_2316_length_1493_cov_100.467719	947	1028	143	1	81	0.0123457
NODE_2316_length_1493_cov_100.467719	947	1028	149	1	81	0.0123457
NODE_2316_length_1493_cov_100.467719	947	1028	152	1	81	0.0123457
NODE_2316_length_1493_cov_100.467719	947	1028	156	1	81	0.0123457
NODE_2316_length_1493_cov_100.467719	947	1028	160	1	81	0.0123457
NODE_2316_length_1493_cov_100.467719	947	1028	164	1	81	0.0123457
NODE_2316_length_1493_cov_100.467719	947	1028	169	1	81	0.0123457
NODE_2316_length_1493_cov_100.467719	947	1028	171	1	81	0.0123457
NODE_2316_length_1493_cov_100.467719	947	1028	175	1	81	0.0123457
NODE_2316_length_1493_cov_100.467719	947	1028	179	1	81	0.0123457
NODE_2316_length_1493_cov_100.467719	947	1028	183	2	81	0.0246914
NODE_2316_length_1493_cov_100.467719	947	1028	187	1	81	0.0123457
NODE_2316_length_1493_cov_100.467719	947	1028	189	1	81	0.0123457
NODE_2316_length_1493_cov_100.467719	947	1028	192	1	81	0.0123457
NODE_2316_length_1493_cov_100.467719	947	1028	200	3	81	0.0370370
NODE_2316_length_1493_cov_100.467719	947	1028	202	1	81	0.0123457
NODE_2316_length_1493_cov_100.467719	947	1028	208	1	81	0.0123457
NODE_2316_length_1493_cov_100.467719	947	1028	209	2	81	0.0246914
NODE_2316_length_1493_cov_100.467719	947	1028	213	1	81	0.0123457
NODE_2316_length_1493_cov_100.467719	947	1028	215	1	81	0.0123457
NODE_2316_length_1493_cov_100.467719	947	1028	219	2	81	0.0246914
NODE_2316_length_1493_cov_100.467719	947	1028	227	1	81	0.0123457
NODE_2316_length_1493_cov_100.467719	947	1028	231	1	81	0.0123457
NODE_2316_length_1493_cov_100.467719	947	1028	239	1	81	0.0123457
NODE_2316_length_1493_cov_100.467719	947	1028	249	2	81	0.0246914
NODE_2316_length_1493_cov_100.467719	947	1028	251	1	81	0.0123457
NODE_2316_length_1493_cov_100.467719	947	1028	252	1	81	0.0123457
NODE_2316_length_1493_cov_100.467719	947	1028	256	2	81	0.0246914
NODE_2316_length_1493_cov_100.467719	947	1028	258	2	81	0.0246914
NODE_2316_length_1493_cov_100.467719	947	1028	264	1	81	0.0123457
NODE_2316_length_1493_cov_100.467719	947	1028	265	1	81	0.0123457
NODE_2316_length_1493_cov_100.467719	947	1028	267	1	81	0.0123457
NODE_2316_length_1493_cov_100.467719	947	1028	269	1	81	0.0123457
NODE_2316_length_1493_cov_100.467719	947	1028	270	1	81	0.0123457
NODE_2316_length_1493_cov_100.467719	947	1028	271	1	81	0.0123457
NODE_2316_length_1493_cov_100.467719	947	1028	277	2	81	0.0246914
NODE_2316_length_1493_cov_100.467719	947	1028	278	1	81	0.0123457
NODE_2316_length_1493_cov_100.467719	947	1028	284	1	81	0.0123457
NODE_2316_length_1493_cov_100.467719	947	1028	289	1	81	0.0123457
NODE_2316_length_1493_cov_100.467719	947	1028	295	1	81	0.0123457
NODE_2316_length_1493_cov_100.467719	947	1028	312	1	81	0.0123457
NODE_2316_length_1493_cov_100.467719	947	1028	315	1	81	0.0123457
NODE_2316_length_1493_cov_100.467719	947	1028	317	1	81	0.0123457
NODE_2316_length_1493_cov_100.467719	947	1028	322	1	81	0.0123457
NODE_2316_length_1493_cov_100.467719	1001	1071	227	1	70	0.0142857
NODE_2316_length_1493_cov_100.467719	1001	1071	231	1	70	0.0142857
NODE_2316_length_1493_cov_100.467719	1001	1071	239	1	70	0.0142857
NODE_2316_length_1493_cov_100.467719	1001	1071	249	2	70	0.0285714
NODE_2316_length_1493_cov_100.467719	1001	1071	251	1	70	0.0142857
NODE_2316_length_1493_cov_100.467719	1001	1071	252	1	70	0.0142857
NODE_2316_length_1493_cov_100.467719	1001	1071	256	2	70	0.0285714
NODE_2316_length_1493_cov_100.467719	1001	1071	258	2	70	0.0285714
NODE_2316_length_1493_cov_100.467719	1001	1071	264	1	70	0.0142857
NODE_2316_length_1493_cov_100.467719	1001	1071	265	1	70	0.0142857
NODE_2316_length_1493_cov_100.467719	1001	1071	267	1	70	0.0142857
NODE_2316_length_1493_cov_100.467719	1001	1071	269	1	70	0.0142857
NODE_2316_length_1493_cov_100.467719	1001	1071	270	1	70	0.0142857
NODE_2316_length_1493_cov_100.467719	1001	1071	271	1	70	0.0142857
NODE_2316_length_1493_cov_100.467719	1001	1071	277	2	70	0.0285714
NODE_2316_length_1493_cov_100.467719	1001	1071	278	1	70	0.0142857
NODE_2316_length_1493_cov_100.467719	1001	1071	284	1	70	0.0142857
NODE_2316_length_1493_cov_100.467719	1001	1071	289	1	70	0.0142857
NODE_2316_length_1493_cov_100.467719	1001	1071	295	1	70	0.0142857
NODE_2316_length_1493_cov_100.467719	1001	1071	312	1	70	0.0142857
NODE_2316_length_1493_cov_100.467719	1001	1071	315	1	70	0.0142857
NODE_2316_length_1493_cov_100.467719	1001	1071	317	1	70	0.0142857
NODE_2316_length_1493_cov_100.467719	1001	1071	322	1	70	0.0142857
NODE_2316_length_1493_cov_100.467719	1001	1071	334	1	70	0.0142857
NODE_2316_length_1493_cov_100.467719	1001	1071	340	1	70	0.0142857
NODE_2316_length_1493_cov_100.467719	1001	1071	346	1	70	0.0142857
NODE_2316_length_1493_cov_100.467719	1001	1071	350	1	70	0.0142857
NODE_2316_length_1493_cov_100.467719	1001	1071	354	1	70	0.0142857
NODE_2316_length_1493_cov_100.467719	1001	1071	363	2	70	0.0285714
NODE_2316_length_1493_cov_100.467719	1001	1071	368	1	70	0.0142857
NODE_2316_length_1493_cov_100.467719	1001	1071	374	1	70	0.0142857
NODE_2316_length_1493_cov_100.467719	1001	1071	377	2	70	0.0285714
NODE_2316_length_1493_cov_100.467719	1001	1071	378	1	70	0.0142857
NODE_2316_length_1493_cov_100.467719	1001	1071	380	2	70	0.0285714
NODE_2316_length_1493_cov_100.467719	1001	1071	386	1	70	0.0142857
NODE_2316_length_1493_cov_100.467719	1001	1071	387	1	70	0.0142857
NODE_2316_length_1493_cov_100.467719	1001	1071	392	1	70	0.0142857
NODE_2316_length_1493_cov_100.467719	1001	1071	398	1	70	0.0142857
NODE_2316_length_1493_cov_100.467719	1001	1071	403	1	70	0.0142857
NODE_2316_length_1493_cov_100.467719	1001	1071	418	1	70	0.0142857
NODE_2316_length_1493_cov_100.467719	1001	1071	422	1	70	0.0142857
NODE_2316_length_1493_cov_100.467719	1001	1071	442	1	70	0.0142857
NODE_2316_length_1493_cov_100.467719	1001	1071	447	1	70	0.0142857
NODE_2316_length_1493_cov_100.467719	1001	1071	449	2	70	0.0285714
NODE_2316_length_1493_cov_100.467719	1001	1071	455	1	70	0.0142857
NODE_2316_length_1493_cov_100.467719	1001	1071	459	1	70	0.0142857
NODE_2316_length_1493_cov_100.467719	1001	1071	466	2	70	0.0285714
NODE_2316_length_1493_cov_100.467719	1001	1071	467	1	70	0.0142857
NODE_2316_length_1493_cov_100.467719	1001	1071	468	1	70	0.0142857
NODE_2316_length_1493_cov_100.467719	1001	1071	471	1	70	0.0142857
NODE_2316_length_1493_cov_100.467719	1001	1071	472	3	70	0.0428571
NODE_2316_length_1493_cov_100.467719	1001	1071	476	1	70	0.0142857
NODE_2316_length_1493_cov_100.467719	1001	1071	481	1	70	0.0142857
NODE_2316_length_1493_cov_100.467719	1001	1071	487	2	70	0.0285714
NODE_2316_length_1493_cov_100.467719	1001	1071	489	1	70	0.0142857
NODE_2316_length_1493_cov_100.467719	1001	1071	490	3	70	0.0428571
NODE_2316_length_1493_cov_100.467719	1077	1157	518	2	80	0.0250000
NODE_2316_length_1493_cov_100.467719	1077	1157	526	1	80	0.0125000
NODE_2316_length_1493_cov_100.467719	1077	1157	532	2	80	0.0250000
NODE_2316_length_1493_cov_100.467719	1077	1157	553	1	80	0.0125000
NODE_2316_length_1493_cov_100.467719	1077	1157	566	2	80	0.0250000
NODE_2316_length_1493_cov_100.467719	1077	1157	568	1	80	0.0125000
NODE_2316_length_1493_cov_100.467719	1077	1157	570	2	80	0.0250000
NODE_2316_length_1493_cov_100.467719	1077	1157	579	1	80	0.0125000
NODE_2316_length_1493_cov_100.467719	1077	1157	581	2	80	0.0250000
NODE_2316_length_1493_cov_100.467719	1077	1157	586	1	80	0.0125000
NODE_2316_length_1493_cov_100.467719	1077	1157	592	3	80	0.0375000
NODE_2316_length_1493_cov_100.467719	1077	1157	593	2	80	0.0250000
NODE_2316_length_1493_cov_100.467719	1077	1157	596	1	80	0.0125000
NODE_2316_length_1493_cov_100.467719	1077	1157	603	1	80	0.0125000
NODE_2316_length_1493_cov_100.467719	1077	1157	611	1	80	0.0125000
NODE_2316_length_1493_cov_100.467719	1077	1157	612	1	80	0.0125000
NODE_2316_length_1493_cov_100.467719	1077	1157	617	1	80	0.0125000
NODE_2316_length_1493_cov_100.467719	1077	1157	620	1	80	0.0125000
NODE_2316_length_1493_cov_100.467719	1077	1157	622	1	80	0.0125000
NODE_2316_length_1493_cov_100.467719	1077	1157	633	1	80	0.0125000
NODE_2316_length_1493_cov_100.467719	1077	1157	642	1	80	0.0125000
NODE_2316_length_1493_cov_100.467719	1077	1157	645	1	80	0.0125000
NODE_2316_length_1493_cov_100.467719	1077	1157	646	1	80	0.0125000
NODE_2316_length_1493_cov_100.467719	1077	1157	648	1	80	0.0125000
NODE_2316_length_1493_cov_100.467719	1077	1157	657	3	80	0.0375000
NODE_2316_length_1493_cov_100.467719	1077	1157	663	2	80	0.0250000
NODE_2316_length_1493_cov_100.467719	1077	1157	665	1	80	0.0125000
NODE_2316_length_1493_cov_100.467719	1077	1157	666	1	80	0.0125000
NODE_2316_length_1493_cov_100.467719	1077	1157	668	2	80	0.0250000
NODE_2316_length_1493_cov_100.467719	1077	1157	670	1	80	0.0125000
NODE_2316_length_1493_cov_100.467719	1077	1157	672	1	80	0.0125000
NODE_2316_length_1493_cov_100.467719	1077	1157	676	2	80	0.0250000
NODE_2316_length_1493_cov_100.467719	1077	1157	680	3	80	0.0375000
NODE_2316_length_1493_cov_100.467719	1077	1157	685	1	80	0.0125000
NODE_2316_length_1493_cov_100.467719	1077	1157	706	2	80	0.0250000
NODE_2316_length_1493_cov_100.467719	1077	1157	709	1	80	0.0125000
NODE_2316_length_1493_cov_100.467719	1077	1157	718	1	80	0.0125000
NODE_2316_length_1493_cov_100.467719	1077	1157	726	2	80	0.0250000
NODE_2316_length_1493_cov_100.467719	1077	1157	737	1	80	0.0125000
NODE_2316_length_1493_cov_100.467719	1077	1157	739	1	80	0.0125000
NODE_2316_length_1493_cov_100.467719	1077	1157	759	1	80	0.0125000
NODE_2316_length_1493_cov_100.467719	1077	1157	768	1	80	0.0125000
NODE_2316_length_1493_cov_100.467719	1077	1157	769	1	80	0.0125000
NODE_2316_length_1493_cov_100.467719	1077	1157	770	1	80	0.0125000
NODE_2316_length_1493_cov_100.467719	1077	1157	772	1	80	0.0125000
NODE_2316_length_1493_cov_100.467719	1077	1157	784	2	80	0.0250000
NODE_2316_length_1493_cov_100.467719	1077	1157	785	1	80	0.0125000
NODE_2316_length_1493_cov_100.467719	1077	1157	786	1	80	0.0125000
NODE_2316_length_1493_cov_100.467719	1077	1157	794	1	80	0.0125000
NODE_2316_length_1493_cov_100.467719	1077	1157	795	1	80	0.0125000
NODE_2316_length_1493_cov_100.467719	1077	1157	797	1	80	0.0125000
NODE_2316_length_1493_cov_100.467719	1077	1157	799	1	80	0.0125000
NODE_2316_length_1493_cov_100.467719	1077	1157	801	1	80	0.0125000
NODE_2316_length_1493_cov_100.467719	1077	1157	802	1	80	0.0125000
NODE_2316_length_1493_cov_100.467719	1077	1157	805	1	80	0.0125000
NODE_2316_length_1493_cov_100.467719	1077	1157	815	2	80	0.0250000
NODE_2316_length_1493_cov_100.467719	1077	1157	818	2	80	0.0250000
NODE_2316_length_1493_cov_100.467719	1077	1157	822	1	80	0.0125000
NODE_2316_length_1493_cov_100.467719	1077	1157	825	1	80	0.0125000
NODE_2316_length_1493_cov_100.467719	1077	1157	829	1	80	0.0125000
NODE_2316_length_1493_cov_100.467719	1130	1210	726	2	80	0.0250000
NODE_2316_length_1493_cov_100.467719	1130	1210	737	1	80	0.0125000
NODE_2316_length_1493_cov_100.467719	1130	1210	739	1	80	0.0125000
NODE_2316_length_1493_cov_100.467719	1130	1210	759	1	80	0.0125000
NODE_2316_length_1493_cov_100.467719	1130	1210	768	1	80	0.0125000
NODE_2316_length_1493_cov_100.467719	1130	1210	769	1	80	0.0125000
NODE_2316_length_1493_cov_100.467719	1130	1210	770	1	80	0.0125000
NODE_2316_length_1493_cov_100.467719	1130	1210	771	1	80	0.0125000
NODE_2316_length_1493_cov_100.467719	1130	1210	772	1	80	0.0125000
NODE_2316_length_1493_cov_100.467719	1130	1210	775	1	80	0.0125000
NODE_2316_length_1493_cov_100.467719	1130	1210	776	1	80	0.0125000
NODE_2316_length_1493_cov_100.467719	1130	1210	777	1	80	0.0125000
NODE_2316_length_1493_cov_100.467719	1130	1210	780	1	80	0.0125000
NODE_2316_length_1493_cov_100.467719	1130	1210	782	1	80	0.0125000
NODE_2316_length_1493_cov_100.467719	1130	1210	784	2	80	0.0250000
NODE_2316_length_1493_cov_100.467719	1130	1210	785	1	80	0.0125000
NODE_2316_length_1493_cov_100.467719	1130	1210	786	2	80	0.0250000
NODE_2316_length_1493_cov_100.467719	1130	1210	788	1	80	0.0125000
NODE_2316_length_1493_cov_100.467719	1130	1210	789	2	80	0.0250000
NODE_2316_length_1493_cov_100.467719	1130	1210	794	1	80	0.0125000
NODE_2316_length_1493_cov_100.467719	1130	1210	795	1	80	0.0125000
NODE_2316_length_1493_cov_100.467719	1130	1210	797	1	80	0.0125000
NODE_2316_length_1493_cov_100.467719	1130	1210	799	2	80	0.0250000
NODE_2316_length_1493_cov_100.467719	1130	1210	801	1	80	0.0125000
NODE_2316_length_1493_cov_100.467719	1130	1210	802	1	80	0.0125000
NODE_2316_length_1493_cov_100.467719	1130	1210	805	2	80	0.0250000
NODE_2316_length_1493_cov_100.467719	1130	1210	806	1	80	0.0125000
NODE_2316_length_1493_cov_100.467719	1130	1210	807	1	80	0.0125000
NODE_2316_length_1493_cov_100.467719	1130	1210	808	1	80	0.0125000
NODE_2316_length_1493_cov_100.467719	1130	1210	811	1	80	0.0125000
NODE_2316_length_1493_cov_100.467719	1130	1210	812	1	80	0.0125000
NODE_2316_length_1493_cov_100.467719	1130	1210	815	2	80	0.0250000
NODE_2316_length_1493_cov_100.467719	1130	1210	816	1	80	0.0125000
NODE_2316_length_1493_cov_100.467719	1130	1210	818	3	80	0.0375000
NODE_2316_length_1493_cov_100.467719	1130	1210	819	1	80	0.0125000
NODE_2316_length_1493_cov_100.467719	1130	1210	822	1	80	0.0125000
NODE_2316_length_1493_cov_100.467719	1130	1210	823	1	80	0.0125000
NODE_2316_length_1493_cov_100.467719	1130	1210	825	1	80	0.0125000
NODE_2316_length_1493_cov_100.467719	1130	1210	826	1	80	0.0125000
NODE_2316_length_1493_cov_100.467719	1130	1210	828	2	80	0.0250000
NODE_2316_length_1493_cov_100.467719	1130	1210	829	1	80	0.0125000
NODE_2316_length_1493_cov_100.467719	1130	1210	832	2	80	0.0250000
NODE_2316_length_1493_cov_100.467719	1130	1210	833	1	80	0.0125000
NODE_2316_length_1493_cov_100.467719	1130	1210	838	1	80	0.0125000
NODE_2316_length_1493_cov_100.467719	1130	1210	840	1	80	0.0125000
NODE_2316_length_1493_cov_100.467719	1130	1210	841	1	80	0.0125000
NODE_2316_length_1493_cov_100.467719	1130	1210	842	1	80	0.0125000
NODE_2316_length_1493_cov_100.467719	1130	1210	843	1	80	0.0125000
NODE_2316_length_1493_cov_100.467719	1130	1210	844	1	80	0.0125000
NODE_2316_length_1493_cov_100.467719	1130	1210	847	1	80	0.0125000
NODE_2316_length_1493_cov_100.467719	1130	1210	848	2	80	0.0250000
NODE_2316_length_1493_cov_100.467719	1130	1210	851	1	80	0.0125000
NODE_2316_length_1493_cov_100.467719	1130	1210	852	3	80	0.0375000
NODE_2316_length_1493_cov_100.467719	1130	1210	853	3	80	0.0375000
NODE_2316_length_1493_cov_100.467719	1130	1210	854	2	80	0.0250000
NODE_2316_length_1493_cov_100.467719	1130	1210	855	1	80	0.0125000
NODE_2316_length_1493_cov_100.467719	1130	1210	858	1	80	0.0125000
NODE_2316_length_1493_cov_100.467719	1130	1210	861	1	80	0.0125000
NODE_2316_length_1493_cov_100.467719	1130	1210	862	1	80	0.0125000
NODE_2316_length_1493_cov_100.467719	1130	1210	868	1	80	0.0125000
NODE_2316_length_1493_cov_100.467719	1130	1210	872	2	80	0.0250000
NODE_2316_length_1493_cov_100.467719	1130	1210	878	1	80	0.0125000
NODE_2321_length_1493_cov_1.138451	1341	1420	2	27	79	0.3417721
NODE_2321_length_1493_cov_1.138451	1341	1420	4	52	79	0.6582279
NODE_2321_length_1493_cov_1.138451	1341	1420	2	27	79	0.3417721
NODE_2321_length_1493_cov_1.138451	1341	1420	4	52	79	0.6582279
NODE_2321_length_1493_cov_1.138451	1393	1459	2	50	66	0.7575758
NODE_2321_length_1493_cov_1.138451	1393	1459	4	16	66	0.2424242
NODE_2332_length_1490_cov_5.726096	233	295	2	10	62	0.1612903
NODE_2332_length_1490_cov_5.726096	233	295	4	38	62	0.6129032
NODE_2332_length_1490_cov_5.726096	233	295	6	8	62	0.1290323
NODE_2332_length_1490_cov_5.726096	233	295	8	6	62	0.0967742
NODE_2332_length_1490_cov_5.726096	1065	1149	0	7	84	0.0833333
NODE_2332_length_1490_cov_5.726096	1065	1149	4	77	84	0.9166667
NODE_2333_length_1490_cov_4.687275	318	399	0	81	81	1.0000000
NODE_2333_length_1490_cov_4.687275	372	452	0	80	80	1.0000000
NODE_2338_length_1488_cov_3.734341	1141	1221	0	80	80	1.0000000
NODE_2340_length_1487_cov_19.332133	673	753	2	80	80	1.0000000
NODE_2340_length_1487_cov_19.332133	726	806	0	33	80	0.4125000
NODE_2340_length_1487_cov_19.332133	726	806	2	47	80	0.5875000
NODE_2348_length_1484_cov_38.342960	706	786	4	1	80	0.0125000
NODE_2348_length_1484_cov_38.342960	706	786	10	19	80	0.2375000
NODE_2348_length_1484_cov_38.342960	706	786	16	50	80	0.6250000
NODE_2348_length_1484_cov_38.342960	706	786	18	10	80	0.1250000
NODE_2348_length_1484_cov_38.342960	759	839	2	52	80	0.6500000
NODE_2348_length_1484_cov_38.342960	759	839	4	2	80	0.0250000
NODE_2348_length_1484_cov_38.342960	759	839	10	19	80	0.2375000
NODE_2348_length_1484_cov_38.342960	759	839	16	7	80	0.0875000
NODE_2349_length_1484_cov_21.260650	348	428	0	66	80	0.8250000
NODE_2349_length_1484_cov_21.260650	348	428	2	14	80	0.1750000
NODE_2349_length_1484_cov_21.260650	401	481	0	80	80	1.0000000
NODE_2349_length_1484_cov_21.260650	978	1058	2	21	80	0.2625000
NODE_2349_length_1484_cov_21.260650	978	1058	6	53	80	0.6625000
NODE_2349_length_1484_cov_21.260650	978	1058	8	6	80	0.0750000
NODE_2349_length_1484_cov_21.260650	1031	1111	2	74	80	0.9250000
NODE_2349_length_1484_cov_21.260650	1031	1111	6	3	80	0.0375000
NODE_2349_length_1484_cov_21.260650	1031	1111	8	3	80	0.0375000
NODE_2350_length_1484_cov_19.243321	952	1032	4	15	80	0.1875000
NODE_2350_length_1484_cov_19.243321	952	1032	6	12	80	0.1500000
NODE_2350_length_1484_cov_19.243321	952	1032	19	42	80	0.5250000
NODE_2350_length_1484_cov_19.243321	952	1032	21	11	80	0.1375000
NODE_2350_length_1484_cov_19.243321	1005	1085	19	71	80	0.8875000
NODE_2350_length_1484_cov_19.243321	1005	1085	21	9	80	0.1125000
NODE_2351_length_1484_cov_9.085199	314	394	0	52	80	0.6500000
NODE_2351_length_1484_cov_9.085199	314	394	2	28	80	0.3500000
NODE_2351_length_1484_cov_9.085199	367	447	2	80	80	1.0000000
NODE_2353_length_1483_cov_21.207370	555	635	0	5	80	0.0625000
NODE_2353_length_1483_cov_21.207370	555	635	2	3	80	0.0375000
NODE_2353_length_1483_cov_21.207370	555	635	6	72	80	0.9000000
NODE_2353_length_1483_cov_21.207370	608	688	0	58	80	0.7250000
NODE_2353_length_1483_cov_21.207370	608	688	2	3	80	0.0375000
NODE_2353_length_1483_cov_21.207370	608	688	6	19	80	0.2375000
NODE_2359_length_1482_cov_20.177874	430	510	0	17	80	0.2125000
NODE_2359_length_1482_cov_20.177874	430	510	4	63	80	0.7875000
NODE_2359_length_1482_cov_20.177874	483	563	0	6	80	0.0750000
NODE_2359_length_1482_cov_20.177874	483	563	2	20	80	0.2500000
NODE_2359_length_1482_cov_20.177874	483	563	4	54	80	0.6750000
NODE_2359_length_1482_cov_20.177874	559	639	2	2	80	0.0250000
NODE_2359_length_1482_cov_20.177874	559	639	4	44	80	0.5500000
NODE_2359_length_1482_cov_20.177874	559	639	6	9	80	0.1125000
NODE_2359_length_1482_cov_20.177874	559	639	8	25	80	0.3125000
NODE_2359_length_1482_cov_20.177874	612	692	4	54	80	0.6750000
NODE_2359_length_1482_cov_20.177874	612	692	6	9	80	0.1125000
NODE_2359_length_1482_cov_20.177874	612	692	8	17	80	0.2125000
NODE_2360_length_1482_cov_13.644252	1000	1080	4	33	80	0.4125000
NODE_2360_length_1482_cov_13.644252	1000	1080	6	47	80	0.5875000
NODE_2360_length_1482_cov_13.644252	1053	1133	0	38	80	0.4750000
NODE_2360_length_1482_cov_13.644252	1053	1133	2	5	80	0.0625000
NODE_2360_length_1482_cov_13.644252	1053	1133	4	37	80	0.4625000
NODE_2361_length_1482_cov_6.157628	525	605	0	80	80	1.0000000
NODE_2361_length_1482_cov_6.157628	578	658	0	80	80	1.0000000
NODE_2361_length_1482_cov_6.157628	1306	1388	14	2	82	0.0243902
NODE_2361_length_1482_cov_6.157628	1306	1388	16	7	82	0.0853659
NODE_2361_length_1482_cov_6.157628	1306	1388	18	7	82	0.0853659
NODE_2361_length_1482_cov_6.157628	1306	1388	20	6	82	0.0731707
NODE_2361_length_1482_cov_6.157628	1306	1388	24	1	82	0.0121951
NODE_2361_length_1482_cov_6.157628	1306	1388	26	8	82	0.0975610
NODE_2361_length_1482_cov_6.157628	1306	1388	28	50	82	0.6097561
NODE_2361_length_1482_cov_6.157628	1306	1388	30	1	82	0.0121951
NODE_2364_length_1481_cov_19.238784	480	560	3	14	80	0.1750000
NODE_2364_length_1481_cov_19.238784	480	560	5	24	80	0.3000000
NODE_2364_length_1481_cov_19.238784	480	560	6	33	80	0.4125000
NODE_2364_length_1481_cov_19.238784	480	560	8	9	80	0.1125000
NODE_2364_length_1481_cov_19.238784	533	613	0	43	80	0.5375000
NODE_2364_length_1481_cov_19.238784	533	613	3	24	80	0.3000000
NODE_2364_length_1481_cov_19.238784	533	613	5	13	80	0.1625000
NODE_2365_length_1481_cov_18.139653	706	786	0	16	80	0.2000000
NODE_2365_length_1481_cov_18.139653	706	786	2	64	80	0.8000000
NODE_2365_length_1481_cov_18.139653	759	839	2	71	80	0.8875000
NODE_2365_length_1481_cov_18.139653	759	839	4	1	80	0.0125000
NODE_2365_length_1481_cov_18.139653	759	839	8	8	80	0.1000000
NODE_2367_length_1480_cov_27.552498	762	842	0	80	80	1.0000000
NODE_2367_length_1480_cov_27.552498	815	895	0	80	80	1.0000000
NODE_2367_length_1480_cov_27.552498	891	971	0	80	80	1.0000000
NODE_2367_length_1480_cov_27.552498	944	1024	0	80	80	1.0000000
NODE_2367_length_1480_cov_27.552498	1171	1222	0	4	51	0.0784314
NODE_2367_length_1480_cov_27.552498	1171	1222	6	1	51	0.0196078
NODE_2367_length_1480_cov_27.552498	1171	1222	8	10	51	0.1960784
NODE_2367_length_1480_cov_27.552498	1171	1222	13	1	51	0.0196078
NODE_2367_length_1480_cov_27.552498	1171	1222	14	1	51	0.0196078
NODE_2367_length_1480_cov_27.552498	1171	1222	18	1	51	0.0196078
NODE_2367_length_1480_cov_27.552498	1171	1222	22	3	51	0.0588235
NODE_2367_length_1480_cov_27.552498	1171	1222	24	4	51	0.0784314
NODE_2367_length_1480_cov_27.552498	1171	1222	30	3	51	0.0588235
NODE_2367_length_1480_cov_27.552498	1171	1222	34	1	51	0.0196078
NODE_2367_length_1480_cov_27.552498	1171	1222	36	4	51	0.0784314
NODE_2367_length_1480_cov_27.552498	1171	1222	41	4	51	0.0784314
NODE_2367_length_1480_cov_27.552498	1171	1222	45	1	51	0.0196078
NODE_2367_length_1480_cov_27.552498	1171	1222	46	5	51	0.0980392
NODE_2367_length_1480_cov_27.552498	1171	1222	52	2	51	0.0392157
NODE_2367_length_1480_cov_27.552498	1171	1222	54	2	51	0.0392157
NODE_2367_length_1480_cov_27.552498	1171	1222	67	1	51	0.0196078
NODE_2367_length_1480_cov_27.552498	1171	1222	70	3	51	0.0588235
NODE_2369_length_1480_cov_12.535844	466	546	0	80	80	1.0000000
NODE_2369_length_1480_cov_12.535844	519	599	0	80	80	1.0000000
NODE_2373_length_1479_cov_17.035507	708	788	0	80	80	1.0000000
NODE_2373_length_1479_cov_17.035507	761	841	0	27	80	0.3375000
NODE_2373_length_1479_cov_17.035507	761	841	2	53	80	0.6625000
NODE_2373_length_1479_cov_17.035507	837	917	0	15	80	0.1875000
NODE_2373_length_1479_cov_17.035507	837	917	2	65	80	0.8125000
NODE_2373_length_1479_cov_17.035507	890	970	0	62	80	0.7750000
NODE_2373_length_1479_cov_17.035507	890	970	2	18	80	0.2250000
NODE_2374_length_1479_cov_16.448551	908	988	2	51	80	0.6375000
NODE_2374_length_1479_cov_16.448551	908	988	4	29	80	0.3625000
NODE_2374_length_1479_cov_16.448551	961	1041	0	13	80	0.1625000
NODE_2374_length_1479_cov_16.448551	961	1041	2	47	80	0.5875000
NODE_2374_length_1479_cov_16.448551	961	1041	4	20	80	0.2500000
NODE_2375_length_1479_cov_5.285507	123	185	20	5	62	0.0806452
NODE_2375_length_1479_cov_5.285507	123	185	22	2	62	0.0322581
NODE_2375_length_1479_cov_5.285507	123	185	24	2	62	0.0322581
NODE_2375_length_1479_cov_5.285507	123	185	26	1	62	0.0161290
NODE_2375_length_1479_cov_5.285507	123	185	28	2	62	0.0322581
NODE_2375_length_1479_cov_5.285507	123	185	32	11	62	0.1774193
NODE_2375_length_1479_cov_5.285507	123	185	34	1	62	0.0161290
NODE_2375_length_1479_cov_5.285507	123	185	40	2	62	0.0322581
NODE_2375_length_1479_cov_5.285507	123	185	43	3	62	0.0483871
NODE_2375_length_1479_cov_5.285507	123	185	55	1	62	0.0161290
NODE_2375_length_1479_cov_5.285507	123	185	58	1	62	0.0161290
NODE_2375_length_1479_cov_5.285507	123	185	61	1	62	0.0161290
NODE_2375_length_1479_cov_5.285507	123	185	63	1	62	0.0161290
NODE_2375_length_1479_cov_5.285507	123	185	69	1	62	0.0161290
NODE_2375_length_1479_cov_5.285507	123	185	73	1	62	0.0161290
NODE_2375_length_1479_cov_5.285507	123	185	76	2	62	0.0322581
NODE_2375_length_1479_cov_5.285507	123	185	78	2	62	0.0322581
NODE_2375_length_1479_cov_5.285507	123	185	81	1	62	0.0161290
NODE_2375_length_1479_cov_5.285507	123	185	88	1	62	0.0161290
NODE_2375_length_1479_cov_5.285507	123	185	94	2	62	0.0322581
NODE_2375_length_1479_cov_5.285507	123	185	96	2	62	0.0322581
NODE_2375_length_1479_cov_5.285507	123	185	98	2	62	0.0322581
NODE_2375_length_1479_cov_5.285507	123	185	102	1	62	0.0161290
NODE_2375_length_1479_cov_5.285507	123	185	108	2	62	0.0322581
NODE_2375_length_1479_cov_5.285507	123	185	109	1	62	0.0161290
NODE_2375_length_1479_cov_5.285507	123	185	110	2	62	0.0322581
NODE_2375_length_1479_cov_5.285507	123	185	112	2	62	0.0322581
NODE_2375_length_1479_cov_5.285507	123	185	114	2	62	0.0322581
NODE_2375_length_1479_cov_5.285507	123	185	116	2	62	0.0322581
NODE_2375_length_1479_cov_5.285507	123	185	120	3	62	0.0483871
NODE_2376_length_1479_cov_2.018841	881	967	0	37	86	0.4302326
NODE_2376_length_1479_cov_2.018841	881	967	2	29	86	0.3372093
NODE_2376_length_1479_cov_2.018841	881	967	4	20	86	0.2325581
NODE_2377_length_1478_cov_32.050761	411	491	0	55	80	0.6875000
NODE_2377_length_1478_cov_32.050761	411	491	2	14	80	0.1750000
NODE_2377_length_1478_cov_32.050761	411	491	4	11	80	0.1375000
NODE_2377_length_1478_cov_32.050761	464	544	0	2	80	0.0250000
NODE_2377_length_1478_cov_32.050761	464	544	2	14	80	0.1750000
NODE_2377_length_1478_cov_32.050761	464	544	4	64	80	0.8000000
NODE_2377_length_1478_cov_32.050761	540	620	0	63	80	0.7875000
NODE_2377_length_1478_cov_32.050761	540	620	2	12	80	0.1500000
NODE_2377_length_1478_cov_32.050761	540	620	4	5	80	0.0625000
NODE_2377_length_1478_cov_32.050761	593	673	0	80	80	1.0000000
NODE_2378_length_1478_cov_27.414793	817	897	0	80	80	1.0000000
NODE_2378_length_1478_cov_27.414793	870	950	0	27	80	0.3375000
NODE_2378_length_1478_cov_27.414793	870	950	4	53	80	0.6625000
NODE_2379_length_1478_cov_23.472081	1212	1241	82	1	29	0.0344828
NODE_2379_length_1478_cov_23.472081	1212	1241	83	1	29	0.0344828
NODE_2379_length_1478_cov_23.472081	1212	1241	84	2	29	0.0689655
NODE_2379_length_1478_cov_23.472081	1212	1241	85	1	29	0.0344828
NODE_2379_length_1478_cov_23.472081	1212	1241	86	2	29	0.0689655
NODE_2379_length_1478_cov_23.472081	1212	1241	87	4	29	0.1379310
NODE_2379_length_1478_cov_23.472081	1212	1241	89	6	29	0.2068966
NODE_2379_length_1478_cov_23.472081	1212	1241	91	8	29	0.2758621
NODE_2379_length_1478_cov_23.472081	1212	1241	92	1	29	0.0344828
NODE_2379_length_1478_cov_23.472081	1212	1241	93	1	29	0.0344828
NODE_2379_length_1478_cov_23.472081	1212	1241	94	2	29	0.0689655
NODE_2380_length_1478_cov_10.746193	678	758	8	10	80	0.1250000
NODE_2380_length_1478_cov_10.746193	678	758	10	11	80	0.1375000
NODE_2380_length_1478_cov_10.746193	678	758	11	1	80	0.0125000
NODE_2380_length_1478_cov_10.746193	678	758	12	29	80	0.3625000
NODE_2380_length_1478_cov_10.746193	678	758	14	29	80	0.3625000
NODE_2380_length_1478_cov_10.746193	731	811	0	3	80	0.0375000
NODE_2380_length_1478_cov_10.746193	731	811	2	7	80	0.0875000
NODE_2380_length_1478_cov_10.746193	731	811	4	24	80	0.3000000
NODE_2380_length_1478_cov_10.746193	731	811	6	9	80	0.1125000
NODE_2380_length_1478_cov_10.746193	731	811	8	9	80	0.1125000
NODE_2380_length_1478_cov_10.746193	731	811	14	28	80	0.3500000
NODE_2380_length_1478_cov_10.746193	807	892	0	10	85	0.1176471
NODE_2380_length_1478_cov_10.746193	807	892	2	26	85	0.3058824
NODE_2380_length_1478_cov_10.746193	807	892	4	17	85	0.2000000
NODE_2380_length_1478_cov_10.746193	807	892	6	32	85	0.3764706
NODE_2380_length_1478_cov_10.746193	860	945	2	4	85	0.0470588
NODE_2380_length_1478_cov_10.746193	860	945	4	46	85	0.5411765
NODE_2380_length_1478_cov_10.746193	860	945	6	35	85	0.4117647
NODE_2384_length_1476_cov_6.522150	791	871	0	22	80	0.2750000
NODE_2384_length_1476_cov_6.522150	791	871	3	23	80	0.2875000
NODE_2384_length_1476_cov_6.522150	791	871	4	35	80	0.4375000
NODE_2384_length_1476_cov_6.522150	844	924	0	75	80	0.9375000
NODE_2384_length_1476_cov_6.522150	844	924	4	5	80	0.0625000
NODE_2392_length_1474_cov_11.209455	515	595	0	80	80	1.0000000
NODE_2392_length_1474_cov_11.209455	568	648	0	80	80	1.0000000
NODE_2397_length_1472_cov_22.159505	428	508	2	6	80	0.0750000
NODE_2397_length_1472_cov_22.159505	428	508	4	47	80	0.5875000
NODE_2397_length_1472_cov_22.159505	428	508	6	27	80	0.3375000
NODE_2397_length_1472_cov_22.159505	428	508	2	6	80	0.0750000
NODE_2397_length_1472_cov_22.159505	428	508	4	47	80	0.5875000
NODE_2397_length_1472_cov_22.159505	428	508	6	27	80	0.3375000
NODE_2397_length_1472_cov_22.159505	481	561	4	63	80	0.7875000
NODE_2397_length_1472_cov_22.159505	481	561	6	1	80	0.0125000
NODE_2397_length_1472_cov_22.159505	481	561	17	1	80	0.0125000
NODE_2397_length_1472_cov_22.159505	481	561	19	7	80	0.0875000
NODE_2397_length_1472_cov_22.159505	481	561	21	2	80	0.0250000
NODE_2397_length_1472_cov_22.159505	481	561	23	1	80	0.0125000
NODE_2397_length_1472_cov_22.159505	481	561	25	5	80	0.0625000
NODE_2397_length_1472_cov_22.159505	913	993	0	80	80	1.0000000
NODE_2397_length_1472_cov_22.159505	966	1046	0	35	80	0.4375000
NODE_2397_length_1472_cov_22.159505	966	1046	2	45	80	0.5625000
NODE_2397_length_1472_cov_22.159505	1042	1122	0	49	80	0.6125000
NODE_2397_length_1472_cov_22.159505	1042	1122	2	31	80	0.3875000
NODE_2397_length_1472_cov_22.159505	1095	1175	0	37	80	0.4625000
NODE_2397_length_1472_cov_22.159505	1095	1175	2	43	80	0.5375000
NODE_2398_length_1472_cov_22.018208	523	590	0	35	67	0.5223880
NODE_2398_length_1472_cov_22.018208	523	590	2	32	67	0.4776119
NODE_2398_length_1472_cov_22.018208	563	643	0	80	80	1.0000000
NODE_2398_length_1472_cov_22.018208	639	719	0	80	80	1.0000000
NODE_2398_length_1472_cov_22.018208	692	772	0	28	80	0.3500000
NODE_2398_length_1472_cov_22.018208	692	772	2	52	80	0.6500000
NODE_2404_length_1470_cov_7.042305	5	57	6	5	52	0.0961538
NODE_2404_length_1470_cov_7.042305	5	57	10	2	52	0.0384615
NODE_2404_length_1470_cov_7.042305	5	57	14	6	52	0.1153846
NODE_2404_length_1470_cov_7.042305	5	57	15	1	52	0.0192308
NODE_2404_length_1470_cov_7.042305	5	57	19	1	52	0.0192308
NODE_2404_length_1470_cov_7.042305	5	57	26	2	52	0.0384615
NODE_2404_length_1470_cov_7.042305	5	57	28	3	52	0.0576923
NODE_2404_length_1470_cov_7.042305	5	57	30	32	52	0.6153846
NODE_2405_length_1470_cov_2.185266	199	245	0	5	46	0.1086956
NODE_2405_length_1470_cov_2.185266	199	245	2	4	46	0.0869565
NODE_2405_length_1470_cov_2.185266	199	245	4	37	46	0.8043478
NODE_2407_length_1469_cov_5.683942	834	914	0	35	80	0.4375000
NODE_2407_length_1469_cov_5.683942	834	914	2	45	80	0.5625000
NODE_2407_length_1469_cov_5.683942	887	967	2	80	80	1.0000000
NODE_2410_length_1467_cov_31.231725	1048	1131	0	83	83	1.0000000
NODE_2411_length_1467_cov_19.731725	485	565	8	25	80	0.3125000
NODE_2411_length_1467_cov_19.731725	485	565	10	7	80	0.0875000
NODE_2411_length_1467_cov_19.731725	485	565	12	19	80	0.2375000
NODE_2411_length_1467_cov_19.731725	485	565	14	29	80	0.3625000
NODE_2411_length_1467_cov_19.731725	538	618	0	20	80	0.2500000
NODE_2411_length_1467_cov_19.731725	538	618	2	3	80	0.0375000
NODE_2411_length_1467_cov_19.731725	538	618	4	9	80	0.1125000
NODE_2411_length_1467_cov_19.731725	538	618	6	2	80	0.0250000
NODE_2411_length_1467_cov_19.731725	538	618	12	5	80	0.0625000
NODE_2411_length_1467_cov_19.731725	538	618	14	41	80	0.5125000
NODE_2412_length_1467_cov_11.807749	180	242	10	9	62	0.1451613
NODE_2412_length_1467_cov_11.807749	180	242	12	3	62	0.0483871
NODE_2412_length_1467_cov_11.807749	180	242	14	4	62	0.0645161
NODE_2412_length_1467_cov_11.807749	180	242	16	3	62	0.0483871
NODE_2412_length_1467_cov_11.807749	180	242	18	1	62	0.0161290
NODE_2412_length_1467_cov_11.807749	180	242	22	6	62	0.0967742
NODE_2412_length_1467_cov_11.807749	180	242	24	36	62	0.5806451
NODE_2412_length_1467_cov_11.807749	264	293	10	4	29	0.1379310
NODE_2412_length_1467_cov_11.807749	264	293	12	3	29	0.1034483
NODE_2412_length_1467_cov_11.807749	264	293	14	6	29	0.2068966
NODE_2412_length_1467_cov_11.807749	264	293	16	1	29	0.0344828
NODE_2412_length_1467_cov_11.807749	264	293	18	5	29	0.1724138
NODE_2412_length_1467_cov_11.807749	264	293	20	2	29	0.0689655
NODE_2412_length_1467_cov_11.807749	264	293	22	1	29	0.0344828
NODE_2412_length_1467_cov_11.807749	264	293	24	7	29	0.2413793
NODE_2412_length_1467_cov_11.807749	930	1010	0	9	80	0.1125000
NODE_2412_length_1467_cov_11.807749	930	1010	4	71	80	0.8875000
NODE_2412_length_1467_cov_11.807749	983	1063	0	62	80	0.7750000
NODE_2412_length_1467_cov_11.807749	983	1063	4	18	80	0.2250000
NODE_2414_length_1466_cov_41.326993	664	744	0	5	80	0.0625000
NODE_2414_length_1466_cov_41.326993	664	744	2	37	80	0.4625000
NODE_2414_length_1466_cov_41.326993	664	744	4	38	80	0.4750000
NODE_2414_length_1466_cov_41.326993	717	797	0	30	80	0.3750000
NODE_2414_length_1466_cov_41.326993	717	797	2	7	80	0.0875000
NODE_2414_length_1466_cov_41.326993	717	797	4	43	80	0.5375000
NODE_2414_length_1466_cov_41.326993	793	873	0	80	80	1.0000000
NODE_2414_length_1466_cov_41.326993	846	926	0	38	80	0.4750000
NODE_2414_length_1466_cov_41.326993	846	926	2	42	80	0.5250000
NODE_2420_length_1464_cov_6.726740	137	204	6	67	67	1.0000000
NODE_2422_length_1464_cov_2.198535	1301	1363	11	1	62	0.0161290
NODE_2422_length_1464_cov_2.198535	1301	1363	12	4	62	0.0645161
NODE_2422_length_1464_cov_2.198535	1301	1363	14	8	62	0.1290323
NODE_2422_length_1464_cov_2.198535	1301	1363	15	3	62	0.0483871
NODE_2422_length_1464_cov_2.198535	1301	1363	18	1	62	0.0161290
NODE_2422_length_1464_cov_2.198535	1301	1363	22	12	62	0.1935484
NODE_2422_length_1464_cov_2.198535	1301	1363	24	1	62	0.0161290
NODE_2422_length_1464_cov_2.198535	1301	1363	26	2	62	0.0322581
NODE_2422_length_1464_cov_2.198535	1301	1363	28	10	62	0.1612903
NODE_2422_length_1464_cov_2.198535	1301	1363	30	20	62	0.3225806
NODE_2425_length_1463_cov_15.345308	314	394	0	72	80	0.9000000
NODE_2425_length_1463_cov_15.345308	314	394	1	5	80	0.0625000
NODE_2425_length_1463_cov_15.345308	314	394	2	3	80	0.0375000
NODE_2425_length_1463_cov_15.345308	367	447	0	24	80	0.3000000
NODE_2425_length_1463_cov_15.345308	367	447	2	37	80	0.4625000
NODE_2425_length_1463_cov_15.345308	367	447	4	19	80	0.2375000
NODE_2427_length_1462_cov_18.082172	418	498	0	80	80	1.0000000
NODE_2427_length_1462_cov_18.082172	471	551	0	80	80	1.0000000
NODE_2427_length_1462_cov_18.082172	1036	1116	0	80	80	1.0000000
NODE_2427_length_1462_cov_18.082172	1089	1169	0	80	80	1.0000000
NODE_2428_length_1462_cov_1.792370	1247	1319	0	72	72	1.0000000
NODE_2428_length_1462_cov_1.792370	1305	1374	0	69	69	1.0000000
NODE_2433_length_1460_cov_23.927994	852	932	0	2	80	0.0250000
NODE_2433_length_1460_cov_23.927994	852	932	2	17	80	0.2125000
NODE_2433_length_1460_cov_23.927994	852	932	6	7	80	0.0875000
NODE_2433_length_1460_cov_23.927994	852	932	8	54	80	0.6750000
NODE_2433_length_1460_cov_23.927994	905	985	0	11	80	0.1375000
NODE_2433_length_1460_cov_23.927994	905	985	4	6	80	0.0750000
NODE_2433_length_1460_cov_23.927994	905	985	6	42	80	0.5250000
NODE_2433_length_1460_cov_23.927994	905	985	8	21	80	0.2625000
NODE_2436_length_1459_cov_43.600000	535	615	0	28	80	0.3500000
NODE_2436_length_1459_cov_43.600000	535	615	2	52	80	0.6500000
NODE_2436_length_1459_cov_43.600000	588	668	0	6	80	0.0750000
NODE_2436_length_1459_cov_43.600000	588	668	2	57	80	0.7125000
NODE_2436_length_1459_cov_43.600000	588	668	4	17	80	0.2125000
NODE_2436_length_1459_cov_43.600000	664	744	4	6	80	0.0750000
NODE_2436_length_1459_cov_43.600000	664	744	5	2	80	0.0250000
NODE_2436_length_1459_cov_43.600000	664	744	6	28	80	0.3500000
NODE_2436_length_1459_cov_43.600000	664	744	8	40	80	0.5000000
NODE_2436_length_1459_cov_43.600000	664	744	10	4	80	0.0500000
NODE_2436_length_1459_cov_43.600000	717	797	4	25	80	0.3125000
NODE_2436_length_1459_cov_43.600000	717	797	6	35	80	0.4375000
NODE_2436_length_1459_cov_43.600000	717	797	8	16	80	0.2000000
NODE_2436_length_1459_cov_43.600000	717	797	10	4	80	0.0500000
NODE_2437_length_1459_cov_32.276471	865	945	0	80	80	1.0000000
NODE_2437_length_1459_cov_32.276471	918	998	0	44	80	0.5500000
NODE_2437_length_1459_cov_32.276471	918	998	2	36	80	0.4500000
NODE_2437_length_1459_cov_32.276471	994	1074	0	5	80	0.0625000
NODE_2437_length_1459_cov_32.276471	994	1074	2	55	80	0.6875000
NODE_2437_length_1459_cov_32.276471	994	1074	4	20	80	0.2500000
NODE_2437_length_1459_cov_32.276471	1047	1127	0	5	80	0.0625000
NODE_2437_length_1459_cov_32.276471	1047	1127	2	2	80	0.0250000
NODE_2437_length_1459_cov_32.276471	1047	1127	4	73	80	0.9125000
NODE_2441_length_1458_cov_2.184695	1361	1441	0	48	80	0.6000000
NODE_2441_length_1458_cov_2.184695	1361	1441	2	2	80	0.0250000
NODE_2441_length_1458_cov_2.184695	1361	1441	4	5	80	0.0625000
NODE_2441_length_1458_cov_2.184695	1361	1441	6	25	80	0.3125000
NODE_2442_length_1457_cov_19.687040	834	914	0	80	80	1.0000000
NODE_2442_length_1457_cov_19.687040	887	967	0	80	80	1.0000000
NODE_2442_length_1457_cov_19.687040	963	1043	0	77	80	0.9625000
NODE_2442_length_1457_cov_19.687040	963	1043	2	3	80	0.0375000
NODE_2442_length_1457_cov_19.687040	1016	1096	0	24	80	0.3000000
NODE_2442_length_1457_cov_19.687040	1016	1096	2	56	80	0.7000000
NODE_2444_length_1457_cov_14.944772	754	834	0	35	80	0.4375000
NODE_2444_length_1457_cov_14.944772	754	834	3	1	80	0.0125000
NODE_2444_length_1457_cov_14.944772	754	834	4	44	80	0.5500000
NODE_2444_length_1457_cov_14.944772	807	887	0	5	80	0.0625000
NODE_2444_length_1457_cov_14.944772	807	887	4	75	80	0.9375000
NODE_2445_length_1457_cov_10.168630	827	907	0	48	80	0.6000000
NODE_2445_length_1457_cov_10.168630	827	907	4	23	80	0.2875000
NODE_2445_length_1457_cov_10.168630	827	907	6	9	80	0.1125000
NODE_2445_length_1457_cov_10.168630	880	960	4	18	80	0.2250000
NODE_2445_length_1457_cov_10.168630	880	960	6	62	80	0.7750000
NODE_2445_length_1457_cov_10.168630	956	1036	0	32	80	0.4000000
NODE_2445_length_1457_cov_10.168630	956	1036	2	20	80	0.2500000
NODE_2445_length_1457_cov_10.168630	956	1036	4	2	80	0.0250000
NODE_2445_length_1457_cov_10.168630	956	1036	6	26	80	0.3250000
NODE_2445_length_1457_cov_10.168630	1009	1089	0	7	80	0.0875000
NODE_2445_length_1457_cov_10.168630	1009	1089	2	73	80	0.9125000
NODE_2448_length_1456_cov_13.675755	557	637	0	6	80	0.0750000
NODE_2448_length_1456_cov_13.675755	557	637	2	62	80	0.7750000
NODE_2448_length_1456_cov_13.675755	557	637	4	12	80	0.1500000
NODE_2448_length_1456_cov_13.675755	610	690	0	6	80	0.0750000
NODE_2448_length_1456_cov_13.675755	610	690	2	9	80	0.1125000
NODE_2448_length_1456_cov_13.675755	610	690	4	65	80	0.8125000
NODE_2449_length_1456_cov_11.109064	951	1031	0	80	80	1.0000000
NODE_2449_length_1456_cov_11.109064	1004	1084	0	80	80	1.0000000
NODE_2452_length_1456_cov_3.137067	374	410	8	10	36	0.2777778
NODE_2452_length_1456_cov_3.137067	374	410	10	4	36	0.1111111
NODE_2452_length_1456_cov_3.137067	374	410	12	20	36	0.5555556
NODE_2452_length_1456_cov_3.137067	374	410	14	1	36	0.0277778
NODE_2452_length_1456_cov_3.137067	374	410	16	1	36	0.0277778
NODE_2454_length_1456_cov_1.889462	35	99	0	64	64	1.0000000
NODE_2456_length_1455_cov_60.874631	369	449	0	40	80	0.5000000
NODE_2456_length_1455_cov_60.874631	369	449	2	40	80	0.5000000
NODE_2456_length_1455_cov_60.874631	422	502	0	80	80	1.0000000
NODE_2456_length_1455_cov_60.874631	498	578	0	5	80	0.0625000
NODE_2456_length_1455_cov_60.874631	498	578	2	15	80	0.1875000
NODE_2456_length_1455_cov_60.874631	498	578	4	60	80	0.7500000
NODE_2456_length_1455_cov_60.874631	551	631	0	50	80	0.6250000
NODE_2456_length_1455_cov_60.874631	551	631	4	30	80	0.3750000
NODE_2458_length_1455_cov_35.253687	615	695	2	26	80	0.3250000
NODE_2458_length_1455_cov_35.253687	615	695	8	10	80	0.1250000
NODE_2458_length_1455_cov_35.253687	615	695	9	1	80	0.0125000
NODE_2458_length_1455_cov_35.253687	615	695	10	43	80	0.5375000
NODE_2458_length_1455_cov_35.253687	668	748	2	16	80	0.2000000
NODE_2458_length_1455_cov_35.253687	668	748	8	42	80	0.5250000
NODE_2458_length_1455_cov_35.253687	668	748	10	22	80	0.2750000
NODE_2458_length_1455_cov_35.253687	744	824	2	68	80	0.8500000
NODE_2458_length_1455_cov_35.253687	744	824	4	12	80	0.1500000
NODE_2458_length_1455_cov_35.253687	797	877	2	61	80	0.7625000
NODE_2458_length_1455_cov_35.253687	797	877	4	19	80	0.2375000
NODE_2465_length_1452_cov_7.101256	976	1056	0	80	80	1.0000000
NODE_2465_length_1452_cov_7.101256	1029	1109	0	80	80	1.0000000
NODE_2465_length_1452_cov_7.101256	1105	1185	0	63	80	0.7875000
NODE_2465_length_1452_cov_7.101256	1105	1185	2	17	80	0.2125000
NODE_2465_length_1452_cov_7.101256	1158	1238	0	10	80	0.1250000
NODE_2465_length_1452_cov_7.101256	1158	1238	2	70	80	0.8750000
NODE_2470_length_1451_cov_23.880178	439	520	2	13	81	0.1604938
NODE_2470_length_1451_cov_23.880178	439	520	4	5	81	0.0617284
NODE_2470_length_1451_cov_23.880178	439	520	6	22	81	0.2716049
NODE_2470_length_1451_cov_23.880178	439	520	8	41	81	0.5061728
NODE_2470_length_1451_cov_23.880178	493	573	2	66	80	0.8250000
NODE_2470_length_1451_cov_23.880178	493	573	4	5	80	0.0625000
NODE_2470_length_1451_cov_23.880178	493	573	8	9	80	0.1125000
NODE_2471_length_1451_cov_16.249260	422	502	0	18	80	0.2250000
NODE_2471_length_1451_cov_16.249260	422	502	2	62	80	0.7750000
NODE_2471_length_1451_cov_16.249260	475	555	0	39	80	0.4875000
NODE_2471_length_1451_cov_16.249260	475	555	2	41	80	0.5125000
NODE_2472_length_1451_cov_8.663462	908	988	0	3	80	0.0375000
NODE_2472_length_1451_cov_8.663462	908	988	2	7	80	0.0875000
NODE_2472_length_1451_cov_8.663462	908	988	6	70	80	0.8750000
NODE_2472_length_1451_cov_8.663462	961	1040	0	22	79	0.2784810
NODE_2472_length_1451_cov_8.663462	961	1040	4	8	79	0.1012658
NODE_2472_length_1451_cov_8.663462	961	1040	6	49	79	0.6202531
NODE_2474_length_1451_cov_5.219675	897	977	0	2	80	0.0250000
NODE_2474_length_1451_cov_5.219675	897	977	2	78	80	0.9750000
NODE_2474_length_1451_cov_5.219675	950	1030	0	40	80	0.5000000
NODE_2474_length_1451_cov_5.219675	950	1030	2	40	80	0.5000000
NODE_2477_length_1450_cov_20.371577	611	691	0	63	80	0.7875000
NODE_2477_length_1450_cov_20.371577	611	691	6	17	80	0.2125000
NODE_2477_length_1450_cov_20.371577	664	744	0	10	80	0.1250000
NODE_2477_length_1450_cov_20.371577	664	744	6	70	80	0.8750000
NODE_2482_length_1449_cov_24.665926	432	512	0	80	80	1.0000000
NODE_2482_length_1449_cov_24.665926	485	565	0	80	80	1.0000000
NODE_2482_length_1449_cov_24.665926	561	643	0	82	82	1.0000000
NODE_2482_length_1449_cov_24.665926	616	696	0	80	80	1.0000000
NODE_2485_length_1448_cov_20.587102	904	984	2	62	80	0.7750000
NODE_2485_length_1448_cov_20.587102	904	984	4	18	80	0.2250000
NODE_2485_length_1448_cov_20.587102	957	1037	0	47	80	0.5875000
NODE_2485_length_1448_cov_20.587102	957	1037	2	33	80	0.4125000
NODE_2487_length_1448_cov_8.693847	537	617	0	73	80	0.9125000
NODE_2487_length_1448_cov_8.693847	537	617	3	1	80	0.0125000
NODE_2487_length_1448_cov_8.693847	537	617	4	6	80	0.0750000
NODE_2487_length_1448_cov_8.693847	590	670	0	20	80	0.2500000
NODE_2487_length_1448_cov_8.693847	590	670	3	1	80	0.0125000
NODE_2487_length_1448_cov_8.693847	590	670	4	8	80	0.1000000
NODE_2487_length_1448_cov_8.693847	590	670	10	51	80	0.6375000
NODE_2488_length_1447_cov_21.391691	519	599	0	80	80	1.0000000
NODE_2488_length_1447_cov_21.391691	572	652	0	80	80	1.0000000
NODE_2488_length_1447_cov_21.391691	648	728	0	80	80	1.0000000
NODE_2488_length_1447_cov_21.391691	701	781	0	44	80	0.5500000
NODE_2488_length_1447_cov_21.391691	701	781	2	36	80	0.4500000
NODE_2491_length_1447_cov_2.262611	1268	1325	28	2	57	0.0350877
NODE_2491_length_1447_cov_2.262611	1268	1325	29	1	57	0.0175439
NODE_2491_length_1447_cov_2.262611	1268	1325	31	1	57	0.0175439
NODE_2491_length_1447_cov_2.262611	1268	1325	34	2	57	0.0350877
NODE_2491_length_1447_cov_2.262611	1268	1325	35	5	57	0.0877193
NODE_2491_length_1447_cov_2.262611	1268	1325	39	1	57	0.0175439
NODE_2491_length_1447_cov_2.262611	1268	1325	41	1	57	0.0175439
NODE_2491_length_1447_cov_2.262611	1268	1325	45	4	57	0.0701754
NODE_2491_length_1447_cov_2.262611	1268	1325	46	1	57	0.0175439
NODE_2491_length_1447_cov_2.262611	1268	1325	47	2	57	0.0350877
NODE_2491_length_1447_cov_2.262611	1268	1325	53	3	57	0.0526316
NODE_2491_length_1447_cov_2.262611	1268	1325	55	1	57	0.0175439
NODE_2491_length_1447_cov_2.262611	1268	1325	59	1	57	0.0175439
NODE_2491_length_1447_cov_2.262611	1268	1325	60	4	57	0.0701754
NODE_2491_length_1447_cov_2.262611	1268	1325	64	1	57	0.0175439
NODE_2491_length_1447_cov_2.262611	1268	1325	71	1	57	0.0175439
NODE_2491_length_1447_cov_2.262611	1268	1325	77	1	57	0.0175439
NODE_2491_length_1447_cov_2.262611	1268	1325	79	2	57	0.0350877
NODE_2491_length_1447_cov_2.262611	1268	1325	80	4	57	0.0701754
NODE_2491_length_1447_cov_2.262611	1268	1325	81	2	57	0.0350877
NODE_2491_length_1447_cov_2.262611	1268	1325	83	6	57	0.1052632
NODE_2491_length_1447_cov_2.262611	1268	1325	85	5	57	0.0877193
NODE_2491_length_1447_cov_2.262611	1268	1325	87	6	57	0.1052632
NODE_2491_length_1447_cov_2.262611	1321	1378	71	2	57	0.0350877
NODE_2491_length_1447_cov_2.262611	1321	1378	74	1	57	0.0175439
NODE_2491_length_1447_cov_2.262611	1321	1378	79	9	57	0.1578947
NODE_2491_length_1447_cov_2.262611	1321	1378	81	3	57	0.0526316
NODE_2491_length_1447_cov_2.262611	1321	1378	83	18	57	0.3157895
NODE_2491_length_1447_cov_2.262611	1321	1378	87	24	57	0.4210526
NODE_2494_length_1445_cov_22.052006	759	839	0	80	80	1.0000000
NODE_2494_length_1445_cov_22.052006	812	892	0	80	80	1.0000000
NODE_2494_length_1445_cov_22.052006	888	968	0	80	80	1.0000000
NODE_2494_length_1445_cov_22.052006	941	1021	0	80	80	1.0000000
NODE_2495_length_1445_cov_13.378900	584	664	0	29	80	0.3625000
NODE_2495_length_1445_cov_13.378900	584	664	4	51	80	0.6375000
NODE_2495_length_1445_cov_13.378900	637	717	2	10	80	0.1250000
NODE_2495_length_1445_cov_13.378900	637	717	4	63	80	0.7875000
NODE_2495_length_1445_cov_13.378900	637	717	6	7	80	0.0875000
NODE_2501_length_1443_cov_7.628720	480	560	0	80	80	1.0000000
NODE_2501_length_1443_cov_7.628720	533	613	0	80	80	1.0000000
NODE_2501_length_1443_cov_7.628720	609	689	0	80	80	1.0000000
NODE_2501_length_1443_cov_7.628720	662	742	0	80	80	1.0000000
NODE_2502_length_1443_cov_4.843006	924	1004	0	57	80	0.7125000
NODE_2502_length_1443_cov_4.843006	924	1004	2	20	80	0.2500000
NODE_2502_length_1443_cov_4.843006	924	1004	4	3	80	0.0375000
NODE_2502_length_1443_cov_4.843006	977	1057	0	80	80	1.0000000
NODE_2508_length_1442_cov_24.551750	427	507	0	44	80	0.5500000
NODE_2508_length_1442_cov_24.551750	427	507	2	36	80	0.4500000
NODE_2508_length_1442_cov_24.551750	480	560	0	80	80	1.0000000
NODE_2508_length_1442_cov_24.551750	556	636	0	40	80	0.5000000
NODE_2508_length_1442_cov_24.551750	556	636	2	40	80	0.5000000
NODE_2508_length_1442_cov_24.551750	609	689	2	80	80	1.0000000
NODE_2509_length_1442_cov_24.032762	424	504	0	8	80	0.1000000
NODE_2509_length_1442_cov_24.032762	424	504	4	1	80	0.0125000
NODE_2509_length_1442_cov_24.032762	424	504	6	71	80	0.8875000
NODE_2509_length_1442_cov_24.032762	477	557	0	61	80	0.7625000
NODE_2509_length_1442_cov_24.032762	477	557	4	1	80	0.0125000
NODE_2509_length_1442_cov_24.032762	477	557	6	18	80	0.2250000
NODE_2511_length_1441_cov_16.528316	963	1043	2	11	80	0.1375000
NODE_2511_length_1441_cov_16.528316	963	1043	4	5	80	0.0625000
NODE_2511_length_1441_cov_16.528316	963	1043	6	16	80	0.2000000
NODE_2511_length_1441_cov_16.528316	963	1043	8	44	80	0.5500000
NODE_2511_length_1441_cov_16.528316	963	1043	10	4	80	0.0500000
NODE_2511_length_1441_cov_16.528316	1016	1096	2	10	80	0.1250000
NODE_2511_length_1441_cov_16.528316	1016	1096	4	7	80	0.0875000
NODE_2511_length_1441_cov_16.528316	1016	1096	6	2	80	0.0250000
NODE_2511_length_1441_cov_16.528316	1016	1096	8	31	80	0.3875000
NODE_2511_length_1441_cov_16.528316	1016	1096	10	30	80	0.3750000
NODE_2512_length_1441_cov_3.781669	80	156	0	76	76	1.0000000
NODE_2512_length_1441_cov_3.781669	129	209	0	80	80	1.0000000
NODE_2515_length_1440_cov_34.523490	446	526	0	50	80	0.6250000
NODE_2515_length_1440_cov_34.523490	446	526	2	30	80	0.3750000
NODE_2515_length_1440_cov_34.523490	499	576	0	8	77	0.1038961
NODE_2515_length_1440_cov_34.523490	499	576	2	69	77	0.8961039
NODE_2515_length_1440_cov_34.523490	576	654	0	67	78	0.8589743
NODE_2515_length_1440_cov_34.523490	576	654	2	11	78	0.1410256
NODE_2515_length_1440_cov_34.523490	627	707	0	16	80	0.2000000
NODE_2515_length_1440_cov_34.523490	627	707	2	64	80	0.8000000
NODE_2516_length_1440_cov_20.372110	776	856	0	3	80	0.0375000
NODE_2516_length_1440_cov_20.372110	776	856	2	77	80	0.9625000
NODE_2516_length_1440_cov_20.372110	829	909	0	56	80	0.7000000
NODE_2516_length_1440_cov_20.372110	829	909	2	24	80	0.3000000
NODE_2516_length_1440_cov_20.372110	905	985	0	7	80	0.0875000
NODE_2516_length_1440_cov_20.372110	905	985	2	65	80	0.8125000
NODE_2516_length_1440_cov_20.372110	905	985	4	3	80	0.0375000
NODE_2516_length_1440_cov_20.372110	905	985	6	5	80	0.0625000
NODE_2516_length_1440_cov_20.372110	958	1038	2	19	80	0.2375000
NODE_2516_length_1440_cov_20.372110	958	1038	4	51	80	0.6375000
NODE_2516_length_1440_cov_20.372110	958	1038	5	3	80	0.0375000
NODE_2516_length_1440_cov_20.372110	958	1038	6	7	80	0.0875000
NODE_2517_length_1440_cov_14.476510	586	615	3	1	29	0.0344828
NODE_2517_length_1440_cov_14.476510	586	615	5	1	29	0.0344828
NODE_2517_length_1440_cov_14.476510	586	615	6	27	29	0.9310345
NODE_2517_length_1440_cov_14.476510	666	695	0	21	29	0.7241379
NODE_2517_length_1440_cov_14.476510	666	695	2	8	29	0.2758621
NODE_2517_length_1440_cov_14.476510	1295	1359	235	4	64	0.0625000
NODE_2517_length_1440_cov_14.476510	1295	1359	236	5	64	0.0781250
NODE_2517_length_1440_cov_14.476510	1295	1359	244	2	64	0.0312500
NODE_2517_length_1440_cov_14.476510	1295	1359	246	1	64	0.0156250
NODE_2517_length_1440_cov_14.476510	1295	1359	248	1	64	0.0156250
NODE_2517_length_1440_cov_14.476510	1295	1359	250	2	64	0.0312500
NODE_2517_length_1440_cov_14.476510	1295	1359	252	1	64	0.0156250
NODE_2517_length_1440_cov_14.476510	1295	1359	253	3	64	0.0468750
NODE_2517_length_1440_cov_14.476510	1295	1359	254	15	64	0.2343750
NODE_2517_length_1440_cov_14.476510	1295	1359	256	4	64	0.0625000
NODE_2517_length_1440_cov_14.476510	1295	1359	258	2	64	0.0312500
NODE_2517_length_1440_cov_14.476510	1295	1359	259	2	64	0.0312500
NODE_2517_length_1440_cov_14.476510	1295	1359	260	6	64	0.0937500
NODE_2517_length_1440_cov_14.476510	1295	1359	262	2	64	0.0312500
NODE_2517_length_1440_cov_14.476510	1295	1359	264	9	64	0.1406250
NODE_2517_length_1440_cov_14.476510	1295	1359	265	1	64	0.0156250
NODE_2517_length_1440_cov_14.476510	1295	1359	266	4	64	0.0625000
NODE_2518_length_1440_cov_9.049217	384	464	0	14	80	0.1750000
NODE_2518_length_1440_cov_9.049217	384	464	2	66	80	0.8250000
NODE_2518_length_1440_cov_9.049217	437	517	0	67	80	0.8375000
NODE_2518_length_1440_cov_9.049217	437	517	2	13	80	0.1625000
NODE_2520_length_1439_cov_11.784328	898	978	0	80	80	1.0000000
NODE_2520_length_1439_cov_11.784328	951	1031	0	80	80	1.0000000
NODE_2525_length_1438_cov_41.481703	671	751	0	35	80	0.4375000
NODE_2525_length_1438_cov_41.481703	671	751	2	45	80	0.5625000
NODE_2525_length_1438_cov_41.481703	724	804	0	25	80	0.3125000
NODE_2525_length_1438_cov_41.481703	724	804	2	55	80	0.6875000
NODE_2529_length_1437_cov_14.449178	815	895	0	80	80	1.0000000
NODE_2529_length_1437_cov_14.449178	868	948	0	80	80	1.0000000
NODE_2529_length_1437_cov_14.449178	944	1024	0	80	80	1.0000000
NODE_2529_length_1437_cov_14.449178	997	1077	0	80	80	1.0000000
NODE_2532_length_1436_cov_96.256545	1145	1225	0	80	80	1.0000000
NODE_2532_length_1436_cov_96.256545	1198	1278	0	80	80	1.0000000
NODE_2532_length_1436_cov_96.256545	1274	1354	0	43	80	0.5375000
NODE_2532_length_1436_cov_96.256545	1274	1354	2	37	80	0.4625000
NODE_2532_length_1436_cov_96.256545	1327	1407	0	64	80	0.8000000
NODE_2532_length_1436_cov_96.256545	1327	1407	2	16	80	0.2000000
NODE_2536_length_1435_cov_21.468563	783	863	0	80	80	1.0000000
NODE_2536_length_1435_cov_21.468563	836	916	0	80	80	1.0000000
NODE_2536_length_1435_cov_21.468563	912	992	0	37	80	0.4625000
NODE_2536_length_1435_cov_21.468563	912	992	2	26	80	0.3250000
NODE_2536_length_1435_cov_21.468563	912	992	4	10	80	0.1250000
NODE_2536_length_1435_cov_21.468563	912	992	6	7	80	0.0875000
NODE_2536_length_1435_cov_21.468563	965	1045	2	10	80	0.1250000
NODE_2536_length_1435_cov_21.468563	965	1045	4	10	80	0.1250000
NODE_2536_length_1435_cov_21.468563	965	1045	6	24	80	0.3000000
NODE_2536_length_1435_cov_21.468563	965	1045	8	36	80	0.4500000
NODE_2537_length_1435_cov_18.593563	1123	1203	6	41	80	0.5125000
NODE_2537_length_1435_cov_18.593563	1123	1203	8	9	80	0.1125000
NODE_2537_length_1435_cov_18.593563	1123	1203	10	8	80	0.1000000
NODE_2537_length_1435_cov_18.593563	1123	1203	12	22	80	0.2750000
NODE_2537_length_1435_cov_18.593563	1176	1256	0	18	80	0.2250000
NODE_2537_length_1435_cov_18.593563	1176	1256	2	30	80	0.3750000
NODE_2537_length_1435_cov_18.593563	1176	1256	6	32	80	0.4000000
NODE_2538_length_1435_cov_5.828593	299	379	0	80	80	1.0000000
NODE_2538_length_1435_cov_5.828593	352	432	0	80	80	1.0000000
NODE_2540_length_1434_cov_17.610487	1023	1103	0	31	80	0.3875000
NODE_2540_length_1434_cov_17.610487	1023	1103	2	15	80	0.1875000
NODE_2540_length_1434_cov_17.610487	1023	1103	4	34	80	0.4250000
NODE_2540_length_1434_cov_17.610487	1076	1156	0	6	80	0.0750000
NODE_2540_length_1434_cov_17.610487	1076	1156	2	14	80	0.1750000
NODE_2540_length_1434_cov_17.610487	1076	1156	4	60	80	0.7500000
NODE_2540_length_1434_cov_17.610487	1152	1232	0	80	80	1.0000000
NODE_2540_length_1434_cov_17.610487	1205	1285	0	80	80	1.0000000
NODE_2541_length_1434_cov_9.845693	846	926	0	23	80	0.2875000
NODE_2541_length_1434_cov_9.845693	846	926	6	1	80	0.0125000
NODE_2541_length_1434_cov_9.845693	846	926	8	56	80	0.7000000
NODE_2541_length_1434_cov_9.845693	899	978	0	16	79	0.2025317
NODE_2541_length_1434_cov_9.845693	899	978	2	10	79	0.1265823
NODE_2541_length_1434_cov_9.845693	899	978	8	53	79	0.6708861
NODE_2544_length_1433_cov_36.452774	538	618	0	80	80	1.0000000
NODE_2544_length_1433_cov_36.452774	591	671	0	33	80	0.4125000
NODE_2544_length_1433_cov_36.452774	591	671	4	47	80	0.5875000
NODE_2544_length_1433_cov_36.452774	667	747	2	20	80	0.2500000
NODE_2544_length_1433_cov_36.452774	667	747	4	34	80	0.4250000
NODE_2544_length_1433_cov_36.452774	667	747	6	26	80	0.3250000
NODE_2544_length_1433_cov_36.452774	720	800	0	27	80	0.3375000
NODE_2544_length_1433_cov_36.452774	720	800	2	46	80	0.5750000
NODE_2544_length_1433_cov_36.452774	720	800	6	7	80	0.0875000
NODE_2550_length_1431_cov_7.409159	513	593	0	71	80	0.8875000
NODE_2550_length_1431_cov_7.409159	513	593	2	9	80	0.1125000
NODE_2550_length_1431_cov_7.409159	566	646	0	80	80	1.0000000
NODE_2551_length_1431_cov_6.721471	1074	1154	2	9	80	0.1125000
NODE_2551_length_1431_cov_6.721471	1074	1154	4	9	80	0.1125000
NODE_2551_length_1431_cov_6.721471	1074	1154	6	62	80	0.7750000
NODE_2551_length_1431_cov_6.721471	1127	1207	0	29	80	0.3625000
NODE_2551_length_1431_cov_6.721471	1127	1207	2	33	80	0.4125000
NODE_2551_length_1431_cov_6.721471	1127	1207	6	18	80	0.2250000
NODE_2552_length_1430_cov_32.643877	753	833	0	80	80	1.0000000
NODE_2552_length_1430_cov_32.643877	806	886	0	80	80	1.0000000
NODE_2552_length_1430_cov_32.643877	882	962	0	35	80	0.4375000
NODE_2552_length_1430_cov_32.643877	882	962	2	45	80	0.5625000
NODE_2552_length_1430_cov_32.643877	935	1016	0	32	81	0.3950617
NODE_2552_length_1430_cov_32.643877	935	1016	2	49	81	0.6049383
NODE_2557_length_1428_cov_5.895410	340	416	0	47	76	0.6184211
NODE_2557_length_1428_cov_5.895410	340	416	2	16	76	0.2105263
NODE_2557_length_1428_cov_5.895410	340	416	3	13	76	0.1710526
NODE_2557_length_1428_cov_5.895410	393	476	0	68	83	0.8192771
NODE_2557_length_1428_cov_5.895410	393	476	2	15	83	0.1807229
NODE_2560_length_1427_cov_38.919428	707	787	1	10	80	0.1250000
NODE_2560_length_1427_cov_38.919428	707	787	2	70	80	0.8750000
NODE_2560_length_1427_cov_38.919428	760	840	1	42	80	0.5250000
NODE_2560_length_1427_cov_38.919428	760	840	2	38	80	0.4750000
NODE_2560_length_1427_cov_38.919428	836	916	0	49	80	0.6125000
NODE_2560_length_1427_cov_38.919428	836	916	1	31	80	0.3875000
NODE_2560_length_1427_cov_38.919428	889	969	0	80	80	1.0000000
NODE_2561_length_1427_cov_19.442771	808	888	0	80	80	1.0000000
NODE_2561_length_1427_cov_19.442771	861	941	0	74	80	0.9250000
NODE_2561_length_1427_cov_19.442771	861	941	6	6	80	0.0750000
NODE_2561_length_1427_cov_19.442771	937	1017	6	80	80	1.0000000
NODE_2561_length_1427_cov_19.442771	990	1070	0	18	80	0.2250000
NODE_2561_length_1427_cov_19.442771	990	1070	2	24	80	0.3000000
NODE_2561_length_1427_cov_19.442771	990	1070	4	9	80	0.1125000
NODE_2561_length_1427_cov_19.442771	990	1070	6	29	80	0.3625000
NODE_2562_length_1427_cov_10.490964	728	808	0	80	80	1.0000000
NODE_2562_length_1427_cov_10.490964	781	861	0	80	80	1.0000000
NODE_2562_length_1427_cov_10.490964	857	937	0	51	80	0.6375000
NODE_2562_length_1427_cov_10.490964	857	937	2	29	80	0.3625000
NODE_2562_length_1427_cov_10.490964	910	990	0	17	80	0.2125000
NODE_2562_length_1427_cov_10.490964	910	990	2	63	80	0.7875000
NODE_2563_length_1427_cov_9.929217	646	726	4	11	80	0.1375000
NODE_2563_length_1427_cov_9.929217	646	726	6	69	80	0.8625000
NODE_2563_length_1427_cov_9.929217	699	779	0	13	80	0.1625000
NODE_2563_length_1427_cov_9.929217	699	779	2	22	80	0.2750000
NODE_2563_length_1427_cov_9.929217	699	779	6	45	80	0.5625000
NODE_2563_length_1427_cov_9.929217	775	855	2	80	80	1.0000000
NODE_2563_length_1427_cov_9.929217	828	908	0	51	80	0.6375000
NODE_2563_length_1427_cov_9.929217	828	908	2	29	80	0.3625000
NODE_2563_length_1427_cov_9.929217	1248	1324	0	36	76	0.4736842
NODE_2563_length_1427_cov_9.929217	1248	1324	2	36	76	0.4736842
NODE_2563_length_1427_cov_9.929217	1248	1324	4	4	76	0.0526316
NODE_2563_length_1427_cov_9.929217	1301	1376	2	20	75	0.2666667
NODE_2563_length_1427_cov_9.929217	1301	1376	4	55	75	0.7333333
NODE_2564_length_1427_cov_3.122741	1336	1399	2	63	63	1.0000000
NODE_2570_length_1426_cov_36.580256	422	502	4	78	80	0.9750000
NODE_2570_length_1426_cov_36.580256	422	502	6	2	80	0.0250000
NODE_2570_length_1426_cov_36.580256	475	555	0	8	80	0.1000000
NODE_2570_length_1426_cov_36.580256	475	555	2	11	80	0.1375000
NODE_2570_length_1426_cov_36.580256	475	555	4	61	80	0.7625000
NODE_2570_length_1426_cov_36.580256	551	631	0	80	80	1.0000000
NODE_2570_length_1426_cov_36.580256	604	684	0	45	80	0.5625000
NODE_2570_length_1426_cov_36.580256	604	684	2	35	80	0.4375000
NODE_2574_length_1425_cov_25.524133	561	641	0	22	80	0.2750000
NODE_2574_length_1425_cov_25.524133	561	641	3	1	80	0.0125000
NODE_2574_length_1425_cov_25.524133	561	641	4	57	80	0.7125000
NODE_2574_length_1425_cov_25.524133	614	694	0	6	80	0.0750000
NODE_2574_length_1425_cov_25.524133	614	694	4	74	80	0.9250000
NODE_2575_length_1425_cov_10.175716	361	441	4	27	80	0.3375000
NODE_2575_length_1425_cov_10.175716	361	441	10	14	80	0.1750000
NODE_2575_length_1425_cov_10.175716	361	441	12	39	80	0.4875000
NODE_2575_length_1425_cov_10.175716	414	494	8	10	80	0.1250000
NODE_2575_length_1425_cov_10.175716	414	494	10	2	80	0.0250000
NODE_2575_length_1425_cov_10.175716	414	494	12	35	80	0.4375000
NODE_2575_length_1425_cov_10.175716	414	494	14	33	80	0.4125000
NODE_2587_length_1423_cov_31.158610	862	942	0	1	80	0.0125000
NODE_2587_length_1423_cov_31.158610	862	942	6	19	80	0.2375000
NODE_2587_length_1423_cov_31.158610	862	942	8	60	80	0.7500000
NODE_2587_length_1423_cov_31.158610	915	995	0	54	80	0.6750000
NODE_2587_length_1423_cov_31.158610	915	995	6	19	80	0.2375000
NODE_2587_length_1423_cov_31.158610	915	995	8	7	80	0.0875000
NODE_2588_length_1423_cov_30.731873	764	844	0	69	80	0.8625000
NODE_2588_length_1423_cov_30.731873	764	844	2	11	80	0.1375000
NODE_2588_length_1423_cov_30.731873	817	897	0	38	80	0.4750000
NODE_2588_length_1423_cov_30.731873	817	897	2	42	80	0.5250000
NODE_2596_length_1421_cov_8.285930	136	212	87	1	76	0.0131579
NODE_2596_length_1421_cov_8.285930	136	212	90	3	76	0.0394737
NODE_2596_length_1421_cov_8.285930	136	212	92	1	76	0.0131579
NODE_2596_length_1421_cov_8.285930	136	212	96	1	76	0.0131579
NODE_2596_length_1421_cov_8.285930	136	212	101	1	76	0.0131579
NODE_2596_length_1421_cov_8.285930	136	212	105	1	76	0.0131579
NODE_2596_length_1421_cov_8.285930	136	212	106	1	76	0.0131579
NODE_2596_length_1421_cov_8.285930	136	212	108	1	76	0.0131579
NODE_2596_length_1421_cov_8.285930	136	212	111	1	76	0.0131579
NODE_2596_length_1421_cov_8.285930	136	212	112	6	76	0.0789474
NODE_2596_length_1421_cov_8.285930	136	212	115	2	76	0.0263158
NODE_2596_length_1421_cov_8.285930	136	212	116	3	76	0.0394737
NODE_2596_length_1421_cov_8.285930	136	212	117	2	76	0.0263158
NODE_2596_length_1421_cov_8.285930	136	212	119	3	76	0.0394737
NODE_2596_length_1421_cov_8.285930	136	212	121	1	76	0.0131579
NODE_2596_length_1421_cov_8.285930	136	212	122	1	76	0.0131579
NODE_2596_length_1421_cov_8.285930	136	212	128	1	76	0.0131579
NODE_2596_length_1421_cov_8.285930	136	212	138	1	76	0.0131579
NODE_2596_length_1421_cov_8.285930	136	212	140	1	76	0.0131579
NODE_2596_length_1421_cov_8.285930	136	212	143	1	76	0.0131579
NODE_2596_length_1421_cov_8.285930	136	212	146	1	76	0.0131579
NODE_2596_length_1421_cov_8.285930	136	212	150	1	76	0.0131579
NODE_2596_length_1421_cov_8.285930	136	212	153	1	76	0.0131579
NODE_2596_length_1421_cov_8.285930	136	212	155	1	76	0.0131579
NODE_2596_length_1421_cov_8.285930	136	212	161	1	76	0.0131579
NODE_2596_length_1421_cov_8.285930	136	212	165	2	76	0.0263158
NODE_2596_length_1421_cov_8.285930	136	212	167	2	76	0.0263158
NODE_2596_length_1421_cov_8.285930	136	212	171	1	76	0.0131579
NODE_2596_length_1421_cov_8.285930	136	212	173	2	76	0.0263158
NODE_2596_length_1421_cov_8.285930	136	212	177	1	76	0.0131579
NODE_2596_length_1421_cov_8.285930	136	212	178	2	76	0.0263158
NODE_2596_length_1421_cov_8.285930	136	212	186	1	76	0.0131579
NODE_2596_length_1421_cov_8.285930	136	212	187	1	76	0.0131579
NODE_2596_length_1421_cov_8.285930	136	212	193	3	76	0.0394737
NODE_2596_length_1421_cov_8.285930	136	212	194	1	76	0.0131579
NODE_2596_length_1421_cov_8.285930	136	212	195	1	76	0.0131579
NODE_2596_length_1421_cov_8.285930	136	212	196	3	76	0.0394737
NODE_2596_length_1421_cov_8.285930	136	212	198	2	76	0.0263158
NODE_2596_length_1421_cov_8.285930	136	212	199	1	76	0.0131579
NODE_2596_length_1421_cov_8.285930	136	212	200	3	76	0.0394737
NODE_2596_length_1421_cov_8.285930	136	212	201	5	76	0.0657895
NODE_2596_length_1421_cov_8.285930	136	212	203	5	76	0.0657895
NODE_2596_length_1421_cov_8.285930	136	212	205	2	76	0.0263158
NODE_2598_length_1421_cov_2.574130	22	102	2	3	80	0.0375000
NODE_2598_length_1421_cov_2.574130	22	102	4	6	80	0.0750000
NODE_2598_length_1421_cov_2.574130	22	102	6	5	80	0.0625000
NODE_2598_length_1421_cov_2.574130	22	102	8	3	80	0.0375000
NODE_2598_length_1421_cov_2.574130	22	102	10	63	80	0.7875000
NODE_2598_length_1421_cov_2.574130	75	132	4	25	57	0.4385965
NODE_2598_length_1421_cov_2.574130	75	132	6	1	57	0.0175439
NODE_2598_length_1421_cov_2.574130	75	132	8	3	57	0.0526316
NODE_2598_length_1421_cov_2.574130	75	132	10	28	57	0.4912281
NODE_2599_length_1420_cov_256.442846	60	140	0	30	80	0.3750000
NODE_2599_length_1420_cov_256.442846	60	140	4	20	80	0.2500000
NODE_2599_length_1420_cov_256.442846	60	140	6	6	80	0.0750000
NODE_2599_length_1420_cov_256.442846	60	140	8	5	80	0.0625000
NODE_2599_length_1420_cov_256.442846	60	140	15	1	80	0.0125000
NODE_2599_length_1420_cov_256.442846	60	140	16	18	80	0.2250000
NODE_2599_length_1420_cov_256.442846	1294	1360	7	14	66	0.2121212
NODE_2599_length_1420_cov_256.442846	1294	1360	9	12	66	0.1818182
NODE_2599_length_1420_cov_256.442846	1294	1360	10	38	66	0.5757576
NODE_2599_length_1420_cov_256.442846	1294	1360	17	1	66	0.0151515
NODE_2599_length_1420_cov_256.442846	1294	1360	19	1	66	0.0151515
NODE_2600_length_1420_cov_7.547313	628	708	0	55	80	0.6875000
NODE_2600_length_1420_cov_7.547313	628	708	2	25	80	0.3125000
NODE_2600_length_1420_cov_7.547313	681	761	0	2	80	0.0250000
NODE_2600_length_1420_cov_7.547313	681	761	2	78	80	0.9750000
NODE_2602_length_1420_cov_2.051476	972	1039	2	13	67	0.1940299
NODE_2602_length_1420_cov_2.051476	972	1039	4	54	67	0.8059701
NODE_2604_length_1419_cov_46.997727	1230	1305	2	75	75	1.0000000
NODE_2604_length_1419_cov_46.997727	1278	1332	0	2	54	0.0370370
NODE_2604_length_1419_cov_46.997727	1278	1332	2	52	54	0.9629630
NODE_2609_length_1418_cov_11.373010	432	512	0	10	80	0.1250000
NODE_2609_length_1418_cov_11.373010	432	512	2	70	80	0.8750000
NODE_2609_length_1418_cov_11.373010	485	556	0	41	71	0.5774648
NODE_2609_length_1418_cov_11.373010	485	556	2	30	71	0.4225352
NODE_2615_length_1417_cov_12.477997	354	399	0	45	45	1.0000000
NODE_2616_length_1417_cov_11.120637	794	874	0	80	80	1.0000000
NODE_2616_length_1417_cov_11.120637	847	927	0	80	80	1.0000000
NODE_2625_length_1415_cov_51.375380	423	503	0	80	80	1.0000000
NODE_2625_length_1415_cov_51.375380	476	556	0	80	80	1.0000000
NODE_2625_length_1415_cov_51.375380	552	632	0	80	80	1.0000000
NODE_2625_length_1415_cov_51.375380	605	683	0	78	78	1.0000000
NODE_2626_length_1415_cov_38.272036	513	593	0	22	80	0.2750000
NODE_2626_length_1415_cov_38.272036	513	593	4	58	80	0.7250000
NODE_2626_length_1415_cov_38.272036	566	646	2	24	80	0.3000000
NODE_2626_length_1415_cov_38.272036	566	646	4	56	80	0.7000000
NODE_2627_length_1415_cov_17.232523	642	722	0	10	80	0.1250000
NODE_2627_length_1415_cov_17.232523	642	722	2	3	80	0.0375000
NODE_2627_length_1415_cov_17.232523	642	722	3	36	80	0.4500000
NODE_2627_length_1415_cov_17.232523	642	722	4	31	80	0.3875000
NODE_2627_length_1415_cov_17.232523	695	775	2	39	80	0.4875000
NODE_2627_length_1415_cov_17.232523	695	775	4	41	80	0.5125000
NODE_2629_length_1414_cov_5.307985	1026	1106	4	80	80	1.0000000
NODE_2629_length_1414_cov_5.307985	1079	1159	0	26	80	0.3250000
NODE_2629_length_1414_cov_5.307985	1079	1159	4	54	80	0.6750000
NODE_2637_length_1412_cov_17.723534	875	955	2	10	80	0.1250000
NODE_2637_length_1412_cov_17.723534	875	955	4	10	80	0.1250000
NODE_2637_length_1412_cov_17.723534	875	955	8	60	80	0.7500000
NODE_2637_length_1412_cov_17.723534	928	1008	0	9	80	0.1125000
NODE_2637_length_1412_cov_17.723534	928	1008	4	31	80	0.3875000
NODE_2637_length_1412_cov_17.723534	928	1008	6	3	80	0.0375000
NODE_2637_length_1412_cov_17.723534	928	1008	8	37	80	0.4625000
NODE_2641_length_1411_cov_34.004573	516	596	0	80	80	1.0000000
NODE_2641_length_1411_cov_34.004573	569	649	0	80	80	1.0000000
NODE_2641_length_1411_cov_34.004573	645	725	0	80	80	1.0000000
NODE_2641_length_1411_cov_34.004573	698	778	0	80	80	1.0000000
NODE_2643_length_1409_cov_25.380153	828	908	1	21	80	0.2625000
NODE_2643_length_1409_cov_25.380153	828	908	2	4	80	0.0500000
NODE_2643_length_1409_cov_25.380153	828	908	3	55	80	0.6875000
NODE_2643_length_1409_cov_25.380153	881	961	1	21	80	0.2625000
NODE_2643_length_1409_cov_25.380153	881	961	3	8	80	0.1000000
NODE_2643_length_1409_cov_25.380153	881	961	5	5	80	0.0625000
NODE_2643_length_1409_cov_25.380153	881	961	7	39	80	0.4875000
NODE_2643_length_1409_cov_25.380153	881	961	8	7	80	0.0875000
NODE_2644_length_1409_cov_13.028244	349	405	4	56	56	1.0000000
NODE_2644_length_1409_cov_13.028244	416	482	0	48	66	0.7272727
NODE_2644_length_1409_cov_13.028244	416	482	1	18	66	0.2727273
NODE_2648_length_1408_cov_6.261268	492	572	0	80	80	1.0000000
NODE_2648_length_1408_cov_6.261268	545	625	0	42	80	0.5250000
NODE_2648_length_1408_cov_6.261268	545	625	2	38	80	0.4750000
NODE_2652_length_1407_cov_27.711009	772	852	23	37	80	0.4625000
NODE_2652_length_1407_cov_27.711009	772	852	25	40	80	0.5000000
NODE_2652_length_1407_cov_27.711009	772	852	26	3	80	0.0375000
NODE_2652_length_1407_cov_27.711009	825	905	0	2	80	0.0250000
NODE_2652_length_1407_cov_27.711009	825	905	4	2	80	0.0250000
NODE_2652_length_1407_cov_27.711009	825	905	6	4	80	0.0500000
NODE_2652_length_1407_cov_27.711009	825	905	16	17	80	0.2125000
NODE_2652_length_1407_cov_27.711009	825	905	24	3	80	0.0375000
NODE_2652_length_1407_cov_27.711009	825	905	25	49	80	0.6125000
NODE_2652_length_1407_cov_27.711009	825	905	26	3	80	0.0375000
NODE_2653_length_1407_cov_24.387615	586	666	2	70	80	0.8750000
NODE_2653_length_1407_cov_24.387615	586	666	4	10	80	0.1250000
NODE_2653_length_1407_cov_24.387615	639	719	2	70	80	0.8750000
NODE_2653_length_1407_cov_24.387615	639	719	4	10	80	0.1250000
NODE_2653_length_1407_cov_24.387615	715	795	2	74	80	0.9250000
NODE_2653_length_1407_cov_24.387615	715	795	4	6	80	0.0750000
NODE_2653_length_1407_cov_24.387615	768	848	0	39	80	0.4875000
NODE_2653_length_1407_cov_24.387615	768	848	2	41	80	0.5125000
NODE_2654_length_1407_cov_19.022936	551	629	2	1	78	0.0128205
NODE_2654_length_1407_cov_19.022936	551	629	4	9	78	0.1153846
NODE_2654_length_1407_cov_19.022936	551	629	24	12	78	0.1538462
NODE_2654_length_1407_cov_19.022936	551	629	28	56	78	0.7179487
NODE_2654_length_1407_cov_19.022936	602	665	2	29	63	0.4603175
NODE_2654_length_1407_cov_19.022936	602	665	4	17	63	0.2698413
NODE_2654_length_1407_cov_19.022936	602	665	24	12	63	0.1904762
NODE_2654_length_1407_cov_19.022936	602	665	28	5	63	0.0793651
NODE_2655_length_1407_cov_11.266820	813	893	0	80	80	1.0000000
NODE_2655_length_1407_cov_11.266820	866	946	0	53	80	0.6625000
NODE_2655_length_1407_cov_11.266820	866	946	4	27	80	0.3375000
NODE_2655_length_1407_cov_11.266820	942	1022	0	10	80	0.1250000
NODE_2655_length_1407_cov_11.266820	942	1022	4	70	80	0.8750000
NODE_2655_length_1407_cov_11.266820	995	1075	0	63	80	0.7875000
NODE_2655_length_1407_cov_11.266820	995	1075	4	17	80	0.2125000
NODE_2657_length_1406_cov_7.247896	761	841	2	28	80	0.3500000
NODE_2657_length_1406_cov_7.247896	761	841	6	52	80	0.6500000
NODE_2657_length_1406_cov_7.247896	814	894	1	19	80	0.2375000
NODE_2657_length_1406_cov_7.247896	814	894	5	12	80	0.1500000
NODE_2657_length_1406_cov_7.247896	814	894	6	49	80	0.6125000
NODE_2659_length_1404_cov_23.406130	826	906	0	80	80	1.0000000
NODE_2659_length_1404_cov_23.406130	879	959	0	80	80	1.0000000
NODE_2659_length_1404_cov_23.406130	955	1035	0	80	80	1.0000000
NODE_2659_length_1404_cov_23.406130	1008	1088	0	80	80	1.0000000
NODE_2666_length_1403_cov_14.331288	325	405	0	80	80	1.0000000
NODE_2666_length_1403_cov_14.331288	378	458	0	80	80	1.0000000
NODE_2666_length_1403_cov_14.331288	454	534	0	57	80	0.7125000
NODE_2666_length_1403_cov_14.331288	454	534	1	15	80	0.1875000
NODE_2666_length_1403_cov_14.331288	454	534	2	8	80	0.1000000
NODE_2666_length_1403_cov_14.331288	454	534	0	57	80	0.7125000
NODE_2666_length_1403_cov_14.331288	454	534	1	15	80	0.1875000
NODE_2666_length_1403_cov_14.331288	454	534	2	8	80	0.1000000
NODE_2666_length_1403_cov_14.331288	454	524	0	57	70	0.8142857
NODE_2666_length_1403_cov_14.331288	454	524	1	13	70	0.1857143
NODE_2666_length_1403_cov_14.331288	507	587	0	4	80	0.0500000
NODE_2666_length_1403_cov_14.331288	507	587	1	15	80	0.1875000
NODE_2666_length_1403_cov_14.331288	507	587	2	61	80	0.7625000
NODE_2666_length_1403_cov_14.331288	507	579	0	4	72	0.0555556
NODE_2666_length_1403_cov_14.331288	507	579	1	15	72	0.2083333
NODE_2666_length_1403_cov_14.331288	507	579	2	53	72	0.7361111
NODE_2668_length_1402_cov_29.095165	610	690	0	80	80	1.0000000
NODE_2668_length_1402_cov_29.095165	663	743	0	80	80	1.0000000
NODE_2669_length_1402_cov_23.411358	528	608	4	60	80	0.7500000
NODE_2669_length_1402_cov_23.411358	528	608	6	20	80	0.2500000
NODE_2669_length_1402_cov_23.411358	581	661	0	4	80	0.0500000
NODE_2669_length_1402_cov_23.411358	581	661	2	10	80	0.1250000
NODE_2669_length_1402_cov_23.411358	581	661	4	58	80	0.7250000
NODE_2669_length_1402_cov_23.411358	581	661	6	8	80	0.1000000
NODE_2669_length_1402_cov_23.411358	657	737	0	28	80	0.3500000
NODE_2669_length_1402_cov_23.411358	657	737	2	52	80	0.6500000
NODE_2669_length_1402_cov_23.411358	710	790	0	1	80	0.0125000
NODE_2669_length_1402_cov_23.411358	710	790	2	79	80	0.9875000
NODE_2670_length_1402_cov_11.732924	661	741	0	59	80	0.7375000
NODE_2670_length_1402_cov_11.732924	661	741	2	1	80	0.0125000
NODE_2670_length_1402_cov_11.732924	661	741	3	20	80	0.2500000
NODE_2670_length_1402_cov_11.732924	714	794	0	6	80	0.0750000
NODE_2670_length_1402_cov_11.732924	714	794	2	1	80	0.0125000
NODE_2670_length_1402_cov_11.732924	714	794	3	31	80	0.3875000
NODE_2670_length_1402_cov_11.732924	714	794	4	42	80	0.5250000
NODE_2671_length_1402_cov_9.929394	766	846	2	26	80	0.3250000
NODE_2671_length_1402_cov_9.929394	766	846	4	54	80	0.6750000
NODE_2671_length_1402_cov_9.929394	819	899	2	30	80	0.3750000
NODE_2671_length_1402_cov_9.929394	819	899	4	50	80	0.6250000
NODE_2677_length_1401_cov_35.754992	825	905	2	22	80	0.2750000
NODE_2677_length_1401_cov_35.754992	825	905	6	31	80	0.3875000
NODE_2677_length_1401_cov_35.754992	825	905	10	12	80	0.1500000
NODE_2677_length_1401_cov_35.754992	825	905	12	15	80	0.1875000
NODE_2677_length_1401_cov_35.754992	878	958	10	62	80	0.7750000
NODE_2677_length_1401_cov_35.754992	878	958	12	18	80	0.2250000
NODE_2678_length_1401_cov_10.811828	539	619	0	53	80	0.6625000
NODE_2678_length_1401_cov_10.811828	539	619	2	27	80	0.3375000
NODE_2678_length_1401_cov_10.811828	592	672	2	40	80	0.5000000
NODE_2678_length_1401_cov_10.811828	592	672	4	24	80	0.3000000
NODE_2678_length_1401_cov_10.811828	592	672	6	16	80	0.2000000
NODE_2679_length_1401_cov_5.438556	241	321	2	28	80	0.3500000
NODE_2679_length_1401_cov_5.438556	241	321	4	17	80	0.2125000
NODE_2679_length_1401_cov_5.438556	241	321	6	35	80	0.4375000
NODE_2679_length_1401_cov_5.438556	294	374	0	3	80	0.0375000
NODE_2679_length_1401_cov_5.438556	294	374	2	77	80	0.9625000
NODE_2683_length_1400_cov_16.680246	813	893	0	80	80	1.0000000
NODE_2683_length_1400_cov_16.680246	866	946	0	80	80	1.0000000
NODE_2684_length_1400_cov_8.166795	53	133	8	30	80	0.3750000
NODE_2684_length_1400_cov_8.166795	53	133	11	41	80	0.5125000
NODE_2684_length_1400_cov_8.166795	53	133	12	9	80	0.1125000
NODE_2684_length_1400_cov_8.166795	106	186	0	25	80	0.3125000
NODE_2684_length_1400_cov_8.166795	106	186	2	3	80	0.0375000
NODE_2684_length_1400_cov_8.166795	106	186	6	8	80	0.1000000
NODE_2684_length_1400_cov_8.166795	106	186	11	44	80	0.5500000
NODE_2694_length_1397_cov_25.549307	869	918	2	33	49	0.6734694
NODE_2694_length_1397_cov_25.549307	869	918	4	16	49	0.3265306
NODE_2694_length_1397_cov_25.549307	891	971	2	48	80	0.6000000
NODE_2694_length_1397_cov_25.549307	891	971	4	32	80	0.4000000
NODE_2695_length_1397_cov_14.395223	672	752	0	31	80	0.3875000
NODE_2695_length_1397_cov_14.395223	672	752	7	6	80	0.0750000
NODE_2695_length_1397_cov_14.395223	672	752	9	23	80	0.2875000
NODE_2695_length_1397_cov_14.395223	672	752	10	20	80	0.2500000
NODE_2695_length_1397_cov_14.395223	725	805	7	9	80	0.1125000
NODE_2695_length_1397_cov_14.395223	725	805	8	19	80	0.2375000
NODE_2695_length_1397_cov_14.395223	725	805	9	7	80	0.0875000
NODE_2695_length_1397_cov_14.395223	725	805	10	45	80	0.5625000
NODE_2695_length_1397_cov_14.395223	801	881	0	69	80	0.8625000
NODE_2695_length_1397_cov_14.395223	801	881	7	11	80	0.1375000
NODE_2695_length_1397_cov_14.395223	854	934	0	80	80	1.0000000
NODE_2699_length_1396_cov_21.656130	825	905	0	4	80	0.0500000
NODE_2699_length_1396_cov_21.656130	825	905	12	17	80	0.2125000
NODE_2699_length_1396_cov_21.656130	825	905	14	59	80	0.7375000
NODE_2699_length_1396_cov_21.656130	878	958	0	57	80	0.7125000
NODE_2699_length_1396_cov_21.656130	878	958	12	17	80	0.2125000
NODE_2699_length_1396_cov_21.656130	878	958	14	6	80	0.0750000
NODE_2700_length_1396_cov_18.108712	560	640	0	80	80	1.0000000
NODE_2700_length_1396_cov_18.108712	613	693	0	80	80	1.0000000
NODE_2701_length_1396_cov_16.208944	136	198	2	8	62	0.1290323
NODE_2701_length_1396_cov_16.208944	136	198	3	8	62	0.1290323
NODE_2701_length_1396_cov_16.208944	136	198	4	3	62	0.0483871
NODE_2701_length_1396_cov_16.208944	136	198	5	4	62	0.0645161
NODE_2701_length_1396_cov_16.208944	136	198	7	6	62	0.0967742
NODE_2701_length_1396_cov_16.208944	136	198	8	3	62	0.0483871
NODE_2701_length_1396_cov_16.208944	136	198	12	2	62	0.0322581
NODE_2701_length_1396_cov_16.208944	136	198	14	4	62	0.0645161
NODE_2701_length_1396_cov_16.208944	136	198	18	8	62	0.1290323
NODE_2701_length_1396_cov_16.208944	136	198	22	14	62	0.2258064
NODE_2701_length_1396_cov_16.208944	136	198	23	2	62	0.0322581
NODE_2701_length_1396_cov_16.208944	848	928	0	80	80	1.0000000
NODE_2701_length_1396_cov_16.208944	901	981	0	80	80	1.0000000
NODE_2701_length_1396_cov_16.208944	977	1057	0	80	80	1.0000000
NODE_2701_length_1396_cov_16.208944	1030	1110	0	80	80	1.0000000
NODE_2702_length_1396_cov_9.196608	428	508	0	80	80	1.0000000
NODE_2702_length_1396_cov_9.196608	481	561	0	80	80	1.0000000
NODE_2712_length_1394_cov_29.602317	349	415	0	42	66	0.6363636
NODE_2712_length_1394_cov_29.602317	349	415	2	10	66	0.1515152
NODE_2712_length_1394_cov_29.602317	349	415	4	4	66	0.0606061
NODE_2712_length_1394_cov_29.602317	349	415	5	10	66	0.1515152
NODE_2712_length_1394_cov_29.602317	349	416	0	43	67	0.6417910
NODE_2712_length_1394_cov_29.602317	349	416	2	10	67	0.1492537
NODE_2712_length_1394_cov_29.602317	349	416	4	4	67	0.0597015
NODE_2712_length_1394_cov_29.602317	349	416	5	10	67	0.1492537
NODE_2712_length_1394_cov_29.602317	1117	1197	2	5	80	0.0625000
NODE_2712_length_1394_cov_29.602317	1117	1197	4	47	80	0.5875000
NODE_2712_length_1394_cov_29.602317	1117	1197	6	19	80	0.2375000
NODE_2712_length_1394_cov_29.602317	1117	1197	8	9	80	0.1125000
NODE_2712_length_1394_cov_29.602317	1170	1250	4	22	80	0.2750000
NODE_2712_length_1394_cov_29.602317	1170	1250	6	49	80	0.6125000
NODE_2712_length_1394_cov_29.602317	1170	1250	8	9	80	0.1125000
NODE_2713_length_1394_cov_6.291892	313	393	0	77	80	0.9625000
NODE_2713_length_1394_cov_6.291892	313	393	2	3	80	0.0375000
NODE_2713_length_1394_cov_6.291892	366	446	0	24	80	0.3000000
NODE_2713_length_1394_cov_6.291892	366	446	2	56	80	0.7000000
NODE_2716_length_1393_cov_14.635240	1286	1339	6	1	53	0.0188679
NODE_2716_length_1393_cov_14.635240	1286	1339	10	1	53	0.0188679
NODE_2716_length_1393_cov_14.635240	1286	1339	12	51	53	0.9622642
NODE_2717_length_1393_cov_12.032457	737	817	0	2	80	0.0250000
NODE_2717_length_1393_cov_12.032457	737	817	4	21	80	0.2625000
NODE_2717_length_1393_cov_12.032457	737	817	6	57	80	0.7125000
NODE_2717_length_1393_cov_12.032457	790	870	2	32	80	0.4000000
NODE_2717_length_1393_cov_12.032457	790	870	4	8	80	0.1000000
NODE_2717_length_1393_cov_12.032457	790	870	6	40	80	0.5000000
NODE_2720_length_1392_cov_5.898685	270	350	0	80	80	1.0000000
NODE_2720_length_1392_cov_5.898685	323	399	0	76	76	1.0000000
NODE_2723_length_1391_cov_35.921827	415	495	0	4	80	0.0500000
NODE_2723_length_1391_cov_35.921827	415	495	2	76	80	0.9500000
NODE_2723_length_1391_cov_35.921827	468	548	0	57	80	0.7125000
NODE_2723_length_1391_cov_35.921827	468	548	2	23	80	0.2875000
NODE_2723_length_1391_cov_35.921827	544	624	0	80	80	1.0000000
NODE_2723_length_1391_cov_35.921827	597	677	0	80	80	1.0000000
NODE_2729_length_1390_cov_16.326878	550	630	0	3	80	0.0375000
NODE_2729_length_1390_cov_16.326878	550	630	2	65	80	0.8125000
NODE_2729_length_1390_cov_16.326878	550	630	4	12	80	0.1500000
NODE_2729_length_1390_cov_16.326878	603	683	2	49	80	0.6125000
NODE_2729_length_1390_cov_16.326878	603	683	4	31	80	0.3875000
NODE_2731_length_1389_cov_29.772093	780	860	0	25	80	0.3125000
NODE_2731_length_1389_cov_29.772093	780	860	2	1	80	0.0125000
NODE_2731_length_1389_cov_29.772093	780	860	4	2	80	0.0250000
NODE_2731_length_1389_cov_29.772093	780	860	6	52	80	0.6500000
NODE_2731_length_1389_cov_29.772093	833	913	0	71	80	0.8875000
NODE_2731_length_1389_cov_29.772093	833	913	2	8	80	0.1000000
NODE_2731_length_1389_cov_29.772093	833	913	4	1	80	0.0125000
NODE_2732_length_1389_cov_12.858140	821	901	0	16	80	0.2000000
NODE_2732_length_1389_cov_12.858140	821	901	6	5	80	0.0625000
NODE_2732_length_1389_cov_12.858140	821	901	10	59	80	0.7375000
NODE_2732_length_1389_cov_12.858140	874	954	0	69	80	0.8625000
NODE_2732_length_1389_cov_12.858140	874	954	6	5	80	0.0625000
NODE_2732_length_1389_cov_12.858140	874	954	10	6	80	0.0750000
NODE_2735_length_1388_cov_14.641583	529	610	0	81	81	1.0000000
NODE_2735_length_1388_cov_14.641583	583	660	0	40	77	0.5194805
NODE_2735_length_1388_cov_14.641583	583	660	2	37	77	0.4805195
NODE_2736_length_1388_cov_5.168348	427	499	50	3	72	0.0416667
NODE_2736_length_1388_cov_5.168348	427	499	51	2	72	0.0277778
NODE_2736_length_1388_cov_5.168348	427	499	52	15	72	0.2083333
NODE_2736_length_1388_cov_5.168348	427	499	54	12	72	0.1666667
NODE_2736_length_1388_cov_5.168348	427	499	55	5	72	0.0694444
NODE_2736_length_1388_cov_5.168348	427	499	56	6	72	0.0833333
NODE_2736_length_1388_cov_5.168348	427	499	57	5	72	0.0694444
NODE_2736_length_1388_cov_5.168348	427	499	58	3	72	0.0416667
NODE_2736_length_1388_cov_5.168348	427	499	59	4	72	0.0555556
NODE_2736_length_1388_cov_5.168348	427	499	61	10	72	0.1388889
NODE_2736_length_1388_cov_5.168348	427	499	63	2	72	0.0277778
NODE_2736_length_1388_cov_5.168348	427	499	65	5	72	0.0694444
NODE_2742_length_1386_cov_55.384615	559	639	9	4	80	0.0500000
NODE_2742_length_1386_cov_55.384615	559	639	10	6	80	0.0750000
NODE_2742_length_1386_cov_55.384615	559	639	14	70	80	0.8750000
NODE_2742_length_1386_cov_55.384615	612	692	10	59	80	0.7375000
NODE_2742_length_1386_cov_55.384615	612	692	14	21	80	0.2625000
NODE_2742_length_1386_cov_55.384615	688	768	0	2	80	0.0250000
NODE_2742_length_1386_cov_55.384615	688	768	2	36	80	0.4500000
NODE_2742_length_1386_cov_55.384615	688	768	5	7	80	0.0875000
NODE_2742_length_1386_cov_55.384615	688	768	6	15	80	0.1875000
NODE_2742_length_1386_cov_55.384615	688	768	9	9	80	0.1125000
NODE_2742_length_1386_cov_55.384615	688	768	10	11	80	0.1375000
NODE_2742_length_1386_cov_55.384615	741	821	2	12	80	0.1500000
NODE_2742_length_1386_cov_55.384615	741	821	4	3	80	0.0375000
NODE_2742_length_1386_cov_55.384615	741	821	6	65	80	0.8125000
NODE_2744_length_1386_cov_13.181041	549	629	2	39	80	0.4875000
NODE_2744_length_1386_cov_13.181041	549	629	4	11	80	0.1375000
NODE_2744_length_1386_cov_13.181041	549	629	6	30	80	0.3750000
NODE_2744_length_1386_cov_13.181041	602	682	0	49	80	0.6125000
NODE_2744_length_1386_cov_13.181041	602	682	2	31	80	0.3875000
NODE_2748_length_1385_cov_41.636081	968	1048	0	39	80	0.4875000
NODE_2748_length_1385_cov_41.636081	968	1048	2	1	80	0.0125000
NODE_2748_length_1385_cov_41.636081	968	1048	6	40	80	0.5000000
NODE_2748_length_1385_cov_41.636081	1021	1101	2	3	80	0.0375000
NODE_2748_length_1385_cov_41.636081	1021	1101	6	77	80	0.9625000
NODE_2749_length_1385_cov_38.877138	707	787	0	80	80	1.0000000
NODE_2749_length_1385_cov_38.877138	760	840	0	80	80	1.0000000
NODE_2749_length_1385_cov_38.877138	836	916	0	43	80	0.5375000
NODE_2749_length_1385_cov_38.877138	836	916	2	37	80	0.4625000
NODE_2749_length_1385_cov_38.877138	889	969	0	3	80	0.0375000
NODE_2749_length_1385_cov_38.877138	889	969	2	77	80	0.9625000
NODE_2751_length_1385_cov_4.608865	844	904	0	2	60	0.0333333
NODE_2751_length_1385_cov_4.608865	844	904	1	5	60	0.0833333
NODE_2751_length_1385_cov_4.608865	844	904	2	1	60	0.0166667
NODE_2751_length_1385_cov_4.608865	844	904	3	52	60	0.8666667
NODE_2758_length_1384_cov_10.574319	865	922	0	57	57	1.0000000
NODE_2758_length_1384_cov_10.574319	933	1013	0	72	80	0.9000000
NODE_2758_length_1384_cov_10.574319	933	1013	2	8	80	0.1000000
NODE_2758_length_1384_cov_10.574319	986	1066	0	19	80	0.2375000
NODE_2758_length_1384_cov_10.574319	986	1066	2	9	80	0.1125000
NODE_2758_length_1384_cov_10.574319	986	1066	4	52	80	0.6500000
NODE_2759_length_1383_cov_10.710280	414	493	2	79	79	1.0000000
NODE_2759_length_1383_cov_10.710280	466	546	0	24	80	0.3000000
NODE_2759_length_1383_cov_10.710280	466	546	1	5	80	0.0625000
NODE_2759_length_1383_cov_10.710280	466	546	2	51	80	0.6375000
NODE_2763_length_1382_cov_12.521434	837	917	0	80	80	1.0000000
NODE_2763_length_1382_cov_12.521434	890	970	0	80	80	1.0000000
NODE_2764_length_1382_cov_5.074045	1028	1108	0	80	80	1.0000000
NODE_2764_length_1382_cov_5.074045	1081	1161	0	80	80	1.0000000
NODE_2771_length_1381_cov_7.796412	307	387	0	80	80	1.0000000
NODE_2771_length_1381_cov_7.796412	360	440	0	80	80	1.0000000
NODE_2775_length_1380_cov_12.804059	835	915	2	15	80	0.1875000
NODE_2775_length_1380_cov_12.804059	835	915	4	8	80	0.1000000
NODE_2775_length_1380_cov_12.804059	835	915	5	12	80	0.1500000
NODE_2775_length_1380_cov_12.804059	835	915	6	45	80	0.5625000
NODE_2775_length_1380_cov_12.804059	888	968	4	61	80	0.7625000
NODE_2775_length_1380_cov_12.804059	888	968	5	12	80	0.1500000
NODE_2775_length_1380_cov_12.804059	888	968	6	7	80	0.0875000
NODE_2782_length_1378_cov_25.362002	368	448	2	3	80	0.0375000
NODE_2782_length_1378_cov_25.362002	368	448	4	77	80	0.9625000
NODE_2782_length_1378_cov_25.362002	421	501	0	53	80	0.6625000
NODE_2782_length_1378_cov_25.362002	421	501	2	2	80	0.0250000
NODE_2782_length_1378_cov_25.362002	421	501	4	25	80	0.3125000
NODE_2782_length_1378_cov_25.362002	497	577	0	80	80	1.0000000
NODE_2782_length_1378_cov_25.362002	550	630	0	46	80	0.5750000
NODE_2782_length_1378_cov_25.362002	550	630	2	12	80	0.1500000
NODE_2782_length_1378_cov_25.362002	550	630	4	22	80	0.2750000
NODE_2783_length_1378_cov_20.508210	318	338	20	4	20	0.2000000
NODE_2783_length_1378_cov_20.508210	318	338	23	1	20	0.0500000
NODE_2783_length_1378_cov_20.508210	318	338	26	2	20	0.1000000
NODE_2783_length_1378_cov_20.508210	318	338	32	5	20	0.2500000
NODE_2783_length_1378_cov_20.508210	318	338	34	4	20	0.2000000
NODE_2783_length_1378_cov_20.508210	318	338	37	4	20	0.2000000
NODE_2783_length_1378_cov_20.508210	318	391	20	4	73	0.0547945
NODE_2783_length_1378_cov_20.508210	318	391	23	1	73	0.0136986
NODE_2783_length_1378_cov_20.508210	318	391	26	2	73	0.0273973
NODE_2783_length_1378_cov_20.508210	318	391	32	5	73	0.0684932
NODE_2783_length_1378_cov_20.508210	318	391	34	4	73	0.0547945
NODE_2783_length_1378_cov_20.508210	318	391	37	10	73	0.1369863
NODE_2783_length_1378_cov_20.508210	318	391	38	2	73	0.0273973
NODE_2783_length_1378_cov_20.508210	318	391	42	1	73	0.0136986
NODE_2783_length_1378_cov_20.508210	318	391	43	5	73	0.0684932
NODE_2783_length_1378_cov_20.508210	318	391	45	9	73	0.1232877
NODE_2783_length_1378_cov_20.508210	318	391	47	1	73	0.0136986
NODE_2783_length_1378_cov_20.508210	318	391	49	4	73	0.0547945
NODE_2783_length_1378_cov_20.508210	318	391	51	1	73	0.0136986
NODE_2783_length_1378_cov_20.508210	318	391	55	1	73	0.0136986
NODE_2783_length_1378_cov_20.508210	318	391	57	2	73	0.0273973
NODE_2783_length_1378_cov_20.508210	318	391	59	4	73	0.0547945
NODE_2783_length_1378_cov_20.508210	318	391	62	1	73	0.0136986
NODE_2783_length_1378_cov_20.508210	318	391	63	7	73	0.0958904
NODE_2783_length_1378_cov_20.508210	318	391	68	1	73	0.0136986
NODE_2783_length_1378_cov_20.508210	318	391	69	1	73	0.0136986
NODE_2783_length_1378_cov_20.508210	318	391	72	1	73	0.0136986
NODE_2783_length_1378_cov_20.508210	318	391	73	4	73	0.0547945
NODE_2783_length_1378_cov_20.508210	318	391	75	1	73	0.0136986
NODE_2783_length_1378_cov_20.508210	318	391	77	1	73	0.0136986
NODE_2785_length_1377_cov_103.832551	1259	1299	137	7	40	0.1750000
NODE_2785_length_1377_cov_103.832551	1259	1299	139	2	40	0.0500000
NODE_2785_length_1377_cov_103.832551	1259	1299	142	1	40	0.0250000
NODE_2785_length_1377_cov_103.832551	1259	1299	143	3	40	0.0750000
NODE_2785_length_1377_cov_103.832551	1259	1299	144	1	40	0.0250000
NODE_2785_length_1377_cov_103.832551	1259	1299	148	2	40	0.0500000
NODE_2785_length_1377_cov_103.832551	1259	1299	150	1	40	0.0250000
NODE_2785_length_1377_cov_103.832551	1259	1299	162	1	40	0.0250000
NODE_2785_length_1377_cov_103.832551	1259	1299	165	1	40	0.0250000
NODE_2785_length_1377_cov_103.832551	1259	1299	166	1	40	0.0250000
NODE_2785_length_1377_cov_103.832551	1259	1299	171	1	40	0.0250000
NODE_2785_length_1377_cov_103.832551	1259	1299	172	1	40	0.0250000
NODE_2785_length_1377_cov_103.832551	1259	1299	174	2	40	0.0500000
NODE_2785_length_1377_cov_103.832551	1259	1299	177	1	40	0.0250000
NODE_2785_length_1377_cov_103.832551	1259	1299	178	1	40	0.0250000
NODE_2785_length_1377_cov_103.832551	1259	1299	179	1	40	0.0250000
NODE_2785_length_1377_cov_103.832551	1259	1299	180	1	40	0.0250000
NODE_2785_length_1377_cov_103.832551	1259	1299	181	4	40	0.1000000
NODE_2785_length_1377_cov_103.832551	1259	1299	182	1	40	0.0250000
NODE_2785_length_1377_cov_103.832551	1259	1299	184	1	40	0.0250000
NODE_2785_length_1377_cov_103.832551	1259	1299	186	1	40	0.0250000
NODE_2785_length_1377_cov_103.832551	1259	1299	187	3	40	0.0750000
NODE_2785_length_1377_cov_103.832551	1259	1299	189	1	40	0.0250000
NODE_2785_length_1377_cov_103.832551	1259	1299	191	1	40	0.0250000
NODE_2788_length_1376_cov_7.967110	904	984	0	36	80	0.4500000
NODE_2788_length_1376_cov_7.967110	904	984	4	44	80	0.5500000
NODE_2788_length_1376_cov_7.967110	957	1037	0	9	80	0.1125000
NODE_2788_length_1376_cov_7.967110	957	1037	4	71	80	0.8875000
NODE_2798_length_1373_cov_52.691523	524	606	6	16	82	0.1951219
NODE_2798_length_1373_cov_52.691523	524	606	8	19	82	0.2317073
NODE_2798_length_1373_cov_52.691523	524	606	14	1	82	0.0121951
NODE_2798_length_1373_cov_52.691523	524	606	16	1	82	0.0121951
NODE_2798_length_1373_cov_52.691523	524	606	17	9	82	0.1097561
NODE_2798_length_1373_cov_52.691523	524	606	33	25	82	0.3048781
NODE_2798_length_1373_cov_52.691523	524	606	39	11	82	0.1341463
NODE_2798_length_1373_cov_52.691523	579	659	0	4	80	0.0500000
NODE_2798_length_1373_cov_52.691523	579	659	12	7	80	0.0875000
NODE_2798_length_1373_cov_52.691523	579	659	33	27	80	0.3375000
NODE_2798_length_1373_cov_52.691523	579	659	34	40	80	0.5000000
NODE_2798_length_1373_cov_52.691523	579	659	39	2	80	0.0250000
NODE_2799_length_1373_cov_20.880691	987	1067	0	4	80	0.0500000
NODE_2799_length_1373_cov_20.880691	987	1067	2	32	80	0.4000000
NODE_2799_length_1373_cov_20.880691	987	1067	4	19	80	0.2375000
NODE_2799_length_1373_cov_20.880691	987	1067	6	25	80	0.3125000
NODE_2799_length_1373_cov_20.880691	1116	1195	8	14	79	0.1772152
NODE_2799_length_1373_cov_20.880691	1116	1195	12	1	79	0.0126582
NODE_2799_length_1373_cov_20.880691	1116	1195	14	10	79	0.1265823
NODE_2799_length_1373_cov_20.880691	1116	1195	17	1	79	0.0126582
NODE_2799_length_1373_cov_20.880691	1116	1195	24	30	79	0.3797468
NODE_2799_length_1373_cov_20.880691	1116	1195	26	23	79	0.2911392
NODE_2799_length_1373_cov_20.880691	1168	1248	0	3	80	0.0375000
NODE_2799_length_1373_cov_20.880691	1168	1248	2	6	80	0.0750000
NODE_2799_length_1373_cov_20.880691	1168	1248	12	2	80	0.0250000
NODE_2799_length_1373_cov_20.880691	1168	1248	14	7	80	0.0875000
NODE_2799_length_1373_cov_20.880691	1168	1248	16	1	80	0.0125000
NODE_2799_length_1373_cov_20.880691	1168	1248	20	4	80	0.0500000
NODE_2799_length_1373_cov_20.880691	1168	1248	22	30	80	0.3750000
NODE_2799_length_1373_cov_20.880691	1168	1248	24	16	80	0.2000000
NODE_2799_length_1373_cov_20.880691	1168	1248	26	11	80	0.1375000
NODE_2800_length_1373_cov_12.694662	94	167	25	10	73	0.1369863
NODE_2800_length_1373_cov_12.694662	94	167	27	3	73	0.0410959
NODE_2800_length_1373_cov_12.694662	94	167	29	11	73	0.1506849
NODE_2800_length_1373_cov_12.694662	94	167	31	9	73	0.1232877
NODE_2800_length_1373_cov_12.694662	94	167	33	1	73	0.0136986
NODE_2800_length_1373_cov_12.694662	94	167	35	2	73	0.0273973
NODE_2800_length_1373_cov_12.694662	94	167	36	1	73	0.0136986
NODE_2800_length_1373_cov_12.694662	94	167	37	9	73	0.1232877
NODE_2800_length_1373_cov_12.694662	94	167	39	7	73	0.0958904
NODE_2800_length_1373_cov_12.694662	94	167	40	1	73	0.0136986
NODE_2800_length_1373_cov_12.694662	94	167	41	2	73	0.0273973
NODE_2800_length_1373_cov_12.694662	94	167	42	1	73	0.0136986
NODE_2800_length_1373_cov_12.694662	94	167	46	5	73	0.0684932
NODE_2800_length_1373_cov_12.694662	94	167	49	1	73	0.0136986
NODE_2800_length_1373_cov_12.694662	94	167	51	4	73	0.0547945
NODE_2800_length_1373_cov_12.694662	94	167	53	3	73	0.0410959
NODE_2800_length_1373_cov_12.694662	94	167	54	3	73	0.0410959
NODE_2800_length_1373_cov_12.694662	140	224	36	1	84	0.0119048
NODE_2800_length_1373_cov_12.694662	140	224	37	3	84	0.0357143
NODE_2800_length_1373_cov_12.694662	140	224	39	3	84	0.0357143
NODE_2800_length_1373_cov_12.694662	140	224	40	1	84	0.0119048
NODE_2800_length_1373_cov_12.694662	140	224	41	2	84	0.0238095
NODE_2800_length_1373_cov_12.694662	140	224	42	1	84	0.0119048
NODE_2800_length_1373_cov_12.694662	140	224	46	5	84	0.0595238
NODE_2800_length_1373_cov_12.694662	140	224	49	1	84	0.0119048
NODE_2800_length_1373_cov_12.694662	140	224	51	4	84	0.0476190
NODE_2800_length_1373_cov_12.694662	140	224	53	3	84	0.0357143
NODE_2800_length_1373_cov_12.694662	140	224	54	4	84	0.0476190
NODE_2800_length_1373_cov_12.694662	140	224	55	3	84	0.0357143
NODE_2800_length_1373_cov_12.694662	140	224	58	1	84	0.0119048
NODE_2800_length_1373_cov_12.694662	140	224	60	1	84	0.0119048
NODE_2800_length_1373_cov_12.694662	140	224	61	2	84	0.0238095
NODE_2800_length_1373_cov_12.694662	140	224	62	1	84	0.0119048
NODE_2800_length_1373_cov_12.694662	140	224	63	3	84	0.0357143
NODE_2800_length_1373_cov_12.694662	140	224	65	4	84	0.0476190
NODE_2800_length_1373_cov_12.694662	140	224	67	7	84	0.0833333
NODE_2800_length_1373_cov_12.694662	140	224	73	7	84	0.0833333
NODE_2800_length_1373_cov_12.694662	140	224	77	1	84	0.0119048
NODE_2800_length_1373_cov_12.694662	140	224	79	5	84	0.0595238
NODE_2800_length_1373_cov_12.694662	140	224	80	1	84	0.0119048
NODE_2800_length_1373_cov_12.694662	140	224	81	3	84	0.0357143
NODE_2800_length_1373_cov_12.694662	140	224	82	6	84	0.0714286
NODE_2800_length_1373_cov_12.694662	140	224	86	2	84	0.0238095
NODE_2800_length_1373_cov_12.694662	140	224	87	7	84	0.0833333
NODE_2800_length_1373_cov_12.694662	140	224	88	1	84	0.0119048
NODE_2800_length_1373_cov_12.694662	140	224	89	1	84	0.0119048
NODE_2800_length_1373_cov_12.694662	1214	1286	5	55	72	0.7638889
NODE_2800_length_1373_cov_12.694662	1214	1286	9	17	72	0.2361111
NODE_2800_length_1373_cov_12.694662	1267	1339	0	31	72	0.4305556
NODE_2800_length_1373_cov_12.694662	1267	1339	5	41	72	0.5694444
NODE_2801_length_1372_cov_25.408484	665	745	0	62	80	0.7750000
NODE_2801_length_1372_cov_25.408484	665	745	2	18	80	0.2250000
NODE_2801_length_1372_cov_25.408484	718	798	0	80	80	1.0000000
NODE_2802_length_1372_cov_17.123331	647	727	0	80	80	1.0000000
NODE_2802_length_1372_cov_17.123331	700	780	0	80	80	1.0000000
NODE_2802_length_1372_cov_17.123331	776	856	0	26	80	0.3250000
NODE_2802_length_1372_cov_17.123331	776	856	2	54	80	0.6750000
NODE_2802_length_1372_cov_17.123331	829	909	0	27	80	0.3375000
NODE_2802_length_1372_cov_17.123331	829	909	2	53	80	0.6625000
NODE_2803_length_1372_cov_14.418696	211	291	0	80	80	1.0000000
NODE_2803_length_1372_cov_14.418696	264	344	0	80	80	1.0000000
NODE_2806_length_1371_cov_39.366352	715	795	26	22	80	0.2750000
NODE_2806_length_1371_cov_39.366352	715	795	28	5	80	0.0625000
NODE_2806_length_1371_cov_39.366352	715	795	36	1	80	0.0125000
NODE_2806_length_1371_cov_39.366352	715	795	42	2	80	0.0250000
NODE_2806_length_1371_cov_39.366352	715	795	44	4	80	0.0500000
NODE_2806_length_1371_cov_39.366352	715	795	46	7	80	0.0875000
NODE_2806_length_1371_cov_39.366352	715	795	48	21	80	0.2625000
NODE_2806_length_1371_cov_39.366352	715	795	50	9	80	0.1125000
NODE_2806_length_1371_cov_39.366352	715	795	52	4	80	0.0500000
NODE_2806_length_1371_cov_39.366352	715	795	54	5	80	0.0625000
NODE_2806_length_1371_cov_39.366352	768	848	34	4	80	0.0500000
NODE_2806_length_1371_cov_39.366352	768	848	37	2	80	0.0250000
NODE_2806_length_1371_cov_39.366352	768	848	40	2	80	0.0250000
NODE_2806_length_1371_cov_39.366352	768	848	44	1	80	0.0125000
NODE_2806_length_1371_cov_39.366352	768	848	46	3	80	0.0375000
NODE_2806_length_1371_cov_39.366352	768	848	48	12	80	0.1500000
NODE_2806_length_1371_cov_39.366352	768	848	50	9	80	0.1125000
NODE_2806_length_1371_cov_39.366352	768	848	52	4	80	0.0500000
NODE_2806_length_1371_cov_39.366352	768	848	54	10	80	0.1250000
NODE_2806_length_1371_cov_39.366352	768	848	56	1	80	0.0125000
NODE_2806_length_1371_cov_39.366352	768	848	57	1	80	0.0125000
NODE_2806_length_1371_cov_39.366352	768	848	58	2	80	0.0250000
NODE_2806_length_1371_cov_39.366352	768	848	62	27	80	0.3375000
NODE_2806_length_1371_cov_39.366352	768	848	64	2	80	0.0250000
NODE_2807_length_1371_cov_36.961478	371	455	3	84	84	1.0000000
NODE_2807_length_1371_cov_36.961478	424	508	0	6	84	0.0714286
NODE_2807_length_1371_cov_36.961478	424	508	1	40	84	0.4761905
NODE_2807_length_1371_cov_36.961478	424	508	3	38	84	0.4523810
NODE_2807_length_1371_cov_36.961478	504	584	0	80	80	1.0000000
NODE_2807_length_1371_cov_36.961478	557	637	0	73	80	0.9125000
NODE_2807_length_1371_cov_36.961478	557	637	1	7	80	0.0875000
NODE_2808_length_1371_cov_16.944182	459	539	0	19	80	0.2375000
NODE_2808_length_1371_cov_16.944182	459	539	2	61	80	0.7625000
NODE_2808_length_1371_cov_16.944182	512	592	0	72	80	0.9000000
NODE_2808_length_1371_cov_16.944182	512	592	2	8	80	0.1000000
NODE_2808_length_1371_cov_16.944182	588	668	0	80	80	1.0000000
NODE_2808_length_1371_cov_16.944182	641	721	0	80	80	1.0000000
NODE_2812_length_1370_cov_11.627065	502	582	0	70	80	0.8750000
NODE_2812_length_1370_cov_11.627065	502	582	2	10	80	0.1250000
NODE_2812_length_1370_cov_11.627065	555	635	0	80	80	1.0000000
NODE_2812_length_1370_cov_11.627065	631	711	0	80	80	1.0000000
NODE_2812_length_1370_cov_11.627065	684	764	0	80	80	1.0000000
NODE_2813_length_1369_cov_27.937795	597	677	2	58	80	0.7250000
NODE_2813_length_1369_cov_27.937795	597	677	4	4	80	0.0500000
NODE_2813_length_1369_cov_27.937795	597	677	6	18	80	0.2250000
NODE_2813_length_1369_cov_27.937795	650	730	2	76	80	0.9500000
NODE_2813_length_1369_cov_27.937795	650	730	4	4	80	0.0500000
NODE_2820_length_1368_cov_35.148148	546	626	0	41	80	0.5125000
NODE_2820_length_1368_cov_35.148148	546	626	2	27	80	0.3375000
NODE_2820_length_1368_cov_35.148148	546	626	4	10	80	0.1250000
NODE_2820_length_1368_cov_35.148148	546	626	6	2	80	0.0250000
NODE_2820_length_1368_cov_35.148148	599	679	0	5	80	0.0625000
NODE_2820_length_1368_cov_35.148148	599	679	2	10	80	0.1250000
NODE_2820_length_1368_cov_35.148148	599	679	4	16	80	0.2000000
NODE_2820_length_1368_cov_35.148148	599	679	6	49	80	0.6125000
NODE_2821_length_1368_cov_27.847912	486	559	0	73	73	1.0000000
NODE_2821_length_1368_cov_27.847912	532	612	0	80	80	1.0000000
NODE_2821_length_1368_cov_27.847912	608	688	0	80	80	1.0000000
NODE_2821_length_1368_cov_27.847912	661	741	0	80	80	1.0000000
NODE_2822_length_1368_cov_26.832151	458	538	2	80	80	1.0000000
NODE_2822_length_1368_cov_26.832151	511	591	0	39	80	0.4875000
NODE_2822_length_1368_cov_26.832151	511	591	2	41	80	0.5125000
NODE_2822_length_1368_cov_26.832151	587	667	0	5	80	0.0625000
NODE_2822_length_1368_cov_26.832151	587	667	6	1	80	0.0125000
NODE_2822_length_1368_cov_26.832151	587	667	8	5	80	0.0625000
NODE_2822_length_1368_cov_26.832151	587	667	18	61	80	0.7625000
NODE_2822_length_1368_cov_26.832151	587	667	19	8	80	0.1000000
NODE_2822_length_1368_cov_26.832151	640	720	8	10	80	0.1250000
NODE_2822_length_1368_cov_26.832151	640	720	16	12	80	0.1500000
NODE_2822_length_1368_cov_26.832151	640	720	17	15	80	0.1875000
NODE_2822_length_1368_cov_26.832151	640	720	18	35	80	0.4375000
NODE_2822_length_1368_cov_26.832151	640	720	19	8	80	0.1000000
NODE_2823_length_1368_cov_18.205674	603	683	0	80	80	1.0000000
NODE_2823_length_1368_cov_18.205674	656	736	0	80	80	1.0000000
NODE_2826_length_1367_cov_576.769716	799	879	224	1	80	0.0125000
NODE_2826_length_1367_cov_576.769716	799	879	229	1	80	0.0125000
NODE_2826_length_1367_cov_576.769716	799	879	234	1	80	0.0125000
NODE_2826_length_1367_cov_576.769716	799	879	236	1	80	0.0125000
NODE_2826_length_1367_cov_576.769716	799	879	239	1	80	0.0125000
NODE_2826_length_1367_cov_576.769716	799	879	241	1	80	0.0125000
NODE_2826_length_1367_cov_576.769716	799	879	243	1	80	0.0125000
NODE_2826_length_1367_cov_576.769716	799	879	248	1	80	0.0125000
NODE_2826_length_1367_cov_576.769716	799	879	249	1	80	0.0125000
NODE_2826_length_1367_cov_576.769716	799	879	256	2	80	0.0250000
NODE_2826_length_1367_cov_576.769716	799	879	257	1	80	0.0125000
NODE_2826_length_1367_cov_576.769716	799	879	258	1	80	0.0125000
NODE_2826_length_1367_cov_576.769716	799	879	260	1	80	0.0125000
NODE_2826_length_1367_cov_576.769716	799	879	262	1	80	0.0125000
NODE_2826_length_1367_cov_576.769716	799	879	263	2	80	0.0250000
NODE_2826_length_1367_cov_576.769716	799	879	265	1	80	0.0125000
NODE_2826_length_1367_cov_576.769716	799	879	267	1	80	0.0125000
NODE_2826_length_1367_cov_576.769716	799	879	269	1	80	0.0125000
NODE_2826_length_1367_cov_576.769716	799	879	271	2	80	0.0250000
NODE_2826_length_1367_cov_576.769716	799	879	272	2	80	0.0250000
NODE_2826_length_1367_cov_576.769716	799	879	274	2	80	0.0250000
NODE_2826_length_1367_cov_576.769716	799	879	276	1	80	0.0125000
NODE_2826_length_1367_cov_576.769716	799	879	277	1	80	0.0125000
NODE_2826_length_1367_cov_576.769716	799	879	279	1	80	0.0125000
NODE_2826_length_1367_cov_576.769716	799	879	280	2	80	0.0250000
NODE_2826_length_1367_cov_576.769716	799	879	281	1	80	0.0125000
NODE_2826_length_1367_cov_576.769716	799	879	282	1	80	0.0125000
NODE_2826_length_1367_cov_576.769716	799	879	285	1	80	0.0125000
NODE_2826_length_1367_cov_576.769716	799	879	286	1	80	0.0125000
NODE_2826_length_1367_cov_576.769716	799	879	287	1	80	0.0125000
NODE_2826_length_1367_cov_576.769716	799	879	288	1	80	0.0125000
NODE_2826_length_1367_cov_576.769716	799	879	289	2	80	0.0250000
NODE_2826_length_1367_cov_576.769716	799	879	291	1	80	0.0125000
NODE_2826_length_1367_cov_576.769716	799	879	294	1	80	0.0125000
NODE_2826_length_1367_cov_576.769716	799	879	303	2	80	0.0250000
NODE_2826_length_1367_cov_576.769716	799	879	307	1	80	0.0125000
NODE_2826_length_1367_cov_576.769716	799	879	317	1	80	0.0125000
NODE_2826_length_1367_cov_576.769716	799	879	321	1	80	0.0125000
NODE_2826_length_1367_cov_576.769716	799	879	323	2	80	0.0250000
NODE_2826_length_1367_cov_576.769716	799	879	324	1	80	0.0125000
NODE_2826_length_1367_cov_576.769716	799	879	326	1	80	0.0125000
NODE_2826_length_1367_cov_576.769716	799	879	327	1	80	0.0125000
NODE_2826_length_1367_cov_576.769716	799	879	347	1	80	0.0125000
NODE_2826_length_1367_cov_576.769716	799	879	366	2	80	0.0250000
NODE_2826_length_1367_cov_576.769716	799	879	392	1	80	0.0125000
NODE_2826_length_1367_cov_576.769716	799	879	411	1	80	0.0125000
NODE_2826_length_1367_cov_576.769716	799	879	413	1	80	0.0125000
NODE_2826_length_1367_cov_576.769716	799	879	417	2	80	0.0250000
NODE_2826_length_1367_cov_576.769716	799	879	422	1	80	0.0125000
NODE_2826_length_1367_cov_576.769716	799	879	449	1	80	0.0125000
NODE_2826_length_1367_cov_576.769716	799	879	482	1	80	0.0125000
NODE_2826_length_1367_cov_576.769716	799	879	517	2	80	0.0250000
NODE_2826_length_1367_cov_576.769716	799	879	561	1	80	0.0125000
NODE_2826_length_1367_cov_576.769716	799	879	631	1	80	0.0125000
NODE_2826_length_1367_cov_576.769716	799	879	643	1	80	0.0125000
NODE_2826_length_1367_cov_576.769716	799	879	644	1	80	0.0125000
NODE_2826_length_1367_cov_576.769716	799	879	654	2	80	0.0250000
NODE_2826_length_1367_cov_576.769716	799	879	753	1	80	0.0125000
NODE_2826_length_1367_cov_576.769716	799	879	759	1	80	0.0125000
NODE_2826_length_1367_cov_576.769716	799	879	770	1	80	0.0125000
NODE_2826_length_1367_cov_576.769716	799	879	775	1	80	0.0125000
NODE_2826_length_1367_cov_576.769716	799	879	806	1	80	0.0125000
NODE_2826_length_1367_cov_576.769716	799	879	816	4	80	0.0500000
NODE_2826_length_1367_cov_576.769716	799	879	817	1	80	0.0125000
NODE_2826_length_1367_cov_576.769716	852	932	366	1	80	0.0125000
NODE_2826_length_1367_cov_576.769716	852	932	392	1	80	0.0125000
NODE_2826_length_1367_cov_576.769716	852	932	411	1	80	0.0125000
NODE_2826_length_1367_cov_576.769716	852	932	413	1	80	0.0125000
NODE_2826_length_1367_cov_576.769716	852	932	417	2	80	0.0250000
NODE_2826_length_1367_cov_576.769716	852	932	422	1	80	0.0125000
NODE_2826_length_1367_cov_576.769716	852	932	449	1	80	0.0125000
NODE_2826_length_1367_cov_576.769716	852	932	482	1	80	0.0125000
NODE_2826_length_1367_cov_576.769716	852	932	517	2	80	0.0250000
NODE_2826_length_1367_cov_576.769716	852	932	561	1	80	0.0125000
NODE_2826_length_1367_cov_576.769716	852	932	631	1	80	0.0125000
NODE_2826_length_1367_cov_576.769716	852	932	643	1	80	0.0125000
NODE_2826_length_1367_cov_576.769716	852	932	644	1	80	0.0125000
NODE_2826_length_1367_cov_576.769716	852	932	654	2	80	0.0250000
NODE_2826_length_1367_cov_576.769716	852	932	753	1	80	0.0125000
NODE_2826_length_1367_cov_576.769716	852	932	759	1	80	0.0125000
NODE_2826_length_1367_cov_576.769716	852	932	770	1	80	0.0125000
NODE_2826_length_1367_cov_576.769716	852	932	775	1	80	0.0125000
NODE_2826_length_1367_cov_576.769716	852	932	806	1	80	0.0125000
NODE_2826_length_1367_cov_576.769716	852	932	814	2	80	0.0250000
NODE_2826_length_1367_cov_576.769716	852	932	816	4	80	0.0500000
NODE_2826_length_1367_cov_576.769716	852	932	817	2	80	0.0250000
NODE_2826_length_1367_cov_576.769716	852	932	828	1	80	0.0125000
NODE_2826_length_1367_cov_576.769716	852	932	840	2	80	0.0250000
NODE_2826_length_1367_cov_576.769716	852	932	881	1	80	0.0125000
NODE_2826_length_1367_cov_576.769716	852	932	885	2	80	0.0250000
NODE_2826_length_1367_cov_576.769716	852	932	902	1	80	0.0125000
NODE_2826_length_1367_cov_576.769716	852	932	918	1	80	0.0125000
NODE_2826_length_1367_cov_576.769716	852	932	922	1	80	0.0125000
NODE_2826_length_1367_cov_576.769716	852	932	932	1	80	0.0125000
NODE_2826_length_1367_cov_576.769716	852	932	939	1	80	0.0125000
NODE_2826_length_1367_cov_576.769716	852	932	969	1	80	0.0125000
NODE_2826_length_1367_cov_576.769716	852	932	974	2	80	0.0250000
NODE_2826_length_1367_cov_576.769716	852	932	975	1	80	0.0125000
NODE_2826_length_1367_cov_576.769716	852	932	979	1	80	0.0125000
NODE_2826_length_1367_cov_576.769716	852	932	983	1	80	0.0125000
NODE_2826_length_1367_cov_576.769716	852	932	984	1	80	0.0125000
NODE_2826_length_1367_cov_576.769716	852	932	985	2	80	0.0250000
NODE_2826_length_1367_cov_576.769716	852	932	987	2	80	0.0250000
NODE_2826_length_1367_cov_576.769716	852	932	988	1	80	0.0125000
NODE_2826_length_1367_cov_576.769716	852	932	989	7	80	0.0875000
NODE_2826_length_1367_cov_576.769716	852	932	996	1	80	0.0125000
NODE_2826_length_1367_cov_576.769716	852	932	998	1	80	0.0125000
NODE_2826_length_1367_cov_576.769716	852	932	999	3	80	0.0375000
NODE_2826_length_1367_cov_576.769716	852	932	1000	1	80	0.0125000
NODE_2826_length_1367_cov_576.769716	852	932	1001	1	80	0.0125000
NODE_2826_length_1367_cov_576.769716	852	932	1002	1	80	0.0125000
NODE_2826_length_1367_cov_576.769716	852	932	1003	2	80	0.0250000
NODE_2826_length_1367_cov_576.769716	852	932	1004	3	80	0.0375000
NODE_2826_length_1367_cov_576.769716	852	932	1005	1	80	0.0125000
NODE_2826_length_1367_cov_576.769716	852	932	1006	1	80	0.0125000
NODE_2826_length_1367_cov_576.769716	852	932	1008	1	80	0.0125000
NODE_2826_length_1367_cov_576.769716	852	932	1013	4	80	0.0500000
NODE_2826_length_1367_cov_576.769716	900	980	709	1	80	0.0125000
NODE_2826_length_1367_cov_576.769716	900	980	763	1	80	0.0125000
NODE_2826_length_1367_cov_576.769716	900	980	824	1	80	0.0125000
NODE_2826_length_1367_cov_576.769716	900	980	834	1	80	0.0125000
NODE_2826_length_1367_cov_576.769716	900	980	848	1	80	0.0125000
NODE_2826_length_1367_cov_576.769716	900	980	866	1	80	0.0125000
NODE_2826_length_1367_cov_576.769716	900	980	900	1	80	0.0125000
NODE_2826_length_1367_cov_576.769716	900	980	909	1	80	0.0125000
NODE_2826_length_1367_cov_576.769716	900	980	919	1	80	0.0125000
NODE_2826_length_1367_cov_576.769716	900	980	927	2	80	0.0250000
NODE_2826_length_1367_cov_576.769716	900	980	935	1	80	0.0125000
NODE_2826_length_1367_cov_576.769716	900	980	937	1	80	0.0125000
NODE_2826_length_1367_cov_576.769716	900	980	938	1	80	0.0125000
NODE_2826_length_1367_cov_576.769716	900	980	952	1	80	0.0125000
NODE_2826_length_1367_cov_576.769716	900	980	963	1	80	0.0125000
NODE_2826_length_1367_cov_576.769716	900	980	973	1	80	0.0125000
NODE_2826_length_1367_cov_576.769716	900	980	974	3	80	0.0375000
NODE_2826_length_1367_cov_576.769716	900	980	975	2	80	0.0250000
NODE_2826_length_1367_cov_576.769716	900	980	976	3	80	0.0375000
NODE_2826_length_1367_cov_576.769716	900	980	979	2	80	0.0250000
NODE_2826_length_1367_cov_576.769716	900	980	980	1	80	0.0125000
NODE_2826_length_1367_cov_576.769716	900	980	982	1	80	0.0125000
NODE_2826_length_1367_cov_576.769716	900	980	984	1	80	0.0125000
NODE_2826_length_1367_cov_576.769716	900	980	985	2	80	0.0250000
NODE_2826_length_1367_cov_576.769716	900	980	986	1	80	0.0125000
NODE_2826_length_1367_cov_576.769716	900	980	987	2	80	0.0250000
NODE_2826_length_1367_cov_576.769716	900	980	988	1	80	0.0125000
NODE_2826_length_1367_cov_576.769716	900	980	989	10	80	0.1250000
NODE_2826_length_1367_cov_576.769716	900	980	992	1	80	0.0125000
NODE_2826_length_1367_cov_576.769716	900	980	994	1	80	0.0125000
NODE_2826_length_1367_cov_576.769716	900	980	996	1	80	0.0125000
NODE_2826_length_1367_cov_576.769716	900	980	997	3	80	0.0375000
NODE_2826_length_1367_cov_576.769716	900	980	998	1	80	0.0125000
NODE_2826_length_1367_cov_576.769716	900	980	999	4	80	0.0500000
NODE_2826_length_1367_cov_576.769716	900	980	1000	2	80	0.0250000
NODE_2826_length_1367_cov_576.769716	900	980	1001	4	80	0.0500000
NODE_2826_length_1367_cov_576.769716	900	980	1002	3	80	0.0375000
NODE_2826_length_1367_cov_576.769716	900	980	1003	2	80	0.0250000
NODE_2826_length_1367_cov_576.769716	900	980	1004	4	80	0.0500000
NODE_2826_length_1367_cov_576.769716	900	980	1005	2	80	0.0250000
NODE_2826_length_1367_cov_576.769716	900	980	1006	1	80	0.0125000
NODE_2826_length_1367_cov_576.769716	900	980	1008	1	80	0.0125000
NODE_2826_length_1367_cov_576.769716	900	980	1013	4	80	0.0500000
NODE_2826_length_1367_cov_576.769716	905	927	974	2	22	0.0909091
NODE_2826_length_1367_cov_576.769716	905	927	979	1	22	0.0454545
NODE_2826_length_1367_cov_576.769716	905	927	984	1	22	0.0454545
NODE_2826_length_1367_cov_576.769716	905	927	985	2	22	0.0909091
NODE_2826_length_1367_cov_576.769716	905	927	989	1	22	0.0454545
NODE_2826_length_1367_cov_576.769716	905	927	996	1	22	0.0454545
NODE_2826_length_1367_cov_576.769716	905	927	998	1	22	0.0454545
NODE_2826_length_1367_cov_576.769716	905	927	999	3	22	0.1363636
NODE_2826_length_1367_cov_576.769716	905	927	1003	1	22	0.0454545
NODE_2826_length_1367_cov_576.769716	905	927	1004	3	22	0.1363636
NODE_2826_length_1367_cov_576.769716	905	927	1006	1	22	0.0454545
NODE_2826_length_1367_cov_576.769716	905	927	1008	1	22	0.0454545
NODE_2826_length_1367_cov_576.769716	905	927	1013	4	22	0.1818182
NODE_2826_length_1367_cov_576.769716	1051	1131	25	2	80	0.0250000
NODE_2826_length_1367_cov_576.769716	1051	1131	26	4	80	0.0500000
NODE_2826_length_1367_cov_576.769716	1051	1131	27	5	80	0.0625000
NODE_2826_length_1367_cov_576.769716	1051	1131	28	2	80	0.0250000
NODE_2826_length_1367_cov_576.769716	1051	1131	29	4	80	0.0500000
NODE_2826_length_1367_cov_576.769716	1051	1131	31	4	80	0.0500000
NODE_2826_length_1367_cov_576.769716	1051	1131	32	12	80	0.1500000
NODE_2826_length_1367_cov_576.769716	1051	1131	34	1	80	0.0125000
NODE_2826_length_1367_cov_576.769716	1051	1131	35	4	80	0.0500000
NODE_2826_length_1367_cov_576.769716	1051	1131	37	2	80	0.0250000
NODE_2826_length_1367_cov_576.769716	1051	1131	41	2	80	0.0250000
NODE_2826_length_1367_cov_576.769716	1051	1131	43	2	80	0.0250000
NODE_2826_length_1367_cov_576.769716	1051	1131	45	5	80	0.0625000
NODE_2826_length_1367_cov_576.769716	1051	1131	47	1	80	0.0125000
NODE_2826_length_1367_cov_576.769716	1051	1131	48	4	80	0.0500000
NODE_2826_length_1367_cov_576.769716	1051	1131	50	2	80	0.0250000
NODE_2826_length_1367_cov_576.769716	1051	1131	51	2	80	0.0250000
NODE_2826_length_1367_cov_576.769716	1051	1131	52	8	80	0.1000000
NODE_2826_length_1367_cov_576.769716	1051	1131	53	4	80	0.0500000
NODE_2826_length_1367_cov_576.769716	1051	1131	56	2	80	0.0250000
NODE_2826_length_1367_cov_576.769716	1051	1131	59	1	80	0.0125000
NODE_2826_length_1367_cov_576.769716	1051	1131	62	1	80	0.0125000
NODE_2826_length_1367_cov_576.769716	1051	1131	64	3	80	0.0375000
NODE_2826_length_1367_cov_576.769716	1051	1131	65	3	80	0.0375000
NODE_2826_length_1367_cov_576.769716	1104	1184	43	2	80	0.0250000
NODE_2826_length_1367_cov_576.769716	1104	1184	45	5	80	0.0625000
NODE_2826_length_1367_cov_576.769716	1104	1184	48	3	80	0.0375000
NODE_2826_length_1367_cov_576.769716	1104	1184	50	1	80	0.0125000
NODE_2826_length_1367_cov_576.769716	1104	1184	51	2	80	0.0250000
NODE_2826_length_1367_cov_576.769716	1104	1184	53	4	80	0.0500000
NODE_2826_length_1367_cov_576.769716	1104	1184	56	2	80	0.0250000
NODE_2826_length_1367_cov_576.769716	1104	1184	59	1	80	0.0125000
NODE_2826_length_1367_cov_576.769716	1104	1184	62	1	80	0.0125000
NODE_2826_length_1367_cov_576.769716	1104	1184	64	3	80	0.0375000
NODE_2826_length_1367_cov_576.769716	1104	1184	65	3	80	0.0375000
NODE_2826_length_1367_cov_576.769716	1104	1184	70	2	80	0.0250000
NODE_2826_length_1367_cov_576.769716	1104	1184	72	1	80	0.0125000
NODE_2826_length_1367_cov_576.769716	1104	1184	75	2	80	0.0250000
NODE_2826_length_1367_cov_576.769716	1104	1184	76	1	80	0.0125000
NODE_2826_length_1367_cov_576.769716	1104	1184	79	6	80	0.0750000
NODE_2826_length_1367_cov_576.769716	1104	1184	80	1	80	0.0125000
NODE_2826_length_1367_cov_576.769716	1104	1184	81	2	80	0.0250000
NODE_2826_length_1367_cov_576.769716	1104	1184	89	1	80	0.0125000
NODE_2826_length_1367_cov_576.769716	1104	1184	91	4	80	0.0500000
NODE_2826_length_1367_cov_576.769716	1104	1184	95	1	80	0.0125000
NODE_2826_length_1367_cov_576.769716	1104	1184	99	1	80	0.0125000
NODE_2826_length_1367_cov_576.769716	1104	1184	105	2	80	0.0250000
NODE_2826_length_1367_cov_576.769716	1104	1184	109	7	80	0.0875000
NODE_2826_length_1367_cov_576.769716	1104	1184	111	1	80	0.0125000
NODE_2826_length_1367_cov_576.769716	1104	1184	112	2	80	0.0250000
NODE_2826_length_1367_cov_576.769716	1104	1184	114	1	80	0.0125000
NODE_2826_length_1367_cov_576.769716	1104	1184	115	4	80	0.0500000
NODE_2826_length_1367_cov_576.769716	1104	1184	116	4	80	0.0500000
NODE_2826_length_1367_cov_576.769716	1104	1184	117	1	80	0.0125000
NODE_2826_length_1367_cov_576.769716	1104	1184	118	2	80	0.0250000
NODE_2826_length_1367_cov_576.769716	1104	1184	120	2	80	0.0250000
NODE_2826_length_1367_cov_576.769716	1104	1184	121	4	80	0.0500000
NODE_2826_length_1367_cov_576.769716	1104	1184	123	1	80	0.0125000
NODE_2827_length_1367_cov_152.824921	513	593	5	10	80	0.1250000
NODE_2827_length_1367_cov_152.824921	513	593	6	37	80	0.4625000
NODE_2827_length_1367_cov_152.824921	513	593	11	33	80	0.4125000
NODE_2827_length_1367_cov_152.824921	566	646	5	10	80	0.1250000
NODE_2827_length_1367_cov_152.824921	566	646	6	59	80	0.7375000
NODE_2827_length_1367_cov_152.824921	566	646	11	11	80	0.1375000
NODE_2827_length_1367_cov_152.824921	642	722	0	74	80	0.9250000
NODE_2827_length_1367_cov_152.824921	642	722	6	6	80	0.0750000
NODE_2827_length_1367_cov_152.824921	695	775	0	80	80	1.0000000
NODE_2829_length_1367_cov_2.947161	250	326	6	6	76	0.0789474
NODE_2829_length_1367_cov_2.947161	250	326	8	14	76	0.1842105
NODE_2829_length_1367_cov_2.947161	250	326	10	48	76	0.6315789
NODE_2829_length_1367_cov_2.947161	250	326	12	8	76	0.1052632
NODE_2831_length_1366_cov_82.742699	198	278	0	80	80	1.0000000
NODE_2831_length_1366_cov_82.742699	251	331	0	80	80	1.0000000
NODE_2832_length_1366_cov_36.659037	577	657	2	26	80	0.3250000
NODE_2832_length_1366_cov_36.659037	577	657	10	48	80	0.6000000
NODE_2832_length_1366_cov_36.659037	577	657	12	6	80	0.0750000
NODE_2832_length_1366_cov_36.659037	630	710	10	74	80	0.9250000
NODE_2832_length_1366_cov_36.659037	630	710	12	6	80	0.0750000
NODE_2834_length_1366_cov_2.320442	47	116	7	5	69	0.0724638
NODE_2834_length_1366_cov_2.320442	47	116	10	64	69	0.9275362
NODE_2834_length_1366_cov_2.320442	1122	1202	0	1	80	0.0125000
NODE_2834_length_1366_cov_2.320442	1122	1202	2	68	80	0.8500000
NODE_2834_length_1366_cov_2.320442	1122	1202	4	11	80	0.1375000
NODE_2834_length_1366_cov_2.320442	1175	1255	0	2	80	0.0250000
NODE_2834_length_1366_cov_2.320442	1175	1255	2	26	80	0.3250000
NODE_2834_length_1366_cov_2.320442	1175	1255	4	2	80	0.0250000
NODE_2834_length_1366_cov_2.320442	1175	1255	6	2	80	0.0250000
NODE_2834_length_1366_cov_2.320442	1175	1255	8	1	80	0.0125000
NODE_2834_length_1366_cov_2.320442	1175	1255	10	1	80	0.0125000
NODE_2834_length_1366_cov_2.320442	1175	1255	11	1	80	0.0125000
NODE_2834_length_1366_cov_2.320442	1175	1255	17	1	80	0.0125000
NODE_2834_length_1366_cov_2.320442	1175	1255	19	5	80	0.0625000
NODE_2834_length_1366_cov_2.320442	1175	1255	21	7	80	0.0875000
NODE_2834_length_1366_cov_2.320442	1175	1255	23	2	80	0.0250000
NODE_2834_length_1366_cov_2.320442	1175	1255	24	7	80	0.0875000
NODE_2834_length_1366_cov_2.320442	1175	1255	26	6	80	0.0750000
NODE_2834_length_1366_cov_2.320442	1175	1255	28	1	80	0.0125000
NODE_2834_length_1366_cov_2.320442	1175	1255	30	3	80	0.0375000
NODE_2834_length_1366_cov_2.320442	1175	1255	34	8	80	0.1000000
NODE_2834_length_1366_cov_2.320442	1175	1255	36	1	80	0.0125000
NODE_2834_length_1366_cov_2.320442	1175	1255	38	3	80	0.0375000
NODE_2834_length_1366_cov_2.320442	1175	1255	40	1	80	0.0125000
NODE_2834_length_1366_cov_2.320442	1251	1331	26	2	80	0.0250000
NODE_2834_length_1366_cov_2.320442	1251	1331	30	2	80	0.0250000
NODE_2834_length_1366_cov_2.320442	1251	1331	34	8	80	0.1000000
NODE_2834_length_1366_cov_2.320442	1251	1331	36	1	80	0.0125000
NODE_2834_length_1366_cov_2.320442	1251	1331	38	6	80	0.0750000
NODE_2834_length_1366_cov_2.320442	1251	1331	40	2	80	0.0250000
NODE_2834_length_1366_cov_2.320442	1251	1331	42	2	80	0.0250000
NODE_2834_length_1366_cov_2.320442	1251	1331	44	13	80	0.1625000
NODE_2834_length_1366_cov_2.320442	1251	1331	46	1	80	0.0125000
NODE_2834_length_1366_cov_2.320442	1251	1331	48	1	80	0.0125000
NODE_2834_length_1366_cov_2.320442	1251	1331	50	42	80	0.5250000
NODE_2835_length_1365_cov_25.540284	432	509	0	14	77	0.1818182
NODE_2835_length_1365_cov_25.540284	432	509	2	1	77	0.0129870
NODE_2835_length_1365_cov_25.540284	432	509	4	1	77	0.0129870
NODE_2835_length_1365_cov_25.540284	432	509	6	61	77	0.7922078
NODE_2835_length_1365_cov_25.540284	482	562	0	3	80	0.0375000
NODE_2835_length_1365_cov_25.540284	482	562	2	21	80	0.2625000
NODE_2835_length_1365_cov_25.540284	482	562	4	22	80	0.2750000
NODE_2835_length_1365_cov_25.540284	482	562	6	34	80	0.4250000
NODE_2835_length_1365_cov_25.540284	558	635	0	76	77	0.9870130
NODE_2835_length_1365_cov_25.540284	558	635	2	1	77	0.0129870
NODE_2835_length_1365_cov_25.540284	625	688	0	63	63	1.0000000
NODE_2838_length_1364_cov_15.222134	120	191	12	9	71	0.1267606
NODE_2838_length_1364_cov_15.222134	120	191	13	3	71	0.0422535
NODE_2838_length_1364_cov_15.222134	120	191	15	9	71	0.1267606
NODE_2838_length_1364_cov_15.222134	120	191	16	4	71	0.0563380
NODE_2838_length_1364_cov_15.222134	120	191	22	1	71	0.0140845
NODE_2838_length_1364_cov_15.222134	120	191	27	2	71	0.0281690
NODE_2838_length_1364_cov_15.222134	120	191	30	5	71	0.0704225
NODE_2838_length_1364_cov_15.222134	120	191	34	1	71	0.0140845
NODE_2838_length_1364_cov_15.222134	120	191	37	4	71	0.0563380
NODE_2838_length_1364_cov_15.222134	120	191	44	1	71	0.0140845
NODE_2838_length_1364_cov_15.222134	120	191	46	4	71	0.0563380
NODE_2838_length_1364_cov_15.222134	120	191	50	3	71	0.0422535
NODE_2838_length_1364_cov_15.222134	120	191	51	4	71	0.0563380
NODE_2838_length_1364_cov_15.222134	120	191	53	2	71	0.0281690
NODE_2838_length_1364_cov_15.222134	120	191	56	4	71	0.0563380
NODE_2838_length_1364_cov_15.222134	120	191	60	1	71	0.0140845
NODE_2838_length_1364_cov_15.222134	120	191	64	2	71	0.0281690
NODE_2838_length_1364_cov_15.222134	120	191	68	3	71	0.0422535
NODE_2838_length_1364_cov_15.222134	120	191	69	1	71	0.0140845
NODE_2838_length_1364_cov_15.222134	120	191	70	2	71	0.0281690
NODE_2838_length_1364_cov_15.222134	120	191	72	4	71	0.0563380
NODE_2838_length_1364_cov_15.222134	120	191	76	2	71	0.0281690
NODE_2839_length_1364_cov_7.456917	843	923	0	25	80	0.3125000
NODE_2839_length_1364_cov_7.456917	843	923	5	55	80	0.6875000
NODE_2839_length_1364_cov_7.456917	896	976	0	17	80	0.2125000
NODE_2839_length_1364_cov_7.456917	896	976	2	3	80	0.0375000
NODE_2839_length_1364_cov_7.456917	896	976	5	60	80	0.7500000
NODE_2840_length_1364_cov_5.055336	239	290	0	39	51	0.7647059
NODE_2840_length_1364_cov_5.055336	239	290	4	12	51	0.2352941
NODE_2840_length_1364_cov_5.055336	263	343	0	15	80	0.1875000
NODE_2840_length_1364_cov_5.055336	263	343	4	65	80	0.8125000
NODE_2846_length_1363_cov_19.442247	615	695	0	8	80	0.1000000
NODE_2846_length_1363_cov_19.442247	615	695	2	6	80	0.0750000
NODE_2846_length_1363_cov_19.442247	615	695	6	46	80	0.5750000
NODE_2846_length_1363_cov_19.442247	615	695	10	20	80	0.2500000
NODE_2846_length_1363_cov_19.442247	668	748	6	7	80	0.0875000
NODE_2846_length_1363_cov_19.442247	668	748	8	31	80	0.3875000
NODE_2846_length_1363_cov_19.442247	668	748	10	42	80	0.5250000
NODE_2847_length_1363_cov_13.575949	619	699	0	50	80	0.6250000
NODE_2847_length_1363_cov_13.575949	619	699	2	30	80	0.3750000
NODE_2847_length_1363_cov_13.575949	672	752	2	80	80	1.0000000
NODE_2850_length_1362_cov_15.796516	898	978	0	37	80	0.4625000
NODE_2850_length_1362_cov_15.796516	898	978	2	5	80	0.0625000
NODE_2850_length_1362_cov_15.796516	898	978	4	38	80	0.4750000
NODE_2850_length_1362_cov_15.796516	951	1031	0	6	80	0.0750000
NODE_2850_length_1362_cov_15.796516	951	1031	2	20	80	0.2500000
NODE_2850_length_1362_cov_15.796516	951	1031	4	54	80	0.6750000
NODE_2855_length_1361_cov_24.574485	528	608	1	45	80	0.5625000
NODE_2855_length_1361_cov_24.574485	528	608	7	35	80	0.4375000
NODE_2855_length_1361_cov_24.574485	581	661	7	80	80	1.0000000
NODE_2856_length_1361_cov_20.148970	866	946	0	13	80	0.1625000
NODE_2856_length_1361_cov_20.148970	866	946	2	67	80	0.8375000
NODE_2856_length_1361_cov_20.148970	919	999	0	66	80	0.8250000
NODE_2856_length_1361_cov_20.148970	919	999	2	14	80	0.1750000
NODE_2858_length_1361_cov_10.530903	1139	1219	2	22	80	0.2750000
NODE_2858_length_1361_cov_10.530903	1139	1219	6	7	80	0.0875000
NODE_2858_length_1361_cov_10.530903	1139	1219	8	21	80	0.2625000
NODE_2858_length_1361_cov_10.530903	1139	1219	10	30	80	0.3750000
NODE_2858_length_1361_cov_10.530903	1139	1219	2	22	80	0.2750000
NODE_2858_length_1361_cov_10.530903	1139	1219	6	7	80	0.0875000
NODE_2858_length_1361_cov_10.530903	1139	1219	8	21	80	0.2625000
NODE_2858_length_1361_cov_10.530903	1139	1219	10	30	80	0.3750000
NODE_2858_length_1361_cov_10.530903	1192	1277	2	19	85	0.2235294
NODE_2858_length_1361_cov_10.530903	1192	1277	4	3	85	0.0352941
NODE_2858_length_1361_cov_10.530903	1192	1277	8	1	85	0.0117647
NODE_2858_length_1361_cov_10.530903	1192	1277	10	62	85	0.7294118
NODE_2858_length_1361_cov_10.530903	1273	1353	0	61	80	0.7625000
NODE_2858_length_1361_cov_10.530903	1273	1353	2	19	80	0.2375000
NODE_2858_length_1361_cov_10.530903	1273	1353	0	61	80	0.7625000
NODE_2858_length_1361_cov_10.530903	1273	1353	2	19	80	0.2375000
NODE_2858_length_1361_cov_10.530903	1273	1353	0	61	80	0.7625000
NODE_2858_length_1361_cov_10.530903	1273	1353	2	19	80	0.2375000
NODE_2858_length_1361_cov_10.530903	1273	1353	0	61	80	0.7625000
NODE_2858_length_1361_cov_10.530903	1273	1353	2	19	80	0.2375000
NODE_2858_length_1361_cov_10.530903	1273	1353	0	61	80	0.7625000
NODE_2858_length_1361_cov_10.530903	1273	1353	2	19	80	0.2375000
NODE_2858_length_1361_cov_10.530903	1273	1353	0	61	80	0.7625000
NODE_2858_length_1361_cov_10.530903	1273	1353	2	19	80	0.2375000
NODE_2859_length_1360_cov_42.789056	351	431	0	36	80	0.4500000
NODE_2859_length_1360_cov_42.789056	351	431	2	44	80	0.5500000
NODE_2859_length_1360_cov_42.789056	404	484	0	13	80	0.1625000
NODE_2859_length_1360_cov_42.789056	404	484	2	67	80	0.8375000
NODE_2860_length_1360_cov_26.407613	531	611	23	9	80	0.1125000
NODE_2860_length_1360_cov_26.407613	531	611	27	13	80	0.1625000
NODE_2860_length_1360_cov_26.407613	531	611	28	25	80	0.3125000
NODE_2860_length_1360_cov_26.407613	531	611	30	27	80	0.3375000
NODE_2860_length_1360_cov_26.407613	531	611	33	4	80	0.0500000
NODE_2860_length_1360_cov_26.407613	531	611	34	2	80	0.0250000
NODE_2860_length_1360_cov_26.407613	584	669	6	7	85	0.0823529
NODE_2860_length_1360_cov_26.407613	584	669	17	1	85	0.0117647
NODE_2860_length_1360_cov_26.407613	584	669	18	17	85	0.2000000
NODE_2860_length_1360_cov_26.407613	584	669	22	12	85	0.1411765
NODE_2860_length_1360_cov_26.407613	584	669	26	4	85	0.0470588
NODE_2860_length_1360_cov_26.407613	584	669	30	21	85	0.2470588
NODE_2860_length_1360_cov_26.407613	584	669	33	4	85	0.0470588
NODE_2860_length_1360_cov_26.407613	584	669	34	19	85	0.2235294
NODE_2861_length_1360_cov_16.182395	796	876	6	11	80	0.1375000
NODE_2861_length_1360_cov_16.182395	796	876	10	9	80	0.1125000
NODE_2861_length_1360_cov_16.182395	796	876	12	1	80	0.0125000
NODE_2861_length_1360_cov_16.182395	796	876	14	25	80	0.3125000
NODE_2861_length_1360_cov_16.182395	796	876	15	33	80	0.4125000
NODE_2861_length_1360_cov_16.182395	796	876	16	1	80	0.0125000
NODE_2861_length_1360_cov_16.182395	849	929	0	6	80	0.0750000
NODE_2861_length_1360_cov_16.182395	849	929	2	14	80	0.1750000
NODE_2861_length_1360_cov_16.182395	849	929	8	16	80	0.2000000
NODE_2861_length_1360_cov_16.182395	849	929	10	26	80	0.3250000
NODE_2861_length_1360_cov_16.182395	849	929	15	18	80	0.2250000
NODE_2861_length_1360_cov_16.182395	925	1005	0	80	80	1.0000000
NODE_2861_length_1360_cov_16.182395	978	1058	0	80	80	1.0000000
NODE_2862_length_1360_cov_12.763680	582	662	0	25	80	0.3125000
NODE_2862_length_1360_cov_12.763680	582	662	4	2	80	0.0250000
NODE_2862_length_1360_cov_12.763680	582	662	6	11	80	0.1375000
NODE_2862_length_1360_cov_12.763680	582	662	8	42	80	0.5250000
NODE_2862_length_1360_cov_12.763680	635	715	2	23	80	0.2875000
NODE_2862_length_1360_cov_12.763680	635	715	6	25	80	0.3125000
NODE_2862_length_1360_cov_12.763680	635	715	8	32	80	0.4000000
NODE_2866_length_1359_cov_41.324603	674	754	0	34	80	0.4250000
NODE_2866_length_1359_cov_41.324603	674	754	1	46	80	0.5750000
NODE_2866_length_1359_cov_41.324603	727	807	1	43	80	0.5375000
NODE_2866_length_1359_cov_41.324603	727	807	5	18	80	0.2250000
NODE_2866_length_1359_cov_41.324603	727	807	6	19	80	0.2375000
NODE_2866_length_1359_cov_41.324603	803	883	6	7	80	0.0875000
NODE_2866_length_1359_cov_41.324603	803	883	11	25	80	0.3125000
NODE_2866_length_1359_cov_41.324603	803	883	12	2	80	0.0250000
NODE_2866_length_1359_cov_41.324603	803	883	14	26	80	0.3250000
NODE_2866_length_1359_cov_41.324603	803	883	16	20	80	0.2500000
NODE_2866_length_1359_cov_41.324603	856	936	1	19	80	0.2375000
NODE_2866_length_1359_cov_41.324603	856	936	3	24	80	0.3000000
NODE_2866_length_1359_cov_41.324603	856	936	11	35	80	0.4375000
NODE_2866_length_1359_cov_41.324603	856	936	12	2	80	0.0250000
NODE_2871_length_1358_cov_23.427323	292	372	0	13	80	0.1625000
NODE_2871_length_1358_cov_23.427323	292	372	6	20	80	0.2500000
NODE_2871_length_1358_cov_23.427323	292	372	8	47	80	0.5875000
NODE_2871_length_1358_cov_23.427323	345	425	6	25	80	0.3125000
NODE_2871_length_1358_cov_23.427323	345	425	8	55	80	0.6875000
NODE_2872_length_1358_cov_19.489277	411	491	0	46	80	0.5750000
NODE_2872_length_1358_cov_19.489277	411	491	2	34	80	0.4250000
NODE_2872_length_1358_cov_19.489277	464	544	2	80	80	1.0000000
NODE_2875_length_1357_cov_15.962639	732	812	0	80	80	1.0000000
NODE_2875_length_1357_cov_15.962639	785	865	0	80	80	1.0000000
NODE_2879_length_1354_cov_9.854980	735	815	0	15	80	0.1875000
NODE_2879_length_1354_cov_9.854980	735	815	4	65	80	0.8125000
NODE_2879_length_1354_cov_9.854980	788	868	2	4	80	0.0500000
NODE_2879_length_1354_cov_9.854980	788	868	4	76	80	0.9500000
NODE_2882_length_1353_cov_32.982456	708	788	0	35	80	0.4375000
NODE_2882_length_1353_cov_32.982456	708	788	2	13	80	0.1625000
NODE_2882_length_1353_cov_32.982456	708	788	7	1	80	0.0125000
NODE_2882_length_1353_cov_32.982456	708	788	8	31	80	0.3875000
NODE_2882_length_1353_cov_32.982456	761	841	0	2	80	0.0250000
NODE_2882_length_1353_cov_32.982456	761	841	6	11	80	0.1375000
NODE_2882_length_1353_cov_32.982456	761	841	8	67	80	0.8375000
NODE_2883_length_1353_cov_21.775120	493	573	0	27	80	0.3375000
NODE_2883_length_1353_cov_21.775120	493	573	2	53	80	0.6625000
NODE_2883_length_1353_cov_21.775120	546	626	0	48	80	0.6000000
NODE_2883_length_1353_cov_21.775120	546	626	2	32	80	0.4000000
NODE_2884_length_1353_cov_18.201754	696	776	2	24	80	0.3000000
NODE_2884_length_1353_cov_18.201754	696	776	4	56	80	0.7000000
NODE_2884_length_1353_cov_18.201754	749	829	0	12	80	0.1500000
NODE_2884_length_1353_cov_18.201754	749	829	2	65	80	0.8125000
NODE_2884_length_1353_cov_18.201754	749	829	4	3	80	0.0375000
NODE_2888_length_1352_cov_26.942538	455	535	0	1	80	0.0125000
NODE_2888_length_1352_cov_26.942538	455	535	6	12	80	0.1500000
NODE_2888_length_1352_cov_26.942538	455	535	12	3	80	0.0375000
NODE_2888_length_1352_cov_26.942538	455	535	16	64	80	0.8000000
NODE_2888_length_1352_cov_26.942538	508	588	0	48	80	0.6000000
NODE_2888_length_1352_cov_26.942538	508	588	2	6	80	0.0750000
NODE_2888_length_1352_cov_26.942538	508	588	6	12	80	0.1500000
NODE_2888_length_1352_cov_26.942538	508	588	12	3	80	0.0375000
NODE_2888_length_1352_cov_26.942538	508	588	16	11	80	0.1375000
NODE_2889_length_1352_cov_17.189944	717	797	4	80	80	1.0000000
NODE_2889_length_1352_cov_17.189944	770	850	0	21	80	0.2625000
NODE_2889_length_1352_cov_17.189944	770	850	2	3	80	0.0375000
NODE_2889_length_1352_cov_17.189944	770	850	4	56	80	0.7000000
NODE_2890_length_1352_cov_15.752594	640	720	0	80	80	1.0000000
NODE_2890_length_1352_cov_15.752594	693	773	0	80	80	1.0000000
NODE_2891_length_1352_cov_10.699920	237	317	0	80	80	1.0000000
NODE_2891_length_1352_cov_10.699920	290	370	0	80	80	1.0000000
NODE_2894_length_1351_cov_32.325879	561	641	0	2	80	0.0250000
NODE_2894_length_1351_cov_32.325879	561	641	5	1	80	0.0125000
NODE_2894_length_1351_cov_32.325879	561	641	7	10	80	0.1250000
NODE_2894_length_1351_cov_32.325879	561	641	13	1	80	0.0125000
NODE_2894_length_1351_cov_32.325879	561	641	14	9	80	0.1125000
NODE_2894_length_1351_cov_32.325879	561	641	18	7	80	0.0875000
NODE_2894_length_1351_cov_32.325879	561	641	19	16	80	0.2000000
NODE_2894_length_1351_cov_32.325879	561	641	20	34	80	0.4250000
NODE_2894_length_1351_cov_32.325879	614	694	17	20	80	0.2500000
NODE_2894_length_1351_cov_32.325879	614	694	19	49	80	0.6125000
NODE_2894_length_1351_cov_32.325879	614	694	20	11	80	0.1375000
NODE_2895_length_1351_cov_16.861022	97	162	29	1	65	0.0153846
NODE_2895_length_1351_cov_16.861022	97	162	31	2	65	0.0307692
NODE_2895_length_1351_cov_16.861022	97	162	35	2	65	0.0307692
NODE_2895_length_1351_cov_16.861022	97	162	43	1	65	0.0153846
NODE_2895_length_1351_cov_16.861022	97	162	55	1	65	0.0153846
NODE_2895_length_1351_cov_16.861022	97	162	58	1	65	0.0153846
NODE_2895_length_1351_cov_16.861022	97	162	62	2	65	0.0307692
NODE_2895_length_1351_cov_16.861022	97	162	65	1	65	0.0153846
NODE_2895_length_1351_cov_16.861022	97	162	69	2	65	0.0307692
NODE_2895_length_1351_cov_16.861022	97	162	73	2	65	0.0307692
NODE_2895_length_1351_cov_16.861022	97	162	75	41	65	0.6307693
NODE_2895_length_1351_cov_16.861022	97	162	77	9	65	0.1384615
NODE_2896_length_1351_cov_9.894569	331	411	0	35	80	0.4375000
NODE_2896_length_1351_cov_9.894569	331	411	4	45	80	0.5625000
NODE_2896_length_1351_cov_9.894569	384	464	0	10	80	0.1250000
NODE_2896_length_1351_cov_9.894569	384	464	4	70	80	0.8750000
NODE_2897_length_1351_cov_8.699681	1055	1137	0	17	82	0.2073171
NODE_2897_length_1351_cov_8.699681	1055	1137	2	58	82	0.7073171
NODE_2897_length_1351_cov_8.699681	1055	1137	8	7	82	0.0853659
NODE_2897_length_1351_cov_8.699681	1110	1175	2	65	65	1.0000000
NODE_2898_length_1351_cov_2.931310	68	148	31	6	80	0.0750000
NODE_2898_length_1351_cov_2.931310	68	148	35	2	80	0.0250000
NODE_2898_length_1351_cov_2.931310	68	148	41	3	80	0.0375000
NODE_2898_length_1351_cov_2.931310	68	148	44	9	80	0.1125000
NODE_2898_length_1351_cov_2.931310	68	148	46	4	80	0.0500000
NODE_2898_length_1351_cov_2.931310	68	148	48	2	80	0.0250000
NODE_2898_length_1351_cov_2.931310	68	148	50	2	80	0.0250000
NODE_2898_length_1351_cov_2.931310	68	148	51	5	80	0.0625000
NODE_2898_length_1351_cov_2.931310	68	148	52	4	80	0.0500000
NODE_2898_length_1351_cov_2.931310	68	148	53	7	80	0.0875000
NODE_2898_length_1351_cov_2.931310	68	148	54	8	80	0.1000000
NODE_2898_length_1351_cov_2.931310	68	148	55	11	80	0.1375000
NODE_2898_length_1351_cov_2.931310	68	148	56	1	80	0.0125000
NODE_2898_length_1351_cov_2.931310	68	148	57	5	80	0.0625000
NODE_2898_length_1351_cov_2.931310	68	148	59	6	80	0.0750000
NODE_2898_length_1351_cov_2.931310	68	148	63	2	80	0.0250000
NODE_2898_length_1351_cov_2.931310	68	148	65	2	80	0.0250000
NODE_2898_length_1351_cov_2.931310	68	148	67	1	80	0.0125000
NODE_2898_length_1351_cov_2.931310	495	528	0	33	33	1.0000000
NODE_2899_length_1350_cov_18.274181	424	504	0	69	80	0.8625000
NODE_2899_length_1350_cov_18.274181	424	504	2	11	80	0.1375000
NODE_2899_length_1350_cov_18.274181	477	557	0	16	80	0.2000000
NODE_2899_length_1350_cov_18.274181	477	557	2	64	80	0.8000000
NODE_2899_length_1350_cov_18.274181	553	633	2	27	80	0.3375000
NODE_2899_length_1350_cov_18.274181	553	633	4	21	80	0.2625000
NODE_2899_length_1350_cov_18.274181	553	633	6	32	80	0.4000000
NODE_2899_length_1350_cov_18.274181	606	686	0	11	80	0.1375000
NODE_2899_length_1350_cov_18.274181	606	686	2	2	80	0.0250000
NODE_2899_length_1350_cov_18.274181	606	686	4	48	80	0.6000000
NODE_2899_length_1350_cov_18.274181	606	686	6	19	80	0.2375000
NODE_2900_length_1350_cov_8.053557	737	817	0	80	80	1.0000000
NODE_2900_length_1350_cov_8.053557	790	870	0	80	80	1.0000000
NODE_2903_length_1349_cov_23.782400	839	919	0	21	80	0.2625000
NODE_2903_length_1349_cov_23.782400	839	919	2	59	80	0.7375000
NODE_2903_length_1349_cov_23.782400	892	972	0	14	80	0.1750000
NODE_2903_length_1349_cov_23.782400	892	972	2	66	80	0.8250000
NODE_2903_length_1349_cov_23.782400	968	1048	0	80	80	1.0000000
NODE_2903_length_1349_cov_23.782400	1021	1101	0	80	80	1.0000000
NODE_2904_length_1349_cov_17.776800	811	891	4	35	80	0.4375000
NODE_2904_length_1349_cov_17.776800	811	891	5	45	80	0.5625000
NODE_2904_length_1349_cov_17.776800	864	944	0	30	80	0.3750000
NODE_2904_length_1349_cov_17.776800	864	944	2	1	80	0.0125000
NODE_2904_length_1349_cov_17.776800	864	944	4	13	80	0.1625000
NODE_2904_length_1349_cov_17.776800	864	944	5	36	80	0.4500000
NODE_2905_length_1349_cov_16.468800	828	908	0	37	80	0.4625000
NODE_2905_length_1349_cov_16.468800	828	908	2	43	80	0.5375000
NODE_2905_length_1349_cov_16.468800	881	961	0	7	80	0.0875000
NODE_2905_length_1349_cov_16.468800	881	961	2	73	80	0.9125000
NODE_2908_length_1348_cov_22.731785	468	548	0	19	80	0.2375000
NODE_2908_length_1348_cov_22.731785	468	548	2	61	80	0.7625000
NODE_2908_length_1348_cov_22.731785	521	601	0	37	80	0.4625000
NODE_2908_length_1348_cov_22.731785	521	601	2	43	80	0.5375000
NODE_2909_length_1348_cov_20.778223	517	597	0	80	80	1.0000000
NODE_2909_length_1348_cov_20.778223	570	650	0	80	80	1.0000000
NODE_2910_length_1348_cov_11.180144	673	753	0	22	80	0.2750000
NODE_2910_length_1348_cov_11.180144	673	753	4	29	80	0.3625000
NODE_2910_length_1348_cov_11.180144	673	753	6	29	80	0.3625000
NODE_2910_length_1348_cov_11.180144	726	806	2	4	80	0.0500000
NODE_2910_length_1348_cov_11.180144	726	806	6	69	80	0.8625000
NODE_2910_length_1348_cov_11.180144	726	806	8	7	80	0.0875000
NODE_2916_length_1347_cov_45.906250	683	763	2	31	80	0.3875000
NODE_2916_length_1347_cov_45.906250	683	763	4	49	80	0.6125000
NODE_2916_length_1347_cov_45.906250	736	816	2	58	80	0.7250000
NODE_2916_length_1347_cov_45.906250	736	816	4	22	80	0.2750000
NODE_2916_length_1347_cov_45.906250	812	892	0	15	80	0.1875000
NODE_2916_length_1347_cov_45.906250	812	892	2	22	80	0.2750000
NODE_2916_length_1347_cov_45.906250	812	892	4	13	80	0.1625000
NODE_2916_length_1347_cov_45.906250	812	892	8	30	80	0.3750000
NODE_2916_length_1347_cov_45.906250	865	945	4	12	80	0.1500000
NODE_2916_length_1347_cov_45.906250	865	945	8	68	80	0.8500000
NODE_2917_length_1347_cov_41.643429	439	519	6	20	80	0.2500000
NODE_2917_length_1347_cov_41.643429	439	519	8	9	80	0.1125000
NODE_2917_length_1347_cov_41.643429	439	519	10	12	80	0.1500000
NODE_2917_length_1347_cov_41.643429	439	519	12	38	80	0.4750000
NODE_2917_length_1347_cov_41.643429	439	519	14	1	80	0.0125000
NODE_2917_length_1347_cov_41.643429	492	572	0	16	80	0.2000000
NODE_2917_length_1347_cov_41.643429	492	572	2	5	80	0.0625000
NODE_2917_length_1347_cov_41.643429	492	572	3	16	80	0.2000000
NODE_2917_length_1347_cov_41.643429	492	572	4	14	80	0.1750000
NODE_2917_length_1347_cov_41.643429	492	572	6	22	80	0.2750000
NODE_2917_length_1347_cov_41.643429	492	572	8	7	80	0.0875000
NODE_2918_length_1347_cov_19.941506	458	538	0	46	80	0.5750000
NODE_2918_length_1347_cov_19.941506	458	538	2	34	80	0.4250000
NODE_2918_length_1347_cov_19.941506	511	591	0	66	80	0.8250000
NODE_2918_length_1347_cov_19.941506	511	591	2	14	80	0.1750000
NODE_2918_length_1347_cov_19.941506	587	667	2	80	80	1.0000000
NODE_2918_length_1347_cov_19.941506	640	720	0	40	80	0.5000000
NODE_2918_length_1347_cov_19.941506	640	720	2	40	80	0.5000000
NODE_2919_length_1347_cov_16.520833	713	793	0	80	80	1.0000000
NODE_2919_length_1347_cov_16.520833	766	846	0	80	80	1.0000000
NODE_2920_length_1347_cov_15.967147	638	718	0	58	80	0.7250000
NODE_2920_length_1347_cov_15.967147	638	718	2	22	80	0.2750000
NODE_2920_length_1347_cov_15.967147	691	771	0	80	80	1.0000000
NODE_2925_length_1346_cov_13.112269	429	509	4	14	80	0.1750000
NODE_2925_length_1346_cov_13.112269	429	509	6	1	80	0.0125000
NODE_2925_length_1346_cov_13.112269	429	509	8	65	80	0.8125000
NODE_2925_length_1346_cov_13.112269	482	562	2	44	80	0.5500000
NODE_2925_length_1346_cov_13.112269	482	562	4	14	80	0.1750000
NODE_2925_length_1346_cov_13.112269	482	562	6	10	80	0.1250000
NODE_2925_length_1346_cov_13.112269	482	562	8	12	80	0.1500000
NODE_2928_length_1345_cov_32.099518	629	709	0	29	80	0.3625000
NODE_2928_length_1345_cov_32.099518	629	709	2	16	80	0.2000000
NODE_2928_length_1345_cov_32.099518	629	709	4	35	80	0.4375000
NODE_2928_length_1345_cov_32.099518	682	762	2	25	80	0.3125000
NODE_2928_length_1345_cov_32.099518	682	762	4	55	80	0.6875000
NODE_2929_length_1345_cov_19.837881	723	803	0	80	80	1.0000000
NODE_2929_length_1345_cov_19.837881	776	856	0	80	80	1.0000000
NODE_2930_length_1345_cov_14.262440	361	441	0	80	80	1.0000000
NODE_2930_length_1345_cov_14.262440	414	494	0	80	80	1.0000000
NODE_2930_length_1345_cov_14.262440	490	570	0	80	80	1.0000000
NODE_2930_length_1345_cov_14.262440	543	623	0	80	80	1.0000000
NODE_2931_length_1345_cov_14.103531	950	1030	6	5	80	0.0625000
NODE_2931_length_1345_cov_14.103531	950	1030	8	17	80	0.2125000
NODE_2931_length_1345_cov_14.103531	950	1030	9	3	80	0.0375000
NODE_2931_length_1345_cov_14.103531	950	1030	10	41	80	0.5125000
NODE_2931_length_1345_cov_14.103531	950	1030	12	14	80	0.1750000
NODE_2931_length_1345_cov_14.103531	1003	1083	6	51	80	0.6375000
NODE_2931_length_1345_cov_14.103531	1003	1083	9	1	80	0.0125000
NODE_2931_length_1345_cov_14.103531	1003	1083	10	28	80	0.3500000
NODE_2934_length_1344_cov_15.013655	345	425	0	50	80	0.6250000
NODE_2934_length_1344_cov_15.013655	345	425	6	30	80	0.3750000
NODE_2934_length_1344_cov_15.013655	398	478	6	80	80	1.0000000
NODE_2935_length_1344_cov_11.383133	519	599	0	80	80	1.0000000
NODE_2935_length_1344_cov_11.383133	572	652	0	80	80	1.0000000
NODE_2935_length_1344_cov_11.383133	648	728	0	22	80	0.2750000
NODE_2935_length_1344_cov_11.383133	648	728	2	58	80	0.7250000
NODE_2935_length_1344_cov_11.383133	701	781	0	43	80	0.5375000
NODE_2935_length_1344_cov_11.383133	701	781	2	37	80	0.4625000
NODE_2936_length_1344_cov_10.924498	529	609	0	12	80	0.1500000
NODE_2936_length_1344_cov_10.924498	529	609	1	15	80	0.1875000
NODE_2936_length_1344_cov_10.924498	529	609	2	53	80	0.6625000
NODE_2936_length_1344_cov_10.924498	582	662	2	80	80	1.0000000
NODE_2937_length_1344_cov_5.531727	920	975	0	55	55	1.0000000
NODE_2942_length_1343_cov_36.005627	150	230	24	7	80	0.0875000
NODE_2942_length_1343_cov_36.005627	150	230	26	3	80	0.0375000
NODE_2942_length_1343_cov_36.005627	150	230	27	1	80	0.0125000
NODE_2942_length_1343_cov_36.005627	150	230	28	1	80	0.0125000
NODE_2942_length_1343_cov_36.005627	150	230	30	9	80	0.1125000
NODE_2942_length_1343_cov_36.005627	150	230	32	5	80	0.0625000
NODE_2942_length_1343_cov_36.005627	150	230	34	12	80	0.1500000
NODE_2942_length_1343_cov_36.005627	150	230	36	4	80	0.0500000
NODE_2942_length_1343_cov_36.005627	150	230	38	19	80	0.2375000
NODE_2942_length_1343_cov_36.005627	150	230	40	6	80	0.0750000
NODE_2942_length_1343_cov_36.005627	150	230	42	5	80	0.0625000
NODE_2942_length_1343_cov_36.005627	150	230	44	8	80	0.1000000
NODE_2942_length_1343_cov_36.005627	286	366	0	1	80	0.0125000
NODE_2942_length_1343_cov_36.005627	286	366	4	79	80	0.9875000
NODE_2942_length_1343_cov_36.005627	339	419	0	21	80	0.2625000
NODE_2942_length_1343_cov_36.005627	339	419	4	59	80	0.7375000
NODE_2942_length_1343_cov_36.005627	415	495	0	33	80	0.4125000
NODE_2942_length_1343_cov_36.005627	415	495	2	1	80	0.0125000
NODE_2942_length_1343_cov_36.005627	415	495	3	46	80	0.5750000
NODE_2942_length_1343_cov_36.005627	468	548	3	80	80	1.0000000
NODE_2943_length_1343_cov_26.826367	782	862	0	80	80	1.0000000
NODE_2943_length_1343_cov_26.826367	835	915	0	80	80	1.0000000
NODE_2944_length_1343_cov_19.353698	799	879	2	16	80	0.2000000
NODE_2944_length_1343_cov_19.353698	799	879	4	3	80	0.0375000
NODE_2944_length_1343_cov_19.353698	799	879	6	61	80	0.7625000
NODE_2944_length_1343_cov_19.353698	852	932	0	36	80	0.4500000
NODE_2944_length_1343_cov_19.353698	852	932	2	22	80	0.2750000
NODE_2944_length_1343_cov_19.353698	852	932	4	2	80	0.0250000
NODE_2944_length_1343_cov_19.353698	852	932	6	20	80	0.2500000
NODE_2944_length_1343_cov_19.353698	928	1008	0	52	80	0.6500000
NODE_2944_length_1343_cov_19.353698	928	1008	2	16	80	0.2000000
NODE_2944_length_1343_cov_19.353698	928	1008	4	12	80	0.1500000
NODE_2944_length_1343_cov_19.353698	981	1061	2	27	80	0.3375000
NODE_2944_length_1343_cov_19.353698	981	1061	4	53	80	0.6625000
NODE_2945_length_1343_cov_15.717846	745	825	0	80	80	1.0000000
NODE_2945_length_1343_cov_15.717846	798	878	0	80	80	1.0000000
NODE_2949_length_1342_cov_30.491553	456	536	2	5	80	0.0625000
NODE_2949_length_1342_cov_30.491553	456	536	6	50	80	0.6250000
NODE_2949_length_1342_cov_30.491553	456	536	8	25	80	0.3125000
NODE_2949_length_1342_cov_30.491553	509	589	6	28	80	0.3500000
NODE_2949_length_1342_cov_30.491553	509	589	8	21	80	0.2625000
NODE_2949_length_1342_cov_30.491553	509	589	11	1	80	0.0125000
NODE_2949_length_1342_cov_30.491553	509	589	12	22	80	0.2750000
NODE_2949_length_1342_cov_30.491553	509	589	18	8	80	0.1000000
NODE_2949_length_1342_cov_30.491553	585	665	12	23	80	0.2875000
NODE_2949_length_1342_cov_30.491553	585	665	13	1	80	0.0125000
NODE_2949_length_1342_cov_30.491553	585	665	14	6	80	0.0750000
NODE_2949_length_1342_cov_30.491553	585	665	16	33	80	0.4125000
NODE_2949_length_1342_cov_30.491553	585	665	18	17	80	0.2125000
NODE_2949_length_1342_cov_30.491553	638	718	2	5	80	0.0625000
NODE_2949_length_1342_cov_30.491553	638	718	4	5	80	0.0625000
NODE_2949_length_1342_cov_30.491553	638	718	6	2	80	0.0250000
NODE_2949_length_1342_cov_30.491553	638	718	12	53	80	0.6625000
NODE_2949_length_1342_cov_30.491553	638	718	16	15	80	0.1875000
NODE_2950_length_1342_cov_26.796460	538	618	4	15	80	0.1875000
NODE_2950_length_1342_cov_26.796460	538	618	6	11	80	0.1375000
NODE_2950_length_1342_cov_26.796460	538	618	8	36	80	0.4500000
NODE_2950_length_1342_cov_26.796460	538	618	10	18	80	0.2250000
NODE_2950_length_1342_cov_26.796460	591	671	0	40	80	0.5000000
NODE_2950_length_1342_cov_26.796460	591	671	2	1	80	0.0125000
NODE_2950_length_1342_cov_26.796460	591	671	4	27	80	0.3375000
NODE_2950_length_1342_cov_26.796460	591	671	8	12	80	0.1500000
NODE_2950_length_1342_cov_26.796460	667	747	0	80	80	1.0000000
NODE_2950_length_1342_cov_26.796460	720	800	0	80	80	1.0000000
NODE_2951_length_1342_cov_22.769912	298	378	2	19	80	0.2375000
NODE_2951_length_1342_cov_22.769912	298	378	8	1	80	0.0125000
NODE_2951_length_1342_cov_22.769912	298	378	9	32	80	0.4000000
NODE_2951_length_1342_cov_22.769912	298	378	10	13	80	0.1625000
NODE_2951_length_1342_cov_22.769912	298	378	12	15	80	0.1875000
NODE_2951_length_1342_cov_22.769912	351	431	10	22	80	0.2750000
NODE_2951_length_1342_cov_22.769912	351	431	11	6	80	0.0750000
NODE_2951_length_1342_cov_22.769912	351	431	12	52	80	0.6500000
NODE_2951_length_1342_cov_22.769912	427	507	0	70	80	0.8750000
NODE_2951_length_1342_cov_22.769912	427	507	7	1	80	0.0125000
NODE_2951_length_1342_cov_22.769912	427	507	8	1	80	0.0125000
NODE_2951_length_1342_cov_22.769912	427	507	10	8	80	0.1000000
NODE_2951_length_1342_cov_22.769912	480	560	0	80	80	1.0000000
NODE_2953_length_1341_cov_22.449275	494	574	0	17	80	0.2125000
NODE_2953_length_1341_cov_22.449275	494	574	2	63	80	0.7875000
NODE_2953_length_1341_cov_22.449275	547	627	0	70	80	0.8750000
NODE_2953_length_1341_cov_22.449275	547	627	2	10	80	0.1250000
NODE_2953_length_1341_cov_22.449275	623	703	0	80	80	1.0000000
NODE_2953_length_1341_cov_22.449275	676	755	0	79	79	1.0000000
NODE_2954_length_1341_cov_14.497585	415	495	0	8	80	0.1000000
NODE_2954_length_1341_cov_14.497585	415	495	2	16	80	0.2000000
NODE_2954_length_1341_cov_14.497585	415	495	3	35	80	0.4375000
NODE_2954_length_1341_cov_14.497585	415	495	4	21	80	0.2625000
NODE_2954_length_1341_cov_14.497585	468	548	2	13	80	0.1625000
NODE_2954_length_1341_cov_14.497585	468	548	3	6	80	0.0750000
NODE_2954_length_1341_cov_14.497585	468	548	4	52	80	0.6500000
NODE_2954_length_1341_cov_14.497585	468	548	6	7	80	0.0875000
NODE_2954_length_1341_cov_14.497585	468	548	8	2	80	0.0250000
NODE_2954_length_1341_cov_14.497585	544	624	6	2	80	0.0250000
NODE_2954_length_1341_cov_14.497585	544	624	8	31	80	0.3875000
NODE_2954_length_1341_cov_14.497585	544	624	9	11	80	0.1375000
NODE_2954_length_1341_cov_14.497585	544	624	11	25	80	0.3125000
NODE_2954_length_1341_cov_14.497585	544	624	12	11	80	0.1375000
NODE_2954_length_1341_cov_14.497585	597	677	2	9	80	0.1125000
NODE_2954_length_1341_cov_14.497585	597	677	4	4	80	0.0500000
NODE_2954_length_1341_cov_14.497585	597	677	6	26	80	0.3250000
NODE_2954_length_1341_cov_14.497585	597	677	8	14	80	0.1750000
NODE_2954_length_1341_cov_14.497585	597	677	9	11	80	0.1375000
NODE_2954_length_1341_cov_14.497585	597	677	11	16	80	0.2000000
NODE_2960_length_1340_cov_9.460113	531	611	0	4	80	0.0500000
NODE_2960_length_1340_cov_9.460113	531	611	4	20	80	0.2500000
NODE_2960_length_1340_cov_9.460113	531	611	8	56	80	0.7000000
NODE_2960_length_1340_cov_9.460113	584	664	0	8	80	0.1000000
NODE_2960_length_1340_cov_9.460113	584	664	4	26	80	0.3250000
NODE_2960_length_1340_cov_9.460113	584	664	8	46	80	0.5750000
NODE_2961_length_1340_cov_6.511684	735	815	2	51	80	0.6375000
NODE_2961_length_1340_cov_6.511684	735	815	4	29	80	0.3625000
NODE_2961_length_1340_cov_6.511684	788	868	2	32	80	0.4000000
NODE_2961_length_1340_cov_6.511684	788	868	4	48	80	0.6000000
NODE_2966_length_1339_cov_22.725000	751	831	0	80	80	1.0000000
NODE_2966_length_1339_cov_22.725000	804	884	0	80	80	1.0000000
NODE_2967_length_1339_cov_9.322581	329	409	2	6	80	0.0750000
NODE_2967_length_1339_cov_9.322581	329	409	4	74	80	0.9250000
NODE_2967_length_1339_cov_9.322581	382	462	0	12	80	0.1500000
NODE_2967_length_1339_cov_9.322581	382	462	2	39	80	0.4875000
NODE_2967_length_1339_cov_9.322581	382	462	4	29	80	0.3625000
NODE_2970_length_1338_cov_31.740920	527	607	0	80	80	1.0000000
NODE_2970_length_1338_cov_31.740920	580	660	0	80	80	1.0000000
NODE_2970_length_1338_cov_31.740920	656	736	0	80	80	1.0000000
NODE_2970_length_1338_cov_31.740920	709	789	0	80	80	1.0000000
NODE_2971_length_1338_cov_21.254237	639	719	0	80	80	1.0000000
NODE_2971_length_1338_cov_21.254237	692	772	0	80	80	1.0000000
NODE_2974_length_1337_cov_32.307754	739	819	11	11	80	0.1375000
NODE_2974_length_1337_cov_32.307754	739	819	13	22	80	0.2750000
NODE_2974_length_1337_cov_32.307754	739	819	15	2	80	0.0250000
NODE_2974_length_1337_cov_32.307754	739	819	18	7	80	0.0875000
NODE_2974_length_1337_cov_32.307754	739	819	20	1	80	0.0125000
NODE_2974_length_1337_cov_32.307754	739	819	21	7	80	0.0875000
NODE_2974_length_1337_cov_32.307754	739	819	23	8	80	0.1000000
NODE_2974_length_1337_cov_32.307754	739	819	25	22	80	0.2750000
NODE_2974_length_1337_cov_32.307754	792	872	21	6	80	0.0750000
NODE_2974_length_1337_cov_32.307754	792	872	22	1	80	0.0125000
NODE_2974_length_1337_cov_32.307754	792	872	23	35	80	0.4375000
NODE_2974_length_1337_cov_32.307754	792	872	24	1	80	0.0125000
NODE_2974_length_1337_cov_32.307754	792	872	25	19	80	0.2375000
NODE_2974_length_1337_cov_32.307754	792	872	26	18	80	0.2250000
NODE_2975_length_1337_cov_30.412763	465	545	0	8	80	0.1000000
NODE_2975_length_1337_cov_30.412763	465	545	4	12	80	0.1500000
NODE_2975_length_1337_cov_30.412763	465	545	6	60	80	0.7500000
NODE_2975_length_1337_cov_30.412763	518	598	0	21	80	0.2625000
NODE_2975_length_1337_cov_30.412763	518	598	3	5	80	0.0625000
NODE_2975_length_1337_cov_30.412763	518	598	4	29	80	0.3625000
NODE_2975_length_1337_cov_30.412763	518	598	6	25	80	0.3125000
NODE_2976_length_1337_cov_12.760905	560	640	2	80	80	1.0000000
NODE_2976_length_1337_cov_12.760905	613	693	0	41	80	0.5125000
NODE_2976_length_1337_cov_12.760905	613	693	2	39	80	0.4875000
NODE_2977_length_1337_cov_9.463651	724	804	0	13	80	0.1625000
NODE_2977_length_1337_cov_9.463651	724	804	2	67	80	0.8375000
NODE_2977_length_1337_cov_9.463651	777	857	0	43	80	0.5375000
NODE_2977_length_1337_cov_9.463651	777	857	2	37	80	0.4625000
NODE_2979_length_1337_cov_4.540388	216	296	0	80	80	1.0000000
NODE_2979_length_1337_cov_4.540388	272	349	0	77	77	1.0000000
NODE_2981_length_1336_cov_28.161681	394	474	0	21	80	0.2625000
NODE_2981_length_1336_cov_28.161681	394	474	2	59	80	0.7375000
NODE_2981_length_1336_cov_28.161681	447	527	0	74	80	0.9250000
NODE_2981_length_1336_cov_28.161681	447	527	2	6	80	0.0750000
NODE_2981_length_1336_cov_28.161681	523	603	0	80	80	1.0000000
NODE_2981_length_1336_cov_28.161681	576	656	0	80	80	1.0000000
NODE_2982_length_1336_cov_7.860954	17	98	35	8	81	0.0987654
NODE_2982_length_1336_cov_7.860954	17	98	36	8	81	0.0987654
NODE_2982_length_1336_cov_7.860954	17	98	37	65	81	0.8024691
NODE_2984_length_1336_cov_1.689572	1229	1289	4	3	60	0.0500000
NODE_2984_length_1336_cov_1.689572	1229	1289	6	57	60	0.9500000
NODE_2984_length_1336_cov_1.689572	1262	1336	0	27	74	0.3648649
NODE_2984_length_1336_cov_1.689572	1262	1336	2	3	74	0.0405405
NODE_2984_length_1336_cov_1.689572	1262	1336	4	4	74	0.0540541
NODE_2984_length_1336_cov_1.689572	1262	1336	6	40	74	0.5405405
NODE_2985_length_1335_cov_19.547735	530	607	0	25	77	0.3246753
NODE_2985_length_1335_cov_19.547735	530	607	2	52	77	0.6753247
NODE_2985_length_1335_cov_19.547735	582	660	2	78	78	1.0000000
NODE_2985_length_1335_cov_19.547735	656	736	2	49	80	0.6125000
NODE_2985_length_1335_cov_19.547735	656	736	4	31	80	0.3875000
NODE_2985_length_1335_cov_19.547735	709	789	2	48	80	0.6000000
NODE_2985_length_1335_cov_19.547735	709	789	4	32	80	0.4000000
NODE_2986_length_1335_cov_15.383495	419	499	0	80	80	1.0000000
NODE_2986_length_1335_cov_15.383495	472	552	0	80	80	1.0000000
NODE_2986_length_1335_cov_15.383495	548	628	0	80	80	1.0000000
NODE_2986_length_1335_cov_15.383495	601	681	0	80	80	1.0000000
NODE_2991_length_1333_cov_27.372771	493	573	0	29	80	0.3625000
NODE_2991_length_1333_cov_27.372771	493	573	1	1	80	0.0125000
NODE_2991_length_1333_cov_27.372771	493	573	2	29	80	0.3625000
NODE_2991_length_1333_cov_27.372771	493	573	4	21	80	0.2625000
NODE_2991_length_1333_cov_27.372771	546	626	2	6	80	0.0750000
NODE_2991_length_1333_cov_27.372771	546	626	4	74	80	0.9250000
NODE_2996_length_1332_cov_18.978913	648	728	0	80	80	1.0000000
NODE_2996_length_1332_cov_18.978913	701	781	0	80	80	1.0000000
NODE_2996_length_1332_cov_18.978913	777	857	0	80	80	1.0000000
NODE_2996_length_1332_cov_18.978913	830	910	0	61	80	0.7625000
NODE_2996_length_1332_cov_18.978913	830	910	2	19	80	0.2375000
NODE_2997_length_1332_cov_3.112733	87	151	10	4	64	0.0625000
NODE_2997_length_1332_cov_3.112733	87	151	11	5	64	0.0781250
NODE_2997_length_1332_cov_3.112733	87	151	12	8	64	0.1250000
NODE_2997_length_1332_cov_3.112733	87	151	13	1	64	0.0156250
NODE_2997_length_1332_cov_3.112733	87	151	14	38	64	0.5937500
NODE_2997_length_1332_cov_3.112733	87	151	30	6	64	0.0937500
NODE_2997_length_1332_cov_3.112733	87	151	31	2	64	0.0312500
NODE_3000_length_1331_cov_16.831981	392	472	19	31	80	0.3875000
NODE_3000_length_1331_cov_16.831981	392	472	20	37	80	0.4625000
NODE_3000_length_1331_cov_16.831981	392	472	21	12	80	0.1500000
NODE_3000_length_1331_cov_16.831981	445	525	6	2	80	0.0250000
NODE_3000_length_1331_cov_16.831981	445	525	7	4	80	0.0500000
NODE_3000_length_1331_cov_16.831981	445	525	9	9	80	0.1125000
NODE_3000_length_1331_cov_16.831981	445	525	11	15	80	0.1875000
NODE_3000_length_1331_cov_16.831981	445	525	16	1	80	0.0125000
NODE_3000_length_1331_cov_16.831981	445	525	17	5	80	0.0625000
NODE_3000_length_1331_cov_16.831981	445	525	19	32	80	0.4000000
NODE_3000_length_1331_cov_16.831981	445	525	21	12	80	0.1500000
NODE_3000_length_1331_cov_16.831981	521	601	0	76	80	0.9500000
NODE_3000_length_1331_cov_16.831981	521	601	6	2	80	0.0250000
NODE_3000_length_1331_cov_16.831981	521	601	7	2	80	0.0250000
NODE_3000_length_1331_cov_16.831981	574	654	0	80	80	1.0000000
NODE_3001_length_1331_cov_12.841721	871	951	0	30	80	0.3750000
NODE_3001_length_1331_cov_12.841721	871	951	2	2	80	0.0250000
NODE_3001_length_1331_cov_12.841721	871	951	9	48	80	0.6000000
NODE_3001_length_1331_cov_12.841721	924	1004	9	62	80	0.7750000
NODE_3001_length_1331_cov_12.841721	924	1004	10	18	80	0.2250000
NODE_3004_length_1331_cov_2.090097	0	76	0	76	76	1.0000000
NODE_3004_length_1331_cov_2.090097	49	98	0	49	49	1.0000000
NODE_3007_length_1330_cov_48.993501	278	358	2	17	80	0.2125000
NODE_3007_length_1330_cov_48.993501	278	358	4	32	80	0.4000000
NODE_3007_length_1330_cov_48.993501	278	358	6	10	80	0.1250000
NODE_3007_length_1330_cov_48.993501	278	358	8	21	80	0.2625000
NODE_3007_length_1330_cov_48.993501	331	411	4	39	80	0.4875000
NODE_3007_length_1330_cov_48.993501	331	411	6	20	80	0.2500000
NODE_3007_length_1330_cov_48.993501	331	411	8	21	80	0.2625000
NODE_3007_length_1330_cov_48.993501	742	822	0	80	80	1.0000000
NODE_3007_length_1330_cov_48.993501	795	875	0	80	80	1.0000000
NODE_3008_length_1330_cov_11.037368	407	487	4	12	80	0.1500000
NODE_3008_length_1330_cov_11.037368	407	487	6	68	80	0.8500000
NODE_3008_length_1330_cov_11.037368	460	540	0	34	80	0.4250000
NODE_3008_length_1330_cov_11.037368	460	540	2	3	80	0.0375000
NODE_3008_length_1330_cov_11.037368	460	540	4	28	80	0.3500000
NODE_3008_length_1330_cov_11.037368	460	540	6	15	80	0.1875000
NODE_3008_length_1330_cov_11.037368	536	617	0	81	81	1.0000000
NODE_3008_length_1330_cov_11.037368	590	670	0	80	80	1.0000000
NODE_3009_length_1330_cov_9.026807	551	631	6	27	80	0.3375000
NODE_3009_length_1330_cov_9.026807	551	631	8	18	80	0.2250000
NODE_3009_length_1330_cov_9.026807	551	631	10	35	80	0.4375000
NODE_3009_length_1330_cov_9.026807	604	684	0	15	80	0.1875000
NODE_3009_length_1330_cov_9.026807	604	684	2	16	80	0.2000000
NODE_3009_length_1330_cov_9.026807	604	684	8	14	80	0.1750000
NODE_3009_length_1330_cov_9.026807	604	684	10	35	80	0.4375000
NODE_3011_length_1329_cov_17.036585	691	771	0	80	80	1.0000000
NODE_3011_length_1329_cov_17.036585	744	824	0	80	80	1.0000000
NODE_3011_length_1329_cov_17.036585	820	900	0	80	80	1.0000000
NODE_3011_length_1329_cov_17.036585	873	953	0	80	80	1.0000000
NODE_3012_length_1329_cov_16.341463	428	476	8	12	48	0.2500000
NODE_3012_length_1329_cov_16.341463	428	476	10	3	48	0.0625000
NODE_3012_length_1329_cov_16.341463	428	476	11	1	48	0.0208333
NODE_3012_length_1329_cov_16.341463	428	476	13	1	48	0.0208333
NODE_3012_length_1329_cov_16.341463	428	476	15	4	48	0.0833333
NODE_3012_length_1329_cov_16.341463	428	476	19	1	48	0.0208333
NODE_3012_length_1329_cov_16.341463	428	476	20	1	48	0.0208333
NODE_3012_length_1329_cov_16.341463	428	476	22	10	48	0.2083333
NODE_3012_length_1329_cov_16.341463	428	476	23	1	48	0.0208333
NODE_3012_length_1329_cov_16.341463	428	476	25	1	48	0.0208333
NODE_3012_length_1329_cov_16.341463	428	476	27	5	48	0.1041667
NODE_3012_length_1329_cov_16.341463	428	476	29	3	48	0.0625000
NODE_3012_length_1329_cov_16.341463	428	476	31	1	48	0.0208333
NODE_3012_length_1329_cov_16.341463	428	476	33	4	48	0.0833333
NODE_3013_length_1329_cov_5.620325	888	955	0	13	67	0.1940299
NODE_3013_length_1329_cov_5.620325	888	955	4	15	67	0.2238806
NODE_3013_length_1329_cov_5.620325	888	955	6	39	67	0.5820895
NODE_3013_length_1329_cov_5.620325	941	999	4	2	58	0.0344828
NODE_3013_length_1329_cov_5.620325	941	999	6	39	58	0.6724138
NODE_3013_length_1329_cov_5.620325	941	999	8	17	58	0.2931035
NODE_3017_length_1328_cov_12.954434	794	874	0	66	80	0.8250000
NODE_3017_length_1328_cov_12.954434	794	874	2	14	80	0.1750000
NODE_3017_length_1328_cov_12.954434	847	927	0	13	80	0.1625000
NODE_3017_length_1328_cov_12.954434	847	927	2	67	80	0.8375000
NODE_3018_length_1328_cov_8.810415	762	842	0	80	80	1.0000000
NODE_3018_length_1328_cov_8.810415	815	895	0	80	80	1.0000000
NODE_3021_length_1327_cov_15.938925	260	340	2	16	80	0.2000000
NODE_3021_length_1327_cov_15.938925	260	340	4	50	80	0.6250000
NODE_3021_length_1327_cov_15.938925	260	340	6	14	80	0.1750000
NODE_3021_length_1327_cov_15.938925	313	393	2	13	80	0.1625000
NODE_3021_length_1327_cov_15.938925	313	393	6	28	80	0.3500000
NODE_3021_length_1327_cov_15.938925	313	393	7	4	80	0.0500000
NODE_3021_length_1327_cov_15.938925	313	393	8	35	80	0.4375000
NODE_3022_length_1327_cov_7.274430	159	235	0	14	76	0.1842105
NODE_3022_length_1327_cov_7.274430	159	235	4	62	76	0.8157895
NODE_3022_length_1327_cov_7.274430	774	854	0	80	80	1.0000000
NODE_3022_length_1327_cov_7.274430	827	890	0	63	63	1.0000000
NODE_3023_length_1327_cov_6.486156	896	976	0	80	80	1.0000000
NODE_3023_length_1327_cov_6.486156	949	1029	0	80	80	1.0000000
NODE_3029_length_1326_cov_32.382233	571	651	0	80	80	1.0000000
NODE_3029_length_1326_cov_32.382233	624	704	0	80	80	1.0000000
NODE_3030_length_1326_cov_30.614507	760	840	2	29	80	0.3625000
NODE_3030_length_1326_cov_30.614507	760	840	3	14	80	0.1750000
NODE_3030_length_1326_cov_30.614507	760	840	4	23	80	0.2875000
NODE_3030_length_1326_cov_30.614507	760	840	6	14	80	0.1750000
NODE_3030_length_1326_cov_30.614507	813	893	2	12	80	0.1500000
NODE_3030_length_1326_cov_30.614507	813	893	4	27	80	0.3375000
NODE_3030_length_1326_cov_30.614507	813	893	6	41	80	0.5125000
NODE_3031_length_1326_cov_30.304808	488	568	2	31	80	0.3875000
NODE_3031_length_1326_cov_30.304808	488	568	4	36	80	0.4500000
NODE_3031_length_1326_cov_30.304808	488	568	6	13	80	0.1625000
NODE_3031_length_1326_cov_30.304808	541	621	0	8	80	0.1000000
NODE_3031_length_1326_cov_30.304808	541	621	2	72	80	0.9000000
NODE_3031_length_1326_cov_30.304808	617	697	0	71	80	0.8875000
NODE_3031_length_1326_cov_30.304808	617	697	2	9	80	0.1125000
NODE_3031_length_1326_cov_30.304808	670	750	0	18	80	0.2250000
NODE_3031_length_1326_cov_30.304808	670	750	2	62	80	0.7750000
NODE_3032_length_1326_cov_10.913610	238	318	0	80	80	1.0000000
NODE_3032_length_1326_cov_10.913610	291	371	0	80	80	1.0000000
NODE_3036_length_1325_cov_38.136215	0	46	0	13	46	0.2826087
NODE_3036_length_1325_cov_38.136215	0	46	3	7	46	0.1521739
NODE_3036_length_1325_cov_38.136215	0	46	5	11	46	0.2391304
NODE_3036_length_1325_cov_38.136215	0	46	6	15	46	0.3260870
NODE_3036_length_1325_cov_38.136215	19	99	3	1	80	0.0125000
NODE_3036_length_1325_cov_38.136215	19	99	5	11	80	0.1375000
NODE_3036_length_1325_cov_38.136215	19	99	6	52	80	0.6500000
NODE_3036_length_1325_cov_38.136215	19	99	8	16	80	0.2000000
NODE_3036_length_1325_cov_38.136215	948	1022	19	18	74	0.2432432
NODE_3036_length_1325_cov_38.136215	948	1022	21	26	74	0.3513514
NODE_3036_length_1325_cov_38.136215	948	1022	22	2	74	0.0270270
NODE_3036_length_1325_cov_38.136215	948	1022	23	14	74	0.1891892
NODE_3036_length_1325_cov_38.136215	948	1022	24	4	74	0.0540541
NODE_3036_length_1325_cov_38.136215	948	1022	26	8	74	0.1081081
NODE_3036_length_1325_cov_38.136215	948	1022	28	1	74	0.0135135
NODE_3036_length_1325_cov_38.136215	948	1022	30	1	74	0.0135135
NODE_3036_length_1325_cov_38.136215	1001	1063	21	5	62	0.0806452
NODE_3036_length_1325_cov_38.136215	1001	1063	22	8	62	0.1290323
NODE_3036_length_1325_cov_38.136215	1001	1063	24	4	62	0.0645161
NODE_3036_length_1325_cov_38.136215	1001	1063	26	8	62	0.1290323
NODE_3036_length_1325_cov_38.136215	1001	1063	28	13	62	0.2096774
NODE_3036_length_1325_cov_38.136215	1001	1063	30	10	62	0.1612903
NODE_3036_length_1325_cov_38.136215	1001	1063	33	2	62	0.0322581
NODE_3036_length_1325_cov_38.136215	1001	1063	35	4	62	0.0645161
NODE_3036_length_1325_cov_38.136215	1001	1063	41	4	62	0.0645161
NODE_3036_length_1325_cov_38.136215	1001	1063	44	4	62	0.0645161
NODE_3037_length_1325_cov_29.201468	613	693	0	80	80	1.0000000
NODE_3037_length_1325_cov_29.201468	666	746	0	80	80	1.0000000
NODE_3038_length_1325_cov_11.902121	697	777	0	80	80	1.0000000
NODE_3038_length_1325_cov_11.902121	750	830	0	80	80	1.0000000
NODE_3039_length_1325_cov_7.876835	645	725	2	80	80	1.0000000
NODE_3039_length_1325_cov_7.876835	698	778	0	34	80	0.4250000
NODE_3039_length_1325_cov_7.876835	698	778	2	46	80	0.5750000
NODE_3040_length_1325_cov_3.774062	1157	1218	0	24	61	0.3934426
NODE_3040_length_1325_cov_3.774062	1157	1218	2	30	61	0.4918033
NODE_3040_length_1325_cov_3.774062	1157	1218	4	7	61	0.1147541
NODE_3040_length_1325_cov_3.774062	1191	1271	2	22	80	0.2750000
NODE_3040_length_1325_cov_3.774062	1191	1271	4	58	80	0.7250000
NODE_3041_length_1325_cov_2.896411	0	58	0	1	58	0.0172414
NODE_3041_length_1325_cov_2.896411	0	58	2	16	58	0.2758621
NODE_3041_length_1325_cov_2.896411	0	58	4	41	58	0.7068965
NODE_3041_length_1325_cov_2.896411	8	67	2	9	59	0.1525424
NODE_3041_length_1325_cov_2.896411	8	67	4	50	59	0.8474576
NODE_3046_length_1324_cov_30.340408	939	1019	0	7	80	0.0875000
NODE_3046_length_1324_cov_30.340408	939	1019	6	26	80	0.3250000
NODE_3046_length_1324_cov_30.340408	939	1019	8	47	80	0.5875000
NODE_3046_length_1324_cov_30.340408	992	1072	0	60	80	0.7500000
NODE_3046_length_1324_cov_30.340408	992	1072	6	20	80	0.2500000
NODE_3047_length_1324_cov_7.391020	742	822	0	12	80	0.1500000
NODE_3047_length_1324_cov_7.391020	742	822	2	39	80	0.4875000
NODE_3047_length_1324_cov_7.391020	742	822	4	18	80	0.2250000
NODE_3047_length_1324_cov_7.391020	742	822	6	6	80	0.0750000
NODE_3047_length_1324_cov_7.391020	742	822	8	5	80	0.0625000
NODE_3047_length_1324_cov_7.391020	795	875	4	16	80	0.2000000
NODE_3047_length_1324_cov_7.391020	795	875	6	6	80	0.0750000
NODE_3047_length_1324_cov_7.391020	795	875	8	29	80	0.3625000
NODE_3047_length_1324_cov_7.391020	795	875	10	29	80	0.3625000
NODE_3053_length_1323_cov_30.600490	392	472	0	80	80	1.0000000
NODE_3053_length_1323_cov_30.600490	445	525	0	80	80	1.0000000
NODE_3053_length_1323_cov_30.600490	521	601	0	73	80	0.9125000
NODE_3053_length_1323_cov_30.600490	521	601	4	7	80	0.0875000
NODE_3053_length_1323_cov_30.600490	574	654	0	20	80	0.2500000
NODE_3053_length_1323_cov_30.600490	574	654	4	60	80	0.7500000
NODE_3054_length_1323_cov_20.888889	758	838	2	11	80	0.1375000
NODE_3054_length_1323_cov_20.888889	758	838	8	7	80	0.0875000
NODE_3054_length_1323_cov_20.888889	758	838	9	1	80	0.0125000
NODE_3054_length_1323_cov_20.888889	758	838	10	61	80	0.7625000
NODE_3054_length_1323_cov_20.888889	811	891	0	33	80	0.4125000
NODE_3054_length_1323_cov_20.888889	811	891	8	27	80	0.3375000
NODE_3054_length_1323_cov_20.888889	811	891	10	20	80	0.2500000
NODE_3061_length_1322_cov_8.988553	287	368	0	81	81	1.0000000
NODE_3061_length_1322_cov_8.988553	341	421	0	80	80	1.0000000
NODE_3061_length_1322_cov_8.988553	417	497	0	80	80	1.0000000
NODE_3061_length_1322_cov_8.988553	470	550	0	80	80	1.0000000
NODE_3068_length_1321_cov_57.885434	359	439	0	80	80	1.0000000
NODE_3068_length_1321_cov_57.885434	412	492	0	80	80	1.0000000
NODE_3068_length_1321_cov_57.885434	488	568	0	66	80	0.8250000
NODE_3068_length_1321_cov_57.885434	488	568	21	14	80	0.1750000
NODE_3068_length_1321_cov_57.885434	541	621	0	13	80	0.1625000
NODE_3068_length_1321_cov_57.885434	541	621	21	22	80	0.2750000
NODE_3068_length_1321_cov_57.885434	541	621	22	24	80	0.3000000
NODE_3068_length_1321_cov_57.885434	541	621	23	6	80	0.0750000
NODE_3068_length_1321_cov_57.885434	541	621	24	15	80	0.1875000
NODE_3071_length_1320_cov_70.753481	432	512	6	80	80	1.0000000
NODE_3071_length_1320_cov_70.753481	485	565	0	26	80	0.3250000
NODE_3071_length_1320_cov_70.753481	485	565	6	54	80	0.6750000
NODE_3071_length_1320_cov_70.753481	561	641	0	80	80	1.0000000
NODE_3071_length_1320_cov_70.753481	614	694	0	80	80	1.0000000
NODE_3072_length_1320_cov_39.149058	715	795	0	80	80	1.0000000
NODE_3072_length_1320_cov_39.149058	768	848	0	80	80	1.0000000
NODE_3072_length_1320_cov_39.149058	844	924	0	67	80	0.8375000
NODE_3072_length_1320_cov_39.149058	844	924	4	13	80	0.1625000
NODE_3072_length_1320_cov_39.149058	897	977	0	14	80	0.1750000
NODE_3072_length_1320_cov_39.149058	897	977	4	66	80	0.8250000
NODE_3073_length_1320_cov_19.175266	707	783	0	12	76	0.1578947
NODE_3073_length_1320_cov_19.175266	707	783	4	64	76	0.8421053
NODE_3073_length_1320_cov_19.175266	760	840	4	80	80	1.0000000
NODE_3074_length_1320_cov_11.224406	860	940	0	31	80	0.3875000
NODE_3074_length_1320_cov_11.224406	860	940	4	24	80	0.3000000
NODE_3074_length_1320_cov_11.224406	860	940	8	25	80	0.3125000
NODE_3074_length_1320_cov_11.224406	913	993	4	2	80	0.0250000
NODE_3074_length_1320_cov_11.224406	913	993	8	78	80	0.9750000
NODE_3075_length_1320_cov_11.036036	760	840	0	35	80	0.4375000
NODE_3075_length_1320_cov_11.036036	760	840	2	19	80	0.2375000
NODE_3075_length_1320_cov_11.036036	760	840	4	26	80	0.3250000
NODE_3075_length_1320_cov_11.036036	813	893	2	19	80	0.2375000
NODE_3075_length_1320_cov_11.036036	813	893	4	61	80	0.7625000
NODE_3076_length_1320_cov_8.357084	800	880	0	80	80	1.0000000
NODE_3076_length_1320_cov_8.357084	853	933	0	80	80	1.0000000
NODE_3080_length_1319_cov_27.098361	630	710	0	80	80	1.0000000
NODE_3080_length_1319_cov_27.098361	683	763	0	80	80	1.0000000
NODE_3081_length_1319_cov_22.992623	490	570	2	34	80	0.4250000
NODE_3081_length_1319_cov_22.992623	490	570	4	35	80	0.4375000
NODE_3081_length_1319_cov_22.992623	490	570	8	11	80	0.1375000
NODE_3081_length_1319_cov_22.992623	543	623	4	16	80	0.2000000
NODE_3081_length_1319_cov_22.992623	543	623	6	40	80	0.5000000
NODE_3081_length_1319_cov_22.992623	543	623	8	24	80	0.3000000
NODE_3086_length_1318_cov_13.624282	642	722	0	80	80	1.0000000
NODE_3086_length_1318_cov_13.624282	695	775	0	80	80	1.0000000
NODE_3086_length_1318_cov_13.624282	771	851	0	18	80	0.2250000
NODE_3086_length_1318_cov_13.624282	771	851	2	62	80	0.7750000
NODE_3086_length_1318_cov_13.624282	824	904	2	80	80	1.0000000
NODE_3089_length_1317_cov_162.041872	66	143	2	4	77	0.0519481
NODE_3089_length_1317_cov_162.041872	66	143	4	3	77	0.0389610
NODE_3089_length_1317_cov_162.041872	66	143	6	14	77	0.1818182
NODE_3089_length_1317_cov_162.041872	66	143	8	52	77	0.6753247
NODE_3089_length_1317_cov_162.041872	66	143	25	1	77	0.0129870
NODE_3089_length_1317_cov_162.041872	66	143	137	1	77	0.0129870
NODE_3089_length_1317_cov_162.041872	66	143	174	1	77	0.0129870
NODE_3089_length_1317_cov_162.041872	66	143	195	1	77	0.0129870
NODE_3090_length_1317_cov_19.736453	675	755	0	9	80	0.1125000
NODE_3090_length_1317_cov_19.736453	675	755	2	45	80	0.5625000
NODE_3090_length_1317_cov_19.736453	675	755	4	26	80	0.3250000
NODE_3090_length_1317_cov_19.736453	728	808	2	33	80	0.4125000
NODE_3090_length_1317_cov_19.736453	728	808	4	47	80	0.5875000
NODE_3090_length_1317_cov_19.736453	804	884	0	65	80	0.8125000
NODE_3090_length_1317_cov_19.736453	804	884	2	15	80	0.1875000
NODE_3090_length_1317_cov_19.736453	857	937	0	80	80	1.0000000
NODE_3092_length_1317_cov_2.203612	779	859	0	33	80	0.4125000
NODE_3092_length_1317_cov_2.203612	779	859	2	47	80	0.5875000
NODE_3095_length_1316_cov_25.377157	557	637	0	46	80	0.5750000
NODE_3095_length_1316_cov_25.377157	557	637	2	34	80	0.4250000
NODE_3095_length_1316_cov_25.377157	610	690	2	80	80	1.0000000
NODE_3096_length_1316_cov_15.891537	446	526	5	47	80	0.5875000
NODE_3096_length_1316_cov_15.891537	446	526	6	33	80	0.4125000
NODE_3096_length_1316_cov_15.891537	499	579	0	39	80	0.4875000
NODE_3096_length_1316_cov_15.891537	499	579	6	41	80	0.5125000
NODE_3096_length_1316_cov_15.891537	575	655	0	80	80	1.0000000
NODE_3096_length_1316_cov_15.891537	628	708	0	80	80	1.0000000
NODE_3101_length_1315_cov_24.136513	592	672	4	18	80	0.2250000
NODE_3101_length_1315_cov_24.136513	592	672	6	62	80	0.7750000
NODE_3101_length_1315_cov_24.136513	645	725	0	32	80	0.4000000
NODE_3101_length_1315_cov_24.136513	645	725	4	39	80	0.4875000
NODE_3101_length_1315_cov_24.136513	645	725	6	9	80	0.1125000
NODE_3105_length_1314_cov_38.391770	647	727	0	80	80	1.0000000
NODE_3105_length_1314_cov_38.391770	700	780	0	58	80	0.7250000
NODE_3105_length_1314_cov_38.391770	700	780	2	22	80	0.2750000
NODE_3105_length_1314_cov_38.391770	776	856	0	16	80	0.2000000
NODE_3105_length_1314_cov_38.391770	776	856	2	64	80	0.8000000
NODE_3105_length_1314_cov_38.391770	829	909	0	69	80	0.8625000
NODE_3105_length_1314_cov_38.391770	829	909	2	11	80	0.1375000
NODE_3106_length_1314_cov_30.167078	736	816	0	27	80	0.3375000
NODE_3106_length_1314_cov_30.167078	736	816	2	8	80	0.1000000
NODE_3106_length_1314_cov_30.167078	736	816	4	8	80	0.1000000
NODE_3106_length_1314_cov_30.167078	736	816	6	37	80	0.4625000
NODE_3106_length_1314_cov_30.167078	789	869	0	3	80	0.0375000
NODE_3106_length_1314_cov_30.167078	789	869	2	29	80	0.3625000
NODE_3106_length_1314_cov_30.167078	789	869	4	1	80	0.0125000
NODE_3106_length_1314_cov_30.167078	789	869	6	47	80	0.5875000
NODE_3107_length_1314_cov_11.221399	523	603	0	80	80	1.0000000
NODE_3107_length_1314_cov_11.221399	576	656	0	80	80	1.0000000
NODE_3114_length_1313_cov_29.315486	463	543	6	19	80	0.2375000
NODE_3114_length_1313_cov_29.315486	463	543	12	26	80	0.3250000
NODE_3114_length_1313_cov_29.315486	463	543	16	35	80	0.4375000
NODE_3114_length_1313_cov_29.315486	516	596	4	32	80	0.4000000
NODE_3114_length_1313_cov_29.315486	516	596	10	17	80	0.2125000
NODE_3114_length_1313_cov_29.315486	516	596	15	1	80	0.0125000
NODE_3114_length_1313_cov_29.315486	516	596	16	30	80	0.3750000
NODE_3115_length_1313_cov_25.144975	709	789	8	43	80	0.5375000
NODE_3115_length_1313_cov_25.144975	709	789	10	37	80	0.4625000
NODE_3115_length_1313_cov_25.144975	762	842	2	50	80	0.6250000
NODE_3115_length_1313_cov_25.144975	762	842	9	1	80	0.0125000
NODE_3115_length_1313_cov_25.144975	762	842	10	29	80	0.3625000
NODE_3115_length_1313_cov_25.144975	838	918	0	74	80	0.9250000
NODE_3115_length_1313_cov_25.144975	838	918	2	6	80	0.0750000
NODE_3115_length_1313_cov_25.144975	891	971	0	80	80	1.0000000
NODE_3118_length_1312_cov_20.378401	138	218	0	22	80	0.2750000
NODE_3118_length_1312_cov_20.378401	138	218	1	16	80	0.2000000
NODE_3118_length_1312_cov_20.378401	138	218	2	8	80	0.1000000
NODE_3118_length_1312_cov_20.378401	138	218	6	17	80	0.2125000
NODE_3118_length_1312_cov_20.378401	138	218	10	17	80	0.2125000
NODE_3118_length_1312_cov_20.378401	191	271	6	10	80	0.1250000
NODE_3118_length_1312_cov_20.378401	191	271	10	70	80	0.8750000
NODE_3121_length_1311_cov_38.468647	584	664	0	12	80	0.1500000
NODE_3121_length_1311_cov_38.468647	584	664	2	1	80	0.0125000
NODE_3121_length_1311_cov_38.468647	584	664	4	9	80	0.1125000
NODE_3121_length_1311_cov_38.468647	584	664	6	58	80	0.7250000
NODE_3121_length_1311_cov_38.468647	637	717	0	65	80	0.8125000
NODE_3121_length_1311_cov_38.468647	637	717	2	1	80	0.0125000
NODE_3121_length_1311_cov_38.468647	637	717	4	6	80	0.0750000
NODE_3121_length_1311_cov_38.468647	637	717	6	8	80	0.1000000
NODE_3121_length_1311_cov_38.468647	713	793	0	80	80	1.0000000
NODE_3121_length_1311_cov_38.468647	766	846	0	80	80	1.0000000
NODE_3125_length_1310_cov_37.739884	679	759	8	55	80	0.6875000
NODE_3125_length_1310_cov_37.739884	679	759	15	4	80	0.0500000
NODE_3125_length_1310_cov_37.739884	679	759	16	15	80	0.1875000
NODE_3125_length_1310_cov_37.739884	679	759	18	6	80	0.0750000
NODE_3125_length_1310_cov_37.739884	683	763	8	51	80	0.6375000
NODE_3125_length_1310_cov_37.739884	683	763	15	8	80	0.1000000
NODE_3125_length_1310_cov_37.739884	683	763	16	15	80	0.1875000
NODE_3125_length_1310_cov_37.739884	683	763	18	6	80	0.0750000
NODE_3125_length_1310_cov_37.739884	732	816	8	2	84	0.0238095
NODE_3125_length_1310_cov_37.739884	732	816	10	2	84	0.0238095
NODE_3125_length_1310_cov_37.739884	732	816	14	3	84	0.0357143
NODE_3125_length_1310_cov_37.739884	732	816	15	56	84	0.6666667
NODE_3125_length_1310_cov_37.739884	732	816	16	15	84	0.1785714
NODE_3125_length_1310_cov_37.739884	732	816	18	6	84	0.0714286
NODE_3125_length_1310_cov_37.739884	736	816	10	2	80	0.0250000
NODE_3125_length_1310_cov_37.739884	736	816	14	3	80	0.0375000
NODE_3125_length_1310_cov_37.739884	736	816	15	56	80	0.7000000
NODE_3125_length_1310_cov_37.739884	736	816	16	15	80	0.1875000
NODE_3125_length_1310_cov_37.739884	736	816	18	4	80	0.0500000
NODE_3125_length_1310_cov_37.739884	812	892	0	32	80	0.4000000
NODE_3125_length_1310_cov_37.739884	812	892	2	15	80	0.1875000
NODE_3125_length_1310_cov_37.739884	812	892	10	31	80	0.3875000
NODE_3125_length_1310_cov_37.739884	812	892	14	2	80	0.0250000
NODE_3125_length_1310_cov_37.739884	865	945	0	12	80	0.1500000
NODE_3125_length_1310_cov_37.739884	865	945	2	68	80	0.8500000
NODE_3126_length_1310_cov_12.245252	615	695	0	36	80	0.4500000
NODE_3126_length_1310_cov_12.245252	615	695	2	44	80	0.5500000
NODE_3126_length_1310_cov_12.245252	668	748	2	80	80	1.0000000
NODE_3127_length_1310_cov_10.184971	422	502	0	80	80	1.0000000
NODE_3127_length_1310_cov_10.184971	475	555	0	80	80	1.0000000
NODE_3128_length_1310_cov_3.186623	876	956	0	80	80	1.0000000
NODE_3128_length_1310_cov_3.186623	929	1009	0	80	80	1.0000000
NODE_3131_length_1310_cov_0.757225	1255	1310	0	9	55	0.1636364
NODE_3131_length_1310_cov_0.757225	1255	1310	2	1	55	0.0181818
NODE_3131_length_1310_cov_0.757225	1255	1310	4	16	55	0.2909091
NODE_3131_length_1310_cov_0.757225	1255	1310	6	8	55	0.1454545
NODE_3131_length_1310_cov_0.757225	1255	1310	8	7	55	0.1272727
NODE_3131_length_1310_cov_0.757225	1255	1310	10	14	55	0.2545455
NODE_3132_length_1309_cov_34.942149	474	554	4	14	80	0.1750000
NODE_3132_length_1309_cov_34.942149	474	554	12	66	80	0.8250000
NODE_3132_length_1309_cov_34.942149	527	607	0	48	80	0.6000000
NODE_3132_length_1309_cov_34.942149	527	607	4	19	80	0.2375000
NODE_3132_length_1309_cov_34.942149	527	607	12	13	80	0.1625000
NODE_3132_length_1309_cov_34.942149	603	683	0	80	80	1.0000000
NODE_3132_length_1309_cov_34.942149	656	736	0	80	80	1.0000000
NODE_3133_length_1309_cov_10.571074	839	921	0	82	82	1.0000000
NODE_3133_length_1309_cov_10.571074	894	974	0	80	80	1.0000000
NODE_3135_length_1308_cov_43.461538	330	410	0	26	80	0.3250000
NODE_3135_length_1308_cov_43.461538	330	410	4	13	80	0.1625000
NODE_3135_length_1308_cov_43.461538	330	410	6	41	80	0.5125000
NODE_3135_length_1308_cov_43.461538	383	463	2	12	80	0.1500000
NODE_3135_length_1308_cov_43.461538	383	463	6	68	80	0.8500000
NODE_3145_length_1307_cov_11.290563	595	673	0	71	78	0.9102564
NODE_3145_length_1307_cov_11.290563	595	673	2	7	78	0.0897436
NODE_3145_length_1307_cov_11.290563	646	726	0	20	80	0.2500000
NODE_3145_length_1307_cov_11.290563	646	726	2	60	80	0.7500000
NODE_3146_length_1307_cov_8.653146	430	510	0	80	80	1.0000000
NODE_3146_length_1307_cov_8.653146	483	563	0	80	80	1.0000000
NODE_3153_length_1306_cov_26.813587	369	449	0	31	80	0.3875000
NODE_3153_length_1306_cov_26.813587	369	449	2	49	80	0.6125000
NODE_3153_length_1306_cov_26.813587	422	502	0	31	80	0.3875000
NODE_3153_length_1306_cov_26.813587	422	502	2	49	80	0.6125000
NODE_3153_length_1306_cov_26.813587	498	578	0	80	80	1.0000000
NODE_3153_length_1306_cov_26.813587	551	631	0	56	80	0.7000000
NODE_3153_length_1306_cov_26.813587	551	631	2	24	80	0.3000000
NODE_3154_length_1306_cov_24.904722	634	714	0	60	80	0.7500000
NODE_3154_length_1306_cov_24.904722	634	714	2	20	80	0.2500000
NODE_3154_length_1306_cov_24.904722	687	767	0	7	80	0.0875000
NODE_3154_length_1306_cov_24.904722	687	767	2	73	80	0.9125000
NODE_3155_length_1306_cov_18.274234	388	468	0	30	80	0.3750000
NODE_3155_length_1306_cov_18.274234	388	468	2	50	80	0.6250000
NODE_3155_length_1306_cov_18.274234	441	521	0	45	80	0.5625000
NODE_3155_length_1306_cov_18.274234	441	521	2	35	80	0.4375000
NODE_3156_length_1306_cov_15.176471	1214	1294	0	34	80	0.4250000
NODE_3156_length_1306_cov_15.176471	1214	1294	2	20	80	0.2500000
NODE_3156_length_1306_cov_15.176471	1214	1294	4	26	80	0.3250000
NODE_3157_length_1306_cov_12.699254	458	538	7	24	80	0.3000000
NODE_3157_length_1306_cov_12.699254	458	538	8	11	80	0.1375000
NODE_3157_length_1306_cov_12.699254	458	538	9	9	80	0.1125000
NODE_3157_length_1306_cov_12.699254	458	538	10	36	80	0.4500000
NODE_3157_length_1306_cov_12.699254	511	591	0	35	80	0.4375000
NODE_3157_length_1306_cov_12.699254	511	591	7	1	80	0.0125000
NODE_3157_length_1306_cov_12.699254	511	591	8	28	80	0.3500000
NODE_3157_length_1306_cov_12.699254	511	591	10	16	80	0.2000000
NODE_3158_length_1306_cov_9.958575	630	710	0	80	80	1.0000000
NODE_3158_length_1306_cov_9.958575	683	764	0	81	81	1.0000000
NODE_3159_length_1306_cov_2.739851	1206	1246	0	40	40	1.0000000
NODE_3168_length_1304_cov_28.444813	511	591	0	36	80	0.4500000
NODE_3168_length_1304_cov_28.444813	511	591	2	19	80	0.2375000
NODE_3168_length_1304_cov_28.444813	511	591	4	25	80	0.3125000
NODE_3168_length_1304_cov_28.444813	564	644	2	22	80	0.2750000
NODE_3168_length_1304_cov_28.444813	564	644	4	58	80	0.7250000
NODE_3168_length_1304_cov_28.444813	640	720	0	40	80	0.5000000
NODE_3168_length_1304_cov_28.444813	640	720	2	40	80	0.5000000
NODE_3168_length_1304_cov_28.444813	693	773	2	80	80	1.0000000
NODE_3169_length_1304_cov_27.137759	575	655	0	80	80	1.0000000
NODE_3169_length_1304_cov_27.137759	628	708	0	80	80	1.0000000
NODE_3169_length_1304_cov_27.137759	704	784	0	6	80	0.0750000
NODE_3169_length_1304_cov_27.137759	704	784	2	23	80	0.2875000
NODE_3169_length_1304_cov_27.137759	704	784	4	6	80	0.0750000
NODE_3169_length_1304_cov_27.137759	704	784	6	8	80	0.1000000
NODE_3169_length_1304_cov_27.137759	704	784	14	7	80	0.0875000
NODE_3169_length_1304_cov_27.137759	704	784	16	12	80	0.1500000
NODE_3169_length_1304_cov_27.137759	704	784	20	18	80	0.2250000
NODE_3169_length_1304_cov_27.137759	757	837	6	8	80	0.1000000
NODE_3169_length_1304_cov_27.137759	757	837	16	12	80	0.1500000
NODE_3169_length_1304_cov_27.137759	757	837	18	23	80	0.2875000
NODE_3169_length_1304_cov_27.137759	757	837	20	37	80	0.4625000
NODE_3171_length_1303_cov_36.546512	458	538	2	3	80	0.0375000
NODE_3171_length_1303_cov_36.546512	458	538	4	72	80	0.9000000
NODE_3171_length_1303_cov_36.546512	458	538	6	5	80	0.0625000
NODE_3171_length_1303_cov_36.546512	511	591	0	6	80	0.0750000
NODE_3171_length_1303_cov_36.546512	511	591	2	16	80	0.2000000
NODE_3171_length_1303_cov_36.546512	511	591	4	58	80	0.7250000
NODE_3171_length_1303_cov_36.546512	587	667	0	80	80	1.0000000
NODE_3171_length_1303_cov_36.546512	640	720	0	80	80	1.0000000
NODE_3174_length_1302_cov_22.265170	747	827	4	10	80	0.1250000
NODE_3174_length_1302_cov_22.265170	747	827	6	70	80	0.8750000
NODE_3174_length_1302_cov_22.265170	800	880	0	46	80	0.5750000
NODE_3174_length_1302_cov_22.265170	800	880	4	17	80	0.2125000
NODE_3174_length_1302_cov_22.265170	800	880	6	17	80	0.2125000
NODE_3175_length_1302_cov_16.199501	480	560	0	80	80	1.0000000
NODE_3175_length_1302_cov_16.199501	533	613	0	80	80	1.0000000
NODE_3176_length_1302_cov_6.953450	687	767	0	61	80	0.7625000
NODE_3176_length_1302_cov_6.953450	687	767	2	18	80	0.2250000
NODE_3176_length_1302_cov_6.953450	687	767	4	1	80	0.0125000
NODE_3176_length_1302_cov_6.953450	740	820	0	8	80	0.1000000
NODE_3176_length_1302_cov_6.953450	740	820	2	18	80	0.2250000
NODE_3176_length_1302_cov_6.953450	740	820	4	54	80	0.6750000
NODE_3179_length_1301_cov_31.711314	401	481	0	80	80	1.0000000
NODE_3179_length_1301_cov_31.711314	454	534	0	80	80	1.0000000
NODE_3181_length_1301_cov_5.529950	246	326	0	80	80	1.0000000
NODE_3181_length_1301_cov_5.529950	299	379	0	80	80	1.0000000
NODE_3186_length_1300_cov_39.109908	602	682	0	9	80	0.1125000
NODE_3186_length_1300_cov_39.109908	602	682	4	32	80	0.4000000
NODE_3186_length_1300_cov_39.109908	602	682	6	11	80	0.1375000
NODE_3186_length_1300_cov_39.109908	602	682	9	1	80	0.0125000
NODE_3186_length_1300_cov_39.109908	602	682	10	27	80	0.3375000
NODE_3186_length_1300_cov_39.109908	655	735	0	6	80	0.0750000
NODE_3186_length_1300_cov_39.109908	655	735	6	4	80	0.0500000
NODE_3186_length_1300_cov_39.109908	655	735	10	70	80	0.8750000
NODE_3187_length_1300_cov_34.360533	586	666	2	77	80	0.9625000
NODE_3187_length_1300_cov_34.360533	586	666	4	3	80	0.0375000
NODE_3187_length_1300_cov_34.360533	639	719	0	17	80	0.2125000
NODE_3187_length_1300_cov_34.360533	639	719	2	63	80	0.7875000
NODE_3188_length_1300_cov_4.659450	454	535	4	29	81	0.3580247
NODE_3188_length_1300_cov_4.659450	454	535	8	31	81	0.3827161
NODE_3188_length_1300_cov_4.659450	454	535	13	1	81	0.0123457
NODE_3188_length_1300_cov_4.659450	454	535	14	20	81	0.2469136
NODE_3188_length_1300_cov_4.659450	508	588	8	6	80	0.0750000
NODE_3188_length_1300_cov_4.659450	508	588	9	2	80	0.0250000
NODE_3188_length_1300_cov_4.659450	508	588	10	24	80	0.3000000
NODE_3188_length_1300_cov_4.659450	508	588	11	14	80	0.1750000
NODE_3188_length_1300_cov_4.659450	508	588	13	6	80	0.0750000
NODE_3188_length_1300_cov_4.659450	508	588	14	28	80	0.3500000
NODE_3189_length_1299_cov_29.071667	452	532	0	80	80	1.0000000
NODE_3190_length_1299_cov_23.600833	818	898	0	80	80	1.0000000
NODE_3190_length_1299_cov_23.600833	871	951	0	80	80	1.0000000
NODE_3191_length_1299_cov_23.169167	625	705	0	1	80	0.0125000
NODE_3191_length_1299_cov_23.169167	625	705	10	79	80	0.9875000
NODE_3191_length_1299_cov_23.169167	678	758	0	54	80	0.6750000
NODE_3191_length_1299_cov_23.169167	678	758	10	26	80	0.3250000
NODE_3191_length_1299_cov_23.169167	754	834	0	80	80	1.0000000
NODE_3191_length_1299_cov_23.169167	807	887	0	80	80	1.0000000
NODE_3192_length_1299_cov_19.315000	306	386	0	80	80	1.0000000
NODE_3192_length_1299_cov_19.315000	359	439	0	80	80	1.0000000
NODE_3192_length_1299_cov_19.315000	435	515	0	24	80	0.3000000
NODE_3192_length_1299_cov_19.315000	435	515	2	56	80	0.7000000
NODE_3192_length_1299_cov_19.315000	488	568	0	16	80	0.2000000
NODE_3192_length_1299_cov_19.315000	488	568	2	64	80	0.8000000
NODE_3193_length_1299_cov_13.691667	540	620	0	80	80	1.0000000
NODE_3193_length_1299_cov_13.691667	593	673	0	80	80	1.0000000
NODE_3195_length_1298_cov_58.277731	679	759	0	25	80	0.3125000
NODE_3195_length_1298_cov_58.277731	679	759	4	55	80	0.6875000
NODE_3195_length_1298_cov_58.277731	732	812	0	78	80	0.9750000
NODE_3195_length_1298_cov_58.277731	732	812	4	2	80	0.0250000
NODE_3195_length_1298_cov_58.277731	808	888	0	80	80	1.0000000
NODE_3195_length_1298_cov_58.277731	861	941	0	66	80	0.8250000
NODE_3195_length_1298_cov_58.277731	861	941	2	14	80	0.1750000
NODE_3196_length_1298_cov_31.319433	375	455	0	47	80	0.5875000
NODE_3196_length_1298_cov_31.319433	375	455	2	33	80	0.4125000
NODE_3196_length_1298_cov_31.319433	428	508	0	80	80	1.0000000
NODE_3196_length_1298_cov_31.319433	504	584	0	75	80	0.9375000
NODE_3196_length_1298_cov_31.319433	504	584	4	5	80	0.0625000
NODE_3196_length_1298_cov_31.319433	557	637	0	29	80	0.3625000
NODE_3196_length_1298_cov_31.319433	557	637	4	51	80	0.6375000
NODE_3197_length_1298_cov_2.158465	294	360	0	66	66	1.0000000
NODE_3201_length_1296_cov_34.778613	620	700	0	12	80	0.1500000
NODE_3201_length_1296_cov_34.778613	620	700	1	20	80	0.2500000
NODE_3201_length_1296_cov_34.778613	620	700	2	48	80	0.6000000
NODE_3201_length_1296_cov_34.778613	673	753	2	80	80	1.0000000
NODE_3202_length_1296_cov_28.726817	671	751	0	80	80	1.0000000
NODE_3202_length_1296_cov_28.726817	724	804	0	44	80	0.5500000
NODE_3202_length_1296_cov_28.726817	724	804	3	1	80	0.0125000
NODE_3202_length_1296_cov_28.726817	724	804	4	35	80	0.4375000
NODE_3202_length_1296_cov_28.726817	800	880	0	8	80	0.1000000
NODE_3202_length_1296_cov_28.726817	800	880	2	15	80	0.1875000
NODE_3202_length_1296_cov_28.726817	800	880	4	57	80	0.7125000
NODE_3202_length_1296_cov_28.726817	853	933	0	8	80	0.1000000
NODE_3202_length_1296_cov_28.726817	853	933	2	68	80	0.8500000
NODE_3202_length_1296_cov_28.726817	853	933	4	4	80	0.0500000
NODE_3205_length_1295_cov_10.661371	818	898	0	27	80	0.3375000
NODE_3205_length_1295_cov_10.661371	818	898	2	37	80	0.4625000
NODE_3205_length_1295_cov_10.661371	818	898	4	16	80	0.2000000
NODE_3205_length_1295_cov_10.661371	871	951	0	8	80	0.1000000
NODE_3205_length_1295_cov_10.661371	871	951	2	17	80	0.2125000
NODE_3205_length_1295_cov_10.661371	871	951	4	55	80	0.6875000
NODE_3211_length_1294_cov_15.098745	353	433	0	80	80	1.0000000
NODE_3211_length_1294_cov_15.098745	406	486	0	80	80	1.0000000
NODE_3216_length_1293_cov_26.580402	595	675	0	80	80	1.0000000
NODE_3216_length_1293_cov_26.580402	648	728	0	80	80	1.0000000
NODE_3216_length_1293_cov_26.580402	724	804	0	15	80	0.1875000
NODE_3216_length_1293_cov_26.580402	724	804	4	65	80	0.8125000
NODE_3216_length_1293_cov_26.580402	777	857	0	19	80	0.2375000
NODE_3216_length_1293_cov_26.580402	777	857	4	61	80	0.7625000
NODE_3217_length_1293_cov_9.252094	1187	1207	2	20	20	1.0000000
NODE_3220_length_1293_cov_2.118090	1131	1195	0	22	64	0.3437500
NODE_3220_length_1293_cov_2.118090	1131	1195	4	42	64	0.6562500
NODE_3220_length_1293_cov_2.118090	1184	1248	4	64	64	1.0000000
NODE_3224_length_1292_cov_50.158424	402	482	0	24	80	0.3000000
NODE_3224_length_1292_cov_50.158424	402	482	2	15	80	0.1875000
NODE_3224_length_1292_cov_50.158424	402	482	4	41	80	0.5125000
NODE_3224_length_1292_cov_50.158424	455	535	0	77	80	0.9625000
NODE_3224_length_1292_cov_50.158424	455	535	2	3	80	0.0375000
NODE_3224_length_1292_cov_50.158424	531	611	0	40	80	0.5000000
NODE_3224_length_1292_cov_50.158424	531	611	2	40	80	0.5000000
NODE_3224_length_1292_cov_50.158424	584	664	2	30	80	0.3750000
NODE_3224_length_1292_cov_50.158424	584	664	3	1	80	0.0125000
NODE_3224_length_1292_cov_50.158424	584	664	4	49	80	0.6125000
NODE_3225_length_1292_cov_36.535624	670	750	0	9	80	0.1125000
NODE_3225_length_1292_cov_36.535624	670	750	5	1	80	0.0125000
NODE_3225_length_1292_cov_36.535624	670	750	6	29	80	0.3625000
NODE_3225_length_1292_cov_36.535624	670	750	12	29	80	0.3625000
NODE_3225_length_1292_cov_36.535624	670	750	14	12	80	0.1500000
NODE_3225_length_1292_cov_36.535624	723	803	8	50	80	0.6250000
NODE_3225_length_1292_cov_36.535624	723	803	12	15	80	0.1875000
NODE_3225_length_1292_cov_36.535624	723	803	14	15	80	0.1875000
NODE_3226_length_1292_cov_24.523889	420	500	0	53	80	0.6625000
NODE_3226_length_1292_cov_24.523889	420	500	2	27	80	0.3375000
NODE_3226_length_1292_cov_24.523889	473	553	0	80	80	1.0000000
NODE_3232_length_1291_cov_8.734060	623	703	0	45	80	0.5625000
NODE_3232_length_1291_cov_8.734060	623	703	2	35	80	0.4375000
NODE_3232_length_1291_cov_8.734060	676	756	0	80	80	1.0000000
NODE_3233_length_1291_cov_8.625839	756	836	0	80	80	1.0000000
NODE_3233_length_1291_cov_8.625839	809	889	0	55	80	0.6875000
NODE_3233_length_1291_cov_8.625839	809	889	1	8	80	0.1000000
NODE_3233_length_1291_cov_8.625839	809	889	2	17	80	0.2125000
NODE_3236_length_1290_cov_24.120067	497	577	0	80	80	1.0000000
NODE_3236_length_1290_cov_24.120067	550	630	0	80	80	1.0000000
NODE_3236_length_1290_cov_24.120067	626	706	0	17	80	0.2125000
NODE_3236_length_1290_cov_24.120067	626	706	2	63	80	0.7875000
NODE_3236_length_1290_cov_24.120067	679	759	0	30	80	0.3750000
NODE_3236_length_1290_cov_24.120067	679	759	2	50	80	0.6250000
NODE_3237_length_1290_cov_18.874895	671	751	0	80	80	1.0000000
NODE_3237_length_1290_cov_18.874895	724	804	0	80	80	1.0000000
NODE_3238_length_1290_cov_11.627204	573	653	6	80	80	1.0000000
NODE_3238_length_1290_cov_11.627204	626	706	2	6	80	0.0750000
NODE_3238_length_1290_cov_11.627204	626	706	6	73	80	0.9125000
NODE_3238_length_1290_cov_11.627204	626	706	8	1	80	0.0125000
NODE_3239_length_1290_cov_11.215785	373	453	0	75	80	0.9375000
NODE_3239_length_1290_cov_11.215785	373	453	2	5	80	0.0625000
NODE_3239_length_1290_cov_11.215785	426	506	0	22	80	0.2750000
NODE_3239_length_1290_cov_11.215785	426	506	2	58	80	0.7250000
NODE_3240_length_1290_cov_8.752309	788	868	0	58	80	0.7250000
NODE_3240_length_1290_cov_8.752309	788	868	2	22	80	0.2750000
NODE_3240_length_1290_cov_8.752309	841	921	0	5	80	0.0625000
NODE_3240_length_1290_cov_8.752309	841	921	2	75	80	0.9375000
NODE_3242_length_1289_cov_47.476471	919	999	15	12	80	0.1500000
NODE_3242_length_1289_cov_47.476471	919	999	22	63	80	0.7875000
NODE_3242_length_1289_cov_47.476471	919	999	23	1	80	0.0125000
NODE_3242_length_1289_cov_47.476471	919	999	24	4	80	0.0500000
NODE_3242_length_1289_cov_47.476471	972	1052	0	3	80	0.0375000
NODE_3242_length_1289_cov_47.476471	972	1052	2	43	80	0.5375000
NODE_3242_length_1289_cov_47.476471	972	1052	6	5	80	0.0625000
NODE_3242_length_1289_cov_47.476471	972	1052	15	14	80	0.1750000
NODE_3242_length_1289_cov_47.476471	972	1052	22	10	80	0.1250000
NODE_3242_length_1289_cov_47.476471	972	1052	23	1	80	0.0125000
NODE_3242_length_1289_cov_47.476471	972	1052	24	4	80	0.0500000
NODE_3243_length_1289_cov_18.497479	688	768	0	17	80	0.2125000
NODE_3243_length_1289_cov_18.497479	688	768	2	4	80	0.0500000
NODE_3243_length_1289_cov_18.497479	688	768	4	47	80	0.5875000
NODE_3243_length_1289_cov_18.497479	688	768	9	1	80	0.0125000
NODE_3243_length_1289_cov_18.497479	688	768	10	11	80	0.1375000
NODE_3243_length_1289_cov_18.497479	741	821	0	70	80	0.8750000
NODE_3243_length_1289_cov_18.497479	741	821	2	4	80	0.0500000
NODE_3243_length_1289_cov_18.497479	741	821	4	6	80	0.0750000
NODE_3243_length_1289_cov_18.497479	817	893	0	76	76	1.0000000
NODE_3243_length_1289_cov_18.497479	878	958	0	80	80	1.0000000
NODE_3244_length_1289_cov_11.692437	574	654	0	80	80	1.0000000
NODE_3244_length_1289_cov_11.692437	627	707	0	80	80	1.0000000
NODE_3244_length_1289_cov_11.692437	703	783	0	39	80	0.4875000
NODE_3244_length_1289_cov_11.692437	703	783	2	11	80	0.1375000
NODE_3244_length_1289_cov_11.692437	703	783	4	30	80	0.3750000
NODE_3244_length_1289_cov_11.692437	756	836	4	80	80	1.0000000
NODE_3249_length_1288_cov_29.369218	711	791	6	8	80	0.1000000
NODE_3249_length_1288_cov_29.369218	711	791	8	21	80	0.2625000
NODE_3249_length_1288_cov_29.369218	711	791	12	12	80	0.1500000
NODE_3249_length_1288_cov_29.369218	711	791	15	3	80	0.0375000
NODE_3249_length_1288_cov_29.369218	711	791	17	36	80	0.4500000
NODE_3249_length_1288_cov_29.369218	764	844	9	10	80	0.1250000
NODE_3249_length_1288_cov_29.369218	764	844	10	43	80	0.5375000
NODE_3249_length_1288_cov_29.369218	764	844	15	3	80	0.0375000
NODE_3249_length_1288_cov_29.369218	764	844	17	24	80	0.3000000
NODE_3250_length_1288_cov_6.207738	735	815	0	80	80	1.0000000
NODE_3250_length_1288_cov_6.207738	788	868	0	80	80	1.0000000
NODE_3255_length_1288_cov_1.731707	1017	1095	0	13	78	0.1666667
NODE_3255_length_1288_cov_1.731707	1017	1095	2	19	78	0.2435897
NODE_3255_length_1288_cov_1.731707	1017	1095	4	1	78	0.0128205
NODE_3255_length_1288_cov_1.731707	1017	1095	8	17	78	0.2179487
NODE_3255_length_1288_cov_1.731707	1017	1095	10	5	78	0.0641026
NODE_3255_length_1288_cov_1.731707	1017	1095	11	1	78	0.0128205
NODE_3255_length_1288_cov_1.731707	1017	1095	12	22	78	0.2820513
NODE_3261_length_1287_cov_29.186027	730	810	0	53	80	0.6625000
NODE_3261_length_1287_cov_29.186027	730	810	6	1	80	0.0125000
NODE_3261_length_1287_cov_29.186027	730	810	8	26	80	0.3250000
NODE_3261_length_1287_cov_29.186027	783	863	6	11	80	0.1375000
NODE_3261_length_1287_cov_29.186027	783	863	8	69	80	0.8625000
NODE_3262_length_1287_cov_22.747475	168	248	0	51	80	0.6375000
NODE_3262_length_1287_cov_22.747475	168	248	2	18	80	0.2250000
NODE_3262_length_1287_cov_22.747475	168	248	4	11	80	0.1375000
NODE_3262_length_1287_cov_22.747475	221	301	2	28	80	0.3500000
NODE_3262_length_1287_cov_22.747475	221	301	4	52	80	0.6500000
NODE_3263_length_1287_cov_19.478956	575	655	0	24	80	0.3000000
NODE_3263_length_1287_cov_19.478956	575	655	2	56	80	0.7000000
NODE_3263_length_1287_cov_19.478956	628	708	0	77	80	0.9625000
NODE_3263_length_1287_cov_19.478956	628	708	2	3	80	0.0375000
NODE_3266_length_1286_cov_27.128054	428	508	0	5	80	0.0625000
NODE_3266_length_1286_cov_27.128054	428	508	2	75	80	0.9375000
NODE_3266_length_1286_cov_27.128054	481	561	0	35	80	0.4375000
NODE_3266_length_1286_cov_27.128054	481	561	2	45	80	0.5625000
NODE_3266_length_1286_cov_27.128054	557	637	0	13	80	0.1625000
NODE_3266_length_1286_cov_27.128054	557	637	2	67	80	0.8375000
NODE_3266_length_1286_cov_27.128054	610	690	0	66	80	0.8250000
NODE_3266_length_1286_cov_27.128054	610	690	2	14	80	0.1750000
NODE_3267_length_1286_cov_12.192081	647	727	0	80	80	1.0000000
NODE_3267_length_1286_cov_12.192081	700	780	0	80	80	1.0000000
NODE_3267_length_1286_cov_12.192081	776	856	0	42	80	0.5250000
NODE_3267_length_1286_cov_12.192081	776	856	1	1	80	0.0125000
NODE_3267_length_1286_cov_12.192081	776	856	2	35	80	0.4375000
NODE_3267_length_1286_cov_12.192081	776	856	4	2	80	0.0250000
NODE_3267_length_1286_cov_12.192081	829	909	2	25	80	0.3125000
NODE_3267_length_1286_cov_12.192081	829	909	4	55	80	0.6875000
NODE_3268_length_1286_cov_8.338669	577	657	0	16	80	0.2000000
NODE_3268_length_1286_cov_8.338669	577	657	1	21	80	0.2625000
NODE_3268_length_1286_cov_8.338669	577	657	2	43	80	0.5375000
NODE_3268_length_1286_cov_8.338669	630	710	1	18	80	0.2250000
NODE_3268_length_1286_cov_8.338669	630	710	2	62	80	0.7750000
NODE_3273_length_1285_cov_40.282462	751	831	4	80	80	1.0000000
NODE_3273_length_1285_cov_40.282462	804	884	0	41	80	0.5125000
NODE_3273_length_1285_cov_40.282462	804	884	4	39	80	0.4875000
NODE_3274_length_1285_cov_15.422428	647	727	0	12	80	0.1500000
NODE_3274_length_1285_cov_15.422428	647	727	6	68	80	0.8500000
NODE_3274_length_1285_cov_15.422428	700	780	0	49	80	0.6125000
NODE_3274_length_1285_cov_15.422428	700	780	6	31	80	0.3875000
NODE_3275_length_1285_cov_6.620573	589	669	4	80	80	1.0000000
NODE_3275_length_1285_cov_6.620573	642	722	0	43	80	0.5375000
NODE_3275_length_1285_cov_6.620573	642	722	4	37	80	0.4625000
NODE_3279_length_1284_cov_5.637975	294	374	0	31	80	0.3875000
NODE_3279_length_1284_cov_5.637975	294	374	2	32	80	0.4000000
NODE_3279_length_1284_cov_5.637975	294	374	4	17	80	0.2125000
NODE_3279_length_1284_cov_5.637975	347	427	0	10	80	0.1250000
NODE_3279_length_1284_cov_5.637975	347	427	4	70	80	0.8750000
NODE_3283_length_1283_cov_10.070101	408	488	1	1	80	0.0125000
NODE_3283_length_1283_cov_10.070101	408	488	3	1	80	0.0125000
NODE_3283_length_1283_cov_10.070101	408	488	4	4	80	0.0500000
NODE_3283_length_1283_cov_10.070101	408	488	7	9	80	0.1125000
NODE_3283_length_1283_cov_10.070101	408	488	9	9	80	0.1125000
NODE_3283_length_1283_cov_10.070101	408	488	10	23	80	0.2875000
NODE_3283_length_1283_cov_10.070101	408	488	11	30	80	0.3750000
NODE_3283_length_1283_cov_10.070101	408	488	14	3	80	0.0375000
NODE_3283_length_1283_cov_10.070101	461	541	10	42	80	0.5250000
NODE_3283_length_1283_cov_10.070101	461	541	11	1	80	0.0125000
NODE_3283_length_1283_cov_10.070101	461	541	12	20	80	0.2500000
NODE_3283_length_1283_cov_10.070101	461	541	14	17	80	0.2125000
NODE_3288_length_1282_cov_37.786137	649	729	14	32	80	0.4000000
NODE_3288_length_1282_cov_37.786137	649	729	17	1	80	0.0125000
NODE_3288_length_1282_cov_37.786137	649	729	18	47	80	0.5875000
NODE_3288_length_1282_cov_37.786137	702	782	4	9	80	0.1125000
NODE_3288_length_1282_cov_37.786137	702	782	8	29	80	0.3625000
NODE_3288_length_1282_cov_37.786137	702	782	12	4	80	0.0500000
NODE_3288_length_1282_cov_37.786137	702	782	16	4	80	0.0500000
NODE_3288_length_1282_cov_37.786137	702	782	18	34	80	0.4250000
NODE_3288_length_1282_cov_37.786137	778	858	0	5	80	0.0625000
NODE_3288_length_1282_cov_37.786137	778	858	2	21	80	0.2625000
NODE_3288_length_1282_cov_37.786137	778	858	4	13	80	0.1625000
NODE_3288_length_1282_cov_37.786137	778	858	12	15	80	0.1875000
NODE_3288_length_1282_cov_37.786137	778	858	13	4	80	0.0500000
NODE_3288_length_1282_cov_37.786137	778	858	17	5	80	0.0625000
NODE_3288_length_1282_cov_37.786137	778	858	19	17	80	0.2125000
NODE_3288_length_1282_cov_37.786137	831	911	12	1	80	0.0125000
NODE_3288_length_1282_cov_37.786137	831	911	13	4	80	0.0500000
NODE_3288_length_1282_cov_37.786137	831	911	15	17	80	0.2125000
NODE_3288_length_1282_cov_37.786137	831	911	17	21	80	0.2625000
NODE_3288_length_1282_cov_37.786137	831	911	19	37	80	0.4625000
NODE_3289_length_1282_cov_25.900254	85	167	14	3	82	0.0365854
NODE_3289_length_1282_cov_25.900254	85	167	16	4	82	0.0487805
NODE_3289_length_1282_cov_25.900254	85	167	18	1	82	0.0121951
NODE_3289_length_1282_cov_25.900254	85	167	22	1	82	0.0121951
NODE_3289_length_1282_cov_25.900254	85	167	26	2	82	0.0243902
NODE_3289_length_1282_cov_25.900254	85	167	30	3	82	0.0365854
NODE_3289_length_1282_cov_25.900254	85	167	36	8	82	0.0975610
NODE_3289_length_1282_cov_25.900254	85	167	38	10	82	0.1219512
NODE_3289_length_1282_cov_25.900254	85	167	40	2	82	0.0243902
NODE_3289_length_1282_cov_25.900254	85	167	42	2	82	0.0243902
NODE_3289_length_1282_cov_25.900254	85	167	44	4	82	0.0487805
NODE_3289_length_1282_cov_25.900254	85	167	46	13	82	0.1585366
NODE_3289_length_1282_cov_25.900254	85	167	47	5	82	0.0609756
NODE_3289_length_1282_cov_25.900254	85	167	53	1	82	0.0121951
NODE_3289_length_1282_cov_25.900254	85	167	55	2	82	0.0243902
NODE_3289_length_1282_cov_25.900254	85	167	57	3	82	0.0365854
NODE_3289_length_1282_cov_25.900254	85	167	58	18	82	0.2195122
NODE_3289_length_1282_cov_25.900254	140	183	9	1	43	0.0232558
NODE_3289_length_1282_cov_25.900254	140	183	12	8	43	0.1860465
NODE_3289_length_1282_cov_25.900254	140	183	14	10	43	0.2325581
NODE_3289_length_1282_cov_25.900254	140	183	16	4	43	0.0930233
NODE_3289_length_1282_cov_25.900254	140	183	18	1	43	0.0232558
NODE_3289_length_1282_cov_25.900254	140	183	22	1	43	0.0232558
NODE_3289_length_1282_cov_25.900254	140	183	26	2	43	0.0465116
NODE_3289_length_1282_cov_25.900254	140	183	30	3	43	0.0697674
NODE_3289_length_1282_cov_25.900254	140	183	36	5	43	0.1162791
NODE_3289_length_1282_cov_25.900254	140	183	38	8	43	0.1860465
NODE_3289_length_1282_cov_25.900254	1006	1086	2	75	80	0.9375000
NODE_3289_length_1282_cov_25.900254	1006	1086	4	5	80	0.0625000
NODE_3289_length_1282_cov_25.900254	1006	1086	2	75	80	0.9375000
NODE_3289_length_1282_cov_25.900254	1006	1086	4	5	80	0.0625000
NODE_3289_length_1282_cov_25.900254	1015	1086	2	66	71	0.9295775
NODE_3289_length_1282_cov_25.900254	1015	1086	4	5	71	0.0704225
NODE_3290_length_1282_cov_14.600169	429	477	0	48	48	1.0000000
NODE_3290_length_1282_cov_14.600169	708	788	0	80	80	1.0000000
NODE_3291_length_1282_cov_8.017751	343	420	2	18	77	0.2337662
NODE_3291_length_1282_cov_8.017751	343	420	4	31	77	0.4025974
NODE_3291_length_1282_cov_8.017751	343	420	6	28	77	0.3636364
NODE_3292_length_1282_cov_5.092984	239	319	0	80	80	1.0000000
NODE_3292_length_1282_cov_5.092984	292	372	0	80	80	1.0000000
NODE_3295_length_1281_cov_31.342640	470	550	2	13	80	0.1625000
NODE_3295_length_1281_cov_31.342640	470	550	6	6	80	0.0750000
NODE_3295_length_1281_cov_31.342640	470	550	8	35	80	0.4375000
NODE_3295_length_1281_cov_31.342640	470	550	11	1	80	0.0125000
NODE_3295_length_1281_cov_31.342640	470	550	12	5	80	0.0625000
NODE_3295_length_1281_cov_31.342640	470	550	16	20	80	0.2500000
NODE_3295_length_1281_cov_31.342640	523	603	0	36	80	0.4500000
NODE_3295_length_1281_cov_31.342640	523	603	2	30	80	0.3750000
NODE_3295_length_1281_cov_31.342640	523	603	6	6	80	0.0750000
NODE_3295_length_1281_cov_31.342640	523	603	8	8	80	0.1000000
NODE_3295_length_1281_cov_31.342640	599	679	0	80	80	1.0000000
NODE_3295_length_1281_cov_31.342640	652	732	0	80	80	1.0000000
NODE_3296_length_1281_cov_25.482234	474	554	0	9	80	0.1125000
NODE_3296_length_1281_cov_25.482234	474	554	2	71	80	0.8875000
NODE_3296_length_1281_cov_25.482234	527	607	0	16	80	0.2000000
NODE_3296_length_1281_cov_25.482234	527	607	2	64	80	0.8000000
NODE_3297_length_1281_cov_14.617597	809	887	0	48	78	0.6153846
NODE_3297_length_1281_cov_14.617597	809	887	2	30	78	0.3846154
NODE_3297_length_1281_cov_14.617597	860	940	0	13	80	0.1625000
NODE_3297_length_1281_cov_14.617597	860	940	2	67	80	0.8375000
NODE_3298_length_1281_cov_12.065144	655	735	0	36	80	0.4500000
NODE_3298_length_1281_cov_12.065144	655	735	8	14	80	0.1750000
NODE_3298_length_1281_cov_12.065144	655	735	18	1	80	0.0125000
NODE_3298_length_1281_cov_12.065144	655	735	19	12	80	0.1500000
NODE_3298_length_1281_cov_12.065144	655	735	21	17	80	0.2125000
NODE_3298_length_1281_cov_12.065144	708	788	19	10	80	0.1250000
NODE_3298_length_1281_cov_12.065144	708	788	21	70	80	0.8750000
NODE_3299_length_1281_cov_9.235195	408	488	2	37	80	0.4625000
NODE_3299_length_1281_cov_9.235195	408	488	4	43	80	0.5375000
NODE_3299_length_1281_cov_9.235195	461	541	2	80	80	1.0000000
NODE_3300_length_1281_cov_7.153976	469	549	0	32	80	0.4000000
NODE_3300_length_1281_cov_7.153976	469	549	2	48	80	0.6000000
NODE_3300_length_1281_cov_7.153976	522	602	0	80	80	1.0000000
NODE_3307_length_1280_cov_24.231160	418	498	2	76	80	0.9500000
NODE_3307_length_1280_cov_24.231160	418	498	4	4	80	0.0500000
NODE_3307_length_1280_cov_24.231160	471	551	0	33	80	0.4125000
NODE_3307_length_1280_cov_24.231160	471	551	2	47	80	0.5875000
NODE_3307_length_1280_cov_24.231160	547	627	0	61	80	0.7625000
NODE_3307_length_1280_cov_24.231160	547	627	2	19	80	0.2375000
NODE_3307_length_1280_cov_24.231160	600	680	0	34	80	0.4250000
NODE_3307_length_1280_cov_24.231160	600	680	2	46	80	0.5750000
NODE_3308_length_1280_cov_5.908552	1077	1138	6	1	61	0.0163934
NODE_3308_length_1280_cov_5.908552	1077	1138	7	4	61	0.0655738
NODE_3308_length_1280_cov_5.908552	1077	1138	15	2	61	0.0327869
NODE_3308_length_1280_cov_5.908552	1077	1138	21	1	61	0.0163934
NODE_3308_length_1280_cov_5.908552	1077	1138	23	2	61	0.0327869
NODE_3308_length_1280_cov_5.908552	1077	1138	28	5	61	0.0819672
NODE_3308_length_1280_cov_5.908552	1077	1138	33	1	61	0.0163934
NODE_3308_length_1280_cov_5.908552	1077	1138	34	2	61	0.0327869
NODE_3308_length_1280_cov_5.908552	1077	1138	37	2	61	0.0327869
NODE_3308_length_1280_cov_5.908552	1077	1138	38	1	61	0.0163934
NODE_3308_length_1280_cov_5.908552	1077	1138	47	1	61	0.0163934
NODE_3308_length_1280_cov_5.908552	1077	1138	48	4	61	0.0655738
NODE_3308_length_1280_cov_5.908552	1077	1138	50	5	61	0.0819672
NODE_3308_length_1280_cov_5.908552	1077	1138	57	1	61	0.0163934
NODE_3308_length_1280_cov_5.908552	1077	1138	59	1	61	0.0163934
NODE_3308_length_1280_cov_5.908552	1077	1138	63	1	61	0.0163934
NODE_3308_length_1280_cov_5.908552	1077	1138	69	2	61	0.0327869
NODE_3308_length_1280_cov_5.908552	1077	1138	76	1	61	0.0163934
NODE_3308_length_1280_cov_5.908552	1077	1138	82	1	61	0.0163934
NODE_3308_length_1280_cov_5.908552	1077	1138	84	1	61	0.0163934
NODE_3308_length_1280_cov_5.908552	1077	1138	87	2	61	0.0327869
NODE_3308_length_1280_cov_5.908552	1077	1138	88	3	61	0.0491803
NODE_3308_length_1280_cov_5.908552	1077	1138	92	1	61	0.0163934
NODE_3308_length_1280_cov_5.908552	1077	1138	97	1	61	0.0163934
NODE_3308_length_1280_cov_5.908552	1077	1138	111	4	61	0.0655738
NODE_3308_length_1280_cov_5.908552	1077	1138	113	1	61	0.0163934
NODE_3308_length_1280_cov_5.908552	1077	1138	117	3	61	0.0491803
NODE_3308_length_1280_cov_5.908552	1077	1138	119	1	61	0.0163934
NODE_3308_length_1280_cov_5.908552	1077	1138	121	2	61	0.0327869
NODE_3308_length_1280_cov_5.908552	1077	1138	123	3	61	0.0491803
NODE_3308_length_1280_cov_5.908552	1077	1138	126	1	61	0.0163934
NODE_3311_length_1279_cov_16.840678	749	829	0	80	80	1.0000000
NODE_3311_length_1279_cov_16.840678	802	882	0	80	80	1.0000000
NODE_3312_length_1279_cov_3.772881	951	981	2	30	30	1.0000000
NODE_3317_length_1278_cov_45.991518	411	491	0	80	80	1.0000000
NODE_3317_length_1278_cov_45.991518	464	530	0	66	66	1.0000000
NODE_3318_length_1278_cov_37.164546	447	527	0	20	80	0.2500000
NODE_3318_length_1278_cov_37.164546	447	527	2	28	80	0.3500000
NODE_3318_length_1278_cov_37.164546	447	527	4	5	80	0.0625000
NODE_3318_length_1278_cov_37.164546	447	527	6	27	80	0.3375000
NODE_3318_length_1278_cov_37.164546	500	580	4	7	80	0.0875000
NODE_3318_length_1278_cov_37.164546	500	580	6	45	80	0.5625000
NODE_3318_length_1278_cov_37.164546	500	580	8	28	80	0.3500000
NODE_3318_length_1278_cov_37.164546	576	656	0	13	80	0.1625000
NODE_3318_length_1278_cov_37.164546	576	656	2	21	80	0.2625000
NODE_3318_length_1278_cov_37.164546	576	656	4	46	80	0.5750000
NODE_3318_length_1278_cov_37.164546	629	709	0	66	80	0.8250000
NODE_3318_length_1278_cov_37.164546	629	709	2	14	80	0.1750000
NODE_3319_length_1278_cov_12.505513	522	602	0	6	80	0.0750000
NODE_3319_length_1278_cov_12.505513	522	602	4	47	80	0.5875000
NODE_3319_length_1278_cov_12.505513	522	602	6	27	80	0.3375000
NODE_3319_length_1278_cov_12.505513	575	655	0	7	80	0.0875000
NODE_3319_length_1278_cov_12.505513	575	655	4	27	80	0.3375000
NODE_3319_length_1278_cov_12.505513	575	655	6	46	80	0.5750000
NODE_3320_length_1278_cov_12.171332	212	292	8	49	80	0.6125000
NODE_3320_length_1278_cov_12.171332	212	292	10	31	80	0.3875000
NODE_3320_length_1278_cov_12.171332	265	344	2	7	79	0.0886076
NODE_3320_length_1278_cov_12.171332	265	344	5	24	79	0.3037975
NODE_3320_length_1278_cov_12.171332	265	344	8	34	79	0.4303797
NODE_3320_length_1278_cov_12.171332	265	344	10	14	79	0.1772152
NODE_3329_length_1277_cov_21.407470	667	717	2	1	50	0.0200000
NODE_3329_length_1277_cov_21.407470	667	717	4	18	50	0.3600000
NODE_3329_length_1277_cov_21.407470	667	717	6	31	50	0.6200000
NODE_3329_length_1277_cov_21.407470	690	770	0	40	80	0.5000000
NODE_3329_length_1277_cov_21.407470	690	770	1	12	80	0.1500000
NODE_3329_length_1277_cov_21.407470	690	770	2	2	80	0.0250000
NODE_3329_length_1277_cov_21.407470	690	770	6	26	80	0.3250000
NODE_3330_length_1277_cov_18.111205	834	914	10	14	80	0.1750000
NODE_3330_length_1277_cov_18.111205	834	914	12	66	80	0.8250000
NODE_3330_length_1277_cov_18.111205	887	967	0	18	80	0.2250000
NODE_3330_length_1277_cov_18.111205	887	967	10	5	80	0.0625000
NODE_3330_length_1277_cov_18.111205	887	967	12	57	80	0.7125000
NODE_3331_length_1277_cov_12.449066	276	356	2	80	80	1.0000000
NODE_3331_length_1277_cov_12.449066	329	409	0	53	80	0.6625000
NODE_3331_length_1277_cov_12.449066	329	409	2	27	80	0.3375000
NODE_3331_length_1277_cov_12.449066	405	485	0	64	80	0.8000000
NODE_3331_length_1277_cov_12.449066	405	485	2	10	80	0.1250000
NODE_3331_length_1277_cov_12.449066	405	485	4	6	80	0.0750000
NODE_3331_length_1277_cov_12.449066	458	538	0	11	80	0.1375000
NODE_3331_length_1277_cov_12.449066	458	538	2	10	80	0.1250000
NODE_3331_length_1277_cov_12.449066	458	538	4	59	80	0.7375000
NODE_3337_length_1276_cov_21.446899	526	606	0	7	80	0.0875000
NODE_3337_length_1276_cov_21.446899	526	606	2	73	80	0.9125000
NODE_3337_length_1276_cov_21.446899	579	659	0	37	80	0.4625000
NODE_3337_length_1276_cov_21.446899	579	659	2	43	80	0.5375000
NODE_3337_length_1276_cov_21.446899	655	735	0	68	80	0.8500000
NODE_3337_length_1276_cov_21.446899	655	735	2	12	80	0.1500000
NODE_3337_length_1276_cov_21.446899	708	788	0	15	80	0.1875000
NODE_3337_length_1276_cov_21.446899	708	788	2	31	80	0.3875000
NODE_3337_length_1276_cov_21.446899	708	788	4	34	80	0.4250000
NODE_3346_length_1275_cov_35.471939	632	712	0	80	80	1.0000000
NODE_3346_length_1275_cov_35.471939	685	765	0	80	80	1.0000000
NODE_3347_length_1275_cov_19.910714	361	441	0	80	80	1.0000000
NODE_3347_length_1275_cov_19.910714	414	494	0	80	80	1.0000000
NODE_3347_length_1275_cov_19.910714	879	949	12	17	70	0.2428571
NODE_3347_length_1275_cov_19.910714	879	949	14	2	70	0.0285714
NODE_3347_length_1275_cov_19.910714	879	949	16	29	70	0.4142857
NODE_3347_length_1275_cov_19.910714	879	949	18	22	70	0.3142857
NODE_3351_length_1274_cov_23.404255	427	507	0	80	80	1.0000000
NODE_3351_length_1274_cov_23.404255	480	560	0	80	80	1.0000000
NODE_3351_length_1274_cov_23.404255	556	636	0	80	80	1.0000000
NODE_3351_length_1274_cov_23.404255	609	689	0	38	80	0.4750000
NODE_3351_length_1274_cov_23.404255	609	689	2	42	80	0.5250000
NODE_3352_length_1274_cov_20.178723	545	625	2	18	80	0.2250000
NODE_3352_length_1274_cov_20.178723	545	625	4	62	80	0.7750000
NODE_3352_length_1274_cov_20.178723	598	678	1	8	80	0.1000000
NODE_3352_length_1274_cov_20.178723	598	678	2	52	80	0.6500000
NODE_3352_length_1274_cov_20.178723	598	678	3	4	80	0.0500000
NODE_3352_length_1274_cov_20.178723	598	678	4	16	80	0.2000000
NODE_3354_length_1274_cov_2.019574	841	907	0	50	66	0.7575758
NODE_3354_length_1274_cov_2.019574	841	907	2	9	66	0.1363636
NODE_3354_length_1274_cov_2.019574	841	907	4	7	66	0.1060606
NODE_3354_length_1274_cov_2.019574	894	961	2	6	67	0.0895522
NODE_3354_length_1274_cov_2.019574	894	961	4	61	67	0.9104478
NODE_3361_length_1273_cov_42.349233	337	417	0	80	80	1.0000000
NODE_3361_length_1273_cov_42.349233	390	470	0	80	80	1.0000000
NODE_3361_length_1273_cov_42.349233	466	546	0	80	80	1.0000000
NODE_3361_length_1273_cov_42.349233	519	599	0	80	80	1.0000000
NODE_3364_length_1273_cov_4.404600	407	487	6	80	80	1.0000000
NODE_3364_length_1273_cov_4.404600	460	540	0	15	80	0.1875000
NODE_3364_length_1273_cov_4.404600	460	540	3	6	80	0.0750000
NODE_3364_length_1273_cov_4.404600	460	540	6	59	80	0.7375000
NODE_3368_length_1272_cov_28.887468	588	668	0	80	80	1.0000000
NODE_3368_length_1272_cov_28.887468	641	721	0	71	80	0.8875000
NODE_3368_length_1272_cov_28.887468	641	721	2	9	80	0.1125000
NODE_3369_length_1272_cov_11.290708	366	447	10	1	81	0.0123457
NODE_3369_length_1272_cov_11.290708	366	447	12	21	81	0.2592593
NODE_3369_length_1272_cov_11.290708	366	447	14	40	81	0.4938272
NODE_3369_length_1272_cov_11.290708	366	447	16	19	81	0.2345679
NODE_3375_length_1270_cov_13.617421	365	445	0	33	80	0.4125000
NODE_3375_length_1270_cov_13.617421	365	445	2	47	80	0.5875000
NODE_3375_length_1270_cov_13.617421	396	473	0	61	77	0.7922078
NODE_3375_length_1270_cov_13.617421	396	473	2	16	77	0.2077922
NODE_3375_length_1270_cov_13.617421	418	498	0	80	80	1.0000000
NODE_3375_length_1270_cov_13.617421	449	473	0	24	24	1.0000000
NODE_3375_length_1270_cov_13.617421	465	498	0	33	33	1.0000000
NODE_3376_length_1270_cov_11.645602	294	374	0	49	80	0.6125000
NODE_3376_length_1270_cov_11.645602	294	374	2	15	80	0.1875000
NODE_3376_length_1270_cov_11.645602	294	374	4	16	80	0.2000000
NODE_3376_length_1270_cov_11.645602	347	427	2	22	80	0.2750000
NODE_3376_length_1270_cov_11.645602	347	427	4	58	80	0.7250000
NODE_3377_length_1270_cov_2.495303	74	131	10	18	57	0.3157895
NODE_3377_length_1270_cov_2.495303	74	131	14	2	57	0.0350877
NODE_3377_length_1270_cov_2.495303	74	131	16	19	57	0.3333333
NODE_3377_length_1270_cov_2.495303	74	131	18	18	57	0.3157895
NODE_3378_length_1269_cov_55.070940	492	569	5	1	77	0.0129870
NODE_3378_length_1269_cov_55.070940	492	569	6	76	77	0.9870130
NODE_3378_length_1269_cov_55.070940	545	625	0	44	80	0.5500000
NODE_3378_length_1269_cov_55.070940	545	625	6	36	80	0.4500000
NODE_3378_length_1269_cov_55.070940	621	701	0	17	80	0.2125000
NODE_3378_length_1269_cov_55.070940	621	701	8	34	80	0.4250000
NODE_3378_length_1269_cov_55.070940	621	701	9	5	80	0.0625000
NODE_3378_length_1269_cov_55.070940	621	701	10	24	80	0.3000000
NODE_3378_length_1269_cov_55.070940	674	754	2	40	80	0.5000000
NODE_3378_length_1269_cov_55.070940	674	754	9	3	80	0.0375000
NODE_3378_length_1269_cov_55.070940	674	754	10	37	80	0.4625000
NODE_3379_length_1269_cov_22.154701	1152	1216	0	37	64	0.5781250
NODE_3379_length_1269_cov_22.154701	1152	1216	4	27	64	0.4218750
NODE_3379_length_1269_cov_22.154701	1152	1216	0	37	64	0.5781250
NODE_3379_length_1269_cov_22.154701	1152	1216	4	27	64	0.4218750
NODE_3379_length_1269_cov_22.154701	1152	1216	0	37	64	0.5781250
NODE_3379_length_1269_cov_22.154701	1152	1216	4	27	64	0.4218750
NODE_3379_length_1269_cov_22.154701	1189	1269	0	6	80	0.0750000
NODE_3379_length_1269_cov_22.154701	1189	1269	4	74	80	0.9250000
NODE_3379_length_1269_cov_22.154701	1189	1269	0	6	80	0.0750000
NODE_3379_length_1269_cov_22.154701	1189	1269	4	74	80	0.9250000
NODE_3380_length_1269_cov_18.753846	317	398	4	4	81	0.0493827
NODE_3380_length_1269_cov_18.753846	317	398	6	14	81	0.1728395
NODE_3380_length_1269_cov_18.753846	317	398	8	9	81	0.1111111
NODE_3380_length_1269_cov_18.753846	317	398	10	11	81	0.1358025
NODE_3380_length_1269_cov_18.753846	317	398	12	15	81	0.1851852
NODE_3380_length_1269_cov_18.753846	317	398	16	2	81	0.0246914
NODE_3380_length_1269_cov_18.753846	317	398	18	26	81	0.3209876
NODE_3381_length_1269_cov_12.637607	580	660	0	80	80	1.0000000
NODE_3381_length_1269_cov_12.637607	633	713	0	80	80	1.0000000
NODE_3381_length_1269_cov_12.637607	709	729	0	20	20	1.0000000
NODE_3381_length_1269_cov_12.637607	709	789	0	80	80	1.0000000
NODE_3381_length_1269_cov_12.637607	762	842	0	80	80	1.0000000
NODE_3382_length_1269_cov_10.552137	765	845	0	80	80	1.0000000
NODE_3382_length_1269_cov_10.552137	818	898	0	80	80	1.0000000
NODE_3391_length_1268_cov_12.862275	300	350	16	1	50	0.0200000
NODE_3391_length_1268_cov_12.862275	300	350	18	2	50	0.0400000
NODE_3391_length_1268_cov_12.862275	300	350	24	3	50	0.0600000
NODE_3391_length_1268_cov_12.862275	300	350	26	7	50	0.1400000
NODE_3391_length_1268_cov_12.862275	300	350	28	1	50	0.0200000
NODE_3391_length_1268_cov_12.862275	300	350	32	1	50	0.0200000
NODE_3391_length_1268_cov_12.862275	300	350	34	1	50	0.0200000
NODE_3391_length_1268_cov_12.862275	300	350	36	6	50	0.1200000
NODE_3391_length_1268_cov_12.862275	300	350	38	7	50	0.1400000
NODE_3391_length_1268_cov_12.862275	300	350	40	3	50	0.0600000
NODE_3391_length_1268_cov_12.862275	300	350	44	1	50	0.0200000
NODE_3391_length_1268_cov_12.862275	300	350	46	2	50	0.0400000
NODE_3391_length_1268_cov_12.862275	300	350	50	15	50	0.3000000
NODE_3392_length_1268_cov_9.523524	265	345	0	25	80	0.3125000
NODE_3392_length_1268_cov_9.523524	265	345	2	55	80	0.6875000
NODE_3392_length_1268_cov_9.523524	318	398	0	78	80	0.9750000
NODE_3392_length_1268_cov_9.523524	318	398	2	2	80	0.0250000
NODE_3393_length_1267_cov_21.315068	299	379	2	78	80	0.9750000
NODE_3393_length_1267_cov_21.315068	299	379	4	2	80	0.0250000
NODE_3393_length_1267_cov_21.315068	352	432	0	15	80	0.1875000
NODE_3393_length_1267_cov_21.315068	352	432	2	65	80	0.8125000
NODE_3393_length_1267_cov_21.315068	698	778	0	24	80	0.3000000
NODE_3393_length_1267_cov_21.315068	698	778	6	56	80	0.7000000
NODE_3393_length_1267_cov_21.315068	751	831	6	36	80	0.4500000
NODE_3393_length_1267_cov_21.315068	751	831	8	44	80	0.5500000
NODE_3394_length_1267_cov_14.880137	606	686	0	80	80	1.0000000
NODE_3394_length_1267_cov_14.880137	659	739	0	80	80	1.0000000
NODE_3397_length_1266_cov_20.584404	357	437	2	19	80	0.2375000
NODE_3397_length_1266_cov_20.584404	357	437	6	25	80	0.3125000
NODE_3397_length_1266_cov_20.584404	357	437	8	13	80	0.1625000
NODE_3397_length_1266_cov_20.584404	357	437	9	3	80	0.0375000
NODE_3397_length_1266_cov_20.584404	357	437	10	20	80	0.2500000
NODE_3397_length_1266_cov_20.584404	410	490	6	5	80	0.0625000
NODE_3397_length_1266_cov_20.584404	410	490	8	4	80	0.0500000
NODE_3397_length_1266_cov_20.584404	410	490	9	3	80	0.0375000
NODE_3397_length_1266_cov_20.584404	410	490	10	68	80	0.8500000
NODE_3398_length_1266_cov_16.571551	359	435	0	76	76	1.0000000
NODE_3398_length_1266_cov_16.571551	408	488	0	80	80	1.0000000
NODE_3399_length_1266_cov_14.218509	517	595	0	78	78	1.0000000
NODE_3399_length_1266_cov_14.218509	568	648	0	80	80	1.0000000
NODE_3399_length_1266_cov_14.218509	644	724	0	80	80	1.0000000
NODE_3399_length_1266_cov_14.218509	697	777	0	80	80	1.0000000
NODE_3403_length_1265_cov_9.807890	429	509	2	54	80	0.6750000
NODE_3403_length_1265_cov_9.807890	429	509	6	26	80	0.3250000
NODE_3403_length_1265_cov_9.807890	482	562	0	9	80	0.1125000
NODE_3403_length_1265_cov_9.807890	482	562	2	71	80	0.8875000
NODE_3404_length_1265_cov_8.233276	160	207	4	4	47	0.0851064
NODE_3404_length_1265_cov_8.233276	160	207	6	2	47	0.0425532
NODE_3404_length_1265_cov_8.233276	160	207	10	3	47	0.0638298
NODE_3404_length_1265_cov_8.233276	160	207	12	2	47	0.0425532
NODE_3404_length_1265_cov_8.233276	160	207	14	4	47	0.0851064
NODE_3404_length_1265_cov_8.233276	160	207	16	4	47	0.0851064
NODE_3404_length_1265_cov_8.233276	160	207	20	8	47	0.1702128
NODE_3404_length_1265_cov_8.233276	160	207	22	2	47	0.0425532
NODE_3404_length_1265_cov_8.233276	160	207	26	7	47	0.1489362
NODE_3404_length_1265_cov_8.233276	160	207	30	3	47	0.0638298
NODE_3404_length_1265_cov_8.233276	160	207	34	8	47	0.1702128
NODE_3404_length_1265_cov_8.233276	1004	1058	0	1	54	0.0185185
NODE_3404_length_1265_cov_8.233276	1004	1058	2	53	54	0.9814815
NODE_3406_length_1265_cov_3.941681	503	583	0	54	80	0.6750000
NODE_3406_length_1265_cov_3.941681	503	583	4	26	80	0.3250000
NODE_3406_length_1265_cov_3.941681	556	636	0	80	80	1.0000000
NODE_3408_length_1264_cov_8.024034	290	370	0	80	80	1.0000000
NODE_3408_length_1264_cov_8.024034	343	423	0	80	80	1.0000000
NODE_3413_length_1263_cov_8.566151	698	778	0	80	80	1.0000000
NODE_3413_length_1263_cov_8.566151	751	831	0	80	80	1.0000000
NODE_3413_length_1263_cov_8.566151	833	910	0	77	77	1.0000000
NODE_3413_length_1263_cov_8.566151	883	963	0	80	80	1.0000000
NODE_3414_length_1263_cov_7.376289	1060	1140	0	80	80	1.0000000
NODE_3414_length_1263_cov_7.376289	1113	1213	0	100	100	1.0000000
NODE_3416_length_1263_cov_1.827320	227	307	0	80	80	1.0000000
NODE_3416_length_1263_cov_1.827320	280	360	0	80	80	1.0000000
NODE_3418_length_1262_cov_17.416165	404	484	0	80	80	1.0000000
NODE_3418_length_1262_cov_17.416165	457	537	0	80	80	1.0000000
NODE_3419_length_1262_cov_15.268272	648	728	0	80	80	1.0000000
NODE_3419_length_1262_cov_15.268272	701	781	0	80	80	1.0000000
NODE_3419_length_1262_cov_15.268272	777	857	0	51	80	0.6375000
NODE_3419_length_1262_cov_15.268272	777	857	10	29	80	0.3625000
NODE_3419_length_1262_cov_15.268272	830	910	9	18	80	0.2250000
NODE_3419_length_1262_cov_15.268272	830	910	10	62	80	0.7750000
NODE_3424_length_1261_cov_1.777969	272	318	0	46	46	1.0000000
NODE_3425_length_1260_cov_55.640827	499	579	0	80	80	1.0000000
NODE_3425_length_1260_cov_55.640827	552	632	0	39	80	0.4875000
NODE_3425_length_1260_cov_55.640827	552	632	2	41	80	0.5125000
NODE_3425_length_1260_cov_55.640827	628	708	0	3	80	0.0375000
NODE_3425_length_1260_cov_55.640827	628	708	2	77	80	0.9625000
NODE_3425_length_1260_cov_55.640827	681	761	0	3	80	0.0375000
NODE_3425_length_1260_cov_55.640827	681	761	2	77	80	0.9625000
NODE_3426_length_1260_cov_12.242894	427	507	7	1	80	0.0125000
NODE_3426_length_1260_cov_12.242894	427	507	9	10	80	0.1250000
NODE_3426_length_1260_cov_12.242894	427	507	10	48	80	0.6000000
NODE_3426_length_1260_cov_12.242894	427	507	11	21	80	0.2625000
NODE_3426_length_1260_cov_12.242894	480	560	1	38	80	0.4750000
NODE_3426_length_1260_cov_12.242894	480	560	7	3	80	0.0375000
NODE_3426_length_1260_cov_12.242894	480	560	9	3	80	0.0375000
NODE_3426_length_1260_cov_12.242894	480	560	10	6	80	0.0750000
NODE_3426_length_1260_cov_12.242894	480	560	11	30	80	0.3750000
NODE_3436_length_1259_cov_15.381897	509	589	0	7	80	0.0875000
NODE_3436_length_1259_cov_15.381897	509	589	4	73	80	0.9125000
NODE_3436_length_1259_cov_15.381897	562	642	0	60	80	0.7500000
NODE_3436_length_1259_cov_15.381897	562	642	4	20	80	0.2500000
NODE_3439_length_1258_cov_33.519413	608	688	0	54	80	0.6750000
NODE_3439_length_1258_cov_33.519413	608	688	2	24	80	0.3000000
NODE_3439_length_1258_cov_33.519413	608	688	4	1	80	0.0125000
NODE_3439_length_1258_cov_33.519413	608	688	5	1	80	0.0125000
NODE_3439_length_1258_cov_33.519413	661	741	0	1	80	0.0125000
NODE_3439_length_1258_cov_33.519413	661	741	2	24	80	0.3000000
NODE_3439_length_1258_cov_33.519413	661	741	4	1	80	0.0125000
NODE_3439_length_1258_cov_33.519413	661	741	5	25	80	0.3125000
NODE_3439_length_1258_cov_33.519413	661	741	6	29	80	0.3625000
NODE_3440_length_1258_cov_22.569456	583	663	0	47	80	0.5875000
NODE_3440_length_1258_cov_22.569456	583	663	8	33	80	0.4125000
NODE_3440_length_1258_cov_22.569456	636	716	0	2	80	0.0250000
NODE_3440_length_1258_cov_22.569456	636	716	8	78	80	0.9750000
NODE_3441_length_1258_cov_18.747196	308	388	0	80	80	1.0000000
NODE_3441_length_1258_cov_18.747196	361	441	0	80	80	1.0000000
NODE_3441_length_1258_cov_18.747196	437	517	0	80	80	1.0000000
NODE_3441_length_1258_cov_18.747196	490	570	0	28	80	0.3500000
NODE_3441_length_1258_cov_18.747196	490	570	2	52	80	0.6500000
NODE_3442_length_1258_cov_13.699741	332	412	0	2	80	0.0250000
NODE_3442_length_1258_cov_13.699741	332	412	4	42	80	0.5250000
NODE_3442_length_1258_cov_13.699741	332	412	6	36	80	0.4500000
NODE_3442_length_1258_cov_13.699741	385	465	0	3	80	0.0375000
NODE_3442_length_1258_cov_13.699741	385	465	2	43	80	0.5375000
NODE_3442_length_1258_cov_13.699741	385	465	6	34	80	0.4250000
NODE_3447_length_1257_cov_34.029361	567	647	0	80	80	1.0000000
NODE_3447_length_1257_cov_34.029361	620	700	0	80	80	1.0000000
NODE_3447_length_1257_cov_34.029361	696	776	0	5	80	0.0625000
NODE_3447_length_1257_cov_34.029361	696	776	4	75	80	0.9375000
NODE_3447_length_1257_cov_34.029361	749	829	0	29	80	0.3625000
NODE_3447_length_1257_cov_34.029361	749	829	4	51	80	0.6375000
NODE_3449_length_1257_cov_7.892919	317	397	0	18	80	0.2250000
NODE_3449_length_1257_cov_7.892919	317	397	2	62	80	0.7750000
NODE_3449_length_1257_cov_7.892919	370	450	0	22	80	0.2750000
NODE_3449_length_1257_cov_7.892919	370	450	2	58	80	0.7250000
NODE_3452_length_1256_cov_50.506482	389	469	0	24	80	0.3000000
NODE_3452_length_1256_cov_50.506482	389	469	2	1	80	0.0125000
NODE_3452_length_1256_cov_50.506482	389	469	3	55	80	0.6875000
NODE_3452_length_1256_cov_50.506482	442	522	3	56	80	0.7000000
NODE_3452_length_1256_cov_50.506482	442	522	4	24	80	0.3000000
NODE_3452_length_1256_cov_50.506482	518	598	3	34	80	0.4250000
NODE_3452_length_1256_cov_50.506482	518	598	7	1	80	0.0125000
NODE_3452_length_1256_cov_50.506482	518	598	8	41	80	0.5125000
NODE_3452_length_1256_cov_50.506482	518	598	10	1	80	0.0125000
NODE_3452_length_1256_cov_50.506482	518	598	11	3	80	0.0375000
NODE_3452_length_1256_cov_50.506482	571	651	0	19	80	0.2375000
NODE_3452_length_1256_cov_50.506482	571	651	5	18	80	0.2250000
NODE_3452_length_1256_cov_50.506482	571	651	7	17	80	0.2125000
NODE_3452_length_1256_cov_50.506482	571	651	8	26	80	0.3250000
NODE_3453_length_1256_cov_25.944685	754	834	0	18	80	0.2250000
NODE_3453_length_1256_cov_25.944685	754	834	2	49	80	0.6125000
NODE_3453_length_1256_cov_25.944685	754	834	4	13	80	0.1625000
NODE_3453_length_1256_cov_25.944685	807	887	2	41	80	0.5125000
NODE_3453_length_1256_cov_25.944685	807	887	4	39	80	0.4875000
NODE_3455_length_1256_cov_21.720830	713	793	0	80	80	1.0000000
NODE_3455_length_1256_cov_21.720830	766	846	0	80	80	1.0000000
NODE_3456_length_1256_cov_14.242005	595	675	0	80	80	1.0000000
NODE_3456_length_1256_cov_14.242005	648	728	0	80	80	1.0000000
NODE_3457_length_1256_cov_5.870354	879	959	0	80	80	1.0000000
NODE_3463_length_1255_cov_37.271626	458	538	0	80	80	1.0000000
NODE_3463_length_1255_cov_37.271626	511	591	0	80	80	1.0000000
NODE_3463_length_1255_cov_37.271626	587	667	0	14	80	0.1750000
NODE_3463_length_1255_cov_37.271626	587	667	2	27	80	0.3375000
NODE_3463_length_1255_cov_37.271626	587	667	4	39	80	0.4875000
NODE_3463_length_1255_cov_37.271626	640	720	0	15	80	0.1875000
NODE_3463_length_1255_cov_37.271626	640	720	2	13	80	0.1625000
NODE_3463_length_1255_cov_37.271626	640	720	4	52	80	0.6500000
NODE_3464_length_1255_cov_21.374567	516	596	2	15	80	0.1875000
NODE_3464_length_1255_cov_21.374567	516	596	4	39	80	0.4875000
NODE_3464_length_1255_cov_21.374567	516	596	10	26	80	0.3250000
NODE_3464_length_1255_cov_21.374567	569	649	4	1	80	0.0125000
NODE_3464_length_1255_cov_21.374567	569	649	6	25	80	0.3125000
NODE_3464_length_1255_cov_21.374567	569	649	8	17	80	0.2125000
NODE_3464_length_1255_cov_21.374567	569	649	10	37	80	0.4625000
NODE_3464_length_1255_cov_21.374567	645	725	0	69	80	0.8625000
NODE_3464_length_1255_cov_21.374567	645	725	6	11	80	0.1375000
NODE_3464_length_1255_cov_21.374567	698	778	0	80	80	1.0000000
NODE_3465_length_1255_cov_18.391869	521	601	8	24	80	0.3000000
NODE_3465_length_1255_cov_18.391869	521	601	10	56	80	0.7000000
NODE_3465_length_1255_cov_18.391869	574	654	1	22	80	0.2750000
NODE_3465_length_1255_cov_18.391869	574	654	2	20	80	0.2500000
NODE_3465_length_1255_cov_18.391869	574	654	3	1	80	0.0125000
NODE_3465_length_1255_cov_18.391869	574	654	8	30	80	0.3750000
NODE_3465_length_1255_cov_18.391869	574	654	10	7	80	0.0875000
NODE_3466_length_1255_cov_4.096021	1194	1242	0	48	48	1.0000000
NODE_3469_length_1254_cov_32.470996	612	692	2	8	80	0.1000000
NODE_3469_length_1254_cov_32.470996	612	692	4	21	80	0.2625000
NODE_3469_length_1254_cov_32.470996	612	692	6	51	80	0.6375000
NODE_3469_length_1254_cov_32.470996	665	745	2	38	80	0.4750000
NODE_3469_length_1254_cov_32.470996	665	745	4	3	80	0.0375000
NODE_3469_length_1254_cov_32.470996	665	745	6	39	80	0.4875000
NODE_3470_length_1254_cov_26.449351	488	568	3	16	80	0.2000000
NODE_3470_length_1254_cov_26.449351	488	568	4	64	80	0.8000000
NODE_3470_length_1254_cov_26.449351	541	621	1	50	80	0.6250000
NODE_3470_length_1254_cov_26.449351	541	621	3	14	80	0.1750000
NODE_3470_length_1254_cov_26.449351	541	621	4	16	80	0.2000000
NODE_3471_length_1254_cov_22.032035	531	611	2	45	80	0.5625000
NODE_3471_length_1254_cov_22.032035	531	611	4	35	80	0.4375000
NODE_3471_length_1254_cov_22.032035	584	664	0	25	80	0.3125000
NODE_3471_length_1254_cov_22.032035	584	664	2	55	80	0.6875000
NODE_3479_length_1253_cov_16.916811	651	731	0	80	80	1.0000000
NODE_3479_length_1253_cov_16.916811	704	784	0	80	80	1.0000000
NODE_3479_length_1253_cov_16.916811	780	860	0	80	80	1.0000000
NODE_3479_length_1253_cov_16.916811	833	913	0	80	80	1.0000000
NODE_3480_length_1253_cov_13.816291	811	891	4	60	80	0.7500000
NODE_3480_length_1253_cov_13.816291	811	891	6	20	80	0.2500000
NODE_3481_length_1253_cov_9.067591	306	386	0	80	80	1.0000000
NODE_3481_length_1253_cov_9.067591	359	439	0	77	80	0.9625000
NODE_3481_length_1253_cov_9.067591	359	439	2	3	80	0.0375000
NODE_3487_length_1252_cov_57.745880	477	557	0	80	80	1.0000000
NODE_3487_length_1252_cov_57.745880	530	610	0	58	80	0.7250000
NODE_3487_length_1252_cov_57.745880	530	610	2	22	80	0.2750000
NODE_3487_length_1252_cov_57.745880	606	686	2	60	80	0.7500000
NODE_3487_length_1252_cov_57.745880	606	686	4	20	80	0.2500000
NODE_3487_length_1252_cov_57.745880	659	739	0	7	80	0.0875000
NODE_3487_length_1252_cov_57.745880	659	739	2	50	80	0.6250000
NODE_3487_length_1252_cov_57.745880	659	739	4	23	80	0.2875000
NODE_3488_length_1252_cov_56.694709	594	674	0	80	80	1.0000000
NODE_3488_length_1252_cov_56.694709	647	727	0	80	80	1.0000000
NODE_3488_length_1252_cov_56.694709	723	803	0	35	80	0.4375000
NODE_3488_length_1252_cov_56.694709	723	803	8	45	80	0.5625000
NODE_3488_length_1252_cov_56.694709	785	847	8	30	62	0.4838710
NODE_3488_length_1252_cov_56.694709	785	847	10	32	62	0.5161290
NODE_3489_length_1252_cov_34.023417	468	548	8	35	80	0.4375000
NODE_3489_length_1252_cov_34.023417	468	548	9	1	80	0.0125000
NODE_3489_length_1252_cov_34.023417	468	548	10	44	80	0.5500000
NODE_3489_length_1252_cov_34.023417	521	601	0	41	80	0.5125000
NODE_3489_length_1252_cov_34.023417	521	601	2	5	80	0.0625000
NODE_3489_length_1252_cov_34.023417	521	601	8	27	80	0.3375000
NODE_3489_length_1252_cov_34.023417	521	601	9	1	80	0.0125000
NODE_3489_length_1252_cov_34.023417	521	601	10	6	80	0.0750000
NODE_3489_length_1252_cov_34.023417	597	677	0	80	80	1.0000000
NODE_3489_length_1252_cov_34.023417	650	730	0	80	80	1.0000000
NODE_3490_length_1252_cov_9.316565	573	653	6	13	80	0.1625000
NODE_3490_length_1252_cov_9.316565	573	653	10	5	80	0.0625000
NODE_3490_length_1252_cov_9.316565	573	653	12	53	80	0.6625000
NODE_3490_length_1252_cov_9.316565	573	653	14	3	80	0.0375000
NODE_3490_length_1252_cov_9.316565	573	653	16	6	80	0.0750000
NODE_3490_length_1252_cov_9.316565	626	706	0	19	80	0.2375000
NODE_3490_length_1252_cov_9.316565	626	706	4	17	80	0.2125000
NODE_3490_length_1252_cov_9.316565	626	706	6	1	80	0.0125000
NODE_3490_length_1252_cov_9.316565	626	706	9	1	80	0.0125000
NODE_3490_length_1252_cov_9.316565	626	706	10	1	80	0.0125000
NODE_3490_length_1252_cov_9.316565	626	706	12	41	80	0.5125000
NODE_3491_length_1252_cov_8.295750	602	682	0	80	80	1.0000000
NODE_3491_length_1252_cov_8.295750	655	735	0	80	80	1.0000000
NODE_3494_length_1251_cov_17.513889	579	659	0	78	80	0.9750000
NODE_3494_length_1251_cov_17.513889	579	659	2	2	80	0.0250000
NODE_3494_length_1251_cov_17.513889	632	712	0	80	80	1.0000000
NODE_3494_length_1251_cov_17.513889	708	788	0	41	80	0.5125000
NODE_3494_length_1251_cov_17.513889	708	788	2	39	80	0.4875000
NODE_3494_length_1251_cov_17.513889	761	841	2	80	80	1.0000000
NODE_3497_length_1251_cov_3.139757	0	76	0	76	76	1.0000000
NODE_3497_length_1251_cov_3.139757	49	98	0	49	49	1.0000000
NODE_3501_length_1250_cov_25.133797	325	405	0	26	80	0.3250000
NODE_3501_length_1250_cov_25.133797	325	405	2	54	80	0.6750000
NODE_3501_length_1250_cov_25.133797	378	458	0	24	80	0.3000000
NODE_3501_length_1250_cov_25.133797	378	458	2	56	80	0.7000000
NODE_3503_length_1250_cov_11.471764	652	733	0	41	81	0.5061728
NODE_3503_length_1250_cov_11.471764	652	733	2	40	81	0.4938272
NODE_3503_length_1250_cov_11.471764	706	786	0	6	80	0.0750000
NODE_3503_length_1250_cov_11.471764	706	786	2	74	80	0.9250000
NODE_3505_length_1249_cov_45.772174	543	623	0	80	80	1.0000000
NODE_3505_length_1249_cov_45.772174	596	676	0	80	80	1.0000000
NODE_3505_length_1249_cov_45.772174	672	749	0	19	77	0.2467532
NODE_3505_length_1249_cov_45.772174	672	749	23	1	77	0.0129870
NODE_3505_length_1249_cov_45.772174	672	749	24	57	77	0.7402598
NODE_3505_length_1249_cov_45.772174	729	802	24	73	73	1.0000000
NODE_3506_length_1249_cov_35.670435	515	595	0	43	80	0.5375000
NODE_3506_length_1249_cov_35.670435	515	595	2	37	80	0.4625000
NODE_3506_length_1249_cov_35.670435	568	648	0	7	80	0.0875000
NODE_3506_length_1249_cov_35.670435	568	648	2	73	80	0.9125000
NODE_3506_length_1249_cov_35.670435	644	724	0	80	80	1.0000000
NODE_3506_length_1249_cov_35.670435	697	777	0	32	80	0.4000000
NODE_3506_length_1249_cov_35.670435	697	777	6	48	80	0.6000000
NODE_3507_length_1249_cov_34.616522	576	656	0	26	80	0.3250000
NODE_3507_length_1249_cov_34.616522	576	656	2	17	80	0.2125000
NODE_3507_length_1249_cov_34.616522	576	656	4	37	80	0.4625000
NODE_3507_length_1249_cov_34.616522	629	709	2	16	80	0.2000000
NODE_3507_length_1249_cov_34.616522	629	709	4	64	80	0.8000000
NODE_3507_length_1249_cov_34.616522	705	785	0	73	80	0.9125000
NODE_3507_length_1249_cov_34.616522	705	785	2	7	80	0.0875000
NODE_3507_length_1249_cov_34.616522	758	838	0	34	80	0.4250000
NODE_3507_length_1249_cov_34.616522	758	838	1	46	80	0.5750000
NODE_3508_length_1249_cov_19.592174	461	541	0	21	80	0.2625000
NODE_3508_length_1249_cov_19.592174	461	541	2	59	80	0.7375000
NODE_3508_length_1249_cov_19.592174	514	594	0	31	80	0.3875000
NODE_3508_length_1249_cov_19.592174	514	594	2	49	80	0.6125000
NODE_3508_length_1249_cov_19.592174	860	940	0	64	80	0.8000000
NODE_3508_length_1249_cov_19.592174	860	940	2	16	80	0.2000000
NODE_3508_length_1249_cov_19.592174	913	993	0	80	80	1.0000000
NODE_3509_length_1249_cov_14.926957	1153	1219	0	66	66	1.0000000
NODE_3509_length_1249_cov_14.926957	1192	1249	0	57	57	1.0000000
NODE_3509_length_1249_cov_14.926957	1192	1247	0	55	55	1.0000000
NODE_3509_length_1249_cov_14.926957	1192	1249	0	57	57	1.0000000
NODE_3510_length_1249_cov_7.682609	757	837	0	80	80	1.0000000
NODE_3510_length_1249_cov_7.682609	810	890	0	80	80	1.0000000
NODE_3514_length_1248_cov_14.351610	469	549	2	28	80	0.3500000
NODE_3514_length_1248_cov_14.351610	469	549	4	25	80	0.3125000
NODE_3514_length_1248_cov_14.351610	469	549	6	27	80	0.3375000
NODE_3514_length_1248_cov_14.351610	522	602	0	10	80	0.1250000
NODE_3514_length_1248_cov_14.351610	522	602	2	13	80	0.1625000
NODE_3514_length_1248_cov_14.351610	522	602	4	32	80	0.4000000
NODE_3514_length_1248_cov_14.351610	522	602	6	25	80	0.3125000
NODE_3514_length_1248_cov_14.351610	598	678	0	16	80	0.2000000
NODE_3514_length_1248_cov_14.351610	598	678	4	64	80	0.8000000
NODE_3514_length_1248_cov_14.351610	651	731	4	48	80	0.6000000
NODE_3514_length_1248_cov_14.351610	651	731	6	32	80	0.4000000
NODE_3515_length_1248_cov_11.181027	303	383	4	2	80	0.0250000
NODE_3515_length_1248_cov_11.181027	303	383	6	7	80	0.0875000
NODE_3515_length_1248_cov_11.181027	303	383	7	48	80	0.6000000
NODE_3515_length_1248_cov_11.181027	303	383	10	23	80	0.2875000
NODE_3515_length_1248_cov_11.181027	356	436	0	15	80	0.1875000
NODE_3515_length_1248_cov_11.181027	356	436	4	40	80	0.5000000
NODE_3515_length_1248_cov_11.181027	356	436	7	25	80	0.3125000
NODE_3515_length_1248_cov_11.181027	432	512	0	12	80	0.1500000
NODE_3515_length_1248_cov_11.181027	432	512	1	35	80	0.4375000
NODE_3515_length_1248_cov_11.181027	432	512	2	33	80	0.4125000
NODE_3515_length_1248_cov_11.181027	485	565	0	11	80	0.1375000
NODE_3515_length_1248_cov_11.181027	485	565	1	69	80	0.8625000
NODE_3516_length_1248_cov_4.372498	17	98	0	81	81	1.0000000
NODE_3516_length_1248_cov_4.372498	94	152	0	58	58	1.0000000
NODE_3517_length_1248_cov_2.356832	952	1032	0	80	80	1.0000000
NODE_3517_length_1248_cov_2.356832	1005	1085	0	80	80	1.0000000
NODE_3518_length_1248_cov_2.283725	1102	1151	0	49	49	1.0000000
NODE_3522_length_1247_cov_25.355401	487	567	0	36	80	0.4500000
NODE_3522_length_1247_cov_25.355401	487	567	4	44	80	0.5500000
NODE_3522_length_1247_cov_25.355401	540	620	0	10	80	0.1250000
NODE_3522_length_1247_cov_25.355401	540	620	4	70	80	0.8750000
NODE_3522_length_1247_cov_25.355401	616	696	0	80	80	1.0000000
NODE_3522_length_1247_cov_25.355401	669	749	0	80	80	1.0000000
NODE_3528_length_1246_cov_30.231909	433	513	0	36	80	0.4500000
NODE_3528_length_1246_cov_30.231909	433	513	4	44	80	0.5500000
NODE_3528_length_1246_cov_30.231909	486	566	4	53	80	0.6625000
NODE_3528_length_1246_cov_30.231909	486	566	6	7	80	0.0875000
NODE_3528_length_1246_cov_30.231909	486	566	8	10	80	0.1250000
NODE_3528_length_1246_cov_30.231909	486	566	12	10	80	0.1250000
NODE_3528_length_1246_cov_30.231909	562	642	8	10	80	0.1250000
NODE_3528_length_1246_cov_30.231909	562	642	14	5	80	0.0625000
NODE_3528_length_1246_cov_30.231909	562	642	16	65	80	0.8125000
NODE_3528_length_1246_cov_30.231909	615	695	6	12	80	0.1500000
NODE_3528_length_1246_cov_30.231909	615	695	16	49	80	0.6125000
NODE_3528_length_1246_cov_30.231909	615	695	20	15	80	0.1875000
NODE_3528_length_1246_cov_30.231909	615	695	21	1	80	0.0125000
NODE_3528_length_1246_cov_30.231909	615	695	22	3	80	0.0375000
NODE_3529_length_1246_cov_13.847428	497	577	0	51	80	0.6375000
NODE_3529_length_1246_cov_13.847428	497	577	1	19	80	0.2375000
NODE_3529_length_1246_cov_13.847428	497	577	2	10	80	0.1250000
NODE_3529_length_1246_cov_13.847428	550	630	1	17	80	0.2125000
NODE_3529_length_1246_cov_13.847428	550	630	2	63	80	0.7875000
NODE_3535_length_1245_cov_31.472949	443	523	0	80	80	1.0000000
NODE_3535_length_1245_cov_31.472949	496	576	0	80	80	1.0000000
NODE_3536_length_1245_cov_30.068935	771	841	0	9	70	0.1285714
NODE_3536_length_1245_cov_30.068935	771	841	2	39	70	0.5571429
NODE_3536_length_1245_cov_30.068935	771	841	3	16	70	0.2285714
NODE_3536_length_1245_cov_30.068935	771	841	4	6	70	0.0857143
NODE_3537_length_1245_cov_24.765271	668	748	0	12	80	0.1500000
NODE_3537_length_1245_cov_24.765271	668	748	2	19	80	0.2375000
NODE_3537_length_1245_cov_24.765271	668	748	6	49	80	0.6125000
NODE_3537_length_1245_cov_24.765271	721	801	0	33	80	0.4125000
NODE_3537_length_1245_cov_24.765271	721	801	2	47	80	0.5875000
NODE_3537_length_1245_cov_24.765271	797	877	0	16	80	0.2000000
NODE_3537_length_1245_cov_24.765271	797	877	2	64	80	0.8000000
NODE_3537_length_1245_cov_24.765271	850	930	0	69	80	0.8625000
NODE_3537_length_1245_cov_24.765271	850	930	2	11	80	0.1375000
NODE_3538_length_1245_cov_16.854276	655	735	0	80	80	1.0000000
NODE_3538_length_1245_cov_16.854276	701	771	0	70	70	1.0000000
NODE_3538_length_1245_cov_16.854276	708	788	0	80	80	1.0000000
NODE_3540_length_1245_cov_1.187609	1148	1194	2	45	46	0.9782609
NODE_3540_length_1245_cov_1.187609	1148	1194	4	1	46	0.0217391
NODE_3540_length_1245_cov_1.187609	1167	1245	0	15	78	0.1923077
NODE_3540_length_1245_cov_1.187609	1167	1245	2	63	78	0.8076923
NODE_3541_length_1244_cov_52.633188	501	581	2	14	80	0.1750000
NODE_3541_length_1244_cov_52.633188	501	581	5	1	80	0.0125000
NODE_3541_length_1244_cov_52.633188	501	581	6	40	80	0.5000000
NODE_3541_length_1244_cov_52.633188	501	581	8	25	80	0.3125000
NODE_3541_length_1244_cov_52.633188	554	634	2	18	80	0.2250000
NODE_3541_length_1244_cov_52.633188	554	634	5	36	80	0.4500000
NODE_3541_length_1244_cov_52.633188	554	634	6	17	80	0.2125000
NODE_3541_length_1244_cov_52.633188	554	634	8	9	80	0.1125000
NODE_3541_length_1244_cov_52.633188	630	710	2	42	80	0.5250000
NODE_3541_length_1244_cov_52.633188	630	710	4	11	80	0.1375000
NODE_3541_length_1244_cov_52.633188	630	710	6	27	80	0.3375000
NODE_3541_length_1244_cov_52.633188	683	763	4	26	80	0.3250000
NODE_3541_length_1244_cov_52.633188	683	763	6	54	80	0.6750000
NODE_3542_length_1244_cov_33.889956	445	525	0	3	80	0.0375000
NODE_3542_length_1244_cov_33.889956	445	525	2	77	80	0.9625000
NODE_3542_length_1244_cov_33.889956	498	578	0	22	80	0.2750000
NODE_3542_length_1244_cov_33.889956	498	578	2	58	80	0.7250000
NODE_3542_length_1244_cov_33.889956	574	654	0	70	80	0.8750000
NODE_3542_length_1244_cov_33.889956	574	654	2	10	80	0.1250000
NODE_3542_length_1244_cov_33.889956	627	707	0	17	80	0.2125000
NODE_3542_length_1244_cov_33.889956	627	707	2	63	80	0.7875000
NODE_3543_length_1244_cov_16.798253	644	724	0	16	80	0.2000000
NODE_3543_length_1244_cov_16.798253	644	724	4	18	80	0.2250000
NODE_3543_length_1244_cov_16.798253	644	724	6	46	80	0.5750000
NODE_3543_length_1244_cov_16.798253	697	777	4	2	80	0.0250000
NODE_3543_length_1244_cov_16.798253	697	777	6	78	80	0.9750000
NODE_3544_length_1244_cov_1.735371	276	347	0	71	71	1.0000000
NODE_3544_length_1244_cov_1.735371	276	347	0	71	71	1.0000000
NODE_3544_length_1244_cov_1.735371	320	400	0	80	80	1.0000000
NODE_3544_length_1244_cov_1.735371	320	400	0	80	80	1.0000000
NODE_3548_length_1243_cov_34.284965	774	854	0	74	80	0.9250000
NODE_3548_length_1243_cov_34.284965	774	854	2	6	80	0.0750000
NODE_3548_length_1243_cov_34.284965	827	907	0	21	80	0.2625000
NODE_3548_length_1243_cov_34.284965	827	907	2	59	80	0.7375000
NODE_3552_length_1242_cov_29.665792	539	619	0	80	80	1.0000000
NODE_3552_length_1242_cov_29.665792	592	672	0	80	80	1.0000000
NODE_3553_length_1242_cov_28.304462	506	586	0	10	80	0.1250000
NODE_3553_length_1242_cov_28.304462	506	586	4	17	80	0.2125000
NODE_3553_length_1242_cov_28.304462	506	586	6	2	80	0.0250000
NODE_3553_length_1242_cov_28.304462	506	586	8	9	80	0.1125000
NODE_3553_length_1242_cov_28.304462	506	586	10	42	80	0.5250000
NODE_3553_length_1242_cov_28.304462	559	639	0	7	80	0.0875000
NODE_3553_length_1242_cov_28.304462	559	639	2	10	80	0.1250000
NODE_3553_length_1242_cov_28.304462	559	639	4	23	80	0.2875000
NODE_3553_length_1242_cov_28.304462	559	639	6	4	80	0.0500000
NODE_3553_length_1242_cov_28.304462	559	639	8	15	80	0.1875000
NODE_3553_length_1242_cov_28.304462	559	639	10	21	80	0.2625000
NODE_3553_length_1242_cov_28.304462	635	715	0	80	80	1.0000000
NODE_3553_length_1242_cov_28.304462	688	768	0	80	80	1.0000000
NODE_3554_length_1242_cov_16.383202	704	784	0	40	80	0.5000000
NODE_3554_length_1242_cov_16.383202	704	784	1	12	80	0.1500000
NODE_3554_length_1242_cov_16.383202	704	784	2	28	80	0.3500000
NODE_3554_length_1242_cov_16.383202	757	837	0	80	80	1.0000000
NODE_3555_length_1242_cov_8.081365	688	768	0	9	80	0.1125000
NODE_3555_length_1242_cov_8.081365	688	768	2	71	80	0.8875000
NODE_3555_length_1242_cov_8.081365	741	821	2	80	80	1.0000000
NODE_3561_length_1241_cov_36.544658	602	682	0	80	80	1.0000000
NODE_3561_length_1241_cov_36.544658	655	735	0	80	80	1.0000000
NODE_3562_length_1241_cov_19.894921	676	756	4	80	80	1.0000000
NODE_3562_length_1241_cov_19.894921	729	809	0	13	80	0.1625000
NODE_3562_length_1241_cov_19.894921	729	809	2	10	80	0.1250000
NODE_3562_length_1241_cov_19.894921	729	809	4	57	80	0.7125000
NODE_3569_length_1240_cov_38.375110	483	563	0	80	80	1.0000000
NODE_3569_length_1240_cov_38.375110	536	616	0	80	80	1.0000000
NODE_3569_length_1240_cov_38.375110	612	692	0	32	80	0.4000000
NODE_3569_length_1240_cov_38.375110	612	692	1	3	80	0.0375000
NODE_3569_length_1240_cov_38.375110	612	692	2	45	80	0.5625000
NODE_3569_length_1240_cov_38.375110	665	745	0	19	80	0.2375000
NODE_3569_length_1240_cov_38.375110	665	745	1	21	80	0.2625000
NODE_3569_length_1240_cov_38.375110	665	745	2	40	80	0.5000000
NODE_3570_length_1240_cov_24.975460	625	705	0	57	80	0.7125000
NODE_3570_length_1240_cov_24.975460	625	705	8	23	80	0.2875000
NODE_3570_length_1240_cov_24.975460	678	758	0	4	80	0.0500000
NODE_3570_length_1240_cov_24.975460	678	758	8	76	80	0.9500000
NODE_3571_length_1240_cov_23.812445	731	811	2	44	80	0.5500000
NODE_3571_length_1240_cov_23.812445	731	811	6	7	80	0.0875000
NODE_3571_length_1240_cov_23.812445	731	811	12	26	80	0.3250000
NODE_3571_length_1240_cov_23.812445	731	811	14	3	80	0.0375000
NODE_3571_length_1240_cov_23.812445	784	864	12	79	80	0.9875000
NODE_3571_length_1240_cov_23.812445	784	864	14	1	80	0.0125000
NODE_3576_length_1239_cov_37.657895	399	479	0	27	80	0.3375000
NODE_3576_length_1239_cov_37.657895	399	479	2	53	80	0.6625000
NODE_3576_length_1239_cov_37.657895	452	532	0	80	80	1.0000000
NODE_3576_length_1239_cov_37.657895	528	608	0	27	80	0.3375000
NODE_3576_length_1239_cov_37.657895	528	608	2	53	80	0.6625000
NODE_3576_length_1239_cov_37.657895	581	661	0	38	80	0.4750000
NODE_3576_length_1239_cov_37.657895	581	661	2	42	80	0.5250000
NODE_3577_length_1239_cov_14.984211	398	478	0	80	80	1.0000000
NODE_3577_length_1239_cov_14.984211	451	531	0	80	80	1.0000000
NODE_3577_length_1239_cov_14.984211	771	825	0	54	54	1.0000000
NODE_3577_length_1239_cov_14.984211	798	878	0	80	80	1.0000000
NODE_3578_length_1239_cov_13.312281	806	886	4	43	80	0.5375000
NODE_3578_length_1239_cov_13.312281	806	886	6	37	80	0.4625000
NODE_3578_length_1239_cov_13.312281	859	939	2	24	80	0.3000000
NODE_3578_length_1239_cov_13.312281	859	939	6	56	80	0.7000000
NODE_3579_length_1239_cov_7.116667	444	524	0	80	80	1.0000000
NODE_3579_length_1239_cov_7.116667	497	577	0	80	80	1.0000000
NODE_3582_length_1238_cov_33.830553	625	705	0	80	80	1.0000000
NODE_3582_length_1238_cov_33.830553	678	758	0	80	80	1.0000000
NODE_3583_length_1238_cov_8.163301	664	744	4	53	80	0.6625000
NODE_3583_length_1238_cov_8.163301	664	744	8	8	80	0.1000000
NODE_3583_length_1238_cov_8.163301	664	744	10	9	80	0.1125000
NODE_3583_length_1238_cov_8.163301	664	744	12	10	80	0.1250000
NODE_3583_length_1238_cov_8.163301	717	797	4	8	80	0.1000000
NODE_3583_length_1238_cov_8.163301	717	797	8	20	80	0.2500000
NODE_3583_length_1238_cov_8.163301	717	797	10	17	80	0.2125000
NODE_3583_length_1238_cov_8.163301	717	797	12	35	80	0.4375000
NODE_3586_length_1237_cov_24.562390	447	527	2	7	80	0.0875000
NODE_3586_length_1237_cov_24.562390	447	527	6	73	80	0.9125000
NODE_3586_length_1237_cov_24.562390	500	580	0	34	80	0.4250000
NODE_3586_length_1237_cov_24.562390	500	580	2	26	80	0.3250000
NODE_3586_length_1237_cov_24.562390	500	580	6	20	80	0.2500000
NODE_3587_length_1237_cov_9.297012	515	595	1	36	80	0.4500000
NODE_3587_length_1237_cov_9.297012	515	595	2	44	80	0.5500000
NODE_3587_length_1237_cov_9.297012	568	648	2	36	80	0.4500000
NODE_3587_length_1237_cov_9.297012	568	648	4	44	80	0.5500000
NODE_3594_length_1236_cov_46.661390	632	712	16	9	80	0.1125000
NODE_3594_length_1236_cov_46.661390	632	712	26	2	80	0.0250000
NODE_3594_length_1236_cov_46.661390	632	712	27	3	80	0.0375000
NODE_3594_length_1236_cov_46.661390	632	712	29	17	80	0.2125000
NODE_3594_length_1236_cov_46.661390	632	712	34	4	80	0.0500000
NODE_3594_length_1236_cov_46.661390	632	712	35	3	80	0.0375000
NODE_3594_length_1236_cov_46.661390	632	712	37	4	80	0.0500000
NODE_3594_length_1236_cov_46.661390	632	712	39	4	80	0.0500000
NODE_3594_length_1236_cov_46.661390	632	712	41	34	80	0.4250000
NODE_3594_length_1236_cov_46.661390	685	765	16	35	80	0.4375000
NODE_3594_length_1236_cov_46.661390	685	765	18	1	80	0.0125000
NODE_3594_length_1236_cov_46.661390	685	765	24	1	80	0.0125000
NODE_3594_length_1236_cov_46.661390	685	765	30	5	80	0.0625000
NODE_3594_length_1236_cov_46.661390	685	765	32	7	80	0.0875000
NODE_3594_length_1236_cov_46.661390	685	765	34	8	80	0.1000000
NODE_3594_length_1236_cov_46.661390	685	765	37	2	80	0.0250000
NODE_3594_length_1236_cov_46.661390	685	765	41	21	80	0.2625000
NODE_3595_length_1236_cov_8.625330	735	815	0	25	80	0.3125000
NODE_3595_length_1236_cov_8.625330	735	815	2	10	80	0.1250000
NODE_3595_length_1236_cov_8.625330	735	815	4	45	80	0.5625000
NODE_3595_length_1236_cov_8.625330	788	868	0	15	80	0.1875000
NODE_3595_length_1236_cov_8.625330	788	868	2	19	80	0.2375000
NODE_3595_length_1236_cov_8.625330	788	868	4	46	80	0.5750000
NODE_3597_length_1235_cov_31.619718	331	411	0	58	80	0.7250000
NODE_3597_length_1235_cov_31.619718	331	411	4	22	80	0.2750000
NODE_3597_length_1235_cov_31.619718	384	464	0	5	80	0.0625000
NODE_3597_length_1235_cov_31.619718	384	464	4	75	80	0.9375000
NODE_3598_length_1235_cov_20.252641	559	639	0	80	80	1.0000000
NODE_3598_length_1235_cov_20.252641	612	692	0	80	80	1.0000000
NODE_3598_length_1235_cov_20.252641	688	768	0	80	80	1.0000000
NODE_3598_length_1235_cov_20.252641	741	821	0	32	80	0.4000000
NODE_3598_length_1235_cov_20.252641	741	821	2	48	80	0.6000000
NODE_3599_length_1235_cov_18.462148	695	775	0	66	80	0.8250000
NODE_3599_length_1235_cov_18.462148	695	775	2	14	80	0.1750000
NODE_3599_length_1235_cov_18.462148	748	828	0	13	80	0.1625000
NODE_3599_length_1235_cov_18.462148	748	828	2	67	80	0.8375000
NODE_3600_length_1235_cov_8.696303	765	845	0	47	80	0.5875000
NODE_3600_length_1235_cov_8.696303	765	845	2	33	80	0.4125000
NODE_3600_length_1235_cov_8.696303	818	898	0	9	80	0.1125000
NODE_3600_length_1235_cov_8.696303	818	898	1	1	80	0.0125000
NODE_3600_length_1235_cov_8.696303	818	898	2	70	80	0.8750000
NODE_3601_length_1235_cov_5.580106	544	624	0	24	80	0.3000000
NODE_3601_length_1235_cov_5.580106	544	624	2	26	80	0.3250000
NODE_3601_length_1235_cov_5.580106	544	624	4	13	80	0.1625000
NODE_3601_length_1235_cov_5.580106	544	624	6	17	80	0.2125000
NODE_3601_length_1235_cov_5.580106	597	677	2	4	80	0.0500000
NODE_3601_length_1235_cov_5.580106	597	677	4	16	80	0.2000000
NODE_3601_length_1235_cov_5.580106	597	677	6	60	80	0.7500000
NODE_3608_length_1234_cov_27.136564	528	608	0	80	80	1.0000000
NODE_3608_length_1234_cov_27.136564	581	661	0	30	80	0.3750000
NODE_3608_length_1234_cov_27.136564	581	661	4	50	80	0.6250000
NODE_3611_length_1233_cov_64.374780	497	577	0	80	80	1.0000000
NODE_3611_length_1233_cov_64.374780	550	630	0	80	80	1.0000000
NODE_3611_length_1233_cov_64.374780	626	706	0	80	80	1.0000000
NODE_3611_length_1233_cov_64.374780	679	759	0	37	80	0.4625000
NODE_3611_length_1233_cov_64.374780	679	759	6	43	80	0.5375000
NODE_3612_length_1233_cov_52.833333	654	734	0	80	80	1.0000000
NODE_3612_length_1233_cov_52.833333	707	787	0	33	80	0.4125000
NODE_3612_length_1233_cov_52.833333	707	787	4	11	80	0.1375000
NODE_3612_length_1233_cov_52.833333	707	787	6	36	80	0.4500000
NODE_3613_length_1233_cov_18.096120	522	602	6	1	80	0.0125000
NODE_3613_length_1233_cov_18.096120	522	602	10	7	80	0.0875000
NODE_3613_length_1233_cov_18.096120	522	602	11	1	80	0.0125000
NODE_3613_length_1233_cov_18.096120	522	602	12	49	80	0.6125000
NODE_3613_length_1233_cov_18.096120	522	602	14	6	80	0.0750000
NODE_3613_length_1233_cov_18.096120	522	602	16	1	80	0.0125000
NODE_3613_length_1233_cov_18.096120	522	602	21	15	80	0.1875000
NODE_3613_length_1233_cov_18.096120	575	655	8	2	80	0.0250000
NODE_3613_length_1233_cov_18.096120	575	655	10	5	80	0.0625000
NODE_3613_length_1233_cov_18.096120	575	655	12	18	80	0.2250000
NODE_3613_length_1233_cov_18.096120	575	655	14	6	80	0.0750000
NODE_3613_length_1233_cov_18.096120	575	655	16	6	80	0.0750000
NODE_3613_length_1233_cov_18.096120	575	655	21	35	80	0.4375000
NODE_3613_length_1233_cov_18.096120	575	655	22	8	80	0.1000000
NODE_3613_length_1233_cov_18.096120	651	731	0	33	80	0.4125000
NODE_3613_length_1233_cov_18.096120	651	731	6	29	80	0.3625000
NODE_3613_length_1233_cov_18.096120	651	731	8	16	80	0.2000000
NODE_3613_length_1233_cov_18.096120	651	731	10	2	80	0.0250000
NODE_3613_length_1233_cov_18.096120	704	784	0	80	80	1.0000000
NODE_3614_length_1233_cov_15.360670	585	656	0	71	71	1.0000000
NODE_3614_length_1233_cov_15.360670	631	709	0	78	78	1.0000000
NODE_3620_length_1232_cov_62.112974	552	632	0	80	80	1.0000000
NODE_3620_length_1232_cov_62.112974	605	694	0	89	89	1.0000000
NODE_3620_length_1232_cov_62.112974	690	770	0	57	80	0.7125000
NODE_3620_length_1232_cov_62.112974	690	770	2	17	80	0.2125000
NODE_3620_length_1232_cov_62.112974	690	770	4	6	80	0.0750000
NODE_3620_length_1232_cov_62.112974	743	823	0	4	80	0.0500000
NODE_3620_length_1232_cov_62.112974	743	823	2	17	80	0.2125000
NODE_3620_length_1232_cov_62.112974	743	823	4	57	80	0.7125000
NODE_3620_length_1232_cov_62.112974	743	823	7	1	80	0.0125000
NODE_3620_length_1232_cov_62.112974	743	823	10	1	80	0.0125000
NODE_3621_length_1232_cov_34.635481	469	549	2	7	80	0.0875000
NODE_3621_length_1232_cov_34.635481	469	549	4	17	80	0.2125000
NODE_3621_length_1232_cov_34.635481	469	549	8	1	80	0.0125000
NODE_3621_length_1232_cov_34.635481	469	549	9	4	80	0.0500000
NODE_3621_length_1232_cov_34.635481	469	549	10	11	80	0.1375000
NODE_3621_length_1232_cov_34.635481	469	549	12	18	80	0.2250000
NODE_3621_length_1232_cov_34.635481	469	549	16	22	80	0.2750000
NODE_3621_length_1232_cov_34.635481	522	602	12	13	80	0.1625000
NODE_3621_length_1232_cov_34.635481	522	602	15	24	80	0.3000000
NODE_3621_length_1232_cov_34.635481	522	602	16	24	80	0.3000000
NODE_3621_length_1232_cov_34.635481	522	602	17	8	80	0.1000000
NODE_3621_length_1232_cov_34.635481	522	602	18	11	80	0.1375000
NODE_3622_length_1232_cov_16.362754	774	854	0	80	80	1.0000000
NODE_3622_length_1232_cov_16.362754	827	907	0	80	80	1.0000000
NODE_3623_length_1232_cov_13.395410	234	315	0	31	81	0.3827161
NODE_3623_length_1232_cov_13.395410	234	315	2	2	81	0.0246914
NODE_3623_length_1232_cov_13.395410	234	315	4	45	81	0.5555556
NODE_3623_length_1232_cov_13.395410	234	315	6	3	81	0.0370370
NODE_3623_length_1232_cov_13.395410	287	368	0	81	81	1.0000000
NODE_3623_length_1232_cov_13.395410	364	444	0	80	80	1.0000000
NODE_3623_length_1232_cov_13.395410	417	497	0	80	80	1.0000000
NODE_3625_length_1231_cov_47.606890	509	589	4	14	80	0.1750000
NODE_3625_length_1231_cov_47.606890	509	589	6	66	80	0.8250000
NODE_3625_length_1231_cov_47.606890	562	642	4	1	80	0.0125000
NODE_3625_length_1231_cov_47.606890	562	642	6	32	80	0.4000000
NODE_3625_length_1231_cov_47.606890	562	642	10	22	80	0.2750000
NODE_3625_length_1231_cov_47.606890	562	642	12	25	80	0.3125000
NODE_3625_length_1231_cov_47.606890	638	718	10	1	80	0.0125000
NODE_3625_length_1231_cov_47.606890	638	718	12	22	80	0.2750000
NODE_3625_length_1231_cov_47.606890	638	718	14	1	80	0.0125000
NODE_3625_length_1231_cov_47.606890	638	718	23	1	80	0.0125000
NODE_3625_length_1231_cov_47.606890	638	718	24	5	80	0.0625000
NODE_3625_length_1231_cov_47.606890	638	718	26	2	80	0.0250000
NODE_3625_length_1231_cov_47.606890	638	718	27	8	80	0.1000000
NODE_3625_length_1231_cov_47.606890	638	718	29	8	80	0.1000000
NODE_3625_length_1231_cov_47.606890	638	718	31	7	80	0.0875000
NODE_3625_length_1231_cov_47.606890	638	718	32	9	80	0.1125000
NODE_3625_length_1231_cov_47.606890	638	718	33	9	80	0.1125000
NODE_3625_length_1231_cov_47.606890	638	718	34	2	80	0.0250000
NODE_3625_length_1231_cov_47.606890	638	718	38	5	80	0.0625000
NODE_3625_length_1231_cov_47.606890	691	771	24	2	80	0.0250000
NODE_3625_length_1231_cov_47.606890	691	771	28	3	80	0.0375000
NODE_3625_length_1231_cov_47.606890	691	771	30	7	80	0.0875000
NODE_3625_length_1231_cov_47.606890	691	771	31	2	80	0.0250000
NODE_3625_length_1231_cov_47.606890	691	771	32	19	80	0.2375000
NODE_3625_length_1231_cov_47.606890	691	771	33	9	80	0.1125000
NODE_3625_length_1231_cov_47.606890	691	771	34	33	80	0.4125000
NODE_3625_length_1231_cov_47.606890	691	771	38	5	80	0.0625000
NODE_3626_length_1231_cov_27.498233	698	777	0	14	79	0.1772152
NODE_3626_length_1231_cov_27.498233	698	777	2	65	79	0.8227848
NODE_3626_length_1231_cov_27.498233	750	830	0	16	80	0.2000000
NODE_3626_length_1231_cov_27.498233	750	830	2	64	80	0.8000000
NODE_3627_length_1231_cov_21.245583	673	753	2	21	80	0.2625000
NODE_3627_length_1231_cov_21.245583	673	753	4	28	80	0.3500000
NODE_3627_length_1231_cov_21.245583	673	753	10	31	80	0.3875000
NODE_3627_length_1231_cov_21.245583	726	806	6	21	80	0.2625000
NODE_3627_length_1231_cov_21.245583	726	806	8	6	80	0.0750000
NODE_3627_length_1231_cov_21.245583	726	806	10	53	80	0.6625000
NODE_3627_length_1231_cov_21.245583	802	882	2	57	80	0.7125000
NODE_3627_length_1231_cov_21.245583	802	882	6	4	80	0.0500000
NODE_3627_length_1231_cov_21.245583	802	882	8	19	80	0.2375000
NODE_3627_length_1231_cov_21.245583	860	935	0	39	75	0.5200000
NODE_3627_length_1231_cov_21.245583	860	935	2	36	75	0.4800000
NODE_3628_length_1231_cov_9.895760	515	595	2	55	80	0.6875000
NODE_3628_length_1231_cov_9.895760	515	595	4	25	80	0.3125000
NODE_3628_length_1231_cov_9.895760	568	648	2	29	80	0.3625000
NODE_3628_length_1231_cov_9.895760	568	648	4	47	80	0.5875000
NODE_3628_length_1231_cov_9.895760	568	648	6	4	80	0.0500000
NODE_3630_length_1230_cov_43.705570	412	492	0	31	80	0.3875000
NODE_3630_length_1230_cov_43.705570	412	492	2	49	80	0.6125000
NODE_3630_length_1230_cov_43.705570	465	545	0	80	80	1.0000000
NODE_3631_length_1230_cov_43.663130	501	581	0	39	80	0.4875000
NODE_3631_length_1230_cov_43.663130	501	581	2	41	80	0.5125000
NODE_3631_length_1230_cov_43.663130	554	634	0	8	80	0.1000000
NODE_3631_length_1230_cov_43.663130	554	634	2	72	80	0.9000000
NODE_3632_length_1230_cov_33.173298	315	395	0	80	80	1.0000000
NODE_3632_length_1230_cov_33.173298	368	448	0	80	80	1.0000000
NODE_3633_length_1230_cov_12.939876	201	281	0	80	80	1.0000000
NODE_3633_length_1230_cov_12.939876	218	273	0	55	55	1.0000000
NODE_3633_length_1230_cov_12.939876	254	334	0	70	80	0.8750000
NODE_3633_length_1230_cov_12.939876	254	334	2	10	80	0.1250000
NODE_3633_length_1230_cov_12.939876	330	410	0	6	80	0.0750000
NODE_3633_length_1230_cov_12.939876	330	410	2	74	80	0.9250000
NODE_3633_length_1230_cov_12.939876	383	463	0	59	80	0.7375000
NODE_3633_length_1230_cov_12.939876	383	463	2	21	80	0.2625000
NODE_3634_length_1230_cov_5.155615	248	328	0	80	80	1.0000000
NODE_3634_length_1230_cov_5.155615	301	381	0	80	80	1.0000000
NODE_3640_length_1229_cov_30.214159	341	421	0	21	80	0.2625000
NODE_3640_length_1229_cov_30.214159	341	421	2	40	80	0.5000000
NODE_3640_length_1229_cov_30.214159	341	421	4	12	80	0.1500000
NODE_3640_length_1229_cov_30.214159	341	421	6	7	80	0.0875000
NODE_3640_length_1229_cov_30.214159	394	474	2	12	80	0.1500000
NODE_3640_length_1229_cov_30.214159	394	474	4	52	80	0.6500000
NODE_3640_length_1229_cov_30.214159	394	474	5	1	80	0.0125000
NODE_3640_length_1229_cov_30.214159	394	474	6	15	80	0.1875000
NODE_3641_length_1229_cov_23.165487	376	456	2	80	80	1.0000000
NODE_3641_length_1229_cov_23.165487	429	509	0	29	80	0.3625000
NODE_3641_length_1229_cov_23.165487	429	509	2	51	80	0.6375000
NODE_3641_length_1229_cov_23.165487	505	585	0	47	80	0.5875000
NODE_3641_length_1229_cov_23.165487	505	585	6	5	80	0.0625000
NODE_3641_length_1229_cov_23.165487	505	585	8	28	80	0.3500000
NODE_3641_length_1229_cov_23.165487	558	638	8	80	80	1.0000000
NODE_3642_length_1229_cov_19.376991	484	564	0	69	80	0.8625000
NODE_3642_length_1229_cov_19.376991	484	564	2	11	80	0.1375000
NODE_3642_length_1229_cov_19.376991	537	614	0	16	77	0.2077922
NODE_3642_length_1229_cov_19.376991	537	614	2	22	77	0.2857143
NODE_3642_length_1229_cov_19.376991	537	614	6	39	77	0.5064935
NODE_3643_length_1229_cov_11.799115	670	748	8	34	78	0.4358974
NODE_3643_length_1229_cov_11.799115	670	748	10	44	78	0.5641026
NODE_3643_length_1229_cov_11.799115	728	801	0	26	73	0.3561644
NODE_3643_length_1229_cov_11.799115	728	801	2	10	73	0.1369863
NODE_3643_length_1229_cov_11.799115	728	801	4	16	73	0.2191781
NODE_3643_length_1229_cov_11.799115	728	801	10	21	73	0.2876712
NODE_3644_length_1229_cov_8.140708	970	1050	0	80	80	1.0000000
NODE_3644_length_1229_cov_8.140708	1023	1103	0	80	80	1.0000000
NODE_3646_length_1229_cov_3.654867	765	840	2	5	75	0.0666667
NODE_3646_length_1229_cov_3.654867	765	840	4	28	75	0.3733333
NODE_3646_length_1229_cov_3.654867	765	840	6	42	75	0.5600000
NODE_3646_length_1229_cov_3.654867	813	893	0	7	80	0.0875000
NODE_3646_length_1229_cov_3.654867	813	893	2	18	80	0.2250000
NODE_3646_length_1229_cov_3.654867	813	893	4	20	80	0.2500000
NODE_3646_length_1229_cov_3.654867	813	893	6	35	80	0.4375000
NODE_3652_length_1229_cov_0.949558	1034	1079	0	37	45	0.8222222
NODE_3652_length_1229_cov_0.949558	1034	1079	2	4	45	0.0888889
NODE_3652_length_1229_cov_0.949558	1034	1079	4	4	45	0.0888889
NODE_3652_length_1229_cov_0.949558	1090	1130	6	3	40	0.0750000
NODE_3652_length_1229_cov_0.949558	1090	1130	8	7	40	0.1750000
NODE_3652_length_1229_cov_0.949558	1090	1130	12	30	40	0.7500000
NODE_3654_length_1228_cov_22.622675	604	684	0	80	80	1.0000000
NODE_3654_length_1228_cov_22.622675	657	738	0	28	81	0.3456790
NODE_3654_length_1228_cov_22.622675	657	738	4	53	81	0.6543210
NODE_3655_length_1228_cov_17.900797	423	503	0	80	80	1.0000000
NODE_3655_length_1228_cov_17.900797	423	503	0	80	80	1.0000000
NODE_3655_length_1228_cov_17.900797	423	503	0	80	80	1.0000000
NODE_3655_length_1228_cov_17.900797	476	538	0	62	62	1.0000000
NODE_3655_length_1228_cov_17.900797	476	538	0	62	62	1.0000000
NODE_3655_length_1228_cov_17.900797	476	538	0	62	62	1.0000000
NODE_3655_length_1228_cov_17.900797	476	556	0	80	80	1.0000000
NODE_3656_length_1228_cov_14.554473	367	447	0	80	80	1.0000000
NODE_3656_length_1228_cov_14.554473	420	500	0	32	80	0.4000000
NODE_3656_length_1228_cov_14.554473	420	500	1	48	80	0.6000000
NODE_3657_length_1228_cov_10.021258	661	741	0	80	80	1.0000000
NODE_3657_length_1228_cov_10.021258	714	794	0	80	80	1.0000000
NODE_3660_length_1228_cov_3.987600	1139	1219	0	80	80	1.0000000
NODE_3662_length_1227_cov_29.002660	423	503	0	80	80	1.0000000
NODE_3662_length_1227_cov_29.002660	476	556	0	80	80	1.0000000
NODE_3663_length_1227_cov_17.479610	759	839	0	50	80	0.6250000
NODE_3663_length_1227_cov_17.479610	759	839	4	1	80	0.0125000
NODE_3663_length_1227_cov_17.479610	759	839	5	29	80	0.3625000
NODE_3663_length_1227_cov_17.479610	812	892	4	26	80	0.3250000
NODE_3663_length_1227_cov_17.479610	812	892	5	54	80	0.6750000
NODE_3666_length_1227_cov_3.808511	120	186	13	9	66	0.1363636
NODE_3666_length_1227_cov_3.808511	120	186	16	1	66	0.0151515
NODE_3666_length_1227_cov_3.808511	120	186	19	4	66	0.0606061
NODE_3666_length_1227_cov_3.808511	120	186	21	13	66	0.1969697
NODE_3666_length_1227_cov_3.808511	120	186	23	11	66	0.1666667
NODE_3666_length_1227_cov_3.808511	120	186	25	6	66	0.0909091
NODE_3666_length_1227_cov_3.808511	120	186	27	10	66	0.1515152
NODE_3666_length_1227_cov_3.808511	120	186	29	1	66	0.0151515
NODE_3666_length_1227_cov_3.808511	120	186	30	11	66	0.1666667
NODE_3666_length_1227_cov_3.808511	173	239	16	8	66	0.1212121
NODE_3666_length_1227_cov_3.808511	173	239	18	4	66	0.0606061
NODE_3666_length_1227_cov_3.808511	173	239	20	4	66	0.0606061
NODE_3666_length_1227_cov_3.808511	173	239	27	2	66	0.0303030
NODE_3666_length_1227_cov_3.808511	173	239	28	4	66	0.0606061
NODE_3666_length_1227_cov_3.808511	173	239	29	1	66	0.0151515
NODE_3666_length_1227_cov_3.808511	173	239	30	43	66	0.6515151
NODE_3666_length_1227_cov_3.808511	229	299	1	30	70	0.4285714
NODE_3666_length_1227_cov_3.808511	229	299	3	3	70	0.0428571
NODE_3666_length_1227_cov_3.808511	229	299	5	11	70	0.1571429
NODE_3666_length_1227_cov_3.808511	229	299	7	5	70	0.0714286
NODE_3666_length_1227_cov_3.808511	229	299	11	1	70	0.0142857
NODE_3666_length_1227_cov_3.808511	229	299	12	4	70	0.0571429
NODE_3666_length_1227_cov_3.808511	229	299	14	6	70	0.0857143
NODE_3666_length_1227_cov_3.808511	229	299	16	8	70	0.1142857
NODE_3666_length_1227_cov_3.808511	229	299	18	2	70	0.0285714
NODE_3672_length_1226_cov_23.792369	579	659	0	80	80	1.0000000
NODE_3672_length_1226_cov_23.792369	632	712	0	80	80	1.0000000
NODE_3672_length_1226_cov_23.792369	708	788	0	80	80	1.0000000
NODE_3672_length_1226_cov_23.792369	761	839	0	78	78	1.0000000
NODE_3673_length_1226_cov_5.620231	463	543	0	72	80	0.9000000
NODE_3673_length_1226_cov_5.620231	463	543	2	8	80	0.1000000
NODE_3673_length_1226_cov_5.620231	516	596	0	80	80	1.0000000
NODE_3674_length_1226_cov_4.881988	582	662	0	80	80	1.0000000
NODE_3674_length_1226_cov_4.881988	635	715	0	80	80	1.0000000
NODE_3682_length_1225_cov_55.596803	637	717	0	37	80	0.4625000
NODE_3682_length_1225_cov_55.596803	637	717	2	9	80	0.1125000
NODE_3682_length_1225_cov_55.596803	637	717	4	34	80	0.4250000
NODE_3682_length_1225_cov_55.596803	690	770	2	4	80	0.0500000
NODE_3682_length_1225_cov_55.596803	690	770	4	76	80	0.9500000
NODE_3682_length_1225_cov_55.596803	766	846	0	72	80	0.9000000
NODE_3682_length_1225_cov_55.596803	766	846	2	8	80	0.1000000
NODE_3682_length_1225_cov_55.596803	819	899	0	80	80	1.0000000
NODE_3683_length_1225_cov_35.189165	661	742	18	7	81	0.0864198
NODE_3683_length_1225_cov_35.189165	661	742	23	33	81	0.4074074
NODE_3683_length_1225_cov_35.189165	661	742	24	34	81	0.4197531
NODE_3683_length_1225_cov_35.189165	661	742	25	7	81	0.0864198
NODE_3683_length_1225_cov_35.189165	714	795	0	25	81	0.3086420
NODE_3683_length_1225_cov_35.189165	714	795	4	21	81	0.2592593
NODE_3683_length_1225_cov_35.189165	714	795	8	5	81	0.0617284
NODE_3683_length_1225_cov_35.189165	714	795	17	1	81	0.0123457
NODE_3683_length_1225_cov_35.189165	714	795	18	8	81	0.0987654
NODE_3683_length_1225_cov_35.189165	714	795	24	21	81	0.2592593
NODE_3684_length_1225_cov_33.755773	456	535	15	58	79	0.7341772
NODE_3684_length_1225_cov_33.755773	456	535	16	2	79	0.0253165
NODE_3684_length_1225_cov_33.755773	456	535	22	1	79	0.0126582
NODE_3684_length_1225_cov_33.755773	456	535	23	1	79	0.0126582
NODE_3684_length_1225_cov_33.755773	456	535	26	17	79	0.2151899
NODE_3684_length_1225_cov_33.755773	508	588	12	32	80	0.4000000
NODE_3684_length_1225_cov_33.755773	508	588	15	6	80	0.0750000
NODE_3684_length_1225_cov_33.755773	508	588	16	2	80	0.0250000
NODE_3684_length_1225_cov_33.755773	508	588	22	1	80	0.0125000
NODE_3684_length_1225_cov_33.755773	508	588	23	1	80	0.0125000
NODE_3684_length_1225_cov_33.755773	508	588	26	25	80	0.3125000
NODE_3684_length_1225_cov_33.755773	508	588	27	1	80	0.0125000
NODE_3684_length_1225_cov_33.755773	508	588	28	12	80	0.1500000
NODE_3685_length_1225_cov_30.116341	566	646	0	33	80	0.4125000
NODE_3685_length_1225_cov_30.116341	566	646	2	47	80	0.5875000
NODE_3685_length_1225_cov_30.116341	619	699	0	25	80	0.3125000
NODE_3685_length_1225_cov_30.116341	619	699	2	55	80	0.6875000
NODE_3685_length_1225_cov_30.116341	695	775	0	80	80	1.0000000
NODE_3685_length_1225_cov_30.116341	748	828	0	80	80	1.0000000
NODE_3686_length_1225_cov_29.177620	195	275	0	17	80	0.2125000
NODE_3686_length_1225_cov_29.177620	195	275	1	1	80	0.0125000
NODE_3686_length_1225_cov_29.177620	195	275	2	22	80	0.2750000
NODE_3686_length_1225_cov_29.177620	195	275	3	1	80	0.0125000
NODE_3686_length_1225_cov_29.177620	195	275	4	39	80	0.4875000
NODE_3686_length_1225_cov_29.177620	248	328	4	80	80	1.0000000
NODE_3687_length_1225_cov_26.849023	588	668	0	29	80	0.3625000
NODE_3687_length_1225_cov_26.849023	588	668	2	51	80	0.6375000
NODE_3687_length_1225_cov_26.849023	641	721	0	80	80	1.0000000
NODE_3687_length_1225_cov_26.849023	717	797	0	73	80	0.9125000
NODE_3687_length_1225_cov_26.849023	717	797	3	7	80	0.0875000
NODE_3687_length_1225_cov_26.849023	770	850	0	20	80	0.2500000
NODE_3687_length_1225_cov_26.849023	770	850	3	20	80	0.2500000
NODE_3687_length_1225_cov_26.849023	770	850	9	40	80	0.5000000
NODE_3688_length_1225_cov_24.444938	386	466	0	7	80	0.0875000
NODE_3688_length_1225_cov_24.444938	386	466	2	73	80	0.9125000
NODE_3688_length_1225_cov_24.444938	439	519	2	80	80	1.0000000
NODE_3690_length_1225_cov_19.369449	491	571	0	80	80	1.0000000
NODE_3690_length_1225_cov_19.369449	544	624	0	80	80	1.0000000
NODE_3690_length_1225_cov_19.369449	620	700	0	80	80	1.0000000
NODE_3690_length_1225_cov_19.369449	673	753	0	80	80	1.0000000
NODE_3691_length_1225_cov_13.281528	462	542	0	80	80	1.0000000
NODE_3691_length_1225_cov_13.281528	515	595	0	80	80	1.0000000
NODE_3691_length_1225_cov_13.281528	591	671	0	5	80	0.0625000
NODE_3691_length_1225_cov_13.281528	591	671	2	75	80	0.9375000
NODE_3691_length_1225_cov_13.281528	644	724	2	60	80	0.7500000
NODE_3691_length_1225_cov_13.281528	644	724	4	20	80	0.2500000
NODE_3692_length_1225_cov_10.887211	566	646	0	45	80	0.5625000
NODE_3692_length_1225_cov_10.887211	566	646	1	9	80	0.1125000
NODE_3692_length_1225_cov_10.887211	566	646	3	4	80	0.0500000
NODE_3692_length_1225_cov_10.887211	566	646	4	22	80	0.2750000
NODE_3692_length_1225_cov_10.887211	619	699	1	1	80	0.0125000
NODE_3692_length_1225_cov_10.887211	619	699	2	9	80	0.1125000
NODE_3692_length_1225_cov_10.887211	619	699	3	4	80	0.0500000
NODE_3692_length_1225_cov_10.887211	619	699	4	66	80	0.8250000
NODE_3696_length_1224_cov_24.568889	613	693	0	19	80	0.2375000
NODE_3696_length_1224_cov_24.568889	613	693	2	53	80	0.6625000
NODE_3696_length_1224_cov_24.568889	613	693	4	8	80	0.1000000
NODE_3696_length_1224_cov_24.568889	666	746	2	33	80	0.4125000
NODE_3696_length_1224_cov_24.568889	666	746	4	47	80	0.5875000
NODE_3697_length_1224_cov_17.538667	762	842	0	43	80	0.5375000
NODE_3697_length_1224_cov_17.538667	762	842	4	36	80	0.4500000
NODE_3697_length_1224_cov_17.538667	762	842	8	1	80	0.0125000
NODE_3697_length_1224_cov_17.538667	815	895	4	26	80	0.3250000
NODE_3697_length_1224_cov_17.538667	815	895	8	54	80	0.6750000
NODE_3698_length_1224_cov_14.138667	389	469	4	15	80	0.1875000
NODE_3698_length_1224_cov_14.138667	389	469	6	21	80	0.2625000
NODE_3698_length_1224_cov_14.138667	389	469	8	13	80	0.1625000
NODE_3698_length_1224_cov_14.138667	389	469	10	31	80	0.3875000
NODE_3698_length_1224_cov_14.138667	442	522	2	30	80	0.3750000
NODE_3698_length_1224_cov_14.138667	442	522	4	15	80	0.1875000
NODE_3698_length_1224_cov_14.138667	442	522	6	23	80	0.2875000
NODE_3698_length_1224_cov_14.138667	442	522	8	12	80	0.1500000
NODE_3699_length_1224_cov_11.358222	704	784	0	80	80	1.0000000
NODE_3699_length_1224_cov_11.358222	757	837	0	80	80	1.0000000
NODE_3700_length_1224_cov_6.963556	516	581	0	65	65	1.0000000
NODE_3705_length_1223_cov_44.608541	548	630	0	23	82	0.2804878
NODE_3705_length_1223_cov_44.608541	548	630	4	12	82	0.1463415
NODE_3705_length_1223_cov_44.608541	548	630	8	47	82	0.5731707
NODE_3705_length_1223_cov_44.608541	601	683	0	13	82	0.1585366
NODE_3705_length_1223_cov_44.608541	601	683	4	10	82	0.1219512
NODE_3705_length_1223_cov_44.608541	601	683	8	59	82	0.7195122
NODE_3705_length_1223_cov_44.608541	679	759	0	80	80	1.0000000
NODE_3705_length_1223_cov_44.608541	732	812	0	80	80	1.0000000
NODE_3706_length_1223_cov_26.730427	508	588	2	5	80	0.0625000
NODE_3706_length_1223_cov_26.730427	508	588	4	52	80	0.6500000
NODE_3706_length_1223_cov_26.730427	508	588	6	23	80	0.2875000
NODE_3706_length_1223_cov_26.730427	561	641	0	23	80	0.2875000
NODE_3706_length_1223_cov_26.730427	561	641	2	35	80	0.4375000
NODE_3706_length_1223_cov_26.730427	561	641	6	22	80	0.2750000
NODE_3707_length_1223_cov_18.902135	460	540	0	80	80	1.0000000
NODE_3707_length_1223_cov_18.902135	513	593	0	80	80	1.0000000
NODE_3708_length_1223_cov_6.989324	707	778	0	71	71	1.0000000
NODE_3710_length_1223_cov_5.251779	666	746	0	19	80	0.2375000
NODE_3710_length_1223_cov_5.251779	666	746	2	61	80	0.7625000
NODE_3710_length_1223_cov_5.251779	719	799	0	72	80	0.9000000
NODE_3710_length_1223_cov_5.251779	719	799	2	8	80	0.1000000
NODE_3710_length_1223_cov_5.251779	795	875	0	56	80	0.7000000
NODE_3710_length_1223_cov_5.251779	795	875	2	23	80	0.2875000
NODE_3710_length_1223_cov_5.251779	795	875	4	1	80	0.0125000
NODE_3710_length_1223_cov_5.251779	848	928	0	3	80	0.0375000
NODE_3710_length_1223_cov_5.251779	848	928	2	33	80	0.4125000
NODE_3710_length_1223_cov_5.251779	848	928	4	44	80	0.5500000
NODE_3716_length_1222_cov_18.406946	273	353	4	60	80	0.7500000
NODE_3716_length_1222_cov_18.406946	273	353	6	20	80	0.2500000
NODE_3716_length_1222_cov_18.406946	326	406	2	40	80	0.5000000
NODE_3716_length_1222_cov_18.406946	326	406	4	7	80	0.0875000
NODE_3716_length_1222_cov_18.406946	326	406	6	33	80	0.4125000
NODE_3720_length_1221_cov_33.261141	505	577	0	72	72	1.0000000
NODE_3720_length_1221_cov_33.261141	558	637	0	77	79	0.9746835
NODE_3720_length_1221_cov_33.261141	558	637	1	2	79	0.0253165
NODE_3720_length_1221_cov_33.261141	633	713	0	2	80	0.0250000
NODE_3720_length_1221_cov_33.261141	633	713	1	13	80	0.1625000
NODE_3720_length_1221_cov_33.261141	633	713	2	65	80	0.8125000
NODE_3720_length_1221_cov_33.261141	686	766	2	80	80	1.0000000
NODE_3721_length_1221_cov_19.466132	541	621	0	80	80	1.0000000
NODE_3721_length_1221_cov_19.466132	594	674	0	80	80	1.0000000
NODE_3722_length_1221_cov_15.940285	788	868	0	80	80	1.0000000
NODE_3722_length_1221_cov_15.940285	841	921	0	80	80	1.0000000
NODE_3722_length_1221_cov_15.940285	917	997	0	80	80	1.0000000
NODE_3722_length_1221_cov_15.940285	970	1050	0	80	80	1.0000000
NODE_3723_length_1221_cov_15.796791	484	564	0	75	80	0.9375000
NODE_3723_length_1221_cov_15.796791	484	564	2	5	80	0.0625000
NODE_3723_length_1221_cov_15.796791	537	617	0	22	80	0.2750000
NODE_3723_length_1221_cov_15.796791	537	617	2	58	80	0.7250000
NODE_3724_length_1221_cov_15.312834	342	415	0	73	73	1.0000000
NODE_3724_length_1221_cov_15.312834	395	474	0	79	79	1.0000000
NODE_3725_length_1221_cov_9.695187	988	1068	0	75	80	0.9375000
NODE_3725_length_1221_cov_9.695187	988	1068	1	5	80	0.0625000
NODE_3725_length_1221_cov_9.695187	1041	1100	0	59	59	1.0000000
NODE_3726_length_1221_cov_9.043672	695	775	0	80	80	1.0000000
NODE_3726_length_1221_cov_9.043672	748	828	0	80	80	1.0000000
NODE_3727_length_1221_cov_7.946524	147	227	0	25	80	0.3125000
NODE_3727_length_1221_cov_7.946524	147	227	2	4	80	0.0500000
NODE_3727_length_1221_cov_7.946524	147	227	4	34	80	0.4250000
NODE_3727_length_1221_cov_7.946524	147	227	6	17	80	0.2125000
NODE_3727_length_1221_cov_7.946524	200	280	2	1	80	0.0125000
NODE_3727_length_1221_cov_7.946524	200	280	4	11	80	0.1375000
NODE_3727_length_1221_cov_7.946524	200	280	6	68	80	0.8500000
NODE_3728_length_1221_cov_5.122103	248	328	0	80	80	1.0000000
NODE_3728_length_1221_cov_5.122103	301	381	0	80	80	1.0000000
NODE_3736_length_1220_cov_44.501338	319	399	0	50	80	0.6250000
NODE_3736_length_1220_cov_44.501338	319	399	6	30	80	0.3750000
NODE_3736_length_1220_cov_44.501338	372	452	6	80	80	1.0000000
NODE_3736_length_1220_cov_44.501338	448	528	6	6	80	0.0750000
NODE_3736_length_1220_cov_44.501338	448	528	8	11	80	0.1375000
NODE_3736_length_1220_cov_44.501338	448	528	12	11	80	0.1375000
NODE_3736_length_1220_cov_44.501338	448	528	13	2	80	0.0250000
NODE_3736_length_1220_cov_44.501338	448	528	14	50	80	0.6250000
NODE_3736_length_1220_cov_44.501338	501	581	0	9	80	0.1125000
NODE_3736_length_1220_cov_44.501338	501	581	6	15	80	0.1875000
NODE_3736_length_1220_cov_44.501338	501	581	8	14	80	0.1750000
NODE_3736_length_1220_cov_44.501338	501	581	10	5	80	0.0625000
NODE_3736_length_1220_cov_44.501338	501	581	12	8	80	0.1000000
NODE_3736_length_1220_cov_44.501338	501	581	14	29	80	0.3625000
NODE_3737_length_1220_cov_43.868867	720	800	0	7	80	0.0875000
NODE_3737_length_1220_cov_43.868867	720	800	2	7	80	0.0875000
NODE_3737_length_1220_cov_43.868867	720	800	4	38	80	0.4750000
NODE_3737_length_1220_cov_43.868867	720	800	9	15	80	0.1875000
NODE_3737_length_1220_cov_43.868867	720	800	11	13	80	0.1625000
NODE_3737_length_1220_cov_43.868867	773	853	2	3	80	0.0375000
NODE_3737_length_1220_cov_43.868867	773	853	5	1	80	0.0125000
NODE_3737_length_1220_cov_43.868867	773	853	6	20	80	0.2500000
NODE_3737_length_1220_cov_43.868867	773	853	8	1	80	0.0125000
NODE_3737_length_1220_cov_43.868867	773	853	9	22	80	0.2750000
NODE_3737_length_1220_cov_43.868867	773	853	10	15	80	0.1875000
NODE_3737_length_1220_cov_43.868867	773	853	11	15	80	0.1875000
NODE_3737_length_1220_cov_43.868867	773	853	12	3	80	0.0375000
NODE_3738_length_1220_cov_41.900089	593	673	8	16	80	0.2000000
NODE_3738_length_1220_cov_41.900089	593	673	10	59	80	0.7375000
NODE_3738_length_1220_cov_41.900089	593	673	12	5	80	0.0625000
NODE_3738_length_1220_cov_41.900089	646	726	2	49	80	0.6125000
NODE_3738_length_1220_cov_41.900089	646	726	7	2	80	0.0250000
NODE_3738_length_1220_cov_41.900089	646	726	8	18	80	0.2250000
NODE_3738_length_1220_cov_41.900089	646	726	10	6	80	0.0750000
NODE_3738_length_1220_cov_41.900089	646	726	12	5	80	0.0625000
NODE_3738_length_1220_cov_41.900089	722	802	0	24	80	0.3000000
NODE_3738_length_1220_cov_41.900089	722	802	2	31	80	0.3875000
NODE_3738_length_1220_cov_41.900089	722	802	8	25	80	0.3125000
NODE_3738_length_1220_cov_41.900089	775	855	2	2	80	0.0250000
NODE_3738_length_1220_cov_41.900089	775	855	8	78	80	0.9750000
NODE_3739_length_1220_cov_15.485281	395	475	0	14	80	0.1750000
NODE_3739_length_1220_cov_15.485281	395	475	2	22	80	0.2750000
NODE_3739_length_1220_cov_15.485281	395	475	7	44	80	0.5500000
NODE_3739_length_1220_cov_15.485281	448	528	7	51	80	0.6375000
NODE_3739_length_1220_cov_15.485281	448	528	9	29	80	0.3625000
NODE_3745_length_1219_cov_30.493750	643	723	0	69	80	0.8625000
NODE_3745_length_1219_cov_30.493750	643	723	2	11	80	0.1375000
NODE_3745_length_1219_cov_30.493750	696	776	0	16	80	0.2000000
NODE_3745_length_1219_cov_30.493750	696	776	2	64	80	0.8000000
NODE_3745_length_1219_cov_30.493750	772	852	0	59	80	0.7375000
NODE_3745_length_1219_cov_30.493750	772	852	2	21	80	0.2625000
NODE_3745_length_1219_cov_30.493750	825	905	0	80	80	1.0000000
NODE_3746_length_1219_cov_24.991071	566	646	0	80	80	1.0000000
NODE_3746_length_1219_cov_24.991071	619	699	0	60	80	0.7500000
NODE_3746_length_1219_cov_24.991071	619	699	2	19	80	0.2375000
NODE_3746_length_1219_cov_24.991071	619	699	4	1	80	0.0125000
NODE_3746_length_1219_cov_24.991071	695	775	2	12	80	0.1500000
NODE_3746_length_1219_cov_24.991071	695	775	4	41	80	0.5125000
NODE_3746_length_1219_cov_24.991071	695	775	6	27	80	0.3375000
NODE_3746_length_1219_cov_24.991071	748	828	0	33	80	0.4125000
NODE_3746_length_1219_cov_24.991071	748	828	2	29	80	0.3625000
NODE_3746_length_1219_cov_24.991071	748	828	4	5	80	0.0625000
NODE_3746_length_1219_cov_24.991071	748	828	6	13	80	0.1625000
NODE_3747_length_1219_cov_24.728571	465	545	4	9	80	0.1125000
NODE_3747_length_1219_cov_24.728571	465	545	8	11	80	0.1375000
NODE_3747_length_1219_cov_24.728571	465	545	10	60	80	0.7500000
NODE_3747_length_1219_cov_24.728571	518	598	2	1	80	0.0125000
NODE_3747_length_1219_cov_24.728571	518	598	4	14	80	0.1750000
NODE_3747_length_1219_cov_24.728571	518	598	6	17	80	0.2125000
NODE_3747_length_1219_cov_24.728571	518	598	10	48	80	0.6000000
NODE_3747_length_1219_cov_24.728571	594	674	2	2	80	0.0250000
NODE_3747_length_1219_cov_24.728571	594	674	4	30	80	0.3750000
NODE_3747_length_1219_cov_24.728571	594	674	6	5	80	0.0625000
NODE_3747_length_1219_cov_24.728571	594	674	8	43	80	0.5375000
NODE_3747_length_1219_cov_24.728571	647	727	0	26	80	0.3250000
NODE_3747_length_1219_cov_24.728571	647	727	5	8	80	0.1000000
NODE_3747_length_1219_cov_24.728571	647	727	6	24	80	0.3000000
NODE_3747_length_1219_cov_24.728571	647	727	8	22	80	0.2750000
NODE_3748_length_1219_cov_11.130357	535	615	0	47	80	0.5875000
NODE_3748_length_1219_cov_11.130357	535	615	2	10	80	0.1250000
NODE_3748_length_1219_cov_11.130357	535	615	4	23	80	0.2875000
NODE_3748_length_1219_cov_11.130357	588	668	2	11	80	0.1375000
NODE_3748_length_1219_cov_11.130357	588	668	4	69	80	0.8625000
NODE_3749_length_1219_cov_9.696429	734	814	0	28	80	0.3500000
NODE_3749_length_1219_cov_9.696429	734	814	2	52	80	0.6500000
NODE_3749_length_1219_cov_9.696429	787	867	0	9	80	0.1125000
NODE_3749_length_1219_cov_9.696429	787	867	2	71	80	0.8875000
NODE_3754_length_1218_cov_40.159071	554	634	8	6	80	0.0750000
NODE_3754_length_1218_cov_40.159071	554	634	12	74	80	0.9250000
NODE_3754_length_1218_cov_40.159071	607	687	0	20	80	0.2500000
NODE_3754_length_1218_cov_40.159071	607	687	8	6	80	0.0750000
NODE_3754_length_1218_cov_40.159071	607	687	11	1	80	0.0125000
NODE_3754_length_1218_cov_40.159071	607	687	12	53	80	0.6625000
NODE_3754_length_1218_cov_40.159071	683	763	0	10	80	0.1250000
NODE_3754_length_1218_cov_40.159071	683	763	2	1	80	0.0125000
NODE_3754_length_1218_cov_40.159071	683	763	6	69	80	0.8625000
NODE_3754_length_1218_cov_40.159071	736	816	2	30	80	0.3750000
NODE_3754_length_1218_cov_40.159071	736	816	4	2	80	0.0250000
NODE_3754_length_1218_cov_40.159071	736	816	6	48	80	0.6000000
NODE_3765_length_1216_cov_99.538944	44	124	223	1	80	0.0125000
NODE_3765_length_1216_cov_99.538944	44	124	228	1	80	0.0125000
NODE_3765_length_1216_cov_99.538944	44	124	235	2	80	0.0250000
NODE_3765_length_1216_cov_99.538944	44	124	246	1	80	0.0125000
NODE_3765_length_1216_cov_99.538944	44	124	249	1	80	0.0125000
NODE_3765_length_1216_cov_99.538944	44	124	251	1	80	0.0125000
NODE_3765_length_1216_cov_99.538944	44	124	252	1	80	0.0125000
NODE_3765_length_1216_cov_99.538944	44	124	254	1	80	0.0125000
NODE_3765_length_1216_cov_99.538944	44	124	256	1	80	0.0125000
NODE_3765_length_1216_cov_99.538944	44	124	273	1	80	0.0125000
NODE_3765_length_1216_cov_99.538944	44	124	278	1	80	0.0125000
NODE_3765_length_1216_cov_99.538944	44	124	282	1	80	0.0125000
NODE_3765_length_1216_cov_99.538944	44	124	292	1	80	0.0125000
NODE_3765_length_1216_cov_99.538944	44	124	300	1	80	0.0125000
NODE_3765_length_1216_cov_99.538944	44	124	308	1	80	0.0125000
NODE_3765_length_1216_cov_99.538944	44	124	316	2	80	0.0250000
NODE_3765_length_1216_cov_99.538944	44	124	325	1	80	0.0125000
NODE_3765_length_1216_cov_99.538944	44	124	332	1	80	0.0125000
NODE_3765_length_1216_cov_99.538944	44	124	335	1	80	0.0125000
NODE_3765_length_1216_cov_99.538944	44	124	336	2	80	0.0250000
NODE_3765_length_1216_cov_99.538944	44	124	338	1	80	0.0125000
NODE_3765_length_1216_cov_99.538944	44	124	340	1	80	0.0125000
NODE_3765_length_1216_cov_99.538944	44	124	350	1	80	0.0125000
NODE_3765_length_1216_cov_99.538944	44	124	354	1	80	0.0125000
NODE_3765_length_1216_cov_99.538944	44	124	359	1	80	0.0125000
NODE_3765_length_1216_cov_99.538944	44	124	381	1	80	0.0125000
NODE_3765_length_1216_cov_99.538944	44	124	388	1	80	0.0125000
NODE_3765_length_1216_cov_99.538944	44	124	396	1	80	0.0125000
NODE_3765_length_1216_cov_99.538944	44	124	397	1	80	0.0125000
NODE_3765_length_1216_cov_99.538944	44	124	401	2	80	0.0250000
NODE_3765_length_1216_cov_99.538944	44	124	409	1	80	0.0125000
NODE_3765_length_1216_cov_99.538944	44	124	410	1	80	0.0125000
NODE_3765_length_1216_cov_99.538944	44	124	413	1	80	0.0125000
NODE_3765_length_1216_cov_99.538944	44	124	415	2	80	0.0250000
NODE_3765_length_1216_cov_99.538944	44	124	426	3	80	0.0375000
NODE_3765_length_1216_cov_99.538944	44	124	432	1	80	0.0125000
NODE_3765_length_1216_cov_99.538944	44	124	433	1	80	0.0125000
NODE_3765_length_1216_cov_99.538944	44	124	448	1	80	0.0125000
NODE_3765_length_1216_cov_99.538944	44	124	452	1	80	0.0125000
NODE_3765_length_1216_cov_99.538944	44	124	458	3	80	0.0375000
NODE_3765_length_1216_cov_99.538944	44	124	460	3	80	0.0375000
NODE_3765_length_1216_cov_99.538944	44	124	462	2	80	0.0250000
NODE_3765_length_1216_cov_99.538944	44	124	474	3	80	0.0375000
NODE_3765_length_1216_cov_99.538944	44	124	476	2	80	0.0250000
NODE_3765_length_1216_cov_99.538944	44	124	478	8	80	0.1000000
NODE_3765_length_1216_cov_99.538944	44	124	480	4	80	0.0500000
NODE_3765_length_1216_cov_99.538944	44	124	481	1	80	0.0125000
NODE_3765_length_1216_cov_99.538944	44	124	483	1	80	0.0125000
NODE_3765_length_1216_cov_99.538944	44	124	485	2	80	0.0250000
NODE_3765_length_1216_cov_99.538944	44	124	487	3	80	0.0375000
NODE_3765_length_1216_cov_99.538944	44	124	489	2	80	0.0250000
NODE_3765_length_1216_cov_99.538944	97	157	393	2	60	0.0333333
NODE_3765_length_1216_cov_99.538944	97	157	395	1	60	0.0166667
NODE_3765_length_1216_cov_99.538944	97	157	400	1	60	0.0166667
NODE_3765_length_1216_cov_99.538944	97	157	407	1	60	0.0166667
NODE_3765_length_1216_cov_99.538944	97	157	409	1	60	0.0166667
NODE_3765_length_1216_cov_99.538944	97	157	410	1	60	0.0166667
NODE_3765_length_1216_cov_99.538944	97	157	430	1	60	0.0166667
NODE_3765_length_1216_cov_99.538944	97	157	431	1	60	0.0166667
NODE_3765_length_1216_cov_99.538944	97	157	438	2	60	0.0333333
NODE_3765_length_1216_cov_99.538944	97	157	439	1	60	0.0166667
NODE_3765_length_1216_cov_99.538944	97	157	443	1	60	0.0166667
NODE_3765_length_1216_cov_99.538944	97	157	447	1	60	0.0166667
NODE_3765_length_1216_cov_99.538944	97	157	450	1	60	0.0166667
NODE_3765_length_1216_cov_99.538944	97	157	452	1	60	0.0166667
NODE_3765_length_1216_cov_99.538944	97	157	454	1	60	0.0166667
NODE_3765_length_1216_cov_99.538944	97	157	455	2	60	0.0333333
NODE_3765_length_1216_cov_99.538944	97	157	458	1	60	0.0166667
NODE_3765_length_1216_cov_99.538944	97	157	459	1	60	0.0166667
NODE_3765_length_1216_cov_99.538944	97	157	461	1	60	0.0166667
NODE_3765_length_1216_cov_99.538944	97	157	462	1	60	0.0166667
NODE_3765_length_1216_cov_99.538944	97	157	473	1	60	0.0166667
NODE_3765_length_1216_cov_99.538944	97	157	474	4	60	0.0666667
NODE_3765_length_1216_cov_99.538944	97	157	476	2	60	0.0333333
NODE_3765_length_1216_cov_99.538944	97	157	478	8	60	0.1333333
NODE_3765_length_1216_cov_99.538944	97	157	480	4	60	0.0666667
NODE_3765_length_1216_cov_99.538944	97	157	481	1	60	0.0166667
NODE_3765_length_1216_cov_99.538944	97	157	482	1	60	0.0166667
NODE_3765_length_1216_cov_99.538944	97	157	483	2	60	0.0333333
NODE_3765_length_1216_cov_99.538944	97	157	484	2	60	0.0333333
NODE_3765_length_1216_cov_99.538944	97	157	485	4	60	0.0666667
NODE_3765_length_1216_cov_99.538944	97	157	487	4	60	0.0666667
NODE_3765_length_1216_cov_99.538944	97	157	489	2	60	0.0333333
NODE_3765_length_1216_cov_99.538944	97	157	490	1	60	0.0166667
NODE_3765_length_1216_cov_99.538944	97	157	493	1	60	0.0166667
NODE_3765_length_1216_cov_99.538944	824	903	135	2	79	0.0253165
NODE_3765_length_1216_cov_99.538944	824	903	137	2	79	0.0253165
NODE_3765_length_1216_cov_99.538944	824	903	140	1	79	0.0126582
NODE_3765_length_1216_cov_99.538944	824	903	141	1	79	0.0126582
NODE_3765_length_1216_cov_99.538944	824	903	142	4	79	0.0506329
NODE_3765_length_1216_cov_99.538944	824	903	143	3	79	0.0379747
NODE_3765_length_1216_cov_99.538944	824	903	144	1	79	0.0126582
NODE_3765_length_1216_cov_99.538944	824	903	145	2	79	0.0253165
NODE_3765_length_1216_cov_99.538944	824	903	146	2	79	0.0253165
NODE_3765_length_1216_cov_99.538944	824	903	147	1	79	0.0126582
NODE_3765_length_1216_cov_99.538944	824	903	148	1	79	0.0126582
NODE_3765_length_1216_cov_99.538944	824	903	149	4	79	0.0506329
NODE_3765_length_1216_cov_99.538944	824	903	150	1	79	0.0126582
NODE_3765_length_1216_cov_99.538944	824	903	151	1	79	0.0126582
NODE_3765_length_1216_cov_99.538944	824	903	152	1	79	0.0126582
NODE_3765_length_1216_cov_99.538944	824	903	155	2	79	0.0253165
NODE_3765_length_1216_cov_99.538944	824	903	158	1	79	0.0126582
NODE_3765_length_1216_cov_99.538944	824	903	160	2	79	0.0253165
NODE_3765_length_1216_cov_99.538944	824	903	161	2	79	0.0253165
NODE_3765_length_1216_cov_99.538944	824	903	162	4	79	0.0506329
NODE_3765_length_1216_cov_99.538944	824	903	164	2	79	0.0253165
NODE_3765_length_1216_cov_99.538944	824	903	165	3	79	0.0379747
NODE_3765_length_1216_cov_99.538944	824	903	166	1	79	0.0126582
NODE_3765_length_1216_cov_99.538944	824	903	167	1	79	0.0126582
NODE_3765_length_1216_cov_99.538944	824	903	169	2	79	0.0253165
NODE_3765_length_1216_cov_99.538944	824	903	173	1	79	0.0126582
NODE_3765_length_1216_cov_99.538944	824	903	174	1	79	0.0126582
NODE_3765_length_1216_cov_99.538944	824	903	178	1	79	0.0126582
NODE_3765_length_1216_cov_99.538944	824	903	179	2	79	0.0253165
NODE_3765_length_1216_cov_99.538944	824	903	183	1	79	0.0126582
NODE_3765_length_1216_cov_99.538944	824	903	184	1	79	0.0126582
NODE_3765_length_1216_cov_99.538944	824	903	198	3	79	0.0379747
NODE_3765_length_1216_cov_99.538944	824	903	200	1	79	0.0126582
NODE_3765_length_1216_cov_99.538944	824	903	204	2	79	0.0253165
NODE_3765_length_1216_cov_99.538944	824	903	205	1	79	0.0126582
NODE_3765_length_1216_cov_99.538944	824	903	206	2	79	0.0253165
NODE_3765_length_1216_cov_99.538944	824	903	207	1	79	0.0126582
NODE_3765_length_1216_cov_99.538944	824	903	208	1	79	0.0126582
NODE_3765_length_1216_cov_99.538944	824	903	218	1	79	0.0126582
NODE_3765_length_1216_cov_99.538944	824	903	224	4	79	0.0506329
NODE_3765_length_1216_cov_99.538944	824	903	225	1	79	0.0126582
NODE_3765_length_1216_cov_99.538944	824	903	228	4	79	0.0506329
NODE_3765_length_1216_cov_99.538944	824	903	229	1	79	0.0126582
NODE_3765_length_1216_cov_99.538944	824	903	230	3	79	0.0379747
NODE_3766_length_1216_cov_15.855864	668	748	0	31	80	0.3875000
NODE_3766_length_1216_cov_15.855864	668	748	2	49	80	0.6125000
NODE_3766_length_1216_cov_15.855864	721	801	0	34	80	0.4250000
NODE_3766_length_1216_cov_15.855864	721	801	2	46	80	0.5750000
NODE_3767_length_1216_cov_4.128917	720	800	0	80	80	1.0000000
NODE_3767_length_1216_cov_4.128917	773	853	0	80	80	1.0000000
NODE_3774_length_1215_cov_32.293011	411	491	0	80	80	1.0000000
NODE_3774_length_1215_cov_32.293011	464	544	0	29	80	0.3625000
NODE_3774_length_1215_cov_32.293011	464	544	2	51	80	0.6375000
NODE_3775_length_1215_cov_24.177419	729	809	0	18	80	0.2250000
NODE_3775_length_1215_cov_24.177419	729	809	2	62	80	0.7750000
NODE_3775_length_1215_cov_24.177419	782	862	0	43	80	0.5375000
NODE_3775_length_1215_cov_24.177419	782	862	2	37	80	0.4625000
NODE_3776_length_1215_cov_21.566308	645	725	0	9	80	0.1125000
NODE_3776_length_1215_cov_21.566308	645	725	4	53	80	0.6625000
NODE_3776_length_1215_cov_21.566308	645	725	7	18	80	0.2250000
NODE_3776_length_1215_cov_21.566308	698	778	3	3	80	0.0375000
NODE_3776_length_1215_cov_21.566308	698	778	4	29	80	0.3625000
NODE_3776_length_1215_cov_21.566308	698	778	7	48	80	0.6000000
NODE_3777_length_1215_cov_19.278674	630	710	8	7	80	0.0875000
NODE_3777_length_1215_cov_19.278674	630	710	12	13	80	0.1625000
NODE_3777_length_1215_cov_19.278674	630	710	17	17	80	0.2125000
NODE_3777_length_1215_cov_19.278674	630	710	18	3	80	0.0375000
NODE_3777_length_1215_cov_19.278674	630	710	19	36	80	0.4500000
NODE_3777_length_1215_cov_19.278674	630	710	20	4	80	0.0500000
NODE_3777_length_1215_cov_19.278674	683	763	0	18	80	0.2250000
NODE_3777_length_1215_cov_19.278674	683	763	8	42	80	0.5250000
NODE_3777_length_1215_cov_19.278674	683	763	17	17	80	0.2125000
NODE_3777_length_1215_cov_19.278674	683	763	18	3	80	0.0375000
NODE_3778_length_1215_cov_15.074373	664	744	0	16	80	0.2000000
NODE_3778_length_1215_cov_15.074373	664	744	2	64	80	0.8000000
NODE_3778_length_1215_cov_15.074373	717	797	0	9	80	0.1125000
NODE_3778_length_1215_cov_15.074373	717	797	2	71	80	0.8875000
NODE_3779_length_1215_cov_5.932796	507	587	2	80	80	1.0000000
NODE_3779_length_1215_cov_5.932796	560	640	0	52	80	0.6500000
NODE_3779_length_1215_cov_5.932796	560	640	2	28	80	0.3500000
NODE_3787_length_1214_cov_26.771300	420	500	80	3	80	0.0375000
NODE_3787_length_1214_cov_26.771300	420	500	84	1	80	0.0125000
NODE_3787_length_1214_cov_26.771300	420	500	86	1	80	0.0125000
NODE_3787_length_1214_cov_26.771300	420	500	92	1	80	0.0125000
NODE_3787_length_1214_cov_26.771300	420	500	98	1	80	0.0125000
NODE_3787_length_1214_cov_26.771300	420	500	115	1	80	0.0125000
NODE_3787_length_1214_cov_26.771300	420	500	126	1	80	0.0125000
NODE_3787_length_1214_cov_26.771300	420	500	132	1	80	0.0125000
NODE_3787_length_1214_cov_26.771300	420	500	138	1	80	0.0125000
NODE_3787_length_1214_cov_26.771300	420	500	146	1	80	0.0125000
NODE_3787_length_1214_cov_26.771300	420	500	150	1	80	0.0125000
NODE_3787_length_1214_cov_26.771300	420	500	154	1	80	0.0125000
NODE_3787_length_1214_cov_26.771300	420	500	167	3	80	0.0375000
NODE_3787_length_1214_cov_26.771300	420	500	173	1	80	0.0125000
NODE_3787_length_1214_cov_26.771300	420	500	175	1	80	0.0125000
NODE_3787_length_1214_cov_26.771300	420	500	191	1	80	0.0125000
NODE_3787_length_1214_cov_26.771300	420	500	192	2	80	0.0250000
NODE_3787_length_1214_cov_26.771300	420	500	196	1	80	0.0125000
NODE_3787_length_1214_cov_26.771300	420	500	204	2	80	0.0250000
NODE_3787_length_1214_cov_26.771300	420	500	228	4	80	0.0500000
NODE_3787_length_1214_cov_26.771300	420	500	234	1	80	0.0125000
NODE_3787_length_1214_cov_26.771300	420	500	240	2	80	0.0250000
NODE_3787_length_1214_cov_26.771300	420	500	242	3	80	0.0375000
NODE_3787_length_1214_cov_26.771300	420	500	244	2	80	0.0250000
NODE_3787_length_1214_cov_26.771300	420	500	248	1	80	0.0125000
NODE_3787_length_1214_cov_26.771300	420	500	250	6	80	0.0750000
NODE_3787_length_1214_cov_26.771300	420	500	252	2	80	0.0250000
NODE_3787_length_1214_cov_26.771300	420	500	254	1	80	0.0125000
NODE_3787_length_1214_cov_26.771300	420	500	256	4	80	0.0500000
NODE_3787_length_1214_cov_26.771300	420	500	257	1	80	0.0125000
NODE_3787_length_1214_cov_26.771300	420	500	258	4	80	0.0500000
NODE_3787_length_1214_cov_26.771300	420	500	260	7	80	0.0875000
NODE_3787_length_1214_cov_26.771300	420	500	262	6	80	0.0750000
NODE_3787_length_1214_cov_26.771300	420	500	264	6	80	0.0750000
NODE_3787_length_1214_cov_26.771300	420	500	265	3	80	0.0375000
NODE_3787_length_1214_cov_26.771300	420	500	267	2	80	0.0250000
NODE_3787_length_1214_cov_26.771300	473	553	28	1	80	0.0125000
NODE_3787_length_1214_cov_26.771300	473	553	44	1	80	0.0125000
NODE_3787_length_1214_cov_26.771300	473	553	58	2	80	0.0250000
NODE_3787_length_1214_cov_26.771300	473	553	71	1	80	0.0125000
NODE_3787_length_1214_cov_26.771300	473	553	80	1	80	0.0125000
NODE_3787_length_1214_cov_26.771300	473	553	88	1	80	0.0125000
NODE_3787_length_1214_cov_26.771300	473	553	90	1	80	0.0125000
NODE_3787_length_1214_cov_26.771300	473	553	92	1	80	0.0125000
NODE_3787_length_1214_cov_26.771300	473	553	98	1	80	0.0125000
NODE_3787_length_1214_cov_26.771300	473	553	102	1	80	0.0125000
NODE_3787_length_1214_cov_26.771300	473	553	104	1	80	0.0125000
NODE_3787_length_1214_cov_26.771300	473	553	121	1	80	0.0125000
NODE_3787_length_1214_cov_26.771300	473	553	122	1	80	0.0125000
NODE_3787_length_1214_cov_26.771300	473	553	123	2	80	0.0250000
NODE_3787_length_1214_cov_26.771300	473	553	124	1	80	0.0125000
NODE_3787_length_1214_cov_26.771300	473	553	130	1	80	0.0125000
NODE_3787_length_1214_cov_26.771300	473	553	134	1	80	0.0125000
NODE_3787_length_1214_cov_26.771300	473	553	138	1	80	0.0125000
NODE_3787_length_1214_cov_26.771300	473	553	149	1	80	0.0125000
NODE_3787_length_1214_cov_26.771300	473	553	150	1	80	0.0125000
NODE_3787_length_1214_cov_26.771300	473	553	158	2	80	0.0250000
NODE_3787_length_1214_cov_26.771300	473	553	166	1	80	0.0125000
NODE_3787_length_1214_cov_26.771300	473	553	178	1	80	0.0125000
NODE_3787_length_1214_cov_26.771300	473	553	180	1	80	0.0125000
NODE_3787_length_1214_cov_26.771300	473	553	184	1	80	0.0125000
NODE_3787_length_1214_cov_26.771300	473	553	186	1	80	0.0125000
NODE_3787_length_1214_cov_26.771300	473	553	188	1	80	0.0125000
NODE_3787_length_1214_cov_26.771300	473	553	192	1	80	0.0125000
NODE_3787_length_1214_cov_26.771300	473	553	196	1	80	0.0125000
NODE_3787_length_1214_cov_26.771300	473	553	204	1	80	0.0125000
NODE_3787_length_1214_cov_26.771300	473	553	216	1	80	0.0125000
NODE_3787_length_1214_cov_26.771300	473	553	220	1	80	0.0125000
NODE_3787_length_1214_cov_26.771300	473	553	222	1	80	0.0125000
NODE_3787_length_1214_cov_26.771300	473	553	229	2	80	0.0250000
NODE_3787_length_1214_cov_26.771300	473	553	231	2	80	0.0250000
NODE_3787_length_1214_cov_26.771300	473	553	235	4	80	0.0500000
NODE_3787_length_1214_cov_26.771300	473	553	236	3	80	0.0375000
NODE_3787_length_1214_cov_26.771300	473	553	238	1	80	0.0125000
NODE_3787_length_1214_cov_26.771300	473	553	239	3	80	0.0375000
NODE_3787_length_1214_cov_26.771300	473	553	242	1	80	0.0125000
NODE_3787_length_1214_cov_26.771300	473	553	243	1	80	0.0125000
NODE_3787_length_1214_cov_26.771300	473	553	244	1	80	0.0125000
NODE_3787_length_1214_cov_26.771300	473	553	248	1	80	0.0125000
NODE_3787_length_1214_cov_26.771300	473	553	250	2	80	0.0250000
NODE_3787_length_1214_cov_26.771300	473	553	252	1	80	0.0125000
NODE_3787_length_1214_cov_26.771300	473	553	256	3	80	0.0375000
NODE_3787_length_1214_cov_26.771300	473	553	258	4	80	0.0500000
NODE_3787_length_1214_cov_26.771300	473	553	260	7	80	0.0875000
NODE_3787_length_1214_cov_26.771300	473	553	262	6	80	0.0750000
NODE_3787_length_1214_cov_26.771300	473	553	264	2	80	0.0250000
NODE_3788_length_1214_cov_24.555157	480	560	0	80	80	1.0000000
NODE_3788_length_1214_cov_24.555157	533	613	0	80	80	1.0000000
NODE_3789_length_1214_cov_23.167713	623	703	0	80	80	1.0000000
NODE_3789_length_1214_cov_23.167713	676	756	0	80	80	1.0000000
NODE_3790_length_1214_cov_18.452915	555	635	0	80	80	1.0000000
NODE_3790_length_1214_cov_18.452915	608	688	0	80	80	1.0000000
NODE_3790_length_1214_cov_18.452915	684	764	0	70	80	0.8750000
NODE_3790_length_1214_cov_18.452915	684	764	4	10	80	0.1250000
NODE_3790_length_1214_cov_18.452915	737	817	0	17	80	0.2125000
NODE_3790_length_1214_cov_18.452915	737	817	4	63	80	0.7875000
NODE_3791_length_1214_cov_8.906726	206	286	0	31	80	0.3875000
NODE_3791_length_1214_cov_8.906726	206	286	4	49	80	0.6125000
NODE_3791_length_1214_cov_8.906726	259	339	4	80	80	1.0000000
NODE_3792_length_1214_cov_3.686996	415	495	0	31	80	0.3875000
NODE_3792_length_1214_cov_3.686996	415	495	4	49	80	0.6125000
NODE_3792_length_1214_cov_3.686996	468	548	4	80	80	1.0000000
NODE_3799_length_1214_cov_0.967713	1049	1129	143	1	80	0.0125000
NODE_3799_length_1214_cov_0.967713	1049	1129	147	1	80	0.0125000
NODE_3799_length_1214_cov_0.967713	1049	1129	151	1	80	0.0125000
NODE_3799_length_1214_cov_0.967713	1049	1129	157	1	80	0.0125000
NODE_3799_length_1214_cov_0.967713	1049	1129	161	1	80	0.0125000
NODE_3799_length_1214_cov_0.967713	1049	1129	165	1	80	0.0125000
NODE_3799_length_1214_cov_0.967713	1049	1129	170	1	80	0.0125000
NODE_3799_length_1214_cov_0.967713	1049	1129	184	1	80	0.0125000
NODE_3799_length_1214_cov_0.967713	1049	1129	204	1	80	0.0125000
NODE_3799_length_1214_cov_0.967713	1049	1129	210	1	80	0.0125000
NODE_3799_length_1214_cov_0.967713	1049	1129	212	1	80	0.0125000
NODE_3799_length_1214_cov_0.967713	1049	1129	214	1	80	0.0125000
NODE_3799_length_1214_cov_0.967713	1049	1129	216	1	80	0.0125000
NODE_3799_length_1214_cov_0.967713	1049	1129	226	1	80	0.0125000
NODE_3799_length_1214_cov_0.967713	1049	1129	228	1	80	0.0125000
NODE_3799_length_1214_cov_0.967713	1049	1129	231	4	80	0.0500000
NODE_3799_length_1214_cov_0.967713	1049	1129	232	5	80	0.0625000
NODE_3799_length_1214_cov_0.967713	1049	1129	233	2	80	0.0250000
NODE_3799_length_1214_cov_0.967713	1049	1129	234	3	80	0.0375000
NODE_3799_length_1214_cov_0.967713	1049	1129	235	2	80	0.0250000
NODE_3799_length_1214_cov_0.967713	1049	1129	236	2	80	0.0250000
NODE_3799_length_1214_cov_0.967713	1049	1129	237	1	80	0.0125000
NODE_3799_length_1214_cov_0.967713	1049	1129	238	3	80	0.0375000
NODE_3799_length_1214_cov_0.967713	1049	1129	239	1	80	0.0125000
NODE_3799_length_1214_cov_0.967713	1049	1129	240	1	80	0.0125000
NODE_3799_length_1214_cov_0.967713	1049	1129	241	4	80	0.0500000
NODE_3799_length_1214_cov_0.967713	1049	1129	242	7	80	0.0875000
NODE_3799_length_1214_cov_0.967713	1049	1129	245	9	80	0.1125000
NODE_3799_length_1214_cov_0.967713	1049	1129	246	2	80	0.0250000
NODE_3799_length_1214_cov_0.967713	1049	1129	247	1	80	0.0125000
NODE_3799_length_1214_cov_0.967713	1049	1129	248	3	80	0.0375000
NODE_3799_length_1214_cov_0.967713	1049	1129	250	2	80	0.0250000
NODE_3799_length_1214_cov_0.967713	1049	1129	252	1	80	0.0125000
NODE_3799_length_1214_cov_0.967713	1049	1129	254	1	80	0.0125000
NODE_3799_length_1214_cov_0.967713	1049	1129	259	2	80	0.0250000
NODE_3799_length_1214_cov_0.967713	1049	1129	260	2	80	0.0250000
NODE_3799_length_1214_cov_0.967713	1049	1129	262	1	80	0.0125000
NODE_3799_length_1214_cov_0.967713	1049	1129	264	4	80	0.0500000
NODE_3799_length_1214_cov_0.967713	1049	1129	265	1	80	0.0125000
NODE_3799_length_1214_cov_0.967713	1049	1129	266	1	80	0.0125000
NODE_3800_length_1213_cov_19.524237	499	579	7	3	80	0.0375000
NODE_3800_length_1213_cov_19.524237	499	579	12	77	80	0.9625000
NODE_3800_length_1213_cov_19.524237	552	632	12	29	80	0.3625000
NODE_3800_length_1213_cov_19.524237	552	632	14	5	80	0.0625000
NODE_3800_length_1213_cov_19.524237	552	632	16	35	80	0.4375000
NODE_3800_length_1213_cov_19.524237	552	632	18	11	80	0.1375000
NODE_3806_length_1212_cov_32.663073	688	768	12	7	80	0.0875000
NODE_3806_length_1212_cov_32.663073	688	768	18	16	80	0.2000000
NODE_3806_length_1212_cov_32.663073	688	768	20	57	80	0.7125000
NODE_3806_length_1212_cov_32.663073	741	821	6	15	80	0.1875000
NODE_3806_length_1212_cov_32.663073	741	821	10	1	80	0.0125000
NODE_3806_length_1212_cov_32.663073	741	821	11	33	80	0.4125000
NODE_3806_length_1212_cov_32.663073	741	821	12	3	80	0.0375000
NODE_3806_length_1212_cov_32.663073	741	821	18	1	80	0.0125000
NODE_3806_length_1212_cov_32.663073	741	821	20	27	80	0.3375000
NODE_3807_length_1212_cov_15.981132	33	113	14	4	80	0.0500000
NODE_3807_length_1212_cov_15.981132	33	113	20	4	80	0.0500000
NODE_3807_length_1212_cov_15.981132	33	113	22	8	80	0.1000000
NODE_3807_length_1212_cov_15.981132	33	113	24	64	80	0.8000000
NODE_3807_length_1212_cov_15.981132	511	591	0	1	80	0.0125000
NODE_3807_length_1212_cov_15.981132	511	591	2	79	80	0.9875000
NODE_3807_length_1212_cov_15.981132	564	637	0	47	73	0.6438356
NODE_3807_length_1212_cov_15.981132	564	637	2	26	73	0.3561644
NODE_3813_length_1211_cov_30.513489	561	641	0	54	80	0.6750000
NODE_3813_length_1211_cov_30.513489	561	641	2	26	80	0.3250000
NODE_3813_length_1211_cov_30.513489	614	694	0	1	80	0.0125000
NODE_3813_length_1211_cov_30.513489	614	694	2	79	80	0.9875000
NODE_3813_length_1211_cov_30.513489	690	770	2	28	80	0.3500000
NODE_3813_length_1211_cov_30.513489	690	770	4	24	80	0.3000000
NODE_3813_length_1211_cov_30.513489	690	770	6	28	80	0.3500000
NODE_3813_length_1211_cov_30.513489	743	823	0	20	80	0.2500000
NODE_3813_length_1211_cov_30.513489	743	823	3	1	80	0.0125000
NODE_3813_length_1211_cov_30.513489	743	823	4	56	80	0.7000000
NODE_3813_length_1211_cov_30.513489	743	823	6	3	80	0.0375000
NODE_3815_length_1211_cov_10.073741	380	460	2	9	80	0.1125000
NODE_3815_length_1211_cov_10.073741	380	460	4	71	80	0.8875000
NODE_3815_length_1211_cov_10.073741	433	513	0	42	80	0.5250000
NODE_3815_length_1211_cov_10.073741	433	513	2	20	80	0.2500000
NODE_3815_length_1211_cov_10.073741	433	513	4	18	80	0.2250000
NODE_3816_length_1211_cov_7.561151	598	678	0	36	80	0.4500000
NODE_3816_length_1211_cov_7.561151	598	678	9	44	80	0.5500000
NODE_3816_length_1211_cov_7.561151	651	731	9	61	80	0.7625000
NODE_3816_length_1211_cov_7.561151	651	731	10	19	80	0.2375000
NODE_3820_length_1210_cov_49.743474	398	478	0	16	80	0.2000000
NODE_3820_length_1210_cov_49.743474	398	478	7	1	80	0.0125000
NODE_3820_length_1210_cov_49.743474	398	478	9	8	80	0.1000000
NODE_3820_length_1210_cov_49.743474	398	478	17	23	80	0.2875000
NODE_3820_length_1210_cov_49.743474	398	478	19	32	80	0.4000000
NODE_3820_length_1210_cov_49.743474	451	531	18	14	80	0.1750000
NODE_3820_length_1210_cov_49.743474	451	531	19	35	80	0.4375000
NODE_3820_length_1210_cov_49.743474	451	531	20	31	80	0.3875000
NODE_3821_length_1210_cov_15.647165	647	727	0	80	80	1.0000000
NODE_3821_length_1210_cov_15.647165	700	780	0	80	80	1.0000000
NODE_3822_length_1210_cov_11.194419	794	874	6	80	80	1.0000000
NODE_3822_length_1210_cov_11.194419	847	927	0	51	80	0.6375000
NODE_3822_length_1210_cov_11.194419	847	927	6	29	80	0.3625000
NODE_3826_length_1209_cov_24.504505	582	662	0	80	80	1.0000000
NODE_3826_length_1209_cov_24.504505	635	715	0	78	80	0.9750000
NODE_3826_length_1209_cov_24.504505	635	715	2	2	80	0.0250000
NODE_3826_length_1209_cov_24.504505	711	791	0	3	80	0.0375000
NODE_3826_length_1209_cov_24.504505	711	791	2	77	80	0.9625000
NODE_3826_length_1209_cov_24.504505	764	844	0	54	80	0.6750000
NODE_3826_length_1209_cov_24.504505	764	844	2	26	80	0.3250000
NODE_3827_length_1209_cov_21.846847	520	600	0	17	80	0.2125000
NODE_3827_length_1209_cov_21.846847	520	600	2	63	80	0.7875000
NODE_3827_length_1209_cov_21.846847	573	653	2	45	80	0.5625000
NODE_3827_length_1209_cov_21.846847	573	653	4	35	80	0.4375000
NODE_3827_length_1209_cov_21.846847	649	729	0	10	80	0.1250000
NODE_3827_length_1209_cov_21.846847	649	729	2	70	80	0.8750000
NODE_3827_length_1209_cov_21.846847	702	782	0	63	80	0.7875000
NODE_3827_length_1209_cov_21.846847	702	782	2	17	80	0.2125000
NODE_3828_length_1209_cov_9.026126	782	862	0	7	80	0.0875000
NODE_3828_length_1209_cov_9.026126	782	862	2	29	80	0.3625000
NODE_3828_length_1209_cov_9.026126	782	862	4	28	80	0.3500000
NODE_3828_length_1209_cov_9.026126	782	862	5	16	80	0.2000000
NODE_3828_length_1209_cov_9.026126	835	915	0	60	80	0.7500000
NODE_3828_length_1209_cov_9.026126	835	915	2	20	80	0.2500000
NODE_3830_length_1209_cov_5.721622	926	1006	0	3	80	0.0375000
NODE_3830_length_1209_cov_5.721622	926	1006	7	1	80	0.0125000
NODE_3830_length_1209_cov_5.721622	926	1006	8	76	80	0.9500000
NODE_3830_length_1209_cov_5.721622	979	1059	8	80	80	1.0000000
NODE_3833_length_1208_cov_40.717764	886	966	113	1	80	0.0125000
NODE_3833_length_1208_cov_40.717764	886	966	115	3	80	0.0375000
NODE_3833_length_1208_cov_40.717764	886	966	116	2	80	0.0250000
NODE_3833_length_1208_cov_40.717764	886	966	117	2	80	0.0250000
NODE_3833_length_1208_cov_40.717764	886	966	118	2	80	0.0250000
NODE_3833_length_1208_cov_40.717764	886	966	119	6	80	0.0750000
NODE_3833_length_1208_cov_40.717764	886	966	123	1	80	0.0125000
NODE_3833_length_1208_cov_40.717764	886	966	124	1	80	0.0125000
NODE_3833_length_1208_cov_40.717764	886	966	125	1	80	0.0125000
NODE_3833_length_1208_cov_40.717764	886	966	127	2	80	0.0250000
NODE_3833_length_1208_cov_40.717764	886	966	128	1	80	0.0125000
NODE_3833_length_1208_cov_40.717764	886	966	129	3	80	0.0375000
NODE_3833_length_1208_cov_40.717764	886	966	131	2	80	0.0250000
NODE_3833_length_1208_cov_40.717764	886	966	135	2	80	0.0250000
NODE_3833_length_1208_cov_40.717764	886	966	136	1	80	0.0125000
NODE_3833_length_1208_cov_40.717764	886	966	138	2	80	0.0250000
NODE_3833_length_1208_cov_40.717764	886	966	142	1	80	0.0125000
NODE_3833_length_1208_cov_40.717764	886	966	148	2	80	0.0250000
NODE_3833_length_1208_cov_40.717764	886	966	150	1	80	0.0125000
NODE_3833_length_1208_cov_40.717764	886	966	151	1	80	0.0125000
NODE_3833_length_1208_cov_40.717764	886	966	152	1	80	0.0125000
NODE_3833_length_1208_cov_40.717764	886	966	153	1	80	0.0125000
NODE_3833_length_1208_cov_40.717764	886	966	155	2	80	0.0250000
NODE_3833_length_1208_cov_40.717764	886	966	157	2	80	0.0250000
NODE_3833_length_1208_cov_40.717764	886	966	159	2	80	0.0250000
NODE_3833_length_1208_cov_40.717764	886	966	162	1	80	0.0125000
NODE_3833_length_1208_cov_40.717764	886	966	165	1	80	0.0125000
NODE_3833_length_1208_cov_40.717764	886	966	167	1	80	0.0125000
NODE_3833_length_1208_cov_40.717764	886	966	171	1	80	0.0125000
NODE_3833_length_1208_cov_40.717764	886	966	188	2	80	0.0250000
NODE_3833_length_1208_cov_40.717764	886	966	189	1	80	0.0125000
NODE_3833_length_1208_cov_40.717764	886	966	195	1	80	0.0125000
NODE_3833_length_1208_cov_40.717764	886	966	225	1	80	0.0125000
NODE_3833_length_1208_cov_40.717764	886	966	233	1	80	0.0125000
NODE_3833_length_1208_cov_40.717764	886	966	245	1	80	0.0125000
NODE_3833_length_1208_cov_40.717764	886	966	253	1	80	0.0125000
NODE_3833_length_1208_cov_40.717764	886	966	262	1	80	0.0125000
NODE_3833_length_1208_cov_40.717764	886	966	272	1	80	0.0125000
NODE_3833_length_1208_cov_40.717764	886	966	286	1	80	0.0125000
NODE_3833_length_1208_cov_40.717764	886	966	293	1	80	0.0125000
NODE_3833_length_1208_cov_40.717764	886	966	299	1	80	0.0125000
NODE_3833_length_1208_cov_40.717764	886	966	307	3	80	0.0375000
NODE_3833_length_1208_cov_40.717764	886	966	310	2	80	0.0250000
NODE_3833_length_1208_cov_40.717764	886	966	316	1	80	0.0125000
NODE_3833_length_1208_cov_40.717764	886	966	335	1	80	0.0125000
NODE_3833_length_1208_cov_40.717764	886	966	340	1	80	0.0125000
NODE_3833_length_1208_cov_40.717764	886	966	342	1	80	0.0125000
NODE_3833_length_1208_cov_40.717764	886	966	350	1	80	0.0125000
NODE_3833_length_1208_cov_40.717764	886	966	358	1	80	0.0125000
NODE_3833_length_1208_cov_40.717764	886	966	369	1	80	0.0125000
NODE_3833_length_1208_cov_40.717764	886	966	371	1	80	0.0125000
NODE_3833_length_1208_cov_40.717764	886	966	385	1	80	0.0125000
NODE_3833_length_1208_cov_40.717764	886	966	393	1	80	0.0125000
NODE_3833_length_1208_cov_40.717764	886	966	397	1	80	0.0125000
NODE_3833_length_1208_cov_40.717764	886	966	418	1	80	0.0125000
NODE_3833_length_1208_cov_40.717764	886	966	429	1	80	0.0125000
NODE_3833_length_1208_cov_40.717764	939	985	225	1	46	0.0217391
NODE_3833_length_1208_cov_40.717764	939	985	233	1	46	0.0217391
NODE_3833_length_1208_cov_40.717764	939	985	245	1	46	0.0217391
NODE_3833_length_1208_cov_40.717764	939	985	253	1	46	0.0217391
NODE_3833_length_1208_cov_40.717764	939	985	262	1	46	0.0217391
NODE_3833_length_1208_cov_40.717764	939	985	272	1	46	0.0217391
NODE_3833_length_1208_cov_40.717764	939	985	286	1	46	0.0217391
NODE_3833_length_1208_cov_40.717764	939	985	293	1	46	0.0217391
NODE_3833_length_1208_cov_40.717764	939	985	299	1	46	0.0217391
NODE_3833_length_1208_cov_40.717764	939	985	307	3	46	0.0652174
NODE_3833_length_1208_cov_40.717764	939	985	310	2	46	0.0434783
NODE_3833_length_1208_cov_40.717764	939	985	316	1	46	0.0217391
NODE_3833_length_1208_cov_40.717764	939	985	335	1	46	0.0217391
NODE_3833_length_1208_cov_40.717764	939	985	340	1	46	0.0217391
NODE_3833_length_1208_cov_40.717764	939	985	342	1	46	0.0217391
NODE_3833_length_1208_cov_40.717764	939	985	350	1	46	0.0217391
NODE_3833_length_1208_cov_40.717764	939	985	358	1	46	0.0217391
NODE_3833_length_1208_cov_40.717764	939	985	369	1	46	0.0217391
NODE_3833_length_1208_cov_40.717764	939	985	371	1	46	0.0217391
NODE_3833_length_1208_cov_40.717764	939	985	385	1	46	0.0217391
NODE_3833_length_1208_cov_40.717764	939	985	393	1	46	0.0217391
NODE_3833_length_1208_cov_40.717764	939	985	397	1	46	0.0217391
NODE_3833_length_1208_cov_40.717764	939	985	418	1	46	0.0217391
NODE_3833_length_1208_cov_40.717764	939	985	429	1	46	0.0217391
NODE_3833_length_1208_cov_40.717764	939	985	437	1	46	0.0217391
NODE_3833_length_1208_cov_40.717764	939	985	447	1	46	0.0217391
NODE_3833_length_1208_cov_40.717764	939	985	455	1	46	0.0217391
NODE_3833_length_1208_cov_40.717764	939	985	487	1	46	0.0217391
NODE_3833_length_1208_cov_40.717764	939	985	507	1	46	0.0217391
NODE_3833_length_1208_cov_40.717764	939	985	525	1	46	0.0217391
NODE_3833_length_1208_cov_40.717764	939	985	531	1	46	0.0217391
NODE_3833_length_1208_cov_40.717764	939	985	548	1	46	0.0217391
NODE_3833_length_1208_cov_40.717764	939	985	555	1	46	0.0217391
NODE_3833_length_1208_cov_40.717764	939	985	560	1	46	0.0217391
NODE_3833_length_1208_cov_40.717764	939	985	561	1	46	0.0217391
NODE_3833_length_1208_cov_40.717764	939	985	572	1	46	0.0217391
NODE_3833_length_1208_cov_40.717764	939	985	582	1	46	0.0217391
NODE_3833_length_1208_cov_40.717764	939	985	587	1	46	0.0217391
NODE_3833_length_1208_cov_40.717764	939	985	589	1	46	0.0217391
NODE_3833_length_1208_cov_40.717764	939	985	595	1	46	0.0217391
NODE_3833_length_1208_cov_40.717764	939	985	597	1	46	0.0217391
NODE_3833_length_1208_cov_40.717764	939	985	603	1	46	0.0217391
NODE_3833_length_1208_cov_40.717764	939	985	606	1	46	0.0217391
NODE_3834_length_1208_cov_28.528404	614	694	6	23	80	0.2875000
NODE_3834_length_1208_cov_28.528404	614	694	10	30	80	0.3750000
NODE_3834_length_1208_cov_28.528404	614	694	12	27	80	0.3375000
NODE_3834_length_1208_cov_28.528404	667	747	0	53	80	0.6625000
NODE_3834_length_1208_cov_28.528404	667	747	6	23	80	0.2875000
NODE_3834_length_1208_cov_28.528404	667	747	10	4	80	0.0500000
NODE_3835_length_1208_cov_19.688007	682	762	0	80	80	1.0000000
NODE_3835_length_1208_cov_19.688007	735	815	0	80	80	1.0000000
NODE_3836_length_1208_cov_18.577096	455	535	0	51	80	0.6375000
NODE_3836_length_1208_cov_18.577096	455	535	2	29	80	0.3625000
NODE_3836_length_1208_cov_18.577096	508	588	0	80	80	1.0000000
NODE_3836_length_1208_cov_18.577096	584	664	0	49	80	0.6125000
NODE_3836_length_1208_cov_18.577096	584	664	2	16	80	0.2000000
NODE_3836_length_1208_cov_18.577096	584	664	4	15	80	0.1875000
NODE_3836_length_1208_cov_18.577096	637	717	2	12	80	0.1500000
NODE_3836_length_1208_cov_18.577096	637	717	4	68	80	0.8500000
NODE_3837_length_1208_cov_12.733995	766	846	0	80	80	1.0000000
NODE_3837_length_1208_cov_12.733995	819	899	0	80	80	1.0000000
NODE_3837_length_1208_cov_12.733995	895	975	0	32	80	0.4000000
NODE_3837_length_1208_cov_12.733995	895	975	2	48	80	0.6000000
NODE_3837_length_1208_cov_12.733995	948	1028	0	10	80	0.1250000
NODE_3837_length_1208_cov_12.733995	948	1028	2	70	80	0.8750000
NODE_3838_length_1207_cov_20.461191	874	954	2	80	80	1.0000000
NODE_3838_length_1207_cov_20.461191	927	1007	0	30	80	0.3750000
NODE_3838_length_1207_cov_20.461191	927	1007	2	50	80	0.6250000
NODE_3846_length_1206_cov_59.851852	540	620	0	80	80	1.0000000
NODE_3846_length_1206_cov_59.851852	593	673	0	80	80	1.0000000
NODE_3846_length_1206_cov_59.851852	669	749	0	80	80	1.0000000
NODE_3846_length_1206_cov_59.851852	722	802	0	80	80	1.0000000
NODE_3847_length_1206_cov_23.752484	669	749	0	36	80	0.4500000
NODE_3847_length_1206_cov_23.752484	669	749	2	8	80	0.1000000
NODE_3847_length_1206_cov_23.752484	669	749	4	36	80	0.4500000
NODE_3847_length_1206_cov_23.752484	722	802	0	80	80	1.0000000
NODE_3848_length_1206_cov_21.226739	585	665	0	20	80	0.2500000
NODE_3848_length_1206_cov_21.226739	585	665	2	60	80	0.7500000
NODE_3848_length_1206_cov_21.226739	638	718	0	73	80	0.9125000
NODE_3848_length_1206_cov_21.226739	638	718	2	7	80	0.0875000
NODE_3855_length_1205_cov_23.990054	355	435	0	36	80	0.4500000
NODE_3855_length_1205_cov_23.990054	355	435	2	44	80	0.5500000
NODE_3855_length_1205_cov_23.990054	408	488	0	29	80	0.3625000
NODE_3855_length_1205_cov_23.990054	408	488	2	51	80	0.6375000
NODE_3856_length_1205_cov_10.473779	780	860	0	80	80	1.0000000
NODE_3856_length_1205_cov_10.473779	833	913	0	80	80	1.0000000
NODE_3863_length_1204_cov_19.396380	537	617	0	18	80	0.2250000
NODE_3863_length_1204_cov_19.396380	537	617	2	62	80	0.7750000
NODE_3863_length_1204_cov_19.396380	590	670	0	11	80	0.1375000
NODE_3863_length_1204_cov_19.396380	590	670	2	69	80	0.8625000
NODE_3864_length_1204_cov_17.716742	448	528	0	80	80	1.0000000
NODE_3864_length_1204_cov_17.716742	501	581	0	80	80	1.0000000
NODE_3865_length_1204_cov_15.206335	426	506	0	22	80	0.2750000
NODE_3865_length_1204_cov_15.206335	426	506	6	58	80	0.7250000
NODE_3865_length_1204_cov_15.206335	479	559	0	75	80	0.9375000
NODE_3865_length_1204_cov_15.206335	479	559	6	5	80	0.0625000
NODE_3866_length_1204_cov_14.097738	632	712	0	5	80	0.0625000
NODE_3866_length_1204_cov_14.097738	632	712	2	75	80	0.9375000
NODE_3866_length_1204_cov_14.097738	685	765	0	5	80	0.0625000
NODE_3866_length_1204_cov_14.097738	685	765	2	75	80	0.9375000
NODE_3867_length_1204_cov_11.971946	549	629	2	72	80	0.9000000
NODE_3867_length_1204_cov_11.971946	549	629	4	8	80	0.1000000
NODE_3867_length_1204_cov_11.971946	602	682	0	26	80	0.3250000
NODE_3867_length_1204_cov_11.971946	602	682	2	54	80	0.6750000
NODE_3867_length_1204_cov_11.971946	678	758	0	46	80	0.5750000
NODE_3867_length_1204_cov_11.971946	678	758	2	34	80	0.4250000
NODE_3867_length_1204_cov_11.971946	731	811	2	80	80	1.0000000
NODE_3868_length_1204_cov_11.665158	499	579	2	12	80	0.1500000
NODE_3868_length_1204_cov_11.665158	499	579	4	21	80	0.2625000
NODE_3868_length_1204_cov_11.665158	499	579	8	39	80	0.4875000
NODE_3868_length_1204_cov_11.665158	499	579	12	8	80	0.1000000
NODE_3868_length_1204_cov_11.665158	552	632	8	28	80	0.3500000
NODE_3868_length_1204_cov_11.665158	552	632	10	30	80	0.3750000
NODE_3868_length_1204_cov_11.665158	552	632	12	22	80	0.2750000
NODE_3869_length_1204_cov_7.028959	637	717	0	47	80	0.5875000
NODE_3869_length_1204_cov_7.028959	637	717	2	33	80	0.4125000
NODE_3869_length_1204_cov_7.028959	690	770	2	80	80	1.0000000
NODE_3870_length_1204_cov_4.677828	807	887	0	80	80	1.0000000
NODE_3870_length_1204_cov_4.677828	860	940	0	80	80	1.0000000
NODE_3873_length_1203_cov_46.789855	515	595	2	18	80	0.2250000
NODE_3873_length_1203_cov_46.789855	515	595	4	62	80	0.7750000
NODE_3873_length_1203_cov_46.789855	568	648	0	32	80	0.4000000
NODE_3873_length_1203_cov_46.789855	568	648	2	39	80	0.4875000
NODE_3873_length_1203_cov_46.789855	568	648	4	9	80	0.1125000
NODE_3873_length_1203_cov_46.789855	644	724	0	80	80	1.0000000
NODE_3873_length_1203_cov_46.789855	697	777	0	80	80	1.0000000
NODE_3874_length_1203_cov_44.029891	471	551	0	16	80	0.2000000
NODE_3874_length_1203_cov_44.029891	471	551	2	64	80	0.8000000
NODE_3874_length_1203_cov_44.029891	524	604	0	64	80	0.8000000
NODE_3874_length_1203_cov_44.029891	524	604	2	16	80	0.2000000
NODE_3874_length_1203_cov_44.029891	600	680	0	80	80	1.0000000
NODE_3874_length_1203_cov_44.029891	653	733	0	80	80	1.0000000
NODE_3875_length_1203_cov_23.790761	308	388	0	6	80	0.0750000
NODE_3875_length_1203_cov_23.790761	308	388	2	62	80	0.7750000
NODE_3875_length_1203_cov_23.790761	308	388	4	12	80	0.1500000
NODE_3875_length_1203_cov_23.790761	361	441	2	68	80	0.8500000
NODE_3875_length_1203_cov_23.790761	361	441	4	12	80	0.1500000
NODE_3875_length_1203_cov_23.790761	437	517	2	57	80	0.7125000
NODE_3875_length_1203_cov_23.790761	437	517	4	23	80	0.2875000
NODE_3875_length_1203_cov_23.790761	490	570	0	14	80	0.1750000
NODE_3875_length_1203_cov_23.790761	490	570	2	43	80	0.5375000
NODE_3875_length_1203_cov_23.790761	490	570	4	23	80	0.2875000
NODE_3876_length_1203_cov_19.498188	336	416	0	80	80	1.0000000
NODE_3876_length_1203_cov_19.498188	389	469	0	80	80	1.0000000
NODE_3877_length_1203_cov_10.996377	317	397	0	80	80	1.0000000
NODE_3877_length_1203_cov_10.996377	370	450	0	37	80	0.4625000
NODE_3877_length_1203_cov_10.996377	370	450	2	43	80	0.5375000
NODE_3878_length_1203_cov_5.747283	725	805	0	80	80	1.0000000
NODE_3878_length_1203_cov_5.747283	778	858	0	80	80	1.0000000
NODE_3881_length_1202_cov_39.333636	475	555	0	80	80	1.0000000
NODE_3881_length_1202_cov_39.333636	528	608	0	73	80	0.9125000
NODE_3881_length_1202_cov_39.333636	528	608	2	7	80	0.0875000
NODE_3881_length_1202_cov_39.333636	604	684	2	6	80	0.0750000
NODE_3881_length_1202_cov_39.333636	604	684	6	5	80	0.0625000
NODE_3881_length_1202_cov_39.333636	604	684	8	19	80	0.2375000
NODE_3881_length_1202_cov_39.333636	604	684	10	16	80	0.2000000
NODE_3881_length_1202_cov_39.333636	604	684	12	15	80	0.1875000
NODE_3881_length_1202_cov_39.333636	604	684	14	2	80	0.0250000
NODE_3881_length_1202_cov_39.333636	604	684	18	2	80	0.0250000
NODE_3881_length_1202_cov_39.333636	604	684	20	15	80	0.1875000
NODE_3881_length_1202_cov_39.333636	657	737	12	26	80	0.3250000
NODE_3881_length_1202_cov_39.333636	657	737	14	20	80	0.2500000
NODE_3881_length_1202_cov_39.333636	657	737	16	4	80	0.0500000
NODE_3881_length_1202_cov_39.333636	657	737	18	15	80	0.1875000
NODE_3881_length_1202_cov_39.333636	657	737	20	15	80	0.1875000
NODE_3882_length_1202_cov_17.556664	599	679	0	22	80	0.2750000
NODE_3882_length_1202_cov_17.556664	599	679	2	23	80	0.2875000
NODE_3882_length_1202_cov_17.556664	599	679	12	13	80	0.1625000
NODE_3882_length_1202_cov_17.556664	599	679	18	2	80	0.0250000
NODE_3882_length_1202_cov_17.556664	599	679	20	12	80	0.1500000
NODE_3882_length_1202_cov_17.556664	599	679	22	8	80	0.1000000
NODE_3882_length_1202_cov_17.556664	652	732	12	5	80	0.0625000
NODE_3882_length_1202_cov_17.556664	652	732	18	2	80	0.0250000
NODE_3882_length_1202_cov_17.556664	652	732	20	12	80	0.1500000
NODE_3882_length_1202_cov_17.556664	652	732	22	44	80	0.5500000
NODE_3882_length_1202_cov_17.556664	652	732	24	17	80	0.2125000
NODE_3883_length_1202_cov_12.338169	634	714	2	5	80	0.0625000
NODE_3883_length_1202_cov_12.338169	634	714	7	10	80	0.1250000
NODE_3883_length_1202_cov_12.338169	634	714	8	20	80	0.2500000
NODE_3883_length_1202_cov_12.338169	634	714	9	28	80	0.3500000
NODE_3883_length_1202_cov_12.338169	634	714	10	17	80	0.2125000
NODE_3883_length_1202_cov_12.338169	687	767	0	10	80	0.1250000
NODE_3883_length_1202_cov_12.338169	687	767	2	48	80	0.6000000
NODE_3883_length_1202_cov_12.338169	687	767	8	20	80	0.2500000
NODE_3883_length_1202_cov_12.338169	687	767	10	2	80	0.0250000
NODE_3884_length_1202_cov_11.800544	520	600	0	77	80	0.9625000
NODE_3884_length_1202_cov_11.800544	520	600	2	3	80	0.0375000
NODE_3884_length_1202_cov_11.800544	573	653	0	37	80	0.4625000
NODE_3884_length_1202_cov_11.800544	573	653	2	14	80	0.1750000
NODE_3884_length_1202_cov_11.800544	573	653	4	29	80	0.3625000
NODE_3887_length_1201_cov_12.161525	434	514	0	51	80	0.6375000
NODE_3887_length_1201_cov_12.161525	434	514	2	29	80	0.3625000
NODE_3887_length_1201_cov_12.161525	487	567	0	7	80	0.0875000
NODE_3887_length_1201_cov_12.161525	487	567	2	73	80	0.9125000
NODE_3888_length_1201_cov_12.046279	643	723	2	2	80	0.0250000
NODE_3888_length_1201_cov_12.046279	643	723	3	11	80	0.1375000
NODE_3888_length_1201_cov_12.046279	643	723	5	1	80	0.0125000
NODE_3888_length_1201_cov_12.046279	643	723	6	66	80	0.8250000
NODE_3888_length_1201_cov_12.046279	696	776	0	53	80	0.6625000
NODE_3888_length_1201_cov_12.046279	696	776	2	2	80	0.0250000
NODE_3888_length_1201_cov_12.046279	696	776	3	11	80	0.1375000
NODE_3888_length_1201_cov_12.046279	696	776	5	1	80	0.0125000
NODE_3888_length_1201_cov_12.046279	696	776	6	13	80	0.1625000
NODE_3891_length_1200_cov_76.694823	630	710	0	6	80	0.0750000
NODE_3891_length_1200_cov_76.694823	630	710	4	54	80	0.6750000
NODE_3891_length_1200_cov_76.694823	630	710	6	20	80	0.2500000
NODE_3891_length_1200_cov_76.694823	683	763	0	6	80	0.0750000
NODE_3891_length_1200_cov_76.694823	683	763	2	19	80	0.2375000
NODE_3891_length_1200_cov_76.694823	683	763	4	7	80	0.0875000
NODE_3891_length_1200_cov_76.694823	683	763	6	48	80	0.6000000
NODE_3891_length_1200_cov_76.694823	759	839	0	80	80	1.0000000
NODE_3891_length_1200_cov_76.694823	812	892	0	80	80	1.0000000
NODE_3892_length_1200_cov_16.881926	827	902	7	21	75	0.2800000
NODE_3892_length_1200_cov_16.881926	827	902	9	22	75	0.2933333
NODE_3892_length_1200_cov_16.881926	827	902	15	10	75	0.1333333
NODE_3892_length_1200_cov_16.881926	827	902	16	1	75	0.0133333
NODE_3892_length_1200_cov_16.881926	827	902	17	7	75	0.0933333
NODE_3892_length_1200_cov_16.881926	827	902	19	1	75	0.0133333
NODE_3892_length_1200_cov_16.881926	827	902	20	13	75	0.1733333
NODE_3892_length_1200_cov_16.881926	828	904	7	20	76	0.2631579
NODE_3892_length_1200_cov_16.881926	828	904	9	22	76	0.2894737
NODE_3892_length_1200_cov_16.881926	828	904	15	10	76	0.1315790
NODE_3892_length_1200_cov_16.881926	828	904	16	1	76	0.0131579
NODE_3892_length_1200_cov_16.881926	828	904	17	7	76	0.0921053
NODE_3892_length_1200_cov_16.881926	828	904	19	1	76	0.0131579
NODE_3892_length_1200_cov_16.881926	828	904	20	15	76	0.1973684
NODE_3892_length_1200_cov_16.881926	841	907	7	7	66	0.1060606
NODE_3892_length_1200_cov_16.881926	841	907	9	22	66	0.3333333
NODE_3892_length_1200_cov_16.881926	841	907	15	10	66	0.1515152
NODE_3892_length_1200_cov_16.881926	841	907	16	1	66	0.0151515
NODE_3892_length_1200_cov_16.881926	841	907	17	7	66	0.1060606
NODE_3892_length_1200_cov_16.881926	841	907	19	1	66	0.0151515
NODE_3892_length_1200_cov_16.881926	841	907	20	17	66	0.2575758
NODE_3892_length_1200_cov_16.881926	841	907	21	1	66	0.0151515
NODE_3892_length_1200_cov_16.881926	880	957	15	8	77	0.1038961
NODE_3892_length_1200_cov_16.881926	880	957	18	4	77	0.0519481
NODE_3892_length_1200_cov_16.881926	880	957	19	3	77	0.0389610
NODE_3892_length_1200_cov_16.881926	880	957	20	19	77	0.2467532
NODE_3892_length_1200_cov_16.881926	880	957	21	10	77	0.1298701
NODE_3892_length_1200_cov_16.881926	880	957	25	9	77	0.1168831
NODE_3892_length_1200_cov_16.881926	880	957	27	13	77	0.1688312
NODE_3892_length_1200_cov_16.881926	880	957	30	3	77	0.0389610
NODE_3892_length_1200_cov_16.881926	880	957	32	7	77	0.0909091
NODE_3892_length_1200_cov_16.881926	880	957	36	1	77	0.0129870
NODE_3892_length_1200_cov_16.881926	880	957	15	8	77	0.1038961
NODE_3892_length_1200_cov_16.881926	880	957	18	4	77	0.0519481
NODE_3892_length_1200_cov_16.881926	880	957	19	3	77	0.0389610
NODE_3892_length_1200_cov_16.881926	880	957	20	19	77	0.2467532
NODE_3892_length_1200_cov_16.881926	880	957	21	10	77	0.1298701
NODE_3892_length_1200_cov_16.881926	880	957	25	9	77	0.1168831
NODE_3892_length_1200_cov_16.881926	880	957	27	13	77	0.1688312
NODE_3892_length_1200_cov_16.881926	880	957	30	3	77	0.0389610
NODE_3892_length_1200_cov_16.881926	880	957	32	7	77	0.0909091
NODE_3892_length_1200_cov_16.881926	880	957	36	1	77	0.0129870
NODE_3892_length_1200_cov_16.881926	880	957	15	8	77	0.1038961
NODE_3892_length_1200_cov_16.881926	880	957	18	4	77	0.0519481
NODE_3892_length_1200_cov_16.881926	880	957	19	3	77	0.0389610
NODE_3892_length_1200_cov_16.881926	880	957	20	19	77	0.2467532
NODE_3892_length_1200_cov_16.881926	880	957	21	10	77	0.1298701
NODE_3892_length_1200_cov_16.881926	880	957	25	9	77	0.1168831
NODE_3892_length_1200_cov_16.881926	880	957	27	13	77	0.1688312
NODE_3892_length_1200_cov_16.881926	880	957	30	3	77	0.0389610
NODE_3892_length_1200_cov_16.881926	880	957	32	7	77	0.0909091
NODE_3892_length_1200_cov_16.881926	880	957	36	1	77	0.0129870
NODE_3893_length_1200_cov_15.374205	605	685	8	37	80	0.4625000
NODE_3893_length_1200_cov_15.374205	605	685	12	3	80	0.0375000
NODE_3893_length_1200_cov_15.374205	605	685	14	21	80	0.2625000
NODE_3893_length_1200_cov_15.374205	605	685	16	19	80	0.2375000
NODE_3893_length_1200_cov_15.374205	658	738	8	47	80	0.5875000
NODE_3893_length_1200_cov_15.374205	658	738	10	1	80	0.0125000
NODE_3893_length_1200_cov_15.374205	658	738	12	8	80	0.1000000
NODE_3893_length_1200_cov_15.374205	658	738	14	9	80	0.1125000
NODE_3893_length_1200_cov_15.374205	658	738	16	15	80	0.1875000
NODE_3894_length_1200_cov_12.953678	486	550	12	8	64	0.1250000
NODE_3894_length_1200_cov_12.953678	486	550	18	4	64	0.0625000
NODE_3894_length_1200_cov_12.953678	486	550	20	4	64	0.0625000
NODE_3894_length_1200_cov_12.953678	486	550	22	8	64	0.1250000
NODE_3894_length_1200_cov_12.953678	486	550	24	3	64	0.0468750
NODE_3894_length_1200_cov_12.953678	486	550	26	37	64	0.5781250
NODE_3899_length_1199_cov_14.843636	222	302	0	18	80	0.2250000
NODE_3899_length_1199_cov_14.843636	222	302	2	49	80	0.6125000
NODE_3899_length_1199_cov_14.843636	222	302	4	13	80	0.1625000
NODE_3899_length_1199_cov_14.843636	275	355	0	5	80	0.0625000
NODE_3899_length_1199_cov_14.843636	275	355	2	9	80	0.1125000
NODE_3899_length_1199_cov_14.843636	275	355	4	15	80	0.1875000
NODE_3899_length_1199_cov_14.843636	275	355	6	23	80	0.2875000
NODE_3899_length_1199_cov_14.843636	275	355	8	28	80	0.3500000
NODE_3900_length_1199_cov_12.005455	383	463	0	80	80	1.0000000
NODE_3900_length_1199_cov_12.005455	436	516	0	80	80	1.0000000
NODE_3900_length_1199_cov_12.005455	512	592	0	80	80	1.0000000
NODE_3900_length_1199_cov_12.005455	565	645	0	77	80	0.9625000
NODE_3900_length_1199_cov_12.005455	565	645	2	3	80	0.0375000
NODE_3902_length_1198_cov_36.830755	619	699	2	4	80	0.0500000
NODE_3902_length_1198_cov_36.830755	619	699	4	68	80	0.8500000
NODE_3902_length_1198_cov_36.830755	619	699	6	8	80	0.1000000
NODE_3902_length_1198_cov_36.830755	672	752	2	8	80	0.1000000
NODE_3902_length_1198_cov_36.830755	672	752	4	54	80	0.6750000
NODE_3902_length_1198_cov_36.830755	672	752	6	18	80	0.2250000
NODE_3903_length_1198_cov_22.864422	719	799	0	20	80	0.2500000
NODE_3903_length_1198_cov_22.864422	719	799	2	29	80	0.3625000
NODE_3903_length_1198_cov_22.864422	719	799	8	24	80	0.3000000
NODE_3903_length_1198_cov_22.864422	719	799	14	7	80	0.0875000
NODE_3903_length_1198_cov_22.864422	772	852	8	20	80	0.2500000
NODE_3903_length_1198_cov_22.864422	772	852	14	60	80	0.7500000
NODE_3904_length_1198_cov_17.619654	260	340	4	36	80	0.4500000
NODE_3904_length_1198_cov_17.619654	260	340	6	6	80	0.0750000
NODE_3904_length_1198_cov_17.619654	260	340	8	38	80	0.4750000
NODE_3904_length_1198_cov_17.619654	313	392	2	13	79	0.1645570
NODE_3904_length_1198_cov_17.619654	313	392	6	45	79	0.5696203
NODE_3904_length_1198_cov_17.619654	313	392	8	21	79	0.2658228
NODE_3905_length_1198_cov_10.148317	718	798	0	3	80	0.0375000
NODE_3905_length_1198_cov_10.148317	718	798	2	26	80	0.3250000
NODE_3905_length_1198_cov_10.148317	718	798	8	51	80	0.6375000
NODE_3905_length_1198_cov_10.148317	771	851	8	80	80	1.0000000
NODE_3906_length_1198_cov_6.733394	549	629	0	80	80	1.0000000
NODE_3906_length_1198_cov_6.733394	602	682	0	80	80	1.0000000
NODE_3912_length_1197_cov_27.653005	417	497	0	80	80	1.0000000
NODE_3912_length_1197_cov_27.653005	470	550	0	80	80	1.0000000
NODE_3912_length_1197_cov_27.653005	546	626	0	80	80	1.0000000
NODE_3912_length_1197_cov_27.653005	599	679	0	60	80	0.7500000
NODE_3912_length_1197_cov_27.653005	599	679	2	20	80	0.2500000
NODE_3913_length_1197_cov_14.653916	490	570	2	52	80	0.6500000
NODE_3913_length_1197_cov_14.653916	490	570	4	28	80	0.3500000
NODE_3913_length_1197_cov_14.653916	543	623	0	8	80	0.1000000
NODE_3913_length_1197_cov_14.653916	543	623	2	64	80	0.8000000
NODE_3913_length_1197_cov_14.653916	543	623	4	8	80	0.1000000
NODE_3921_length_1196_cov_26.169553	298	378	0	80	80	1.0000000
NODE_3921_length_1196_cov_26.169553	351	431	0	80	80	1.0000000
NODE_3921_length_1196_cov_26.169553	427	507	0	80	80	1.0000000
NODE_3921_length_1196_cov_26.169553	480	560	0	80	80	1.0000000
NODE_3922_length_1196_cov_21.755697	521	601	0	80	80	1.0000000
NODE_3922_length_1196_cov_21.755697	574	654	0	80	80	1.0000000
NODE_3922_length_1196_cov_21.755697	650	730	0	8	80	0.1000000
NODE_3922_length_1196_cov_21.755697	650	730	2	16	80	0.2000000
NODE_3922_length_1196_cov_21.755697	650	730	6	56	80	0.7000000
NODE_3922_length_1196_cov_21.755697	703	783	4	49	80	0.6125000
NODE_3922_length_1196_cov_21.755697	703	783	6	31	80	0.3875000
NODE_3923_length_1196_cov_5.966272	556	636	0	80	80	1.0000000
NODE_3923_length_1196_cov_5.966272	609	689	0	80	80	1.0000000
NODE_3927_length_1195_cov_69.056569	474	554	0	52	80	0.6500000
NODE_3927_length_1195_cov_69.056569	474	554	2	28	80	0.3500000
NODE_3927_length_1195_cov_69.056569	527	607	2	80	80	1.0000000
NODE_3927_length_1195_cov_69.056569	603	683	0	9	80	0.1125000
NODE_3927_length_1195_cov_69.056569	603	683	2	25	80	0.3125000
NODE_3927_length_1195_cov_69.056569	603	683	4	46	80	0.5750000
NODE_3927_length_1195_cov_69.056569	656	736	4	80	80	1.0000000
NODE_3928_length_1195_cov_65.062044	579	659	0	6	80	0.0750000
NODE_3928_length_1195_cov_65.062044	579	659	2	74	80	0.9250000
NODE_3928_length_1195_cov_65.062044	632	712	0	28	80	0.3500000
NODE_3928_length_1195_cov_65.062044	632	712	2	21	80	0.2625000
NODE_3928_length_1195_cov_65.062044	632	712	4	31	80	0.3875000
NODE_3928_length_1195_cov_65.062044	708	788	4	10	80	0.1250000
NODE_3928_length_1195_cov_65.062044	708	788	6	70	80	0.8750000
NODE_3928_length_1195_cov_65.062044	761	841	0	44	80	0.5500000
NODE_3928_length_1195_cov_65.062044	761	841	2	4	80	0.0500000
NODE_3928_length_1195_cov_65.062044	761	841	6	32	80	0.4000000
NODE_3929_length_1195_cov_23.187044	460	540	0	80	80	1.0000000
NODE_3929_length_1195_cov_23.187044	513	593	0	80	80	1.0000000
NODE_3930_length_1195_cov_18.983577	521	601	0	72	80	0.9000000
NODE_3930_length_1195_cov_18.983577	521	601	2	8	80	0.1000000
NODE_3930_length_1195_cov_18.983577	574	654	0	80	80	1.0000000
NODE_3931_length_1195_cov_14.119526	726	806	0	80	80	1.0000000
NODE_3931_length_1195_cov_14.119526	779	859	0	80	80	1.0000000
NODE_3931_length_1195_cov_14.119526	855	935	0	80	80	1.0000000
NODE_3931_length_1195_cov_14.119526	908	988	0	80	80	1.0000000
NODE_3932_length_1195_cov_13.805657	759	839	0	23	80	0.2875000
NODE_3932_length_1195_cov_13.805657	759	839	2	57	80	0.7125000
NODE_3932_length_1195_cov_13.805657	812	892	0	76	80	0.9500000
NODE_3932_length_1195_cov_13.805657	812	892	2	4	80	0.0500000
NODE_3938_length_1195_cov_1.969891	912	992	2	31	80	0.3875000
NODE_3938_length_1195_cov_1.969891	912	992	5	1	80	0.0125000
NODE_3938_length_1195_cov_1.969891	912	992	6	48	80	0.6000000
NODE_3938_length_1195_cov_1.969891	912	992	2	31	80	0.3875000
NODE_3938_length_1195_cov_1.969891	912	992	5	1	80	0.0125000
NODE_3938_length_1195_cov_1.969891	912	992	6	48	80	0.6000000
NODE_3941_length_1194_cov_40.157991	237	317	0	80	80	1.0000000
NODE_3941_length_1194_cov_40.157991	290	370	0	80	80	1.0000000
NODE_3946_length_1193_cov_34.295247	443	523	0	65	80	0.8125000
NODE_3946_length_1193_cov_34.295247	443	523	2	9	80	0.1125000
NODE_3946_length_1193_cov_34.295247	443	523	4	6	80	0.0750000
NODE_3946_length_1193_cov_34.295247	496	576	0	12	80	0.1500000
NODE_3946_length_1193_cov_34.295247	496	576	2	9	80	0.1125000
NODE_3946_length_1193_cov_34.295247	496	576	4	59	80	0.7375000
NODE_3947_length_1193_cov_16.930530	124	154	6	3	30	0.1000000
NODE_3947_length_1193_cov_16.930530	124	154	10	27	30	0.9000000
NODE_3947_length_1193_cov_16.930530	390	470	15	8	80	0.1000000
NODE_3947_length_1193_cov_16.930530	390	470	27	1	80	0.0125000
NODE_3947_length_1193_cov_16.930530	390	470	29	4	80	0.0500000
NODE_3947_length_1193_cov_16.930530	390	470	30	2	80	0.0250000
NODE_3947_length_1193_cov_16.930530	390	470	32	18	80	0.2250000
NODE_3947_length_1193_cov_16.930530	390	470	34	24	80	0.3000000
NODE_3947_length_1193_cov_16.930530	390	470	36	23	80	0.2875000
NODE_3947_length_1193_cov_16.930530	443	523	0	39	80	0.4875000
NODE_3947_length_1193_cov_16.930530	443	523	2	2	80	0.0250000
NODE_3947_length_1193_cov_16.930530	443	523	6	4	80	0.0500000
NODE_3947_length_1193_cov_16.930530	443	523	13	5	80	0.0625000
NODE_3947_length_1193_cov_16.930530	443	523	15	11	80	0.1375000
NODE_3947_length_1193_cov_16.930530	443	523	27	1	80	0.0125000
NODE_3947_length_1193_cov_16.930530	443	523	29	4	80	0.0500000
NODE_3947_length_1193_cov_16.930530	443	523	30	2	80	0.0250000
NODE_3947_length_1193_cov_16.930530	443	523	32	7	80	0.0875000
NODE_3947_length_1193_cov_16.930530	443	523	34	5	80	0.0625000
NODE_3949_length_1192_cov_26.803294	205	285	0	2	80	0.0250000
NODE_3949_length_1192_cov_26.803294	205	285	2	78	80	0.9750000
NODE_3949_length_1192_cov_26.803294	258	338	0	55	80	0.6875000
NODE_3949_length_1192_cov_26.803294	258	338	2	25	80	0.3125000
NODE_3949_length_1192_cov_26.803294	334	414	0	39	80	0.4875000
NODE_3949_length_1192_cov_26.803294	334	414	2	41	80	0.5125000
NODE_3949_length_1192_cov_26.803294	387	467	0	15	80	0.1875000
NODE_3949_length_1192_cov_26.803294	387	467	2	65	80	0.8125000
NODE_3950_length_1192_cov_23.228728	487	567	2	32	80	0.4000000
NODE_3950_length_1192_cov_23.228728	487	567	4	48	80	0.6000000
NODE_3950_length_1192_cov_23.228728	540	620	0	10	80	0.1250000
NODE_3950_length_1192_cov_23.228728	540	620	2	29	80	0.3625000
NODE_3950_length_1192_cov_23.228728	540	620	4	41	80	0.5125000
NODE_3950_length_1192_cov_23.228728	616	696	0	80	80	1.0000000
NODE_3950_length_1192_cov_23.228728	669	749	0	80	80	1.0000000
NODE_3951_length_1192_cov_18.314730	613	693	0	80	80	1.0000000
NODE_3951_length_1192_cov_18.314730	666	746	0	80	80	1.0000000
NODE_3951_length_1192_cov_18.314730	742	822	0	80	80	1.0000000
NODE_3951_length_1192_cov_18.314730	795	875	0	80	80	1.0000000
NODE_3952_length_1192_cov_14.888381	622	702	0	3	80	0.0375000
NODE_3952_length_1192_cov_14.888381	622	702	2	77	80	0.9625000
NODE_3952_length_1192_cov_14.888381	675	755	0	18	80	0.2250000
NODE_3952_length_1192_cov_14.888381	675	755	2	62	80	0.7750000
NODE_3952_length_1192_cov_14.888381	751	831	0	57	80	0.7125000
NODE_3952_length_1192_cov_14.888381	751	831	2	23	80	0.2875000
NODE_3952_length_1192_cov_14.888381	804	884	0	80	80	1.0000000
NODE_3953_length_1192_cov_9.995425	161	241	0	80	80	1.0000000
NODE_3953_length_1192_cov_9.995425	214	294	0	80	80	1.0000000
NODE_3954_length_1192_cov_5.078683	749	829	0	3	80	0.0375000
NODE_3954_length_1192_cov_5.078683	749	829	2	77	80	0.9625000
NODE_3954_length_1192_cov_5.078683	802	882	0	26	80	0.3250000
NODE_3954_length_1192_cov_5.078683	802	882	2	54	80	0.6750000
NODE_3960_length_1192_cov_0.614822	1046	1126	0	23	80	0.2875000
NODE_3960_length_1192_cov_0.614822	1046	1126	2	3	80	0.0375000
NODE_3960_length_1192_cov_0.614822	1046	1126	4	54	80	0.6750000
NODE_3961_length_1191_cov_55.466117	392	472	0	10	80	0.1250000
NODE_3961_length_1191_cov_55.466117	392	472	2	70	80	0.8750000
NODE_3961_length_1191_cov_55.466117	445	525	0	63	80	0.7875000
NODE_3961_length_1191_cov_55.466117	445	525	2	17	80	0.2125000
NODE_3961_length_1191_cov_55.466117	521	601	0	80	80	1.0000000
NODE_3961_length_1191_cov_55.466117	574	654	0	80	80	1.0000000
NODE_3963_length_1191_cov_20.677656	695	775	0	7	80	0.0875000
NODE_3963_length_1191_cov_20.677656	695	775	2	73	80	0.9125000
NODE_3963_length_1191_cov_20.677656	748	828	0	60	80	0.7500000
NODE_3963_length_1191_cov_20.677656	748	828	2	20	80	0.2500000
NODE_3964_length_1191_cov_9.074176	420	500	2	17	80	0.2125000
NODE_3964_length_1191_cov_9.074176	420	500	4	63	80	0.7875000
NODE_3964_length_1191_cov_9.074176	473	553	0	35	80	0.4375000
NODE_3964_length_1191_cov_9.074176	473	553	2	31	80	0.3875000
NODE_3964_length_1191_cov_9.074176	473	553	4	14	80	0.1750000
NODE_3968_length_1190_cov_40.916590	521	601	4	16	80	0.2000000
NODE_3968_length_1190_cov_40.916590	521	601	6	8	80	0.1000000
NODE_3968_length_1190_cov_40.916590	521	601	7	12	80	0.1500000
NODE_3968_length_1190_cov_40.916590	521	601	8	44	80	0.5500000
NODE_3968_length_1190_cov_40.916590	574	654	2	21	80	0.2625000
NODE_3968_length_1190_cov_40.916590	574	654	4	9	80	0.1125000
NODE_3968_length_1190_cov_40.916590	574	654	8	50	80	0.6250000
NODE_3968_length_1190_cov_40.916590	650	730	0	23	80	0.2875000
NODE_3968_length_1190_cov_40.916590	650	730	1	12	80	0.1500000
NODE_3968_length_1190_cov_40.916590	650	730	2	45	80	0.5625000
NODE_3968_length_1190_cov_40.916590	703	783	0	76	80	0.9500000
NODE_3968_length_1190_cov_40.916590	703	783	1	4	80	0.0500000
NODE_3969_length_1190_cov_20.715857	257	337	0	63	80	0.7875000
NODE_3969_length_1190_cov_20.715857	257	337	1	1	80	0.0125000
NODE_3969_length_1190_cov_20.715857	257	337	2	16	80	0.2000000
NODE_3969_length_1190_cov_20.715857	310	390	0	10	80	0.1250000
NODE_3969_length_1190_cov_20.715857	310	390	1	1	80	0.0125000
NODE_3969_length_1190_cov_20.715857	310	390	2	69	80	0.8625000
NODE_3970_length_1190_cov_19.724106	296	376	0	13	80	0.1625000
NODE_3970_length_1190_cov_19.724106	296	376	2	5	80	0.0625000
NODE_3970_length_1190_cov_19.724106	296	376	4	62	80	0.7750000
NODE_3970_length_1190_cov_19.724106	349	429	4	80	80	1.0000000
NODE_3973_length_1190_cov_2.698442	1022	1070	5	21	48	0.4375000
NODE_3973_length_1190_cov_2.698442	1022	1070	6	6	48	0.1250000
NODE_3973_length_1190_cov_2.698442	1022	1070	8	1	48	0.0208333
NODE_3973_length_1190_cov_2.698442	1022	1070	12	1	48	0.0208333
NODE_3973_length_1190_cov_2.698442	1022	1070	14	1	48	0.0208333
NODE_3973_length_1190_cov_2.698442	1022	1070	16	8	48	0.1666667
NODE_3973_length_1190_cov_2.698442	1022	1070	18	10	48	0.2083333
NODE_3973_length_1190_cov_2.698442	1075	1123	16	9	48	0.1875000
NODE_3973_length_1190_cov_2.698442	1075	1123	18	24	48	0.5000000
NODE_3973_length_1190_cov_2.698442	1075	1123	20	15	48	0.3125000
NODE_3977_length_1189_cov_29.193578	576	656	0	57	80	0.7125000
NODE_3977_length_1189_cov_29.193578	576	656	2	23	80	0.2875000
NODE_3977_length_1189_cov_29.193578	629	709	0	4	80	0.0500000
NODE_3977_length_1189_cov_29.193578	629	709	2	76	80	0.9500000
NODE_3978_length_1189_cov_13.484404	315	341	0	26	26	1.0000000
NODE_3978_length_1189_cov_13.484404	366	446	0	80	80	1.0000000
NODE_3984_length_1188_cov_19.278237	396	476	0	80	80	1.0000000
NODE_3984_length_1188_cov_19.278237	449	529	0	34	80	0.4250000
NODE_3984_length_1188_cov_19.278237	449	529	4	12	80	0.1500000
NODE_3984_length_1188_cov_19.278237	449	529	6	19	80	0.2375000
NODE_3984_length_1188_cov_19.278237	449	529	8	15	80	0.1875000
NODE_3990_length_1187_cov_63.185662	529	609	0	52	80	0.6500000
NODE_3990_length_1187_cov_63.185662	529	609	4	28	80	0.3500000
NODE_3990_length_1187_cov_63.185662	582	662	4	39	80	0.4875000
NODE_3990_length_1187_cov_63.185662	582	662	6	41	80	0.5125000
NODE_3990_length_1187_cov_63.185662	658	738	2	21	80	0.2625000
NODE_3990_length_1187_cov_63.185662	658	738	4	59	80	0.7375000
NODE_3990_length_1187_cov_63.185662	711	791	2	31	80	0.3875000
NODE_3990_length_1187_cov_63.185662	711	791	4	49	80	0.6125000
NODE_3991_length_1187_cov_36.926471	432	512	0	80	80	1.0000000
NODE_3991_length_1187_cov_36.926471	485	565	0	80	80	1.0000000
NODE_3991_length_1187_cov_36.926471	561	641	0	80	80	1.0000000
NODE_3991_length_1187_cov_36.926471	614	694	0	80	80	1.0000000
NODE_3992_length_1187_cov_20.383272	492	572	2	7	80	0.0875000
NODE_3992_length_1187_cov_20.383272	492	572	3	68	80	0.8500000
NODE_3992_length_1187_cov_20.383272	492	572	4	5	80	0.0625000
NODE_3992_length_1187_cov_20.383272	545	625	2	60	80	0.7500000
NODE_3992_length_1187_cov_20.383272	545	625	3	15	80	0.1875000
NODE_3992_length_1187_cov_20.383272	545	625	4	5	80	0.0625000
NODE_3993_length_1187_cov_17.941176	377	457	0	80	80	1.0000000
NODE_3993_length_1187_cov_17.941176	430	510	0	40	80	0.5000000
NODE_3993_length_1187_cov_17.941176	430	510	2	40	80	0.5000000
NODE_3993_length_1187_cov_17.941176	506	586	2	49	80	0.6125000
NODE_3993_length_1187_cov_17.941176	506	586	4	31	80	0.3875000
NODE_3993_length_1187_cov_17.941176	559	639	2	50	80	0.6250000
NODE_3993_length_1187_cov_17.941176	559	639	4	30	80	0.3750000
NODE_3997_length_1186_cov_59.606256	338	418	0	80	80	1.0000000
NODE_3997_length_1186_cov_59.606256	391	471	0	80	80	1.0000000
NODE_3997_length_1186_cov_59.606256	480	551	0	11	71	0.1549296
NODE_3997_length_1186_cov_59.606256	480	551	2	60	71	0.8450704
NODE_3997_length_1186_cov_59.606256	524	604	0	36	80	0.4500000
NODE_3997_length_1186_cov_59.606256	524	604	2	44	80	0.5500000
NODE_3998_length_1186_cov_34.937443	582	662	0	50	80	0.6250000
NODE_3998_length_1186_cov_34.937443	582	662	2	30	80	0.3750000
NODE_3998_length_1186_cov_34.937443	635	715	2	80	80	1.0000000
NODE_3998_length_1186_cov_34.937443	711	791	0	28	80	0.3500000
NODE_3998_length_1186_cov_34.937443	711	791	2	52	80	0.6500000
NODE_3998_length_1186_cov_34.937443	764	844	2	80	80	1.0000000
NODE_3999_length_1186_cov_29.840846	511	591	2	7	80	0.0875000
NODE_3999_length_1186_cov_29.840846	511	591	4	47	80	0.5875000
NODE_3999_length_1186_cov_29.840846	511	591	6	26	80	0.3250000
NODE_3999_length_1186_cov_29.840846	564	644	0	41	80	0.5125000
NODE_3999_length_1186_cov_29.840846	564	644	2	19	80	0.2375000
NODE_3999_length_1186_cov_29.840846	564	644	4	20	80	0.2500000
NODE_3999_length_1186_cov_29.840846	640	720	0	80	80	1.0000000
NODE_3999_length_1186_cov_29.840846	693	773	0	80	80	1.0000000
NODE_4000_length_1186_cov_13.108556	578	658	0	46	80	0.5750000
NODE_4000_length_1186_cov_13.108556	578	658	4	34	80	0.4250000
NODE_4000_length_1186_cov_13.108556	631	711	4	58	80	0.7250000
NODE_4000_length_1186_cov_13.108556	631	711	6	22	80	0.2750000
NODE_4001_length_1186_cov_12.867525	404	484	0	18	80	0.2250000
NODE_4001_length_1186_cov_12.867525	404	484	3	17	80	0.2125000
NODE_4001_length_1186_cov_12.867525	404	484	6	5	80	0.0625000
NODE_4001_length_1186_cov_12.867525	404	484	8	40	80	0.5000000
NODE_4001_length_1186_cov_12.867525	457	534	6	5	77	0.0649351
NODE_4001_length_1186_cov_12.867525	457	534	8	72	77	0.9350649
NODE_4001_length_1186_cov_12.867525	536	613	0	24	77	0.3116883
NODE_4001_length_1186_cov_12.867525	536	613	3	17	77	0.2207792
NODE_4001_length_1186_cov_12.867525	536	613	5	35	77	0.4545455
NODE_4001_length_1186_cov_12.867525	536	613	6	1	77	0.0129870
NODE_4001_length_1186_cov_12.867525	586	666	0	42	80	0.5250000
NODE_4001_length_1186_cov_12.867525	586	666	2	35	80	0.4375000
NODE_4001_length_1186_cov_12.867525	586	666	3	3	80	0.0375000
NODE_4002_length_1186_cov_12.135235	643	723	0	80	80	1.0000000
NODE_4002_length_1186_cov_12.135235	696	776	0	71	80	0.8875000
NODE_4002_length_1186_cov_12.135235	696	776	2	9	80	0.1125000
NODE_4012_length_1185_cov_36.974217	423	503	0	31	80	0.3875000
NODE_4012_length_1185_cov_36.974217	423	503	8	2	80	0.0250000
NODE_4012_length_1185_cov_36.974217	423	503	10	47	80	0.5875000
NODE_4012_length_1185_cov_36.974217	476	556	0	80	80	1.0000000
NODE_4013_length_1185_cov_28.410681	448	528	0	44	80	0.5500000
NODE_4013_length_1185_cov_28.410681	448	528	3	36	80	0.4500000
NODE_4013_length_1185_cov_28.410681	501	581	0	80	80	1.0000000
NODE_4014_length_1185_cov_19.768877	411	491	0	80	80	1.0000000
NODE_4014_length_1185_cov_19.768877	464	544	0	80	80	1.0000000
NODE_4014_length_1185_cov_19.768877	540	620	0	12	80	0.1500000
NODE_4014_length_1185_cov_19.768877	540	620	2	68	80	0.8500000
NODE_4014_length_1185_cov_19.768877	593	673	2	80	80	1.0000000
NODE_4015_length_1185_cov_14.490792	379	459	7	11	80	0.1375000
NODE_4015_length_1185_cov_14.490792	379	459	9	48	80	0.6000000
NODE_4015_length_1185_cov_14.490792	379	459	10	21	80	0.2625000
NODE_4015_length_1185_cov_14.490792	432	512	0	19	80	0.2375000
NODE_4015_length_1185_cov_14.490792	432	512	2	1	80	0.0125000
NODE_4015_length_1185_cov_14.490792	432	512	5	1	80	0.0125000
NODE_4015_length_1185_cov_14.490792	432	512	8	1	80	0.0125000
NODE_4015_length_1185_cov_14.490792	432	512	9	58	80	0.7250000
NODE_4016_length_1185_cov_13.686004	677	757	0	25	80	0.3125000
NODE_4016_length_1185_cov_13.686004	677	757	2	22	80	0.2750000
NODE_4016_length_1185_cov_13.686004	677	757	4	33	80	0.4125000
NODE_4016_length_1185_cov_13.686004	730	810	2	30	80	0.3750000
NODE_4016_length_1185_cov_13.686004	730	810	4	50	80	0.6250000
NODE_4017_length_1185_cov_12.362799	711	791	2	10	80	0.1250000
NODE_4017_length_1185_cov_12.362799	711	791	4	70	80	0.8750000
NODE_4017_length_1185_cov_12.362799	764	844	0	19	80	0.2375000
NODE_4017_length_1185_cov_12.362799	764	844	2	22	80	0.2750000
NODE_4017_length_1185_cov_12.362799	764	844	4	39	80	0.4875000
NODE_4024_length_1184_cov_30.061751	416	497	0	74	81	0.9135802
NODE_4024_length_1184_cov_30.061751	416	497	4	7	81	0.0864198
NODE_4024_length_1184_cov_30.061751	470	550	0	20	80	0.2500000
NODE_4024_length_1184_cov_30.061751	470	550	4	22	80	0.2750000
NODE_4024_length_1184_cov_30.061751	470	550	5	38	80	0.4750000
NODE_4024_length_1184_cov_30.061751	546	627	4	2	81	0.0246914
NODE_4024_length_1184_cov_30.061751	546	627	5	79	81	0.9753087
NODE_4024_length_1184_cov_30.061751	600	680	0	50	80	0.6250000
NODE_4024_length_1184_cov_30.061751	600	680	4	5	80	0.0625000
NODE_4024_length_1184_cov_30.061751	600	680	5	25	80	0.3125000
NODE_4025_length_1184_cov_19.544700	550	630	0	67	80	0.8375000
NODE_4025_length_1184_cov_19.544700	550	630	2	13	80	0.1625000
NODE_4025_length_1184_cov_19.544700	603	683	0	14	80	0.1750000
NODE_4025_length_1184_cov_19.544700	603	683	2	66	80	0.8250000
NODE_4025_length_1184_cov_19.544700	679	759	0	70	80	0.8750000
NODE_4025_length_1184_cov_19.544700	679	759	2	10	80	0.1250000
NODE_4025_length_1184_cov_19.544700	732	812	0	52	80	0.6500000
NODE_4025_length_1184_cov_19.544700	732	812	2	28	80	0.3500000
NODE_4026_length_1184_cov_9.129954	624	704	0	13	80	0.1625000
NODE_4026_length_1184_cov_9.129954	624	704	2	27	80	0.3375000
NODE_4026_length_1184_cov_9.129954	624	704	4	40	80	0.5000000
NODE_4026_length_1184_cov_9.129954	677	757	4	80	80	1.0000000
NODE_4031_length_1183_cov_17.260148	545	625	0	80	80	1.0000000
NODE_4031_length_1183_cov_17.260148	598	678	0	80	80	1.0000000
NODE_4031_length_1183_cov_17.260148	674	754	0	45	80	0.5625000
NODE_4031_length_1183_cov_17.260148	674	754	6	35	80	0.4375000
NODE_4031_length_1183_cov_17.260148	727	807	6	80	80	1.0000000
NODE_4032_length_1183_cov_9.777675	484	564	2	16	80	0.2000000
NODE_4032_length_1183_cov_9.777675	484	564	6	64	80	0.8000000
NODE_4032_length_1183_cov_9.777675	537	617	0	25	80	0.3125000
NODE_4032_length_1183_cov_9.777675	537	617	4	12	80	0.1500000
NODE_4032_length_1183_cov_9.777675	537	617	6	43	80	0.5375000
NODE_4033_length_1183_cov_6.847786	711	791	2	31	80	0.3875000
NODE_4033_length_1183_cov_6.847786	711	791	4	49	80	0.6125000
NODE_4033_length_1183_cov_6.847786	764	844	0	27	80	0.3375000
NODE_4033_length_1183_cov_6.847786	764	844	2	42	80	0.5250000
NODE_4033_length_1183_cov_6.847786	764	844	4	11	80	0.1375000
NODE_4033_length_1183_cov_6.847786	840	920	0	80	80	1.0000000
NODE_4033_length_1183_cov_6.847786	893	973	0	80	80	1.0000000
NODE_4035_length_1183_cov_2.680812	59	139	6	12	80	0.1500000
NODE_4035_length_1183_cov_2.680812	59	139	8	2	80	0.0250000
NODE_4035_length_1183_cov_2.680812	59	139	10	1	80	0.0125000
NODE_4035_length_1183_cov_2.680812	59	139	12	3	80	0.0375000
NODE_4035_length_1183_cov_2.680812	59	139	14	1	80	0.0125000
NODE_4035_length_1183_cov_2.680812	59	139	16	9	80	0.1125000
NODE_4035_length_1183_cov_2.680812	59	139	18	52	80	0.6500000
NODE_4040_length_1182_cov_64.600185	588	668	6	25	80	0.3125000
NODE_4040_length_1182_cov_64.600185	588	668	7	3	80	0.0375000
NODE_4040_length_1182_cov_64.600185	588	668	8	44	80	0.5500000
NODE_4040_length_1182_cov_64.600185	588	668	10	8	80	0.1000000
NODE_4040_length_1182_cov_64.600185	641	721	4	8	80	0.1000000
NODE_4040_length_1182_cov_64.600185	641	721	6	31	80	0.3875000
NODE_4040_length_1182_cov_64.600185	641	721	8	33	80	0.4125000
NODE_4040_length_1182_cov_64.600185	641	721	10	8	80	0.1000000
NODE_4040_length_1182_cov_64.600185	717	797	0	26	80	0.3250000
NODE_4040_length_1182_cov_64.600185	717	797	2	2	80	0.0250000
NODE_4040_length_1182_cov_64.600185	717	797	4	6	80	0.0750000
NODE_4040_length_1182_cov_64.600185	717	797	8	46	80	0.5750000
NODE_4040_length_1182_cov_64.600185	770	849	6	15	79	0.1898734
NODE_4040_length_1182_cov_64.600185	770	849	8	64	79	0.8101266
NODE_4041_length_1182_cov_18.584488	487	557	2	2	70	0.0285714
NODE_4041_length_1182_cov_18.584488	487	557	4	32	70	0.4571429
NODE_4041_length_1182_cov_18.584488	487	557	6	36	70	0.5142857
NODE_4041_length_1182_cov_18.584488	536	612	2	13	76	0.1710526
NODE_4041_length_1182_cov_18.584488	536	612	4	33	76	0.4342105
NODE_4041_length_1182_cov_18.584488	536	612	6	30	76	0.3947369
NODE_4041_length_1182_cov_18.584488	608	688	0	10	80	0.1250000
NODE_4041_length_1182_cov_18.584488	608	688	2	54	80	0.6750000
NODE_4041_length_1182_cov_18.584488	608	688	4	10	80	0.1250000
NODE_4041_length_1182_cov_18.584488	608	688	6	6	80	0.0750000
NODE_4041_length_1182_cov_18.584488	671	741	2	1	70	0.0142857
NODE_4041_length_1182_cov_18.584488	671	741	4	22	70	0.3142857
NODE_4041_length_1182_cov_18.584488	671	741	6	47	70	0.6714286
NODE_4042_length_1182_cov_18.075716	598	678	0	80	80	1.0000000
NODE_4042_length_1182_cov_18.075716	651	731	0	33	80	0.4125000
NODE_4042_length_1182_cov_18.075716	651	731	2	47	80	0.5875000
NODE_4042_length_1182_cov_18.075716	727	807	2	44	80	0.5500000
NODE_4042_length_1182_cov_18.075716	727	807	4	36	80	0.4500000
NODE_4042_length_1182_cov_18.075716	780	860	0	45	80	0.5625000
NODE_4042_length_1182_cov_18.075716	780	860	2	35	80	0.4375000
NODE_4043_length_1182_cov_8.716528	464	544	0	80	80	1.0000000
NODE_4043_length_1182_cov_8.716528	517	597	0	80	80	1.0000000
NODE_4044_length_1182_cov_4.109880	793	873	0	80	80	1.0000000
NODE_4044_length_1182_cov_4.109880	846	926	0	80	80	1.0000000
NODE_4045_length_1182_cov_3.433980	1052	1100	0	25	48	0.5208333
NODE_4045_length_1182_cov_3.433980	1052	1100	2	1	48	0.0208333
NODE_4045_length_1182_cov_3.433980	1052	1100	3	22	48	0.4583333
NODE_4050_length_1181_cov_13.856747	687	767	0	16	80	0.2000000
NODE_4050_length_1181_cov_13.856747	687	767	2	17	80	0.2125000
NODE_4050_length_1181_cov_13.856747	687	767	4	47	80	0.5875000
NODE_4050_length_1181_cov_13.856747	740	820	4	27	80	0.3375000
NODE_4050_length_1181_cov_13.856747	740	820	6	28	80	0.3500000
NODE_4050_length_1181_cov_13.856747	740	820	8	25	80	0.3125000
NODE_4051_length_1181_cov_8.239372	735	815	0	55	80	0.6875000
NODE_4051_length_1181_cov_8.239372	735	815	2	25	80	0.3125000
NODE_4059_length_1180_cov_46.345051	695	775	4	35	80	0.4375000
NODE_4059_length_1180_cov_46.345051	695	775	6	39	80	0.4875000
NODE_4059_length_1180_cov_46.345051	695	775	7	1	80	0.0125000
NODE_4059_length_1180_cov_46.345051	695	775	8	5	80	0.0625000
NODE_4059_length_1180_cov_46.345051	748	828	0	6	80	0.0750000
NODE_4059_length_1180_cov_46.345051	748	828	2	42	80	0.5250000
NODE_4059_length_1180_cov_46.345051	748	828	4	32	80	0.4000000
NODE_4066_length_1179_cov_93.272222	660	740	88	1	80	0.0125000
NODE_4066_length_1179_cov_93.272222	660	740	94	1	80	0.0125000
NODE_4066_length_1179_cov_93.272222	660	740	101	1	80	0.0125000
NODE_4066_length_1179_cov_93.272222	660	740	103	3	80	0.0375000
NODE_4066_length_1179_cov_93.272222	660	740	104	1	80	0.0125000
NODE_4066_length_1179_cov_93.272222	660	740	105	4	80	0.0500000
NODE_4066_length_1179_cov_93.272222	660	740	107	5	80	0.0625000
NODE_4066_length_1179_cov_93.272222	660	740	109	4	80	0.0500000
NODE_4066_length_1179_cov_93.272222	660	740	110	2	80	0.0250000
NODE_4066_length_1179_cov_93.272222	660	740	111	1	80	0.0125000
NODE_4066_length_1179_cov_93.272222	660	740	112	9	80	0.1125000
NODE_4066_length_1179_cov_93.272222	660	740	113	6	80	0.0750000
NODE_4066_length_1179_cov_93.272222	660	740	114	3	80	0.0375000
NODE_4066_length_1179_cov_93.272222	660	740	115	4	80	0.0500000
NODE_4066_length_1179_cov_93.272222	660	740	116	14	80	0.1750000
NODE_4066_length_1179_cov_93.272222	660	740	117	7	80	0.0875000
NODE_4066_length_1179_cov_93.272222	660	740	118	10	80	0.1250000
NODE_4066_length_1179_cov_93.272222	660	740	120	3	80	0.0375000
NODE_4066_length_1179_cov_93.272222	660	740	121	1	80	0.0125000
NODE_4066_length_1179_cov_93.272222	713	793	22	6	80	0.0750000
NODE_4066_length_1179_cov_93.272222	713	793	24	5	80	0.0625000
NODE_4066_length_1179_cov_93.272222	713	793	32	1	80	0.0125000
NODE_4066_length_1179_cov_93.272222	713	793	38	2	80	0.0250000
NODE_4066_length_1179_cov_93.272222	713	793	48	1	80	0.0125000
NODE_4066_length_1179_cov_93.272222	713	793	50	1	80	0.0125000
NODE_4066_length_1179_cov_93.272222	713	793	52	1	80	0.0125000
NODE_4066_length_1179_cov_93.272222	713	793	56	1	80	0.0125000
NODE_4066_length_1179_cov_93.272222	713	793	60	1	80	0.0125000
NODE_4066_length_1179_cov_93.272222	713	793	66	1	80	0.0125000
NODE_4066_length_1179_cov_93.272222	713	793	68	2	80	0.0250000
NODE_4066_length_1179_cov_93.272222	713	793	70	4	80	0.0500000
NODE_4066_length_1179_cov_93.272222	713	793	72	3	80	0.0375000
NODE_4066_length_1179_cov_93.272222	713	793	76	13	80	0.1625000
NODE_4066_length_1179_cov_93.272222	713	793	78	2	80	0.0250000
NODE_4066_length_1179_cov_93.272222	713	793	82	4	80	0.0500000
NODE_4066_length_1179_cov_93.272222	713	793	88	6	80	0.0750000
NODE_4066_length_1179_cov_93.272222	713	793	94	1	80	0.0125000
NODE_4066_length_1179_cov_93.272222	713	793	104	1	80	0.0125000
NODE_4066_length_1179_cov_93.272222	713	793	109	1	80	0.0125000
NODE_4066_length_1179_cov_93.272222	713	793	110	2	80	0.0250000
NODE_4066_length_1179_cov_93.272222	713	793	112	9	80	0.1125000
NODE_4066_length_1179_cov_93.272222	713	793	116	5	80	0.0625000
NODE_4066_length_1179_cov_93.272222	713	793	118	6	80	0.0750000
NODE_4066_length_1179_cov_93.272222	713	793	120	1	80	0.0125000
NODE_4067_length_1179_cov_55.355556	547	627	6	22	80	0.2750000
NODE_4067_length_1179_cov_55.355556	547	627	10	1	80	0.0125000
NODE_4067_length_1179_cov_55.355556	547	627	11	1	80	0.0125000
NODE_4067_length_1179_cov_55.355556	547	627	12	4	80	0.0500000
NODE_4067_length_1179_cov_55.355556	547	627	14	2	80	0.0250000
NODE_4067_length_1179_cov_55.355556	547	627	20	2	80	0.0250000
NODE_4067_length_1179_cov_55.355556	547	627	22	4	80	0.0500000
NODE_4067_length_1179_cov_55.355556	547	627	27	1	80	0.0125000
NODE_4067_length_1179_cov_55.355556	547	627	28	5	80	0.0625000
NODE_4067_length_1179_cov_55.355556	547	627	34	7	80	0.0875000
NODE_4067_length_1179_cov_55.355556	547	627	36	3	80	0.0375000
NODE_4067_length_1179_cov_55.355556	547	627	37	9	80	0.1125000
NODE_4067_length_1179_cov_55.355556	547	627	38	1	80	0.0125000
NODE_4067_length_1179_cov_55.355556	547	627	39	15	80	0.1875000
NODE_4067_length_1179_cov_55.355556	547	627	40	3	80	0.0375000
NODE_4067_length_1179_cov_55.355556	600	680	18	1	80	0.0125000
NODE_4067_length_1179_cov_55.355556	600	680	22	1	80	0.0125000
NODE_4067_length_1179_cov_55.355556	600	680	23	9	80	0.1125000
NODE_4067_length_1179_cov_55.355556	600	680	29	1	80	0.0125000
NODE_4067_length_1179_cov_55.355556	600	680	34	1	80	0.0125000
NODE_4067_length_1179_cov_55.355556	600	680	35	1	80	0.0125000
NODE_4067_length_1179_cov_55.355556	600	680	36	3	80	0.0375000
NODE_4067_length_1179_cov_55.355556	600	680	37	23	80	0.2875000
NODE_4067_length_1179_cov_55.355556	600	680	39	37	80	0.4625000
NODE_4067_length_1179_cov_55.355556	600	680	40	3	80	0.0375000
NODE_4068_length_1179_cov_29.712037	613	693	0	56	80	0.7000000
NODE_4068_length_1179_cov_29.712037	613	693	4	24	80	0.3000000
NODE_4068_length_1179_cov_29.712037	666	746	0	12	80	0.1500000
NODE_4068_length_1179_cov_29.712037	666	746	4	68	80	0.8500000
NODE_4069_length_1179_cov_26.767593	483	563	0	41	80	0.5125000
NODE_4069_length_1179_cov_26.767593	483	563	2	39	80	0.4875000
NODE_4069_length_1179_cov_26.767593	536	616	2	80	80	1.0000000
NODE_4069_length_1179_cov_26.767593	612	692	2	79	80	0.9875000
NODE_4069_length_1179_cov_26.767593	612	692	4	1	80	0.0125000
NODE_4069_length_1179_cov_26.767593	665	745	2	52	80	0.6500000
NODE_4069_length_1179_cov_26.767593	665	745	4	28	80	0.3500000
NODE_4070_length_1179_cov_22.249074	581	661	0	80	80	1.0000000
NODE_4070_length_1179_cov_22.249074	634	714	0	80	80	1.0000000
NODE_4071_length_1179_cov_16.538889	498	568	0	10	70	0.1428571
NODE_4071_length_1179_cov_16.538889	498	568	3	1	70	0.0142857
NODE_4071_length_1179_cov_16.538889	498	568	4	7	70	0.1000000
NODE_4071_length_1179_cov_16.538889	498	568	6	35	70	0.5000000
NODE_4071_length_1179_cov_16.538889	498	568	7	13	70	0.1857143
NODE_4071_length_1179_cov_16.538889	498	568	8	4	70	0.0571429
NODE_4072_length_1179_cov_15.442593	535	615	0	18	80	0.2250000
NODE_4072_length_1179_cov_15.442593	535	615	2	2	80	0.0250000
NODE_4072_length_1179_cov_15.442593	535	615	6	30	80	0.3750000
NODE_4072_length_1179_cov_15.442593	535	615	8	2	80	0.0250000
NODE_4072_length_1179_cov_15.442593	535	615	10	28	80	0.3500000
NODE_4072_length_1179_cov_15.442593	588	668	2	9	80	0.1125000
NODE_4072_length_1179_cov_15.442593	588	668	4	25	80	0.3125000
NODE_4072_length_1179_cov_15.442593	588	668	6	1	80	0.0125000
NODE_4072_length_1179_cov_15.442593	588	668	10	45	80	0.5625000
NODE_4076_length_1179_cov_2.419444	1108	1155	0	47	47	1.0000000
NODE_4078_length_1179_cov_1.009259	944	1024	0	80	80	1.0000000
NODE_4078_length_1179_cov_1.009259	997	1077	0	80	80	1.0000000
NODE_4079_length_1178_cov_42.484708	423	503	0	80	80	1.0000000
NODE_4079_length_1178_cov_42.484708	476	556	0	78	80	0.9750000
NODE_4079_length_1178_cov_42.484708	476	556	4	2	80	0.0250000
NODE_4079_length_1178_cov_42.484708	552	632	0	2	80	0.0250000
NODE_4079_length_1178_cov_42.484708	552	632	4	65	80	0.8125000
NODE_4079_length_1178_cov_42.484708	552	632	6	13	80	0.1625000
NODE_4079_length_1178_cov_42.484708	605	685	2	39	80	0.4875000
NODE_4079_length_1178_cov_42.484708	605	685	4	14	80	0.1750000
NODE_4079_length_1178_cov_42.484708	605	685	6	27	80	0.3375000
NODE_4080_length_1178_cov_15.332715	215	295	0	80	80	1.0000000
NODE_4080_length_1178_cov_15.332715	268	348	0	80	80	1.0000000
NODE_4081_length_1178_cov_11.403151	527	607	0	80	80	1.0000000
NODE_4081_length_1178_cov_11.403151	580	660	0	35	80	0.4375000
NODE_4081_length_1178_cov_11.403151	580	660	4	45	80	0.5625000
NODE_4084_length_1177_cov_34.920223	369	449	0	80	80	1.0000000
NODE_4084_length_1177_cov_34.920223	422	502	0	80	80	1.0000000
NODE_4084_length_1177_cov_34.920223	498	578	0	20	80	0.2500000
NODE_4084_length_1177_cov_34.920223	498	578	2	60	80	0.7500000
NODE_4084_length_1177_cov_34.920223	551	631	0	51	80	0.6375000
NODE_4084_length_1177_cov_34.920223	551	631	2	29	80	0.3625000
NODE_4085_length_1177_cov_12.186456	481	561	0	80	80	1.0000000
NODE_4085_length_1177_cov_12.186456	534	614	0	80	80	1.0000000
NODE_4085_length_1177_cov_12.186456	610	690	0	80	80	1.0000000
NODE_4085_length_1177_cov_12.186456	663	743	0	80	80	1.0000000
NODE_4086_length_1177_cov_11.926716	443	523	0	9	80	0.1125000
NODE_4086_length_1177_cov_11.926716	443	523	2	43	80	0.5375000
NODE_4086_length_1177_cov_11.926716	443	523	8	7	80	0.0875000
NODE_4086_length_1177_cov_11.926716	443	523	10	4	80	0.0500000
NODE_4086_length_1177_cov_11.926716	443	523	12	10	80	0.1250000
NODE_4086_length_1177_cov_11.926716	443	523	14	7	80	0.0875000
NODE_4086_length_1177_cov_11.926716	496	578	8	6	82	0.0731707
NODE_4086_length_1177_cov_11.926716	496	578	10	4	82	0.0487805
NODE_4086_length_1177_cov_11.926716	496	578	12	16	82	0.1951219
NODE_4086_length_1177_cov_11.926716	496	578	14	56	82	0.6829268
NODE_4088_length_1177_cov_5.923933	358	438	0	80	80	1.0000000
NODE_4088_length_1177_cov_5.923933	411	491	0	80	80	1.0000000
NODE_4089_length_1177_cov_5.775510	760	840	0	76	80	0.9500000
NODE_4089_length_1177_cov_5.775510	760	840	2	4	80	0.0500000
NODE_4089_length_1177_cov_5.775510	813	893	0	80	80	1.0000000
NODE_4096_length_1176_cov_26.994429	377	457	0	34	80	0.4250000
NODE_4096_length_1176_cov_26.994429	377	457	4	12	80	0.1500000
NODE_4096_length_1176_cov_26.994429	377	457	8	34	80	0.4250000
NODE_4096_length_1176_cov_26.994429	430	510	0	80	80	1.0000000
NODE_4096_length_1176_cov_26.994429	506	586	0	80	80	1.0000000
NODE_4096_length_1176_cov_26.994429	559	639	0	80	80	1.0000000
NODE_4097_length_1176_cov_15.766945	531	611	4	12	80	0.1500000
NODE_4097_length_1176_cov_15.766945	531	611	6	57	80	0.7125000
NODE_4097_length_1176_cov_15.766945	531	611	8	11	80	0.1375000
NODE_4097_length_1176_cov_15.766945	584	664	4	57	80	0.7125000
NODE_4097_length_1176_cov_15.766945	584	664	6	23	80	0.2875000
NODE_4098_length_1176_cov_14.882080	628	708	0	80	80	1.0000000
NODE_4098_length_1176_cov_14.882080	681	761	0	80	80	1.0000000
NODE_4099_length_1176_cov_10.692665	392	472	2	29	80	0.3625000
NODE_4099_length_1176_cov_10.692665	392	472	4	51	80	0.6375000
NODE_4099_length_1176_cov_10.692665	445	525	0	47	80	0.5875000
NODE_4099_length_1176_cov_10.692665	445	525	2	33	80	0.4125000
NODE_4106_length_1175_cov_50.754647	526	606	0	80	80	1.0000000
NODE_4106_length_1175_cov_50.754647	579	659	0	80	80	1.0000000
NODE_4107_length_1175_cov_42.638476	327	407	4	31	80	0.3875000
NODE_4107_length_1175_cov_42.638476	327	407	6	4	80	0.0500000
NODE_4107_length_1175_cov_42.638476	327	407	10	45	80	0.5625000
NODE_4107_length_1175_cov_42.638476	380	460	4	24	80	0.3000000
NODE_4107_length_1175_cov_42.638476	380	460	6	27	80	0.3375000
NODE_4107_length_1175_cov_42.638476	380	460	10	29	80	0.3625000
NODE_4107_length_1175_cov_42.638476	456	536	0	65	80	0.8125000
NODE_4107_length_1175_cov_42.638476	456	536	4	15	80	0.1875000
NODE_4107_length_1175_cov_42.638476	509	589	0	75	80	0.9375000
NODE_4107_length_1175_cov_42.638476	509	589	2	5	80	0.0625000
NODE_4108_length_1175_cov_40.217472	437	517	0	80	80	1.0000000
NODE_4108_length_1175_cov_40.217472	490	570	0	80	80	1.0000000
NODE_4108_length_1175_cov_40.217472	566	646	0	80	80	1.0000000
NODE_4108_length_1175_cov_40.217472	619	699	0	80	80	1.0000000
NODE_4109_length_1175_cov_12.834572	775	855	0	80	80	1.0000000
NODE_4109_length_1175_cov_12.834572	828	908	0	80	80	1.0000000
NODE_4115_length_1174_cov_20.569302	433	513	6	46	80	0.5750000
NODE_4115_length_1174_cov_20.569302	433	513	8	34	80	0.4250000
NODE_4115_length_1174_cov_20.569302	486	566	0	52	80	0.6500000
NODE_4115_length_1174_cov_20.569302	486	566	6	28	80	0.3500000
NODE_4115_length_1174_cov_20.569302	562	642	0	80	80	1.0000000
NODE_4115_length_1174_cov_20.569302	615	695	0	80	80	1.0000000
NODE_4116_length_1174_cov_18.797209	578	658	0	46	80	0.5750000
NODE_4116_length_1174_cov_18.797209	578	658	4	34	80	0.4250000
NODE_4116_length_1174_cov_18.797209	631	711	4	80	80	1.0000000
NODE_4117_length_1174_cov_17.486512	589	669	0	80	80	1.0000000
NODE_4117_length_1174_cov_17.486512	642	722	0	67	80	0.8375000
NODE_4117_length_1174_cov_17.486512	642	722	2	13	80	0.1625000
NODE_4118_length_1174_cov_15.888372	570	650	0	80	80	1.0000000
NODE_4118_length_1174_cov_15.888372	623	703	0	80	80	1.0000000
NODE_4118_length_1174_cov_15.888372	699	779	0	52	80	0.6500000
NODE_4118_length_1174_cov_15.888372	699	779	2	28	80	0.3500000
NODE_4118_length_1174_cov_15.888372	752	832	2	80	80	1.0000000
NODE_4124_length_1174_cov_1.536744	1066	1115	0	49	49	1.0000000
NODE_4124_length_1174_cov_1.536744	1088	1168	0	80	80	1.0000000
NODE_4128_length_1173_cov_29.562384	455	535	0	21	80	0.2625000
NODE_4128_length_1173_cov_29.562384	455	535	4	41	80	0.5125000
NODE_4128_length_1173_cov_29.562384	455	535	10	18	80	0.2250000
NODE_4128_length_1173_cov_29.562384	508	588	4	9	80	0.1125000
NODE_4128_length_1173_cov_29.562384	508	588	10	41	80	0.5125000
NODE_4128_length_1173_cov_29.562384	508	588	14	30	80	0.3750000
NODE_4128_length_1173_cov_29.562384	584	664	4	58	80	0.7250000
NODE_4128_length_1173_cov_29.562384	584	664	10	22	80	0.2750000
NODE_4128_length_1173_cov_29.562384	637	717	0	50	80	0.6250000
NODE_4128_length_1173_cov_29.562384	637	717	3	1	80	0.0125000
NODE_4128_length_1173_cov_29.562384	637	717	4	29	80	0.3625000
NODE_4129_length_1173_cov_25.206704	395	475	2	80	80	1.0000000
NODE_4129_length_1173_cov_25.206704	448	528	0	53	80	0.6625000
NODE_4129_length_1173_cov_25.206704	448	528	2	27	80	0.3375000
NODE_4130_length_1173_cov_9.486965	693	773	0	5	80	0.0625000
NODE_4130_length_1173_cov_9.486965	693	773	2	21	80	0.2625000
NODE_4130_length_1173_cov_9.486965	693	773	4	15	80	0.1875000
NODE_4130_length_1173_cov_9.486965	693	773	5	5	80	0.0625000
NODE_4130_length_1173_cov_9.486965	693	773	7	34	80	0.4250000
NODE_4130_length_1173_cov_9.486965	746	826	0	58	80	0.7250000
NODE_4130_length_1173_cov_9.486965	746	826	2	21	80	0.2625000
NODE_4130_length_1173_cov_9.486965	746	826	4	1	80	0.0125000
NODE_4131_length_1173_cov_7.946927	201	281	0	80	80	1.0000000
NODE_4131_length_1173_cov_7.946927	254	334	0	80	80	1.0000000
NODE_4136_length_1172_cov_37.177074	527	607	0	66	80	0.8250000
NODE_4136_length_1172_cov_37.177074	527	607	2	9	80	0.1125000
NODE_4136_length_1172_cov_37.177074	527	607	4	5	80	0.0625000
NODE_4136_length_1172_cov_37.177074	580	660	0	13	80	0.1625000
NODE_4136_length_1172_cov_37.177074	580	660	2	9	80	0.1125000
NODE_4136_length_1172_cov_37.177074	580	660	4	58	80	0.7250000
NODE_4137_length_1172_cov_20.397018	677	757	0	13	80	0.1625000
NODE_4137_length_1172_cov_20.397018	677	757	2	29	80	0.3625000
NODE_4137_length_1172_cov_20.397018	677	757	4	38	80	0.4750000
NODE_4137_length_1172_cov_20.397018	730	810	1	7	80	0.0875000
NODE_4137_length_1172_cov_20.397018	730	810	2	25	80	0.3125000
NODE_4137_length_1172_cov_20.397018	730	810	3	2	80	0.0250000
NODE_4137_length_1172_cov_20.397018	730	810	4	46	80	0.5750000
NODE_4138_length_1172_cov_15.018639	460	540	0	80	80	1.0000000
NODE_4138_length_1172_cov_15.018639	513	593	0	80	80	1.0000000
NODE_4139_length_1172_cov_13.199441	622	702	0	80	80	1.0000000
NODE_4139_length_1172_cov_13.199441	675	755	0	80	80	1.0000000
NODE_4140_length_1172_cov_10.720410	499	579	4	80	80	1.0000000
NODE_4140_length_1172_cov_10.720410	552	632	0	7	80	0.0875000
NODE_4140_length_1172_cov_10.720410	552	632	2	9	80	0.1125000
NODE_4140_length_1172_cov_10.720410	552	632	3	1	80	0.0125000
NODE_4140_length_1172_cov_10.720410	552	632	4	63	80	0.7875000
NODE_4140_length_1172_cov_10.720410	628	708	0	26	80	0.3250000
NODE_4140_length_1172_cov_10.720410	628	708	2	54	80	0.6750000
NODE_4140_length_1172_cov_10.720410	681	761	2	50	80	0.6250000
NODE_4140_length_1172_cov_10.720410	681	761	6	30	80	0.3750000
NODE_4141_length_1172_cov_10.574091	951	1021	6	8	70	0.1142857
NODE_4141_length_1172_cov_10.574091	951	1021	8	8	70	0.1142857
NODE_4141_length_1172_cov_10.574091	951	1021	12	35	70	0.5000000
NODE_4141_length_1172_cov_10.574091	951	1021	14	19	70	0.2714286
NODE_4142_length_1172_cov_9.204101	276	356	0	80	80	1.0000000
NODE_4142_length_1172_cov_9.204101	329	409	0	80	80	1.0000000
NODE_4148_length_1171_cov_13.311567	666	746	4	5	80	0.0625000
NODE_4148_length_1171_cov_13.311567	666	746	5	2	80	0.0250000
NODE_4148_length_1171_cov_13.311567	666	746	6	38	80	0.4750000
NODE_4148_length_1171_cov_13.311567	666	746	7	14	80	0.1750000
NODE_4148_length_1171_cov_13.311567	666	746	8	18	80	0.2250000
NODE_4148_length_1171_cov_13.311567	666	746	9	3	80	0.0375000
NODE_4148_length_1171_cov_13.311567	719	803	6	67	84	0.7976190
NODE_4148_length_1171_cov_13.311567	719	803	7	12	84	0.1428571
NODE_4148_length_1171_cov_13.311567	719	803	8	5	84	0.0595238
NODE_4149_length_1171_cov_9.154851	198	278	0	80	80	1.0000000
NODE_4149_length_1171_cov_9.154851	251	331	0	80	80	1.0000000
NODE_4157_length_1170_cov_65.480859	402	482	0	80	80	1.0000000
NODE_4157_length_1170_cov_65.480859	455	535	0	27	80	0.3375000
NODE_4157_length_1170_cov_65.480859	455	535	2	53	80	0.6625000
NODE_4158_length_1170_cov_35.283847	704	784	0	72	80	0.9000000
NODE_4158_length_1170_cov_35.283847	704	784	2	8	80	0.1000000
NODE_4158_length_1170_cov_35.283847	757	837	0	19	80	0.2375000
NODE_4158_length_1170_cov_35.283847	757	837	2	43	80	0.5375000
NODE_4158_length_1170_cov_35.283847	757	837	4	18	80	0.2250000
NODE_4159_length_1170_cov_23.600373	450	530	0	80	80	1.0000000
NODE_4159_length_1170_cov_23.600373	503	583	0	80	80	1.0000000
NODE_4159_length_1170_cov_23.600373	579	659	0	22	80	0.2750000
NODE_4159_length_1170_cov_23.600373	579	659	4	58	80	0.7250000
NODE_4159_length_1170_cov_23.600373	632	705	2	16	73	0.2191781
NODE_4159_length_1170_cov_23.600373	632	705	4	57	73	0.7808219
NODE_4160_length_1170_cov_19.783380	325	405	4	28	80	0.3500000
NODE_4160_length_1170_cov_19.783380	325	405	6	52	80	0.6500000
NODE_4160_length_1170_cov_19.783380	378	458	0	19	80	0.2375000
NODE_4160_length_1170_cov_19.783380	378	458	2	14	80	0.1750000
NODE_4160_length_1170_cov_19.783380	378	458	6	47	80	0.5875000
NODE_4168_length_1169_cov_61.689720	464	544	14	20	80	0.2500000
NODE_4168_length_1169_cov_61.689720	464	544	18	23	80	0.2875000
NODE_4168_length_1169_cov_61.689720	464	544	20	3	80	0.0375000
NODE_4168_length_1169_cov_61.689720	464	544	26	12	80	0.1500000
NODE_4168_length_1169_cov_61.689720	464	544	28	22	80	0.2750000
NODE_4168_length_1169_cov_61.689720	517	597	6	11	80	0.1375000
NODE_4168_length_1169_cov_61.689720	517	597	7	2	80	0.0250000
NODE_4168_length_1169_cov_61.689720	517	597	14	6	80	0.0750000
NODE_4168_length_1169_cov_61.689720	517	597	18	20	80	0.2500000
NODE_4168_length_1169_cov_61.689720	517	597	20	1	80	0.0125000
NODE_4168_length_1169_cov_61.689720	517	597	22	11	80	0.1375000
NODE_4168_length_1169_cov_61.689720	517	597	26	14	80	0.1750000
NODE_4168_length_1169_cov_61.689720	517	597	28	15	80	0.1875000
NODE_4168_length_1169_cov_61.689720	593	673	5	28	80	0.3500000
NODE_4168_length_1169_cov_61.689720	593	673	6	2	80	0.0250000
NODE_4168_length_1169_cov_61.689720	593	673	7	10	80	0.1250000
NODE_4168_length_1169_cov_61.689720	593	673	10	1	80	0.0125000
NODE_4168_length_1169_cov_61.689720	593	673	11	38	80	0.4750000
NODE_4168_length_1169_cov_61.689720	593	673	13	1	80	0.0125000
NODE_4168_length_1169_cov_61.689720	646	726	9	46	80	0.5750000
NODE_4168_length_1169_cov_61.689720	646	726	10	4	80	0.0500000
NODE_4168_length_1169_cov_61.689720	646	726	11	26	80	0.3250000
NODE_4168_length_1169_cov_61.689720	646	726	13	3	80	0.0375000
NODE_4168_length_1169_cov_61.689720	646	726	15	1	80	0.0125000
NODE_4169_length_1169_cov_55.247664	640	720	0	2	80	0.0250000
NODE_4169_length_1169_cov_55.247664	640	720	2	78	80	0.9750000
NODE_4169_length_1169_cov_55.247664	693	773	0	18	80	0.2250000
NODE_4169_length_1169_cov_55.247664	693	773	2	62	80	0.7750000
NODE_4170_length_1169_cov_39.016822	447	527	0	62	80	0.7750000
NODE_4170_length_1169_cov_39.016822	447	527	2	18	80	0.2250000
NODE_4170_length_1169_cov_39.016822	500	580	0	9	80	0.1125000
NODE_4170_length_1169_cov_39.016822	500	580	2	71	80	0.8875000
NODE_4170_length_1169_cov_39.016822	576	656	0	4	80	0.0500000
NODE_4170_length_1169_cov_39.016822	576	656	2	76	80	0.9500000
NODE_4170_length_1169_cov_39.016822	629	709	2	36	80	0.4500000
NODE_4170_length_1169_cov_39.016822	629	709	4	34	80	0.4250000
NODE_4170_length_1169_cov_39.016822	629	709	6	10	80	0.1250000
NODE_4171_length_1169_cov_35.383178	582	662	0	33	80	0.4125000
NODE_4171_length_1169_cov_35.383178	582	662	2	47	80	0.5875000
NODE_4171_length_1169_cov_35.383178	635	715	0	18	80	0.2250000
NODE_4171_length_1169_cov_35.383178	635	715	2	62	80	0.7750000
NODE_4173_length_1169_cov_12.010280	338	418	0	80	80	1.0000000
NODE_4173_length_1169_cov_12.010280	391	471	0	80	80	1.0000000
NODE_4175_length_1169_cov_4.172897	74	135	0	61	61	1.0000000
NODE_4175_length_1169_cov_4.172897	74	135	0	61	61	1.0000000
NODE_4175_length_1169_cov_4.172897	74	135	0	61	61	1.0000000
NODE_4183_length_1168_cov_27.350795	517	597	2	11	80	0.1375000
NODE_4183_length_1168_cov_27.350795	517	597	4	19	80	0.2375000
NODE_4183_length_1168_cov_27.350795	517	597	6	50	80	0.6250000
NODE_4183_length_1168_cov_27.350795	570	650	0	13	80	0.1625000
NODE_4183_length_1168_cov_27.350795	570	650	2	9	80	0.1125000
NODE_4183_length_1168_cov_27.350795	570	650	4	30	80	0.3750000
NODE_4183_length_1168_cov_27.350795	570	650	6	28	80	0.3500000
NODE_4183_length_1168_cov_27.350795	646	726	0	54	80	0.6750000
NODE_4183_length_1168_cov_27.350795	646	726	5	12	80	0.1500000
NODE_4183_length_1168_cov_27.350795	646	726	6	14	80	0.1750000
NODE_4183_length_1168_cov_27.350795	699	779	0	1	80	0.0125000
NODE_4183_length_1168_cov_27.350795	699	779	5	12	80	0.1500000
NODE_4183_length_1168_cov_27.350795	699	779	6	67	80	0.8375000
NODE_4184_length_1168_cov_25.777362	672	752	2	6	80	0.0750000
NODE_4184_length_1168_cov_25.777362	672	752	4	6	80	0.0750000
NODE_4184_length_1168_cov_25.777362	672	752	6	68	80	0.8500000
NODE_4184_length_1168_cov_25.777362	725	805	0	51	80	0.6375000
NODE_4184_length_1168_cov_25.777362	725	805	4	8	80	0.1000000
NODE_4184_length_1168_cov_25.777362	725	805	6	21	80	0.2625000
NODE_4185_length_1168_cov_25.295603	543	623	2	22	80	0.2750000
NODE_4185_length_1168_cov_25.295603	543	623	4	58	80	0.7250000
NODE_4185_length_1168_cov_25.295603	596	676	2	38	80	0.4750000
NODE_4185_length_1168_cov_25.295603	596	676	4	42	80	0.5250000
NODE_4185_length_1168_cov_25.295603	672	752	0	71	80	0.8875000
NODE_4185_length_1168_cov_25.295603	672	752	2	9	80	0.1125000
NODE_4185_length_1168_cov_25.295603	725	804	0	79	79	1.0000000
NODE_4186_length_1168_cov_20.202058	434	514	0	80	80	1.0000000
NODE_4186_length_1168_cov_20.202058	487	567	0	80	80	1.0000000
NODE_4187_length_1168_cov_16.787652	405	485	0	15	80	0.1875000
NODE_4187_length_1168_cov_16.787652	405	485	4	65	80	0.8125000
NODE_4187_length_1168_cov_16.787652	458	538	0	25	80	0.3125000
NODE_4187_length_1168_cov_16.787652	458	538	4	55	80	0.6875000
NODE_4188_length_1168_cov_10.079514	722	802	8	13	80	0.1625000
NODE_4188_length_1168_cov_10.079514	722	802	10	64	80	0.8000000
NODE_4188_length_1168_cov_10.079514	722	802	11	1	80	0.0125000
NODE_4188_length_1168_cov_10.079514	722	802	12	2	80	0.0250000
NODE_4188_length_1168_cov_10.079514	775	855	2	25	80	0.3125000
NODE_4188_length_1168_cov_10.079514	775	855	6	17	80	0.2125000
NODE_4188_length_1168_cov_10.079514	775	855	8	23	80	0.2875000
NODE_4188_length_1168_cov_10.079514	775	855	10	12	80	0.1500000
NODE_4188_length_1168_cov_10.079514	775	855	11	1	80	0.0125000
NODE_4188_length_1168_cov_10.079514	775	855	12	2	80	0.0250000
NODE_4198_length_1167_cov_27.961610	591	671	10	10	80	0.1250000
NODE_4198_length_1167_cov_27.961610	591	671	12	13	80	0.1625000
NODE_4198_length_1167_cov_27.961610	591	671	14	4	80	0.0500000
NODE_4198_length_1167_cov_27.961610	591	671	17	1	80	0.0125000
NODE_4198_length_1167_cov_27.961610	591	671	18	2	80	0.0250000
NODE_4198_length_1167_cov_27.961610	591	671	20	14	80	0.1750000
NODE_4198_length_1167_cov_27.961610	591	671	21	20	80	0.2500000
NODE_4198_length_1167_cov_27.961610	591	671	23	10	80	0.1250000
NODE_4198_length_1167_cov_27.961610	591	671	25	6	80	0.0750000
NODE_4198_length_1167_cov_27.961610	644	724	8	1	80	0.0125000
NODE_4198_length_1167_cov_27.961610	644	724	10	16	80	0.2000000
NODE_4198_length_1167_cov_27.961610	644	724	14	15	80	0.1875000
NODE_4198_length_1167_cov_27.961610	644	724	16	2	80	0.0250000
NODE_4198_length_1167_cov_27.961610	644	724	17	1	80	0.0125000
NODE_4198_length_1167_cov_27.961610	644	724	18	17	80	0.2125000
NODE_4198_length_1167_cov_27.961610	644	724	21	15	80	0.1875000
NODE_4198_length_1167_cov_27.961610	644	724	23	9	80	0.1125000
NODE_4198_length_1167_cov_27.961610	644	724	25	4	80	0.0500000
NODE_4199_length_1167_cov_12.393258	670	750	6	47	80	0.5875000
NODE_4199_length_1167_cov_12.393258	670	750	8	33	80	0.4125000
NODE_4199_length_1167_cov_12.393258	723	803	0	13	80	0.1625000
NODE_4199_length_1167_cov_12.393258	723	803	8	67	80	0.8375000
NODE_4200_length_1167_cov_11.189139	434	514	2	27	80	0.3375000
NODE_4200_length_1167_cov_11.189139	434	514	4	26	80	0.3250000
NODE_4200_length_1167_cov_11.189139	434	514	6	27	80	0.3375000
NODE_4200_length_1167_cov_11.189139	487	567	0	45	80	0.5625000
NODE_4200_length_1167_cov_11.189139	487	567	2	35	80	0.4375000
NODE_4201_length_1167_cov_7.998127	711	791	0	29	80	0.3625000
NODE_4201_length_1167_cov_7.998127	711	791	2	51	80	0.6375000
NODE_4201_length_1167_cov_7.998127	764	844	2	80	80	1.0000000
NODE_4206_length_1166_cov_313.815370	444	524	88	13	80	0.1625000
NODE_4206_length_1166_cov_313.815370	444	524	90	2	80	0.0250000
NODE_4206_length_1166_cov_313.815370	444	524	99	1	80	0.0125000
NODE_4206_length_1166_cov_313.815370	444	524	101	1	80	0.0125000
NODE_4206_length_1166_cov_313.815370	444	524	136	1	80	0.0125000
NODE_4206_length_1166_cov_313.815370	444	524	137	2	80	0.0250000
NODE_4206_length_1166_cov_313.815370	444	524	140	1	80	0.0125000
NODE_4206_length_1166_cov_313.815370	444	524	164	1	80	0.0125000
NODE_4206_length_1166_cov_313.815370	444	524	171	1	80	0.0125000
NODE_4206_length_1166_cov_313.815370	444	524	172	1	80	0.0125000
NODE_4206_length_1166_cov_313.815370	444	524	174	1	80	0.0125000
NODE_4206_length_1166_cov_313.815370	444	524	180	3	80	0.0375000
NODE_4206_length_1166_cov_313.815370	444	524	194	1	80	0.0125000
NODE_4206_length_1166_cov_313.815370	444	524	204	1	80	0.0125000
NODE_4206_length_1166_cov_313.815370	444	524	221	1	80	0.0125000
NODE_4206_length_1166_cov_313.815370	444	524	232	1	80	0.0125000
NODE_4206_length_1166_cov_313.815370	444	524	234	1	80	0.0125000
NODE_4206_length_1166_cov_313.815370	444	524	237	1	80	0.0125000
NODE_4206_length_1166_cov_313.815370	444	524	257	1	80	0.0125000
NODE_4206_length_1166_cov_313.815370	444	524	263	1	80	0.0125000
NODE_4206_length_1166_cov_313.815370	444	524	266	1	80	0.0125000
NODE_4206_length_1166_cov_313.815370	444	524	278	1	80	0.0125000
NODE_4206_length_1166_cov_313.815370	444	524	280	1	80	0.0125000
NODE_4206_length_1166_cov_313.815370	444	524	286	1	80	0.0125000
NODE_4206_length_1166_cov_313.815370	444	524	294	1	80	0.0125000
NODE_4206_length_1166_cov_313.815370	444	524	306	2	80	0.0250000
NODE_4206_length_1166_cov_313.815370	444	524	307	2	80	0.0250000
NODE_4206_length_1166_cov_313.815370	444	524	312	1	80	0.0125000
NODE_4206_length_1166_cov_313.815370	444	524	313	2	80	0.0250000
NODE_4206_length_1166_cov_313.815370	444	524	315	1	80	0.0125000
NODE_4206_length_1166_cov_313.815370	444	524	348	1	80	0.0125000
NODE_4206_length_1166_cov_313.815370	444	524	359	1	80	0.0125000
NODE_4206_length_1166_cov_313.815370	444	524	364	1	80	0.0125000
NODE_4206_length_1166_cov_313.815370	444	524	374	1	80	0.0125000
NODE_4206_length_1166_cov_313.815370	444	524	377	1	80	0.0125000
NODE_4206_length_1166_cov_313.815370	444	524	379	1	80	0.0125000
NODE_4206_length_1166_cov_313.815370	444	524	380	1	80	0.0125000
NODE_4206_length_1166_cov_313.815370	444	524	387	1	80	0.0125000
NODE_4206_length_1166_cov_313.815370	444	524	396	1	80	0.0125000
NODE_4206_length_1166_cov_313.815370	444	524	405	1	80	0.0125000
NODE_4206_length_1166_cov_313.815370	444	524	409	1	80	0.0125000
NODE_4206_length_1166_cov_313.815370	444	524	412	1	80	0.0125000
NODE_4206_length_1166_cov_313.815370	444	524	424	1	80	0.0125000
NODE_4206_length_1166_cov_313.815370	444	524	425	1	80	0.0125000
NODE_4206_length_1166_cov_313.815370	444	524	458	3	80	0.0375000
NODE_4206_length_1166_cov_313.815370	444	524	462	1	80	0.0125000
NODE_4206_length_1166_cov_313.815370	444	524	465	1	80	0.0125000
NODE_4206_length_1166_cov_313.815370	444	524	479	1	80	0.0125000
NODE_4206_length_1166_cov_313.815370	444	524	480	1	80	0.0125000
NODE_4206_length_1166_cov_313.815370	444	524	481	1	80	0.0125000
NODE_4206_length_1166_cov_313.815370	444	524	483	1	80	0.0125000
NODE_4206_length_1166_cov_313.815370	444	524	500	1	80	0.0125000
NODE_4206_length_1166_cov_313.815370	444	524	506	1	80	0.0125000
NODE_4206_length_1166_cov_313.815370	444	524	517	1	80	0.0125000
NODE_4206_length_1166_cov_313.815370	444	524	518	2	80	0.0250000
NODE_4206_length_1166_cov_313.815370	444	524	520	2	80	0.0250000
NODE_4206_length_1166_cov_313.815370	444	524	522	1	80	0.0125000
NODE_4206_length_1166_cov_313.815370	444	524	88	13	80	0.1625000
NODE_4206_length_1166_cov_313.815370	444	524	90	2	80	0.0250000
NODE_4206_length_1166_cov_313.815370	444	524	99	1	80	0.0125000
NODE_4206_length_1166_cov_313.815370	444	524	101	1	80	0.0125000
NODE_4206_length_1166_cov_313.815370	444	524	136	1	80	0.0125000
NODE_4206_length_1166_cov_313.815370	444	524	137	2	80	0.0250000
NODE_4206_length_1166_cov_313.815370	444	524	140	1	80	0.0125000
NODE_4206_length_1166_cov_313.815370	444	524	164	1	80	0.0125000
NODE_4206_length_1166_cov_313.815370	444	524	171	1	80	0.0125000
NODE_4206_length_1166_cov_313.815370	444	524	172	1	80	0.0125000
NODE_4206_length_1166_cov_313.815370	444	524	174	1	80	0.0125000
NODE_4206_length_1166_cov_313.815370	444	524	180	3	80	0.0375000
NODE_4206_length_1166_cov_313.815370	444	524	194	1	80	0.0125000
NODE_4206_length_1166_cov_313.815370	444	524	204	1	80	0.0125000
NODE_4206_length_1166_cov_313.815370	444	524	221	1	80	0.0125000
NODE_4206_length_1166_cov_313.815370	444	524	232	1	80	0.0125000
NODE_4206_length_1166_cov_313.815370	444	524	234	1	80	0.0125000
NODE_4206_length_1166_cov_313.815370	444	524	237	1	80	0.0125000
NODE_4206_length_1166_cov_313.815370	444	524	257	1	80	0.0125000
NODE_4206_length_1166_cov_313.815370	444	524	263	1	80	0.0125000
NODE_4206_length_1166_cov_313.815370	444	524	266	1	80	0.0125000
NODE_4206_length_1166_cov_313.815370	444	524	278	1	80	0.0125000
NODE_4206_length_1166_cov_313.815370	444	524	280	1	80	0.0125000
NODE_4206_length_1166_cov_313.815370	444	524	286	1	80	0.0125000
NODE_4206_length_1166_cov_313.815370	444	524	294	1	80	0.0125000
NODE_4206_length_1166_cov_313.815370	444	524	306	2	80	0.0250000
NODE_4206_length_1166_cov_313.815370	444	524	307	2	80	0.0250000
NODE_4206_length_1166_cov_313.815370	444	524	312	1	80	0.0125000
NODE_4206_length_1166_cov_313.815370	444	524	313	2	80	0.0250000
NODE_4206_length_1166_cov_313.815370	444	524	315	1	80	0.0125000
NODE_4206_length_1166_cov_313.815370	444	524	348	1	80	0.0125000
NODE_4206_length_1166_cov_313.815370	444	524	359	1	80	0.0125000
NODE_4206_length_1166_cov_313.815370	444	524	364	1	80	0.0125000
NODE_4206_length_1166_cov_313.815370	444	524	374	1	80	0.0125000
NODE_4206_length_1166_cov_313.815370	444	524	377	1	80	0.0125000
NODE_4206_length_1166_cov_313.815370	444	524	379	1	80	0.0125000
NODE_4206_length_1166_cov_313.815370	444	524	380	1	80	0.0125000
NODE_4206_length_1166_cov_313.815370	444	524	387	1	80	0.0125000
NODE_4206_length_1166_cov_313.815370	444	524	396	1	80	0.0125000
NODE_4206_length_1166_cov_313.815370	444	524	405	1	80	0.0125000
NODE_4206_length_1166_cov_313.815370	444	524	409	1	80	0.0125000
NODE_4206_length_1166_cov_313.815370	444	524	412	1	80	0.0125000
NODE_4206_length_1166_cov_313.815370	444	524	424	1	80	0.0125000
NODE_4206_length_1166_cov_313.815370	444	524	425	1	80	0.0125000
NODE_4206_length_1166_cov_313.815370	444	524	458	3	80	0.0375000
NODE_4206_length_1166_cov_313.815370	444	524	462	1	80	0.0125000
NODE_4206_length_1166_cov_313.815370	444	524	465	1	80	0.0125000
NODE_4206_length_1166_cov_313.815370	444	524	479	1	80	0.0125000
NODE_4206_length_1166_cov_313.815370	444	524	480	1	80	0.0125000
NODE_4206_length_1166_cov_313.815370	444	524	481	1	80	0.0125000
NODE_4206_length_1166_cov_313.815370	444	524	483	1	80	0.0125000
NODE_4206_length_1166_cov_313.815370	444	524	500	1	80	0.0125000
NODE_4206_length_1166_cov_313.815370	444	524	506	1	80	0.0125000
NODE_4206_length_1166_cov_313.815370	444	524	517	1	80	0.0125000
NODE_4206_length_1166_cov_313.815370	444	524	518	2	80	0.0250000
NODE_4206_length_1166_cov_313.815370	444	524	520	2	80	0.0250000
NODE_4206_length_1166_cov_313.815370	444	524	522	1	80	0.0125000
NODE_4206_length_1166_cov_313.815370	444	524	88	13	80	0.1625000
NODE_4206_length_1166_cov_313.815370	444	524	90	2	80	0.0250000
NODE_4206_length_1166_cov_313.815370	444	524	99	1	80	0.0125000
NODE_4206_length_1166_cov_313.815370	444	524	101	1	80	0.0125000
NODE_4206_length_1166_cov_313.815370	444	524	136	1	80	0.0125000
NODE_4206_length_1166_cov_313.815370	444	524	137	2	80	0.0250000
NODE_4206_length_1166_cov_313.815370	444	524	140	1	80	0.0125000
NODE_4206_length_1166_cov_313.815370	444	524	164	1	80	0.0125000
NODE_4206_length_1166_cov_313.815370	444	524	171	1	80	0.0125000
NODE_4206_length_1166_cov_313.815370	444	524	172	1	80	0.0125000
NODE_4206_length_1166_cov_313.815370	444	524	174	1	80	0.0125000
NODE_4206_length_1166_cov_313.815370	444	524	180	3	80	0.0375000
NODE_4206_length_1166_cov_313.815370	444	524	194	1	80	0.0125000
NODE_4206_length_1166_cov_313.815370	444	524	204	1	80	0.0125000
NODE_4206_length_1166_cov_313.815370	444	524	221	1	80	0.0125000
NODE_4206_length_1166_cov_313.815370	444	524	232	1	80	0.0125000
NODE_4206_length_1166_cov_313.815370	444	524	234	1	80	0.0125000
NODE_4206_length_1166_cov_313.815370	444	524	237	1	80	0.0125000
NODE_4206_length_1166_cov_313.815370	444	524	257	1	80	0.0125000
NODE_4206_length_1166_cov_313.815370	444	524	263	1	80	0.0125000
NODE_4206_length_1166_cov_313.815370	444	524	266	1	80	0.0125000
NODE_4206_length_1166_cov_313.815370	444	524	278	1	80	0.0125000
NODE_4206_length_1166_cov_313.815370	444	524	280	1	80	0.0125000
NODE_4206_length_1166_cov_313.815370	444	524	286	1	80	0.0125000
NODE_4206_length_1166_cov_313.815370	444	524	294	1	80	0.0125000
NODE_4206_length_1166_cov_313.815370	444	524	306	2	80	0.0250000
NODE_4206_length_1166_cov_313.815370	444	524	307	2	80	0.0250000
NODE_4206_length_1166_cov_313.815370	444	524	312	1	80	0.0125000
NODE_4206_length_1166_cov_313.815370	444	524	313	2	80	0.0250000
NODE_4206_length_1166_cov_313.815370	444	524	315	1	80	0.0125000
NODE_4206_length_1166_cov_313.815370	444	524	348	1	80	0.0125000
NODE_4206_length_1166_cov_313.815370	444	524	359	1	80	0.0125000
NODE_4206_length_1166_cov_313.815370	444	524	364	1	80	0.0125000
NODE_4206_length_1166_cov_313.815370	444	524	374	1	80	0.0125000
NODE_4206_length_1166_cov_313.815370	444	524	377	1	80	0.0125000
NODE_4206_length_1166_cov_313.815370	444	524	379	1	80	0.0125000
NODE_4206_length_1166_cov_313.815370	444	524	380	1	80	0.0125000
NODE_4206_length_1166_cov_313.815370	444	524	387	1	80	0.0125000
NODE_4206_length_1166_cov_313.815370	444	524	396	1	80	0.0125000
NODE_4206_length_1166_cov_313.815370	444	524	405	1	80	0.0125000
NODE_4206_length_1166_cov_313.815370	444	524	409	1	80	0.0125000
NODE_4206_length_1166_cov_313.815370	444	524	412	1	80	0.0125000
NODE_4206_length_1166_cov_313.815370	444	524	424	1	80	0.0125000
NODE_4206_length_1166_cov_313.815370	444	524	425	1	80	0.0125000
NODE_4206_length_1166_cov_313.815370	444	524	458	3	80	0.0375000
NODE_4206_length_1166_cov_313.815370	444	524	462	1	80	0.0125000
NODE_4206_length_1166_cov_313.815370	444	524	465	1	80	0.0125000
NODE_4206_length_1166_cov_313.815370	444	524	479	1	80	0.0125000
NODE_4206_length_1166_cov_313.815370	444	524	480	1	80	0.0125000
NODE_4206_length_1166_cov_313.815370	444	524	481	1	80	0.0125000
NODE_4206_length_1166_cov_313.815370	444	524	483	1	80	0.0125000
NODE_4206_length_1166_cov_313.815370	444	524	500	1	80	0.0125000
NODE_4206_length_1166_cov_313.815370	444	524	506	1	80	0.0125000
NODE_4206_length_1166_cov_313.815370	444	524	517	1	80	0.0125000
NODE_4206_length_1166_cov_313.815370	444	524	518	2	80	0.0250000
NODE_4206_length_1166_cov_313.815370	444	524	520	2	80	0.0250000
NODE_4206_length_1166_cov_313.815370	444	524	522	1	80	0.0125000
NODE_4206_length_1166_cov_313.815370	444	524	88	13	80	0.1625000
NODE_4206_length_1166_cov_313.815370	444	524	90	2	80	0.0250000
NODE_4206_length_1166_cov_313.815370	444	524	99	1	80	0.0125000
NODE_4206_length_1166_cov_313.815370	444	524	101	1	80	0.0125000
NODE_4206_length_1166_cov_313.815370	444	524	136	1	80	0.0125000
NODE_4206_length_1166_cov_313.815370	444	524	137	2	80	0.0250000
NODE_4206_length_1166_cov_313.815370	444	524	140	1	80	0.0125000
NODE_4206_length_1166_cov_313.815370	444	524	164	1	80	0.0125000
NODE_4206_length_1166_cov_313.815370	444	524	171	1	80	0.0125000
NODE_4206_length_1166_cov_313.815370	444	524	172	1	80	0.0125000
NODE_4206_length_1166_cov_313.815370	444	524	174	1	80	0.0125000
NODE_4206_length_1166_cov_313.815370	444	524	180	3	80	0.0375000
NODE_4206_length_1166_cov_313.815370	444	524	194	1	80	0.0125000
NODE_4206_length_1166_cov_313.815370	444	524	204	1	80	0.0125000
NODE_4206_length_1166_cov_313.815370	444	524	221	1	80	0.0125000
NODE_4206_length_1166_cov_313.815370	444	524	232	1	80	0.0125000
NODE_4206_length_1166_cov_313.815370	444	524	234	1	80	0.0125000
NODE_4206_length_1166_cov_313.815370	444	524	237	1	80	0.0125000
NODE_4206_length_1166_cov_313.815370	444	524	257	1	80	0.0125000
NODE_4206_length_1166_cov_313.815370	444	524	263	1	80	0.0125000
NODE_4206_length_1166_cov_313.815370	444	524	266	1	80	0.0125000
NODE_4206_length_1166_cov_313.815370	444	524	278	1	80	0.0125000
NODE_4206_length_1166_cov_313.815370	444	524	280	1	80	0.0125000
NODE_4206_length_1166_cov_313.815370	444	524	286	1	80	0.0125000
NODE_4206_length_1166_cov_313.815370	444	524	294	1	80	0.0125000
NODE_4206_length_1166_cov_313.815370	444	524	306	2	80	0.0250000
NODE_4206_length_1166_cov_313.815370	444	524	307	2	80	0.0250000
NODE_4206_length_1166_cov_313.815370	444	524	312	1	80	0.0125000
NODE_4206_length_1166_cov_313.815370	444	524	313	2	80	0.0250000
NODE_4206_length_1166_cov_313.815370	444	524	315	1	80	0.0125000
NODE_4206_length_1166_cov_313.815370	444	524	348	1	80	0.0125000
NODE_4206_length_1166_cov_313.815370	444	524	359	1	80	0.0125000
NODE_4206_length_1166_cov_313.815370	444	524	364	1	80	0.0125000
NODE_4206_length_1166_cov_313.815370	444	524	374	1	80	0.0125000
NODE_4206_length_1166_cov_313.815370	444	524	377	1	80	0.0125000
NODE_4206_length_1166_cov_313.815370	444	524	379	1	80	0.0125000
NODE_4206_length_1166_cov_313.815370	444	524	380	1	80	0.0125000
NODE_4206_length_1166_cov_313.815370	444	524	387	1	80	0.0125000
NODE_4206_length_1166_cov_313.815370	444	524	396	1	80	0.0125000
NODE_4206_length_1166_cov_313.815370	444	524	405	1	80	0.0125000
NODE_4206_length_1166_cov_313.815370	444	524	409	1	80	0.0125000
NODE_4206_length_1166_cov_313.815370	444	524	412	1	80	0.0125000
NODE_4206_length_1166_cov_313.815370	444	524	424	1	80	0.0125000
NODE_4206_length_1166_cov_313.815370	444	524	425	1	80	0.0125000
NODE_4206_length_1166_cov_313.815370	444	524	458	3	80	0.0375000
NODE_4206_length_1166_cov_313.815370	444	524	462	1	80	0.0125000
NODE_4206_length_1166_cov_313.815370	444	524	465	1	80	0.0125000
NODE_4206_length_1166_cov_313.815370	444	524	479	1	80	0.0125000
NODE_4206_length_1166_cov_313.815370	444	524	480	1	80	0.0125000
NODE_4206_length_1166_cov_313.815370	444	524	481	1	80	0.0125000
NODE_4206_length_1166_cov_313.815370	444	524	483	1	80	0.0125000
NODE_4206_length_1166_cov_313.815370	444	524	500	1	80	0.0125000
NODE_4206_length_1166_cov_313.815370	444	524	506	1	80	0.0125000
NODE_4206_length_1166_cov_313.815370	444	524	517	1	80	0.0125000
NODE_4206_length_1166_cov_313.815370	444	524	518	2	80	0.0250000
NODE_4206_length_1166_cov_313.815370	444	524	520	2	80	0.0250000
NODE_4206_length_1166_cov_313.815370	444	524	522	1	80	0.0125000
NODE_4206_length_1166_cov_313.815370	444	524	88	13	80	0.1625000
NODE_4206_length_1166_cov_313.815370	444	524	90	2	80	0.0250000
NODE_4206_length_1166_cov_313.815370	444	524	99	1	80	0.0125000
NODE_4206_length_1166_cov_313.815370	444	524	101	1	80	0.0125000
NODE_4206_length_1166_cov_313.815370	444	524	136	1	80	0.0125000
NODE_4206_length_1166_cov_313.815370	444	524	137	2	80	0.0250000
NODE_4206_length_1166_cov_313.815370	444	524	140	1	80	0.0125000
NODE_4206_length_1166_cov_313.815370	444	524	164	1	80	0.0125000
NODE_4206_length_1166_cov_313.815370	444	524	171	1	80	0.0125000
NODE_4206_length_1166_cov_313.815370	444	524	172	1	80	0.0125000
NODE_4206_length_1166_cov_313.815370	444	524	174	1	80	0.0125000
NODE_4206_length_1166_cov_313.815370	444	524	180	3	80	0.0375000
NODE_4206_length_1166_cov_313.815370	444	524	194	1	80	0.0125000
NODE_4206_length_1166_cov_313.815370	444	524	204	1	80	0.0125000
NODE_4206_length_1166_cov_313.815370	444	524	221	1	80	0.0125000
NODE_4206_length_1166_cov_313.815370	444	524	232	1	80	0.0125000
NODE_4206_length_1166_cov_313.815370	444	524	234	1	80	0.0125000
NODE_4206_length_1166_cov_313.815370	444	524	237	1	80	0.0125000
NODE_4206_length_1166_cov_313.815370	444	524	257	1	80	0.0125000
NODE_4206_length_1166_cov_313.815370	444	524	263	1	80	0.0125000
NODE_4206_length_1166_cov_313.815370	444	524	266	1	80	0.0125000
NODE_4206_length_1166_cov_313.815370	444	524	278	1	80	0.0125000
NODE_4206_length_1166_cov_313.815370	444	524	280	1	80	0.0125000
NODE_4206_length_1166_cov_313.815370	444	524	286	1	80	0.0125000
NODE_4206_length_1166_cov_313.815370	444	524	294	1	80	0.0125000
NODE_4206_length_1166_cov_313.815370	444	524	306	2	80	0.0250000
NODE_4206_length_1166_cov_313.815370	444	524	307	2	80	0.0250000
NODE_4206_length_1166_cov_313.815370	444	524	312	1	80	0.0125000
NODE_4206_length_1166_cov_313.815370	444	524	313	2	80	0.0250000
NODE_4206_length_1166_cov_313.815370	444	524	315	1	80	0.0125000
NODE_4206_length_1166_cov_313.815370	444	524	348	1	80	0.0125000
NODE_4206_length_1166_cov_313.815370	444	524	359	1	80	0.0125000
NODE_4206_length_1166_cov_313.815370	444	524	364	1	80	0.0125000
NODE_4206_length_1166_cov_313.815370	444	524	374	1	80	0.0125000
NODE_4206_length_1166_cov_313.815370	444	524	377	1	80	0.0125000
NODE_4206_length_1166_cov_313.815370	444	524	379	1	80	0.0125000
NODE_4206_length_1166_cov_313.815370	444	524	380	1	80	0.0125000
NODE_4206_length_1166_cov_313.815370	444	524	387	1	80	0.0125000
NODE_4206_length_1166_cov_313.815370	444	524	396	1	80	0.0125000
NODE_4206_length_1166_cov_313.815370	444	524	405	1	80	0.0125000
NODE_4206_length_1166_cov_313.815370	444	524	409	1	80	0.0125000
NODE_4206_length_1166_cov_313.815370	444	524	412	1	80	0.0125000
NODE_4206_length_1166_cov_313.815370	444	524	424	1	80	0.0125000
NODE_4206_length_1166_cov_313.815370	444	524	425	1	80	0.0125000
NODE_4206_length_1166_cov_313.815370	444	524	458	3	80	0.0375000
NODE_4206_length_1166_cov_313.815370	444	524	462	1	80	0.0125000
NODE_4206_length_1166_cov_313.815370	444	524	465	1	80	0.0125000
NODE_4206_length_1166_cov_313.815370	444	524	479	1	80	0.0125000
NODE_4206_length_1166_cov_313.815370	444	524	480	1	80	0.0125000
NODE_4206_length_1166_cov_313.815370	444	524	481	1	80	0.0125000
NODE_4206_length_1166_cov_313.815370	444	524	483	1	80	0.0125000
NODE_4206_length_1166_cov_313.815370	444	524	500	1	80	0.0125000
NODE_4206_length_1166_cov_313.815370	444	524	506	1	80	0.0125000
NODE_4206_length_1166_cov_313.815370	444	524	517	1	80	0.0125000
NODE_4206_length_1166_cov_313.815370	444	524	518	2	80	0.0250000
NODE_4206_length_1166_cov_313.815370	444	524	520	2	80	0.0250000
NODE_4206_length_1166_cov_313.815370	444	524	522	1	80	0.0125000
NODE_4206_length_1166_cov_313.815370	444	524	88	13	80	0.1625000
NODE_4206_length_1166_cov_313.815370	444	524	90	2	80	0.0250000
NODE_4206_length_1166_cov_313.815370	444	524	99	1	80	0.0125000
NODE_4206_length_1166_cov_313.815370	444	524	101	1	80	0.0125000
NODE_4206_length_1166_cov_313.815370	444	524	136	1	80	0.0125000
NODE_4206_length_1166_cov_313.815370	444	524	137	2	80	0.0250000
NODE_4206_length_1166_cov_313.815370	444	524	140	1	80	0.0125000
NODE_4206_length_1166_cov_313.815370	444	524	164	1	80	0.0125000
NODE_4206_length_1166_cov_313.815370	444	524	171	1	80	0.0125000
NODE_4206_length_1166_cov_313.815370	444	524	172	1	80	0.0125000
NODE_4206_length_1166_cov_313.815370	444	524	174	1	80	0.0125000
NODE_4206_length_1166_cov_313.815370	444	524	180	3	80	0.0375000
NODE_4206_length_1166_cov_313.815370	444	524	194	1	80	0.0125000
NODE_4206_length_1166_cov_313.815370	444	524	204	1	80	0.0125000
NODE_4206_length_1166_cov_313.815370	444	524	221	1	80	0.0125000
NODE_4206_length_1166_cov_313.815370	444	524	232	1	80	0.0125000
NODE_4206_length_1166_cov_313.815370	444	524	234	1	80	0.0125000
NODE_4206_length_1166_cov_313.815370	444	524	237	1	80	0.0125000
NODE_4206_length_1166_cov_313.815370	444	524	257	1	80	0.0125000
NODE_4206_length_1166_cov_313.815370	444	524	263	1	80	0.0125000
NODE_4206_length_1166_cov_313.815370	444	524	266	1	80	0.0125000
NODE_4206_length_1166_cov_313.815370	444	524	278	1	80	0.0125000
NODE_4206_length_1166_cov_313.815370	444	524	280	1	80	0.0125000
NODE_4206_length_1166_cov_313.815370	444	524	286	1	80	0.0125000
NODE_4206_length_1166_cov_313.815370	444	524	294	1	80	0.0125000
NODE_4206_length_1166_cov_313.815370	444	524	306	2	80	0.0250000
NODE_4206_length_1166_cov_313.815370	444	524	307	2	80	0.0250000
NODE_4206_length_1166_cov_313.815370	444	524	312	1	80	0.0125000
NODE_4206_length_1166_cov_313.815370	444	524	313	2	80	0.0250000
NODE_4206_length_1166_cov_313.815370	444	524	315	1	80	0.0125000
NODE_4206_length_1166_cov_313.815370	444	524	348	1	80	0.0125000
NODE_4206_length_1166_cov_313.815370	444	524	359	1	80	0.0125000
NODE_4206_length_1166_cov_313.815370	444	524	364	1	80	0.0125000
NODE_4206_length_1166_cov_313.815370	444	524	374	1	80	0.0125000
NODE_4206_length_1166_cov_313.815370	444	524	377	1	80	0.0125000
NODE_4206_length_1166_cov_313.815370	444	524	379	1	80	0.0125000
NODE_4206_length_1166_cov_313.815370	444	524	380	1	80	0.0125000
NODE_4206_length_1166_cov_313.815370	444	524	387	1	80	0.0125000
NODE_4206_length_1166_cov_313.815370	444	524	396	1	80	0.0125000
NODE_4206_length_1166_cov_313.815370	444	524	405	1	80	0.0125000
NODE_4206_length_1166_cov_313.815370	444	524	409	1	80	0.0125000
NODE_4206_length_1166_cov_313.815370	444	524	412	1	80	0.0125000
NODE_4206_length_1166_cov_313.815370	444	524	424	1	80	0.0125000
NODE_4206_length_1166_cov_313.815370	444	524	425	1	80	0.0125000
NODE_4206_length_1166_cov_313.815370	444	524	458	3	80	0.0375000
NODE_4206_length_1166_cov_313.815370	444	524	462	1	80	0.0125000
NODE_4206_length_1166_cov_313.815370	444	524	465	1	80	0.0125000
NODE_4206_length_1166_cov_313.815370	444	524	479	1	80	0.0125000
NODE_4206_length_1166_cov_313.815370	444	524	480	1	80	0.0125000
NODE_4206_length_1166_cov_313.815370	444	524	481	1	80	0.0125000
NODE_4206_length_1166_cov_313.815370	444	524	483	1	80	0.0125000
NODE_4206_length_1166_cov_313.815370	444	524	500	1	80	0.0125000
NODE_4206_length_1166_cov_313.815370	444	524	506	1	80	0.0125000
NODE_4206_length_1166_cov_313.815370	444	524	517	1	80	0.0125000
NODE_4206_length_1166_cov_313.815370	444	524	518	2	80	0.0250000
NODE_4206_length_1166_cov_313.815370	444	524	520	2	80	0.0250000
NODE_4206_length_1166_cov_313.815370	444	524	522	1	80	0.0125000
NODE_4206_length_1166_cov_313.815370	497	577	377	1	80	0.0125000
NODE_4206_length_1166_cov_313.815370	497	577	379	1	80	0.0125000
NODE_4206_length_1166_cov_313.815370	497	577	380	1	80	0.0125000
NODE_4206_length_1166_cov_313.815370	497	577	387	1	80	0.0125000
NODE_4206_length_1166_cov_313.815370	497	577	396	1	80	0.0125000
NODE_4206_length_1166_cov_313.815370	497	577	405	1	80	0.0125000
NODE_4206_length_1166_cov_313.815370	497	577	409	1	80	0.0125000
NODE_4206_length_1166_cov_313.815370	497	577	412	1	80	0.0125000
NODE_4206_length_1166_cov_313.815370	497	577	424	1	80	0.0125000
NODE_4206_length_1166_cov_313.815370	497	577	425	1	80	0.0125000
NODE_4206_length_1166_cov_313.815370	497	577	458	3	80	0.0375000
NODE_4206_length_1166_cov_313.815370	497	577	462	1	80	0.0125000
NODE_4206_length_1166_cov_313.815370	497	577	465	1	80	0.0125000
NODE_4206_length_1166_cov_313.815370	497	577	479	1	80	0.0125000
NODE_4206_length_1166_cov_313.815370	497	577	480	1	80	0.0125000
NODE_4206_length_1166_cov_313.815370	497	577	481	1	80	0.0125000
NODE_4206_length_1166_cov_313.815370	497	577	483	1	80	0.0125000
NODE_4206_length_1166_cov_313.815370	497	577	500	1	80	0.0125000
NODE_4206_length_1166_cov_313.815370	497	577	506	1	80	0.0125000
NODE_4206_length_1166_cov_313.815370	497	577	517	1	80	0.0125000
NODE_4206_length_1166_cov_313.815370	497	577	518	2	80	0.0250000
NODE_4206_length_1166_cov_313.815370	497	577	520	2	80	0.0250000
NODE_4206_length_1166_cov_313.815370	497	577	522	1	80	0.0125000
NODE_4206_length_1166_cov_313.815370	497	577	523	1	80	0.0125000
NODE_4206_length_1166_cov_313.815370	497	577	537	1	80	0.0125000
NODE_4206_length_1166_cov_313.815370	497	577	539	2	80	0.0250000
NODE_4206_length_1166_cov_313.815370	497	577	540	1	80	0.0125000
NODE_4206_length_1166_cov_313.815370	497	577	545	1	80	0.0125000
NODE_4206_length_1166_cov_313.815370	497	577	556	9	80	0.1125000
NODE_4206_length_1166_cov_313.815370	497	577	557	12	80	0.1500000
NODE_4206_length_1166_cov_313.815370	497	577	558	5	80	0.0625000
NODE_4206_length_1166_cov_313.815370	497	577	560	3	80	0.0375000
NODE_4206_length_1166_cov_313.815370	497	577	561	6	80	0.0750000
NODE_4206_length_1166_cov_313.815370	497	577	562	2	80	0.0250000
NODE_4206_length_1166_cov_313.815370	497	577	564	4	80	0.0500000
NODE_4206_length_1166_cov_313.815370	497	577	566	1	80	0.0125000
NODE_4206_length_1166_cov_313.815370	497	577	567	1	80	0.0125000
NODE_4206_length_1166_cov_313.815370	497	577	568	2	80	0.0250000
NODE_4206_length_1166_cov_313.815370	497	577	569	2	80	0.0250000
NODE_4206_length_1166_cov_313.815370	497	577	377	1	80	0.0125000
NODE_4206_length_1166_cov_313.815370	497	577	379	1	80	0.0125000
NODE_4206_length_1166_cov_313.815370	497	577	380	1	80	0.0125000
NODE_4206_length_1166_cov_313.815370	497	577	387	1	80	0.0125000
NODE_4206_length_1166_cov_313.815370	497	577	396	1	80	0.0125000
NODE_4206_length_1166_cov_313.815370	497	577	405	1	80	0.0125000
NODE_4206_length_1166_cov_313.815370	497	577	409	1	80	0.0125000
NODE_4206_length_1166_cov_313.815370	497	577	412	1	80	0.0125000
NODE_4206_length_1166_cov_313.815370	497	577	424	1	80	0.0125000
NODE_4206_length_1166_cov_313.815370	497	577	425	1	80	0.0125000
NODE_4206_length_1166_cov_313.815370	497	577	458	3	80	0.0375000
NODE_4206_length_1166_cov_313.815370	497	577	462	1	80	0.0125000
NODE_4206_length_1166_cov_313.815370	497	577	465	1	80	0.0125000
NODE_4206_length_1166_cov_313.815370	497	577	479	1	80	0.0125000
NODE_4206_length_1166_cov_313.815370	497	577	480	1	80	0.0125000
NODE_4206_length_1166_cov_313.815370	497	577	481	1	80	0.0125000
NODE_4206_length_1166_cov_313.815370	497	577	483	1	80	0.0125000
NODE_4206_length_1166_cov_313.815370	497	577	500	1	80	0.0125000
NODE_4206_length_1166_cov_313.815370	497	577	506	1	80	0.0125000
NODE_4206_length_1166_cov_313.815370	497	577	517	1	80	0.0125000
NODE_4206_length_1166_cov_313.815370	497	577	518	2	80	0.0250000
NODE_4206_length_1166_cov_313.815370	497	577	520	2	80	0.0250000
NODE_4206_length_1166_cov_313.815370	497	577	522	1	80	0.0125000
NODE_4206_length_1166_cov_313.815370	497	577	523	1	80	0.0125000
NODE_4206_length_1166_cov_313.815370	497	577	537	1	80	0.0125000
NODE_4206_length_1166_cov_313.815370	497	577	539	2	80	0.0250000
NODE_4206_length_1166_cov_313.815370	497	577	540	1	80	0.0125000
NODE_4206_length_1166_cov_313.815370	497	577	545	1	80	0.0125000
NODE_4206_length_1166_cov_313.815370	497	577	556	9	80	0.1125000
NODE_4206_length_1166_cov_313.815370	497	577	557	12	80	0.1500000
NODE_4206_length_1166_cov_313.815370	497	577	558	5	80	0.0625000
NODE_4206_length_1166_cov_313.815370	497	577	560	3	80	0.0375000
NODE_4206_length_1166_cov_313.815370	497	577	561	6	80	0.0750000
NODE_4206_length_1166_cov_313.815370	497	577	562	2	80	0.0250000
NODE_4206_length_1166_cov_313.815370	497	577	564	4	80	0.0500000
NODE_4206_length_1166_cov_313.815370	497	577	566	1	80	0.0125000
NODE_4206_length_1166_cov_313.815370	497	577	567	1	80	0.0125000
NODE_4206_length_1166_cov_313.815370	497	577	568	2	80	0.0250000
NODE_4206_length_1166_cov_313.815370	497	577	569	2	80	0.0250000
NODE_4206_length_1166_cov_313.815370	497	577	377	1	80	0.0125000
NODE_4206_length_1166_cov_313.815370	497	577	379	1	80	0.0125000
NODE_4206_length_1166_cov_313.815370	497	577	380	1	80	0.0125000
NODE_4206_length_1166_cov_313.815370	497	577	387	1	80	0.0125000
NODE_4206_length_1166_cov_313.815370	497	577	396	1	80	0.0125000
NODE_4206_length_1166_cov_313.815370	497	577	405	1	80	0.0125000
NODE_4206_length_1166_cov_313.815370	497	577	409	1	80	0.0125000
NODE_4206_length_1166_cov_313.815370	497	577	412	1	80	0.0125000
NODE_4206_length_1166_cov_313.815370	497	577	424	1	80	0.0125000
NODE_4206_length_1166_cov_313.815370	497	577	425	1	80	0.0125000
NODE_4206_length_1166_cov_313.815370	497	577	458	3	80	0.0375000
NODE_4206_length_1166_cov_313.815370	497	577	462	1	80	0.0125000
NODE_4206_length_1166_cov_313.815370	497	577	465	1	80	0.0125000
NODE_4206_length_1166_cov_313.815370	497	577	479	1	80	0.0125000
NODE_4206_length_1166_cov_313.815370	497	577	480	1	80	0.0125000
NODE_4206_length_1166_cov_313.815370	497	577	481	1	80	0.0125000
NODE_4206_length_1166_cov_313.815370	497	577	483	1	80	0.0125000
NODE_4206_length_1166_cov_313.815370	497	577	500	1	80	0.0125000
NODE_4206_length_1166_cov_313.815370	497	577	506	1	80	0.0125000
NODE_4206_length_1166_cov_313.815370	497	577	517	1	80	0.0125000
NODE_4206_length_1166_cov_313.815370	497	577	518	2	80	0.0250000
NODE_4206_length_1166_cov_313.815370	497	577	520	2	80	0.0250000
NODE_4206_length_1166_cov_313.815370	497	577	522	1	80	0.0125000
NODE_4206_length_1166_cov_313.815370	497	577	523	1	80	0.0125000
NODE_4206_length_1166_cov_313.815370	497	577	537	1	80	0.0125000
NODE_4206_length_1166_cov_313.815370	497	577	539	2	80	0.0250000
NODE_4206_length_1166_cov_313.815370	497	577	540	1	80	0.0125000
NODE_4206_length_1166_cov_313.815370	497	577	545	1	80	0.0125000
NODE_4206_length_1166_cov_313.815370	497	577	556	9	80	0.1125000
NODE_4206_length_1166_cov_313.815370	497	577	557	12	80	0.1500000
NODE_4206_length_1166_cov_313.815370	497	577	558	5	80	0.0625000
NODE_4206_length_1166_cov_313.815370	497	577	560	3	80	0.0375000
NODE_4206_length_1166_cov_313.815370	497	577	561	6	80	0.0750000
NODE_4206_length_1166_cov_313.815370	497	577	562	2	80	0.0250000
NODE_4206_length_1166_cov_313.815370	497	577	564	4	80	0.0500000
NODE_4206_length_1166_cov_313.815370	497	577	566	1	80	0.0125000
NODE_4206_length_1166_cov_313.815370	497	577	567	1	80	0.0125000
NODE_4206_length_1166_cov_313.815370	497	577	568	2	80	0.0250000
NODE_4206_length_1166_cov_313.815370	497	577	569	2	80	0.0250000
NODE_4206_length_1166_cov_313.815370	497	577	377	1	80	0.0125000
NODE_4206_length_1166_cov_313.815370	497	577	379	1	80	0.0125000
NODE_4206_length_1166_cov_313.815370	497	577	380	1	80	0.0125000
NODE_4206_length_1166_cov_313.815370	497	577	387	1	80	0.0125000
NODE_4206_length_1166_cov_313.815370	497	577	396	1	80	0.0125000
NODE_4206_length_1166_cov_313.815370	497	577	405	1	80	0.0125000
NODE_4206_length_1166_cov_313.815370	497	577	409	1	80	0.0125000
NODE_4206_length_1166_cov_313.815370	497	577	412	1	80	0.0125000
NODE_4206_length_1166_cov_313.815370	497	577	424	1	80	0.0125000
NODE_4206_length_1166_cov_313.815370	497	577	425	1	80	0.0125000
NODE_4206_length_1166_cov_313.815370	497	577	458	3	80	0.0375000
NODE_4206_length_1166_cov_313.815370	497	577	462	1	80	0.0125000
NODE_4206_length_1166_cov_313.815370	497	577	465	1	80	0.0125000
NODE_4206_length_1166_cov_313.815370	497	577	479	1	80	0.0125000
NODE_4206_length_1166_cov_313.815370	497	577	480	1	80	0.0125000
NODE_4206_length_1166_cov_313.815370	497	577	481	1	80	0.0125000
NODE_4206_length_1166_cov_313.815370	497	577	483	1	80	0.0125000
NODE_4206_length_1166_cov_313.815370	497	577	500	1	80	0.0125000
NODE_4206_length_1166_cov_313.815370	497	577	506	1	80	0.0125000
NODE_4206_length_1166_cov_313.815370	497	577	517	1	80	0.0125000
NODE_4206_length_1166_cov_313.815370	497	577	518	2	80	0.0250000
NODE_4206_length_1166_cov_313.815370	497	577	520	2	80	0.0250000
NODE_4206_length_1166_cov_313.815370	497	577	522	1	80	0.0125000
NODE_4206_length_1166_cov_313.815370	497	577	523	1	80	0.0125000
NODE_4206_length_1166_cov_313.815370	497	577	537	1	80	0.0125000
NODE_4206_length_1166_cov_313.815370	497	577	539	2	80	0.0250000
NODE_4206_length_1166_cov_313.815370	497	577	540	1	80	0.0125000
NODE_4206_length_1166_cov_313.815370	497	577	545	1	80	0.0125000
NODE_4206_length_1166_cov_313.815370	497	577	556	9	80	0.1125000
NODE_4206_length_1166_cov_313.815370	497	577	557	12	80	0.1500000
NODE_4206_length_1166_cov_313.815370	497	577	558	5	80	0.0625000
NODE_4206_length_1166_cov_313.815370	497	577	560	3	80	0.0375000
NODE_4206_length_1166_cov_313.815370	497	577	561	6	80	0.0750000
NODE_4206_length_1166_cov_313.815370	497	577	562	2	80	0.0250000
NODE_4206_length_1166_cov_313.815370	497	577	564	4	80	0.0500000
NODE_4206_length_1166_cov_313.815370	497	577	566	1	80	0.0125000
NODE_4206_length_1166_cov_313.815370	497	577	567	1	80	0.0125000
NODE_4206_length_1166_cov_313.815370	497	577	568	2	80	0.0250000
NODE_4206_length_1166_cov_313.815370	497	577	569	2	80	0.0250000
NODE_4206_length_1166_cov_313.815370	497	577	377	1	80	0.0125000
NODE_4206_length_1166_cov_313.815370	497	577	379	1	80	0.0125000
NODE_4206_length_1166_cov_313.815370	497	577	380	1	80	0.0125000
NODE_4206_length_1166_cov_313.815370	497	577	387	1	80	0.0125000
NODE_4206_length_1166_cov_313.815370	497	577	396	1	80	0.0125000
NODE_4206_length_1166_cov_313.815370	497	577	405	1	80	0.0125000
NODE_4206_length_1166_cov_313.815370	497	577	409	1	80	0.0125000
NODE_4206_length_1166_cov_313.815370	497	577	412	1	80	0.0125000
NODE_4206_length_1166_cov_313.815370	497	577	424	1	80	0.0125000
NODE_4206_length_1166_cov_313.815370	497	577	425	1	80	0.0125000
NODE_4206_length_1166_cov_313.815370	497	577	458	3	80	0.0375000
NODE_4206_length_1166_cov_313.815370	497	577	462	1	80	0.0125000
NODE_4206_length_1166_cov_313.815370	497	577	465	1	80	0.0125000
NODE_4206_length_1166_cov_313.815370	497	577	479	1	80	0.0125000
NODE_4206_length_1166_cov_313.815370	497	577	480	1	80	0.0125000
NODE_4206_length_1166_cov_313.815370	497	577	481	1	80	0.0125000
NODE_4206_length_1166_cov_313.815370	497	577	483	1	80	0.0125000
NODE_4206_length_1166_cov_313.815370	497	577	500	1	80	0.0125000
NODE_4206_length_1166_cov_313.815370	497	577	506	1	80	0.0125000
NODE_4206_length_1166_cov_313.815370	497	577	517	1	80	0.0125000
NODE_4206_length_1166_cov_313.815370	497	577	518	2	80	0.0250000
NODE_4206_length_1166_cov_313.815370	497	577	520	2	80	0.0250000
NODE_4206_length_1166_cov_313.815370	497	577	522	1	80	0.0125000
NODE_4206_length_1166_cov_313.815370	497	577	523	1	80	0.0125000
NODE_4206_length_1166_cov_313.815370	497	577	537	1	80	0.0125000
NODE_4206_length_1166_cov_313.815370	497	577	539	2	80	0.0250000
NODE_4206_length_1166_cov_313.815370	497	577	540	1	80	0.0125000
NODE_4206_length_1166_cov_313.815370	497	577	545	1	80	0.0125000
NODE_4206_length_1166_cov_313.815370	497	577	556	9	80	0.1125000
NODE_4206_length_1166_cov_313.815370	497	577	557	12	80	0.1500000
NODE_4206_length_1166_cov_313.815370	497	577	558	5	80	0.0625000
NODE_4206_length_1166_cov_313.815370	497	577	560	3	80	0.0375000
NODE_4206_length_1166_cov_313.815370	497	577	561	6	80	0.0750000
NODE_4206_length_1166_cov_313.815370	497	577	562	2	80	0.0250000
NODE_4206_length_1166_cov_313.815370	497	577	564	4	80	0.0500000
NODE_4206_length_1166_cov_313.815370	497	577	566	1	80	0.0125000
NODE_4206_length_1166_cov_313.815370	497	577	567	1	80	0.0125000
NODE_4206_length_1166_cov_313.815370	497	577	568	2	80	0.0250000
NODE_4206_length_1166_cov_313.815370	497	577	569	2	80	0.0250000
NODE_4206_length_1166_cov_313.815370	497	577	377	1	80	0.0125000
NODE_4206_length_1166_cov_313.815370	497	577	379	1	80	0.0125000
NODE_4206_length_1166_cov_313.815370	497	577	380	1	80	0.0125000
NODE_4206_length_1166_cov_313.815370	497	577	387	1	80	0.0125000
NODE_4206_length_1166_cov_313.815370	497	577	396	1	80	0.0125000
NODE_4206_length_1166_cov_313.815370	497	577	405	1	80	0.0125000
NODE_4206_length_1166_cov_313.815370	497	577	409	1	80	0.0125000
NODE_4206_length_1166_cov_313.815370	497	577	412	1	80	0.0125000
NODE_4206_length_1166_cov_313.815370	497	577	424	1	80	0.0125000
NODE_4206_length_1166_cov_313.815370	497	577	425	1	80	0.0125000
NODE_4206_length_1166_cov_313.815370	497	577	458	3	80	0.0375000
NODE_4206_length_1166_cov_313.815370	497	577	462	1	80	0.0125000
NODE_4206_length_1166_cov_313.815370	497	577	465	1	80	0.0125000
NODE_4206_length_1166_cov_313.815370	497	577	479	1	80	0.0125000
NODE_4206_length_1166_cov_313.815370	497	577	480	1	80	0.0125000
NODE_4206_length_1166_cov_313.815370	497	577	481	1	80	0.0125000
NODE_4206_length_1166_cov_313.815370	497	577	483	1	80	0.0125000
NODE_4206_length_1166_cov_313.815370	497	577	500	1	80	0.0125000
NODE_4206_length_1166_cov_313.815370	497	577	506	1	80	0.0125000
NODE_4206_length_1166_cov_313.815370	497	577	517	1	80	0.0125000
NODE_4206_length_1166_cov_313.815370	497	577	518	2	80	0.0250000
NODE_4206_length_1166_cov_313.815370	497	577	520	2	80	0.0250000
NODE_4206_length_1166_cov_313.815370	497	577	522	1	80	0.0125000
NODE_4206_length_1166_cov_313.815370	497	577	523	1	80	0.0125000
NODE_4206_length_1166_cov_313.815370	497	577	537	1	80	0.0125000
NODE_4206_length_1166_cov_313.815370	497	577	539	2	80	0.0250000
NODE_4206_length_1166_cov_313.815370	497	577	540	1	80	0.0125000
NODE_4206_length_1166_cov_313.815370	497	577	545	1	80	0.0125000
NODE_4206_length_1166_cov_313.815370	497	577	556	9	80	0.1125000
NODE_4206_length_1166_cov_313.815370	497	577	557	12	80	0.1500000
NODE_4206_length_1166_cov_313.815370	497	577	558	5	80	0.0625000
NODE_4206_length_1166_cov_313.815370	497	577	560	3	80	0.0375000
NODE_4206_length_1166_cov_313.815370	497	577	561	6	80	0.0750000
NODE_4206_length_1166_cov_313.815370	497	577	562	2	80	0.0250000
NODE_4206_length_1166_cov_313.815370	497	577	564	4	80	0.0500000
NODE_4206_length_1166_cov_313.815370	497	577	566	1	80	0.0125000
NODE_4206_length_1166_cov_313.815370	497	577	567	1	80	0.0125000
NODE_4206_length_1166_cov_313.815370	497	577	568	2	80	0.0250000
NODE_4206_length_1166_cov_313.815370	497	577	569	2	80	0.0250000
NODE_4206_length_1166_cov_313.815370	497	568	377	1	71	0.0140845
NODE_4206_length_1166_cov_313.815370	497	568	379	1	71	0.0140845
NODE_4206_length_1166_cov_313.815370	497	568	380	1	71	0.0140845
NODE_4206_length_1166_cov_313.815370	497	568	387	1	71	0.0140845
NODE_4206_length_1166_cov_313.815370	497	568	396	1	71	0.0140845
NODE_4206_length_1166_cov_313.815370	497	568	405	1	71	0.0140845
NODE_4206_length_1166_cov_313.815370	497	568	409	1	71	0.0140845
NODE_4206_length_1166_cov_313.815370	497	568	412	1	71	0.0140845
NODE_4206_length_1166_cov_313.815370	497	568	424	1	71	0.0140845
NODE_4206_length_1166_cov_313.815370	497	568	425	1	71	0.0140845
NODE_4206_length_1166_cov_313.815370	497	568	458	3	71	0.0422535
NODE_4206_length_1166_cov_313.815370	497	568	462	1	71	0.0140845
NODE_4206_length_1166_cov_313.815370	497	568	465	1	71	0.0140845
NODE_4206_length_1166_cov_313.815370	497	568	479	1	71	0.0140845
NODE_4206_length_1166_cov_313.815370	497	568	480	1	71	0.0140845
NODE_4206_length_1166_cov_313.815370	497	568	481	1	71	0.0140845
NODE_4206_length_1166_cov_313.815370	497	568	483	1	71	0.0140845
NODE_4206_length_1166_cov_313.815370	497	568	500	1	71	0.0140845
NODE_4206_length_1166_cov_313.815370	497	568	506	1	71	0.0140845
NODE_4206_length_1166_cov_313.815370	497	568	517	1	71	0.0140845
NODE_4206_length_1166_cov_313.815370	497	568	518	2	71	0.0281690
NODE_4206_length_1166_cov_313.815370	497	568	520	2	71	0.0281690
NODE_4206_length_1166_cov_313.815370	497	568	522	1	71	0.0140845
NODE_4206_length_1166_cov_313.815370	497	568	523	1	71	0.0140845
NODE_4206_length_1166_cov_313.815370	497	568	537	1	71	0.0140845
NODE_4206_length_1166_cov_313.815370	497	568	539	2	71	0.0281690
NODE_4206_length_1166_cov_313.815370	497	568	540	1	71	0.0140845
NODE_4206_length_1166_cov_313.815370	497	568	545	1	71	0.0140845
NODE_4206_length_1166_cov_313.815370	497	568	557	12	71	0.1690141
NODE_4206_length_1166_cov_313.815370	497	568	558	5	71	0.0704225
NODE_4206_length_1166_cov_313.815370	497	568	560	3	71	0.0422535
NODE_4206_length_1166_cov_313.815370	497	568	561	6	71	0.0845070
NODE_4206_length_1166_cov_313.815370	497	568	562	2	71	0.0281690
NODE_4206_length_1166_cov_313.815370	497	568	564	4	71	0.0563380
NODE_4206_length_1166_cov_313.815370	497	568	566	1	71	0.0140845
NODE_4206_length_1166_cov_313.815370	497	568	567	1	71	0.0140845
NODE_4206_length_1166_cov_313.815370	497	568	568	2	71	0.0281690
NODE_4206_length_1166_cov_313.815370	497	568	569	2	71	0.0281690
NODE_4206_length_1166_cov_313.815370	500	570	387	1	70	0.0142857
NODE_4206_length_1166_cov_313.815370	500	570	396	1	70	0.0142857
NODE_4206_length_1166_cov_313.815370	500	570	405	1	70	0.0142857
NODE_4206_length_1166_cov_313.815370	500	570	409	1	70	0.0142857
NODE_4206_length_1166_cov_313.815370	500	570	412	1	70	0.0142857
NODE_4206_length_1166_cov_313.815370	500	570	424	1	70	0.0142857
NODE_4206_length_1166_cov_313.815370	500	570	425	1	70	0.0142857
NODE_4206_length_1166_cov_313.815370	500	570	458	3	70	0.0428571
NODE_4206_length_1166_cov_313.815370	500	570	462	1	70	0.0142857
NODE_4206_length_1166_cov_313.815370	500	570	465	1	70	0.0142857
NODE_4206_length_1166_cov_313.815370	500	570	479	1	70	0.0142857
NODE_4206_length_1166_cov_313.815370	500	570	480	1	70	0.0142857
NODE_4206_length_1166_cov_313.815370	500	570	481	1	70	0.0142857
NODE_4206_length_1166_cov_313.815370	500	570	483	1	70	0.0142857
NODE_4206_length_1166_cov_313.815370	500	570	500	1	70	0.0142857
NODE_4206_length_1166_cov_313.815370	500	570	506	1	70	0.0142857
NODE_4206_length_1166_cov_313.815370	500	570	517	1	70	0.0142857
NODE_4206_length_1166_cov_313.815370	500	570	518	2	70	0.0285714
NODE_4206_length_1166_cov_313.815370	500	570	520	2	70	0.0285714
NODE_4206_length_1166_cov_313.815370	500	570	522	1	70	0.0142857
NODE_4206_length_1166_cov_313.815370	500	570	523	1	70	0.0142857
NODE_4206_length_1166_cov_313.815370	500	570	537	1	70	0.0142857
NODE_4206_length_1166_cov_313.815370	500	570	539	2	70	0.0285714
NODE_4206_length_1166_cov_313.815370	500	570	540	1	70	0.0142857
NODE_4206_length_1166_cov_313.815370	500	570	545	1	70	0.0142857
NODE_4206_length_1166_cov_313.815370	500	570	556	2	70	0.0285714
NODE_4206_length_1166_cov_313.815370	500	570	557	12	70	0.1714286
NODE_4206_length_1166_cov_313.815370	500	570	558	5	70	0.0714286
NODE_4206_length_1166_cov_313.815370	500	570	560	3	70	0.0428571
NODE_4206_length_1166_cov_313.815370	500	570	561	6	70	0.0857143
NODE_4206_length_1166_cov_313.815370	500	570	562	2	70	0.0285714
NODE_4206_length_1166_cov_313.815370	500	570	564	4	70	0.0571429
NODE_4206_length_1166_cov_313.815370	500	570	566	1	70	0.0142857
NODE_4206_length_1166_cov_313.815370	500	570	567	1	70	0.0142857
NODE_4206_length_1166_cov_313.815370	500	570	568	2	70	0.0285714
NODE_4206_length_1166_cov_313.815370	500	570	569	2	70	0.0285714
NODE_4206_length_1166_cov_313.815370	997	1077	2	14	80	0.1750000
NODE_4206_length_1166_cov_313.815370	997	1077	20	16	80	0.2000000
NODE_4206_length_1166_cov_313.815370	997	1077	22	21	80	0.2625000
NODE_4206_length_1166_cov_313.815370	997	1077	26	6	80	0.0750000
NODE_4206_length_1166_cov_313.815370	997	1077	28	2	80	0.0250000
NODE_4206_length_1166_cov_313.815370	997	1077	30	1	80	0.0125000
NODE_4206_length_1166_cov_313.815370	997	1077	32	20	80	0.2500000
NODE_4206_length_1166_cov_313.815370	1050	1130	11	3	80	0.0375000
NODE_4206_length_1166_cov_313.815370	1050	1130	26	4	80	0.0500000
NODE_4206_length_1166_cov_313.815370	1050	1130	28	2	80	0.0250000
NODE_4206_length_1166_cov_313.815370	1050	1130	29	29	80	0.3625000
NODE_4206_length_1166_cov_313.815370	1050	1130	30	6	80	0.0750000
NODE_4206_length_1166_cov_313.815370	1050	1130	32	36	80	0.4500000
NODE_4206_length_1166_cov_313.815370	1050	1130	11	3	80	0.0375000
NODE_4206_length_1166_cov_313.815370	1050	1130	26	4	80	0.0500000
NODE_4206_length_1166_cov_313.815370	1050	1130	28	2	80	0.0250000
NODE_4206_length_1166_cov_313.815370	1050	1130	29	29	80	0.3625000
NODE_4206_length_1166_cov_313.815370	1050	1130	30	6	80	0.0750000
NODE_4206_length_1166_cov_313.815370	1050	1130	32	36	80	0.4500000
NODE_4206_length_1166_cov_313.815370	1050	1121	26	4	71	0.0563380
NODE_4206_length_1166_cov_313.815370	1050	1121	28	2	71	0.0281690
NODE_4206_length_1166_cov_313.815370	1050	1121	29	23	71	0.3239437
NODE_4206_length_1166_cov_313.815370	1050	1121	30	6	71	0.0845070
NODE_4206_length_1166_cov_313.815370	1050	1121	32	36	71	0.5070422
NODE_4207_length_1166_cov_25.107779	561	641	0	34	80	0.4250000
NODE_4207_length_1166_cov_25.107779	561	641	8	46	80	0.5750000
NODE_4207_length_1166_cov_25.107779	614	694	8	80	80	1.0000000
NODE_4209_length_1166_cov_18.820056	325	405	0	76	80	0.9500000
NODE_4209_length_1166_cov_18.820056	325	405	2	4	80	0.0500000
NODE_4209_length_1166_cov_18.820056	378	458	0	23	80	0.2875000
NODE_4209_length_1166_cov_18.820056	378	458	2	57	80	0.7125000
NODE_4210_length_1166_cov_18.404873	676	756	4	2	80	0.0250000
NODE_4210_length_1166_cov_18.404873	676	756	6	20	80	0.2500000
NODE_4210_length_1166_cov_18.404873	676	756	8	11	80	0.1375000
NODE_4210_length_1166_cov_18.404873	676	756	10	3	80	0.0375000
NODE_4210_length_1166_cov_18.404873	676	756	12	44	80	0.5500000
NODE_4210_length_1166_cov_18.404873	729	809	2	13	80	0.1625000
NODE_4210_length_1166_cov_18.404873	729	809	6	1	80	0.0125000
NODE_4210_length_1166_cov_18.404873	729	809	7	14	80	0.1750000
NODE_4210_length_1166_cov_18.404873	729	809	8	32	80	0.4000000
NODE_4210_length_1166_cov_18.404873	729	809	10	7	80	0.0875000
NODE_4210_length_1166_cov_18.404873	729	809	12	13	80	0.1625000
NODE_4214_length_1166_cov_1.893158	0	71	0	71	71	1.0000000
NODE_4214_length_1166_cov_1.893158	44	99	0	55	55	1.0000000
NODE_4218_length_1165_cov_29.402439	497	577	0	5	80	0.0625000
NODE_4218_length_1165_cov_29.402439	497	577	6	17	80	0.2125000
NODE_4218_length_1165_cov_29.402439	497	577	8	14	80	0.1750000
NODE_4218_length_1165_cov_29.402439	497	577	10	44	80	0.5500000
NODE_4218_length_1165_cov_29.402439	550	630	0	3	80	0.0375000
NODE_4218_length_1165_cov_29.402439	550	630	2	18	80	0.2250000
NODE_4218_length_1165_cov_29.402439	550	630	4	18	80	0.2250000
NODE_4218_length_1165_cov_29.402439	550	630	10	41	80	0.5125000
NODE_4218_length_1165_cov_29.402439	626	706	0	63	80	0.7875000
NODE_4218_length_1165_cov_29.402439	626	706	2	17	80	0.2125000
NODE_4218_length_1165_cov_29.402439	679	759	0	18	80	0.2250000
NODE_4218_length_1165_cov_29.402439	679	759	2	62	80	0.7750000
NODE_4219_length_1165_cov_28.366792	663	743	2	19	80	0.2375000
NODE_4219_length_1165_cov_28.366792	663	743	4	32	80	0.4000000
NODE_4219_length_1165_cov_28.366792	663	743	6	28	80	0.3500000
NODE_4219_length_1165_cov_28.366792	663	743	8	1	80	0.0125000
NODE_4219_length_1165_cov_28.366792	716	796	6	79	80	0.9875000
NODE_4219_length_1165_cov_28.366792	716	796	8	1	80	0.0125000
NODE_4220_length_1165_cov_23.841463	631	711	2	80	80	1.0000000
NODE_4220_length_1165_cov_23.841463	684	765	0	48	81	0.5925926
NODE_4220_length_1165_cov_23.841463	684	765	2	33	81	0.4074074
NODE_4220_length_1165_cov_23.841463	761	841	0	49	80	0.6125000
NODE_4220_length_1165_cov_23.841463	761	841	2	31	80	0.3875000
NODE_4220_length_1165_cov_23.841463	814	894	0	30	80	0.3750000
NODE_4220_length_1165_cov_23.841463	814	894	2	50	80	0.6250000
NODE_4221_length_1165_cov_21.883677	482	562	1	2	80	0.0250000
NODE_4221_length_1165_cov_21.883677	482	562	2	20	80	0.2500000
NODE_4221_length_1165_cov_21.883677	482	562	3	37	80	0.4625000
NODE_4221_length_1165_cov_21.883677	482	562	4	21	80	0.2625000
NODE_4221_length_1165_cov_21.883677	535	615	1	40	80	0.5000000
NODE_4221_length_1165_cov_21.883677	535	615	3	40	80	0.5000000
NODE_4222_length_1165_cov_14.591932	295	375	0	25	80	0.3125000
NODE_4222_length_1165_cov_14.591932	295	375	2	35	80	0.4375000
NODE_4222_length_1165_cov_14.591932	295	375	6	20	80	0.2500000
NODE_4222_length_1165_cov_14.591932	348	428	0	78	80	0.9750000
NODE_4222_length_1165_cov_14.591932	348	428	2	2	80	0.0250000
NODE_4223_length_1165_cov_13.683865	502	582	2	80	80	1.0000000
NODE_4223_length_1165_cov_13.683865	555	635	0	32	80	0.4000000
NODE_4223_length_1165_cov_13.683865	555	635	2	48	80	0.6000000
NODE_4224_length_1165_cov_7.915572	383	463	0	2	80	0.0250000
NODE_4224_length_1165_cov_7.915572	383	463	1	13	80	0.1625000
NODE_4224_length_1165_cov_7.915572	383	463	2	1	80	0.0125000
NODE_4224_length_1165_cov_7.915572	383	463	4	13	80	0.1625000
NODE_4224_length_1165_cov_7.915572	383	463	6	51	80	0.6375000
NODE_4224_length_1165_cov_7.915572	436	516	4	19	80	0.2375000
NODE_4224_length_1165_cov_7.915572	436	516	6	61	80	0.7625000
NODE_4225_length_1165_cov_7.466229	552	632	10	30	80	0.3750000
NODE_4225_length_1165_cov_7.466229	552	632	14	31	80	0.3875000
NODE_4225_length_1165_cov_7.466229	552	632	16	19	80	0.2375000
NODE_4225_length_1165_cov_7.466229	605	685	0	5	80	0.0625000
NODE_4225_length_1165_cov_7.466229	605	685	2	23	80	0.2875000
NODE_4225_length_1165_cov_7.466229	605	685	6	6	80	0.0750000
NODE_4225_length_1165_cov_7.466229	605	685	10	5	80	0.0625000
NODE_4225_length_1165_cov_7.466229	605	685	14	9	80	0.1125000
NODE_4225_length_1165_cov_7.466229	605	685	16	32	80	0.4000000
NODE_4226_length_1165_cov_5.617261	676	756	0	80	80	1.0000000
NODE_4226_length_1165_cov_5.617261	729	809	0	80	80	1.0000000
NODE_4227_length_1165_cov_3.658537	554	602	0	48	48	1.0000000
NODE_4233_length_1164_cov_55.273239	459	539	0	80	80	1.0000000
NODE_4233_length_1164_cov_55.273239	512	592	0	78	80	0.9750000
NODE_4233_length_1164_cov_55.273239	512	592	2	2	80	0.0250000
NODE_4234_length_1164_cov_44.183099	571	651	1	6	80	0.0750000
NODE_4234_length_1164_cov_44.183099	571	651	2	54	80	0.6750000
NODE_4234_length_1164_cov_44.183099	571	651	4	20	80	0.2500000
NODE_4234_length_1164_cov_44.183099	624	704	2	7	80	0.0875000
NODE_4234_length_1164_cov_44.183099	624	704	3	5	80	0.0625000
NODE_4234_length_1164_cov_44.183099	624	704	4	22	80	0.2750000
NODE_4234_length_1164_cov_44.183099	624	704	5	11	80	0.1375000
NODE_4234_length_1164_cov_44.183099	624	704	6	35	80	0.4375000
NODE_4234_length_1164_cov_44.183099	700	780	2	53	80	0.6625000
NODE_4234_length_1164_cov_44.183099	700	780	3	27	80	0.3375000
NODE_4234_length_1164_cov_44.183099	753	833	0	34	80	0.4250000
NODE_4234_length_1164_cov_44.183099	753	833	2	46	80	0.5750000
NODE_4235_length_1164_cov_14.277934	1029	1109	0	4	80	0.0500000
NODE_4235_length_1164_cov_14.277934	1029	1109	2	2	80	0.0250000
NODE_4235_length_1164_cov_14.277934	1029	1109	4	27	80	0.3375000
NODE_4235_length_1164_cov_14.277934	1029	1109	6	47	80	0.5875000
NODE_4235_length_1164_cov_14.277934	1097	1162	0	57	65	0.8769231
NODE_4235_length_1164_cov_14.277934	1097	1162	2	2	65	0.0307692
NODE_4235_length_1164_cov_14.277934	1097	1162	4	6	65	0.0923077
NODE_4236_length_1164_cov_12.880751	415	495	2	6	80	0.0750000
NODE_4236_length_1164_cov_12.880751	415	495	4	6	80	0.0750000
NODE_4236_length_1164_cov_12.880751	415	495	5	1	80	0.0125000
NODE_4236_length_1164_cov_12.880751	415	495	6	55	80	0.6875000
NODE_4236_length_1164_cov_12.880751	415	495	8	12	80	0.1500000
NODE_4236_length_1164_cov_12.880751	468	548	2	59	80	0.7375000
NODE_4236_length_1164_cov_12.880751	468	548	4	6	80	0.0750000
NODE_4236_length_1164_cov_12.880751	468	548	5	1	80	0.0125000
NODE_4236_length_1164_cov_12.880751	468	548	6	14	80	0.1750000
NODE_4237_length_1164_cov_6.924883	415	495	0	80	80	1.0000000
NODE_4237_length_1164_cov_6.924883	468	548	0	80	80	1.0000000
NODE_4245_length_1163_cov_36.315789	458	538	0	80	80	1.0000000
NODE_4245_length_1163_cov_36.315789	511	591	0	47	80	0.5875000
NODE_4245_length_1163_cov_36.315789	511	591	2	33	80	0.4125000
NODE_4245_length_1163_cov_36.315789	587	667	2	39	80	0.4875000
NODE_4245_length_1163_cov_36.315789	587	667	4	9	80	0.1125000
NODE_4245_length_1163_cov_36.315789	587	667	6	32	80	0.4000000
NODE_4245_length_1163_cov_36.315789	640	720	4	62	80	0.7750000
NODE_4245_length_1163_cov_36.315789	640	720	6	18	80	0.2250000
NODE_4246_length_1163_cov_29.466165	542	622	0	10	80	0.1250000
NODE_4246_length_1163_cov_29.466165	542	622	2	65	80	0.8125000
NODE_4246_length_1163_cov_29.466165	542	622	8	5	80	0.0625000
NODE_4246_length_1163_cov_29.466165	595	675	0	6	80	0.0750000
NODE_4246_length_1163_cov_29.466165	595	675	2	16	80	0.2000000
NODE_4246_length_1163_cov_29.466165	595	675	8	58	80	0.7250000
NODE_4246_length_1163_cov_29.466165	671	751	4	5	80	0.0625000
NODE_4246_length_1163_cov_29.466165	671	751	8	75	80	0.9375000
NODE_4246_length_1163_cov_29.466165	724	804	0	49	80	0.6125000
NODE_4246_length_1163_cov_29.466165	724	804	4	9	80	0.1125000
NODE_4246_length_1163_cov_29.466165	724	804	8	22	80	0.2750000
NODE_4247_length_1163_cov_15.107143	668	748	2	80	80	1.0000000
NODE_4247_length_1163_cov_15.107143	721	801	0	8	80	0.1000000
NODE_4247_length_1163_cov_15.107143	721	801	2	72	80	0.9000000
NODE_4248_length_1163_cov_14.347744	540	620	0	80	80	1.0000000
NODE_4248_length_1163_cov_14.347744	593	673	0	39	80	0.4875000
NODE_4248_length_1163_cov_14.347744	593	673	4	41	80	0.5125000
NODE_4249_length_1163_cov_11.650376	354	434	0	80	80	1.0000000
NODE_4249_length_1163_cov_11.650376	407	487	0	80	80	1.0000000
NODE_4249_length_1163_cov_11.650376	738	818	0	5	80	0.0625000
NODE_4249_length_1163_cov_11.650376	738	818	1	1	80	0.0125000
NODE_4249_length_1163_cov_11.650376	738	818	2	39	80	0.4875000
NODE_4249_length_1163_cov_11.650376	738	818	3	7	80	0.0875000
NODE_4249_length_1163_cov_11.650376	738	818	4	28	80	0.3500000
NODE_4249_length_1163_cov_11.650376	791	871	2	7	80	0.0875000
NODE_4249_length_1163_cov_11.650376	791	871	3	1	80	0.0125000
NODE_4249_length_1163_cov_11.650376	791	871	4	72	80	0.9000000
NODE_4253_length_1162_cov_30.049859	359	439	0	6	80	0.0750000
NODE_4253_length_1162_cov_30.049859	359	439	2	18	80	0.2250000
NODE_4253_length_1162_cov_30.049859	359	439	4	29	80	0.3625000
NODE_4253_length_1162_cov_30.049859	359	439	6	27	80	0.3375000
NODE_4253_length_1162_cov_30.049859	412	492	0	59	80	0.7375000
NODE_4253_length_1162_cov_30.049859	412	492	2	18	80	0.2250000
NODE_4253_length_1162_cov_30.049859	412	492	4	3	80	0.0375000
NODE_4254_length_1162_cov_25.960489	440	520	0	5	80	0.0625000
NODE_4254_length_1162_cov_25.960489	440	520	2	43	80	0.5375000
NODE_4254_length_1162_cov_25.960489	440	520	4	32	80	0.4000000
NODE_4254_length_1162_cov_25.960489	493	573	0	1	80	0.0125000
NODE_4254_length_1162_cov_25.960489	493	573	2	58	80	0.7250000
NODE_4254_length_1162_cov_25.960489	493	573	4	21	80	0.2625000
NODE_4254_length_1162_cov_25.960489	569	649	0	28	80	0.3500000
NODE_4254_length_1162_cov_25.960489	569	649	2	4	80	0.0500000
NODE_4254_length_1162_cov_25.960489	569	649	3	6	80	0.0750000
NODE_4254_length_1162_cov_25.960489	569	649	4	42	80	0.5250000
NODE_4254_length_1162_cov_25.960489	622	702	0	22	80	0.2750000
NODE_4254_length_1162_cov_25.960489	622	702	4	58	80	0.7250000
NODE_4255_length_1162_cov_24.843838	523	603	0	4	80	0.0500000
NODE_4255_length_1162_cov_24.843838	523	603	10	76	80	0.9500000
NODE_4255_length_1162_cov_24.843838	576	656	6	36	80	0.4500000
NODE_4255_length_1162_cov_24.843838	576	656	10	44	80	0.5500000
NODE_4255_length_1162_cov_24.843838	652	732	0	25	80	0.3125000
NODE_4255_length_1162_cov_24.843838	652	732	2	27	80	0.3375000
NODE_4255_length_1162_cov_24.843838	652	732	4	11	80	0.1375000
NODE_4255_length_1162_cov_24.843838	652	732	6	17	80	0.2125000
NODE_4255_length_1162_cov_24.843838	705	785	2	16	80	0.2000000
NODE_4255_length_1162_cov_24.843838	705	785	4	64	80	0.8000000
NODE_4257_length_1162_cov_17.131703	302	382	0	80	80	1.0000000
NODE_4257_length_1162_cov_17.131703	355	435	0	78	80	0.9750000
NODE_4257_length_1162_cov_17.131703	355	435	2	2	80	0.0250000
NODE_4257_length_1162_cov_17.131703	431	511	0	2	80	0.0250000
NODE_4257_length_1162_cov_17.131703	431	511	2	44	80	0.5500000
NODE_4257_length_1162_cov_17.131703	431	511	3	1	80	0.0125000
NODE_4257_length_1162_cov_17.131703	431	511	4	3	80	0.0375000
NODE_4257_length_1162_cov_17.131703	431	511	6	30	80	0.3750000
NODE_4257_length_1162_cov_17.131703	484	564	2	16	80	0.2000000
NODE_4257_length_1162_cov_17.131703	484	564	4	19	80	0.2375000
NODE_4257_length_1162_cov_17.131703	484	564	6	45	80	0.5625000
NODE_4258_length_1162_cov_14.766698	630	710	12	72	80	0.9000000
NODE_4258_length_1162_cov_14.766698	630	710	18	8	80	0.1000000
NODE_4258_length_1162_cov_14.766698	683	763	8	19	80	0.2375000
NODE_4258_length_1162_cov_14.766698	683	763	12	46	80	0.5750000
NODE_4258_length_1162_cov_14.766698	683	763	18	12	80	0.1500000
NODE_4258_length_1162_cov_14.766698	683	763	20	3	80	0.0375000
NODE_4259_length_1162_cov_13.968015	423	503	0	80	80	1.0000000
NODE_4259_length_1162_cov_13.968015	476	556	0	80	80	1.0000000
NODE_4264_length_1162_cov_1.977422	855	926	0	71	71	1.0000000
NODE_4264_length_1162_cov_1.977422	908	977	0	69	69	1.0000000
NODE_4264_length_1162_cov_1.977422	908	977	0	69	69	1.0000000
NODE_4266_length_1161_cov_33.312618	456	536	0	65	80	0.8125000
NODE_4266_length_1161_cov_33.312618	456	536	4	15	80	0.1875000
NODE_4266_length_1161_cov_33.312618	509	587	0	12	78	0.1538462
NODE_4266_length_1161_cov_33.312618	509	587	4	66	78	0.8461539
NODE_4267_length_1161_cov_30.466102	594	674	4	19	80	0.2375000
NODE_4267_length_1161_cov_30.466102	594	674	10	1	80	0.0125000
NODE_4267_length_1161_cov_30.466102	594	674	12	60	80	0.7500000
NODE_4267_length_1161_cov_30.466102	647	727	0	21	80	0.2625000
NODE_4267_length_1161_cov_30.466102	647	727	6	14	80	0.1750000
NODE_4267_length_1161_cov_30.466102	647	727	8	3	80	0.0375000
NODE_4267_length_1161_cov_30.466102	647	727	10	3	80	0.0375000
NODE_4267_length_1161_cov_30.466102	647	727	12	39	80	0.4875000
NODE_4268_length_1161_cov_29.628060	426	506	0	57	80	0.7125000
NODE_4268_length_1161_cov_29.628060	426	506	4	23	80	0.2875000
NODE_4268_length_1161_cov_29.628060	479	559	0	6	80	0.0750000
NODE_4268_length_1161_cov_29.628060	479	559	4	74	80	0.9250000
NODE_4268_length_1161_cov_29.628060	603	683	3	43	80	0.5375000
NODE_4268_length_1161_cov_29.628060	603	683	5	9	80	0.1125000
NODE_4268_length_1161_cov_29.628060	603	683	6	28	80	0.3500000
NODE_4268_length_1161_cov_29.628060	656	736	0	6	80	0.0750000
NODE_4268_length_1161_cov_29.628060	656	736	2	37	80	0.4625000
NODE_4268_length_1161_cov_29.628060	656	736	5	6	80	0.0750000
NODE_4268_length_1161_cov_29.628060	656	736	6	31	80	0.3875000
NODE_4269_length_1161_cov_22.923729	492	572	4	80	80	1.0000000
NODE_4269_length_1161_cov_22.923729	545	625	0	49	80	0.6125000
NODE_4269_length_1161_cov_22.923729	545	625	4	31	80	0.3875000
NODE_4269_length_1161_cov_22.923729	621	701	0	28	80	0.3500000
NODE_4269_length_1161_cov_22.923729	621	701	4	52	80	0.6500000
NODE_4269_length_1161_cov_22.923729	674	754	0	18	80	0.2250000
NODE_4269_length_1161_cov_22.923729	674	754	4	62	80	0.7750000
NODE_4270_length_1161_cov_20.184557	480	560	0	61	80	0.7625000
NODE_4270_length_1161_cov_20.184557	480	560	2	19	80	0.2375000
NODE_4270_length_1161_cov_20.184557	533	613	0	14	80	0.1750000
NODE_4270_length_1161_cov_20.184557	533	613	2	66	80	0.8250000
NODE_4271_length_1161_cov_17.437853	375	455	0	80	80	1.0000000
NODE_4271_length_1161_cov_17.437853	428	508	0	80	80	1.0000000
NODE_4272_length_1161_cov_14.062147	375	455	0	61	80	0.7625000
NODE_4272_length_1161_cov_14.062147	375	455	2	19	80	0.2375000
NODE_4272_length_1161_cov_14.062147	428	508	0	8	80	0.1000000
NODE_4272_length_1161_cov_14.062147	428	508	2	72	80	0.9000000
NODE_4273_length_1161_cov_12.304143	381	461	0	44	80	0.5500000
NODE_4273_length_1161_cov_12.304143	381	461	2	36	80	0.4500000
NODE_4273_length_1161_cov_12.304143	434	514	0	5	80	0.0625000
NODE_4273_length_1161_cov_12.304143	434	514	2	75	80	0.9375000
NODE_4274_length_1161_cov_10.297552	598	678	0	25	80	0.3125000
NODE_4274_length_1161_cov_10.297552	598	678	2	55	80	0.6875000
NODE_4274_length_1161_cov_10.297552	651	731	0	78	80	0.9750000
NODE_4274_length_1161_cov_10.297552	651	731	2	2	80	0.0250000
NODE_4283_length_1160_cov_86.515551	613	693	0	40	80	0.5000000
NODE_4283_length_1160_cov_86.515551	613	693	40	10	80	0.1250000
NODE_4283_length_1160_cov_86.515551	613	693	41	6	80	0.0750000
NODE_4283_length_1160_cov_86.515551	613	693	42	20	80	0.2500000
NODE_4283_length_1160_cov_86.515551	613	693	45	4	80	0.0500000
NODE_4283_length_1160_cov_86.515551	666	746	41	3	80	0.0375000
NODE_4283_length_1160_cov_86.515551	666	746	42	20	80	0.2500000
NODE_4283_length_1160_cov_86.515551	666	746	45	9	80	0.1125000
NODE_4283_length_1160_cov_86.515551	666	746	47	4	80	0.0500000
NODE_4283_length_1160_cov_86.515551	666	746	48	10	80	0.1250000
NODE_4283_length_1160_cov_86.515551	666	746	49	2	80	0.0250000
NODE_4283_length_1160_cov_86.515551	666	746	51	3	80	0.0375000
NODE_4283_length_1160_cov_86.515551	666	746	52	4	80	0.0500000
NODE_4283_length_1160_cov_86.515551	666	746	57	7	80	0.0875000
NODE_4283_length_1160_cov_86.515551	666	746	58	4	80	0.0500000
NODE_4283_length_1160_cov_86.515551	666	746	59	2	80	0.0250000
NODE_4283_length_1160_cov_86.515551	666	746	62	12	80	0.1500000
NODE_4284_length_1160_cov_29.272385	526	606	0	43	80	0.5375000
NODE_4284_length_1160_cov_29.272385	526	606	2	19	80	0.2375000
NODE_4284_length_1160_cov_29.272385	526	606	4	1	80	0.0125000
NODE_4284_length_1160_cov_29.272385	526	606	6	17	80	0.2125000
NODE_4284_length_1160_cov_29.272385	579	659	2	9	80	0.1125000
NODE_4284_length_1160_cov_29.272385	579	659	4	36	80	0.4500000
NODE_4284_length_1160_cov_29.272385	579	659	6	35	80	0.4375000
NODE_4285_length_1160_cov_21.391140	767	847	0	29	80	0.3625000
NODE_4285_length_1160_cov_21.391140	767	847	2	4	80	0.0500000
NODE_4285_length_1160_cov_21.391140	767	847	9	1	80	0.0125000
NODE_4285_length_1160_cov_21.391140	767	847	10	46	80	0.5750000
NODE_4296_length_1159_cov_147.794340	911	991	257	1	80	0.0125000
NODE_4296_length_1159_cov_147.794340	911	991	259	1	80	0.0125000
NODE_4296_length_1159_cov_147.794340	911	991	272	1	80	0.0125000
NODE_4296_length_1159_cov_147.794340	911	991	281	1	80	0.0125000
NODE_4296_length_1159_cov_147.794340	911	991	292	1	80	0.0125000
NODE_4296_length_1159_cov_147.794340	911	991	300	1	80	0.0125000
NODE_4296_length_1159_cov_147.794340	911	991	312	1	80	0.0125000
NODE_4296_length_1159_cov_147.794340	911	991	326	1	80	0.0125000
NODE_4296_length_1159_cov_147.794340	911	991	328	1	80	0.0125000
NODE_4296_length_1159_cov_147.794340	911	991	329	3	80	0.0375000
NODE_4296_length_1159_cov_147.794340	911	991	330	1	80	0.0125000
NODE_4296_length_1159_cov_147.794340	911	991	336	4	80	0.0500000
NODE_4296_length_1159_cov_147.794340	911	991	338	1	80	0.0125000
NODE_4296_length_1159_cov_147.794340	911	991	341	1	80	0.0125000
NODE_4296_length_1159_cov_147.794340	911	991	342	1	80	0.0125000
NODE_4296_length_1159_cov_147.794340	911	991	343	1	80	0.0125000
NODE_4296_length_1159_cov_147.794340	911	991	344	1	80	0.0125000
NODE_4296_length_1159_cov_147.794340	911	991	350	1	80	0.0125000
NODE_4296_length_1159_cov_147.794340	911	991	357	2	80	0.0250000
NODE_4296_length_1159_cov_147.794340	911	991	361	1	80	0.0125000
NODE_4296_length_1159_cov_147.794340	911	991	366	1	80	0.0125000
NODE_4296_length_1159_cov_147.794340	911	991	372	1	80	0.0125000
NODE_4296_length_1159_cov_147.794340	911	991	388	2	80	0.0250000
NODE_4296_length_1159_cov_147.794340	911	991	390	1	80	0.0125000
NODE_4296_length_1159_cov_147.794340	911	991	392	1	80	0.0125000
NODE_4296_length_1159_cov_147.794340	911	991	399	1	80	0.0125000
NODE_4296_length_1159_cov_147.794340	911	991	412	1	80	0.0125000
NODE_4296_length_1159_cov_147.794340	911	991	414	1	80	0.0125000
NODE_4296_length_1159_cov_147.794340	911	991	429	1	80	0.0125000
NODE_4296_length_1159_cov_147.794340	911	991	431	1	80	0.0125000
NODE_4296_length_1159_cov_147.794340	911	991	437	1	80	0.0125000
NODE_4296_length_1159_cov_147.794340	911	991	438	1	80	0.0125000
NODE_4296_length_1159_cov_147.794340	911	991	442	1	80	0.0125000
NODE_4296_length_1159_cov_147.794340	911	991	447	1	80	0.0125000
NODE_4296_length_1159_cov_147.794340	911	991	451	1	80	0.0125000
NODE_4296_length_1159_cov_147.794340	911	991	454	1	80	0.0125000
NODE_4296_length_1159_cov_147.794340	911	991	461	1	80	0.0125000
NODE_4296_length_1159_cov_147.794340	911	991	463	1	80	0.0125000
NODE_4296_length_1159_cov_147.794340	911	991	469	1	80	0.0125000
NODE_4296_length_1159_cov_147.794340	911	991	470	1	80	0.0125000
NODE_4296_length_1159_cov_147.794340	911	991	471	5	80	0.0625000
NODE_4296_length_1159_cov_147.794340	911	991	474	2	80	0.0250000
NODE_4296_length_1159_cov_147.794340	911	991	475	1	80	0.0125000
NODE_4296_length_1159_cov_147.794340	911	991	477	2	80	0.0250000
NODE_4296_length_1159_cov_147.794340	911	991	479	1	80	0.0125000
NODE_4296_length_1159_cov_147.794340	911	991	480	3	80	0.0375000
NODE_4296_length_1159_cov_147.794340	911	991	482	1	80	0.0125000
NODE_4296_length_1159_cov_147.794340	911	991	483	3	80	0.0375000
NODE_4296_length_1159_cov_147.794340	911	991	484	3	80	0.0375000
NODE_4296_length_1159_cov_147.794340	911	991	485	4	80	0.0500000
NODE_4296_length_1159_cov_147.794340	911	991	486	5	80	0.0625000
NODE_4296_length_1159_cov_147.794340	911	991	487	1	80	0.0125000
NODE_4296_length_1159_cov_147.794340	911	991	488	2	80	0.0250000
NODE_4296_length_1159_cov_147.794340	964	1044	183	1	80	0.0125000
NODE_4296_length_1159_cov_147.794340	964	1044	186	1	80	0.0125000
NODE_4296_length_1159_cov_147.794340	964	1044	192	1	80	0.0125000
NODE_4296_length_1159_cov_147.794340	964	1044	196	1	80	0.0125000
NODE_4296_length_1159_cov_147.794340	964	1044	200	1	80	0.0125000
NODE_4296_length_1159_cov_147.794340	964	1044	206	1	80	0.0125000
NODE_4296_length_1159_cov_147.794340	964	1044	220	1	80	0.0125000
NODE_4296_length_1159_cov_147.794340	964	1044	228	1	80	0.0125000
NODE_4296_length_1159_cov_147.794340	964	1044	230	1	80	0.0125000
NODE_4296_length_1159_cov_147.794340	964	1044	256	1	80	0.0125000
NODE_4296_length_1159_cov_147.794340	964	1044	260	1	80	0.0125000
NODE_4296_length_1159_cov_147.794340	964	1044	268	1	80	0.0125000
NODE_4296_length_1159_cov_147.794340	964	1044	280	1	80	0.0125000
NODE_4296_length_1159_cov_147.794340	964	1044	284	1	80	0.0125000
NODE_4296_length_1159_cov_147.794340	964	1044	296	1	80	0.0125000
NODE_4296_length_1159_cov_147.794340	964	1044	301	1	80	0.0125000
NODE_4296_length_1159_cov_147.794340	964	1044	303	1	80	0.0125000
NODE_4296_length_1159_cov_147.794340	964	1044	307	1	80	0.0125000
NODE_4296_length_1159_cov_147.794340	964	1044	309	1	80	0.0125000
NODE_4296_length_1159_cov_147.794340	964	1044	324	2	80	0.0250000
NODE_4296_length_1159_cov_147.794340	964	1044	326	2	80	0.0250000
NODE_4296_length_1159_cov_147.794340	964	1044	330	1	80	0.0125000
NODE_4296_length_1159_cov_147.794340	964	1044	332	1	80	0.0125000
NODE_4296_length_1159_cov_147.794340	964	1044	334	3	80	0.0375000
NODE_4296_length_1159_cov_147.794340	964	1044	336	1	80	0.0125000
NODE_4296_length_1159_cov_147.794340	964	1044	342	1	80	0.0125000
NODE_4296_length_1159_cov_147.794340	964	1044	344	1	80	0.0125000
NODE_4296_length_1159_cov_147.794340	964	1044	354	1	80	0.0125000
NODE_4296_length_1159_cov_147.794340	964	1044	356	1	80	0.0125000
NODE_4296_length_1159_cov_147.794340	964	1044	358	2	80	0.0250000
NODE_4296_length_1159_cov_147.794340	964	1044	362	1	80	0.0125000
NODE_4296_length_1159_cov_147.794340	964	1044	364	1	80	0.0125000
NODE_4296_length_1159_cov_147.794340	964	1044	383	1	80	0.0125000
NODE_4296_length_1159_cov_147.794340	964	1044	394	1	80	0.0125000
NODE_4296_length_1159_cov_147.794340	964	1044	397	1	80	0.0125000
NODE_4296_length_1159_cov_147.794340	964	1044	407	1	80	0.0125000
NODE_4296_length_1159_cov_147.794340	964	1044	413	1	80	0.0125000
NODE_4296_length_1159_cov_147.794340	964	1044	419	1	80	0.0125000
NODE_4296_length_1159_cov_147.794340	964	1044	422	1	80	0.0125000
NODE_4296_length_1159_cov_147.794340	964	1044	426	1	80	0.0125000
NODE_4296_length_1159_cov_147.794340	964	1044	436	1	80	0.0125000
NODE_4296_length_1159_cov_147.794340	964	1044	440	2	80	0.0250000
NODE_4296_length_1159_cov_147.794340	964	1044	444	1	80	0.0125000
NODE_4296_length_1159_cov_147.794340	964	1044	449	1	80	0.0125000
NODE_4296_length_1159_cov_147.794340	964	1044	451	1	80	0.0125000
NODE_4296_length_1159_cov_147.794340	964	1044	452	2	80	0.0250000
NODE_4296_length_1159_cov_147.794340	964	1044	454	1	80	0.0125000
NODE_4296_length_1159_cov_147.794340	964	1044	471	2	80	0.0250000
NODE_4296_length_1159_cov_147.794340	964	1044	477	2	80	0.0250000
NODE_4296_length_1159_cov_147.794340	964	1044	479	1	80	0.0125000
NODE_4296_length_1159_cov_147.794340	964	1044	480	2	80	0.0250000
NODE_4296_length_1159_cov_147.794340	964	1044	482	1	80	0.0125000
NODE_4296_length_1159_cov_147.794340	964	1044	483	3	80	0.0375000
NODE_4296_length_1159_cov_147.794340	964	1044	484	3	80	0.0375000
NODE_4296_length_1159_cov_147.794340	964	1044	485	4	80	0.0500000
NODE_4296_length_1159_cov_147.794340	964	1044	486	5	80	0.0625000
NODE_4296_length_1159_cov_147.794340	964	1044	487	1	80	0.0125000
NODE_4296_length_1159_cov_147.794340	964	1044	488	2	80	0.0250000
NODE_4297_length_1159_cov_57.566981	457	537	0	26	80	0.3250000
NODE_4297_length_1159_cov_57.566981	457	537	4	54	80	0.6750000
NODE_4297_length_1159_cov_57.566981	510	590	0	23	80	0.2875000
NODE_4297_length_1159_cov_57.566981	510	590	4	57	80	0.7125000
NODE_4297_length_1159_cov_57.566981	586	666	0	43	80	0.5375000
NODE_4297_length_1159_cov_57.566981	586	666	2	37	80	0.4625000
NODE_4297_length_1159_cov_57.566981	639	719	0	29	80	0.3625000
NODE_4297_length_1159_cov_57.566981	639	719	2	51	80	0.6375000
NODE_4298_length_1159_cov_44.053774	329	409	0	80	80	1.0000000
NODE_4298_length_1159_cov_44.053774	382	462	0	69	80	0.8625000
NODE_4298_length_1159_cov_44.053774	382	462	2	11	80	0.1375000
NODE_4298_length_1159_cov_44.053774	458	538	0	5	80	0.0625000
NODE_4298_length_1159_cov_44.053774	458	538	2	75	80	0.9375000
NODE_4298_length_1159_cov_44.053774	511	591	0	31	80	0.3875000
NODE_4298_length_1159_cov_44.053774	511	591	2	49	80	0.6125000
NODE_4299_length_1159_cov_40.194340	391	471	0	34	80	0.4250000
NODE_4299_length_1159_cov_40.194340	391	471	2	8	80	0.1000000
NODE_4299_length_1159_cov_40.194340	391	471	11	1	80	0.0125000
NODE_4299_length_1159_cov_40.194340	391	471	12	15	80	0.1875000
NODE_4299_length_1159_cov_40.194340	391	471	14	17	80	0.2125000
NODE_4299_length_1159_cov_40.194340	391	471	16	5	80	0.0625000
NODE_4299_length_1159_cov_40.194340	444	524	12	5	80	0.0625000
NODE_4299_length_1159_cov_40.194340	444	524	14	25	80	0.3125000
NODE_4299_length_1159_cov_40.194340	444	524	16	11	80	0.1375000
NODE_4299_length_1159_cov_40.194340	444	524	18	39	80	0.4875000
NODE_4301_length_1159_cov_25.919811	456	536	2	25	80	0.3125000
NODE_4301_length_1159_cov_25.919811	456	536	4	55	80	0.6875000
NODE_4301_length_1159_cov_25.919811	509	591	0	52	82	0.6341463
NODE_4301_length_1159_cov_25.919811	509	591	2	12	82	0.1463415
NODE_4301_length_1159_cov_25.919811	509	591	4	18	82	0.2195122
NODE_4302_length_1159_cov_18.306604	538	618	4	17	80	0.2125000
NODE_4302_length_1159_cov_18.306604	538	618	6	8	80	0.1000000
NODE_4302_length_1159_cov_18.306604	538	618	8	55	80	0.6875000
NODE_4302_length_1159_cov_18.306604	591	671	2	30	80	0.3750000
NODE_4302_length_1159_cov_18.306604	591	671	6	23	80	0.2875000
NODE_4302_length_1159_cov_18.306604	591	671	8	27	80	0.3375000
NODE_4303_length_1159_cov_14.457547	358	438	0	36	80	0.4500000
NODE_4303_length_1159_cov_14.457547	358	438	2	26	80	0.3250000
NODE_4303_length_1159_cov_14.457547	358	438	4	18	80	0.2250000
NODE_4303_length_1159_cov_14.457547	411	491	2	19	80	0.2375000
NODE_4303_length_1159_cov_14.457547	411	491	4	61	80	0.7625000
NODE_4304_length_1159_cov_11.566981	625	705	0	12	80	0.1500000
NODE_4304_length_1159_cov_11.566981	625	705	2	68	80	0.8500000
NODE_4304_length_1159_cov_11.566981	678	758	0	35	80	0.4375000
NODE_4304_length_1159_cov_11.566981	678	758	2	45	80	0.5625000
NODE_4305_length_1159_cov_9.927358	278	358	0	80	80	1.0000000
NODE_4305_length_1159_cov_9.927358	331	411	0	80	80	1.0000000
NODE_4314_length_1159_cov_1.568868	513	562	8	2	49	0.0408163
NODE_4314_length_1159_cov_1.568868	513	562	10	11	49	0.2244898
NODE_4314_length_1159_cov_1.568868	513	562	12	5	49	0.1020408
NODE_4314_length_1159_cov_1.568868	513	562	14	1	49	0.0204082
NODE_4314_length_1159_cov_1.568868	513	562	16	9	49	0.1836735
NODE_4314_length_1159_cov_1.568868	513	562	18	16	49	0.3265306
NODE_4314_length_1159_cov_1.568868	513	562	20	5	49	0.1020408
NODE_4316_length_1158_cov_33.529745	357	437	0	80	80	1.0000000
NODE_4316_length_1158_cov_33.529745	410	490	0	80	80	1.0000000
NODE_4316_length_1158_cov_33.529745	486	566	0	26	80	0.3250000
NODE_4316_length_1158_cov_33.529745	486	566	2	54	80	0.6750000
NODE_4316_length_1158_cov_33.529745	539	619	0	33	80	0.4125000
NODE_4316_length_1158_cov_33.529745	539	619	2	47	80	0.5875000
NODE_4317_length_1158_cov_31.368272	416	496	0	70	80	0.8750000
NODE_4317_length_1158_cov_31.368272	416	496	2	10	80	0.1250000
NODE_4317_length_1158_cov_31.368272	469	549	0	17	80	0.2125000
NODE_4317_length_1158_cov_31.368272	469	549	2	63	80	0.7875000
NODE_4317_length_1158_cov_31.368272	545	626	0	4	81	0.0493827
NODE_4317_length_1158_cov_31.368272	545	626	2	77	81	0.9506173
NODE_4317_length_1158_cov_31.368272	599	679	0	4	80	0.0500000
NODE_4317_length_1158_cov_31.368272	599	679	2	36	80	0.4500000
NODE_4317_length_1158_cov_31.368272	599	679	4	40	80	0.5000000
NODE_4318_length_1158_cov_31.240793	430	510	0	47	80	0.5875000
NODE_4318_length_1158_cov_31.240793	430	510	3	1	80	0.0125000
NODE_4318_length_1158_cov_31.240793	430	510	4	12	80	0.1500000
NODE_4318_length_1158_cov_31.240793	430	510	8	1	80	0.0125000
NODE_4318_length_1158_cov_31.240793	430	510	10	19	80	0.2375000
NODE_4318_length_1158_cov_31.240793	483	563	4	7	80	0.0875000
NODE_4318_length_1158_cov_31.240793	483	563	8	1	80	0.0125000
NODE_4318_length_1158_cov_31.240793	483	563	10	72	80	0.9000000
NODE_4318_length_1158_cov_31.240793	559	639	8	12	80	0.1500000
NODE_4318_length_1158_cov_31.240793	559	639	10	44	80	0.5500000
NODE_4318_length_1158_cov_31.240793	559	639	11	4	80	0.0500000
NODE_4318_length_1158_cov_31.240793	559	639	12	20	80	0.2500000
NODE_4318_length_1158_cov_31.240793	612	692	4	47	80	0.5875000
NODE_4318_length_1158_cov_31.240793	612	692	6	5	80	0.0625000
NODE_4318_length_1158_cov_31.240793	612	692	8	13	80	0.1625000
NODE_4318_length_1158_cov_31.240793	612	692	11	2	80	0.0250000
NODE_4318_length_1158_cov_31.240793	612	692	12	13	80	0.1625000
NODE_4319_length_1158_cov_29.216242	405	485	0	60	80	0.7500000
NODE_4319_length_1158_cov_29.216242	405	485	4	20	80	0.2500000
NODE_4319_length_1158_cov_29.216242	458	538	0	7	80	0.0875000
NODE_4319_length_1158_cov_29.216242	458	538	4	73	80	0.9125000
NODE_4320_length_1158_cov_25.245515	500	580	0	80	80	1.0000000
NODE_4320_length_1158_cov_25.245515	553	633	0	80	80	1.0000000
NODE_4320_length_1158_cov_25.245515	629	709	0	38	80	0.4750000
NODE_4320_length_1158_cov_25.245515	629	709	2	27	80	0.3375000
NODE_4320_length_1158_cov_25.245515	629	709	4	15	80	0.1875000
NODE_4320_length_1158_cov_25.245515	682	762	2	32	80	0.4000000
NODE_4320_length_1158_cov_25.245515	682	762	4	48	80	0.6000000
NODE_4321_length_1158_cov_16.566572	396	476	0	66	80	0.8250000
NODE_4321_length_1158_cov_16.566572	396	476	2	14	80	0.1750000
NODE_4321_length_1158_cov_16.566572	449	529	0	13	80	0.1625000
NODE_4321_length_1158_cov_16.566572	449	529	2	67	80	0.8375000
NODE_4322_length_1158_cov_13.092540	372	452	0	80	80	1.0000000
NODE_4322_length_1158_cov_13.092540	425	505	0	80	80	1.0000000
NODE_4322_length_1158_cov_13.092540	735	815	0	80	80	1.0000000
NODE_4322_length_1158_cov_13.092540	788	868	0	62	80	0.7750000
NODE_4322_length_1158_cov_13.092540	788	868	2	18	80	0.2250000
NODE_4323_length_1158_cov_7.408876	656	736	0	34	80	0.4250000
NODE_4323_length_1158_cov_7.408876	656	736	2	46	80	0.5750000
NODE_4323_length_1158_cov_7.408876	709	789	2	75	80	0.9375000
NODE_4323_length_1158_cov_7.408876	709	789	3	1	80	0.0125000
NODE_4323_length_1158_cov_7.408876	709	789	4	4	80	0.0500000
NODE_4324_length_1158_cov_6.242682	239	310	0	71	71	1.0000000
NODE_4325_length_1158_cov_6.043437	531	611	0	80	80	1.0000000
NODE_4325_length_1158_cov_6.043437	584	634	0	50	50	1.0000000
NODE_4326_length_1158_cov_5.855524	324	404	0	80	80	1.0000000
NODE_4326_length_1158_cov_5.855524	377	457	0	80	80	1.0000000
NODE_4329_length_1157_cov_32.233459	472	552	3	17	80	0.2125000
NODE_4329_length_1157_cov_32.233459	472	552	6	6	80	0.0750000
NODE_4329_length_1157_cov_32.233459	472	552	8	29	80	0.3625000
NODE_4329_length_1157_cov_32.233459	472	552	10	28	80	0.3500000
NODE_4329_length_1157_cov_32.233459	525	605	2	21	80	0.2625000
NODE_4329_length_1157_cov_32.233459	525	605	4	8	80	0.1000000
NODE_4329_length_1157_cov_32.233459	525	605	7	1	80	0.0125000
NODE_4329_length_1157_cov_32.233459	525	605	8	1	80	0.0125000
NODE_4329_length_1157_cov_32.233459	525	605	10	49	80	0.6125000
NODE_4329_length_1157_cov_32.233459	601	681	2	75	80	0.9375000
NODE_4329_length_1157_cov_32.233459	601	681	4	5	80	0.0625000
NODE_4329_length_1157_cov_32.233459	654	734	0	32	80	0.4000000
NODE_4329_length_1157_cov_32.233459	654	734	2	48	80	0.6000000
NODE_4330_length_1157_cov_6.438563	765	788	2	21	23	0.9130435
NODE_4330_length_1157_cov_6.438563	765	788	3	2	23	0.0869565
NODE_4332_length_1157_cov_4.068053	221	292	0	58	71	0.8169014
NODE_4332_length_1157_cov_4.068053	221	292	2	13	71	0.1830986
NODE_4333_length_1156_cov_46.381268	328	408	0	80	80	1.0000000
NODE_4333_length_1156_cov_46.381268	381	461	0	80	80	1.0000000
NODE_4333_length_1156_cov_46.381268	457	537	0	26	80	0.3250000
NODE_4333_length_1156_cov_46.381268	457	537	2	54	80	0.6750000
NODE_4333_length_1156_cov_46.381268	510	590	0	15	80	0.1875000
NODE_4333_length_1156_cov_46.381268	510	590	2	65	80	0.8125000
NODE_4334_length_1156_cov_32.198675	378	458	2	28	80	0.3500000
NODE_4334_length_1156_cov_32.198675	378	458	4	52	80	0.6500000
NODE_4334_length_1156_cov_32.198675	431	511	0	31	80	0.3875000
NODE_4334_length_1156_cov_32.198675	431	511	2	36	80	0.4500000
NODE_4334_length_1156_cov_32.198675	431	511	4	13	80	0.1625000
NODE_4334_length_1156_cov_32.198675	507	587	2	46	80	0.5750000
NODE_4334_length_1156_cov_32.198675	507	587	4	20	80	0.2500000
NODE_4334_length_1156_cov_32.198675	507	587	6	14	80	0.1750000
NODE_4334_length_1156_cov_32.198675	560	641	2	13	81	0.1604938
NODE_4334_length_1156_cov_32.198675	560	641	4	43	81	0.5308642
NODE_4334_length_1156_cov_32.198675	560	641	6	25	81	0.3086420
NODE_4335_length_1156_cov_12.683065	593	673	0	2	80	0.0250000
NODE_4335_length_1156_cov_12.683065	593	673	14	78	80	0.9750000
NODE_4335_length_1156_cov_12.683065	646	726	0	2	80	0.0250000
NODE_4335_length_1156_cov_12.683065	646	726	14	78	80	0.9750000
NODE_4336_length_1156_cov_9.287606	680	760	0	27	80	0.3375000
NODE_4336_length_1156_cov_9.287606	680	760	4	53	80	0.6625000
NODE_4336_length_1156_cov_9.287606	733	813	4	80	80	1.0000000
NODE_4339_length_1155_cov_19.570076	437	517	0	27	80	0.3375000
NODE_4339_length_1155_cov_19.570076	437	517	6	19	80	0.2375000
NODE_4339_length_1155_cov_19.570076	437	517	8	34	80	0.4250000
NODE_4339_length_1155_cov_19.570076	490	570	6	17	80	0.2125000
NODE_4339_length_1155_cov_19.570076	490	570	8	31	80	0.3875000
NODE_4339_length_1155_cov_19.570076	490	570	10	6	80	0.0750000
NODE_4339_length_1155_cov_19.570076	490	570	11	1	80	0.0125000
NODE_4339_length_1155_cov_19.570076	490	570	12	25	80	0.3125000
NODE_4340_length_1155_cov_18.666667	332	412	0	8	80	0.1000000
NODE_4340_length_1155_cov_18.666667	332	412	6	31	80	0.3875000
NODE_4340_length_1155_cov_18.666667	332	412	8	1	80	0.0125000
NODE_4340_length_1155_cov_18.666667	332	412	10	40	80	0.5000000
NODE_4340_length_1155_cov_18.666667	385	465	2	7	80	0.0875000
NODE_4340_length_1155_cov_18.666667	385	465	4	27	80	0.3375000
NODE_4340_length_1155_cov_18.666667	385	465	8	11	80	0.1375000
NODE_4340_length_1155_cov_18.666667	385	465	10	35	80	0.4375000
NODE_4346_length_1154_cov_61.769668	488	568	0	80	80	1.0000000
NODE_4346_length_1154_cov_61.769668	541	621	0	47	80	0.5875000
NODE_4346_length_1154_cov_61.769668	541	621	1	33	80	0.4125000
NODE_4347_length_1154_cov_50.909005	409	489	2	1	80	0.0125000
NODE_4347_length_1154_cov_50.909005	409	489	5	4	80	0.0500000
NODE_4347_length_1154_cov_50.909005	409	489	7	3	80	0.0375000
NODE_4347_length_1154_cov_50.909005	409	489	8	8	80	0.1000000
NODE_4347_length_1154_cov_50.909005	409	489	9	64	80	0.8000000
NODE_4347_length_1154_cov_50.909005	462	542	0	6	80	0.0750000
NODE_4347_length_1154_cov_50.909005	462	542	2	18	80	0.2250000
NODE_4347_length_1154_cov_50.909005	462	542	4	30	80	0.3750000
NODE_4347_length_1154_cov_50.909005	462	542	5	4	80	0.0500000
NODE_4347_length_1154_cov_50.909005	462	542	7	2	80	0.0250000
NODE_4347_length_1154_cov_50.909005	462	542	9	20	80	0.2500000
NODE_4347_length_1154_cov_50.909005	538	618	4	56	80	0.7000000
NODE_4347_length_1154_cov_50.909005	538	618	8	24	80	0.3000000
NODE_4347_length_1154_cov_50.909005	591	671	0	19	80	0.2375000
NODE_4347_length_1154_cov_50.909005	591	671	4	57	80	0.7125000
NODE_4347_length_1154_cov_50.909005	591	671	8	4	80	0.0500000
NODE_4348_length_1154_cov_28.941232	695	775	0	80	80	1.0000000
NODE_4348_length_1154_cov_28.941232	748	828	0	80	80	1.0000000
NODE_4349_length_1154_cov_13.765877	322	402	0	80	80	1.0000000
NODE_4349_length_1154_cov_13.765877	375	455	0	80	80	1.0000000
NODE_4351_length_1154_cov_5.930806	497	577	2	80	80	1.0000000
NODE_4351_length_1154_cov_5.930806	550	622	2	72	72	1.0000000
NODE_4357_length_1153_cov_65.486717	416	496	0	80	80	1.0000000
NODE_4357_length_1153_cov_65.486717	469	549	0	31	80	0.3875000
NODE_4357_length_1153_cov_65.486717	469	549	2	47	80	0.5875000
NODE_4357_length_1153_cov_65.486717	469	549	4	2	80	0.0250000
NODE_4357_length_1153_cov_65.486717	545	625	2	2	80	0.0250000
NODE_4357_length_1153_cov_65.486717	545	625	4	13	80	0.1625000
NODE_4357_length_1153_cov_65.486717	545	625	6	23	80	0.2875000
NODE_4357_length_1153_cov_65.486717	545	625	8	15	80	0.1875000
NODE_4357_length_1153_cov_65.486717	545	625	10	20	80	0.2500000
NODE_4357_length_1153_cov_65.486717	545	625	12	7	80	0.0875000
NODE_4357_length_1153_cov_65.486717	598	678	4	10	80	0.1250000
NODE_4357_length_1153_cov_65.486717	598	678	6	25	80	0.3125000
NODE_4357_length_1153_cov_65.486717	598	678	8	15	80	0.1875000
NODE_4357_length_1153_cov_65.486717	598	678	10	23	80	0.2875000
NODE_4357_length_1153_cov_65.486717	598	678	12	7	80	0.0875000
NODE_4358_length_1153_cov_50.733397	404	484	0	80	80	1.0000000
NODE_4358_length_1153_cov_50.733397	457	537	0	80	80	1.0000000
NODE_4358_length_1153_cov_50.733397	533	613	0	48	80	0.6000000
NODE_4358_length_1153_cov_50.733397	533	613	2	7	80	0.0875000
NODE_4358_length_1153_cov_50.733397	533	613	16	2	80	0.0250000
NODE_4358_length_1153_cov_50.733397	533	613	17	1	80	0.0125000
NODE_4358_length_1153_cov_50.733397	533	613	18	9	80	0.1125000
NODE_4358_length_1153_cov_50.733397	533	613	20	13	80	0.1625000
NODE_4358_length_1153_cov_50.733397	586	666	2	2	80	0.0250000
NODE_4358_length_1153_cov_50.733397	586	666	15	1	80	0.0125000
NODE_4358_length_1153_cov_50.733397	586	666	16	2	80	0.0250000
NODE_4358_length_1153_cov_50.733397	586	666	17	11	80	0.1375000
NODE_4358_length_1153_cov_50.733397	586	666	18	9	80	0.1125000
NODE_4358_length_1153_cov_50.733397	586	666	19	34	80	0.4250000
NODE_4358_length_1153_cov_50.733397	586	666	20	21	80	0.2625000
NODE_4359_length_1153_cov_26.131879	493	573	0	30	80	0.3750000
NODE_4359_length_1153_cov_26.131879	493	573	2	44	80	0.5500000
NODE_4359_length_1153_cov_26.131879	493	573	4	6	80	0.0750000
NODE_4359_length_1153_cov_26.131879	546	626	0	80	80	1.0000000
NODE_4360_length_1153_cov_10.195446	500	580	1	1	80	0.0125000
NODE_4360_length_1153_cov_10.195446	500	580	3	52	80	0.6500000
NODE_4360_length_1153_cov_10.195446	500	580	4	27	80	0.3375000
NODE_4360_length_1153_cov_10.195446	553	633	1	54	80	0.6750000
NODE_4360_length_1153_cov_10.195446	553	633	3	2	80	0.0250000
NODE_4360_length_1153_cov_10.195446	553	633	4	24	80	0.3000000
NODE_4361_length_1153_cov_8.286528	558	638	0	13	80	0.1625000
NODE_4361_length_1153_cov_8.286528	558	638	2	67	80	0.8375000
NODE_4361_length_1153_cov_8.286528	611	691	0	66	80	0.8250000
NODE_4361_length_1153_cov_8.286528	611	691	2	14	80	0.1750000
NODE_4368_length_1152_cov_19.800570	553	633	0	80	80	1.0000000
NODE_4368_length_1152_cov_19.800570	606	686	0	71	80	0.8875000
NODE_4368_length_1152_cov_19.800570	606	686	2	9	80	0.1125000
NODE_4369_length_1152_cov_19.365622	490	570	0	8	80	0.1000000
NODE_4369_length_1152_cov_19.365622	490	570	2	72	80	0.9000000
NODE_4369_length_1152_cov_19.365622	543	623	0	30	80	0.3750000
NODE_4369_length_1152_cov_19.365622	543	623	2	50	80	0.6250000
NODE_4370_length_1152_cov_18.654321	594	674	0	80	80	1.0000000
NODE_4370_length_1152_cov_18.654321	647	727	0	45	80	0.5625000
NODE_4370_length_1152_cov_18.654321	647	727	2	35	80	0.4375000
NODE_4371_length_1152_cov_18.075024	377	457	8	17	80	0.2125000
NODE_4371_length_1152_cov_18.075024	377	457	12	10	80	0.1250000
NODE_4371_length_1152_cov_18.075024	377	457	18	18	80	0.2250000
NODE_4371_length_1152_cov_18.075024	377	457	24	35	80	0.4375000
NODE_4371_length_1152_cov_18.075024	430	510	7	3	80	0.0375000
NODE_4371_length_1152_cov_18.075024	430	510	13	17	80	0.2125000
NODE_4371_length_1152_cov_18.075024	430	510	16	1	80	0.0125000
NODE_4371_length_1152_cov_18.075024	430	510	17	1	80	0.0125000
NODE_4371_length_1152_cov_18.075024	430	510	23	22	80	0.2750000
NODE_4371_length_1152_cov_18.075024	430	510	24	36	80	0.4500000
NODE_4371_length_1152_cov_18.075024	506	586	0	7	80	0.0875000
NODE_4371_length_1152_cov_18.075024	506	586	2	44	80	0.5500000
NODE_4371_length_1152_cov_18.075024	506	586	4	16	80	0.2000000
NODE_4371_length_1152_cov_18.075024	506	586	6	5	80	0.0625000
NODE_4371_length_1152_cov_18.075024	506	586	7	7	80	0.0875000
NODE_4371_length_1152_cov_18.075024	506	586	13	1	80	0.0125000
NODE_4371_length_1152_cov_18.075024	559	639	2	40	80	0.5000000
NODE_4371_length_1152_cov_18.075024	559	639	4	40	80	0.5000000
NODE_4373_length_1152_cov_16.047483	543	623	0	51	80	0.6375000
NODE_4373_length_1152_cov_16.047483	543	623	2	29	80	0.3625000
NODE_4373_length_1152_cov_16.047483	596	676	2	80	80	1.0000000
NODE_4373_length_1152_cov_16.047483	672	752	2	74	80	0.9250000
NODE_4373_length_1152_cov_16.047483	672	752	4	6	80	0.0750000
NODE_4373_length_1152_cov_16.047483	725	805	0	44	80	0.5500000
NODE_4373_length_1152_cov_16.047483	725	805	2	36	80	0.4500000
NODE_4374_length_1152_cov_13.981007	583	663	0	14	80	0.1750000
NODE_4374_length_1152_cov_13.981007	583	663	1	66	80	0.8250000
NODE_4374_length_1152_cov_13.981007	636	716	0	64	80	0.8000000
NODE_4374_length_1152_cov_13.981007	636	716	1	16	80	0.2000000
NODE_4380_length_1151_cov_30.469582	479	559	0	80	80	1.0000000
NODE_4380_length_1151_cov_30.469582	532	612	0	80	80	1.0000000
NODE_4381_length_1151_cov_26.650190	567	647	0	80	80	1.0000000
NODE_4381_length_1151_cov_26.650190	620	700	0	68	80	0.8500000
NODE_4381_length_1151_cov_26.650190	620	700	2	12	80	0.1500000
NODE_4382_length_1151_cov_26.375475	441	521	2	28	80	0.3500000
NODE_4382_length_1151_cov_26.375475	441	521	4	52	80	0.6500000
NODE_4382_length_1151_cov_26.375475	494	574	0	19	80	0.2375000
NODE_4382_length_1151_cov_26.375475	494	574	2	61	80	0.7625000
NODE_4382_length_1151_cov_26.375475	570	650	0	75	80	0.9375000
NODE_4382_length_1151_cov_26.375475	570	650	2	5	80	0.0625000
NODE_4382_length_1151_cov_26.375475	623	703	0	22	80	0.2750000
NODE_4382_length_1151_cov_26.375475	623	703	2	58	80	0.7250000
NODE_4383_length_1151_cov_23.614068	590	670	0	60	80	0.7500000
NODE_4383_length_1151_cov_23.614068	590	670	2	20	80	0.2500000
NODE_4383_length_1151_cov_23.614068	643	721	0	7	78	0.0897436
NODE_4383_length_1151_cov_23.614068	643	721	2	71	78	0.9102564
NODE_4384_length_1151_cov_18.693916	355	435	0	14	80	0.1750000
NODE_4384_length_1151_cov_18.693916	355	435	4	66	80	0.8250000
NODE_4384_length_1151_cov_18.693916	408	491	0	70	83	0.8433735
NODE_4384_length_1151_cov_18.693916	408	491	4	13	83	0.1566265
NODE_4385_length_1151_cov_16.093156	474	554	0	80	80	1.0000000
NODE_4385_length_1151_cov_16.093156	527	607	0	33	80	0.4125000
NODE_4385_length_1151_cov_16.093156	527	607	2	47	80	0.5875000
NODE_4386_length_1151_cov_13.782319	400	482	0	82	82	1.0000000
NODE_4386_length_1151_cov_13.782319	450	535	0	85	85	1.0000000
NODE_4392_length_1150_cov_38.601332	563	643	2	2	80	0.0250000
NODE_4392_length_1150_cov_38.601332	563	643	4	13	80	0.1625000
NODE_4392_length_1150_cov_38.601332	563	643	6	65	80	0.8125000
NODE_4392_length_1150_cov_38.601332	616	696	2	55	80	0.6875000
NODE_4392_length_1150_cov_38.601332	616	696	4	9	80	0.1125000
NODE_4392_length_1150_cov_38.601332	616	696	6	16	80	0.2000000
NODE_4392_length_1150_cov_38.601332	692	772	0	70	80	0.8750000
NODE_4392_length_1150_cov_38.601332	692	772	2	10	80	0.1250000
NODE_4392_length_1150_cov_38.601332	745	825	0	80	80	1.0000000
NODE_4393_length_1150_cov_15.741199	497	578	0	31	81	0.3827161
NODE_4393_length_1150_cov_15.741199	497	578	4	36	81	0.4444444
NODE_4393_length_1150_cov_15.741199	497	578	6	14	81	0.1728395
NODE_4393_length_1150_cov_15.741199	550	631	4	14	81	0.1728395
NODE_4393_length_1150_cov_15.741199	550	631	6	16	81	0.1975309
NODE_4393_length_1150_cov_15.741199	550	631	8	48	81	0.5925926
NODE_4393_length_1150_cov_15.741199	550	631	10	3	81	0.0370370
NODE_4394_length_1150_cov_11.132255	795	875	0	55	80	0.6875000
NODE_4394_length_1150_cov_11.132255	795	875	2	25	80	0.3125000
NODE_4394_length_1150_cov_11.132255	848	928	0	2	80	0.0250000
NODE_4394_length_1150_cov_11.132255	848	928	2	78	80	0.9750000
NODE_4395_length_1150_cov_9.253092	583	663	0	80	80	1.0000000
NODE_4395_length_1150_cov_9.253092	636	716	0	80	80	1.0000000
NODE_4398_length_1149_cov_17.289524	644	695	0	3	51	0.0588235
NODE_4398_length_1149_cov_17.289524	644	695	2	48	51	0.9411765
NODE_4399_length_1149_cov_13.805714	584	664	0	15	80	0.1875000
NODE_4399_length_1149_cov_13.805714	584	664	2	11	80	0.1375000
NODE_4399_length_1149_cov_13.805714	584	664	4	16	80	0.2000000
NODE_4399_length_1149_cov_13.805714	584	664	6	1	80	0.0125000
NODE_4399_length_1149_cov_13.805714	584	664	8	8	80	0.1000000
NODE_4399_length_1149_cov_13.805714	584	664	12	29	80	0.3625000
NODE_4399_length_1149_cov_13.805714	637	717	4	2	80	0.0250000
NODE_4399_length_1149_cov_13.805714	637	717	6	19	80	0.2375000
NODE_4399_length_1149_cov_13.805714	637	717	8	4	80	0.0500000
NODE_4399_length_1149_cov_13.805714	637	717	10	26	80	0.3250000
NODE_4399_length_1149_cov_13.805714	637	717	12	29	80	0.3625000
NODE_4399_length_1149_cov_13.805714	713	793	0	2	80	0.0250000
NODE_4399_length_1149_cov_13.805714	713	793	2	25	80	0.3125000
NODE_4399_length_1149_cov_13.805714	713	793	4	51	80	0.6375000
NODE_4399_length_1149_cov_13.805714	713	793	6	2	80	0.0250000
NODE_4399_length_1149_cov_13.805714	766	846	4	55	80	0.6875000
NODE_4399_length_1149_cov_13.805714	766	846	6	25	80	0.3125000
NODE_4407_length_1148_cov_27.674929	387	467	4	10	80	0.1250000
NODE_4407_length_1148_cov_27.674929	387	467	7	43	80	0.5375000
NODE_4407_length_1148_cov_27.674929	387	467	8	10	80	0.1250000
NODE_4407_length_1148_cov_27.674929	387	467	9	17	80	0.2125000
NODE_4407_length_1148_cov_27.674929	440	520	0	18	80	0.2250000
NODE_4407_length_1148_cov_27.674929	440	520	6	35	80	0.4375000
NODE_4407_length_1148_cov_27.674929	440	520	7	18	80	0.2250000
NODE_4407_length_1148_cov_27.674929	440	520	8	9	80	0.1125000
NODE_4408_length_1148_cov_13.275500	136	216	6	9	80	0.1125000
NODE_4408_length_1148_cov_13.275500	136	216	8	5	80	0.0625000
NODE_4408_length_1148_cov_13.275500	136	216	10	27	80	0.3375000
NODE_4408_length_1148_cov_13.275500	136	216	12	31	80	0.3875000
NODE_4408_length_1148_cov_13.275500	136	216	14	8	80	0.1000000
NODE_4408_length_1148_cov_13.275500	189	268	0	15	79	0.1898734
NODE_4408_length_1148_cov_13.275500	189	268	4	13	79	0.1645570
NODE_4408_length_1148_cov_13.275500	189	268	5	1	79	0.0126582
NODE_4408_length_1148_cov_13.275500	189	268	6	32	79	0.4050633
NODE_4408_length_1148_cov_13.275500	189	268	8	5	79	0.0632911
NODE_4408_length_1148_cov_13.275500	189	268	10	13	79	0.1645570
NODE_4409_length_1148_cov_10.613918	506	586	0	57	80	0.7125000
NODE_4409_length_1148_cov_10.613918	506	586	2	23	80	0.2875000
NODE_4409_length_1148_cov_10.613918	559	639	0	4	80	0.0500000
NODE_4409_length_1148_cov_10.613918	559	639	2	34	80	0.4250000
NODE_4409_length_1148_cov_10.613918	559	639	4	42	80	0.5250000
NODE_4415_length_1147_cov_33.543893	378	458	0	56	80	0.7000000
NODE_4415_length_1147_cov_33.543893	378	458	2	24	80	0.3000000
NODE_4415_length_1147_cov_33.543893	431	511	0	3	80	0.0375000
NODE_4415_length_1147_cov_33.543893	431	511	2	63	80	0.7875000
NODE_4415_length_1147_cov_33.543893	431	511	4	14	80	0.1750000
NODE_4416_length_1147_cov_26.858779	254	334	0	80	80	1.0000000
NODE_4416_length_1147_cov_26.858779	307	387	0	80	80	1.0000000
NODE_4416_length_1147_cov_26.858779	383	463	0	80	80	1.0000000
NODE_4416_length_1147_cov_26.858779	436	516	0	80	80	1.0000000
NODE_4417_length_1147_cov_24.227099	606	686	6	14	80	0.1750000
NODE_4417_length_1147_cov_24.227099	606	686	10	66	80	0.8250000
NODE_4417_length_1147_cov_24.227099	659	739	2	20	80	0.2500000
NODE_4417_length_1147_cov_24.227099	659	739	5	1	80	0.0125000
NODE_4417_length_1147_cov_24.227099	659	739	6	30	80	0.3750000
NODE_4417_length_1147_cov_24.227099	659	739	7	3	80	0.0375000
NODE_4417_length_1147_cov_24.227099	659	739	8	13	80	0.1625000
NODE_4417_length_1147_cov_24.227099	659	739	10	13	80	0.1625000
NODE_4417_length_1147_cov_24.227099	735	815	2	62	80	0.7750000
NODE_4417_length_1147_cov_24.227099	735	815	6	18	80	0.2250000
NODE_4417_length_1147_cov_24.227099	788	868	2	9	80	0.1125000
NODE_4417_length_1147_cov_24.227099	788	868	4	41	80	0.5125000
NODE_4417_length_1147_cov_24.227099	788	868	6	30	80	0.3750000
NODE_4418_length_1147_cov_16.559160	417	497	0	23	80	0.2875000
NODE_4418_length_1147_cov_16.559160	417	497	2	57	80	0.7125000
NODE_4418_length_1147_cov_16.559160	470	550	0	17	80	0.2125000
NODE_4418_length_1147_cov_16.559160	470	550	2	63	80	0.7875000
NODE_4428_length_1146_cov_52.393505	411	491	4	3	80	0.0375000
NODE_4428_length_1146_cov_52.393505	411	491	6	5	80	0.0625000
NODE_4428_length_1146_cov_52.393505	411	491	8	69	80	0.8625000
NODE_4428_length_1146_cov_52.393505	411	491	10	3	80	0.0375000
NODE_4428_length_1146_cov_52.393505	464	544	0	16	80	0.2000000
NODE_4428_length_1146_cov_52.393505	464	544	2	11	80	0.1375000
NODE_4428_length_1146_cov_52.393505	464	544	4	29	80	0.3625000
NODE_4428_length_1146_cov_52.393505	464	544	6	5	80	0.0625000
NODE_4428_length_1146_cov_52.393505	464	544	8	19	80	0.2375000
NODE_4428_length_1146_cov_52.393505	540	620	0	31	80	0.3875000
NODE_4428_length_1146_cov_52.393505	540	620	2	49	80	0.6125000
NODE_4428_length_1146_cov_52.393505	593	673	0	47	80	0.5875000
NODE_4428_length_1146_cov_52.393505	593	673	2	33	80	0.4125000
NODE_4429_length_1146_cov_46.364852	233	313	0	80	80	1.0000000
NODE_4429_length_1146_cov_46.364852	286	366	0	80	80	1.0000000
NODE_4430_length_1146_cov_26.159503	476	556	0	22	80	0.2750000
NODE_4430_length_1146_cov_26.159503	476	556	2	21	80	0.2625000
NODE_4430_length_1146_cov_26.159503	476	556	4	4	80	0.0500000
NODE_4430_length_1146_cov_26.159503	476	556	8	33	80	0.4125000
NODE_4430_length_1146_cov_26.159503	529	609	0	6	80	0.0750000
NODE_4430_length_1146_cov_26.159503	529	609	2	74	80	0.9250000
NODE_4430_length_1146_cov_26.159503	605	685	0	63	80	0.7875000
NODE_4430_length_1146_cov_26.159503	605	685	2	17	80	0.2125000
NODE_4430_length_1146_cov_26.159503	658	738	0	27	80	0.3375000
NODE_4430_length_1146_cov_26.159503	658	738	2	53	80	0.6625000
NODE_4431_length_1146_cov_14.210124	343	423	0	2	80	0.0250000
NODE_4431_length_1146_cov_14.210124	343	423	4	78	80	0.9750000
NODE_4431_length_1146_cov_14.210124	396	476	0	55	80	0.6875000
NODE_4431_length_1146_cov_14.210124	396	476	4	25	80	0.3125000
NODE_4432_length_1146_cov_13.479465	425	501	0	65	76	0.8552632
NODE_4432_length_1146_cov_13.479465	425	501	2	11	76	0.1447368
NODE_4432_length_1146_cov_13.479465	505	565	0	50	60	0.8333333
NODE_4432_length_1146_cov_13.479465	505	565	4	10	60	0.1666667
NODE_4432_length_1146_cov_13.479465	561	641	4	80	80	1.0000000
NODE_4432_length_1146_cov_13.479465	614	694	0	52	80	0.6500000
NODE_4432_length_1146_cov_13.479465	614	694	4	28	80	0.3500000
NODE_4438_length_1145_cov_49.566922	395	470	0	12	75	0.1600000
NODE_4438_length_1145_cov_49.566922	395	470	2	24	75	0.3200000
NODE_4438_length_1145_cov_49.566922	395	470	4	39	75	0.5200000
NODE_4438_length_1145_cov_49.566922	443	523	0	6	80	0.0750000
NODE_4438_length_1145_cov_49.566922	443	523	2	12	80	0.1500000
NODE_4438_length_1145_cov_49.566922	443	523	4	62	80	0.7750000
NODE_4439_length_1145_cov_38.191205	497	576	0	62	79	0.7848101
NODE_4439_length_1145_cov_38.191205	497	576	5	1	79	0.0126582
NODE_4439_length_1145_cov_38.191205	497	576	6	16	79	0.2025317
NODE_4439_length_1145_cov_38.191205	549	629	0	11	80	0.1375000
NODE_4439_length_1145_cov_38.191205	549	629	5	1	80	0.0125000
NODE_4439_length_1145_cov_38.191205	549	629	6	68	80	0.8500000
NODE_4440_length_1145_cov_26.929254	468	548	0	50	80	0.6250000
NODE_4440_length_1145_cov_26.929254	468	548	9	3	80	0.0375000
NODE_4440_length_1145_cov_26.929254	468	548	13	1	80	0.0125000
NODE_4440_length_1145_cov_26.929254	468	548	17	26	80	0.3250000
NODE_4440_length_1145_cov_26.929254	521	601	13	1	80	0.0125000
NODE_4440_length_1145_cov_26.929254	521	601	17	47	80	0.5875000
NODE_4440_length_1145_cov_26.929254	521	601	23	5	80	0.0625000
NODE_4440_length_1145_cov_26.929254	521	601	24	14	80	0.1750000
NODE_4440_length_1145_cov_26.929254	521	601	25	13	80	0.1625000
NODE_4441_length_1145_cov_20.121415	508	588	0	17	80	0.2125000
NODE_4441_length_1145_cov_20.121415	508	588	2	63	80	0.7875000
NODE_4441_length_1145_cov_20.121415	561	641	0	21	80	0.2625000
NODE_4441_length_1145_cov_20.121415	561	641	2	59	80	0.7375000
NODE_4442_length_1145_cov_11.753346	527	605	2	24	78	0.3076923
NODE_4442_length_1145_cov_11.753346	527	605	4	54	78	0.6923077
NODE_4442_length_1145_cov_11.753346	578	659	0	18	81	0.2222222
NODE_4442_length_1145_cov_11.753346	578	659	2	36	81	0.4444444
NODE_4442_length_1145_cov_11.753346	578	659	4	27	81	0.3333333
NODE_4443_length_1145_cov_9.571702	93	173	0	28	80	0.3500000
NODE_4443_length_1145_cov_9.571702	93	173	2	52	80	0.6500000
NODE_4443_length_1145_cov_9.571702	146	226	0	7	80	0.0875000
NODE_4443_length_1145_cov_9.571702	146	226	2	73	80	0.9125000
NODE_4455_length_1143_cov_42.255747	380	460	2	10	80	0.1250000
NODE_4455_length_1143_cov_42.255747	380	460	4	64	80	0.8000000
NODE_4455_length_1143_cov_42.255747	380	460	6	6	80	0.0750000
NODE_4455_length_1143_cov_42.255747	433	513	2	39	80	0.4875000
NODE_4455_length_1143_cov_42.255747	433	513	4	23	80	0.2875000
NODE_4455_length_1143_cov_42.255747	433	513	6	5	80	0.0625000
NODE_4455_length_1143_cov_42.255747	433	513	22	13	80	0.1625000
NODE_4455_length_1143_cov_42.255747	509	589	18	7	80	0.0875000
NODE_4455_length_1143_cov_42.255747	509	589	21	1	80	0.0125000
NODE_4455_length_1143_cov_42.255747	509	589	22	20	80	0.2500000
NODE_4455_length_1143_cov_42.255747	509	589	23	11	80	0.1375000
NODE_4455_length_1143_cov_42.255747	509	589	24	38	80	0.4750000
NODE_4455_length_1143_cov_42.255747	509	589	25	3	80	0.0375000
NODE_4455_length_1143_cov_42.255747	562	642	2	11	80	0.1375000
NODE_4455_length_1143_cov_42.255747	562	642	6	19	80	0.2375000
NODE_4455_length_1143_cov_42.255747	562	642	16	20	80	0.2500000
NODE_4455_length_1143_cov_42.255747	562	642	18	10	80	0.1250000
NODE_4455_length_1143_cov_42.255747	562	642	22	7	80	0.0875000
NODE_4455_length_1143_cov_42.255747	562	642	24	13	80	0.1625000
NODE_4456_length_1143_cov_22.076628	526	606	9	29	80	0.3625000
NODE_4456_length_1143_cov_22.076628	526	606	10	33	80	0.4125000
NODE_4456_length_1143_cov_22.076628	526	606	12	7	80	0.0875000
NODE_4456_length_1143_cov_22.076628	526	606	14	1	80	0.0125000
NODE_4456_length_1143_cov_22.076628	526	606	16	8	80	0.1000000
NODE_4456_length_1143_cov_22.076628	526	606	17	1	80	0.0125000
NODE_4456_length_1143_cov_22.076628	526	606	18	1	80	0.0125000
NODE_4456_length_1143_cov_22.076628	579	659	10	11	80	0.1375000
NODE_4456_length_1143_cov_22.076628	579	659	12	18	80	0.2250000
NODE_4456_length_1143_cov_22.076628	579	659	14	41	80	0.5125000
NODE_4456_length_1143_cov_22.076628	579	659	16	8	80	0.1000000
NODE_4456_length_1143_cov_22.076628	579	659	17	1	80	0.0125000
NODE_4456_length_1143_cov_22.076628	579	659	18	1	80	0.0125000
NODE_4457_length_1143_cov_19.106322	565	645	0	80	80	1.0000000
NODE_4457_length_1143_cov_19.106322	618	698	0	80	80	1.0000000
NODE_4458_length_1143_cov_16.223180	638	719	0	81	81	1.0000000
NODE_4458_length_1143_cov_16.223180	692	772	0	80	80	1.0000000
NODE_4459_length_1143_cov_13.961686	634	714	6	3	80	0.0375000
NODE_4459_length_1143_cov_13.961686	634	714	8	17	80	0.2125000
NODE_4459_length_1143_cov_13.961686	634	714	10	29	80	0.3625000
NODE_4459_length_1143_cov_13.961686	634	714	11	2	80	0.0250000
NODE_4459_length_1143_cov_13.961686	634	714	12	29	80	0.3625000
NODE_4459_length_1143_cov_13.961686	687	767	2	33	80	0.4125000
NODE_4459_length_1143_cov_13.961686	687	767	4	10	80	0.1250000
NODE_4459_length_1143_cov_13.961686	687	767	5	1	80	0.0125000
NODE_4459_length_1143_cov_13.961686	687	767	6	12	80	0.1500000
NODE_4459_length_1143_cov_13.961686	687	767	8	15	80	0.1875000
NODE_4459_length_1143_cov_13.961686	687	767	10	9	80	0.1125000
NODE_4459_length_1143_cov_13.961686	763	843	0	68	80	0.8500000
NODE_4459_length_1143_cov_13.961686	763	843	2	12	80	0.1500000
NODE_4459_length_1143_cov_13.961686	816	896	0	80	80	1.0000000
NODE_4460_length_1143_cov_12.782567	328	409	0	81	81	1.0000000
NODE_4460_length_1143_cov_12.782567	381	462	0	81	81	1.0000000
NODE_4460_length_1143_cov_12.782567	458	538	0	24	80	0.3000000
NODE_4460_length_1143_cov_12.782567	458	538	2	56	80	0.7000000
NODE_4460_length_1143_cov_12.782567	511	591	2	80	80	1.0000000
NODE_4461_length_1143_cov_8.287356	692	772	0	16	80	0.2000000
NODE_4461_length_1143_cov_8.287356	692	772	4	64	80	0.8000000
NODE_4461_length_1143_cov_8.287356	745	825	0	9	80	0.1125000
NODE_4461_length_1143_cov_8.287356	745	825	3	1	80	0.0125000
NODE_4461_length_1143_cov_8.287356	745	825	4	70	80	0.8750000
NODE_4463_length_1143_cov_2.197318	988	1057	28	3	69	0.0434783
NODE_4463_length_1143_cov_2.197318	988	1057	29	1	69	0.0144928
NODE_4463_length_1143_cov_2.197318	988	1057	30	9	69	0.1304348
NODE_4463_length_1143_cov_2.197318	988	1057	31	34	69	0.4927536
NODE_4463_length_1143_cov_2.197318	988	1057	32	10	69	0.1449275
NODE_4463_length_1143_cov_2.197318	988	1057	33	12	69	0.1739130
NODE_4466_length_1142_cov_28.364334	613	693	1	21	80	0.2625000
NODE_4466_length_1142_cov_28.364334	613	693	2	59	80	0.7375000
NODE_4466_length_1142_cov_28.364334	666	746	2	73	80	0.9125000
NODE_4466_length_1142_cov_28.364334	666	746	4	7	80	0.0875000
NODE_4467_length_1142_cov_21.669223	518	598	0	36	80	0.4500000
NODE_4467_length_1142_cov_21.669223	518	598	6	44	80	0.5500000
NODE_4467_length_1142_cov_21.669223	571	651	0	16	80	0.2000000
NODE_4467_length_1142_cov_21.669223	571	651	6	64	80	0.8000000
NODE_4468_length_1142_cov_19.007670	411	491	6	31	80	0.3875000
NODE_4468_length_1142_cov_19.007670	411	491	13	1	80	0.0125000
NODE_4468_length_1142_cov_19.007670	411	491	14	7	80	0.0875000
NODE_4468_length_1142_cov_19.007670	411	491	28	24	80	0.3000000
NODE_4468_length_1142_cov_19.007670	411	491	29	1	80	0.0125000
NODE_4468_length_1142_cov_19.007670	411	491	30	7	80	0.0875000
NODE_4468_length_1142_cov_19.007670	411	491	32	1	80	0.0125000
NODE_4468_length_1142_cov_19.007670	411	491	34	8	80	0.1000000
NODE_4468_length_1142_cov_19.007670	464	544	2	10	80	0.1250000
NODE_4468_length_1142_cov_19.007670	464	544	14	3	80	0.0375000
NODE_4468_length_1142_cov_19.007670	464	544	28	50	80	0.6250000
NODE_4468_length_1142_cov_19.007670	464	544	29	1	80	0.0125000
NODE_4468_length_1142_cov_19.007670	464	544	30	7	80	0.0875000
NODE_4468_length_1142_cov_19.007670	464	544	32	1	80	0.0125000
NODE_4468_length_1142_cov_19.007670	464	544	34	8	80	0.1000000
NODE_4474_length_1141_cov_12.500960	17	97	4	6	80	0.0750000
NODE_4474_length_1141_cov_12.500960	17	97	6	22	80	0.2750000
NODE_4474_length_1141_cov_12.500960	17	97	8	12	80	0.1500000
NODE_4474_length_1141_cov_12.500960	17	97	10	40	80	0.5000000
NODE_4474_length_1141_cov_12.500960	17	97	4	6	80	0.0750000
NODE_4474_length_1141_cov_12.500960	17	97	6	22	80	0.2750000
NODE_4474_length_1141_cov_12.500960	17	97	8	12	80	0.1500000
NODE_4474_length_1141_cov_12.500960	17	97	10	40	80	0.5000000
NODE_4474_length_1141_cov_12.500960	17	97	4	6	80	0.0750000
NODE_4474_length_1141_cov_12.500960	17	97	6	22	80	0.2750000
NODE_4474_length_1141_cov_12.500960	17	97	8	12	80	0.1500000
NODE_4474_length_1141_cov_12.500960	17	97	10	40	80	0.5000000
NODE_4474_length_1141_cov_12.500960	17	97	4	6	80	0.0750000
NODE_4474_length_1141_cov_12.500960	17	97	6	22	80	0.2750000
NODE_4474_length_1141_cov_12.500960	17	97	8	12	80	0.1500000
NODE_4474_length_1141_cov_12.500960	17	97	10	40	80	0.5000000
NODE_4474_length_1141_cov_12.500960	70	132	6	10	62	0.1612903
NODE_4474_length_1141_cov_12.500960	70	132	8	3	62	0.0483871
NODE_4474_length_1141_cov_12.500960	70	132	10	49	62	0.7903226
NODE_4474_length_1141_cov_12.500960	70	132	6	10	62	0.1612903
NODE_4474_length_1141_cov_12.500960	70	132	8	3	62	0.0483871
NODE_4474_length_1141_cov_12.500960	70	132	10	49	62	0.7903226
NODE_4474_length_1141_cov_12.500960	70	132	6	10	62	0.1612903
NODE_4474_length_1141_cov_12.500960	70	132	8	3	62	0.0483871
NODE_4474_length_1141_cov_12.500960	70	132	10	49	62	0.7903226
NODE_4474_length_1141_cov_12.500960	70	132	6	10	62	0.1612903
NODE_4474_length_1141_cov_12.500960	70	132	8	3	62	0.0483871
NODE_4474_length_1141_cov_12.500960	70	132	10	49	62	0.7903226
NODE_4475_length_1141_cov_7.197697	54	134	2	80	80	1.0000000
NODE_4475_length_1141_cov_7.197697	107	187	0	51	80	0.6375000
NODE_4475_length_1141_cov_7.197697	107	187	2	29	80	0.3625000
NODE_4475_length_1141_cov_7.197697	573	653	0	80	80	1.0000000
NODE_4475_length_1141_cov_7.197697	626	707	0	81	81	1.0000000
NODE_4476_length_1141_cov_5.428023	411	491	0	80	80	1.0000000
NODE_4476_length_1141_cov_5.428023	464	544	0	80	80	1.0000000
NODE_4482_length_1140_cov_39.383285	451	531	6	16	80	0.2000000
NODE_4482_length_1140_cov_39.383285	451	531	8	22	80	0.2750000
NODE_4482_length_1140_cov_39.383285	451	531	10	1	80	0.0125000
NODE_4482_length_1140_cov_39.383285	451	531	12	13	80	0.1625000
NODE_4482_length_1140_cov_39.383285	451	531	14	28	80	0.3500000
NODE_4482_length_1140_cov_39.383285	504	584	0	6	80	0.0750000
NODE_4482_length_1140_cov_39.383285	504	584	2	2	80	0.0250000
NODE_4482_length_1140_cov_39.383285	504	584	4	8	80	0.1000000
NODE_4482_length_1140_cov_39.383285	504	584	6	34	80	0.4250000
NODE_4482_length_1140_cov_39.383285	504	584	12	3	80	0.0375000
NODE_4482_length_1140_cov_39.383285	504	584	14	27	80	0.3375000
NODE_4482_length_1140_cov_39.383285	580	660	0	80	80	1.0000000
NODE_4482_length_1140_cov_39.383285	633	713	0	80	80	1.0000000
NODE_4483_length_1140_cov_19.493756	543	623	2	29	80	0.3625000
NODE_4483_length_1140_cov_19.493756	543	623	6	29	80	0.3625000
NODE_4483_length_1140_cov_19.493756	543	623	8	22	80	0.2750000
NODE_4483_length_1140_cov_19.493756	596	676	6	80	80	1.0000000
NODE_4484_length_1140_cov_18.341018	347	427	0	6	80	0.0750000
NODE_4484_length_1140_cov_18.341018	347	427	2	74	80	0.9250000
NODE_4484_length_1140_cov_18.341018	400	480	0	59	80	0.7375000
NODE_4484_length_1140_cov_18.341018	400	480	2	21	80	0.2625000
NODE_4484_length_1140_cov_18.341018	476	556	0	15	80	0.1875000
NODE_4484_length_1140_cov_18.341018	476	556	2	65	80	0.8125000
NODE_4484_length_1140_cov_18.341018	529	609	2	58	80	0.7250000
NODE_4484_length_1140_cov_18.341018	529	609	4	22	80	0.2750000
NODE_4494_length_1139_cov_26.812500	410	490	0	80	80	1.0000000
NODE_4494_length_1139_cov_26.812500	463	543	0	80	80	1.0000000
NODE_4494_length_1139_cov_26.812500	539	619	0	68	80	0.8500000
NODE_4494_length_1139_cov_26.812500	539	619	2	12	80	0.1500000
NODE_4494_length_1139_cov_26.812500	592	672	0	15	80	0.1875000
NODE_4494_length_1139_cov_26.812500	592	672	2	65	80	0.8125000
NODE_4495_length_1139_cov_26.323077	308	388	0	80	80	1.0000000
NODE_4495_length_1139_cov_26.323077	361	441	0	80	80	1.0000000
NODE_4495_length_1139_cov_26.323077	437	517	0	80	80	1.0000000
NODE_4495_length_1139_cov_26.323077	490	570	0	80	80	1.0000000
NODE_4496_length_1139_cov_15.223077	530	610	0	80	80	1.0000000
NODE_4496_length_1139_cov_15.223077	583	663	0	80	80	1.0000000
NODE_4505_length_1138_cov_74.599615	480	560	0	20	80	0.2500000
NODE_4505_length_1138_cov_74.599615	480	560	2	60	80	0.7500000
NODE_4505_length_1138_cov_74.599615	533	613	0	24	80	0.3000000
NODE_4505_length_1138_cov_74.599615	533	613	2	56	80	0.7000000
NODE_4505_length_1138_cov_74.599615	609	689	0	11	80	0.1375000
NODE_4505_length_1138_cov_74.599615	609	689	4	69	80	0.8625000
NODE_4505_length_1138_cov_74.599615	662	742	4	80	80	1.0000000
NODE_4506_length_1138_cov_29.407122	559	639	0	80	80	1.0000000
NODE_4506_length_1138_cov_29.407122	612	692	0	80	80	1.0000000
NODE_4506_length_1138_cov_29.407122	688	768	0	80	80	1.0000000
NODE_4506_length_1138_cov_29.407122	741	821	0	80	80	1.0000000
NODE_4507_length_1138_cov_18.326275	454	534	0	80	80	1.0000000
NODE_4507_length_1138_cov_18.326275	507	587	0	80	80	1.0000000
NODE_4507_length_1138_cov_18.326275	583	663	0	10	80	0.1250000
NODE_4507_length_1138_cov_18.326275	583	663	4	70	80	0.8750000
NODE_4507_length_1138_cov_18.326275	636	716	0	31	80	0.3875000
NODE_4507_length_1138_cov_18.326275	636	716	3	2	80	0.0250000
NODE_4507_length_1138_cov_18.326275	636	716	4	47	80	0.5875000
NODE_4509_length_1138_cov_11.834456	291	371	0	80	80	1.0000000
NODE_4509_length_1138_cov_11.834456	344	424	0	80	80	1.0000000
NODE_4510_length_1138_cov_10.923003	318	398	0	76	80	0.9500000
NODE_4510_length_1138_cov_10.923003	318	398	2	4	80	0.0500000
NODE_4510_length_1138_cov_10.923003	371	451	0	23	80	0.2875000
NODE_4510_length_1138_cov_10.923003	371	451	2	57	80	0.7125000
NODE_4517_length_1137_cov_23.983622	470	550	0	80	80	1.0000000
NODE_4517_length_1137_cov_23.983622	523	603	0	80	80	1.0000000
NODE_4517_length_1137_cov_23.983622	599	679	0	5	80	0.0625000
NODE_4517_length_1137_cov_23.983622	599	679	2	28	80	0.3500000
NODE_4517_length_1137_cov_23.983622	599	679	3	9	80	0.1125000
NODE_4517_length_1137_cov_23.983622	599	679	4	38	80	0.4750000
NODE_4517_length_1137_cov_23.983622	652	732	0	8	80	0.1000000
NODE_4517_length_1137_cov_23.983622	652	732	2	9	80	0.1125000
NODE_4517_length_1137_cov_23.983622	652	732	4	63	80	0.7875000
NODE_4518_length_1137_cov_22.877649	405	485	0	17	80	0.2125000
NODE_4518_length_1137_cov_22.877649	405	485	2	6	80	0.0750000
NODE_4518_length_1137_cov_22.877649	405	485	4	56	80	0.7000000
NODE_4518_length_1137_cov_22.877649	405	485	6	1	80	0.0125000
NODE_4518_length_1137_cov_22.877649	458	538	4	26	80	0.3250000
NODE_4518_length_1137_cov_22.877649	458	538	6	23	80	0.2875000
NODE_4518_length_1137_cov_22.877649	458	538	8	31	80	0.3875000
NODE_4518_length_1137_cov_22.877649	534	614	2	13	80	0.1625000
NODE_4518_length_1137_cov_22.877649	534	614	4	27	80	0.3375000
NODE_4518_length_1137_cov_22.877649	534	614	6	34	80	0.4250000
NODE_4518_length_1137_cov_22.877649	534	614	8	6	80	0.0750000
NODE_4518_length_1137_cov_22.877649	587	667	0	3	80	0.0375000
NODE_4518_length_1137_cov_22.877649	587	667	2	63	80	0.7875000
NODE_4518_length_1137_cov_22.877649	587	667	4	6	80	0.0750000
NODE_4518_length_1137_cov_22.877649	587	667	6	8	80	0.1000000
NODE_4519_length_1137_cov_21.570328	383	463	0	80	80	1.0000000
NODE_4519_length_1137_cov_21.570328	436	516	0	38	80	0.4750000
NODE_4519_length_1137_cov_21.570328	436	516	2	23	80	0.2875000
NODE_4519_length_1137_cov_21.570328	436	516	4	19	80	0.2375000
NODE_4520_length_1137_cov_18.560694	665	745	2	34	80	0.4250000
NODE_4520_length_1137_cov_18.560694	665	745	4	46	80	0.5750000
NODE_4520_length_1137_cov_18.560694	718	798	0	14	80	0.1750000
NODE_4520_length_1137_cov_18.560694	718	798	2	55	80	0.6875000
NODE_4520_length_1137_cov_18.560694	718	798	4	11	80	0.1375000
NODE_4521_length_1137_cov_18.505780	557	637	0	80	80	1.0000000
NODE_4521_length_1137_cov_18.505780	610	690	0	80	80	1.0000000
NODE_4521_length_1137_cov_18.505780	686	766	0	6	80	0.0750000
NODE_4521_length_1137_cov_18.505780	686	766	2	74	80	0.9250000
NODE_4521_length_1137_cov_18.505780	739	819	2	80	80	1.0000000
NODE_4523_length_1137_cov_11.866089	313	393	0	21	80	0.2625000
NODE_4523_length_1137_cov_11.866089	313	393	2	59	80	0.7375000
NODE_4523_length_1137_cov_11.866089	366	446	0	74	80	0.9250000
NODE_4523_length_1137_cov_11.866089	366	446	2	6	80	0.0750000
NODE_4523_length_1137_cov_11.866089	442	522	0	80	80	1.0000000
NODE_4523_length_1137_cov_11.866089	495	575	0	80	80	1.0000000
NODE_4524_length_1137_cov_5.594412	144	224	0	80	80	1.0000000
NODE_4524_length_1137_cov_5.594412	197	277	0	80	80	1.0000000
NODE_4532_length_1136_cov_42.827387	445	525	2	22	80	0.2750000
NODE_4532_length_1136_cov_42.827387	445	525	6	58	80	0.7250000
NODE_4532_length_1136_cov_42.827387	498	578	0	36	80	0.4500000
NODE_4532_length_1136_cov_42.827387	498	578	2	32	80	0.4000000
NODE_4532_length_1136_cov_42.827387	498	578	6	12	80	0.1500000
NODE_4532_length_1136_cov_42.827387	574	654	0	80	80	1.0000000
NODE_4532_length_1136_cov_42.827387	627	707	0	80	80	1.0000000
NODE_4533_length_1136_cov_30.940212	534	614	0	80	80	1.0000000
NODE_4533_length_1136_cov_30.940212	587	667	0	80	80	1.0000000
NODE_4533_length_1136_cov_30.940212	663	743	0	27	80	0.3375000
NODE_4533_length_1136_cov_30.940212	663	743	4	6	80	0.0750000
NODE_4533_length_1136_cov_30.940212	663	743	6	47	80	0.5875000
NODE_4533_length_1136_cov_30.940212	716	796	4	22	80	0.2750000
NODE_4533_length_1136_cov_30.940212	716	796	6	58	80	0.7250000
NODE_4534_length_1136_cov_30.797493	557	637	0	30	80	0.3750000
NODE_4534_length_1136_cov_30.797493	557	637	5	15	80	0.1875000
NODE_4534_length_1136_cov_30.797493	557	637	6	35	80	0.4375000
NODE_4534_length_1136_cov_30.797493	610	691	0	19	81	0.2345679
NODE_4534_length_1136_cov_30.797493	610	691	6	62	81	0.7654321
NODE_4534_length_1136_cov_30.797493	687	767	0	80	80	1.0000000
NODE_4534_length_1136_cov_30.797493	740	820	0	80	80	1.0000000
NODE_4535_length_1136_cov_23.142719	704	784	0	50	80	0.6250000
NODE_4535_length_1136_cov_23.142719	704	784	6	16	80	0.2000000
NODE_4535_length_1136_cov_23.142719	704	784	8	14	80	0.1750000
NODE_4535_length_1136_cov_23.142719	757	837	6	13	80	0.1625000
NODE_4535_length_1136_cov_23.142719	757	837	8	67	80	0.8375000
NODE_4536_length_1136_cov_21.798457	570	651	1	17	81	0.2098765
NODE_4536_length_1136_cov_21.798457	570	651	2	18	81	0.2222222
NODE_4536_length_1136_cov_21.798457	570	651	8	42	81	0.5185185
NODE_4536_length_1136_cov_21.798457	570	651	9	4	81	0.0493827
NODE_4536_length_1136_cov_21.798457	624	704	8	80	80	1.0000000
NODE_4537_length_1136_cov_21.109932	460	532	0	70	72	0.9722222
NODE_4537_length_1136_cov_21.109932	460	532	4	2	72	0.0277778
NODE_4537_length_1136_cov_21.109932	505	585	0	25	80	0.3125000
NODE_4537_length_1136_cov_21.109932	505	585	4	12	80	0.1500000
NODE_4537_length_1136_cov_21.109932	505	585	6	43	80	0.5375000
NODE_4538_length_1136_cov_20.528447	19	99	5	6	80	0.0750000
NODE_4538_length_1136_cov_20.528447	19	99	8	11	80	0.1375000
NODE_4538_length_1136_cov_20.528447	19	99	10	5	80	0.0625000
NODE_4538_length_1136_cov_20.528447	19	99	12	12	80	0.1500000
NODE_4538_length_1136_cov_20.528447	19	99	14	5	80	0.0625000
NODE_4538_length_1136_cov_20.528447	19	99	15	8	80	0.1000000
NODE_4538_length_1136_cov_20.528447	19	99	20	6	80	0.0750000
NODE_4538_length_1136_cov_20.528447	19	99	22	6	80	0.0750000
NODE_4538_length_1136_cov_20.528447	19	99	23	14	80	0.1750000
NODE_4538_length_1136_cov_20.528447	19	99	25	7	80	0.0875000
NODE_4538_length_1136_cov_20.528447	19	99	5	6	80	0.0750000
NODE_4538_length_1136_cov_20.528447	19	99	8	11	80	0.1375000
NODE_4538_length_1136_cov_20.528447	19	99	10	5	80	0.0625000
NODE_4538_length_1136_cov_20.528447	19	99	12	12	80	0.1500000
NODE_4538_length_1136_cov_20.528447	19	99	14	5	80	0.0625000
NODE_4538_length_1136_cov_20.528447	19	99	15	8	80	0.1000000
NODE_4538_length_1136_cov_20.528447	19	99	20	6	80	0.0750000
NODE_4538_length_1136_cov_20.528447	19	99	22	6	80	0.0750000
NODE_4538_length_1136_cov_20.528447	19	99	23	14	80	0.1750000
NODE_4538_length_1136_cov_20.528447	19	99	25	7	80	0.0875000
NODE_4538_length_1136_cov_20.528447	28	99	8	8	71	0.1126761
NODE_4538_length_1136_cov_20.528447	28	99	10	5	71	0.0704225
NODE_4538_length_1136_cov_20.528447	28	99	12	12	71	0.1690141
NODE_4538_length_1136_cov_20.528447	28	99	14	5	71	0.0704225
NODE_4538_length_1136_cov_20.528447	28	99	15	8	71	0.1126761
NODE_4538_length_1136_cov_20.528447	28	99	20	6	71	0.0845070
NODE_4538_length_1136_cov_20.528447	28	99	22	6	71	0.0845070
NODE_4538_length_1136_cov_20.528447	28	99	23	14	71	0.1971831
NODE_4538_length_1136_cov_20.528447	28	99	25	7	71	0.0985916
NODE_4538_length_1136_cov_20.528447	877	912	0	35	35	1.0000000
NODE_4538_length_1136_cov_20.528447	879	921	0	42	42	1.0000000
NODE_4539_length_1136_cov_14.921890	657	737	0	50	80	0.6250000
NODE_4539_length_1136_cov_14.921890	657	737	2	30	80	0.3750000
NODE_4539_length_1136_cov_14.921890	710	790	0	16	80	0.2000000
NODE_4539_length_1136_cov_14.921890	710	790	2	64	80	0.8000000
NODE_4556_length_1135_cov_100.121622	454	534	2	6	80	0.0750000
NODE_4556_length_1135_cov_100.121622	454	534	4	74	80	0.9250000
NODE_4556_length_1135_cov_100.121622	507	587	4	39	80	0.4875000
NODE_4556_length_1135_cov_100.121622	507	587	6	6	80	0.0750000
NODE_4556_length_1135_cov_100.121622	507	587	16	1	80	0.0125000
NODE_4556_length_1135_cov_100.121622	507	587	21	6	80	0.0750000
NODE_4556_length_1135_cov_100.121622	507	587	24	1	80	0.0125000
NODE_4556_length_1135_cov_100.121622	507	587	25	1	80	0.0125000
NODE_4556_length_1135_cov_100.121622	507	587	39	4	80	0.0500000
NODE_4556_length_1135_cov_100.121622	507	587	40	11	80	0.1375000
NODE_4556_length_1135_cov_100.121622	507	587	43	3	80	0.0375000
NODE_4556_length_1135_cov_100.121622	507	587	45	8	80	0.1000000
NODE_4556_length_1135_cov_100.121622	583	663	39	2	80	0.0250000
NODE_4556_length_1135_cov_100.121622	583	663	40	4	80	0.0500000
NODE_4556_length_1135_cov_100.121622	583	663	55	12	80	0.1500000
NODE_4556_length_1135_cov_100.121622	583	663	59	34	80	0.4250000
NODE_4556_length_1135_cov_100.121622	583	663	60	10	80	0.1250000
NODE_4556_length_1135_cov_100.121622	583	663	61	8	80	0.1000000
NODE_4556_length_1135_cov_100.121622	583	663	62	10	80	0.1250000
NODE_4556_length_1135_cov_100.121622	636	719	4	8	83	0.0963855
NODE_4556_length_1135_cov_100.121622	636	719	18	1	83	0.0120482
NODE_4556_length_1135_cov_100.121622	636	719	19	3	83	0.0361446
NODE_4556_length_1135_cov_100.121622	636	719	23	5	83	0.0602410
NODE_4556_length_1135_cov_100.121622	636	719	33	1	83	0.0120482
NODE_4556_length_1135_cov_100.121622	636	719	35	4	83	0.0481928
NODE_4556_length_1135_cov_100.121622	636	719	37	6	83	0.0722892
NODE_4556_length_1135_cov_100.121622	636	719	50	1	83	0.0120482
NODE_4556_length_1135_cov_100.121622	636	719	52	1	83	0.0120482
NODE_4556_length_1135_cov_100.121622	636	719	53	1	83	0.0120482
NODE_4556_length_1135_cov_100.121622	636	719	54	11	83	0.1325301
NODE_4556_length_1135_cov_100.121622	636	719	57	3	83	0.0361446
NODE_4556_length_1135_cov_100.121622	636	719	58	5	83	0.0602410
NODE_4556_length_1135_cov_100.121622	636	719	59	5	83	0.0602410
NODE_4556_length_1135_cov_100.121622	636	719	60	10	83	0.1204819
NODE_4556_length_1135_cov_100.121622	636	719	61	7	83	0.0843373
NODE_4556_length_1135_cov_100.121622	636	719	62	11	83	0.1325301
NODE_4557_length_1135_cov_34.523166	313	393	14	80	80	1.0000000
NODE_4557_length_1135_cov_34.523166	366	446	0	7	80	0.0875000
NODE_4557_length_1135_cov_34.523166	366	446	14	73	80	0.9125000
NODE_4558_length_1135_cov_20.735521	484	564	2	80	80	1.0000000
NODE_4558_length_1135_cov_20.735521	537	617	0	39	80	0.4875000
NODE_4558_length_1135_cov_20.735521	537	617	1	9	80	0.1125000
NODE_4558_length_1135_cov_20.735521	537	617	2	32	80	0.4000000
NODE_4558_length_1135_cov_20.735521	613	693	0	32	80	0.4000000
NODE_4558_length_1135_cov_20.735521	613	693	2	43	80	0.5375000
NODE_4558_length_1135_cov_20.735521	613	693	4	5	80	0.0625000
NODE_4558_length_1135_cov_20.735521	666	746	2	22	80	0.2750000
NODE_4558_length_1135_cov_20.735521	666	746	4	58	80	0.7250000
NODE_4559_length_1135_cov_9.644788	620	700	0	80	80	1.0000000
NODE_4559_length_1135_cov_9.644788	673	753	0	80	80	1.0000000
NODE_4562_length_1135_cov_2.990347	349	429	0	80	80	1.0000000
NODE_4562_length_1135_cov_2.990347	402	482	0	80	80	1.0000000
NODE_4571_length_1134_cov_34.784541	478	558	0	80	80	1.0000000
NODE_4571_length_1134_cov_34.784541	531	611	0	80	80	1.0000000
NODE_4571_length_1134_cov_34.784541	607	687	0	41	80	0.5125000
NODE_4571_length_1134_cov_34.784541	607	687	2	39	80	0.4875000
NODE_4571_length_1134_cov_34.784541	660	740	0	19	80	0.2375000
NODE_4571_length_1134_cov_34.784541	660	740	2	61	80	0.7625000
NODE_4572_length_1134_cov_28.524638	511	591	0	80	80	1.0000000
NODE_4572_length_1134_cov_28.524638	564	644	0	80	80	1.0000000
NODE_4572_length_1134_cov_28.524638	640	720	0	80	80	1.0000000
NODE_4572_length_1134_cov_28.524638	693	773	0	80	80	1.0000000
NODE_4576_length_1134_cov_2.619324	606	686	0	80	80	1.0000000
NODE_4576_length_1134_cov_2.619324	659	739	0	80	80	1.0000000
NODE_4584_length_1133_cov_5.563830	292	372	0	80	80	1.0000000
NODE_4584_length_1133_cov_5.563830	345	425	0	80	80	1.0000000
NODE_4584_length_1133_cov_5.563830	904	966	4	7	62	0.1129032
NODE_4584_length_1133_cov_5.563830	904	966	6	9	62	0.1451613
NODE_4584_length_1133_cov_5.563830	904	966	8	5	62	0.0806452
NODE_4584_length_1133_cov_5.563830	904	966	10	25	62	0.4032258
NODE_4584_length_1133_cov_5.563830	904	966	14	16	62	0.2580645
NODE_4592_length_1132_cov_23.121007	485	565	0	80	80	1.0000000
NODE_4592_length_1132_cov_23.121007	538	618	0	80	80	1.0000000
NODE_4592_length_1132_cov_23.121007	618	664	0	46	46	1.0000000
NODE_4592_length_1132_cov_23.121007	700	751	0	51	51	1.0000000
NODE_4593_length_1132_cov_19.377541	595	675	0	35	80	0.4375000
NODE_4593_length_1132_cov_19.377541	595	675	2	14	80	0.1750000
NODE_4593_length_1132_cov_19.377541	595	675	3	18	80	0.2250000
NODE_4593_length_1132_cov_19.377541	595	675	7	5	80	0.0625000
NODE_4593_length_1132_cov_19.377541	595	675	11	2	80	0.0250000
NODE_4593_length_1132_cov_19.377541	595	675	15	6	80	0.0750000
NODE_4593_length_1132_cov_19.377541	648	728	3	14	80	0.1750000
NODE_4593_length_1132_cov_19.377541	648	728	7	5	80	0.0625000
NODE_4593_length_1132_cov_19.377541	648	728	11	2	80	0.0250000
NODE_4593_length_1132_cov_19.377541	648	728	13	32	80	0.4000000
NODE_4593_length_1132_cov_19.377541	648	728	15	27	80	0.3375000
NODE_4594_length_1132_cov_18.872217	363	443	0	75	80	0.9375000
NODE_4594_length_1132_cov_18.872217	363	443	4	5	80	0.0625000
NODE_4594_length_1132_cov_18.872217	416	496	0	22	80	0.2750000
NODE_4594_length_1132_cov_18.872217	416	496	4	25	80	0.3125000
NODE_4594_length_1132_cov_18.872217	416	496	6	33	80	0.4125000
NODE_4595_length_1132_cov_11.242982	474	554	2	80	80	1.0000000
NODE_4595_length_1132_cov_11.242982	527	607	2	80	80	1.0000000
NODE_4596_length_1132_cov_7.356244	354	434	0	80	80	1.0000000
NODE_4596_length_1132_cov_7.356244	407	487	0	80	80	1.0000000
NODE_4597_length_1132_cov_6.214908	269	349	0	16	80	0.2000000
NODE_4597_length_1132_cov_6.214908	269	349	2	64	80	0.8000000
NODE_4597_length_1132_cov_6.214908	322	402	0	21	80	0.2625000
NODE_4597_length_1132_cov_6.214908	322	402	2	59	80	0.7375000
NODE_4606_length_1131_cov_36.161822	478	558	0	80	80	1.0000000
NODE_4606_length_1131_cov_36.161822	531	611	0	80	80	1.0000000
NODE_4606_length_1131_cov_36.161822	607	687	0	27	80	0.3375000
NODE_4606_length_1131_cov_36.161822	607	687	10	10	80	0.1250000
NODE_4606_length_1131_cov_36.161822	607	687	12	10	80	0.1250000
NODE_4606_length_1131_cov_36.161822	607	687	16	22	80	0.2750000
NODE_4606_length_1131_cov_36.161822	607	687	18	11	80	0.1375000
NODE_4606_length_1131_cov_36.161822	660	740	6	15	80	0.1875000
NODE_4606_length_1131_cov_36.161822	660	740	8	1	80	0.0125000
NODE_4606_length_1131_cov_36.161822	660	740	16	16	80	0.2000000
NODE_4606_length_1131_cov_36.161822	660	740	18	48	80	0.6000000
NODE_4607_length_1131_cov_31.907946	390	470	0	80	80	1.0000000
NODE_4607_length_1131_cov_31.907946	443	523	0	80	80	1.0000000
NODE_4607_length_1131_cov_31.907946	519	599	0	80	80	1.0000000
NODE_4607_length_1131_cov_31.907946	572	652	0	80	80	1.0000000
NODE_4608_length_1131_cov_26.827519	464	544	0	80	80	1.0000000
NODE_4608_length_1131_cov_26.827519	517	597	0	80	80	1.0000000
NODE_4609_length_1131_cov_20.441860	555	635	4	80	80	1.0000000
NODE_4609_length_1131_cov_20.441860	608	688	0	53	80	0.6625000
NODE_4609_length_1131_cov_20.441860	608	688	4	27	80	0.3375000
NODE_4610_length_1131_cov_12.517442	420	500	0	75	80	0.9375000
NODE_4610_length_1131_cov_12.517442	420	500	2	5	80	0.0625000
NODE_4610_length_1131_cov_12.517442	473	553	0	80	80	1.0000000
NODE_4611_length_1131_cov_10.912791	429	509	0	54	80	0.6750000
NODE_4611_length_1131_cov_10.912791	429	509	2	26	80	0.3250000
NODE_4611_length_1131_cov_10.912791	482	562	0	80	80	1.0000000
NODE_4620_length_1130_cov_43.354995	742	822	2	52	80	0.6500000
NODE_4620_length_1130_cov_43.354995	742	822	4	19	80	0.2375000
NODE_4620_length_1130_cov_43.354995	742	822	6	9	80	0.1125000
NODE_4620_length_1130_cov_43.354995	795	875	2	6	80	0.0750000
NODE_4620_length_1130_cov_43.354995	795	875	4	41	80	0.5125000
NODE_4620_length_1130_cov_43.354995	795	875	6	33	80	0.4125000
NODE_4621_length_1130_cov_13.097963	642	722	6	11	80	0.1375000
NODE_4621_length_1130_cov_13.097963	642	722	17	1	80	0.0125000
NODE_4621_length_1130_cov_13.097963	642	722	18	18	80	0.2250000
NODE_4621_length_1130_cov_13.097963	642	722	20	1	80	0.0125000
NODE_4621_length_1130_cov_13.097963	642	722	26	3	80	0.0375000
NODE_4621_length_1130_cov_13.097963	642	722	27	3	80	0.0375000
NODE_4621_length_1130_cov_13.097963	642	722	28	39	80	0.4875000
NODE_4621_length_1130_cov_13.097963	642	722	30	4	80	0.0500000
NODE_4621_length_1130_cov_13.097963	695	775	26	30	80	0.3750000
NODE_4621_length_1130_cov_13.097963	695	775	27	2	80	0.0250000
NODE_4621_length_1130_cov_13.097963	695	775	28	26	80	0.3250000
NODE_4621_length_1130_cov_13.097963	695	775	30	22	80	0.2750000
NODE_4626_length_1129_cov_31.088350	396	476	0	42	80	0.5250000
NODE_4626_length_1129_cov_31.088350	396	476	2	38	80	0.4750000
NODE_4626_length_1129_cov_31.088350	449	529	0	80	80	1.0000000
NODE_4627_length_1129_cov_20.591262	450	530	0	19	80	0.2375000
NODE_4627_length_1129_cov_20.591262	450	530	4	61	80	0.7625000
NODE_4627_length_1129_cov_20.591262	503	583	0	10	80	0.1250000
NODE_4627_length_1129_cov_20.591262	503	583	4	70	80	0.8750000
NODE_4628_length_1129_cov_16.934951	261	341	0	60	80	0.7500000
NODE_4628_length_1129_cov_16.934951	261	341	4	20	80	0.2500000
NODE_4628_length_1129_cov_16.934951	314	394	0	7	80	0.0875000
NODE_4628_length_1129_cov_16.934951	314	394	4	25	80	0.3125000
NODE_4628_length_1129_cov_16.934951	314	394	6	48	80	0.6000000
NODE_4629_length_1129_cov_9.441748	665	738	0	73	73	1.0000000
NODE_4629_length_1129_cov_9.441748	711	791	0	80	80	1.0000000
NODE_4630_length_1129_cov_9.260194	658	738	0	50	80	0.6250000
NODE_4630_length_1129_cov_9.260194	658	738	2	30	80	0.3750000
NODE_4630_length_1129_cov_9.260194	711	791	0	80	80	1.0000000
NODE_4631_length_1129_cov_5.055340	759	839	4	80	80	1.0000000
NODE_4638_length_1128_cov_48.099125	588	668	0	80	80	1.0000000
NODE_4638_length_1128_cov_48.099125	641	721	0	80	80	1.0000000
NODE_4640_length_1128_cov_26.230321	455	535	0	14	80	0.1750000
NODE_4640_length_1128_cov_26.230321	455	535	1	1	80	0.0125000
NODE_4640_length_1128_cov_26.230321	455	535	2	65	80	0.8125000
NODE_4640_length_1128_cov_26.230321	508	588	0	12	80	0.1500000
NODE_4640_length_1128_cov_26.230321	508	588	2	68	80	0.8500000
NODE_4640_length_1128_cov_26.230321	584	664	0	26	80	0.3250000
NODE_4640_length_1128_cov_26.230321	584	664	5	1	80	0.0125000
NODE_4640_length_1128_cov_26.230321	584	664	6	1	80	0.0125000
NODE_4640_length_1128_cov_26.230321	584	664	12	52	80	0.6500000
NODE_4640_length_1128_cov_26.230321	637	718	6	11	81	0.1358025
NODE_4640_length_1128_cov_26.230321	637	718	12	70	81	0.8641976
NODE_4641_length_1128_cov_26.031098	594	674	0	80	80	1.0000000
NODE_4641_length_1128_cov_26.031098	647	727	0	80	80	1.0000000
NODE_4642_length_1128_cov_25.869776	465	538	0	73	73	1.0000000
NODE_4642_length_1128_cov_25.869776	601	674	0	19	73	0.2602740
NODE_4642_length_1128_cov_25.869776	601	674	4	20	73	0.2739726
NODE_4642_length_1128_cov_25.869776	601	674	6	34	73	0.4657534
NODE_4642_length_1128_cov_25.869776	647	723	6	76	76	1.0000000
NODE_4643_length_1128_cov_24.185617	350	430	0	23	80	0.2875000
NODE_4643_length_1128_cov_24.185617	350	430	6	33	80	0.4125000
NODE_4643_length_1128_cov_24.185617	350	430	8	24	80	0.3000000
NODE_4643_length_1128_cov_24.185617	403	483	6	3	80	0.0375000
NODE_4643_length_1128_cov_24.185617	403	483	8	77	80	0.9625000
NODE_4644_length_1128_cov_18.537415	335	415	0	25	80	0.3125000
NODE_4644_length_1128_cov_18.537415	335	415	6	55	80	0.6875000
NODE_4644_length_1128_cov_18.537415	388	468	0	30	80	0.3750000
NODE_4644_length_1128_cov_18.537415	388	468	6	50	80	0.6250000
NODE_4645_length_1128_cov_9.345967	690	770	0	80	80	1.0000000
NODE_4645_length_1128_cov_9.345967	743	823	0	80	80	1.0000000
NODE_4647_length_1128_cov_3.920311	675	725	2	50	50	1.0000000
NODE_4647_length_1128_cov_3.920311	698	778	0	24	80	0.3000000
NODE_4647_length_1128_cov_3.920311	698	778	2	56	80	0.7000000
NODE_4648_length_1128_cov_3.631681	613	693	0	80	80	1.0000000
NODE_4648_length_1128_cov_3.631681	666	746	0	80	80	1.0000000
NODE_4650_length_1128_cov_3.091351	519	599	0	58	80	0.7250000
NODE_4650_length_1128_cov_3.091351	519	599	1	22	80	0.2750000
NODE_4650_length_1128_cov_3.091351	572	652	0	80	80	1.0000000
NODE_4660_length_1127_cov_38.932879	405	485	0	2	80	0.0250000
NODE_4660_length_1127_cov_38.932879	405	485	2	78	80	0.9750000
NODE_4660_length_1127_cov_38.932879	458	538	0	20	80	0.2500000
NODE_4660_length_1127_cov_38.932879	458	538	2	60	80	0.7500000
NODE_4660_length_1127_cov_38.932879	534	614	0	57	80	0.7125000
NODE_4660_length_1127_cov_38.932879	534	614	1	1	80	0.0125000
NODE_4660_length_1127_cov_38.932879	534	614	2	22	80	0.2750000
NODE_4660_length_1127_cov_38.932879	587	667	0	4	80	0.0500000
NODE_4660_length_1127_cov_38.932879	587	667	1	1	80	0.0125000
NODE_4660_length_1127_cov_38.932879	587	667	2	75	80	0.9375000
NODE_4661_length_1127_cov_37.721790	236	316	2	70	80	0.8750000
NODE_4661_length_1127_cov_37.721790	236	316	4	10	80	0.1250000
NODE_4661_length_1127_cov_37.721790	289	369	2	37	80	0.4625000
NODE_4661_length_1127_cov_37.721790	289	369	4	32	80	0.4000000
NODE_4661_length_1127_cov_37.721790	289	369	6	11	80	0.1375000
NODE_4661_length_1127_cov_37.721790	365	445	4	10	80	0.1250000
NODE_4661_length_1127_cov_37.721790	365	445	6	70	80	0.8750000
NODE_4661_length_1127_cov_37.721790	418	498	2	6	80	0.0750000
NODE_4661_length_1127_cov_37.721790	418	498	4	45	80	0.5625000
NODE_4661_length_1127_cov_37.721790	418	498	6	29	80	0.3625000
NODE_4662_length_1127_cov_31.866732	444	523	0	14	79	0.1772152
NODE_4662_length_1127_cov_31.866732	444	523	6	18	79	0.2278481
NODE_4662_length_1127_cov_31.866732	444	523	12	47	79	0.5949367
NODE_4662_length_1127_cov_31.866732	496	576	6	6	80	0.0750000
NODE_4662_length_1127_cov_31.866732	496	576	12	74	80	0.9250000
NODE_4662_length_1127_cov_31.866732	572	652	0	29	80	0.3625000
NODE_4662_length_1127_cov_31.866732	572	652	6	51	80	0.6375000
NODE_4662_length_1127_cov_31.866732	625	705	0	80	80	1.0000000
NODE_4663_length_1127_cov_25.616732	430	510	0	18	80	0.2250000
NODE_4663_length_1127_cov_25.616732	430	510	2	49	80	0.6125000
NODE_4663_length_1127_cov_25.616732	430	510	4	13	80	0.1625000
NODE_4663_length_1127_cov_25.616732	483	563	2	14	80	0.1750000
NODE_4663_length_1127_cov_25.616732	483	563	4	13	80	0.1625000
NODE_4663_length_1127_cov_25.616732	483	563	10	46	80	0.5750000
NODE_4663_length_1127_cov_25.616732	483	563	11	3	80	0.0375000
NODE_4663_length_1127_cov_25.616732	483	563	12	4	80	0.0500000
NODE_4664_length_1127_cov_21.838521	338	418	0	2	80	0.0250000
NODE_4664_length_1127_cov_21.838521	338	418	2	78	80	0.9750000
NODE_4664_length_1127_cov_21.838521	391	471	0	21	80	0.2625000
NODE_4664_length_1127_cov_21.838521	391	471	2	59	80	0.7375000
NODE_4664_length_1127_cov_21.838521	467	547	0	66	80	0.8250000
NODE_4664_length_1127_cov_21.838521	467	547	2	14	80	0.1750000
NODE_4664_length_1127_cov_21.838521	520	600	0	13	80	0.1625000
NODE_4664_length_1127_cov_21.838521	520	600	2	67	80	0.8375000
NODE_4665_length_1127_cov_15.024319	711	800	0	11	89	0.1235955
NODE_4665_length_1127_cov_15.024319	711	800	6	49	89	0.5505618
NODE_4665_length_1127_cov_15.024319	711	800	8	10	89	0.1123596
NODE_4665_length_1127_cov_15.024319	711	800	10	19	89	0.2134831
NODE_4665_length_1127_cov_15.024319	773	853	8	8	80	0.1000000
NODE_4665_length_1127_cov_15.024319	773	853	10	72	80	0.9000000
NODE_4667_length_1127_cov_4.786965	386	466	2	50	80	0.6250000
NODE_4667_length_1127_cov_4.786965	386	466	3	1	80	0.0125000
NODE_4667_length_1127_cov_4.786965	386	466	5	2	80	0.0250000
NODE_4667_length_1127_cov_4.786965	386	466	6	27	80	0.3375000
NODE_4667_length_1127_cov_4.786965	439	519	6	80	80	1.0000000
NODE_4672_length_1126_cov_51.699124	448	528	0	67	80	0.8375000
NODE_4672_length_1126_cov_51.699124	448	528	4	2	80	0.0250000
NODE_4672_length_1126_cov_51.699124	448	528	6	11	80	0.1375000
NODE_4672_length_1126_cov_51.699124	501	581	0	14	80	0.1750000
NODE_4672_length_1126_cov_51.699124	501	581	4	2	80	0.0250000
NODE_4672_length_1126_cov_51.699124	501	581	6	12	80	0.1500000
NODE_4672_length_1126_cov_51.699124	501	581	8	52	80	0.6500000
NODE_4673_length_1126_cov_38.135346	427	507	0	10	80	0.1250000
NODE_4673_length_1126_cov_38.135346	427	507	1	13	80	0.1625000
NODE_4673_length_1126_cov_38.135346	427	507	2	57	80	0.7125000
NODE_4673_length_1126_cov_38.135346	480	560	0	10	80	0.1250000
NODE_4673_length_1126_cov_38.135346	480	560	1	16	80	0.2000000
NODE_4673_length_1126_cov_38.135346	480	560	2	54	80	0.6750000
NODE_4673_length_1126_cov_38.135346	556	638	2	18	82	0.2195122
NODE_4673_length_1126_cov_38.135346	556	638	9	5	82	0.0609756
NODE_4673_length_1126_cov_38.135346	556	638	15	46	82	0.5609756
NODE_4673_length_1126_cov_38.135346	556	638	20	1	82	0.0121951
NODE_4673_length_1126_cov_38.135346	556	638	22	12	82	0.1463415
NODE_4673_length_1126_cov_38.135346	611	691	15	14	80	0.1750000
NODE_4673_length_1126_cov_38.135346	611	691	20	32	80	0.4000000
NODE_4673_length_1126_cov_38.135346	611	691	21	16	80	0.2000000
NODE_4673_length_1126_cov_38.135346	611	691	22	18	80	0.2250000
NODE_4674_length_1126_cov_34.637780	23	97	6	16	74	0.2162162
NODE_4674_length_1126_cov_34.637780	23	97	8	9	74	0.1216216
NODE_4674_length_1126_cov_34.637780	23	97	12	32	74	0.4324324
NODE_4674_length_1126_cov_34.637780	23	97	24	9	74	0.1216216
NODE_4674_length_1126_cov_34.637780	23	97	28	8	74	0.1081081
NODE_4674_length_1126_cov_34.637780	146	226	16	1	80	0.0125000
NODE_4674_length_1126_cov_34.637780	146	226	18	27	80	0.3375000
NODE_4674_length_1126_cov_34.637780	146	226	20	15	80	0.1875000
NODE_4674_length_1126_cov_34.637780	146	226	23	2	80	0.0250000
NODE_4674_length_1126_cov_34.637780	146	226	25	4	80	0.0500000
NODE_4674_length_1126_cov_34.637780	146	226	26	5	80	0.0625000
NODE_4674_length_1126_cov_34.637780	146	226	27	7	80	0.0875000
NODE_4674_length_1126_cov_34.637780	146	226	28	2	80	0.0250000
NODE_4674_length_1126_cov_34.637780	146	226	29	9	80	0.1125000
NODE_4674_length_1126_cov_34.637780	146	226	30	2	80	0.0250000
NODE_4674_length_1126_cov_34.637780	146	226	32	2	80	0.0250000
NODE_4674_length_1126_cov_34.637780	146	226	33	4	80	0.0500000
NODE_4674_length_1126_cov_34.637780	146	226	16	1	80	0.0125000
NODE_4674_length_1126_cov_34.637780	146	226	18	27	80	0.3375000
NODE_4674_length_1126_cov_34.637780	146	226	20	15	80	0.1875000
NODE_4674_length_1126_cov_34.637780	146	226	23	2	80	0.0250000
NODE_4674_length_1126_cov_34.637780	146	226	25	4	80	0.0500000
NODE_4674_length_1126_cov_34.637780	146	226	26	5	80	0.0625000
NODE_4674_length_1126_cov_34.637780	146	226	27	7	80	0.0875000
NODE_4674_length_1126_cov_34.637780	146	226	28	2	80	0.0250000
NODE_4674_length_1126_cov_34.637780	146	226	29	9	80	0.1125000
NODE_4674_length_1126_cov_34.637780	146	226	30	2	80	0.0250000
NODE_4674_length_1126_cov_34.637780	146	226	32	2	80	0.0250000
NODE_4674_length_1126_cov_34.637780	146	226	33	4	80	0.0500000
NODE_4674_length_1126_cov_34.637780	146	208	16	1	62	0.0161290
NODE_4674_length_1126_cov_34.637780	146	208	18	24	62	0.3870968
NODE_4674_length_1126_cov_34.637780	146	208	23	2	62	0.0322581
NODE_4674_length_1126_cov_34.637780	146	208	25	4	62	0.0645161
NODE_4674_length_1126_cov_34.637780	146	208	26	5	62	0.0806452
NODE_4674_length_1126_cov_34.637780	146	208	27	7	62	0.1129032
NODE_4674_length_1126_cov_34.637780	146	208	28	2	62	0.0322581
NODE_4674_length_1126_cov_34.637780	146	208	29	9	62	0.1451613
NODE_4674_length_1126_cov_34.637780	146	208	30	2	62	0.0322581
NODE_4674_length_1126_cov_34.637780	146	208	32	2	62	0.0322581
NODE_4674_length_1126_cov_34.637780	146	208	33	4	62	0.0645161
NODE_4674_length_1126_cov_34.637780	146	217	16	1	71	0.0140845
NODE_4674_length_1126_cov_34.637780	146	217	18	27	71	0.3802817
NODE_4674_length_1126_cov_34.637780	146	217	20	6	71	0.0845070
NODE_4674_length_1126_cov_34.637780	146	217	23	2	71	0.0281690
NODE_4674_length_1126_cov_34.637780	146	217	25	4	71	0.0563380
NODE_4674_length_1126_cov_34.637780	146	217	26	5	71	0.0704225
NODE_4674_length_1126_cov_34.637780	146	217	27	7	71	0.0985916
NODE_4674_length_1126_cov_34.637780	146	217	28	2	71	0.0281690
NODE_4674_length_1126_cov_34.637780	146	217	29	9	71	0.1267606
NODE_4674_length_1126_cov_34.637780	146	217	30	2	71	0.0281690
NODE_4674_length_1126_cov_34.637780	146	217	32	2	71	0.0281690
NODE_4674_length_1126_cov_34.637780	146	217	33	4	71	0.0563380
NODE_4675_length_1126_cov_21.360273	595	675	0	80	80	1.0000000
NODE_4675_length_1126_cov_21.360273	648	728	0	80	80	1.0000000
NODE_4676_length_1126_cov_17.420643	422	502	4	80	80	1.0000000
NODE_4676_length_1126_cov_17.420643	475	555	0	15	80	0.1875000
NODE_4676_length_1126_cov_17.420643	475	555	2	33	80	0.4125000
NODE_4676_length_1126_cov_17.420643	475	555	4	32	80	0.4000000
NODE_4677_length_1126_cov_15.896787	383	463	0	13	80	0.1625000
NODE_4677_length_1126_cov_15.896787	383	463	2	67	80	0.8375000
NODE_4677_length_1126_cov_15.896787	436	516	0	66	80	0.8250000
NODE_4677_length_1126_cov_15.896787	436	516	2	14	80	0.1750000
NODE_4678_length_1126_cov_8.525803	174	254	0	44	80	0.5500000
NODE_4678_length_1126_cov_8.525803	174	254	2	36	80	0.4500000
NODE_4678_length_1126_cov_8.525803	227	307	2	80	80	1.0000000
NODE_4679_length_1126_cov_5.805258	463	543	0	80	80	1.0000000
NODE_4679_length_1126_cov_5.805258	516	596	0	80	80	1.0000000
NODE_4685_length_1126_cov_1.502434	6	86	2	30	80	0.3750000
NODE_4685_length_1126_cov_1.502434	6	86	3	2	80	0.0250000
NODE_4685_length_1126_cov_1.502434	6	86	4	48	80	0.6000000
NODE_4685_length_1126_cov_1.502434	59	108	4	49	49	1.0000000
NODE_4689_length_1125_cov_34.314815	405	485	0	8	80	0.1000000
NODE_4689_length_1125_cov_34.314815	405	485	6	19	80	0.2375000
NODE_4689_length_1125_cov_34.314815	405	485	8	41	80	0.5125000
NODE_4689_length_1125_cov_34.314815	405	485	14	12	80	0.1500000
NODE_4689_length_1125_cov_34.314815	458	538	6	39	80	0.4875000
NODE_4689_length_1125_cov_34.314815	458	538	8	20	80	0.2500000
NODE_4689_length_1125_cov_34.314815	458	538	14	21	80	0.2625000
NODE_4689_length_1125_cov_34.314815	534	614	0	6	80	0.0750000
NODE_4689_length_1125_cov_34.314815	534	614	5	31	80	0.3875000
NODE_4689_length_1125_cov_34.314815	534	614	6	43	80	0.5375000
NODE_4689_length_1125_cov_34.314815	587	667	0	59	80	0.7375000
NODE_4689_length_1125_cov_34.314815	587	667	5	21	80	0.2625000
NODE_4690_length_1125_cov_33.553606	458	538	2	31	80	0.3875000
NODE_4690_length_1125_cov_33.553606	458	538	6	3	80	0.0375000
NODE_4690_length_1125_cov_33.553606	458	538	8	12	80	0.1500000
NODE_4690_length_1125_cov_33.553606	458	538	10	34	80	0.4250000
NODE_4690_length_1125_cov_33.553606	511	591	10	47	80	0.5875000
NODE_4690_length_1125_cov_33.553606	511	591	12	15	80	0.1875000
NODE_4690_length_1125_cov_33.553606	511	591	18	18	80	0.2250000
NODE_4690_length_1125_cov_33.553606	587	667	8	59	80	0.7375000
NODE_4690_length_1125_cov_33.553606	587	667	12	4	80	0.0500000
NODE_4690_length_1125_cov_33.553606	587	667	18	17	80	0.2125000
NODE_4690_length_1125_cov_33.553606	640	720	0	16	80	0.2000000
NODE_4690_length_1125_cov_33.553606	640	720	6	34	80	0.4250000
NODE_4690_length_1125_cov_33.553606	640	720	8	30	80	0.3750000
NODE_4691_length_1125_cov_33.371345	408	488	0	80	80	1.0000000
NODE_4691_length_1125_cov_33.371345	461	541	0	80	80	1.0000000
NODE_4691_length_1125_cov_33.371345	537	617	0	42	80	0.5250000
NODE_4691_length_1125_cov_33.371345	537	617	2	7	80	0.0875000
NODE_4691_length_1125_cov_33.371345	537	617	6	31	80	0.3875000
NODE_4691_length_1125_cov_33.371345	590	670	4	1	80	0.0125000
NODE_4691_length_1125_cov_33.371345	590	670	6	78	80	0.9750000
NODE_4691_length_1125_cov_33.371345	590	670	8	1	80	0.0125000
NODE_4692_length_1125_cov_22.580897	279	359	0	14	80	0.1750000
NODE_4692_length_1125_cov_22.580897	279	359	2	66	80	0.8250000
NODE_4692_length_1125_cov_22.580897	332	412	0	67	80	0.8375000
NODE_4692_length_1125_cov_22.580897	332	412	2	13	80	0.1625000
NODE_4692_length_1125_cov_22.580897	408	488	0	80	80	1.0000000
NODE_4692_length_1125_cov_22.580897	461	541	0	80	80	1.0000000
NODE_4705_length_1124_cov_52.278049	616	696	2	37	80	0.4625000
NODE_4705_length_1124_cov_52.278049	616	696	4	11	80	0.1375000
NODE_4705_length_1124_cov_52.278049	616	696	9	9	80	0.1125000
NODE_4705_length_1124_cov_52.278049	616	696	10	23	80	0.2875000
NODE_4705_length_1124_cov_52.278049	669	749	2	80	80	1.0000000
NODE_4706_length_1124_cov_25.280000	444	524	0	44	80	0.5500000
NODE_4706_length_1124_cov_25.280000	444	524	2	1	80	0.0125000
NODE_4706_length_1124_cov_25.280000	444	524	8	35	80	0.4375000
NODE_4706_length_1124_cov_25.280000	497	577	2	8	80	0.1000000
NODE_4706_length_1124_cov_25.280000	497	577	8	72	80	0.9000000
NODE_4706_length_1124_cov_25.280000	573	653	0	26	80	0.3250000
NODE_4706_length_1124_cov_25.280000	573	653	2	54	80	0.6750000
NODE_4706_length_1124_cov_25.280000	626	706	0	17	80	0.2125000
NODE_4706_length_1124_cov_25.280000	626	706	2	63	80	0.7875000
NODE_4707_length_1124_cov_18.700488	114	194	0	80	80	1.0000000
NODE_4707_length_1124_cov_18.700488	167	247	0	80	80	1.0000000
NODE_4717_length_1123_cov_26.445312	388	468	0	12	80	0.1500000
NODE_4717_length_1123_cov_26.445312	388	468	2	68	80	0.8500000
NODE_4717_length_1123_cov_26.445312	441	521	0	58	80	0.7250000
NODE_4717_length_1123_cov_26.445312	441	521	2	22	80	0.2750000
NODE_4717_length_1123_cov_26.445312	517	597	2	80	80	1.0000000
NODE_4717_length_1123_cov_26.445312	570	650	0	36	80	0.4500000
NODE_4717_length_1123_cov_26.445312	570	650	2	44	80	0.5500000
NODE_4718_length_1123_cov_18.677734	522	602	0	80	80	1.0000000
NODE_4718_length_1123_cov_18.677734	575	655	0	80	80	1.0000000
NODE_4718_length_1123_cov_18.677734	651	731	0	80	80	1.0000000
NODE_4718_length_1123_cov_18.677734	704	784	0	80	80	1.0000000
NODE_4728_length_1122_cov_38.688172	295	375	0	80	80	1.0000000
NODE_4728_length_1122_cov_38.688172	348	428	0	80	80	1.0000000
NODE_4728_length_1122_cov_38.688172	424	504	0	80	80	1.0000000
NODE_4728_length_1122_cov_38.688172	477	557	0	80	80	1.0000000
NODE_4729_length_1122_cov_32.827957	232	312	0	79	80	0.9875000
NODE_4729_length_1122_cov_32.827957	232	312	2	1	80	0.0125000
NODE_4729_length_1122_cov_32.827957	285	365	0	26	80	0.3250000
NODE_4729_length_1122_cov_32.827957	285	365	2	54	80	0.6750000
NODE_4729_length_1122_cov_32.827957	361	441	0	30	80	0.3750000
NODE_4729_length_1122_cov_32.827957	361	441	2	50	80	0.6250000
NODE_4729_length_1122_cov_32.827957	414	494	0	80	80	1.0000000
NODE_4730_length_1122_cov_12.574780	396	476	0	63	80	0.7875000
NODE_4730_length_1122_cov_12.574780	396	476	2	17	80	0.2125000
NODE_4730_length_1122_cov_12.574780	449	529	0	80	80	1.0000000
NODE_4730_length_1122_cov_12.574780	525	605	0	80	80	1.0000000
NODE_4730_length_1122_cov_12.574780	578	658	0	80	80	1.0000000
NODE_4731_length_1122_cov_8.582600	586	666	0	80	80	1.0000000
NODE_4731_length_1122_cov_8.582600	639	719	0	59	80	0.7375000
NODE_4731_length_1122_cov_8.582600	639	719	2	21	80	0.2625000
NODE_4733_length_1122_cov_3.714565	284	364	0	67	80	0.8375000
NODE_4733_length_1122_cov_3.714565	284	364	2	5	80	0.0625000
NODE_4733_length_1122_cov_3.714565	284	364	4	8	80	0.1000000
NODE_4733_length_1122_cov_3.714565	337	417	0	80	80	1.0000000
NODE_4738_length_1122_cov_1.757576	25	87	0	62	62	1.0000000
NODE_4742_length_1121_cov_39.595890	507	587	0	14	80	0.1750000
NODE_4742_length_1121_cov_39.595890	507	587	2	66	80	0.8250000
NODE_4742_length_1121_cov_39.595890	560	640	0	60	80	0.7500000
NODE_4742_length_1121_cov_39.595890	560	640	2	20	80	0.2500000
NODE_4742_length_1121_cov_39.595890	636	716	2	80	80	1.0000000
NODE_4742_length_1121_cov_39.595890	689	769	0	50	80	0.6250000
NODE_4742_length_1121_cov_39.595890	689	769	2	30	80	0.3750000
NODE_4743_length_1121_cov_23.832681	525	605	0	10	80	0.1250000
NODE_4743_length_1121_cov_23.832681	525	605	2	22	80	0.2750000
NODE_4743_length_1121_cov_23.832681	525	605	4	20	80	0.2500000
NODE_4743_length_1121_cov_23.832681	525	605	10	28	80	0.3500000
NODE_4743_length_1121_cov_23.832681	578	658	8	45	80	0.5625000
NODE_4743_length_1121_cov_23.832681	578	658	10	35	80	0.4375000
NODE_4744_length_1121_cov_18.033268	1	42	0	41	41	1.0000000
NODE_4744_length_1121_cov_18.033268	671	751	0	80	80	1.0000000
NODE_4744_length_1121_cov_18.033268	724	804	0	80	80	1.0000000
NODE_4745_length_1121_cov_8.633072	610	690	0	24	80	0.3000000
NODE_4745_length_1121_cov_8.633072	610	690	8	56	80	0.7000000
NODE_4745_length_1121_cov_8.633072	663	743	0	77	80	0.9625000
NODE_4745_length_1121_cov_8.633072	663	743	8	3	80	0.0375000
NODE_4751_length_1120_cov_34.281097	377	457	0	1	80	0.0125000
NODE_4751_length_1120_cov_34.281097	377	457	2	79	80	0.9875000
NODE_4751_length_1120_cov_34.281097	430	510	0	54	80	0.6750000
NODE_4751_length_1120_cov_34.281097	430	510	2	26	80	0.3250000
NODE_4751_length_1120_cov_34.281097	506	586	0	19	80	0.2375000
NODE_4751_length_1120_cov_34.281097	506	586	2	18	80	0.2250000
NODE_4751_length_1120_cov_34.281097	506	586	10	3	80	0.0375000
NODE_4751_length_1120_cov_34.281097	506	586	11	19	80	0.2375000
NODE_4751_length_1120_cov_34.281097	506	586	12	21	80	0.2625000
NODE_4751_length_1120_cov_34.281097	559	639	0	4	80	0.0500000
NODE_4751_length_1120_cov_34.281097	559	639	10	52	80	0.6500000
NODE_4751_length_1120_cov_34.281097	559	639	11	3	80	0.0375000
NODE_4751_length_1120_cov_34.281097	559	639	12	21	80	0.2625000
NODE_4752_length_1120_cov_31.468168	401	481	4	37	80	0.4625000
NODE_4752_length_1120_cov_31.468168	401	481	6	43	80	0.5375000
NODE_4752_length_1120_cov_31.468168	454	534	0	51	80	0.6375000
NODE_4752_length_1120_cov_31.468168	454	534	4	29	80	0.3625000
NODE_4752_length_1120_cov_31.468168	530	610	0	80	80	1.0000000
NODE_4752_length_1120_cov_31.468168	583	663	0	80	80	1.0000000
NODE_4753_length_1120_cov_28.182174	418	498	0	19	80	0.2375000
NODE_4753_length_1120_cov_28.182174	418	498	2	4	80	0.0500000
NODE_4753_length_1120_cov_28.182174	418	498	4	26	80	0.3250000
NODE_4753_length_1120_cov_28.182174	418	498	6	31	80	0.3875000
NODE_4753_length_1120_cov_28.182174	471	551	2	5	80	0.0625000
NODE_4753_length_1120_cov_28.182174	471	551	4	7	80	0.0875000
NODE_4753_length_1120_cov_28.182174	471	551	6	68	80	0.8500000
NODE_4754_length_1120_cov_25.423115	405	485	4	73	80	0.9125000
NODE_4754_length_1120_cov_25.423115	405	485	8	7	80	0.0875000
NODE_4754_length_1120_cov_25.423115	458	538	0	39	80	0.4875000
NODE_4754_length_1120_cov_25.423115	458	538	2	1	80	0.0125000
NODE_4754_length_1120_cov_25.423115	458	538	4	40	80	0.5000000
NODE_4754_length_1120_cov_25.423115	534	614	0	80	80	1.0000000
NODE_4754_length_1120_cov_25.423115	587	667	0	37	80	0.4625000
NODE_4754_length_1120_cov_25.423115	587	667	2	43	80	0.5375000
NODE_4755_length_1120_cov_24.441724	589	662	0	18	73	0.2465753
NODE_4755_length_1120_cov_24.441724	589	662	5	2	73	0.0273973
NODE_4755_length_1120_cov_24.441724	589	662	6	44	73	0.6027398
NODE_4755_length_1120_cov_24.441724	589	662	8	9	73	0.1232877
NODE_4755_length_1120_cov_24.441724	636	716	6	17	80	0.2125000
NODE_4755_length_1120_cov_24.441724	636	716	8	63	80	0.7875000
NODE_4756_length_1120_cov_18.966699	406	486	0	7	80	0.0875000
NODE_4756_length_1120_cov_18.966699	406	486	2	50	80	0.6250000
NODE_4756_length_1120_cov_18.966699	406	486	4	23	80	0.2875000
NODE_4756_length_1120_cov_18.966699	459	539	0	60	80	0.7500000
NODE_4756_length_1120_cov_18.966699	459	539	2	20	80	0.2500000
NODE_4757_length_1120_cov_16.136141	508	588	0	80	80	1.0000000
NODE_4757_length_1120_cov_16.136141	561	641	0	80	80	1.0000000
NODE_4758_length_1120_cov_15.492654	460	540	0	80	80	1.0000000
NODE_4758_length_1120_cov_15.492654	460	540	0	80	80	1.0000000
NODE_4758_length_1120_cov_15.492654	513	593	0	80	80	1.0000000
NODE_4759_length_1120_cov_8.696376	646	726	0	80	80	1.0000000
NODE_4759_length_1120_cov_8.696376	699	779	0	80	80	1.0000000
NODE_4760_length_1120_cov_7.916748	304	384	0	80	80	1.0000000
NODE_4760_length_1120_cov_7.916748	357	437	0	80	80	1.0000000
NODE_4772_length_1119_cov_32.617647	425	505	9	2	80	0.0250000
NODE_4772_length_1119_cov_32.617647	425	505	13	2	80	0.0250000
NODE_4772_length_1119_cov_32.617647	425	505	14	76	80	0.9500000
NODE_4772_length_1119_cov_32.617647	478	558	0	45	80	0.5625000
NODE_4772_length_1119_cov_32.617647	478	558	4	2	80	0.0250000
NODE_4772_length_1119_cov_32.617647	478	558	14	33	80	0.4125000
NODE_4773_length_1119_cov_24.944118	455	535	8	11	80	0.1375000
NODE_4773_length_1119_cov_24.944118	455	535	12	69	80	0.8625000
NODE_4773_length_1119_cov_24.944118	508	588	0	33	80	0.4125000
NODE_4773_length_1119_cov_24.944118	508	588	8	19	80	0.2375000
NODE_4773_length_1119_cov_24.944118	508	588	12	28	80	0.3500000
NODE_4774_length_1119_cov_22.214706	614	694	0	28	80	0.3500000
NODE_4774_length_1119_cov_22.214706	614	694	6	23	80	0.2875000
NODE_4774_length_1119_cov_22.214706	614	694	8	23	80	0.2875000
NODE_4774_length_1119_cov_22.214706	614	694	10	6	80	0.0750000
NODE_4774_length_1119_cov_22.214706	667	747	4	13	80	0.1625000
NODE_4774_length_1119_cov_22.214706	667	747	8	21	80	0.2625000
NODE_4774_length_1119_cov_22.214706	667	747	10	46	80	0.5750000
NODE_4775_length_1119_cov_21.115686	431	511	0	34	80	0.4250000
NODE_4775_length_1119_cov_21.115686	431	511	2	5	80	0.0625000
NODE_4775_length_1119_cov_21.115686	431	511	4	41	80	0.5125000
NODE_4775_length_1119_cov_21.115686	484	564	2	3	80	0.0375000
NODE_4775_length_1119_cov_21.115686	484	564	4	77	80	0.9625000
NODE_4777_length_1119_cov_11.895098	565	645	0	80	80	1.0000000
NODE_4777_length_1119_cov_11.895098	618	698	0	80	80	1.0000000
NODE_4782_length_1119_cov_2.783333	37	99	6	62	62	1.0000000
NODE_4789_length_1118_cov_35.214917	555	635	0	11	80	0.1375000
NODE_4789_length_1118_cov_35.214917	555	635	2	1	80	0.0125000
NODE_4789_length_1118_cov_35.214917	555	635	4	68	80	0.8500000
NODE_4789_length_1118_cov_35.214917	608	688	0	2	80	0.0250000
NODE_4789_length_1118_cov_35.214917	608	688	2	35	80	0.4375000
NODE_4789_length_1118_cov_35.214917	608	688	4	43	80	0.5375000
NODE_4789_length_1118_cov_35.214917	684	764	0	1	80	0.0125000
NODE_4789_length_1118_cov_35.214917	684	764	2	8	80	0.1000000
NODE_4789_length_1118_cov_35.214917	684	764	4	71	80	0.8875000
NODE_4789_length_1118_cov_35.214917	737	817	0	54	80	0.6750000
NODE_4789_length_1118_cov_35.214917	737	817	2	3	80	0.0375000
NODE_4789_length_1118_cov_35.214917	737	817	4	23	80	0.2875000
NODE_4790_length_1118_cov_23.114818	602	682	0	24	80	0.3000000
NODE_4790_length_1118_cov_23.114818	602	682	2	56	80	0.7000000
NODE_4790_length_1118_cov_23.114818	655	735	0	19	80	0.2375000
NODE_4790_length_1118_cov_23.114818	655	735	2	46	80	0.5750000
NODE_4790_length_1118_cov_23.114818	655	735	4	15	80	0.1875000
NODE_4790_length_1118_cov_23.114818	731	811	4	67	80	0.8375000
NODE_4790_length_1118_cov_23.114818	731	811	6	13	80	0.1625000
NODE_4790_length_1118_cov_23.114818	784	864	2	43	80	0.5375000
NODE_4790_length_1118_cov_23.114818	784	864	4	14	80	0.1750000
NODE_4790_length_1118_cov_23.114818	784	864	6	23	80	0.2875000
NODE_4791_length_1118_cov_18.293425	388	463	0	75	75	1.0000000
NODE_4791_length_1118_cov_18.293425	436	516	0	80	80	1.0000000
NODE_4791_length_1118_cov_18.293425	512	592	0	29	80	0.3625000
NODE_4791_length_1118_cov_18.293425	512	592	2	51	80	0.6375000
NODE_4791_length_1118_cov_18.293425	565	645	2	52	80	0.6500000
NODE_4791_length_1118_cov_18.293425	565	645	4	28	80	0.3500000
NODE_4792_length_1118_cov_17.228656	480	560	0	80	80	1.0000000
NODE_4792_length_1118_cov_17.228656	533	613	0	80	80	1.0000000
NODE_4794_length_1118_cov_14.299313	468	548	0	80	80	1.0000000
NODE_4794_length_1118_cov_14.299313	521	601	0	80	80	1.0000000
NODE_4795_length_1118_cov_10.203140	306	386	0	80	80	1.0000000
NODE_4795_length_1118_cov_10.203140	359	439	0	80	80	1.0000000
NODE_4795_length_1118_cov_10.203140	435	515	0	80	80	1.0000000
NODE_4795_length_1118_cov_10.203140	488	568	0	80	80	1.0000000
NODE_4796_length_1118_cov_2.885182	471	551	0	80	80	1.0000000
NODE_4796_length_1118_cov_2.885182	524	604	0	80	80	1.0000000
NODE_4805_length_1117_cov_19.425344	541	621	2	67	80	0.8375000
NODE_4805_length_1117_cov_19.425344	541	621	4	13	80	0.1625000
NODE_4805_length_1117_cov_19.425344	594	674	2	66	80	0.8250000
NODE_4805_length_1117_cov_19.425344	594	674	4	14	80	0.1750000
NODE_4806_length_1117_cov_16.386051	385	465	0	80	80	1.0000000
NODE_4806_length_1117_cov_16.386051	438	518	0	80	80	1.0000000
NODE_4807_length_1117_cov_10.353635	294	374	2	2	80	0.0250000
NODE_4807_length_1117_cov_10.353635	294	374	4	78	80	0.9750000
NODE_4807_length_1117_cov_10.353635	347	427	0	22	80	0.2750000
NODE_4807_length_1117_cov_10.353635	347	427	2	16	80	0.2000000
NODE_4807_length_1117_cov_10.353635	347	427	4	42	80	0.5250000
NODE_4808_length_1117_cov_7.492141	417	497	0	80	80	1.0000000
NODE_4808_length_1117_cov_7.492141	470	550	0	80	80	1.0000000
NODE_4812_length_1117_cov_3.225933	666	728	2	48	62	0.7741935
NODE_4812_length_1117_cov_3.225933	666	728	4	14	62	0.2258064
NODE_4819_length_1116_cov_30.106195	457	537	0	69	80	0.8625000
NODE_4819_length_1116_cov_30.106195	457	537	2	11	80	0.1375000
NODE_4819_length_1116_cov_30.106195	510	590	0	80	80	1.0000000
NODE_4820_length_1116_cov_25.518191	831	911	0	80	80	1.0000000
NODE_4820_length_1116_cov_25.518191	884	964	0	80	80	1.0000000
NODE_4821_length_1116_cov_20.629302	500	580	0	14	80	0.1750000
NODE_4821_length_1116_cov_20.629302	500	580	8	66	80	0.8250000
NODE_4821_length_1116_cov_20.629302	553	633	0	67	80	0.8375000
NODE_4821_length_1116_cov_20.629302	553	633	8	13	80	0.1625000
NODE_4822_length_1116_cov_16.723697	345	425	0	73	80	0.9125000
NODE_4822_length_1116_cov_16.723697	345	425	2	7	80	0.0875000
NODE_4822_length_1116_cov_16.723697	398	478	0	20	80	0.2500000
NODE_4822_length_1116_cov_16.723697	398	478	2	60	80	0.7500000
NODE_4823_length_1116_cov_16.046214	735	815	12	4	80	0.0500000
NODE_4823_length_1116_cov_16.046214	735	815	13	47	80	0.5875000
NODE_4823_length_1116_cov_16.046214	735	815	15	29	80	0.3625000
NODE_4823_length_1116_cov_16.046214	788	868	0	6	80	0.0750000
NODE_4823_length_1116_cov_16.046214	788	868	6	9	80	0.1125000
NODE_4823_length_1116_cov_16.046214	788	868	8	10	80	0.1250000
NODE_4823_length_1116_cov_16.046214	788	868	13	39	80	0.4875000
NODE_4823_length_1116_cov_16.046214	788	868	15	16	80	0.2000000
NODE_4828_length_1116_cov_1.379548	800	880	0	17	80	0.2125000
NODE_4828_length_1116_cov_1.379548	800	880	2	19	80	0.2375000
NODE_4828_length_1116_cov_1.379548	800	880	4	44	80	0.5500000
NODE_4828_length_1116_cov_1.379548	853	933	0	34	80	0.4250000
NODE_4828_length_1116_cov_1.379548	853	933	2	8	80	0.1000000
NODE_4828_length_1116_cov_1.379548	853	933	4	38	80	0.4750000
NODE_4832_length_1115_cov_30.584646	549	629	8	80	80	1.0000000
NODE_4832_length_1115_cov_30.584646	602	682	0	31	80	0.3875000
NODE_4832_length_1115_cov_30.584646	602	682	1	2	80	0.0250000
NODE_4832_length_1115_cov_30.584646	602	682	6	18	80	0.2250000
NODE_4832_length_1115_cov_30.584646	602	682	8	29	80	0.3625000
NODE_4833_length_1115_cov_15.871063	454	534	0	80	80	1.0000000
NODE_4833_length_1115_cov_15.871063	507	587	0	80	80	1.0000000
NODE_4833_length_1115_cov_15.871063	583	663	0	80	80	1.0000000
NODE_4833_length_1115_cov_15.871063	636	716	0	80	80	1.0000000
NODE_4840_length_1114_cov_20.633498	1034	1114	0	1	80	0.0125000
NODE_4840_length_1114_cov_20.633498	1034	1114	2	9	80	0.1125000
NODE_4840_length_1114_cov_20.633498	1034	1114	4	7	80	0.0875000
NODE_4840_length_1114_cov_20.633498	1034	1114	10	2	80	0.0250000
NODE_4840_length_1114_cov_20.633498	1034	1114	11	2	80	0.0250000
NODE_4840_length_1114_cov_20.633498	1034	1114	13	3	80	0.0375000
NODE_4840_length_1114_cov_20.633498	1034	1114	15	12	80	0.1500000
NODE_4840_length_1114_cov_20.633498	1034	1114	17	14	80	0.1750000
NODE_4840_length_1114_cov_20.633498	1034	1114	24	29	80	0.3625000
NODE_4840_length_1114_cov_20.633498	1034	1114	28	1	80	0.0125000
NODE_4840_length_1114_cov_20.633498	1034	1114	0	1	80	0.0125000
NODE_4840_length_1114_cov_20.633498	1034	1114	2	9	80	0.1125000
NODE_4840_length_1114_cov_20.633498	1034	1114	4	7	80	0.0875000
NODE_4840_length_1114_cov_20.633498	1034	1114	10	2	80	0.0250000
NODE_4840_length_1114_cov_20.633498	1034	1114	11	2	80	0.0250000
NODE_4840_length_1114_cov_20.633498	1034	1114	13	3	80	0.0375000
NODE_4840_length_1114_cov_20.633498	1034	1114	15	12	80	0.1500000
NODE_4840_length_1114_cov_20.633498	1034	1114	17	14	80	0.1750000
NODE_4840_length_1114_cov_20.633498	1034	1114	24	29	80	0.3625000
NODE_4840_length_1114_cov_20.633498	1034	1114	28	1	80	0.0125000
NODE_4840_length_1114_cov_20.633498	1034	1114	0	1	80	0.0125000
NODE_4840_length_1114_cov_20.633498	1034	1114	2	9	80	0.1125000
NODE_4840_length_1114_cov_20.633498	1034	1114	4	7	80	0.0875000
NODE_4840_length_1114_cov_20.633498	1034	1114	10	2	80	0.0250000
NODE_4840_length_1114_cov_20.633498	1034	1114	11	2	80	0.0250000
NODE_4840_length_1114_cov_20.633498	1034	1114	13	3	80	0.0375000
NODE_4840_length_1114_cov_20.633498	1034	1114	15	12	80	0.1500000
NODE_4840_length_1114_cov_20.633498	1034	1114	17	14	80	0.1750000
NODE_4840_length_1114_cov_20.633498	1034	1114	24	29	80	0.3625000
NODE_4840_length_1114_cov_20.633498	1034	1114	28	1	80	0.0125000
NODE_4840_length_1114_cov_20.633498	1034	1114	0	1	80	0.0125000
NODE_4840_length_1114_cov_20.633498	1034	1114	2	9	80	0.1125000
NODE_4840_length_1114_cov_20.633498	1034	1114	4	7	80	0.0875000
NODE_4840_length_1114_cov_20.633498	1034	1114	10	2	80	0.0250000
NODE_4840_length_1114_cov_20.633498	1034	1114	11	2	80	0.0250000
NODE_4840_length_1114_cov_20.633498	1034	1114	13	3	80	0.0375000
NODE_4840_length_1114_cov_20.633498	1034	1114	15	12	80	0.1500000
NODE_4840_length_1114_cov_20.633498	1034	1114	17	14	80	0.1750000
NODE_4840_length_1114_cov_20.633498	1034	1114	24	29	80	0.3625000
NODE_4840_length_1114_cov_20.633498	1034	1114	28	1	80	0.0125000
NODE_4840_length_1114_cov_20.633498	1034	1114	0	1	80	0.0125000
NODE_4840_length_1114_cov_20.633498	1034	1114	2	9	80	0.1125000
NODE_4840_length_1114_cov_20.633498	1034	1114	4	7	80	0.0875000
NODE_4840_length_1114_cov_20.633498	1034	1114	10	2	80	0.0250000
NODE_4840_length_1114_cov_20.633498	1034	1114	11	2	80	0.0250000
NODE_4840_length_1114_cov_20.633498	1034	1114	13	3	80	0.0375000
NODE_4840_length_1114_cov_20.633498	1034	1114	15	12	80	0.1500000
NODE_4840_length_1114_cov_20.633498	1034	1114	17	14	80	0.1750000
NODE_4840_length_1114_cov_20.633498	1034	1114	24	29	80	0.3625000
NODE_4840_length_1114_cov_20.633498	1034	1114	28	1	80	0.0125000
NODE_4840_length_1114_cov_20.633498	1043	1114	0	1	71	0.0140845
NODE_4840_length_1114_cov_20.633498	1043	1114	2	9	71	0.1267606
NODE_4840_length_1114_cov_20.633498	1043	1114	4	7	71	0.0985916
NODE_4840_length_1114_cov_20.633498	1043	1114	10	2	71	0.0281690
NODE_4840_length_1114_cov_20.633498	1043	1114	11	2	71	0.0281690
NODE_4840_length_1114_cov_20.633498	1043	1114	13	3	71	0.0422535
NODE_4840_length_1114_cov_20.633498	1043	1114	15	12	71	0.1690141
NODE_4840_length_1114_cov_20.633498	1043	1114	17	14	71	0.1971831
NODE_4840_length_1114_cov_20.633498	1043	1114	24	21	71	0.2957746
NODE_4841_length_1114_cov_17.383251	516	601	0	18	85	0.2117647
NODE_4841_length_1114_cov_17.383251	516	601	2	67	85	0.7882353
NODE_4841_length_1114_cov_17.383251	574	653	0	20	79	0.2531646
NODE_4841_length_1114_cov_17.383251	574	653	2	59	79	0.7468355
NODE_4841_length_1114_cov_17.383251	649	729	0	10	80	0.1250000
NODE_4841_length_1114_cov_17.383251	649	729	2	4	80	0.0500000
NODE_4841_length_1114_cov_17.383251	649	729	4	6	80	0.0750000
NODE_4841_length_1114_cov_17.383251	649	729	6	60	80	0.7500000
NODE_4841_length_1114_cov_17.383251	702	782	0	14	80	0.1750000
NODE_4841_length_1114_cov_17.383251	702	782	2	8	80	0.1000000
NODE_4841_length_1114_cov_17.383251	702	782	4	18	80	0.2250000
NODE_4841_length_1114_cov_17.383251	702	782	6	40	80	0.5000000
NODE_4842_length_1114_cov_5.562562	563	643	0	80	80	1.0000000
NODE_4842_length_1114_cov_5.562562	616	696	0	80	80	1.0000000
NODE_4847_length_1113_cov_51.988166	343	423	0	57	80	0.7125000
NODE_4847_length_1113_cov_51.988166	343	423	2	23	80	0.2875000
NODE_4847_length_1113_cov_51.988166	396	476	0	4	80	0.0500000
NODE_4847_length_1113_cov_51.988166	396	476	2	76	80	0.9500000
NODE_4847_length_1113_cov_51.988166	472	552	0	69	80	0.8625000
NODE_4847_length_1113_cov_51.988166	472	552	2	7	80	0.0875000
NODE_4847_length_1113_cov_51.988166	472	552	4	4	80	0.0500000
NODE_4847_length_1113_cov_51.988166	525	605	0	23	80	0.2875000
NODE_4847_length_1113_cov_51.988166	525	605	4	57	80	0.7125000
NODE_4848_length_1113_cov_35.005917	359	439	0	26	80	0.3250000
NODE_4848_length_1113_cov_35.005917	359	439	2	54	80	0.6750000
NODE_4848_length_1113_cov_35.005917	412	492	0	79	80	0.9875000
NODE_4848_length_1113_cov_35.005917	412	492	2	1	80	0.0125000
NODE_4849_length_1113_cov_28.106509	570	650	6	80	80	1.0000000
NODE_4849_length_1113_cov_28.106509	623	703	1	28	80	0.3500000
NODE_4849_length_1113_cov_28.106509	623	703	2	10	80	0.1250000
NODE_4849_length_1113_cov_28.106509	623	703	5	1	80	0.0125000
NODE_4849_length_1113_cov_28.106509	623	703	6	41	80	0.5125000
NODE_4849_length_1113_cov_28.106509	699	779	0	34	80	0.4250000
NODE_4849_length_1113_cov_28.106509	699	779	1	9	80	0.1125000
NODE_4849_length_1113_cov_28.106509	699	779	2	37	80	0.4625000
NODE_4849_length_1113_cov_28.106509	752	832	2	36	80	0.4500000
NODE_4849_length_1113_cov_28.106509	752	832	4	44	80	0.5500000
NODE_4850_length_1113_cov_18.636095	512	592	0	80	80	1.0000000
NODE_4850_length_1113_cov_18.636095	565	645	0	80	80	1.0000000
NODE_4851_length_1113_cov_16.664694	352	432	0	80	80	1.0000000
NODE_4851_length_1113_cov_16.664694	405	485	0	36	80	0.4500000
NODE_4851_length_1113_cov_16.664694	405	485	1	44	80	0.5500000
NODE_4851_length_1113_cov_16.664694	481	561	1	80	80	1.0000000
NODE_4851_length_1113_cov_16.664694	534	614	1	33	80	0.4125000
NODE_4851_length_1113_cov_16.664694	534	614	2	24	80	0.3000000
NODE_4851_length_1113_cov_16.664694	534	614	3	23	80	0.2875000
NODE_4852_length_1113_cov_14.155819	454	512	0	58	58	1.0000000
NODE_4852_length_1113_cov_14.155819	511	575	0	64	64	1.0000000
NODE_4853_length_1113_cov_10.185404	494	574	0	80	80	1.0000000
NODE_4853_length_1113_cov_10.185404	547	627	0	80	80	1.0000000
NODE_4855_length_1113_cov_4.005917	700	780	0	53	80	0.6625000
NODE_4855_length_1113_cov_4.005917	700	780	2	27	80	0.3375000
NODE_4855_length_1113_cov_4.005917	753	833	0	80	80	1.0000000
NODE_4866_length_1112_cov_14.961500	427	507	0	59	80	0.7375000
NODE_4866_length_1112_cov_14.961500	427	507	2	21	80	0.2625000
NODE_4866_length_1112_cov_14.961500	480	560	0	6	80	0.0750000
NODE_4866_length_1112_cov_14.961500	480	560	2	67	80	0.8375000
NODE_4866_length_1112_cov_14.961500	480	560	4	2	80	0.0250000
NODE_4866_length_1112_cov_14.961500	480	560	6	5	80	0.0625000
NODE_4866_length_1112_cov_14.961500	556	636	4	10	80	0.1250000
NODE_4866_length_1112_cov_14.961500	556	636	6	14	80	0.1750000
NODE_4866_length_1112_cov_14.961500	556	636	8	56	80	0.7000000
NODE_4866_length_1112_cov_14.961500	609	689	2	30	80	0.3750000
NODE_4866_length_1112_cov_14.961500	609	689	4	26	80	0.3250000
NODE_4866_length_1112_cov_14.961500	609	689	8	24	80	0.3000000
NODE_4875_length_1112_cov_1.655479	45	123	0	6	78	0.0769231
NODE_4875_length_1112_cov_1.655479	45	123	2	72	78	0.9230769
NODE_4875_length_1112_cov_1.655479	98	166	0	49	68	0.7205882
NODE_4875_length_1112_cov_1.655479	98	166	2	19	68	0.2794118
NODE_4880_length_1111_cov_37.999012	473	553	0	7	80	0.0875000
NODE_4880_length_1111_cov_37.999012	473	553	14	73	80	0.9125000
NODE_4880_length_1111_cov_37.999012	526	606	0	17	80	0.2125000
NODE_4880_length_1111_cov_37.999012	526	606	12	1	80	0.0125000
NODE_4880_length_1111_cov_37.999012	526	606	13	2	80	0.0250000
NODE_4880_length_1111_cov_37.999012	526	606	14	60	80	0.7500000
NODE_4880_length_1111_cov_37.999012	602	682	0	80	80	1.0000000
NODE_4880_length_1111_cov_37.999012	655	735	0	28	80	0.3500000
NODE_4880_length_1111_cov_37.999012	655	735	8	52	80	0.6500000
NODE_4881_length_1111_cov_24.394269	644	724	2	4	80	0.0500000
NODE_4881_length_1111_cov_24.394269	644	724	6	17	80	0.2125000
NODE_4881_length_1111_cov_24.394269	644	724	8	10	80	0.1250000
NODE_4881_length_1111_cov_24.394269	644	724	10	49	80	0.6125000
NODE_4881_length_1111_cov_24.394269	697	777	4	20	80	0.2500000
NODE_4881_length_1111_cov_24.394269	697	777	6	6	80	0.0750000
NODE_4881_length_1111_cov_24.394269	697	777	8	9	80	0.1125000
NODE_4881_length_1111_cov_24.394269	697	777	10	45	80	0.5625000
NODE_4882_length_1111_cov_23.676877	374	454	0	80	80	1.0000000
NODE_4882_length_1111_cov_23.676877	427	507	0	80	80	1.0000000
NODE_4883_length_1111_cov_17.522727	383	463	6	6	80	0.0750000
NODE_4883_length_1111_cov_17.522727	383	463	8	1	80	0.0125000
NODE_4883_length_1111_cov_17.522727	383	463	12	73	80	0.9125000
NODE_4883_length_1111_cov_17.522727	436	516	0	36	80	0.4500000
NODE_4883_length_1111_cov_17.522727	436	516	2	9	80	0.1125000
NODE_4883_length_1111_cov_17.522727	436	516	6	12	80	0.1500000
NODE_4883_length_1111_cov_17.522727	436	516	12	23	80	0.2875000
NODE_4884_length_1111_cov_16.495059	388	468	0	80	80	1.0000000
NODE_4884_length_1111_cov_16.495059	441	521	0	80	80	1.0000000
NODE_4885_length_1111_cov_15.366601	555	635	0	62	80	0.7750000
NODE_4885_length_1111_cov_15.366601	555	635	2	18	80	0.2250000
NODE_4885_length_1111_cov_15.366601	608	688	0	9	80	0.1125000
NODE_4885_length_1111_cov_15.366601	608	688	2	71	80	0.8875000
NODE_4886_length_1111_cov_15.314229	809	889	0	20	80	0.2500000
NODE_4886_length_1111_cov_15.314229	809	889	2	46	80	0.5750000
NODE_4886_length_1111_cov_15.314229	809	889	4	14	80	0.1750000
NODE_4886_length_1111_cov_15.314229	862	942	2	25	80	0.3125000
NODE_4886_length_1111_cov_15.314229	862	942	4	55	80	0.6875000
NODE_4887_length_1111_cov_9.732213	443	523	4	1	80	0.0125000
NODE_4887_length_1111_cov_9.732213	443	523	6	58	80	0.7250000
NODE_4887_length_1111_cov_9.732213	443	523	7	1	80	0.0125000
NODE_4887_length_1111_cov_9.732213	443	523	8	19	80	0.2375000
NODE_4887_length_1111_cov_9.732213	443	523	10	1	80	0.0125000
NODE_4887_length_1111_cov_9.732213	496	576	4	54	80	0.6750000
NODE_4887_length_1111_cov_9.732213	496	576	6	5	80	0.0625000
NODE_4887_length_1111_cov_9.732213	496	576	7	1	80	0.0125000
NODE_4887_length_1111_cov_9.732213	496	576	8	19	80	0.2375000
NODE_4887_length_1111_cov_9.732213	496	576	10	1	80	0.0125000
NODE_4888_length_1111_cov_4.907115	606	686	0	12	80	0.1500000
NODE_4888_length_1111_cov_4.907115	606	686	2	68	80	0.8500000
NODE_4888_length_1111_cov_4.907115	659	739	0	19	80	0.2375000
NODE_4888_length_1111_cov_4.907115	659	739	2	61	80	0.7625000
NODE_4892_length_1110_cov_23.012859	453	533	0	69	80	0.8625000
NODE_4892_length_1110_cov_23.012859	453	533	1	11	80	0.1375000
NODE_4892_length_1110_cov_23.012859	506	586	0	80	80	1.0000000
NODE_4892_length_1110_cov_23.012859	582	662	0	80	80	1.0000000
NODE_4892_length_1110_cov_23.012859	635	715	0	80	80	1.0000000
NODE_4895_length_1110_cov_5.305638	754	834	0	80	80	1.0000000
NODE_4895_length_1110_cov_5.305638	807	887	0	80	80	1.0000000
NODE_4896_length_1110_cov_3.698318	642	685	0	43	43	1.0000000
NODE_4899_length_1110_cov_1.871414	15	86	0	71	71	1.0000000
NODE_4903_length_1109_cov_35.307921	413	493	0	40	80	0.5000000
NODE_4903_length_1109_cov_35.307921	413	493	2	40	80	0.5000000
NODE_4903_length_1109_cov_35.307921	466	546	0	45	80	0.5625000
NODE_4903_length_1109_cov_35.307921	466	546	2	35	80	0.4375000
NODE_4903_length_1109_cov_35.307921	542	622	0	80	80	1.0000000
NODE_4903_length_1109_cov_35.307921	595	675	0	80	80	1.0000000
NODE_4904_length_1109_cov_27.880198	501	581	0	54	80	0.6750000
NODE_4904_length_1109_cov_27.880198	501	581	2	22	80	0.2750000
NODE_4904_length_1109_cov_27.880198	501	581	4	4	80	0.0500000
NODE_4904_length_1109_cov_27.880198	554	634	0	1	80	0.0125000
NODE_4904_length_1109_cov_27.880198	554	634	2	36	80	0.4500000
NODE_4904_length_1109_cov_27.880198	554	634	4	43	80	0.5375000
NODE_4904_length_1109_cov_27.880198	630	710	0	30	80	0.3750000
NODE_4904_length_1109_cov_27.880198	630	710	2	50	80	0.6250000
NODE_4904_length_1109_cov_27.880198	683	763	0	80	80	1.0000000
NODE_4905_length_1109_cov_21.858416	571	651	0	80	80	1.0000000
NODE_4905_length_1109_cov_21.858416	624	704	0	80	80	1.0000000
NODE_4912_length_1108_cov_59.921705	386	466	7	50	80	0.6250000
NODE_4912_length_1108_cov_59.921705	386	466	8	1	80	0.0125000
NODE_4912_length_1108_cov_59.921705	386	466	9	29	80	0.3625000
NODE_4912_length_1108_cov_59.921705	439	519	0	4	80	0.0500000
NODE_4912_length_1108_cov_59.921705	439	519	2	10	80	0.1250000
NODE_4912_length_1108_cov_59.921705	439	519	4	27	80	0.3375000
NODE_4912_length_1108_cov_59.921705	439	519	6	3	80	0.0375000
NODE_4912_length_1108_cov_59.921705	439	519	7	2	80	0.0250000
NODE_4912_length_1108_cov_59.921705	439	519	9	34	80	0.4250000
NODE_4912_length_1108_cov_59.921705	515	595	0	20	80	0.2500000
NODE_4912_length_1108_cov_59.921705	515	595	4	51	80	0.6375000
NODE_4912_length_1108_cov_59.921705	515	595	6	9	80	0.1125000
NODE_4912_length_1108_cov_59.921705	568	648	2	17	80	0.2125000
NODE_4912_length_1108_cov_59.921705	568	648	4	18	80	0.2250000
NODE_4912_length_1108_cov_59.921705	568	648	6	45	80	0.5625000
NODE_4914_length_1108_cov_16.069376	513	593	0	25	80	0.3125000
NODE_4914_length_1108_cov_16.069376	513	593	3	1	80	0.0125000
NODE_4914_length_1108_cov_16.069376	513	593	4	54	80	0.6750000
NODE_4914_length_1108_cov_16.069376	566	646	4	80	80	1.0000000
NODE_4916_length_1108_cov_11.656095	333	413	0	26	80	0.3250000
NODE_4916_length_1108_cov_11.656095	333	413	2	28	80	0.3500000
NODE_4916_length_1108_cov_11.656095	333	413	4	26	80	0.3250000
NODE_4916_length_1108_cov_11.656095	386	466	2	1	80	0.0125000
NODE_4916_length_1108_cov_11.656095	386	466	4	73	80	0.9125000
NODE_4916_length_1108_cov_11.656095	386	466	6	6	80	0.0750000
NODE_4917_length_1108_cov_10.266601	431	511	0	80	80	1.0000000
NODE_4917_length_1108_cov_10.266601	484	564	0	80	80	1.0000000
NODE_4918_length_1108_cov_8.895937	635	715	0	80	80	1.0000000
NODE_4918_length_1108_cov_8.895937	688	768	0	80	80	1.0000000
NODE_4920_length_1108_cov_5.682854	577	657	4	42	80	0.5250000
NODE_4920_length_1108_cov_5.682854	577	657	6	38	80	0.4750000
NODE_4920_length_1108_cov_5.682854	630	710	6	42	80	0.5250000
NODE_4920_length_1108_cov_5.682854	630	710	8	26	80	0.3250000
NODE_4920_length_1108_cov_5.682854	630	710	12	12	80	0.1500000
NODE_4927_length_1107_cov_35.050595	423	503	0	30	80	0.3750000
NODE_4927_length_1107_cov_35.050595	423	503	4	5	80	0.0625000
NODE_4927_length_1107_cov_35.050595	423	503	8	6	80	0.0750000
NODE_4927_length_1107_cov_35.050595	423	503	10	39	80	0.4875000
NODE_4927_length_1107_cov_35.050595	476	556	10	55	80	0.6875000
NODE_4927_length_1107_cov_35.050595	476	556	14	25	80	0.3125000
NODE_4927_length_1107_cov_35.050595	552	632	2	8	80	0.1000000
NODE_4927_length_1107_cov_35.050595	552	632	4	1	80	0.0125000
NODE_4927_length_1107_cov_35.050595	552	632	5	1	80	0.0125000
NODE_4927_length_1107_cov_35.050595	552	632	6	43	80	0.5375000
NODE_4927_length_1107_cov_35.050595	552	632	8	10	80	0.1250000
NODE_4927_length_1107_cov_35.050595	552	632	10	17	80	0.2125000
NODE_4927_length_1107_cov_35.050595	605	685	2	61	80	0.7625000
NODE_4927_length_1107_cov_35.050595	605	685	4	1	80	0.0125000
NODE_4927_length_1107_cov_35.050595	605	685	5	1	80	0.0125000
NODE_4927_length_1107_cov_35.050595	605	685	6	17	80	0.2125000
NODE_4928_length_1107_cov_31.386905	422	502	0	34	80	0.4250000
NODE_4928_length_1107_cov_31.386905	422	502	4	46	80	0.5750000
NODE_4928_length_1107_cov_31.386905	475	555	0	35	80	0.4375000
NODE_4928_length_1107_cov_31.386905	475	555	4	45	80	0.5625000
NODE_4929_length_1107_cov_29.178571	577	657	0	23	80	0.2875000
NODE_4929_length_1107_cov_29.178571	577	657	2	57	80	0.7125000
NODE_4929_length_1107_cov_29.178571	630	710	0	14	80	0.1750000
NODE_4929_length_1107_cov_29.178571	630	710	2	66	80	0.8250000
NODE_4929_length_1107_cov_29.178571	934	1000	4	42	66	0.6363636
NODE_4929_length_1107_cov_29.178571	934	1000	5	24	66	0.3636364
NODE_4929_length_1107_cov_29.178571	934	1005	4	42	71	0.5915493
NODE_4929_length_1107_cov_29.178571	934	1005	5	29	71	0.4084507
NODE_4930_length_1107_cov_16.038690	574	654	2	19	80	0.2375000
NODE_4930_length_1107_cov_16.038690	574	654	4	61	80	0.7625000
NODE_4930_length_1107_cov_16.038690	627	707	0	42	80	0.5250000
NODE_4930_length_1107_cov_16.038690	627	707	2	30	80	0.3750000
NODE_4930_length_1107_cov_16.038690	627	707	4	8	80	0.1000000
NODE_4931_length_1107_cov_15.472222	78	158	233	1	80	0.0125000
NODE_4931_length_1107_cov_15.472222	78	158	234	1	80	0.0125000
NODE_4931_length_1107_cov_15.472222	78	158	241	1	80	0.0125000
NODE_4931_length_1107_cov_15.472222	78	158	249	1	80	0.0125000
NODE_4931_length_1107_cov_15.472222	78	158	253	1	80	0.0125000
NODE_4931_length_1107_cov_15.472222	78	158	264	1	80	0.0125000
NODE_4931_length_1107_cov_15.472222	78	158	269	1	80	0.0125000
NODE_4931_length_1107_cov_15.472222	78	158	275	1	80	0.0125000
NODE_4931_length_1107_cov_15.472222	78	158	277	1	80	0.0125000
NODE_4931_length_1107_cov_15.472222	78	158	287	1	80	0.0125000
NODE_4931_length_1107_cov_15.472222	78	158	295	2	80	0.0250000
NODE_4931_length_1107_cov_15.472222	78	158	317	1	80	0.0125000
NODE_4931_length_1107_cov_15.472222	78	158	319	1	80	0.0125000
NODE_4931_length_1107_cov_15.472222	78	158	325	2	80	0.0250000
NODE_4931_length_1107_cov_15.472222	78	158	329	1	80	0.0125000
NODE_4931_length_1107_cov_15.472222	78	158	333	6	80	0.0750000
NODE_4931_length_1107_cov_15.472222	78	158	338	1	80	0.0125000
NODE_4931_length_1107_cov_15.472222	78	158	341	4	80	0.0500000
NODE_4931_length_1107_cov_15.472222	78	158	349	1	80	0.0125000
NODE_4931_length_1107_cov_15.472222	78	158	351	1	80	0.0125000
NODE_4931_length_1107_cov_15.472222	78	158	355	2	80	0.0250000
NODE_4931_length_1107_cov_15.472222	78	158	357	1	80	0.0125000
NODE_4931_length_1107_cov_15.472222	78	158	359	1	80	0.0125000
NODE_4931_length_1107_cov_15.472222	78	158	361	3	80	0.0375000
NODE_4931_length_1107_cov_15.472222	78	158	363	4	80	0.0500000
NODE_4931_length_1107_cov_15.472222	78	158	365	4	80	0.0500000
NODE_4931_length_1107_cov_15.472222	78	158	367	1	80	0.0125000
NODE_4931_length_1107_cov_15.472222	78	158	369	1	80	0.0125000
NODE_4931_length_1107_cov_15.472222	78	158	371	4	80	0.0500000
NODE_4931_length_1107_cov_15.472222	78	158	375	1	80	0.0125000
NODE_4931_length_1107_cov_15.472222	78	158	376	1	80	0.0125000
NODE_4931_length_1107_cov_15.472222	78	158	377	2	80	0.0250000
NODE_4931_length_1107_cov_15.472222	78	158	378	1	80	0.0125000
NODE_4931_length_1107_cov_15.472222	78	158	380	3	80	0.0375000
NODE_4931_length_1107_cov_15.472222	78	158	388	1	80	0.0125000
NODE_4931_length_1107_cov_15.472222	78	158	390	6	80	0.0750000
NODE_4931_length_1107_cov_15.472222	78	158	394	14	80	0.1750000
NODE_4931_length_1107_cov_15.472222	131	194	28	1	63	0.0158730
NODE_4931_length_1107_cov_15.472222	131	194	34	1	63	0.0158730
NODE_4931_length_1107_cov_15.472222	131	194	35	1	63	0.0158730
NODE_4931_length_1107_cov_15.472222	131	194	45	1	63	0.0158730
NODE_4931_length_1107_cov_15.472222	131	194	50	1	63	0.0158730
NODE_4931_length_1107_cov_15.472222	131	194	65	1	63	0.0158730
NODE_4931_length_1107_cov_15.472222	131	194	73	1	63	0.0158730
NODE_4931_length_1107_cov_15.472222	131	194	76	1	63	0.0158730
NODE_4931_length_1107_cov_15.472222	131	194	85	1	63	0.0158730
NODE_4931_length_1107_cov_15.472222	131	194	90	2	63	0.0317460
NODE_4931_length_1107_cov_15.472222	131	194	102	2	63	0.0317460
NODE_4931_length_1107_cov_15.472222	131	194	104	1	63	0.0158730
NODE_4931_length_1107_cov_15.472222	131	194	114	1	63	0.0158730
NODE_4931_length_1107_cov_15.472222	131	194	120	1	63	0.0158730
NODE_4931_length_1107_cov_15.472222	131	194	128	1	63	0.0158730
NODE_4931_length_1107_cov_15.472222	131	194	132	1	63	0.0158730
NODE_4931_length_1107_cov_15.472222	131	194	138	2	63	0.0317460
NODE_4931_length_1107_cov_15.472222	131	194	149	1	63	0.0158730
NODE_4931_length_1107_cov_15.472222	131	194	155	1	63	0.0158730
NODE_4931_length_1107_cov_15.472222	131	194	164	1	63	0.0158730
NODE_4931_length_1107_cov_15.472222	131	194	168	1	63	0.0158730
NODE_4931_length_1107_cov_15.472222	131	194	176	1	63	0.0158730
NODE_4931_length_1107_cov_15.472222	131	194	191	1	63	0.0158730
NODE_4931_length_1107_cov_15.472222	131	194	201	1	63	0.0158730
NODE_4931_length_1107_cov_15.472222	131	194	205	1	63	0.0158730
NODE_4931_length_1107_cov_15.472222	131	194	209	1	63	0.0158730
NODE_4931_length_1107_cov_15.472222	131	194	217	1	63	0.0158730
NODE_4931_length_1107_cov_15.472222	131	194	219	1	63	0.0158730
NODE_4931_length_1107_cov_15.472222	131	194	227	3	63	0.0476190
NODE_4931_length_1107_cov_15.472222	131	194	229	1	63	0.0158730
NODE_4931_length_1107_cov_15.472222	131	194	232	1	63	0.0158730
NODE_4931_length_1107_cov_15.472222	131	194	233	1	63	0.0158730
NODE_4931_length_1107_cov_15.472222	131	194	234	1	63	0.0158730
NODE_4931_length_1107_cov_15.472222	131	194	241	1	63	0.0158730
NODE_4931_length_1107_cov_15.472222	131	194	249	1	63	0.0158730
NODE_4931_length_1107_cov_15.472222	131	194	253	1	63	0.0158730
NODE_4931_length_1107_cov_15.472222	131	194	264	1	63	0.0158730
NODE_4931_length_1107_cov_15.472222	131	194	269	1	63	0.0158730
NODE_4931_length_1107_cov_15.472222	131	194	275	1	63	0.0158730
NODE_4931_length_1107_cov_15.472222	131	194	277	1	63	0.0158730
NODE_4931_length_1107_cov_15.472222	131	194	287	1	63	0.0158730
NODE_4931_length_1107_cov_15.472222	131	194	295	2	63	0.0317460
NODE_4931_length_1107_cov_15.472222	131	194	317	1	63	0.0158730
NODE_4931_length_1107_cov_15.472222	131	194	319	1	63	0.0158730
NODE_4931_length_1107_cov_15.472222	131	194	325	2	63	0.0317460
NODE_4931_length_1107_cov_15.472222	131	194	329	1	63	0.0158730
NODE_4931_length_1107_cov_15.472222	131	194	333	6	63	0.0952381
NODE_4931_length_1107_cov_15.472222	131	194	338	1	63	0.0158730
NODE_4931_length_1107_cov_15.472222	131	194	341	3	63	0.0476190
NODE_4931_length_1107_cov_15.472222	952	995	3	27	43	0.6279070
NODE_4931_length_1107_cov_15.472222	952	995	5	12	43	0.2790698
NODE_4931_length_1107_cov_15.472222	952	995	7	2	43	0.0465116
NODE_4931_length_1107_cov_15.472222	952	995	9	2	43	0.0465116
NODE_4931_length_1107_cov_15.472222	968	1052	3	48	84	0.5714286
NODE_4931_length_1107_cov_15.472222	968	1052	5	36	84	0.4285714
NODE_4932_length_1107_cov_13.911706	502	582	5	12	80	0.1500000
NODE_4932_length_1107_cov_13.911706	502	582	6	68	80	0.8500000
NODE_4932_length_1107_cov_13.911706	555	635	0	37	80	0.4625000
NODE_4932_length_1107_cov_13.911706	555	635	4	1	80	0.0125000
NODE_4932_length_1107_cov_13.911706	555	635	5	27	80	0.3375000
NODE_4932_length_1107_cov_13.911706	555	635	6	15	80	0.1875000
NODE_4933_length_1107_cov_11.701389	520	600	0	65	80	0.8125000
NODE_4933_length_1107_cov_11.701389	520	600	2	15	80	0.1875000
NODE_4933_length_1107_cov_11.701389	573	653	0	28	80	0.3500000
NODE_4933_length_1107_cov_11.701389	573	653	2	52	80	0.6500000
NODE_4944_length_1106_cov_59.617676	452	532	0	80	80	1.0000000
NODE_4944_length_1106_cov_59.617676	505	585	0	80	80	1.0000000
NODE_4944_length_1106_cov_59.617676	581	661	0	72	80	0.9000000
NODE_4944_length_1106_cov_59.617676	581	661	2	8	80	0.1000000
NODE_4944_length_1106_cov_59.617676	634	714	0	19	80	0.2375000
NODE_4944_length_1106_cov_59.617676	634	714	2	61	80	0.7625000
NODE_4945_length_1106_cov_40.808342	439	504	2	65	65	1.0000000
NODE_4945_length_1106_cov_40.808342	471	511	2	40	40	1.0000000
NODE_4945_length_1106_cov_40.808342	503	569	0	52	66	0.7878788
NODE_4945_length_1106_cov_40.808342	503	569	2	14	66	0.2121212
NODE_4945_length_1106_cov_40.808342	536	601	0	65	65	1.0000000
NODE_4945_length_1106_cov_40.808342	568	648	0	80	80	1.0000000
NODE_4945_length_1106_cov_40.808342	621	682	0	61	61	1.0000000
NODE_4946_length_1106_cov_23.186693	560	640	8	32	80	0.4000000
NODE_4946_length_1106_cov_23.186693	560	640	11	44	80	0.5500000
NODE_4946_length_1106_cov_23.186693	560	640	13	4	80	0.0500000
NODE_4946_length_1106_cov_23.186693	613	693	4	21	80	0.2625000
NODE_4946_length_1106_cov_23.186693	613	693	8	36	80	0.4500000
NODE_4946_length_1106_cov_23.186693	613	693	10	23	80	0.2875000
NODE_4947_length_1106_cov_14.570010	466	546	4	37	80	0.4625000
NODE_4947_length_1106_cov_14.570010	466	546	6	19	80	0.2375000
NODE_4947_length_1106_cov_14.570010	466	546	8	24	80	0.3000000
NODE_4947_length_1106_cov_14.570010	519	599	6	34	80	0.4250000
NODE_4947_length_1106_cov_14.570010	519	599	8	46	80	0.5750000
NODE_4948_length_1106_cov_14.039722	487	567	0	13	80	0.1625000
NODE_4948_length_1106_cov_14.039722	487	567	4	62	80	0.7750000
NODE_4948_length_1106_cov_14.039722	487	567	6	5	80	0.0625000
NODE_4948_length_1106_cov_14.039722	540	620	2	46	80	0.5750000
NODE_4948_length_1106_cov_14.039722	540	620	4	22	80	0.2750000
NODE_4948_length_1106_cov_14.039722	540	620	6	12	80	0.1500000
NODE_4949_length_1106_cov_8.872890	328	408	0	80	80	1.0000000
NODE_4949_length_1106_cov_8.872890	381	461	0	80	80	1.0000000
NODE_4950_length_1106_cov_7.157895	332	412	0	80	80	1.0000000
NODE_4950_length_1106_cov_7.157895	385	465	0	80	80	1.0000000
NODE_4951_length_1106_cov_6.530288	513	593	0	80	80	1.0000000
NODE_4951_length_1106_cov_6.530288	566	646	0	80	80	1.0000000
NODE_4959_length_1105_cov_28.126243	253	333	0	68	80	0.8500000
NODE_4959_length_1105_cov_28.126243	253	333	5	1	80	0.0125000
NODE_4959_length_1105_cov_28.126243	253	333	6	11	80	0.1375000
NODE_4959_length_1105_cov_28.126243	306	386	0	15	80	0.1875000
NODE_4959_length_1105_cov_28.126243	306	386	5	1	80	0.0125000
NODE_4959_length_1105_cov_28.126243	306	386	6	49	80	0.6125000
NODE_4959_length_1105_cov_28.126243	306	386	8	15	80	0.1875000
NODE_4960_length_1105_cov_24.994036	549	629	2	80	80	1.0000000
NODE_4960_length_1105_cov_24.994036	602	682	0	51	80	0.6375000
NODE_4960_length_1105_cov_24.994036	602	682	2	29	80	0.3625000
NODE_4961_length_1105_cov_17.635189	442	522	0	16	80	0.2000000
NODE_4961_length_1105_cov_17.635189	442	522	2	64	80	0.8000000
NODE_4961_length_1105_cov_17.635189	495	575	0	69	80	0.8625000
NODE_4961_length_1105_cov_17.635189	495	575	2	11	80	0.1375000
NODE_4963_length_1105_cov_10.114314	438	518	0	80	80	1.0000000
NODE_4963_length_1105_cov_10.114314	491	571	0	80	80	1.0000000
NODE_4964_length_1105_cov_8.403579	507	587	0	80	80	1.0000000
NODE_4964_length_1105_cov_8.403579	560	640	0	80	80	1.0000000
NODE_4966_length_1105_cov_6.682903	467	547	0	80	80	1.0000000
NODE_4966_length_1105_cov_6.682903	520	600	0	80	80	1.0000000
NODE_4966_length_1105_cov_6.682903	596	676	0	80	80	1.0000000
NODE_4966_length_1105_cov_6.682903	649	729	0	80	80	1.0000000
NODE_4974_length_1104_cov_27.599005	388	468	0	30	80	0.3750000
NODE_4974_length_1104_cov_27.599005	388	468	2	50	80	0.6250000
NODE_4974_length_1104_cov_27.599005	441	521	0	13	80	0.1625000
NODE_4974_length_1104_cov_27.599005	441	521	2	67	80	0.8375000
NODE_4984_length_1103_cov_2.787849	620	682	2	15	62	0.2419355
NODE_4984_length_1103_cov_2.787849	620	682	4	47	62	0.7580645
NODE_4986_length_1102_cov_34.484546	667	747	0	38	80	0.4750000
NODE_4986_length_1102_cov_34.484546	667	747	2	42	80	0.5250000
NODE_4986_length_1102_cov_34.484546	720	800	2	29	80	0.3625000
NODE_4986_length_1102_cov_34.484546	720	800	4	40	80	0.5000000
NODE_4986_length_1102_cov_34.484546	720	800	6	11	80	0.1375000
NODE_4987_length_1102_cov_17.631107	511	587	4	30	76	0.3947369
NODE_4987_length_1102_cov_17.631107	511	587	16	18	76	0.2368421
NODE_4987_length_1102_cov_17.631107	511	587	18	5	76	0.0657895
NODE_4987_length_1102_cov_17.631107	511	587	20	17	76	0.2236842
NODE_4987_length_1102_cov_17.631107	511	587	22	6	76	0.0789474
NODE_4987_length_1102_cov_17.631107	560	640	10	8	80	0.1000000
NODE_4987_length_1102_cov_17.631107	560	640	18	50	80	0.6250000
NODE_4987_length_1102_cov_17.631107	560	640	20	16	80	0.2000000
NODE_4987_length_1102_cov_17.631107	560	640	22	6	80	0.0750000
NODE_4998_length_1101_cov_35.638723	414	491	16	2	77	0.0259740
NODE_4998_length_1101_cov_35.638723	414	491	18	65	77	0.8441558
NODE_4998_length_1101_cov_35.638723	414	491	22	10	77	0.1298701
NODE_4998_length_1101_cov_35.638723	414	491	16	2	77	0.0259740
NODE_4998_length_1101_cov_35.638723	414	491	18	65	77	0.8441558
NODE_4998_length_1101_cov_35.638723	414	491	22	10	77	0.1298701
NODE_4998_length_1101_cov_35.638723	488	544	6	18	56	0.3214286
NODE_4998_length_1101_cov_35.638723	488	544	8	27	56	0.4821429
NODE_4998_length_1101_cov_35.638723	488	544	9	1	56	0.0178571
NODE_4998_length_1101_cov_35.638723	488	544	10	7	56	0.1250000
NODE_4998_length_1101_cov_35.638723	488	544	22	3	56	0.0535714
NODE_4998_length_1101_cov_35.638723	752	832	4	6	80	0.0750000
NODE_4998_length_1101_cov_35.638723	752	832	6	4	80	0.0500000
NODE_4998_length_1101_cov_35.638723	752	832	8	15	80	0.1875000
NODE_4998_length_1101_cov_35.638723	752	832	10	55	80	0.6875000
NODE_4998_length_1101_cov_35.638723	805	885	0	23	80	0.2875000
NODE_4998_length_1101_cov_35.638723	805	885	2	1	80	0.0125000
NODE_4998_length_1101_cov_35.638723	805	885	4	35	80	0.4375000
NODE_4998_length_1101_cov_35.638723	805	885	6	4	80	0.0500000
NODE_4998_length_1101_cov_35.638723	805	885	10	17	80	0.2125000
NODE_4998_length_1101_cov_35.638723	881	961	0	4	80	0.0500000
NODE_4998_length_1101_cov_35.638723	881	961	2	2	80	0.0250000
NODE_4998_length_1101_cov_35.638723	881	961	4	23	80	0.2875000
NODE_4998_length_1101_cov_35.638723	881	961	7	4	80	0.0500000
NODE_4998_length_1101_cov_35.638723	881	961	9	2	80	0.0250000
NODE_4998_length_1101_cov_35.638723	881	961	11	2	80	0.0250000
NODE_4998_length_1101_cov_35.638723	881	961	12	23	80	0.2875000
NODE_4998_length_1101_cov_35.638723	881	961	14	14	80	0.1750000
NODE_4998_length_1101_cov_35.638723	881	961	16	3	80	0.0375000
NODE_4998_length_1101_cov_35.638723	881	961	24	3	80	0.0375000
NODE_4998_length_1101_cov_35.638723	934	1014	12	7	80	0.0875000
NODE_4998_length_1101_cov_35.638723	934	1014	14	14	80	0.1750000
NODE_4998_length_1101_cov_35.638723	934	1014	16	3	80	0.0375000
NODE_4998_length_1101_cov_35.638723	934	1014	24	21	80	0.2625000
NODE_4998_length_1101_cov_35.638723	934	1014	26	8	80	0.1000000
NODE_4998_length_1101_cov_35.638723	934	1014	28	27	80	0.3375000
NODE_4999_length_1101_cov_28.366267	452	532	4	80	80	1.0000000
NODE_4999_length_1101_cov_28.366267	505	585	0	30	80	0.3750000
NODE_4999_length_1101_cov_28.366267	505	585	4	50	80	0.6250000
NODE_5000_length_1101_cov_24.513972	475	555	0	80	80	1.0000000
NODE_5000_length_1101_cov_24.513972	528	608	0	80	80	1.0000000
NODE_5001_length_1101_cov_22.315369	335	415	0	58	80	0.7250000
NODE_5001_length_1101_cov_22.315369	335	415	2	2	80	0.0250000
NODE_5001_length_1101_cov_22.315369	335	415	4	20	80	0.2500000
NODE_5001_length_1101_cov_22.315369	388	468	0	5	80	0.0625000
NODE_5001_length_1101_cov_22.315369	388	468	2	2	80	0.0250000
NODE_5001_length_1101_cov_22.315369	388	468	4	59	80	0.7375000
NODE_5001_length_1101_cov_22.315369	388	468	14	14	80	0.1750000
NODE_5001_length_1101_cov_22.315369	464	544	14	11	80	0.1375000
NODE_5001_length_1101_cov_22.315369	464	544	20	27	80	0.3375000
NODE_5001_length_1101_cov_22.315369	464	544	22	16	80	0.2000000
NODE_5001_length_1101_cov_22.315369	464	544	24	26	80	0.3250000
NODE_5001_length_1101_cov_22.315369	517	597	2	14	80	0.1750000
NODE_5001_length_1101_cov_22.315369	517	597	11	1	80	0.0125000
NODE_5001_length_1101_cov_22.315369	517	597	12	2	80	0.0250000
NODE_5001_length_1101_cov_22.315369	517	597	20	12	80	0.1500000
NODE_5001_length_1101_cov_22.315369	517	597	22	51	80	0.6375000
NODE_5002_length_1101_cov_22.070858	419	499	0	70	80	0.8750000
NODE_5002_length_1101_cov_22.070858	419	499	2	10	80	0.1250000
NODE_5002_length_1101_cov_22.070858	472	552	0	17	80	0.2125000
NODE_5002_length_1101_cov_22.070858	472	552	2	63	80	0.7875000
NODE_5002_length_1101_cov_22.070858	548	628	2	70	80	0.8750000
NODE_5002_length_1101_cov_22.070858	548	628	4	5	80	0.0625000
NODE_5002_length_1101_cov_22.070858	548	628	8	5	80	0.0625000
NODE_5002_length_1101_cov_22.070858	601	681	2	22	80	0.2750000
NODE_5002_length_1101_cov_22.070858	601	681	6	24	80	0.3000000
NODE_5002_length_1101_cov_22.070858	601	681	8	34	80	0.4250000
NODE_5003_length_1101_cov_18.821357	469	549	0	50	80	0.6250000
NODE_5003_length_1101_cov_18.821357	469	549	2	19	80	0.2375000
NODE_5003_length_1101_cov_18.821357	469	549	4	11	80	0.1375000
NODE_5003_length_1101_cov_18.821357	522	602	2	35	80	0.4375000
NODE_5003_length_1101_cov_18.821357	522	602	4	45	80	0.5625000
NODE_5004_length_1101_cov_17.151697	502	582	8	47	80	0.5875000
NODE_5004_length_1101_cov_17.151697	502	582	10	1	80	0.0125000
NODE_5004_length_1101_cov_17.151697	502	582	12	2	80	0.0250000
NODE_5004_length_1101_cov_17.151697	502	582	14	30	80	0.3750000
NODE_5004_length_1101_cov_17.151697	555	635	6	8	80	0.1000000
NODE_5004_length_1101_cov_17.151697	555	635	8	7	80	0.0875000
NODE_5004_length_1101_cov_17.151697	555	635	14	29	80	0.3625000
NODE_5004_length_1101_cov_17.151697	555	635	16	31	80	0.3875000
NODE_5004_length_1101_cov_17.151697	555	635	18	5	80	0.0625000
NODE_5005_length_1101_cov_8.371257	968	1048	10	1	80	0.0125000
NODE_5005_length_1101_cov_8.371257	968	1048	24	12	80	0.1500000
NODE_5005_length_1101_cov_8.371257	968	1048	26	5	80	0.0625000
NODE_5005_length_1101_cov_8.371257	968	1048	28	7	80	0.0875000
NODE_5005_length_1101_cov_8.371257	968	1048	30	1	80	0.0125000
NODE_5005_length_1101_cov_8.371257	968	1048	36	2	80	0.0250000
NODE_5005_length_1101_cov_8.371257	968	1048	40	3	80	0.0375000
NODE_5005_length_1101_cov_8.371257	968	1048	41	40	80	0.5000000
NODE_5005_length_1101_cov_8.371257	968	1048	42	9	80	0.1125000
NODE_5010_length_1100_cov_42.528472	582	662	12	25	80	0.3125000
NODE_5010_length_1100_cov_42.528472	582	662	13	4	80	0.0500000
NODE_5010_length_1100_cov_42.528472	582	662	15	51	80	0.6375000
NODE_5010_length_1100_cov_42.528472	635	715	7	1	80	0.0125000
NODE_5010_length_1100_cov_42.528472	635	715	12	60	80	0.7500000
NODE_5010_length_1100_cov_42.528472	635	715	13	19	80	0.2375000
NODE_5010_length_1100_cov_42.528472	711	791	0	60	80	0.7500000
NODE_5010_length_1100_cov_42.528472	711	791	7	17	80	0.2125000
NODE_5010_length_1100_cov_42.528472	711	791	13	3	80	0.0375000
NODE_5010_length_1100_cov_42.528472	764	844	0	80	80	1.0000000
NODE_5011_length_1100_cov_40.883117	324	404	0	80	80	1.0000000
NODE_5011_length_1100_cov_40.883117	377	457	0	80	80	1.0000000
NODE_5011_length_1100_cov_40.883117	453	533	0	32	80	0.4000000
NODE_5011_length_1100_cov_40.883117	453	533	2	26	80	0.3250000
NODE_5011_length_1100_cov_40.883117	453	533	5	22	80	0.2750000
NODE_5011_length_1100_cov_40.883117	506	586	2	5	80	0.0625000
NODE_5011_length_1100_cov_40.883117	506	586	3	1	80	0.0125000
NODE_5011_length_1100_cov_40.883117	506	586	4	30	80	0.3750000
NODE_5011_length_1100_cov_40.883117	506	586	5	44	80	0.5500000
NODE_5012_length_1100_cov_23.160839	524	604	4	80	80	1.0000000
NODE_5012_length_1100_cov_23.160839	577	657	0	52	80	0.6500000
NODE_5012_length_1100_cov_23.160839	577	657	4	28	80	0.3500000
NODE_5012_length_1100_cov_23.160839	653	733	0	31	80	0.3875000
NODE_5012_length_1100_cov_23.160839	653	733	2	6	80	0.0750000
NODE_5012_length_1100_cov_23.160839	653	733	10	43	80	0.5375000
NODE_5012_length_1100_cov_23.160839	706	786	8	33	80	0.4125000
NODE_5012_length_1100_cov_23.160839	706	786	10	47	80	0.5875000
NODE_5013_length_1100_cov_22.200799	485	565	2	74	80	0.9250000
NODE_5013_length_1100_cov_22.200799	485	565	4	3	80	0.0375000
NODE_5013_length_1100_cov_22.200799	485	565	6	3	80	0.0375000
NODE_5013_length_1100_cov_22.200799	538	618	2	21	80	0.2625000
NODE_5013_length_1100_cov_22.200799	538	618	4	46	80	0.5750000
NODE_5013_length_1100_cov_22.200799	538	618	6	13	80	0.1625000
NODE_5013_length_1100_cov_22.200799	614	694	6	40	80	0.5000000
NODE_5013_length_1100_cov_22.200799	614	694	8	38	80	0.4750000
NODE_5013_length_1100_cov_22.200799	614	694	10	2	80	0.0250000
NODE_5013_length_1100_cov_22.200799	667	745	6	18	78	0.2307692
NODE_5013_length_1100_cov_22.200799	667	745	8	37	78	0.4743590
NODE_5013_length_1100_cov_22.200799	667	745	12	23	78	0.2948718
NODE_5014_length_1100_cov_15.353646	472	552	0	22	80	0.2750000
NODE_5014_length_1100_cov_15.353646	472	552	2	18	80	0.2250000
NODE_5014_length_1100_cov_15.353646	472	552	4	40	80	0.5000000
NODE_5014_length_1100_cov_15.353646	525	605	0	13	80	0.1625000
NODE_5014_length_1100_cov_15.353646	525	605	2	10	80	0.1250000
NODE_5014_length_1100_cov_15.353646	525	605	4	57	80	0.7125000
NODE_5015_length_1100_cov_14.584416	673	753	4	12	80	0.1500000
NODE_5015_length_1100_cov_14.584416	673	753	6	5	80	0.0625000
NODE_5015_length_1100_cov_14.584416	673	753	8	7	80	0.0875000
NODE_5015_length_1100_cov_14.584416	673	753	10	56	80	0.7000000
NODE_5015_length_1100_cov_14.584416	726	806	0	26	80	0.3250000
NODE_5015_length_1100_cov_14.584416	726	806	2	4	80	0.0500000
NODE_5015_length_1100_cov_14.584416	726	806	6	28	80	0.3500000
NODE_5015_length_1100_cov_14.584416	726	806	10	22	80	0.2750000
NODE_5029_length_1099_cov_85.893000	464	544	4	19	80	0.2375000
NODE_5029_length_1099_cov_85.893000	464	544	6	52	80	0.6500000
NODE_5029_length_1099_cov_85.893000	464	544	8	9	80	0.1125000
NODE_5029_length_1099_cov_85.893000	517	597	2	22	80	0.2750000
NODE_5029_length_1099_cov_85.893000	517	597	4	26	80	0.3250000
NODE_5029_length_1099_cov_85.893000	517	597	6	32	80	0.4000000
NODE_5029_length_1099_cov_85.893000	593	673	2	18	80	0.2250000
NODE_5029_length_1099_cov_85.893000	593	673	4	62	80	0.7750000
NODE_5029_length_1099_cov_85.893000	646	726	0	32	80	0.4000000
NODE_5029_length_1099_cov_85.893000	646	726	2	8	80	0.1000000
NODE_5029_length_1099_cov_85.893000	646	726	4	40	80	0.5000000
NODE_5030_length_1099_cov_45.874000	521	601	0	80	80	1.0000000
NODE_5030_length_1099_cov_45.874000	574	654	0	80	80	1.0000000
NODE_5030_length_1099_cov_45.874000	650	730	0	80	80	1.0000000
NODE_5030_length_1099_cov_45.874000	703	783	0	80	80	1.0000000
NODE_5031_length_1099_cov_25.192000	526	606	2	57	80	0.7125000
NODE_5031_length_1099_cov_25.192000	526	606	17	10	80	0.1250000
NODE_5031_length_1099_cov_25.192000	526	606	21	13	80	0.1625000
NODE_5031_length_1099_cov_25.192000	579	659	2	4	80	0.0500000
NODE_5031_length_1099_cov_25.192000	579	659	17	10	80	0.1250000
NODE_5031_length_1099_cov_25.192000	579	659	21	24	80	0.3000000
NODE_5031_length_1099_cov_25.192000	579	659	22	1	80	0.0125000
NODE_5031_length_1099_cov_25.192000	579	659	23	2	80	0.0250000
NODE_5031_length_1099_cov_25.192000	579	659	24	1	80	0.0125000
NODE_5031_length_1099_cov_25.192000	579	659	25	9	80	0.1125000
NODE_5031_length_1099_cov_25.192000	579	659	26	24	80	0.3000000
NODE_5031_length_1099_cov_25.192000	579	659	27	5	80	0.0625000
NODE_5032_length_1099_cov_11.846000	565	645	1	80	80	1.0000000
NODE_5032_length_1099_cov_11.846000	618	698	0	20	80	0.2500000
NODE_5032_length_1099_cov_11.846000	618	698	1	60	80	0.7500000
NODE_5033_length_1099_cov_9.527000	495	575	2	1	80	0.0125000
NODE_5033_length_1099_cov_9.527000	495	575	4	1	80	0.0125000
NODE_5033_length_1099_cov_9.527000	495	575	6	2	80	0.0250000
NODE_5033_length_1099_cov_9.527000	495	575	10	1	80	0.0125000
NODE_5033_length_1099_cov_9.527000	495	575	12	4	80	0.0500000
NODE_5033_length_1099_cov_9.527000	495	575	16	7	80	0.0875000
NODE_5033_length_1099_cov_9.527000	495	575	26	3	80	0.0375000
NODE_5033_length_1099_cov_9.527000	495	575	28	35	80	0.4375000
NODE_5033_length_1099_cov_9.527000	495	575	30	8	80	0.1000000
NODE_5033_length_1099_cov_9.527000	495	575	32	18	80	0.2250000
NODE_5033_length_1099_cov_9.527000	548	628	14	17	80	0.2125000
NODE_5033_length_1099_cov_9.527000	548	628	16	9	80	0.1125000
NODE_5033_length_1099_cov_9.527000	548	628	18	12	80	0.1500000
NODE_5033_length_1099_cov_9.527000	548	628	22	2	80	0.0250000
NODE_5033_length_1099_cov_9.527000	548	628	26	4	80	0.0500000
NODE_5033_length_1099_cov_9.527000	548	628	28	2	80	0.0250000
NODE_5033_length_1099_cov_9.527000	548	628	30	13	80	0.1625000
NODE_5033_length_1099_cov_9.527000	548	628	32	21	80	0.2625000
NODE_5034_length_1099_cov_8.993000	464	544	1	18	80	0.2250000
NODE_5034_length_1099_cov_8.993000	464	544	2	62	80	0.7750000
NODE_5034_length_1099_cov_8.993000	517	597	1	6	80	0.0750000
NODE_5034_length_1099_cov_8.993000	517	597	2	74	80	0.9250000
NODE_5039_length_1099_cov_2.286000	273	353	0	23	80	0.2875000
NODE_5039_length_1099_cov_2.286000	273	353	2	57	80	0.7125000
NODE_5045_length_1098_cov_44.988989	360	440	0	80	80	1.0000000
NODE_5045_length_1098_cov_44.988989	413	493	0	80	80	1.0000000
NODE_5046_length_1098_cov_35.192192	452	532	0	80	80	1.0000000
NODE_5046_length_1098_cov_35.192192	505	585	0	80	80	1.0000000
NODE_5046_length_1098_cov_35.192192	581	661	0	7	80	0.0875000
NODE_5046_length_1098_cov_35.192192	581	661	4	73	80	0.9125000
NODE_5046_length_1098_cov_35.192192	634	714	4	80	80	1.0000000
NODE_5047_length_1098_cov_28.743744	449	529	4	80	80	1.0000000
NODE_5047_length_1098_cov_28.743744	502	582	4	28	80	0.3500000
NODE_5047_length_1098_cov_28.743744	502	582	5	21	80	0.2625000
NODE_5047_length_1098_cov_28.743744	502	582	6	20	80	0.2500000
NODE_5047_length_1098_cov_28.743744	502	582	8	11	80	0.1375000
NODE_5047_length_1098_cov_28.743744	578	658	2	7	80	0.0875000
NODE_5047_length_1098_cov_28.743744	578	658	4	46	80	0.5750000
NODE_5047_length_1098_cov_28.743744	578	658	5	4	80	0.0500000
NODE_5047_length_1098_cov_28.743744	578	658	6	23	80	0.2875000
NODE_5047_length_1098_cov_28.743744	631	711	2	22	80	0.2750000
NODE_5047_length_1098_cov_28.743744	631	711	4	13	80	0.1625000
NODE_5047_length_1098_cov_28.743744	631	711	6	45	80	0.5625000
NODE_5048_length_1098_cov_28.230230	477	557	2	55	80	0.6875000
NODE_5048_length_1098_cov_28.230230	477	557	4	25	80	0.3125000
NODE_5048_length_1098_cov_28.230230	530	610	0	11	80	0.1375000
NODE_5048_length_1098_cov_28.230230	530	610	2	12	80	0.1500000
NODE_5048_length_1098_cov_28.230230	530	610	4	57	80	0.7125000
NODE_5048_length_1098_cov_28.230230	606	686	0	14	80	0.1750000
NODE_5048_length_1098_cov_28.230230	606	686	2	66	80	0.8250000
NODE_5048_length_1098_cov_28.230230	659	739	0	6	80	0.0750000
NODE_5048_length_1098_cov_28.230230	659	739	2	74	80	0.9250000
NODE_5049_length_1098_cov_26.131131	494	574	0	80	80	1.0000000
NODE_5049_length_1098_cov_26.131131	547	627	0	80	80	1.0000000
NODE_5050_length_1098_cov_21.355355	599	679	2	4	80	0.0500000
NODE_5050_length_1098_cov_21.355355	599	679	8	37	80	0.4625000
NODE_5050_length_1098_cov_21.355355	599	679	10	39	80	0.4875000
NODE_5050_length_1098_cov_21.355355	652	732	0	22	80	0.2750000
NODE_5050_length_1098_cov_21.355355	652	732	6	12	80	0.1500000
NODE_5050_length_1098_cov_21.355355	652	732	8	46	80	0.5750000
NODE_5051_length_1098_cov_17.087087	541	621	0	21	80	0.2625000
NODE_5051_length_1098_cov_17.087087	541	621	2	59	80	0.7375000
NODE_5051_length_1098_cov_17.087087	594	674	2	53	80	0.6625000
NODE_5051_length_1098_cov_17.087087	594	674	4	27	80	0.3375000
NODE_5051_length_1098_cov_17.087087	670	750	2	70	80	0.8750000
NODE_5051_length_1098_cov_17.087087	670	750	4	10	80	0.1250000
NODE_5051_length_1098_cov_17.087087	723	803	2	80	80	1.0000000
NODE_5052_length_1098_cov_15.455455	545	625	2	5	80	0.0625000
NODE_5052_length_1098_cov_15.455455	545	625	12	25	80	0.3125000
NODE_5052_length_1098_cov_15.455455	545	625	13	14	80	0.1750000
NODE_5052_length_1098_cov_15.455455	545	625	14	36	80	0.4500000
NODE_5052_length_1098_cov_15.455455	598	678	0	9	80	0.1125000
NODE_5052_length_1098_cov_15.455455	598	678	11	1	80	0.0125000
NODE_5052_length_1098_cov_15.455455	598	678	12	68	80	0.8500000
NODE_5052_length_1098_cov_15.455455	598	678	14	2	80	0.0250000
NODE_5052_length_1098_cov_15.455455	674	754	0	80	80	1.0000000
NODE_5052_length_1098_cov_15.455455	727	807	0	80	80	1.0000000
NODE_5054_length_1097_cov_37.103206	438	518	6	1	80	0.0125000
NODE_5054_length_1097_cov_37.103206	438	518	9	1	80	0.0125000
NODE_5054_length_1097_cov_37.103206	438	518	12	19	80	0.2375000
NODE_5054_length_1097_cov_37.103206	438	518	14	32	80	0.4000000
NODE_5054_length_1097_cov_37.103206	438	518	16	25	80	0.3125000
NODE_5054_length_1097_cov_37.103206	438	518	18	2	80	0.0250000
NODE_5054_length_1097_cov_37.103206	491	571	0	17	80	0.2125000
NODE_5054_length_1097_cov_37.103206	491	571	2	23	80	0.2875000
NODE_5054_length_1097_cov_37.103206	491	571	6	14	80	0.1750000
NODE_5054_length_1097_cov_37.103206	491	571	9	1	80	0.0125000
NODE_5054_length_1097_cov_37.103206	491	571	14	25	80	0.3125000
NODE_5054_length_1097_cov_37.103206	567	647	0	32	80	0.4000000
NODE_5054_length_1097_cov_37.103206	567	647	2	33	80	0.4125000
NODE_5054_length_1097_cov_37.103206	567	647	4	15	80	0.1875000
NODE_5054_length_1097_cov_37.103206	620	700	2	12	80	0.1500000
NODE_5054_length_1097_cov_37.103206	620	700	4	36	80	0.4500000
NODE_5054_length_1097_cov_37.103206	620	700	6	8	80	0.1000000
NODE_5054_length_1097_cov_37.103206	620	700	8	24	80	0.3000000
NODE_5055_length_1097_cov_32.624248	501	581	0	80	80	1.0000000
NODE_5055_length_1097_cov_32.624248	554	634	0	80	80	1.0000000
NODE_5056_length_1097_cov_25.240481	401	480	0	14	79	0.1772152
NODE_5056_length_1097_cov_25.240481	401	480	2	65	79	0.8227848
NODE_5056_length_1097_cov_25.240481	453	533	0	41	80	0.5125000
NODE_5056_length_1097_cov_25.240481	453	533	2	39	80	0.4875000
NODE_5056_length_1097_cov_25.240481	529	609	0	60	80	0.7500000
NODE_5056_length_1097_cov_25.240481	529	609	3	11	80	0.1375000
NODE_5056_length_1097_cov_25.240481	529	609	4	9	80	0.1125000
NODE_5056_length_1097_cov_25.240481	582	662	0	7	80	0.0875000
NODE_5056_length_1097_cov_25.240481	582	662	3	11	80	0.1375000
NODE_5056_length_1097_cov_25.240481	582	662	4	62	80	0.7750000
NODE_5057_length_1097_cov_21.221443	484	564	0	80	80	1.0000000
NODE_5057_length_1097_cov_21.221443	537	617	0	80	80	1.0000000
NODE_5057_length_1097_cov_21.221443	613	693	0	34	80	0.4250000
NODE_5057_length_1097_cov_21.221443	613	693	2	46	80	0.5750000
NODE_5057_length_1097_cov_21.221443	666	746	0	54	80	0.6750000
NODE_5057_length_1097_cov_21.221443	666	746	2	26	80	0.3250000
NODE_5058_length_1097_cov_20.968938	515	595	0	80	80	1.0000000
NODE_5058_length_1097_cov_20.968938	568	648	0	80	80	1.0000000
NODE_5059_length_1097_cov_13.136273	697	779	0	22	82	0.2682927
NODE_5059_length_1097_cov_13.136273	697	779	2	60	82	0.7317073
NODE_5059_length_1097_cov_13.136273	752	832	0	49	80	0.6125000
NODE_5059_length_1097_cov_13.136273	752	832	2	31	80	0.3875000
NODE_5060_length_1097_cov_6.376754	442	522	2	50	80	0.6250000
NODE_5060_length_1097_cov_6.376754	442	522	4	30	80	0.3750000
NODE_5060_length_1097_cov_6.376754	495	575	4	80	80	1.0000000
NODE_5061_length_1097_cov_6.068136	299	379	0	80	80	1.0000000
NODE_5061_length_1097_cov_6.068136	352	432	0	80	80	1.0000000
NODE_5072_length_1096_cov_55.816449	430	510	0	44	80	0.5500000
NODE_5072_length_1096_cov_55.816449	430	510	4	8	80	0.1000000
NODE_5072_length_1096_cov_55.816449	430	510	6	28	80	0.3500000
NODE_5072_length_1096_cov_55.816449	483	563	6	62	80	0.7750000
NODE_5072_length_1096_cov_55.816449	483	563	10	8	80	0.1000000
NODE_5072_length_1096_cov_55.816449	483	563	14	10	80	0.1250000
NODE_5072_length_1096_cov_55.816449	559	639	8	4	80	0.0500000
NODE_5072_length_1096_cov_55.816449	559	639	10	26	80	0.3250000
NODE_5072_length_1096_cov_55.816449	559	639	16	50	80	0.6250000
NODE_5072_length_1096_cov_55.816449	612	692	0	4	80	0.0500000
NODE_5072_length_1096_cov_55.816449	612	692	8	30	80	0.3750000
NODE_5072_length_1096_cov_55.816449	612	692	15	1	80	0.0125000
NODE_5072_length_1096_cov_55.816449	612	692	16	45	80	0.5625000
NODE_5073_length_1096_cov_24.672016	431	511	0	80	80	1.0000000
NODE_5073_length_1096_cov_24.672016	484	564	0	80	80	1.0000000
NODE_5073_length_1096_cov_24.672016	560	640	0	19	80	0.2375000
NODE_5073_length_1096_cov_24.672016	560	640	2	61	80	0.7625000
NODE_5073_length_1096_cov_24.672016	613	693	0	33	80	0.4125000
NODE_5073_length_1096_cov_24.672016	613	693	2	40	80	0.5000000
NODE_5073_length_1096_cov_24.672016	613	693	4	7	80	0.0875000
NODE_5074_length_1096_cov_22.980943	372	452	6	45	80	0.5625000
NODE_5074_length_1096_cov_22.980943	372	452	8	35	80	0.4375000
NODE_5074_length_1096_cov_22.980943	425	505	0	4	80	0.0500000
NODE_5074_length_1096_cov_22.980943	425	505	2	34	80	0.4250000
NODE_5074_length_1096_cov_22.980943	425	505	6	30	80	0.3750000
NODE_5074_length_1096_cov_22.980943	425	505	8	12	80	0.1500000
NODE_5075_length_1096_cov_16.649950	486	566	2	8	80	0.1000000
NODE_5075_length_1096_cov_16.649950	486	566	4	14	80	0.1750000
NODE_5075_length_1096_cov_16.649950	486	566	6	58	80	0.7250000
NODE_5075_length_1096_cov_16.649950	539	619	2	41	80	0.5125000
NODE_5075_length_1096_cov_16.649950	539	619	4	14	80	0.1750000
NODE_5075_length_1096_cov_16.649950	539	619	6	25	80	0.3125000
NODE_5076_length_1096_cov_16.433300	443	523	2	2	80	0.0250000
NODE_5076_length_1096_cov_16.433300	443	523	7	20	80	0.2500000
NODE_5076_length_1096_cov_16.433300	443	523	8	10	80	0.1250000
NODE_5076_length_1096_cov_16.433300	443	523	9	48	80	0.6000000
NODE_5076_length_1096_cov_16.433300	496	576	4	24	80	0.3000000
NODE_5076_length_1096_cov_16.433300	496	576	8	15	80	0.1875000
NODE_5076_length_1096_cov_16.433300	496	576	9	41	80	0.5125000
NODE_5076_length_1096_cov_16.433300	886	966	4	80	80	1.0000000
NODE_5076_length_1096_cov_16.433300	939	1018	0	31	79	0.3924051
NODE_5076_length_1096_cov_16.433300	939	1018	2	18	79	0.2278481
NODE_5076_length_1096_cov_16.433300	939	1018	4	30	79	0.3797468
NODE_5077_length_1096_cov_13.398195	670	750	2	80	80	1.0000000
NODE_5077_length_1096_cov_13.398195	723	803	0	37	80	0.4625000
NODE_5077_length_1096_cov_13.398195	723	803	2	43	80	0.5375000
NODE_5080_length_1095_cov_25.390562	520	600	0	7	80	0.0875000
NODE_5080_length_1095_cov_25.390562	520	600	2	73	80	0.9125000
NODE_5080_length_1095_cov_25.390562	573	653	0	42	80	0.5250000
NODE_5080_length_1095_cov_25.390562	573	653	2	38	80	0.4750000
NODE_5080_length_1095_cov_25.390562	649	729	0	66	80	0.8250000
NODE_5080_length_1095_cov_25.390562	649	729	2	14	80	0.1750000
NODE_5080_length_1095_cov_25.390562	702	782	0	13	80	0.1625000
NODE_5080_length_1095_cov_25.390562	702	782	2	67	80	0.8375000
NODE_5081_length_1095_cov_13.832329	549	629	0	45	80	0.5625000
NODE_5081_length_1095_cov_13.832329	549	629	2	24	80	0.3000000
NODE_5081_length_1095_cov_13.832329	549	629	4	11	80	0.1375000
NODE_5081_length_1095_cov_13.832329	602	682	0	9	80	0.1125000
NODE_5081_length_1095_cov_13.832329	602	682	2	7	80	0.0875000
NODE_5081_length_1095_cov_13.832329	602	682	4	64	80	0.8000000
NODE_5082_length_1095_cov_13.017068	497	577	2	66	80	0.8250000
NODE_5082_length_1095_cov_13.017068	497	577	4	14	80	0.1750000
NODE_5082_length_1095_cov_13.017068	550	630	0	31	80	0.3875000
NODE_5082_length_1095_cov_13.017068	550	630	2	49	80	0.6125000
NODE_5083_length_1095_cov_7.640562	627	707	0	47	80	0.5875000
NODE_5083_length_1095_cov_7.640562	627	707	2	33	80	0.4125000
NODE_5083_length_1095_cov_7.640562	680	760	0	15	80	0.1875000
NODE_5083_length_1095_cov_7.640562	680	760	2	65	80	0.8125000
NODE_5085_length_1095_cov_4.664659	307	387	4	80	80	1.0000000
NODE_5089_length_1094_cov_35.850251	409	489	0	80	80	1.0000000
NODE_5089_length_1094_cov_35.850251	462	542	0	80	80	1.0000000
NODE_5089_length_1094_cov_35.850251	538	618	0	80	80	1.0000000
NODE_5089_length_1094_cov_35.850251	591	671	0	39	80	0.4875000
NODE_5089_length_1094_cov_35.850251	591	671	2	3	80	0.0375000
NODE_5089_length_1094_cov_35.850251	591	671	4	38	80	0.4750000
NODE_5090_length_1094_cov_27.197990	462	542	0	58	80	0.7250000
NODE_5090_length_1094_cov_27.197990	462	542	2	22	80	0.2750000
NODE_5090_length_1094_cov_27.197990	515	595	0	29	80	0.3625000
NODE_5090_length_1094_cov_27.197990	515	595	2	51	80	0.6375000
NODE_5091_length_1094_cov_19.282412	451	531	0	6	80	0.0750000
NODE_5091_length_1094_cov_19.282412	451	531	2	16	80	0.2000000
NODE_5091_length_1094_cov_19.282412	451	531	4	52	80	0.6500000
NODE_5091_length_1094_cov_19.282412	451	531	6	6	80	0.0750000
NODE_5091_length_1094_cov_19.282412	504	584	2	26	80	0.3250000
NODE_5091_length_1094_cov_19.282412	504	584	4	24	80	0.3000000
NODE_5091_length_1094_cov_19.282412	504	584	6	30	80	0.3750000
NODE_5092_length_1094_cov_16.084422	558	614	3	31	56	0.5535714
NODE_5092_length_1094_cov_16.084422	558	614	5	25	56	0.4464286
NODE_5092_length_1094_cov_16.084422	587	667	1	8	80	0.1000000
NODE_5092_length_1094_cov_16.084422	587	667	3	52	80	0.6500000
NODE_5092_length_1094_cov_16.084422	587	667	5	20	80	0.2500000
NODE_5093_length_1094_cov_11.335678	384	464	2	13	80	0.1625000
NODE_5093_length_1094_cov_11.335678	384	464	4	67	80	0.8375000
NODE_5093_length_1094_cov_11.335678	437	517	0	39	80	0.4875000
NODE_5093_length_1094_cov_11.335678	437	517	2	13	80	0.1625000
NODE_5093_length_1094_cov_11.335678	437	517	4	28	80	0.3500000
NODE_5094_length_1094_cov_10.767839	396	476	2	39	80	0.4875000
NODE_5094_length_1094_cov_10.767839	396	476	4	41	80	0.5125000
NODE_5094_length_1094_cov_10.767839	449	529	2	73	80	0.9125000
NODE_5094_length_1094_cov_10.767839	449	529	4	7	80	0.0875000
NODE_5095_length_1094_cov_9.527638	579	659	10	40	80	0.5000000
NODE_5095_length_1094_cov_9.527638	579	659	14	34	80	0.4250000
NODE_5095_length_1094_cov_9.527638	579	659	16	6	80	0.0750000
NODE_5095_length_1094_cov_9.527638	632	712	4	6	80	0.0750000
NODE_5095_length_1094_cov_9.527638	632	712	12	20	80	0.2500000
NODE_5095_length_1094_cov_9.527638	632	712	14	54	80	0.6750000
NODE_5096_length_1094_cov_9.166834	527	607	1	80	80	1.0000000
NODE_5096_length_1094_cov_9.166834	580	660	1	57	80	0.7125000
NODE_5096_length_1094_cov_9.166834	580	660	2	23	80	0.2875000
NODE_5097_length_1094_cov_5.632161	708	768	0	32	60	0.5333334
NODE_5097_length_1094_cov_5.632161	708	768	2	28	60	0.4666667
NODE_5097_length_1094_cov_5.632161	761	821	2	38	60	0.6333333
NODE_5097_length_1094_cov_5.632161	761	821	4	22	60	0.3666667
NODE_5108_length_1093_cov_28.531187	374	454	6	14	80	0.1750000
NODE_5108_length_1093_cov_28.531187	374	454	8	4	80	0.0500000
NODE_5108_length_1093_cov_28.531187	374	454	10	46	80	0.5750000
NODE_5108_length_1093_cov_28.531187	374	454	12	16	80	0.2000000
NODE_5108_length_1093_cov_28.531187	427	507	0	29	80	0.3625000
NODE_5108_length_1093_cov_28.531187	427	507	2	14	80	0.1750000
NODE_5108_length_1093_cov_28.531187	427	507	6	24	80	0.3000000
NODE_5108_length_1093_cov_28.531187	427	507	8	4	80	0.0500000
NODE_5108_length_1093_cov_28.531187	427	507	10	8	80	0.1000000
NODE_5108_length_1093_cov_28.531187	427	507	12	1	80	0.0125000
NODE_5109_length_1093_cov_22.744467	516	596	0	80	80	1.0000000
NODE_5109_length_1093_cov_22.744467	569	649	0	80	80	1.0000000
NODE_5109_length_1093_cov_22.744467	645	725	0	70	80	0.8750000
NODE_5109_length_1093_cov_22.744467	645	725	2	10	80	0.1250000
NODE_5109_length_1093_cov_22.744467	698	778	0	17	80	0.2125000
NODE_5109_length_1093_cov_22.744467	698	778	2	63	80	0.7875000
NODE_5110_length_1093_cov_11.637827	282	362	0	16	80	0.2000000
NODE_5110_length_1093_cov_11.637827	282	362	3	64	80	0.8000000
NODE_5110_length_1093_cov_11.637827	335	415	0	69	80	0.8625000
NODE_5110_length_1093_cov_11.637827	335	415	3	11	80	0.1375000
NODE_5111_length_1093_cov_9.047284	660	740	0	27	80	0.3375000
NODE_5111_length_1093_cov_9.047284	660	740	4	53	80	0.6625000
NODE_5111_length_1093_cov_9.047284	713	793	0	24	80	0.3000000
NODE_5111_length_1093_cov_9.047284	713	793	4	56	80	0.7000000
NODE_5112_length_1093_cov_6.857143	658	738	0	40	80	0.5000000
NODE_5112_length_1093_cov_6.857143	658	738	2	16	80	0.2000000
NODE_5112_length_1093_cov_6.857143	658	738	5	24	80	0.3000000
NODE_5112_length_1093_cov_6.857143	711	791	2	8	80	0.1000000
NODE_5112_length_1093_cov_6.857143	711	791	3	3	80	0.0375000
NODE_5112_length_1093_cov_6.857143	711	791	4	11	80	0.1375000
NODE_5112_length_1093_cov_6.857143	711	791	5	58	80	0.7250000
NODE_5113_length_1093_cov_5.311871	587	667	0	10	80	0.1250000
NODE_5113_length_1093_cov_5.311871	587	667	2	70	80	0.8750000
NODE_5113_length_1093_cov_5.311871	640	720	2	80	80	1.0000000
NODE_5118_length_1092_cov_105.542800	682	768	99	2	86	0.0232558
NODE_5118_length_1092_cov_105.542800	682	768	101	2	86	0.0232558
NODE_5118_length_1092_cov_105.542800	682	768	105	1	86	0.0116279
NODE_5118_length_1092_cov_105.542800	682	768	111	1	86	0.0116279
NODE_5118_length_1092_cov_105.542800	682	768	126	2	86	0.0232558
NODE_5118_length_1092_cov_105.542800	682	768	134	1	86	0.0116279
NODE_5118_length_1092_cov_105.542800	682	768	135	1	86	0.0116279
NODE_5118_length_1092_cov_105.542800	682	768	150	1	86	0.0116279
NODE_5118_length_1092_cov_105.542800	682	768	159	2	86	0.0232558
NODE_5118_length_1092_cov_105.542800	682	768	172	1	86	0.0116279
NODE_5118_length_1092_cov_105.542800	682	768	174	1	86	0.0116279
NODE_5118_length_1092_cov_105.542800	682	768	201	1	86	0.0116279
NODE_5118_length_1092_cov_105.542800	682	768	215	1	86	0.0116279
NODE_5118_length_1092_cov_105.542800	682	768	231	1	86	0.0116279
NODE_5118_length_1092_cov_105.542800	682	768	239	2	86	0.0232558
NODE_5118_length_1092_cov_105.542800	682	768	242	1	86	0.0116279
NODE_5118_length_1092_cov_105.542800	682	768	247	2	86	0.0232558
NODE_5118_length_1092_cov_105.542800	682	768	253	1	86	0.0116279
NODE_5118_length_1092_cov_105.542800	682	768	254	1	86	0.0116279
NODE_5118_length_1092_cov_105.542800	682	768	255	1	86	0.0116279
NODE_5118_length_1092_cov_105.542800	682	768	269	1	86	0.0116279
NODE_5118_length_1092_cov_105.542800	682	768	283	1	86	0.0116279
NODE_5118_length_1092_cov_105.542800	682	768	298	1	86	0.0116279
NODE_5118_length_1092_cov_105.542800	682	768	317	2	86	0.0232558
NODE_5118_length_1092_cov_105.542800	682	768	321	3	86	0.0348837
NODE_5118_length_1092_cov_105.542800	682	768	331	1	86	0.0116279
NODE_5118_length_1092_cov_105.542800	682	768	333	2	86	0.0232558
NODE_5118_length_1092_cov_105.542800	682	768	334	1	86	0.0116279
NODE_5118_length_1092_cov_105.542800	682	768	335	1	86	0.0116279
NODE_5118_length_1092_cov_105.542800	682	768	337	1	86	0.0116279
NODE_5118_length_1092_cov_105.542800	682	768	349	1	86	0.0116279
NODE_5118_length_1092_cov_105.542800	682	768	353	2	86	0.0232558
NODE_5118_length_1092_cov_105.542800	682	768	367	1	86	0.0116279
NODE_5118_length_1092_cov_105.542800	682	768	369	1	86	0.0116279
NODE_5118_length_1092_cov_105.542800	682	768	372	1	86	0.0116279
NODE_5118_length_1092_cov_105.542800	682	768	373	1	86	0.0116279
NODE_5118_length_1092_cov_105.542800	682	768	379	1	86	0.0116279
NODE_5118_length_1092_cov_105.542800	682	768	381	1	86	0.0116279
NODE_5118_length_1092_cov_105.542800	682	768	402	1	86	0.0116279
NODE_5118_length_1092_cov_105.542800	682	768	420	1	86	0.0116279
NODE_5118_length_1092_cov_105.542800	682	768	423	1	86	0.0116279
NODE_5118_length_1092_cov_105.542800	682	768	429	1	86	0.0116279
NODE_5118_length_1092_cov_105.542800	682	768	430	1	86	0.0116279
NODE_5118_length_1092_cov_105.542800	682	768	441	1	86	0.0116279
NODE_5118_length_1092_cov_105.542800	682	768	442	3	86	0.0348837
NODE_5118_length_1092_cov_105.542800	682	768	443	1	86	0.0116279
NODE_5118_length_1092_cov_105.542800	682	768	444	1	86	0.0116279
NODE_5118_length_1092_cov_105.542800	682	768	446	2	86	0.0232558
NODE_5118_length_1092_cov_105.542800	682	768	447	1	86	0.0116279
NODE_5118_length_1092_cov_105.542800	682	768	448	7	86	0.0813954
NODE_5118_length_1092_cov_105.542800	682	768	449	2	86	0.0232558
NODE_5118_length_1092_cov_105.542800	682	768	450	1	86	0.0116279
NODE_5118_length_1092_cov_105.542800	682	768	451	1	86	0.0116279
NODE_5118_length_1092_cov_105.542800	682	768	454	1	86	0.0116279
NODE_5118_length_1092_cov_105.542800	682	768	455	1	86	0.0116279
NODE_5118_length_1092_cov_105.542800	682	768	456	1	86	0.0116279
NODE_5118_length_1092_cov_105.542800	682	768	458	2	86	0.0232558
NODE_5118_length_1092_cov_105.542800	682	768	459	3	86	0.0348837
NODE_5118_length_1092_cov_105.542800	682	768	460	4	86	0.0465116
NODE_5118_length_1092_cov_105.542800	745	807	315	1	62	0.0161290
NODE_5118_length_1092_cov_105.542800	745	807	317	1	62	0.0161290
NODE_5118_length_1092_cov_105.542800	745	807	318	1	62	0.0161290
NODE_5118_length_1092_cov_105.542800	745	807	324	1	62	0.0161290
NODE_5118_length_1092_cov_105.542800	745	807	327	2	62	0.0322581
NODE_5118_length_1092_cov_105.542800	745	807	347	1	62	0.0161290
NODE_5118_length_1092_cov_105.542800	745	807	349	1	62	0.0161290
NODE_5118_length_1092_cov_105.542800	745	807	350	2	62	0.0322581
NODE_5118_length_1092_cov_105.542800	745	807	361	1	62	0.0161290
NODE_5118_length_1092_cov_105.542800	745	807	362	2	62	0.0322581
NODE_5118_length_1092_cov_105.542800	745	807	365	1	62	0.0161290
NODE_5118_length_1092_cov_105.542800	745	807	368	2	62	0.0322581
NODE_5118_length_1092_cov_105.542800	745	807	370	1	62	0.0161290
NODE_5118_length_1092_cov_105.542800	745	807	371	2	62	0.0322581
NODE_5118_length_1092_cov_105.542800	745	807	372	1	62	0.0161290
NODE_5118_length_1092_cov_105.542800	745	807	374	1	62	0.0161290
NODE_5118_length_1092_cov_105.542800	745	807	376	2	62	0.0322581
NODE_5118_length_1092_cov_105.542800	745	807	378	1	62	0.0161290
NODE_5118_length_1092_cov_105.542800	745	807	396	1	62	0.0161290
NODE_5118_length_1092_cov_105.542800	745	807	397	2	62	0.0322581
NODE_5118_length_1092_cov_105.542800	745	807	408	2	62	0.0322581
NODE_5118_length_1092_cov_105.542800	745	807	415	1	62	0.0161290
NODE_5118_length_1092_cov_105.542800	745	807	431	4	62	0.0645161
NODE_5118_length_1092_cov_105.542800	745	807	432	1	62	0.0161290
NODE_5118_length_1092_cov_105.542800	745	807	434	2	62	0.0322581
NODE_5118_length_1092_cov_105.542800	745	807	438	2	62	0.0322581
NODE_5118_length_1092_cov_105.542800	745	807	441	1	62	0.0161290
NODE_5118_length_1092_cov_105.542800	745	807	442	3	62	0.0483871
NODE_5118_length_1092_cov_105.542800	745	807	443	1	62	0.0161290
NODE_5118_length_1092_cov_105.542800	745	807	446	2	62	0.0322581
NODE_5118_length_1092_cov_105.542800	745	807	448	7	62	0.1129032
NODE_5118_length_1092_cov_105.542800	745	807	455	1	62	0.0161290
NODE_5118_length_1092_cov_105.542800	745	807	456	1	62	0.0161290
NODE_5118_length_1092_cov_105.542800	745	807	458	2	62	0.0322581
NODE_5118_length_1092_cov_105.542800	745	807	459	3	62	0.0483871
NODE_5118_length_1092_cov_105.542800	745	807	460	2	62	0.0322581
NODE_5119_length_1092_cov_30.957704	610	690	0	80	80	1.0000000
NODE_5119_length_1092_cov_30.957704	663	743	0	80	80	1.0000000
NODE_5121_length_1092_cov_16.737160	725	805	0	36	80	0.4500000
NODE_5121_length_1092_cov_16.737160	725	805	2	44	80	0.5500000
NODE_5121_length_1092_cov_16.737160	778	858	0	80	80	1.0000000
NODE_5123_length_1092_cov_11.193353	335	415	0	67	80	0.8375000
NODE_5123_length_1092_cov_11.193353	335	415	2	13	80	0.1625000
NODE_5123_length_1092_cov_11.193353	388	468	0	14	80	0.1750000
NODE_5123_length_1092_cov_11.193353	388	468	2	30	80	0.3750000
NODE_5123_length_1092_cov_11.193353	388	468	4	20	80	0.2500000
NODE_5123_length_1092_cov_11.193353	388	468	6	16	80	0.2000000
NODE_5124_length_1092_cov_9.348439	489	569	0	80	80	1.0000000
NODE_5124_length_1092_cov_9.348439	542	622	0	28	80	0.3500000
NODE_5124_length_1092_cov_9.348439	542	622	2	52	80	0.6500000
NODE_5125_length_1092_cov_7.533736	243	323	0	1	80	0.0125000
NODE_5125_length_1092_cov_7.533736	243	323	2	79	80	0.9875000
NODE_5125_length_1092_cov_7.533736	296	376	0	44	80	0.5500000
NODE_5125_length_1092_cov_7.533736	296	376	2	36	80	0.4500000
NODE_5126_length_1092_cov_6.968781	470	550	0	80	80	1.0000000
NODE_5126_length_1092_cov_6.968781	523	603	0	80	80	1.0000000
NODE_5134_length_1091_cov_54.234879	417	497	8	5	80	0.0625000
NODE_5134_length_1091_cov_54.234879	417	497	12	25	80	0.3125000
NODE_5134_length_1091_cov_54.234879	417	497	14	16	80	0.2000000
NODE_5134_length_1091_cov_54.234879	417	497	16	4	80	0.0500000
NODE_5134_length_1091_cov_54.234879	417	497	18	30	80	0.3750000
NODE_5134_length_1091_cov_54.234879	470	550	0	6	80	0.0750000
NODE_5134_length_1091_cov_54.234879	470	550	4	13	80	0.1625000
NODE_5134_length_1091_cov_54.234879	470	550	6	6	80	0.0750000
NODE_5134_length_1091_cov_54.234879	470	550	8	12	80	0.1500000
NODE_5134_length_1091_cov_54.234879	470	550	12	9	80	0.1125000
NODE_5134_length_1091_cov_54.234879	470	550	14	20	80	0.2500000
NODE_5134_length_1091_cov_54.234879	470	550	18	14	80	0.1750000
NODE_5134_length_1091_cov_54.234879	546	626	0	44	80	0.5500000
NODE_5134_length_1091_cov_54.234879	546	626	4	3	80	0.0375000
NODE_5134_length_1091_cov_54.234879	546	626	12	33	80	0.4125000
NODE_5134_length_1091_cov_54.234879	599	679	0	10	80	0.1250000
NODE_5134_length_1091_cov_54.234879	599	679	7	16	80	0.2000000
NODE_5134_length_1091_cov_54.234879	599	679	11	13	80	0.1625000
NODE_5134_length_1091_cov_54.234879	599	679	12	41	80	0.5125000
NODE_5135_length_1091_cov_35.045363	384	464	0	80	80	1.0000000
NODE_5135_length_1091_cov_35.045363	437	517	0	60	80	0.7500000
NODE_5135_length_1091_cov_35.045363	437	517	2	20	80	0.2500000
NODE_5135_length_1091_cov_35.045363	513	593	2	27	80	0.3375000
NODE_5135_length_1091_cov_35.045363	513	593	4	34	80	0.4250000
NODE_5135_length_1091_cov_35.045363	513	593	6	19	80	0.2375000
NODE_5135_length_1091_cov_35.045363	566	646	0	11	80	0.1375000
NODE_5135_length_1091_cov_35.045363	566	646	2	20	80	0.2500000
NODE_5135_length_1091_cov_35.045363	566	646	4	31	80	0.3875000
NODE_5135_length_1091_cov_35.045363	566	646	6	18	80	0.2250000
NODE_5136_length_1091_cov_28.490927	329	409	0	34	80	0.4250000
NODE_5136_length_1091_cov_28.490927	329	409	2	46	80	0.5750000
NODE_5136_length_1091_cov_28.490927	382	462	0	7	80	0.0875000
NODE_5136_length_1091_cov_28.490927	382	462	2	73	80	0.9125000
NODE_5136_length_1091_cov_28.490927	618	698	0	38	80	0.4750000
NODE_5136_length_1091_cov_28.490927	618	698	2	42	80	0.5250000
NODE_5136_length_1091_cov_28.490927	671	751	0	80	80	1.0000000
NODE_5137_length_1091_cov_23.733871	514	594	0	23	80	0.2875000
NODE_5137_length_1091_cov_23.733871	514	594	1	9	80	0.1125000
NODE_5137_length_1091_cov_23.733871	514	594	3	5	80	0.0625000
NODE_5137_length_1091_cov_23.733871	514	594	5	2	80	0.0250000
NODE_5137_length_1091_cov_23.733871	514	594	6	41	80	0.5125000
NODE_5137_length_1091_cov_23.733871	567	647	4	32	80	0.4000000
NODE_5137_length_1091_cov_23.733871	567	647	6	48	80	0.6000000
NODE_5138_length_1091_cov_13.065524	444	524	15	23	80	0.2875000
NODE_5138_length_1091_cov_13.065524	444	524	16	57	80	0.7125000
NODE_5138_length_1091_cov_13.065524	497	577	0	10	80	0.1250000
NODE_5138_length_1091_cov_13.065524	497	577	6	2	80	0.0250000
NODE_5138_length_1091_cov_13.065524	497	577	7	4	80	0.0500000
NODE_5138_length_1091_cov_13.065524	497	577	8	3	80	0.0375000
NODE_5138_length_1091_cov_13.065524	497	577	16	61	80	0.7625000
NODE_5139_length_1091_cov_10.961694	582	646	1	22	64	0.3437500
NODE_5139_length_1091_cov_10.961694	582	646	3	42	64	0.6562500
NODE_5140_length_1091_cov_8.166331	299	379	0	43	80	0.5375000
NODE_5140_length_1091_cov_8.166331	299	379	4	37	80	0.4625000
NODE_5140_length_1091_cov_8.166331	352	432	4	80	80	1.0000000
NODE_5141_length_1091_cov_7.006048	617	697	0	5	80	0.0625000
NODE_5141_length_1091_cov_7.006048	617	697	4	75	80	0.9375000
NODE_5141_length_1091_cov_7.006048	670	750	2	9	80	0.1125000
NODE_5141_length_1091_cov_7.006048	670	750	4	63	80	0.7875000
NODE_5141_length_1091_cov_7.006048	670	750	6	8	80	0.1000000
NODE_5151_length_1090_cov_73.781029	352	432	0	15	80	0.1875000
NODE_5151_length_1090_cov_73.781029	352	432	2	65	80	0.8125000
NODE_5151_length_1090_cov_73.781029	405	485	2	67	80	0.8375000
NODE_5151_length_1090_cov_73.781029	405	485	4	13	80	0.1625000
NODE_5151_length_1090_cov_73.781029	481	567	0	27	86	0.3139535
NODE_5151_length_1090_cov_73.781029	481	567	2	44	86	0.5116279
NODE_5151_length_1090_cov_73.781029	481	567	4	15	86	0.1744186
NODE_5151_length_1090_cov_73.781029	540	620	0	12	80	0.1500000
NODE_5151_length_1090_cov_73.781029	540	620	4	68	80	0.8500000
NODE_5152_length_1090_cov_42.394551	530	610	0	5	80	0.0625000
NODE_5152_length_1090_cov_42.394551	530	610	2	18	80	0.2250000
NODE_5152_length_1090_cov_42.394551	530	610	49	3	80	0.0375000
NODE_5152_length_1090_cov_42.394551	530	610	50	9	80	0.1125000
NODE_5152_length_1090_cov_42.394551	530	610	51	1	80	0.0125000
NODE_5152_length_1090_cov_42.394551	530	610	52	5	80	0.0625000
NODE_5152_length_1090_cov_42.394551	530	610	53	11	80	0.1375000
NODE_5152_length_1090_cov_42.394551	530	610	54	1	80	0.0125000
NODE_5152_length_1090_cov_42.394551	530	610	55	7	80	0.0875000
NODE_5152_length_1090_cov_42.394551	530	610	61	1	80	0.0125000
NODE_5152_length_1090_cov_42.394551	530	610	63	2	80	0.0250000
NODE_5152_length_1090_cov_42.394551	530	610	65	1	80	0.0125000
NODE_5152_length_1090_cov_42.394551	530	610	67	1	80	0.0125000
NODE_5152_length_1090_cov_42.394551	530	610	69	1	80	0.0125000
NODE_5152_length_1090_cov_42.394551	530	610	72	14	80	0.1750000
NODE_5152_length_1090_cov_42.394551	583	663	0	2	80	0.0250000
NODE_5152_length_1090_cov_42.394551	583	663	55	7	80	0.0875000
NODE_5152_length_1090_cov_42.394551	583	663	61	1	80	0.0125000
NODE_5152_length_1090_cov_42.394551	583	663	63	2	80	0.0250000
NODE_5152_length_1090_cov_42.394551	583	663	65	1	80	0.0125000
NODE_5152_length_1090_cov_42.394551	583	663	67	1	80	0.0125000
NODE_5152_length_1090_cov_42.394551	583	663	69	1	80	0.0125000
NODE_5152_length_1090_cov_42.394551	583	663	70	51	80	0.6375000
NODE_5152_length_1090_cov_42.394551	583	663	72	14	80	0.1750000
NODE_5153_length_1090_cov_37.643794	436	516	0	80	80	1.0000000
NODE_5153_length_1090_cov_37.643794	489	569	0	70	80	0.8750000
NODE_5153_length_1090_cov_37.643794	489	569	2	10	80	0.1250000
NODE_5153_length_1090_cov_37.643794	565	645	2	10	80	0.1250000
NODE_5153_length_1090_cov_37.643794	565	645	6	42	80	0.5250000
NODE_5153_length_1090_cov_37.643794	565	645	14	10	80	0.1250000
NODE_5153_length_1090_cov_37.643794	565	645	16	18	80	0.2250000
NODE_5153_length_1090_cov_37.643794	618	698	10	48	80	0.6000000
NODE_5153_length_1090_cov_37.643794	618	698	14	15	80	0.1875000
NODE_5153_length_1090_cov_37.643794	618	698	16	17	80	0.2125000
NODE_5154_length_1090_cov_32.876892	487	567	6	18	80	0.2250000
NODE_5154_length_1090_cov_32.876892	487	567	8	14	80	0.1750000
NODE_5154_length_1090_cov_32.876892	487	567	10	23	80	0.2875000
NODE_5154_length_1090_cov_32.876892	487	567	12	25	80	0.3125000
NODE_5154_length_1090_cov_32.876892	540	620	0	11	80	0.1375000
NODE_5154_length_1090_cov_32.876892	540	620	2	14	80	0.1750000
NODE_5154_length_1090_cov_32.876892	540	620	4	6	80	0.0750000
NODE_5154_length_1090_cov_32.876892	540	620	8	36	80	0.4500000
NODE_5154_length_1090_cov_32.876892	540	620	12	13	80	0.1625000
NODE_5155_length_1090_cov_25.373360	486	566	0	8	80	0.1000000
NODE_5155_length_1090_cov_25.373360	486	566	2	72	80	0.9000000
NODE_5155_length_1090_cov_25.373360	539	619	0	55	80	0.6875000
NODE_5155_length_1090_cov_25.373360	539	619	2	25	80	0.3125000
NODE_5156_length_1090_cov_21.290616	422	502	4	80	80	1.0000000
NODE_5156_length_1090_cov_21.290616	475	555	0	40	80	0.5000000
NODE_5156_length_1090_cov_21.290616	475	555	4	40	80	0.5000000
NODE_5156_length_1090_cov_21.290616	551	631	0	80	80	1.0000000
NODE_5156_length_1090_cov_21.290616	604	684	0	80	80	1.0000000
NODE_5157_length_1090_cov_16.040363	666	746	0	16	80	0.2000000
NODE_5157_length_1090_cov_16.040363	666	746	4	9	80	0.1125000
NODE_5157_length_1090_cov_16.040363	666	746	12	55	80	0.6875000
NODE_5157_length_1090_cov_16.040363	719	799	0	8	80	0.1000000
NODE_5157_length_1090_cov_16.040363	719	799	8	40	80	0.5000000
NODE_5157_length_1090_cov_16.040363	719	799	12	32	80	0.4000000
NODE_5158_length_1090_cov_14.826438	393	473	2	4	80	0.0500000
NODE_5158_length_1090_cov_14.826438	393	473	5	1	80	0.0125000
NODE_5158_length_1090_cov_14.826438	393	473	6	6	80	0.0750000
NODE_5158_length_1090_cov_14.826438	393	473	10	2	80	0.0250000
NODE_5158_length_1090_cov_14.826438	393	473	12	3	80	0.0375000
NODE_5158_length_1090_cov_14.826438	393	473	13	1	80	0.0125000
NODE_5158_length_1090_cov_14.826438	393	473	14	63	80	0.7875000
NODE_5158_length_1090_cov_14.826438	446	526	0	32	80	0.4000000
NODE_5158_length_1090_cov_14.826438	446	526	2	25	80	0.3125000
NODE_5158_length_1090_cov_14.826438	446	526	5	1	80	0.0125000
NODE_5158_length_1090_cov_14.826438	446	526	6	6	80	0.0750000
NODE_5158_length_1090_cov_14.826438	446	526	10	2	80	0.0250000
NODE_5158_length_1090_cov_14.826438	446	526	13	1	80	0.0125000
NODE_5158_length_1090_cov_14.826438	446	526	14	13	80	0.1625000
NODE_5159_length_1090_cov_13.721493	498	578	0	80	80	1.0000000
NODE_5159_length_1090_cov_13.721493	551	631	0	61	80	0.7625000
NODE_5159_length_1090_cov_13.721493	551	631	2	19	80	0.2375000
NODE_5160_length_1090_cov_12.365288	386	467	0	59	81	0.7283950
NODE_5160_length_1090_cov_12.365288	386	467	2	22	81	0.2716049
NODE_5160_length_1090_cov_12.365288	440	520	0	37	80	0.4625000
NODE_5160_length_1090_cov_12.365288	440	520	2	43	80	0.5375000
NODE_5160_length_1090_cov_12.365288	516	596	0	5	80	0.0625000
NODE_5160_length_1090_cov_12.365288	516	596	2	75	80	0.9375000
NODE_5160_length_1090_cov_12.365288	569	649	0	18	80	0.2250000
NODE_5160_length_1090_cov_12.365288	569	649	2	62	80	0.7750000
NODE_5161_length_1090_cov_5.348133	0	80	4	6	80	0.0750000
NODE_5161_length_1090_cov_5.348133	0	80	6	1	80	0.0125000
NODE_5161_length_1090_cov_5.348133	0	80	8	2	80	0.0250000
NODE_5161_length_1090_cov_5.348133	0	80	12	3	80	0.0375000
NODE_5161_length_1090_cov_5.348133	0	80	20	2	80	0.0250000
NODE_5161_length_1090_cov_5.348133	0	80	22	3	80	0.0375000
NODE_5161_length_1090_cov_5.348133	0	80	24	8	80	0.1000000
NODE_5161_length_1090_cov_5.348133	0	80	28	1	80	0.0125000
NODE_5161_length_1090_cov_5.348133	0	80	30	14	80	0.1750000
NODE_5161_length_1090_cov_5.348133	0	80	32	10	80	0.1250000
NODE_5161_length_1090_cov_5.348133	0	80	34	6	80	0.0750000
NODE_5161_length_1090_cov_5.348133	0	80	38	1	80	0.0125000
NODE_5161_length_1090_cov_5.348133	0	80	42	1	80	0.0125000
NODE_5161_length_1090_cov_5.348133	0	80	44	1	80	0.0125000
NODE_5161_length_1090_cov_5.348133	0	80	46	16	80	0.2000000
NODE_5161_length_1090_cov_5.348133	0	80	47	5	80	0.0625000
NODE_5161_length_1090_cov_5.348133	53	99	34	3	46	0.0652174
NODE_5161_length_1090_cov_5.348133	53	99	38	1	46	0.0217391
NODE_5161_length_1090_cov_5.348133	53	99	42	1	46	0.0217391
NODE_5161_length_1090_cov_5.348133	53	99	44	1	46	0.0217391
NODE_5161_length_1090_cov_5.348133	53	99	46	16	46	0.3478261
NODE_5161_length_1090_cov_5.348133	53	99	47	21	46	0.4565217
NODE_5161_length_1090_cov_5.348133	53	99	49	3	46	0.0652174
NODE_5163_length_1090_cov_3.598385	300	340	43	1	40	0.0250000
NODE_5163_length_1090_cov_3.598385	300	340	44	1	40	0.0250000
NODE_5163_length_1090_cov_3.598385	300	340	45	1	40	0.0250000
NODE_5163_length_1090_cov_3.598385	300	340	48	2	40	0.0500000
NODE_5163_length_1090_cov_3.598385	300	340	50	3	40	0.0750000
NODE_5163_length_1090_cov_3.598385	300	340	52	11	40	0.2750000
NODE_5163_length_1090_cov_3.598385	300	340	54	5	40	0.1250000
NODE_5163_length_1090_cov_3.598385	300	340	56	1	40	0.0250000
NODE_5163_length_1090_cov_3.598385	300	340	58	1	40	0.0250000
NODE_5163_length_1090_cov_3.598385	300	340	59	1	40	0.0250000
NODE_5163_length_1090_cov_3.598385	300	340	62	1	40	0.0250000
NODE_5163_length_1090_cov_3.598385	300	340	63	2	40	0.0500000
NODE_5163_length_1090_cov_3.598385	300	340	64	1	40	0.0250000
NODE_5163_length_1090_cov_3.598385	300	340	65	1	40	0.0250000
NODE_5163_length_1090_cov_3.598385	300	340	66	2	40	0.0500000
NODE_5163_length_1090_cov_3.598385	300	340	68	2	40	0.0500000
NODE_5163_length_1090_cov_3.598385	300	340	70	4	40	0.1000000
NODE_5170_length_1089_cov_55.374747	515	594	3	9	79	0.1139240
NODE_5170_length_1089_cov_55.374747	515	594	5	13	79	0.1645570
NODE_5170_length_1089_cov_55.374747	515	594	6	57	79	0.7215190
NODE_5170_length_1089_cov_55.374747	567	647	0	48	80	0.6000000
NODE_5170_length_1089_cov_55.374747	567	647	6	32	80	0.4000000
NODE_5170_length_1089_cov_55.374747	643	723	0	79	80	0.9875000
NODE_5170_length_1089_cov_55.374747	643	723	2	1	80	0.0125000
NODE_5170_length_1089_cov_55.374747	696	776	0	26	80	0.3250000
NODE_5170_length_1089_cov_55.374747	696	776	2	54	80	0.6750000
NODE_5171_length_1089_cov_38.506061	458	538	0	80	80	1.0000000
NODE_5171_length_1089_cov_38.506061	511	591	0	40	80	0.5000000
NODE_5171_length_1089_cov_38.506061	511	591	4	19	80	0.2375000
NODE_5171_length_1089_cov_38.506061	511	591	5	8	80	0.1000000
NODE_5171_length_1089_cov_38.506061	511	591	6	6	80	0.0750000
NODE_5171_length_1089_cov_38.506061	511	591	9	1	80	0.0125000
NODE_5171_length_1089_cov_38.506061	511	591	10	6	80	0.0750000
NODE_5171_length_1089_cov_38.506061	587	667	10	51	80	0.6375000
NODE_5171_length_1089_cov_38.506061	587	667	14	29	80	0.3625000
NODE_5171_length_1089_cov_38.506061	640	720	6	37	80	0.4625000
NODE_5171_length_1089_cov_38.506061	640	720	10	19	80	0.2375000
NODE_5171_length_1089_cov_38.506061	640	720	14	24	80	0.3000000
NODE_5172_length_1089_cov_22.657576	379	459	8	6	80	0.0750000
NODE_5172_length_1089_cov_22.657576	379	459	10	18	80	0.2250000
NODE_5172_length_1089_cov_22.657576	379	459	14	15	80	0.1875000
NODE_5172_length_1089_cov_22.657576	379	459	15	1	80	0.0125000
NODE_5172_length_1089_cov_22.657576	379	459	16	26	80	0.3250000
NODE_5172_length_1089_cov_22.657576	379	459	18	14	80	0.1750000
NODE_5172_length_1089_cov_22.657576	432	512	8	59	80	0.7375000
NODE_5172_length_1089_cov_22.657576	432	512	15	1	80	0.0125000
NODE_5172_length_1089_cov_22.657576	432	512	16	20	80	0.2500000
NODE_5173_length_1089_cov_21.180808	547	627	0	41	80	0.5125000
NODE_5173_length_1089_cov_21.180808	547	627	2	39	80	0.4875000
NODE_5173_length_1089_cov_21.180808	600	680	0	8	80	0.1000000
NODE_5173_length_1089_cov_21.180808	600	680	1	4	80	0.0500000
NODE_5173_length_1089_cov_21.180808	600	680	2	68	80	0.8500000
NODE_5174_length_1089_cov_18.713131	431	511	0	1	80	0.0125000
NODE_5174_length_1089_cov_18.713131	431	511	2	37	80	0.4625000
NODE_5174_length_1089_cov_18.713131	431	511	4	42	80	0.5250000
NODE_5174_length_1089_cov_18.713131	484	564	0	1	80	0.0125000
NODE_5174_length_1089_cov_18.713131	484	564	2	79	80	0.9875000
NODE_5174_length_1089_cov_18.713131	560	640	0	75	80	0.9375000
NODE_5174_length_1089_cov_18.713131	560	640	2	5	80	0.0625000
NODE_5174_length_1089_cov_18.713131	613	693	0	80	80	1.0000000
NODE_5175_length_1089_cov_17.382828	376	456	0	80	80	1.0000000
NODE_5175_length_1089_cov_17.382828	429	509	0	80	80	1.0000000
NODE_5175_length_1089_cov_17.382828	505	585	0	80	80	1.0000000
NODE_5175_length_1089_cov_17.382828	558	638	0	80	80	1.0000000
NODE_5176_length_1089_cov_14.540404	610	690	0	80	80	1.0000000
NODE_5176_length_1089_cov_14.540404	663	743	0	80	80	1.0000000
NODE_5182_length_1088_cov_10.603640	504	584	0	80	80	1.0000000
NODE_5182_length_1088_cov_10.603640	557	632	0	75	75	1.0000000
NODE_5194_length_1088_cov_0.759353	0	59	1	24	59	0.4067796
NODE_5194_length_1088_cov_0.759353	0	59	2	35	59	0.5932204
NODE_5194_length_1088_cov_0.759353	32	97	2	65	65	1.0000000
NODE_5195_length_1087_cov_51.676113	457	537	2	35	80	0.4375000
NODE_5195_length_1087_cov_51.676113	457	537	4	38	80	0.4750000
NODE_5195_length_1087_cov_51.676113	457	537	5	1	80	0.0125000
NODE_5195_length_1087_cov_51.676113	457	537	6	6	80	0.0750000
NODE_5195_length_1087_cov_51.676113	510	590	4	67	80	0.8375000
NODE_5195_length_1087_cov_51.676113	510	590	6	13	80	0.1625000
NODE_5195_length_1087_cov_51.676113	586	666	2	12	80	0.1500000
NODE_5195_length_1087_cov_51.676113	586	666	4	29	80	0.3625000
NODE_5195_length_1087_cov_51.676113	586	666	6	39	80	0.4875000
NODE_5195_length_1087_cov_51.676113	639	719	2	36	80	0.4500000
NODE_5195_length_1087_cov_51.676113	639	719	4	44	80	0.5500000
NODE_5196_length_1087_cov_47.144737	214	276	53	5	62	0.0806452
NODE_5196_length_1087_cov_47.144737	214	276	55	1	62	0.0161290
NODE_5196_length_1087_cov_47.144737	214	276	59	4	62	0.0645161
NODE_5196_length_1087_cov_47.144737	214	276	64	2	62	0.0322581
NODE_5196_length_1087_cov_47.144737	214	276	66	1	62	0.0161290
NODE_5196_length_1087_cov_47.144737	214	276	68	2	62	0.0322581
NODE_5196_length_1087_cov_47.144737	214	276	70	3	62	0.0483871
NODE_5196_length_1087_cov_47.144737	214	276	72	2	62	0.0322581
NODE_5196_length_1087_cov_47.144737	214	276	76	1	62	0.0161290
NODE_5196_length_1087_cov_47.144737	214	276	80	5	62	0.0806452
NODE_5196_length_1087_cov_47.144737	214	276	84	9	62	0.1451613
NODE_5196_length_1087_cov_47.144737	214	276	90	2	62	0.0322581
NODE_5196_length_1087_cov_47.144737	214	276	96	2	62	0.0322581
NODE_5196_length_1087_cov_47.144737	214	276	102	5	62	0.0806452
NODE_5196_length_1087_cov_47.144737	214	276	104	1	62	0.0161290
NODE_5196_length_1087_cov_47.144737	214	276	106	3	62	0.0483871
NODE_5196_length_1087_cov_47.144737	214	276	110	4	62	0.0645161
NODE_5196_length_1087_cov_47.144737	214	276	112	5	62	0.0806452
NODE_5196_length_1087_cov_47.144737	214	276	113	3	62	0.0483871
NODE_5196_length_1087_cov_47.144737	214	276	115	1	62	0.0161290
NODE_5196_length_1087_cov_47.144737	214	276	116	1	62	0.0161290
NODE_5196_length_1087_cov_47.144737	630	710	0	11	80	0.1375000
NODE_5196_length_1087_cov_47.144737	630	710	2	69	80	0.8625000
NODE_5196_length_1087_cov_47.144737	683	763	0	15	80	0.1875000
NODE_5196_length_1087_cov_47.144737	683	763	2	65	80	0.8125000
NODE_5197_length_1087_cov_46.633603	871	951	4	12	80	0.1500000
NODE_5197_length_1087_cov_46.633603	871	951	6	14	80	0.1750000
NODE_5197_length_1087_cov_46.633603	871	951	10	54	80	0.6750000
NODE_5197_length_1087_cov_46.633603	924	999	0	21	75	0.2800000
NODE_5197_length_1087_cov_46.633603	924	999	6	41	75	0.5466667
NODE_5197_length_1087_cov_46.633603	924	999	10	13	75	0.1733333
NODE_5198_length_1087_cov_30.577935	528	608	0	80	80	1.0000000
NODE_5198_length_1087_cov_30.577935	581	661	0	80	80	1.0000000
NODE_5199_length_1087_cov_30.205466	515	591	8	28	76	0.3684210
NODE_5199_length_1087_cov_30.205466	515	591	10	48	76	0.6315789
NODE_5199_length_1087_cov_30.205466	564	644	0	37	80	0.4625000
NODE_5199_length_1087_cov_30.205466	564	644	2	2	80	0.0250000
NODE_5199_length_1087_cov_30.205466	564	644	4	7	80	0.0875000
NODE_5199_length_1087_cov_30.205466	564	644	10	34	80	0.4250000
NODE_5200_length_1087_cov_29.595142	568	648	2	48	80	0.6000000
NODE_5200_length_1087_cov_29.595142	568	648	4	5	80	0.0625000
NODE_5200_length_1087_cov_29.595142	568	648	6	27	80	0.3375000
NODE_5200_length_1087_cov_29.595142	621	701	0	53	80	0.6625000
NODE_5200_length_1087_cov_29.595142	621	701	2	27	80	0.3375000
NODE_5201_length_1087_cov_11.600202	374	454	0	4	80	0.0500000
NODE_5201_length_1087_cov_11.600202	374	454	1	61	80	0.7625000
NODE_5201_length_1087_cov_11.600202	374	454	2	15	80	0.1875000
NODE_5201_length_1087_cov_11.600202	427	507	1	12	80	0.1500000
NODE_5201_length_1087_cov_11.600202	427	507	2	42	80	0.5250000
NODE_5201_length_1087_cov_11.600202	427	507	4	23	80	0.2875000
NODE_5201_length_1087_cov_11.600202	427	507	6	3	80	0.0375000
NODE_5202_length_1087_cov_7.746964	436	516	0	31	80	0.3875000
NODE_5202_length_1087_cov_7.746964	436	516	1	7	80	0.0875000
NODE_5202_length_1087_cov_7.746964	436	516	2	12	80	0.1500000
NODE_5202_length_1087_cov_7.746964	436	516	3	4	80	0.0500000
NODE_5202_length_1087_cov_7.746964	436	516	4	26	80	0.3250000
NODE_5202_length_1087_cov_7.746964	489	569	0	80	80	1.0000000
NODE_5211_length_1086_cov_35.748734	406	486	2	80	80	1.0000000
NODE_5211_length_1086_cov_35.748734	459	539	0	46	80	0.5750000
NODE_5211_length_1086_cov_35.748734	459	539	1	1	80	0.0125000
NODE_5211_length_1086_cov_35.748734	459	539	2	33	80	0.4125000
NODE_5212_length_1086_cov_18.445795	325	405	2	80	80	1.0000000
NODE_5212_length_1086_cov_18.445795	378	458	0	46	80	0.5750000
NODE_5212_length_1086_cov_18.445795	378	458	2	34	80	0.4250000
NODE_5213_length_1086_cov_16.878419	528	608	0	48	80	0.6000000
NODE_5213_length_1086_cov_16.878419	528	608	4	32	80	0.4000000
NODE_5213_length_1086_cov_16.878419	581	661	4	80	80	1.0000000
NODE_5214_length_1086_cov_10.700101	498	578	0	36	80	0.4500000
NODE_5214_length_1086_cov_10.700101	498	578	2	44	80	0.5500000
NODE_5214_length_1086_cov_10.700101	551	631	0	20	80	0.2500000
NODE_5214_length_1086_cov_10.700101	551	631	2	60	80	0.7500000
NODE_5215_length_1086_cov_10.656535	277	357	0	80	80	1.0000000
NODE_5215_length_1086_cov_10.656535	330	410	0	80	80	1.0000000
NODE_5216_length_1086_cov_6.873354	374	454	0	80	80	1.0000000
NODE_5216_length_1086_cov_6.873354	427	507	0	80	80	1.0000000
NODE_5217_length_1086_cov_5.225937	869	949	0	73	80	0.9125000
NODE_5217_length_1086_cov_5.225937	869	949	2	7	80	0.0875000
NODE_5217_length_1086_cov_5.225937	922	1002	0	20	80	0.2500000
NODE_5217_length_1086_cov_5.225937	922	1002	2	60	80	0.7500000
NODE_5229_length_1085_cov_30.599391	515	595	2	39	80	0.4875000
NODE_5229_length_1085_cov_30.599391	515	595	9	19	80	0.2375000
NODE_5229_length_1085_cov_30.599391	515	595	10	22	80	0.2750000
NODE_5229_length_1085_cov_30.599391	568	648	8	29	80	0.3625000
NODE_5229_length_1085_cov_30.599391	568	648	9	5	80	0.0625000
NODE_5229_length_1085_cov_30.599391	568	648	10	46	80	0.5750000
NODE_5231_length_1085_cov_13.723124	558	638	0	41	80	0.5125000
NODE_5231_length_1085_cov_13.723124	558	638	2	39	80	0.4875000
NODE_5231_length_1085_cov_13.723124	611	691	0	29	80	0.3625000
NODE_5231_length_1085_cov_13.723124	611	691	2	51	80	0.6375000
NODE_5232_length_1085_cov_12.481744	576	656	0	80	80	1.0000000
NODE_5232_length_1085_cov_12.481744	629	709	0	80	80	1.0000000
NODE_5233_length_1085_cov_11.570994	553	633	1	47	80	0.5875000
NODE_5233_length_1085_cov_11.570994	553	633	2	33	80	0.4125000
NODE_5233_length_1085_cov_11.570994	606	686	0	49	80	0.6125000
NODE_5233_length_1085_cov_11.570994	606	686	1	31	80	0.3875000
NODE_5234_length_1085_cov_10.730223	273	353	5	38	80	0.4750000
NODE_5234_length_1085_cov_10.730223	273	353	6	42	80	0.5250000
NODE_5234_length_1085_cov_10.730223	326	406	0	10	80	0.1250000
NODE_5234_length_1085_cov_10.730223	326	406	2	4	80	0.0500000
NODE_5234_length_1085_cov_10.730223	326	406	6	66	80	0.8250000
NODE_5234_length_1085_cov_10.730223	402	482	2	35	80	0.4375000
NODE_5234_length_1085_cov_10.730223	402	482	4	45	80	0.5625000
NODE_5234_length_1085_cov_10.730223	455	535	0	11	80	0.1375000
NODE_5234_length_1085_cov_10.730223	455	535	2	52	80	0.6500000
NODE_5234_length_1085_cov_10.730223	455	535	4	17	80	0.2125000
NODE_5234_length_1085_cov_10.730223	832	908	16	2	76	0.0263158
NODE_5234_length_1085_cov_10.730223	832	908	18	10	76	0.1315790
NODE_5234_length_1085_cov_10.730223	832	908	20	13	76	0.1710526
NODE_5234_length_1085_cov_10.730223	832	908	22	1	76	0.0131579
NODE_5234_length_1085_cov_10.730223	832	908	26	1	76	0.0131579
NODE_5234_length_1085_cov_10.730223	832	908	28	5	76	0.0657895
NODE_5234_length_1085_cov_10.730223	832	908	30	2	76	0.0263158
NODE_5234_length_1085_cov_10.730223	832	908	34	16	76	0.2105263
NODE_5234_length_1085_cov_10.730223	832	908	36	11	76	0.1447368
NODE_5234_length_1085_cov_10.730223	832	908	38	15	76	0.1973684
NODE_5236_length_1085_cov_8.309331	400	480	0	8	80	0.1000000
NODE_5236_length_1085_cov_8.309331	400	480	2	72	80	0.9000000
NODE_5236_length_1085_cov_8.309331	453	533	0	22	80	0.2750000
NODE_5236_length_1085_cov_8.309331	453	533	2	58	80	0.7250000
NODE_5248_length_1084_cov_60.255838	446	524	0	19	78	0.2435897
NODE_5248_length_1084_cov_60.255838	446	524	2	39	78	0.5000000
NODE_5248_length_1084_cov_60.255838	446	524	6	20	78	0.2564103
NODE_5248_length_1084_cov_60.255838	497	577	0	1	80	0.0125000
NODE_5248_length_1084_cov_60.255838	497	577	2	7	80	0.0875000
NODE_5248_length_1084_cov_60.255838	497	577	4	49	80	0.6125000
NODE_5248_length_1084_cov_60.255838	497	577	6	23	80	0.2875000
NODE_5249_length_1084_cov_33.332995	445	525	8	6	80	0.0750000
NODE_5249_length_1084_cov_33.332995	445	525	10	54	80	0.6750000
NODE_5249_length_1084_cov_33.332995	445	525	13	1	80	0.0125000
NODE_5249_length_1084_cov_33.332995	445	525	14	19	80	0.2375000
NODE_5249_length_1084_cov_33.332995	498	578	4	6	80	0.0750000
NODE_5249_length_1084_cov_33.332995	498	578	8	33	80	0.4125000
NODE_5249_length_1084_cov_33.332995	498	578	10	39	80	0.4875000
NODE_5249_length_1084_cov_33.332995	498	578	13	1	80	0.0125000
NODE_5249_length_1084_cov_33.332995	498	578	14	1	80	0.0125000
NODE_5250_length_1084_cov_11.004061	757	837	0	60	80	0.7500000
NODE_5250_length_1084_cov_11.004061	757	837	2	20	80	0.2500000
NODE_5250_length_1084_cov_11.004061	810	890	0	80	80	1.0000000
NODE_5258_length_1083_cov_42.182927	451	531	0	80	80	1.0000000
NODE_5258_length_1083_cov_42.182927	504	584	0	62	80	0.7750000
NODE_5258_length_1083_cov_42.182927	504	584	6	18	80	0.2250000
NODE_5258_length_1083_cov_42.182927	580	660	4	2	80	0.0250000
NODE_5258_length_1083_cov_42.182927	580	660	6	17	80	0.2125000
NODE_5258_length_1083_cov_42.182927	580	660	7	2	80	0.0250000
NODE_5258_length_1083_cov_42.182927	580	660	8	59	80	0.7375000
NODE_5258_length_1083_cov_42.182927	633	713	4	2	80	0.0250000
NODE_5258_length_1083_cov_42.182927	633	713	7	2	80	0.0250000
NODE_5258_length_1083_cov_42.182927	633	713	8	36	80	0.4500000
NODE_5258_length_1083_cov_42.182927	633	713	9	1	80	0.0125000
NODE_5258_length_1083_cov_42.182927	633	713	10	39	80	0.4875000
NODE_5259_length_1083_cov_41.163618	275	355	0	32	80	0.4000000
NODE_5259_length_1083_cov_41.163618	275	355	2	11	80	0.1375000
NODE_5259_length_1083_cov_41.163618	275	355	6	21	80	0.2625000
NODE_5259_length_1083_cov_41.163618	275	355	8	16	80	0.2000000
NODE_5259_length_1083_cov_41.163618	328	408	6	22	80	0.2750000
NODE_5259_length_1083_cov_41.163618	328	408	8	58	80	0.7250000
NODE_5259_length_1083_cov_41.163618	404	484	6	10	80	0.1250000
NODE_5259_length_1083_cov_41.163618	404	484	14	6	80	0.0750000
NODE_5259_length_1083_cov_41.163618	404	484	15	9	80	0.1125000
NODE_5259_length_1083_cov_41.163618	404	484	16	17	80	0.2125000
NODE_5259_length_1083_cov_41.163618	404	484	18	7	80	0.0875000
NODE_5259_length_1083_cov_41.163618	404	484	19	16	80	0.2000000
NODE_5259_length_1083_cov_41.163618	404	484	20	15	80	0.1875000
NODE_5259_length_1083_cov_41.163618	457	537	15	54	80	0.6750000
NODE_5259_length_1083_cov_41.163618	457	537	16	25	80	0.3125000
NODE_5259_length_1083_cov_41.163618	457	537	19	1	80	0.0125000
NODE_5260_length_1083_cov_39.798780	527	607	2	40	80	0.5000000
NODE_5260_length_1083_cov_39.798780	527	607	4	23	80	0.2875000
NODE_5260_length_1083_cov_39.798780	527	607	6	17	80	0.2125000
NODE_5260_length_1083_cov_39.798780	580	660	2	30	80	0.3750000
NODE_5260_length_1083_cov_39.798780	580	660	4	33	80	0.4125000
NODE_5260_length_1083_cov_39.798780	580	660	6	17	80	0.2125000
NODE_5261_length_1083_cov_34.261179	475	555	2	1	80	0.0125000
NODE_5261_length_1083_cov_34.261179	475	555	4	48	80	0.6000000
NODE_5261_length_1083_cov_34.261179	475	555	6	20	80	0.2500000
NODE_5261_length_1083_cov_34.261179	475	555	8	11	80	0.1375000
NODE_5261_length_1083_cov_34.261179	528	608	6	45	80	0.5625000
NODE_5261_length_1083_cov_34.261179	528	608	8	35	80	0.4375000
NODE_5262_length_1083_cov_33.573171	486	566	0	53	80	0.6625000
NODE_5262_length_1083_cov_33.573171	486	566	2	27	80	0.3375000
NODE_5262_length_1083_cov_33.573171	539	619	2	52	80	0.6500000
NODE_5262_length_1083_cov_33.573171	539	619	4	28	80	0.3500000
NODE_5262_length_1083_cov_33.573171	615	695	4	22	80	0.2750000
NODE_5262_length_1083_cov_33.573171	615	695	10	4	80	0.0500000
NODE_5262_length_1083_cov_33.573171	615	695	14	40	80	0.5000000
NODE_5262_length_1083_cov_33.573171	615	695	16	14	80	0.1750000
NODE_5262_length_1083_cov_33.573171	668	748	4	18	80	0.2250000
NODE_5262_length_1083_cov_33.573171	668	748	10	12	80	0.1500000
NODE_5262_length_1083_cov_33.573171	668	748	14	36	80	0.4500000
NODE_5262_length_1083_cov_33.573171	668	748	16	14	80	0.1750000
NODE_5263_length_1083_cov_33.091463	452	532	0	80	80	1.0000000
NODE_5263_length_1083_cov_33.091463	505	585	0	80	80	1.0000000
NODE_5264_length_1083_cov_30.982724	550	630	2	22	80	0.2750000
NODE_5264_length_1083_cov_30.982724	550	630	4	58	80	0.7250000
NODE_5264_length_1083_cov_30.982724	603	683	0	38	80	0.4750000
NODE_5264_length_1083_cov_30.982724	603	683	2	37	80	0.4625000
NODE_5264_length_1083_cov_30.982724	603	683	4	5	80	0.0625000
NODE_5265_length_1083_cov_18.819106	586	666	4	25	80	0.3125000
NODE_5265_length_1083_cov_18.819106	586	666	6	24	80	0.3000000
NODE_5265_length_1083_cov_18.819106	586	666	8	31	80	0.3875000
NODE_5265_length_1083_cov_18.819106	639	719	0	27	80	0.3375000
NODE_5265_length_1083_cov_18.819106	639	719	2	12	80	0.1500000
NODE_5265_length_1083_cov_18.819106	639	719	4	19	80	0.2375000
NODE_5265_length_1083_cov_18.819106	639	719	6	14	80	0.1750000
NODE_5265_length_1083_cov_18.819106	639	719	8	8	80	0.1000000
NODE_5266_length_1083_cov_17.278455	408	488	2	80	80	1.0000000
NODE_5266_length_1083_cov_17.278455	461	541	0	47	80	0.5875000
NODE_5266_length_1083_cov_17.278455	461	541	2	33	80	0.4125000
NODE_5267_length_1083_cov_13.862805	481	561	0	4	80	0.0500000
NODE_5267_length_1083_cov_13.862805	481	561	2	6	80	0.0750000
NODE_5267_length_1083_cov_13.862805	481	561	6	9	80	0.1125000
NODE_5267_length_1083_cov_13.862805	481	561	8	61	80	0.7625000
NODE_5267_length_1083_cov_13.862805	534	614	4	30	80	0.3750000
NODE_5267_length_1083_cov_13.862805	534	614	8	50	80	0.6250000
NODE_5268_length_1083_cov_13.083333	522	602	0	14	80	0.1750000
NODE_5268_length_1083_cov_13.083333	522	602	6	32	80	0.4000000
NODE_5268_length_1083_cov_13.083333	522	602	8	1	80	0.0125000
NODE_5268_length_1083_cov_13.083333	522	602	10	20	80	0.2500000
NODE_5268_length_1083_cov_13.083333	522	602	12	1	80	0.0125000
NODE_5268_length_1083_cov_13.083333	522	602	16	12	80	0.1500000
NODE_5268_length_1083_cov_13.083333	575	655	8	10	80	0.1250000
NODE_5268_length_1083_cov_13.083333	575	655	10	29	80	0.3625000
NODE_5268_length_1083_cov_13.083333	575	655	12	1	80	0.0125000
NODE_5268_length_1083_cov_13.083333	575	655	15	3	80	0.0375000
NODE_5268_length_1083_cov_13.083333	575	655	16	37	80	0.4625000
NODE_5269_length_1083_cov_11.824187	242	322	0	80	80	1.0000000
NODE_5269_length_1083_cov_11.824187	295	375	0	80	80	1.0000000
NODE_5271_length_1083_cov_3.025407	359	439	0	80	80	1.0000000
NODE_5271_length_1083_cov_3.025407	412	489	0	77	77	1.0000000
NODE_5277_length_1082_cov_34.664293	461	541	0	6	80	0.0750000
NODE_5277_length_1082_cov_34.664293	461	541	2	74	80	0.9250000
NODE_5277_length_1082_cov_34.664293	514	594	0	56	80	0.7000000
NODE_5277_length_1082_cov_34.664293	514	594	2	24	80	0.3000000
NODE_5278_length_1082_cov_17.422177	406	486	0	4	80	0.0500000
NODE_5278_length_1082_cov_17.422177	406	486	4	34	80	0.4250000
NODE_5278_length_1082_cov_17.422177	406	486	6	21	80	0.2625000
NODE_5278_length_1082_cov_17.422177	406	486	8	19	80	0.2375000
NODE_5278_length_1082_cov_17.422177	406	486	10	2	80	0.0250000
NODE_5278_length_1082_cov_17.422177	459	539	4	15	80	0.1875000
NODE_5278_length_1082_cov_17.422177	459	539	6	16	80	0.2000000
NODE_5278_length_1082_cov_17.422177	459	539	8	19	80	0.2375000
NODE_5278_length_1082_cov_17.422177	459	539	10	30	80	0.3750000
NODE_5279_length_1082_cov_15.906409	442	522	0	9	80	0.1125000
NODE_5279_length_1082_cov_15.906409	442	522	2	71	80	0.8875000
NODE_5279_length_1082_cov_15.906409	495	575	0	62	80	0.7750000
NODE_5279_length_1082_cov_15.906409	495	575	2	18	80	0.2250000
NODE_5280_length_1082_cov_13.703967	324	404	4	7	80	0.0875000
NODE_5280_length_1082_cov_13.703967	324	404	8	73	80	0.9125000
NODE_5280_length_1082_cov_13.703967	377	457	0	35	80	0.4375000
NODE_5280_length_1082_cov_13.703967	377	457	4	25	80	0.3125000
NODE_5280_length_1082_cov_13.703967	377	457	8	20	80	0.2500000
NODE_5281_length_1082_cov_6.478128	159	205	0	20	46	0.4347826
NODE_5281_length_1082_cov_6.478128	159	205	2	23	46	0.5000000
NODE_5281_length_1082_cov_6.478128	159	205	4	3	46	0.0652174
NODE_5281_length_1082_cov_6.478128	203	283	0	16	80	0.2000000
NODE_5281_length_1082_cov_6.478128	203	283	2	7	80	0.0875000
NODE_5281_length_1082_cov_6.478128	203	283	4	7	80	0.0875000
NODE_5281_length_1082_cov_6.478128	203	283	6	5	80	0.0625000
NODE_5281_length_1082_cov_6.478128	203	283	12	1	80	0.0125000
NODE_5281_length_1082_cov_6.478128	203	283	18	9	80	0.1125000
NODE_5281_length_1082_cov_6.478128	203	283	20	7	80	0.0875000
NODE_5281_length_1082_cov_6.478128	203	283	22	28	80	0.3500000
NODE_5281_length_1082_cov_6.478128	256	336	0	9	80	0.1125000
NODE_5281_length_1082_cov_6.478128	256	336	4	1	80	0.0125000
NODE_5281_length_1082_cov_6.478128	256	336	8	2	80	0.0250000
NODE_5281_length_1082_cov_6.478128	256	336	10	2	80	0.0250000
NODE_5281_length_1082_cov_6.478128	256	336	14	1	80	0.0125000
NODE_5281_length_1082_cov_6.478128	256	336	16	3	80	0.0375000
NODE_5281_length_1082_cov_6.478128	256	336	18	3	80	0.0375000
NODE_5281_length_1082_cov_6.478128	256	336	21	1	80	0.0125000
NODE_5281_length_1082_cov_6.478128	256	336	22	58	80	0.7250000
NODE_5281_length_1082_cov_6.478128	861	941	0	35	80	0.4375000
NODE_5281_length_1082_cov_6.478128	861	941	2	45	80	0.5625000
NODE_5282_length_1082_cov_4.218718	982	1062	103	1	80	0.0125000
NODE_5282_length_1082_cov_4.218718	982	1062	105	1	80	0.0125000
NODE_5282_length_1082_cov_4.218718	982	1062	113	1	80	0.0125000
NODE_5282_length_1082_cov_4.218718	982	1062	117	1	80	0.0125000
NODE_5282_length_1082_cov_4.218718	982	1062	135	1	80	0.0125000
NODE_5282_length_1082_cov_4.218718	982	1062	141	1	80	0.0125000
NODE_5282_length_1082_cov_4.218718	982	1062	149	3	80	0.0375000
NODE_5282_length_1082_cov_4.218718	982	1062	151	1	80	0.0125000
NODE_5282_length_1082_cov_4.218718	982	1062	160	3	80	0.0375000
NODE_5282_length_1082_cov_4.218718	982	1062	162	1	80	0.0125000
NODE_5282_length_1082_cov_4.218718	982	1062	168	1	80	0.0125000
NODE_5282_length_1082_cov_4.218718	982	1062	169	1	80	0.0125000
NODE_5282_length_1082_cov_4.218718	982	1062	173	1	80	0.0125000
NODE_5282_length_1082_cov_4.218718	982	1062	179	1	80	0.0125000
NODE_5282_length_1082_cov_4.218718	982	1062	189	2	80	0.0250000
NODE_5282_length_1082_cov_4.218718	982	1062	199	1	80	0.0125000
NODE_5282_length_1082_cov_4.218718	982	1062	213	1	80	0.0125000
NODE_5282_length_1082_cov_4.218718	982	1062	217	1	80	0.0125000
NODE_5282_length_1082_cov_4.218718	982	1062	227	1	80	0.0125000
NODE_5282_length_1082_cov_4.218718	982	1062	239	1	80	0.0125000
NODE_5282_length_1082_cov_4.218718	982	1062	251	1	80	0.0125000
NODE_5282_length_1082_cov_4.218718	982	1062	253	1	80	0.0125000
NODE_5282_length_1082_cov_4.218718	982	1062	259	2	80	0.0250000
NODE_5282_length_1082_cov_4.218718	982	1062	260	3	80	0.0375000
NODE_5282_length_1082_cov_4.218718	982	1062	262	2	80	0.0250000
NODE_5282_length_1082_cov_4.218718	982	1062	266	2	80	0.0250000
NODE_5282_length_1082_cov_4.218718	982	1062	270	1	80	0.0125000
NODE_5282_length_1082_cov_4.218718	982	1062	272	1	80	0.0125000
NODE_5282_length_1082_cov_4.218718	982	1062	274	1	80	0.0125000
NODE_5282_length_1082_cov_4.218718	982	1062	286	1	80	0.0125000
NODE_5282_length_1082_cov_4.218718	982	1062	292	2	80	0.0250000
NODE_5282_length_1082_cov_4.218718	982	1062	296	3	80	0.0375000
NODE_5282_length_1082_cov_4.218718	982	1062	298	1	80	0.0125000
NODE_5282_length_1082_cov_4.218718	982	1062	303	1	80	0.0125000
NODE_5282_length_1082_cov_4.218718	982	1062	305	1	80	0.0125000
NODE_5282_length_1082_cov_4.218718	982	1062	308	1	80	0.0125000
NODE_5282_length_1082_cov_4.218718	982	1062	309	1	80	0.0125000
NODE_5282_length_1082_cov_4.218718	982	1062	310	1	80	0.0125000
NODE_5282_length_1082_cov_4.218718	982	1062	314	1	80	0.0125000
NODE_5282_length_1082_cov_4.218718	982	1062	320	1	80	0.0125000
NODE_5282_length_1082_cov_4.218718	982	1062	322	1	80	0.0125000
NODE_5282_length_1082_cov_4.218718	982	1062	326	1	80	0.0125000
NODE_5282_length_1082_cov_4.218718	982	1062	327	1	80	0.0125000
NODE_5282_length_1082_cov_4.218718	982	1062	335	2	80	0.0250000
NODE_5282_length_1082_cov_4.218718	982	1062	339	4	80	0.0500000
NODE_5282_length_1082_cov_4.218718	982	1062	343	1	80	0.0125000
NODE_5282_length_1082_cov_4.218718	982	1062	347	1	80	0.0125000
NODE_5282_length_1082_cov_4.218718	982	1062	349	2	80	0.0250000
NODE_5282_length_1082_cov_4.218718	982	1062	351	1	80	0.0125000
NODE_5282_length_1082_cov_4.218718	982	1062	353	1	80	0.0125000
NODE_5282_length_1082_cov_4.218718	982	1062	355	1	80	0.0125000
NODE_5282_length_1082_cov_4.218718	982	1062	357	3	80	0.0375000
NODE_5282_length_1082_cov_4.218718	982	1062	359	1	80	0.0125000
NODE_5282_length_1082_cov_4.218718	982	1062	361	1	80	0.0125000
NODE_5282_length_1082_cov_4.218718	982	1062	365	1	80	0.0125000
NODE_5282_length_1082_cov_4.218718	982	1062	367	1	80	0.0125000
NODE_5282_length_1082_cov_4.218718	982	1062	370	4	80	0.0500000
NODE_5291_length_1081_cov_45.308554	510	590	0	11	80	0.1375000
NODE_5291_length_1081_cov_45.308554	510	590	2	24	80	0.3000000
NODE_5291_length_1081_cov_45.308554	510	590	4	45	80	0.5625000
NODE_5291_length_1081_cov_45.308554	563	643	0	64	80	0.8000000
NODE_5291_length_1081_cov_45.308554	563	643	2	16	80	0.2000000
NODE_5292_length_1081_cov_39.581466	476	556	0	13	80	0.1625000
NODE_5292_length_1081_cov_39.581466	476	556	4	5	80	0.0625000
NODE_5292_length_1081_cov_39.581466	476	556	10	1	80	0.0125000
NODE_5292_length_1081_cov_39.581466	476	556	11	39	80	0.4875000
NODE_5292_length_1081_cov_39.581466	476	556	12	22	80	0.2750000
NODE_5292_length_1081_cov_39.581466	529	609	0	51	80	0.6375000
NODE_5292_length_1081_cov_39.581466	529	609	2	15	80	0.1875000
NODE_5292_length_1081_cov_39.581466	529	609	4	5	80	0.0625000
NODE_5292_length_1081_cov_39.581466	529	609	10	1	80	0.0125000
NODE_5292_length_1081_cov_39.581466	529	609	11	8	80	0.1000000
NODE_5292_length_1081_cov_39.581466	605	685	0	30	80	0.3750000
NODE_5292_length_1081_cov_39.581466	605	685	2	30	80	0.3750000
NODE_5292_length_1081_cov_39.581466	605	685	7	2	80	0.0250000
NODE_5292_length_1081_cov_39.581466	605	685	8	18	80	0.2250000
NODE_5292_length_1081_cov_39.581466	658	738	0	7	80	0.0875000
NODE_5292_length_1081_cov_39.581466	658	738	7	2	80	0.0250000
NODE_5292_length_1081_cov_39.581466	658	738	8	71	80	0.8875000
NODE_5293_length_1081_cov_39.457230	373	453	0	26	80	0.3250000
NODE_5293_length_1081_cov_39.457230	373	453	2	54	80	0.6750000
NODE_5293_length_1081_cov_39.457230	426	506	0	79	80	0.9875000
NODE_5293_length_1081_cov_39.457230	426	506	2	1	80	0.0125000
NODE_5294_length_1081_cov_20.415479	376	451	0	75	75	1.0000000
NODE_5294_length_1081_cov_20.415479	436	511	0	75	75	1.0000000
NODE_5294_length_1081_cov_20.415479	496	571	0	75	75	1.0000000
NODE_5294_length_1081_cov_20.415479	544	624	0	57	80	0.7125000
NODE_5294_length_1081_cov_20.415479	544	624	2	23	80	0.2875000
NODE_5295_length_1081_cov_19.985743	378	458	4	49	80	0.6125000
NODE_5295_length_1081_cov_19.985743	378	458	6	31	80	0.3875000
NODE_5295_length_1081_cov_19.985743	431	511	0	22	80	0.2750000
NODE_5295_length_1081_cov_19.985743	431	511	2	19	80	0.2375000
NODE_5295_length_1081_cov_19.985743	431	511	4	39	80	0.4875000
NODE_5295_length_1081_cov_19.985743	507	587	0	80	80	1.0000000
NODE_5295_length_1081_cov_19.985743	560	640	0	80	80	1.0000000
NODE_5296_length_1081_cov_12.658859	468	548	6	78	80	0.9750000
NODE_5296_length_1081_cov_12.658859	468	548	8	2	80	0.0250000
NODE_5296_length_1081_cov_12.658859	521	601	2	15	80	0.1875000
NODE_5296_length_1081_cov_12.658859	521	601	4	17	80	0.2125000
NODE_5296_length_1081_cov_12.658859	521	601	6	48	80	0.6000000
NODE_5299_length_1081_cov_2.586558	7	44	0	37	37	1.0000000
NODE_5304_length_1080_cov_27.857288	261	341	0	80	80	1.0000000
NODE_5304_length_1080_cov_27.857288	314	394	0	80	80	1.0000000
NODE_5305_length_1080_cov_24.258919	321	401	2	35	80	0.4375000
NODE_5305_length_1080_cov_24.258919	321	401	4	45	80	0.5625000
NODE_5305_length_1080_cov_24.258919	374	454	0	12	80	0.1500000
NODE_5305_length_1080_cov_24.258919	374	454	2	38	80	0.4750000
NODE_5305_length_1080_cov_24.258919	374	454	4	30	80	0.3750000
NODE_5305_length_1080_cov_24.258919	450	530	0	80	80	1.0000000
NODE_5305_length_1080_cov_24.258919	503	583	0	80	80	1.0000000
NODE_5306_length_1080_cov_22.589195	446	526	0	71	80	0.8875000
NODE_5306_length_1080_cov_22.589195	446	526	2	9	80	0.1125000
NODE_5306_length_1080_cov_22.589195	499	579	0	80	80	1.0000000
NODE_5306_length_1080_cov_22.589195	575	655	0	42	80	0.5250000
NODE_5306_length_1080_cov_22.589195	575	655	2	19	80	0.2375000
NODE_5306_length_1080_cov_22.589195	575	655	4	19	80	0.2375000
NODE_5306_length_1080_cov_22.589195	628	708	2	8	80	0.1000000
NODE_5306_length_1080_cov_22.589195	628	708	4	72	80	0.9000000
NODE_5307_length_1080_cov_15.544343	599	679	0	80	80	1.0000000
NODE_5307_length_1080_cov_15.544343	652	732	0	80	80	1.0000000
NODE_5308_length_1080_cov_10.416922	321	401	1	3	80	0.0375000
NODE_5308_length_1080_cov_10.416922	321	401	2	43	80	0.5375000
NODE_5308_length_1080_cov_10.416922	321	401	5	34	80	0.4250000
NODE_5308_length_1080_cov_10.416922	374	454	5	39	80	0.4875000
NODE_5308_length_1080_cov_10.416922	374	454	7	4	80	0.0500000
NODE_5308_length_1080_cov_10.416922	374	454	8	3	80	0.0375000
NODE_5308_length_1080_cov_10.416922	374	454	9	34	80	0.4250000
NODE_5315_length_1079_cov_55.352041	367	447	1	9	80	0.1125000
NODE_5315_length_1079_cov_55.352041	367	447	3	71	80	0.8875000
NODE_5315_length_1079_cov_55.352041	420	500	1	26	80	0.3250000
NODE_5315_length_1079_cov_55.352041	420	500	2	36	80	0.4500000
NODE_5315_length_1079_cov_55.352041	420	500	3	18	80	0.2250000
NODE_5315_length_1079_cov_55.352041	496	576	1	37	80	0.4625000
NODE_5315_length_1079_cov_55.352041	496	576	2	2	80	0.0250000
NODE_5315_length_1079_cov_55.352041	496	576	19	41	80	0.5125000
NODE_5315_length_1079_cov_55.352041	549	629	17	31	80	0.3875000
NODE_5315_length_1079_cov_55.352041	549	629	18	16	80	0.2000000
NODE_5315_length_1079_cov_55.352041	549	629	19	33	80	0.4125000
NODE_5316_length_1079_cov_46.879592	444	524	15	16	80	0.2000000
NODE_5316_length_1079_cov_46.879592	444	524	17	2	80	0.0250000
NODE_5316_length_1079_cov_46.879592	444	524	19	10	80	0.1250000
NODE_5316_length_1079_cov_46.879592	444	524	20	1	80	0.0125000
NODE_5316_length_1079_cov_46.879592	444	524	22	22	80	0.2750000
NODE_5316_length_1079_cov_46.879592	444	524	24	3	80	0.0375000
NODE_5316_length_1079_cov_46.879592	444	524	25	26	80	0.3250000
NODE_5316_length_1079_cov_46.879592	497	577	4	4	80	0.0500000
NODE_5316_length_1079_cov_46.879592	497	577	10	7	80	0.0875000
NODE_5316_length_1079_cov_46.879592	497	577	13	1	80	0.0125000
NODE_5316_length_1079_cov_46.879592	497	577	14	4	80	0.0500000
NODE_5316_length_1079_cov_46.879592	497	577	19	1	80	0.0125000
NODE_5316_length_1079_cov_46.879592	497	577	24	11	80	0.1375000
NODE_5316_length_1079_cov_46.879592	497	577	25	39	80	0.4875000
NODE_5316_length_1079_cov_46.879592	497	577	26	13	80	0.1625000
NODE_5316_length_1079_cov_46.879592	573	652	1	27	79	0.3417721
NODE_5316_length_1079_cov_46.879592	573	652	3	19	79	0.2405063
NODE_5316_length_1079_cov_46.879592	573	652	4	12	79	0.1518987
NODE_5316_length_1079_cov_46.879592	573	652	5	21	79	0.2658228
NODE_5316_length_1079_cov_46.879592	625	703	1	78	78	1.0000000
NODE_5317_length_1079_cov_13.708163	611	691	0	80	80	1.0000000
NODE_5317_length_1079_cov_13.708163	664	744	0	80	80	1.0000000
NODE_5318_length_1079_cov_8.632653	416	496	0	80	80	1.0000000
NODE_5318_length_1079_cov_8.632653	469	549	0	29	80	0.3625000
NODE_5318_length_1079_cov_8.632653	469	549	2	12	80	0.1500000
NODE_5318_length_1079_cov_8.632653	469	549	4	39	80	0.4875000
NODE_5325_length_1078_cov_27.804903	357	437	4	11	80	0.1375000
NODE_5325_length_1078_cov_27.804903	357	437	8	34	80	0.4250000
NODE_5325_length_1078_cov_27.804903	357	437	10	11	80	0.1375000
NODE_5325_length_1078_cov_27.804903	357	437	12	10	80	0.1250000
NODE_5325_length_1078_cov_27.804903	357	437	14	14	80	0.1750000
NODE_5325_length_1078_cov_27.804903	410	490	8	10	80	0.1250000
NODE_5325_length_1078_cov_27.804903	410	490	10	8	80	0.1000000
NODE_5325_length_1078_cov_27.804903	410	490	12	10	80	0.1250000
NODE_5325_length_1078_cov_27.804903	410	490	14	52	80	0.6500000
NODE_5326_length_1078_cov_26.071502	459	539	0	5	80	0.0625000
NODE_5326_length_1078_cov_26.071502	459	539	5	34	80	0.4250000
NODE_5326_length_1078_cov_26.071502	459	539	6	41	80	0.5125000
NODE_5326_length_1078_cov_26.071502	512	592	0	45	80	0.5625000
NODE_5326_length_1078_cov_26.071502	512	592	2	2	80	0.0250000
NODE_5326_length_1078_cov_26.071502	512	592	5	22	80	0.2750000
NODE_5326_length_1078_cov_26.071502	512	592	6	11	80	0.1375000
NODE_5326_length_1078_cov_26.071502	588	668	2	1	80	0.0125000
NODE_5326_length_1078_cov_26.071502	588	668	4	4	80	0.0500000
NODE_5326_length_1078_cov_26.071502	588	668	6	49	80	0.6125000
NODE_5326_length_1078_cov_26.071502	588	668	8	26	80	0.3250000
NODE_5326_length_1078_cov_26.071502	641	718	2	1	77	0.0129870
NODE_5326_length_1078_cov_26.071502	641	718	4	54	77	0.7012987
NODE_5326_length_1078_cov_26.071502	641	718	6	5	77	0.0649351
NODE_5326_length_1078_cov_26.071502	641	718	8	17	77	0.2207792
NODE_5327_length_1078_cov_14.985700	495	575	0	80	80	1.0000000
NODE_5327_length_1078_cov_14.985700	548	628	0	80	80	1.0000000
NODE_5333_length_1077_cov_23.876278	546	626	2	3	80	0.0375000
NODE_5333_length_1077_cov_23.876278	546	626	4	9	80	0.1125000
NODE_5333_length_1077_cov_23.876278	546	626	5	30	80	0.3750000
NODE_5333_length_1077_cov_23.876278	546	626	6	38	80	0.4750000
NODE_5333_length_1077_cov_23.876278	599	679	0	47	80	0.5875000
NODE_5333_length_1077_cov_23.876278	599	679	4	15	80	0.1875000
NODE_5333_length_1077_cov_23.876278	599	679	5	18	80	0.2250000
NODE_5334_length_1077_cov_16.067485	532	612	0	26	80	0.3250000
NODE_5334_length_1077_cov_16.067485	532	612	2	54	80	0.6750000
NODE_5334_length_1077_cov_16.067485	585	665	0	31	80	0.3875000
NODE_5334_length_1077_cov_16.067485	585	665	2	49	80	0.6125000
NODE_5335_length_1077_cov_14.568507	556	636	6	80	80	1.0000000
NODE_5335_length_1077_cov_14.568507	609	689	0	25	80	0.3125000
NODE_5335_length_1077_cov_14.568507	609	689	6	55	80	0.6875000
NODE_5336_length_1077_cov_9.507157	496	576	0	80	80	1.0000000
NODE_5336_length_1077_cov_9.507157	549	629	0	80	80	1.0000000
NODE_5342_length_1077_cov_1.781186	252	274	0	22	22	1.0000000
NODE_5345_length_1076_cov_20.592631	534	614	0	80	80	1.0000000
NODE_5345_length_1076_cov_20.592631	587	667	0	80	80	1.0000000
NODE_5346_length_1076_cov_14.788127	427	507	0	70	80	0.8750000
NODE_5346_length_1076_cov_14.788127	427	507	2	10	80	0.1250000
NODE_5346_length_1076_cov_14.788127	480	560	0	17	80	0.2125000
NODE_5346_length_1076_cov_14.788127	480	560	2	36	80	0.4500000
NODE_5346_length_1076_cov_14.788127	480	560	4	27	80	0.3375000
NODE_5348_length_1076_cov_6.306039	883	961	0	78	78	1.0000000
NODE_5348_length_1076_cov_6.306039	936	1014	0	78	78	1.0000000
NODE_5357_length_1075_cov_37.941598	550	630	2	35	80	0.4375000
NODE_5357_length_1075_cov_37.941598	550	630	4	16	80	0.2000000
NODE_5357_length_1075_cov_37.941598	550	630	6	29	80	0.3625000
NODE_5357_length_1075_cov_37.941598	603	685	0	35	82	0.4268293
NODE_5357_length_1075_cov_37.941598	603	685	4	36	82	0.4390244
NODE_5357_length_1075_cov_37.941598	603	685	6	11	82	0.1341463
NODE_5357_length_1075_cov_37.941598	681	761	0	80	80	1.0000000
NODE_5357_length_1075_cov_37.941598	734	814	0	80	80	1.0000000
NODE_5358_length_1075_cov_32.224385	397	477	0	80	80	1.0000000
NODE_5358_length_1075_cov_32.224385	450	530	0	80	80	1.0000000
NODE_5359_length_1075_cov_9.626025	440	520	0	61	80	0.7625000
NODE_5359_length_1075_cov_9.626025	440	520	2	19	80	0.2375000
NODE_5359_length_1075_cov_9.626025	493	573	0	8	80	0.1000000
NODE_5359_length_1075_cov_9.626025	493	573	2	72	80	0.9000000
NODE_5362_length_1075_cov_2.926230	38	99	0	61	61	1.0000000
NODE_5372_length_1074_cov_19.034872	568	648	2	80	80	1.0000000
NODE_5372_length_1074_cov_19.034872	621	701	0	44	80	0.5500000
NODE_5372_length_1074_cov_19.034872	621	701	1	1	80	0.0125000
NODE_5372_length_1074_cov_19.034872	621	701	2	35	80	0.4375000
NODE_5372_length_1074_cov_19.034872	697	777	0	80	80	1.0000000
NODE_5372_length_1074_cov_19.034872	750	830	0	80	80	1.0000000
NODE_5373_length_1074_cov_9.450256	577	657	1	68	80	0.8500000
NODE_5373_length_1074_cov_9.450256	577	657	2	12	80	0.1500000
NODE_5373_length_1074_cov_9.450256	630	710	1	49	80	0.6125000
NODE_5373_length_1074_cov_9.450256	630	710	2	31	80	0.3875000
NODE_5374_length_1074_cov_9.155897	526	606	0	80	80	1.0000000
NODE_5374_length_1074_cov_9.155897	579	659	0	80	80	1.0000000
NODE_5374_length_1074_cov_9.155897	655	735	0	25	80	0.3125000
NODE_5374_length_1074_cov_9.155897	655	735	4	55	80	0.6875000
NODE_5374_length_1074_cov_9.155897	708	788	0	28	80	0.3500000
NODE_5374_length_1074_cov_9.155897	708	788	4	52	80	0.6500000
NODE_5375_length_1074_cov_4.600000	606	686	0	80	80	1.0000000
NODE_5375_length_1074_cov_4.600000	659	739	0	80	80	1.0000000
NODE_5376_length_1074_cov_4.328205	32	112	27	1	80	0.0125000
NODE_5376_length_1074_cov_4.328205	32	112	28	14	80	0.1750000
NODE_5376_length_1074_cov_4.328205	32	112	30	1	80	0.0125000
NODE_5376_length_1074_cov_4.328205	32	112	32	1	80	0.0125000
NODE_5376_length_1074_cov_4.328205	32	112	34	1	80	0.0125000
NODE_5376_length_1074_cov_4.328205	32	112	36	3	80	0.0375000
NODE_5376_length_1074_cov_4.328205	32	112	39	1	80	0.0125000
NODE_5376_length_1074_cov_4.328205	32	112	41	4	80	0.0500000
NODE_5376_length_1074_cov_4.328205	32	112	43	4	80	0.0500000
NODE_5376_length_1074_cov_4.328205	32	112	45	1	80	0.0125000
NODE_5376_length_1074_cov_4.328205	32	112	46	14	80	0.1750000
NODE_5376_length_1074_cov_4.328205	32	112	48	14	80	0.1750000
NODE_5376_length_1074_cov_4.328205	32	112	50	21	80	0.2625000
NODE_5380_length_1073_cov_60.012320	448	528	0	79	80	0.9875000
NODE_5380_length_1073_cov_60.012320	448	528	4	1	80	0.0125000
NODE_5380_length_1073_cov_60.012320	501	581	0	26	80	0.3250000
NODE_5380_length_1073_cov_60.012320	501	581	4	54	80	0.6750000
NODE_5382_length_1073_cov_26.415811	529	609	0	22	80	0.2750000
NODE_5382_length_1073_cov_26.415811	529	609	2	58	80	0.7250000
NODE_5382_length_1073_cov_26.415811	582	662	0	75	80	0.9375000
NODE_5382_length_1073_cov_26.415811	582	662	2	5	80	0.0625000
NODE_5383_length_1073_cov_19.062628	571	651	2	4	80	0.0500000
NODE_5383_length_1073_cov_19.062628	571	651	4	75	80	0.9375000
NODE_5383_length_1073_cov_19.062628	571	651	6	1	80	0.0125000
NODE_5383_length_1073_cov_19.062628	624	704	2	37	80	0.4625000
NODE_5383_length_1073_cov_19.062628	624	704	4	43	80	0.5375000
NODE_5384_length_1073_cov_18.536961	447	527	0	80	80	1.0000000
NODE_5384_length_1073_cov_18.536961	500	580	0	80	80	1.0000000
NODE_5384_length_1073_cov_18.536961	576	656	0	80	80	1.0000000
NODE_5384_length_1073_cov_18.536961	629	709	0	80	80	1.0000000
NODE_5385_length_1073_cov_15.318275	712	792	0	7	80	0.0875000
NODE_5385_length_1073_cov_15.318275	712	792	2	73	80	0.9125000
NODE_5385_length_1073_cov_15.318275	765	845	0	43	80	0.5375000
NODE_5385_length_1073_cov_15.318275	765	845	1	1	80	0.0125000
NODE_5385_length_1073_cov_15.318275	765	845	2	36	80	0.4500000
NODE_5386_length_1073_cov_8.376797	287	367	0	8	80	0.1000000
NODE_5386_length_1073_cov_8.376797	287	367	4	33	80	0.4125000
NODE_5386_length_1073_cov_8.376797	287	367	6	39	80	0.4875000
NODE_5386_length_1073_cov_8.376797	340	420	4	11	80	0.1375000
NODE_5386_length_1073_cov_8.376797	340	420	6	69	80	0.8625000
NODE_5387_length_1073_cov_5.749487	257	337	0	80	80	1.0000000
NODE_5387_length_1073_cov_5.749487	310	390	0	80	80	1.0000000
NODE_5388_length_1073_cov_5.156057	408	444	0	15	36	0.4166667
NODE_5388_length_1073_cov_5.156057	408	444	4	21	36	0.5833333
NODE_5390_length_1073_cov_3.019507	1	69	0	11	68	0.1617647
NODE_5390_length_1073_cov_3.019507	1	69	7	1	68	0.0147059
NODE_5390_length_1073_cov_3.019507	1	69	8	56	68	0.8235294
NODE_5390_length_1073_cov_3.019507	42	122	0	12	80	0.1500000
NODE_5390_length_1073_cov_3.019507	42	122	8	68	80	0.8500000
NODE_5399_length_1072_cov_62.729702	351	431	0	57	80	0.7125000
NODE_5399_length_1072_cov_62.729702	351	431	2	3	80	0.0375000
NODE_5399_length_1072_cov_62.729702	351	431	4	3	80	0.0375000
NODE_5399_length_1072_cov_62.729702	351	431	6	7	80	0.0875000
NODE_5399_length_1072_cov_62.729702	351	431	11	10	80	0.1250000
NODE_5399_length_1072_cov_62.729702	404	484	0	4	80	0.0500000
NODE_5399_length_1072_cov_62.729702	404	484	2	3	80	0.0375000
NODE_5399_length_1072_cov_62.729702	404	484	4	6	80	0.0750000
NODE_5399_length_1072_cov_62.729702	404	484	6	20	80	0.2500000
NODE_5399_length_1072_cov_62.729702	404	484	9	1	80	0.0125000
NODE_5399_length_1072_cov_62.729702	404	484	10	3	80	0.0375000
NODE_5399_length_1072_cov_62.729702	404	484	11	19	80	0.2375000
NODE_5399_length_1072_cov_62.729702	404	484	13	24	80	0.3000000
NODE_5399_length_1072_cov_62.729702	480	560	2	65	80	0.8125000
NODE_5399_length_1072_cov_62.729702	480	560	4	14	80	0.1750000
NODE_5399_length_1072_cov_62.729702	480	560	6	1	80	0.0125000
NODE_5399_length_1072_cov_62.729702	533	613	0	7	80	0.0875000
NODE_5399_length_1072_cov_62.729702	533	613	2	73	80	0.9125000
NODE_5400_length_1072_cov_34.045221	430	510	0	37	80	0.4625000
NODE_5400_length_1072_cov_34.045221	430	510	2	43	80	0.5375000
NODE_5400_length_1072_cov_34.045221	483	563	0	80	80	1.0000000
NODE_5401_length_1072_cov_34.006166	342	423	0	23	81	0.2839506
NODE_5401_length_1072_cov_34.006166	342	423	2	58	81	0.7160494
NODE_5401_length_1072_cov_34.006166	396	476	0	68	80	0.8500000
NODE_5401_length_1072_cov_34.006166	396	476	2	4	80	0.0500000
NODE_5401_length_1072_cov_34.006166	396	476	8	8	80	0.1000000
NODE_5401_length_1072_cov_34.006166	472	552	8	74	80	0.9250000
NODE_5401_length_1072_cov_34.006166	472	552	12	6	80	0.0750000
NODE_5401_length_1072_cov_34.006166	525	605	8	21	80	0.2625000
NODE_5401_length_1072_cov_34.006166	525	605	12	59	80	0.7375000
NODE_5403_length_1072_cov_21.852004	300	380	0	3	80	0.0375000
NODE_5403_length_1072_cov_21.852004	300	380	2	77	80	0.9625000
NODE_5403_length_1072_cov_21.852004	353	433	0	3	80	0.0375000
NODE_5403_length_1072_cov_21.852004	353	433	2	77	80	0.9625000
NODE_5404_length_1072_cov_21.532374	476	556	0	31	80	0.3875000
NODE_5404_length_1072_cov_21.532374	476	556	2	49	80	0.6125000
NODE_5404_length_1072_cov_21.532374	529	609	0	16	80	0.2000000
NODE_5404_length_1072_cov_21.532374	529	609	2	64	80	0.8000000
NODE_5405_length_1072_cov_17.018499	415	495	0	65	80	0.8125000
NODE_5405_length_1072_cov_17.018499	415	495	2	15	80	0.1875000
NODE_5405_length_1072_cov_17.018499	468	548	0	80	80	1.0000000
NODE_5410_length_1072_cov_3.302158	388	449	2	23	61	0.3770492
NODE_5410_length_1072_cov_3.302158	388	449	4	38	61	0.6229508
NODE_5410_length_1072_cov_3.302158	422	502	2	52	80	0.6500000
NODE_5410_length_1072_cov_3.302158	422	502	4	28	80	0.3500000
NODE_5414_length_1072_cov_1.773895	114	176	0	20	62	0.3225806
NODE_5414_length_1072_cov_1.773895	114	176	1	4	62	0.0645161
NODE_5414_length_1072_cov_1.773895	114	176	2	10	62	0.1612903
NODE_5414_length_1072_cov_1.773895	114	176	6	26	62	0.4193548
NODE_5414_length_1072_cov_1.773895	114	176	8	2	62	0.0322581
NODE_5417_length_1071_cov_27.565844	312	392	0	80	80	1.0000000
NODE_5417_length_1071_cov_27.565844	365	445	0	80	80	1.0000000
NODE_5419_length_1071_cov_12.666667	480	560	0	80	80	1.0000000
NODE_5419_length_1071_cov_12.666667	533	613	0	80	80	1.0000000
NODE_5421_length_1071_cov_8.942387	418	498	0	80	80	1.0000000
NODE_5421_length_1071_cov_8.942387	471	551	0	80	80	1.0000000
NODE_5427_length_1070_cov_39.255407	591	671	0	80	80	1.0000000
NODE_5427_length_1070_cov_39.255407	644	724	0	80	80	1.0000000
NODE_5428_length_1070_cov_21.903193	430	510	0	39	80	0.4875000
NODE_5428_length_1070_cov_21.903193	430	510	2	41	80	0.5125000
NODE_5428_length_1070_cov_21.903193	483	563	0	80	80	1.0000000
NODE_5428_length_1070_cov_21.903193	559	639	0	55	80	0.6875000
NODE_5428_length_1070_cov_21.903193	559	639	5	3	80	0.0375000
NODE_5428_length_1070_cov_21.903193	559	639	6	22	80	0.2750000
NODE_5428_length_1070_cov_21.903193	612	692	0	2	80	0.0250000
NODE_5428_length_1070_cov_21.903193	612	692	5	3	80	0.0375000
NODE_5428_length_1070_cov_21.903193	612	692	6	75	80	0.9375000
NODE_5429_length_1070_cov_8.963955	871	900	10	5	29	0.1724138
NODE_5429_length_1070_cov_8.963955	871	900	20	1	29	0.0344828
NODE_5429_length_1070_cov_8.963955	871	900	22	1	29	0.0344828
NODE_5429_length_1070_cov_8.963955	871	900	24	1	29	0.0344828
NODE_5429_length_1070_cov_8.963955	871	900	27	2	29	0.0689655
NODE_5429_length_1070_cov_8.963955	871	900	34	1	29	0.0344828
NODE_5429_length_1070_cov_8.963955	871	900	37	1	29	0.0344828
NODE_5429_length_1070_cov_8.963955	871	900	39	2	29	0.0689655
NODE_5429_length_1070_cov_8.963955	871	900	41	3	29	0.1034483
NODE_5429_length_1070_cov_8.963955	871	900	45	4	29	0.1379310
NODE_5429_length_1070_cov_8.963955	871	900	47	1	29	0.0344828
NODE_5429_length_1070_cov_8.963955	871	900	51	1	29	0.0344828
NODE_5429_length_1070_cov_8.963955	871	900	57	1	29	0.0344828
NODE_5429_length_1070_cov_8.963955	871	900	59	1	29	0.0344828
NODE_5429_length_1070_cov_8.963955	871	900	62	1	29	0.0344828
NODE_5429_length_1070_cov_8.963955	871	900	64	2	29	0.0689655
NODE_5429_length_1070_cov_8.963955	871	900	66	1	29	0.0344828
NODE_5429_length_1070_cov_8.963955	873	953	10	3	80	0.0375000
NODE_5429_length_1070_cov_8.963955	873	953	20	1	80	0.0125000
NODE_5429_length_1070_cov_8.963955	873	953	22	1	80	0.0125000
NODE_5429_length_1070_cov_8.963955	873	953	24	1	80	0.0125000
NODE_5429_length_1070_cov_8.963955	873	953	27	2	80	0.0250000
NODE_5429_length_1070_cov_8.963955	873	953	34	1	80	0.0125000
NODE_5429_length_1070_cov_8.963955	873	953	37	1	80	0.0125000
NODE_5429_length_1070_cov_8.963955	873	953	39	2	80	0.0250000
NODE_5429_length_1070_cov_8.963955	873	953	41	3	80	0.0375000
NODE_5429_length_1070_cov_8.963955	873	953	45	4	80	0.0500000
NODE_5429_length_1070_cov_8.963955	873	953	47	1	80	0.0125000
NODE_5429_length_1070_cov_8.963955	873	953	51	1	80	0.0125000
NODE_5429_length_1070_cov_8.963955	873	953	57	1	80	0.0125000
NODE_5429_length_1070_cov_8.963955	873	953	59	1	80	0.0125000
NODE_5429_length_1070_cov_8.963955	873	953	62	1	80	0.0125000
NODE_5429_length_1070_cov_8.963955	873	953	64	2	80	0.0250000
NODE_5429_length_1070_cov_8.963955	873	953	66	2	80	0.0250000
NODE_5429_length_1070_cov_8.963955	873	953	68	1	80	0.0125000
NODE_5429_length_1070_cov_8.963955	873	953	70	1	80	0.0125000
NODE_5429_length_1070_cov_8.963955	873	953	72	1	80	0.0125000
NODE_5429_length_1070_cov_8.963955	873	953	78	1	80	0.0125000
NODE_5429_length_1070_cov_8.963955	873	953	82	1	80	0.0125000
NODE_5429_length_1070_cov_8.963955	873	953	84	1	80	0.0125000
NODE_5429_length_1070_cov_8.963955	873	953	86	1	80	0.0125000
NODE_5429_length_1070_cov_8.963955	873	953	90	1	80	0.0125000
NODE_5429_length_1070_cov_8.963955	873	953	92	2	80	0.0250000
NODE_5429_length_1070_cov_8.963955	873	953	98	1	80	0.0125000
NODE_5429_length_1070_cov_8.963955	873	953	100	1	80	0.0125000
NODE_5429_length_1070_cov_8.963955	873	953	108	1	80	0.0125000
NODE_5429_length_1070_cov_8.963955	873	953	114	2	80	0.0250000
NODE_5429_length_1070_cov_8.963955	873	953	116	1	80	0.0125000
NODE_5429_length_1070_cov_8.963955	873	953	118	2	80	0.0250000
NODE_5429_length_1070_cov_8.963955	873	953	122	2	80	0.0250000
NODE_5429_length_1070_cov_8.963955	873	953	124	3	80	0.0375000
NODE_5429_length_1070_cov_8.963955	873	953	129	1	80	0.0125000
NODE_5429_length_1070_cov_8.963955	873	953	130	4	80	0.0500000
NODE_5429_length_1070_cov_8.963955	873	953	134	1	80	0.0125000
NODE_5429_length_1070_cov_8.963955	873	953	140	2	80	0.0250000
NODE_5429_length_1070_cov_8.963955	873	953	148	1	80	0.0125000
NODE_5429_length_1070_cov_8.963955	873	953	150	20	80	0.2500000
NODE_5433_length_1070_cov_1.659114	1027	1046	2	19	19	1.0000000
NODE_5439_length_1069_cov_40.277320	451	531	10	39	80	0.4875000
NODE_5439_length_1069_cov_40.277320	451	531	12	15	80	0.1875000
NODE_5439_length_1069_cov_40.277320	451	531	14	26	80	0.3250000
NODE_5439_length_1069_cov_40.277320	504	584	6	5	80	0.0625000
NODE_5439_length_1069_cov_40.277320	504	584	9	35	80	0.4375000
NODE_5439_length_1069_cov_40.277320	504	584	10	1	80	0.0125000
NODE_5439_length_1069_cov_40.277320	504	584	12	15	80	0.1875000
NODE_5439_length_1069_cov_40.277320	504	584	13	9	80	0.1125000
NODE_5439_length_1069_cov_40.277320	504	584	14	12	80	0.1500000
NODE_5439_length_1069_cov_40.277320	504	584	15	1	80	0.0125000
NODE_5439_length_1069_cov_40.277320	504	584	16	2	80	0.0250000
NODE_5440_length_1069_cov_23.571134	274	354	0	1	80	0.0125000
NODE_5440_length_1069_cov_23.571134	274	354	2	79	80	0.9875000
NODE_5440_length_1069_cov_23.571134	327	407	0	54	80	0.6750000
NODE_5440_length_1069_cov_23.571134	327	407	2	26	80	0.3250000
NODE_5441_length_1069_cov_22.436082	185	265	0	80	80	1.0000000
NODE_5441_length_1069_cov_22.436082	238	318	0	80	80	1.0000000
NODE_5442_length_1069_cov_18.207216	436	516	4	5	80	0.0625000
NODE_5442_length_1069_cov_18.207216	436	516	8	37	80	0.4625000
NODE_5442_length_1069_cov_18.207216	436	516	10	9	80	0.1125000
NODE_5442_length_1069_cov_18.207216	436	516	12	22	80	0.2750000
NODE_5442_length_1069_cov_18.207216	436	516	16	7	80	0.0875000
NODE_5442_length_1069_cov_18.207216	489	569	10	1	80	0.0125000
NODE_5442_length_1069_cov_18.207216	489	569	12	24	80	0.3000000
NODE_5442_length_1069_cov_18.207216	489	569	14	8	80	0.1000000
NODE_5442_length_1069_cov_18.207216	489	569	16	24	80	0.3000000
NODE_5442_length_1069_cov_18.207216	489	569	18	23	80	0.2875000
NODE_5443_length_1069_cov_17.601031	596	676	0	28	80	0.3500000
NODE_5443_length_1069_cov_17.601031	596	676	2	2	80	0.0250000
NODE_5443_length_1069_cov_17.601031	596	676	4	4	80	0.0500000
NODE_5443_length_1069_cov_17.601031	596	676	6	40	80	0.5000000
NODE_5443_length_1069_cov_17.601031	596	676	8	6	80	0.0750000
NODE_5443_length_1069_cov_17.601031	649	729	4	9	80	0.1125000
NODE_5443_length_1069_cov_17.601031	649	729	6	23	80	0.2875000
NODE_5443_length_1069_cov_17.601031	649	729	8	31	80	0.3875000
NODE_5443_length_1069_cov_17.601031	649	729	10	17	80	0.2125000
NODE_5444_length_1069_cov_16.318557	353	433	0	16	80	0.2000000
NODE_5444_length_1069_cov_16.318557	353	433	2	64	80	0.8000000
NODE_5444_length_1069_cov_16.318557	406	486	0	69	80	0.8625000
NODE_5444_length_1069_cov_16.318557	406	486	2	11	80	0.1375000
NODE_5444_length_1069_cov_16.318557	482	562	0	80	80	1.0000000
NODE_5444_length_1069_cov_16.318557	535	615	0	80	80	1.0000000
NODE_5445_length_1069_cov_13.349485	471	551	0	9	80	0.1125000
NODE_5445_length_1069_cov_13.349485	471	551	2	71	80	0.8875000
NODE_5445_length_1069_cov_13.349485	524	604	0	32	80	0.4000000
NODE_5445_length_1069_cov_13.349485	524	604	2	48	80	0.6000000
NODE_5446_length_1069_cov_13.050515	314	394	0	14	80	0.1750000
NODE_5446_length_1069_cov_13.050515	314	394	2	6	80	0.0750000
NODE_5446_length_1069_cov_13.050515	314	394	10	60	80	0.7500000
NODE_5446_length_1069_cov_13.050515	367	447	0	67	80	0.8375000
NODE_5446_length_1069_cov_13.050515	367	447	2	6	80	0.0750000
NODE_5446_length_1069_cov_13.050515	367	447	10	7	80	0.0875000
NODE_5447_length_1069_cov_12.818557	240	320	0	80	80	1.0000000
NODE_5447_length_1069_cov_12.818557	293	373	0	80	80	1.0000000
NODE_5448_length_1069_cov_11.985567	554	634	0	80	80	1.0000000
NODE_5448_length_1069_cov_11.985567	607	687	0	80	80	1.0000000
NODE_5449_length_1069_cov_10.812371	366	446	0	29	80	0.3625000
NODE_5449_length_1069_cov_10.812371	366	446	2	51	80	0.6375000
NODE_5449_length_1069_cov_10.812371	419	499	2	48	80	0.6000000
NODE_5449_length_1069_cov_10.812371	419	499	4	32	80	0.4000000
NODE_5450_length_1069_cov_7.729897	482	562	0	80	80	1.0000000
NODE_5450_length_1069_cov_7.729897	535	615	0	80	80	1.0000000
NODE_5456_length_1068_cov_31.692466	314	394	0	73	80	0.9125000
NODE_5456_length_1068_cov_31.692466	314	394	2	7	80	0.0875000
NODE_5456_length_1068_cov_31.692466	367	447	0	80	80	1.0000000
NODE_5456_length_1068_cov_31.692466	443	523	0	39	80	0.4875000
NODE_5456_length_1068_cov_31.692466	443	523	4	41	80	0.5125000
NODE_5456_length_1068_cov_31.692466	496	576	0	21	80	0.2625000
NODE_5456_length_1068_cov_31.692466	496	576	4	59	80	0.7375000
NODE_5457_length_1068_cov_29.579979	347	427	6	1	80	0.0125000
NODE_5457_length_1068_cov_29.579979	347	427	8	4	80	0.0500000
NODE_5457_length_1068_cov_29.579979	347	427	17	38	80	0.4750000
NODE_5457_length_1068_cov_29.579979	347	427	18	37	80	0.4625000
NODE_5457_length_1068_cov_29.579979	400	480	0	44	80	0.5500000
NODE_5457_length_1068_cov_29.579979	400	480	9	2	80	0.0250000
NODE_5457_length_1068_cov_29.579979	400	480	11	3	80	0.0375000
NODE_5457_length_1068_cov_29.579979	400	480	17	31	80	0.3875000
NODE_5459_length_1068_cov_23.020640	476	556	0	48	80	0.6000000
NODE_5459_length_1068_cov_23.020640	476	556	8	7	80	0.0875000
NODE_5459_length_1068_cov_23.020640	476	556	12	15	80	0.1875000
NODE_5459_length_1068_cov_23.020640	476	556	14	10	80	0.1250000
NODE_5459_length_1068_cov_23.020640	529	609	8	2	80	0.0250000
NODE_5459_length_1068_cov_23.020640	529	609	11	6	80	0.0750000
NODE_5459_length_1068_cov_23.020640	529	609	12	15	80	0.1875000
NODE_5459_length_1068_cov_23.020640	529	609	13	10	80	0.1250000
NODE_5459_length_1068_cov_23.020640	529	609	14	35	80	0.4375000
NODE_5459_length_1068_cov_23.020640	529	609	15	12	80	0.1500000
NODE_5460_length_1068_cov_15.272446	546	626	0	33	80	0.4125000
NODE_5460_length_1068_cov_15.272446	546	626	2	24	80	0.3000000
NODE_5460_length_1068_cov_15.272446	546	626	4	23	80	0.2875000
NODE_5460_length_1068_cov_15.272446	599	679	2	13	80	0.1625000
NODE_5460_length_1068_cov_15.272446	599	679	4	67	80	0.8375000
NODE_5461_length_1068_cov_13.557276	674	754	0	6	80	0.0750000
NODE_5461_length_1068_cov_13.557276	674	754	4	32	80	0.4000000
NODE_5461_length_1068_cov_13.557276	674	754	6	42	80	0.5250000
NODE_5461_length_1068_cov_13.557276	727	807	0	59	80	0.7375000
NODE_5461_length_1068_cov_13.557276	727	807	4	21	80	0.2625000
NODE_5479_length_1067_cov_48.282025	429	509	0	80	80	1.0000000
NODE_5479_length_1067_cov_48.282025	482	562	0	80	80	1.0000000
NODE_5480_length_1067_cov_41.111570	460	540	4	31	80	0.3875000
NODE_5480_length_1067_cov_41.111570	460	540	10	16	80	0.2000000
NODE_5480_length_1067_cov_41.111570	460	540	14	33	80	0.4125000
NODE_5480_length_1067_cov_41.111570	513	593	4	24	80	0.3000000
NODE_5480_length_1067_cov_41.111570	513	593	10	6	80	0.0750000
NODE_5480_length_1067_cov_41.111570	513	593	14	50	80	0.6250000
NODE_5481_length_1067_cov_39.109504	295	375	0	29	80	0.3625000
NODE_5481_length_1067_cov_39.109504	295	375	2	51	80	0.6375000
NODE_5481_length_1067_cov_39.109504	348	428	0	2	80	0.0250000
NODE_5481_length_1067_cov_39.109504	348	428	2	78	80	0.9750000
NODE_5481_length_1067_cov_39.109504	424	504	0	21	80	0.2625000
NODE_5481_length_1067_cov_39.109504	424	504	2	2	80	0.0250000
NODE_5481_length_1067_cov_39.109504	424	504	4	8	80	0.1000000
NODE_5481_length_1067_cov_39.109504	424	504	6	7	80	0.0875000
NODE_5481_length_1067_cov_39.109504	424	504	8	41	80	0.5125000
NODE_5481_length_1067_cov_39.109504	424	504	10	1	80	0.0125000
NODE_5481_length_1067_cov_39.109504	477	557	4	8	80	0.1000000
NODE_5481_length_1067_cov_39.109504	477	557	6	13	80	0.1625000
NODE_5481_length_1067_cov_39.109504	477	557	8	45	80	0.5625000
NODE_5481_length_1067_cov_39.109504	477	557	10	14	80	0.1750000
NODE_5482_length_1067_cov_35.426653	252	332	0	56	80	0.7000000
NODE_5482_length_1067_cov_35.426653	252	332	2	24	80	0.3000000
NODE_5482_length_1067_cov_35.426653	305	385	0	3	80	0.0375000
NODE_5482_length_1067_cov_35.426653	305	385	2	77	80	0.9625000
NODE_5483_length_1067_cov_29.467975	412	492	2	4	80	0.0500000
NODE_5483_length_1067_cov_29.467975	412	492	3	56	80	0.7000000
NODE_5483_length_1067_cov_29.467975	412	492	4	20	80	0.2500000
NODE_5483_length_1067_cov_29.467975	465	545	2	52	80	0.6500000
NODE_5483_length_1067_cov_29.467975	465	545	3	7	80	0.0875000
NODE_5483_length_1067_cov_29.467975	465	545	4	21	80	0.2625000
NODE_5484_length_1067_cov_20.738636	579	645	14	11	66	0.1666667
NODE_5484_length_1067_cov_20.738636	579	645	16	14	66	0.2121212
NODE_5484_length_1067_cov_20.738636	579	645	18	3	66	0.0454545
NODE_5484_length_1067_cov_20.738636	579	645	20	8	66	0.1212121
NODE_5484_length_1067_cov_20.738636	579	645	22	4	66	0.0606061
NODE_5484_length_1067_cov_20.738636	579	645	24	8	66	0.1212121
NODE_5484_length_1067_cov_20.738636	579	645	26	4	66	0.0606061
NODE_5484_length_1067_cov_20.738636	579	645	28	14	66	0.2121212
NODE_5484_length_1067_cov_20.738636	618	698	22	3	80	0.0375000
NODE_5484_length_1067_cov_20.738636	618	698	24	6	80	0.0750000
NODE_5484_length_1067_cov_20.738636	618	698	26	4	80	0.0500000
NODE_5484_length_1067_cov_20.738636	618	698	28	25	80	0.3125000
NODE_5484_length_1067_cov_20.738636	618	698	30	7	80	0.0875000
NODE_5484_length_1067_cov_20.738636	618	698	31	3	80	0.0375000
NODE_5484_length_1067_cov_20.738636	618	698	32	2	80	0.0250000
NODE_5484_length_1067_cov_20.738636	618	698	33	2	80	0.0250000
NODE_5484_length_1067_cov_20.738636	618	698	34	6	80	0.0750000
NODE_5484_length_1067_cov_20.738636	618	698	36	7	80	0.0875000
NODE_5484_length_1067_cov_20.738636	618	698	37	14	80	0.1750000
NODE_5484_length_1067_cov_20.738636	618	698	38	1	80	0.0125000
NODE_5485_length_1067_cov_15.280992	538	617	0	10	79	0.1265823
NODE_5485_length_1067_cov_15.280992	538	617	1	57	79	0.7215190
NODE_5485_length_1067_cov_15.280992	538	617	2	12	79	0.1518987
NODE_5485_length_1067_cov_15.280992	590	670	0	63	80	0.7875000
NODE_5485_length_1067_cov_15.280992	590	670	1	17	80	0.2125000
NODE_5486_length_1067_cov_13.708678	478	558	0	80	80	1.0000000
NODE_5486_length_1067_cov_13.708678	531	611	0	80	80	1.0000000
NODE_5488_length_1067_cov_9.070248	625	705	0	80	80	1.0000000
NODE_5488_length_1067_cov_9.070248	678	758	0	80	80	1.0000000
NODE_5494_length_1067_cov_1.946281	765	812	0	47	47	1.0000000
NODE_5501_length_1066_cov_54.227508	395	475	16	19	80	0.2375000
NODE_5501_length_1066_cov_54.227508	395	475	18	1	80	0.0125000
NODE_5501_length_1066_cov_54.227508	395	475	20	3	80	0.0375000
NODE_5501_length_1066_cov_54.227508	395	475	30	13	80	0.1625000
NODE_5501_length_1066_cov_54.227508	395	475	32	26	80	0.3250000
NODE_5501_length_1066_cov_54.227508	395	475	34	18	80	0.2250000
NODE_5501_length_1066_cov_54.227508	448	528	4	24	80	0.3000000
NODE_5501_length_1066_cov_54.227508	448	528	8	3	80	0.0375000
NODE_5501_length_1066_cov_54.227508	448	528	16	18	80	0.2250000
NODE_5501_length_1066_cov_54.227508	448	528	19	1	80	0.0125000
NODE_5501_length_1066_cov_54.227508	448	528	20	28	80	0.3500000
NODE_5501_length_1066_cov_54.227508	448	528	30	6	80	0.0750000
NODE_5502_length_1066_cov_33.501551	357	437	0	60	80	0.7500000
NODE_5502_length_1066_cov_33.501551	357	437	6	20	80	0.2500000
NODE_5502_length_1066_cov_33.501551	410	490	0	7	80	0.0875000
NODE_5502_length_1066_cov_33.501551	410	490	6	21	80	0.2625000
NODE_5502_length_1066_cov_33.501551	410	490	10	10	80	0.1250000
NODE_5502_length_1066_cov_33.501551	410	490	12	42	80	0.5250000
NODE_5503_length_1066_cov_33.115822	397	477	0	55	80	0.6875000
NODE_5503_length_1066_cov_33.115822	397	477	4	25	80	0.3125000
NODE_5503_length_1066_cov_33.115822	450	530	0	2	80	0.0250000
NODE_5503_length_1066_cov_33.115822	450	530	4	78	80	0.9750000
NODE_5504_length_1066_cov_26.517063	215	285	285	1	70	0.0142857
NODE_5504_length_1066_cov_26.517063	215	285	286	1	70	0.0142857
NODE_5504_length_1066_cov_26.517063	215	285	287	2	70	0.0285714
NODE_5504_length_1066_cov_26.517063	215	285	289	1	70	0.0142857
NODE_5504_length_1066_cov_26.517063	215	285	290	1	70	0.0142857
NODE_5504_length_1066_cov_26.517063	215	285	291	1	70	0.0142857
NODE_5504_length_1066_cov_26.517063	215	285	294	1	70	0.0142857
NODE_5504_length_1066_cov_26.517063	215	285	295	2	70	0.0285714
NODE_5504_length_1066_cov_26.517063	215	285	296	1	70	0.0142857
NODE_5504_length_1066_cov_26.517063	215	285	297	1	70	0.0142857
NODE_5504_length_1066_cov_26.517063	215	285	299	1	70	0.0142857
NODE_5504_length_1066_cov_26.517063	215	285	304	1	70	0.0142857
NODE_5504_length_1066_cov_26.517063	215	285	308	1	70	0.0142857
NODE_5504_length_1066_cov_26.517063	215	285	318	1	70	0.0142857
NODE_5504_length_1066_cov_26.517063	215	285	320	1	70	0.0142857
NODE_5504_length_1066_cov_26.517063	215	285	324	2	70	0.0285714
NODE_5504_length_1066_cov_26.517063	215	285	326	1	70	0.0142857
NODE_5504_length_1066_cov_26.517063	215	285	328	1	70	0.0142857
NODE_5504_length_1066_cov_26.517063	215	285	329	1	70	0.0142857
NODE_5504_length_1066_cov_26.517063	215	285	331	1	70	0.0142857
NODE_5504_length_1066_cov_26.517063	215	285	332	1	70	0.0142857
NODE_5504_length_1066_cov_26.517063	215	285	333	1	70	0.0142857
NODE_5504_length_1066_cov_26.517063	215	285	335	1	70	0.0142857
NODE_5504_length_1066_cov_26.517063	215	285	339	1	70	0.0142857
NODE_5504_length_1066_cov_26.517063	215	285	343	1	70	0.0142857
NODE_5504_length_1066_cov_26.517063	215	285	344	1	70	0.0142857
NODE_5504_length_1066_cov_26.517063	215	285	346	1	70	0.0142857
NODE_5504_length_1066_cov_26.517063	215	285	348	2	70	0.0285714
NODE_5504_length_1066_cov_26.517063	215	285	349	1	70	0.0142857
NODE_5504_length_1066_cov_26.517063	215	285	350	4	70	0.0571429
NODE_5504_length_1066_cov_26.517063	215	285	351	1	70	0.0142857
NODE_5504_length_1066_cov_26.517063	215	285	353	1	70	0.0142857
NODE_5504_length_1066_cov_26.517063	215	285	367	1	70	0.0142857
NODE_5504_length_1066_cov_26.517063	215	285	372	1	70	0.0142857
NODE_5504_length_1066_cov_26.517063	215	285	381	1	70	0.0142857
NODE_5504_length_1066_cov_26.517063	215	285	383	1	70	0.0142857
NODE_5504_length_1066_cov_26.517063	215	285	384	1	70	0.0142857
NODE_5504_length_1066_cov_26.517063	215	285	385	1	70	0.0142857
NODE_5504_length_1066_cov_26.517063	215	285	392	1	70	0.0142857
NODE_5504_length_1066_cov_26.517063	215	285	411	1	70	0.0142857
NODE_5504_length_1066_cov_26.517063	215	285	414	1	70	0.0142857
NODE_5504_length_1066_cov_26.517063	215	285	415	2	70	0.0285714
NODE_5504_length_1066_cov_26.517063	215	285	416	1	70	0.0142857
NODE_5504_length_1066_cov_26.517063	215	285	417	2	70	0.0285714
NODE_5504_length_1066_cov_26.517063	215	285	420	1	70	0.0142857
NODE_5504_length_1066_cov_26.517063	215	285	422	2	70	0.0285714
NODE_5504_length_1066_cov_26.517063	215	285	423	3	70	0.0428571
NODE_5504_length_1066_cov_26.517063	215	285	426	1	70	0.0142857
NODE_5504_length_1066_cov_26.517063	215	285	428	1	70	0.0142857
NODE_5504_length_1066_cov_26.517063	215	285	432	1	70	0.0142857
NODE_5504_length_1066_cov_26.517063	215	285	440	1	70	0.0142857
NODE_5504_length_1066_cov_26.517063	215	285	441	1	70	0.0142857
NODE_5504_length_1066_cov_26.517063	215	285	443	1	70	0.0142857
NODE_5504_length_1066_cov_26.517063	215	285	447	1	70	0.0142857
NODE_5504_length_1066_cov_26.517063	215	285	450	2	70	0.0285714
NODE_5504_length_1066_cov_26.517063	215	285	451	1	70	0.0142857
NODE_5504_length_1066_cov_26.517063	215	285	467	1	70	0.0142857
NODE_5505_length_1066_cov_16.906929	526	606	0	31	80	0.3875000
NODE_5505_length_1066_cov_16.906929	526	606	5	1	80	0.0125000
NODE_5505_length_1066_cov_16.906929	526	606	6	48	80	0.6000000
NODE_5505_length_1066_cov_16.906929	579	659	6	80	80	1.0000000
NODE_5506_length_1066_cov_16.190279	298	378	0	72	80	0.9000000
NODE_5506_length_1066_cov_16.190279	298	378	2	8	80	0.1000000
NODE_5506_length_1066_cov_16.190279	351	432	0	19	81	0.2345679
NODE_5506_length_1066_cov_16.190279	351	432	2	62	81	0.7654321
NODE_5507_length_1066_cov_15.444674	582	662	4	11	80	0.1375000
NODE_5507_length_1066_cov_15.444674	582	662	8	6	80	0.0750000
NODE_5507_length_1066_cov_15.444674	582	662	10	3	80	0.0375000
NODE_5507_length_1066_cov_15.444674	582	662	12	1	80	0.0125000
NODE_5507_length_1066_cov_15.444674	582	662	18	56	80	0.7000000
NODE_5507_length_1066_cov_15.444674	582	662	20	3	80	0.0375000
NODE_5507_length_1066_cov_15.444674	635	715	2	44	80	0.5500000
NODE_5507_length_1066_cov_15.444674	635	715	4	20	80	0.2500000
NODE_5507_length_1066_cov_15.444674	635	715	8	6	80	0.0750000
NODE_5507_length_1066_cov_15.444674	635	715	10	3	80	0.0375000
NODE_5507_length_1066_cov_15.444674	635	715	12	1	80	0.0125000
NODE_5507_length_1066_cov_15.444674	635	715	18	5	80	0.0625000
NODE_5507_length_1066_cov_15.444674	635	715	20	1	80	0.0125000
NODE_5516_length_1065_cov_51.693582	480	560	0	30	80	0.3750000
NODE_5516_length_1065_cov_51.693582	480	560	2	9	80	0.1125000
NODE_5516_length_1065_cov_51.693582	480	560	10	41	80	0.5125000
NODE_5516_length_1065_cov_51.693582	533	613	10	76	80	0.9500000
NODE_5516_length_1065_cov_51.693582	533	613	12	4	80	0.0500000
NODE_5517_length_1065_cov_33.428571	422	502	0	49	80	0.6125000
NODE_5517_length_1065_cov_33.428571	422	502	6	1	80	0.0125000
NODE_5517_length_1065_cov_33.428571	422	502	8	1	80	0.0125000
NODE_5517_length_1065_cov_33.428571	422	502	12	2	80	0.0250000
NODE_5517_length_1065_cov_33.428571	422	502	16	6	80	0.0750000
NODE_5517_length_1065_cov_33.428571	422	502	22	4	80	0.0500000
NODE_5517_length_1065_cov_33.428571	422	502	24	1	80	0.0125000
NODE_5517_length_1065_cov_33.428571	422	502	25	1	80	0.0125000
NODE_5517_length_1065_cov_33.428571	422	502	28	8	80	0.1000000
NODE_5517_length_1065_cov_33.428571	422	502	29	7	80	0.0875000
NODE_5517_length_1065_cov_33.428571	422	502	0	49	80	0.6125000
NODE_5517_length_1065_cov_33.428571	422	502	6	1	80	0.0125000
NODE_5517_length_1065_cov_33.428571	422	502	8	1	80	0.0125000
NODE_5517_length_1065_cov_33.428571	422	502	12	2	80	0.0250000
NODE_5517_length_1065_cov_33.428571	422	502	16	6	80	0.0750000
NODE_5517_length_1065_cov_33.428571	422	502	22	4	80	0.0500000
NODE_5517_length_1065_cov_33.428571	422	502	24	1	80	0.0125000
NODE_5517_length_1065_cov_33.428571	422	502	25	1	80	0.0125000
NODE_5517_length_1065_cov_33.428571	422	502	28	8	80	0.1000000
NODE_5517_length_1065_cov_33.428571	422	502	29	7	80	0.0875000
NODE_5517_length_1065_cov_33.428571	422	502	0	49	80	0.6125000
NODE_5517_length_1065_cov_33.428571	422	502	6	1	80	0.0125000
NODE_5517_length_1065_cov_33.428571	422	502	8	1	80	0.0125000
NODE_5517_length_1065_cov_33.428571	422	502	12	2	80	0.0250000
NODE_5517_length_1065_cov_33.428571	422	502	16	6	80	0.0750000
NODE_5517_length_1065_cov_33.428571	422	502	22	4	80	0.0500000
NODE_5517_length_1065_cov_33.428571	422	502	24	1	80	0.0125000
NODE_5517_length_1065_cov_33.428571	422	502	25	1	80	0.0125000
NODE_5517_length_1065_cov_33.428571	422	502	28	8	80	0.1000000
NODE_5517_length_1065_cov_33.428571	422	502	29	7	80	0.0875000
NODE_5517_length_1065_cov_33.428571	475	555	16	6	80	0.0750000
NODE_5517_length_1065_cov_33.428571	475	555	22	4	80	0.0500000
NODE_5517_length_1065_cov_33.428571	475	555	24	1	80	0.0125000
NODE_5517_length_1065_cov_33.428571	475	555	25	1	80	0.0125000
NODE_5517_length_1065_cov_33.428571	475	555	26	2	80	0.0250000
NODE_5517_length_1065_cov_33.428571	475	555	27	4	80	0.0500000
NODE_5517_length_1065_cov_33.428571	475	555	28	8	80	0.1000000
NODE_5517_length_1065_cov_33.428571	475	555	29	20	80	0.2500000
NODE_5517_length_1065_cov_33.428571	475	555	31	34	80	0.4250000
NODE_5517_length_1065_cov_33.428571	475	555	16	6	80	0.0750000
NODE_5517_length_1065_cov_33.428571	475	555	22	4	80	0.0500000
NODE_5517_length_1065_cov_33.428571	475	555	24	1	80	0.0125000
NODE_5517_length_1065_cov_33.428571	475	555	25	1	80	0.0125000
NODE_5517_length_1065_cov_33.428571	475	555	26	2	80	0.0250000
NODE_5517_length_1065_cov_33.428571	475	555	27	4	80	0.0500000
NODE_5517_length_1065_cov_33.428571	475	555	28	8	80	0.1000000
NODE_5517_length_1065_cov_33.428571	475	555	29	20	80	0.2500000
NODE_5517_length_1065_cov_33.428571	475	555	31	34	80	0.4250000
NODE_5517_length_1065_cov_33.428571	551	631	26	1	80	0.0125000
NODE_5517_length_1065_cov_33.428571	551	631	27	14	80	0.1750000
NODE_5517_length_1065_cov_33.428571	551	631	34	17	80	0.2125000
NODE_5517_length_1065_cov_33.428571	551	631	35	1	80	0.0125000
NODE_5517_length_1065_cov_33.428571	551	631	36	1	80	0.0125000
NODE_5517_length_1065_cov_33.428571	551	631	37	9	80	0.1125000
NODE_5517_length_1065_cov_33.428571	551	631	38	8	80	0.1000000
NODE_5517_length_1065_cov_33.428571	551	631	42	15	80	0.1875000
NODE_5517_length_1065_cov_33.428571	551	631	44	1	80	0.0125000
NODE_5517_length_1065_cov_33.428571	551	631	45	4	80	0.0500000
NODE_5517_length_1065_cov_33.428571	551	631	47	9	80	0.1125000
NODE_5517_length_1065_cov_33.428571	551	631	26	1	80	0.0125000
NODE_5517_length_1065_cov_33.428571	551	631	27	14	80	0.1750000
NODE_5517_length_1065_cov_33.428571	551	631	34	17	80	0.2125000
NODE_5517_length_1065_cov_33.428571	551	631	35	1	80	0.0125000
NODE_5517_length_1065_cov_33.428571	551	631	36	1	80	0.0125000
NODE_5517_length_1065_cov_33.428571	551	631	37	9	80	0.1125000
NODE_5517_length_1065_cov_33.428571	551	631	38	8	80	0.1000000
NODE_5517_length_1065_cov_33.428571	551	631	42	15	80	0.1875000
NODE_5517_length_1065_cov_33.428571	551	631	44	1	80	0.0125000
NODE_5517_length_1065_cov_33.428571	551	631	45	4	80	0.0500000
NODE_5517_length_1065_cov_33.428571	551	631	47	9	80	0.1125000
NODE_5517_length_1065_cov_33.428571	551	572	26	1	21	0.0476190
NODE_5517_length_1065_cov_33.428571	551	572	27	14	21	0.6666667
NODE_5517_length_1065_cov_33.428571	551	572	34	2	21	0.0952381
NODE_5517_length_1065_cov_33.428571	551	572	35	1	21	0.0476190
NODE_5517_length_1065_cov_33.428571	551	572	38	3	21	0.1428571
NODE_5517_length_1065_cov_33.428571	604	666	24	8	62	0.1290323
NODE_5517_length_1065_cov_33.428571	604	666	26	17	62	0.2741936
NODE_5517_length_1065_cov_33.428571	604	666	27	2	62	0.0322581
NODE_5517_length_1065_cov_33.428571	604	666	28	4	62	0.0645161
NODE_5517_length_1065_cov_33.428571	604	666	29	4	62	0.0645161
NODE_5517_length_1065_cov_33.428571	604	666	36	1	62	0.0161290
NODE_5517_length_1065_cov_33.428571	604	666	37	9	62	0.1451613
NODE_5517_length_1065_cov_33.428571	604	666	42	3	62	0.0483871
NODE_5517_length_1065_cov_33.428571	604	666	44	1	62	0.0161290
NODE_5517_length_1065_cov_33.428571	604	666	45	4	62	0.0645161
NODE_5517_length_1065_cov_33.428571	604	666	47	9	62	0.1451613
NODE_5517_length_1065_cov_33.428571	604	684	14	1	80	0.0125000
NODE_5517_length_1065_cov_33.428571	604	684	16	4	80	0.0500000
NODE_5517_length_1065_cov_33.428571	604	684	18	4	80	0.0500000
NODE_5517_length_1065_cov_33.428571	604	684	22	1	80	0.0125000
NODE_5517_length_1065_cov_33.428571	604	684	24	8	80	0.1000000
NODE_5517_length_1065_cov_33.428571	604	684	26	17	80	0.2125000
NODE_5517_length_1065_cov_33.428571	604	684	27	2	80	0.0250000
NODE_5517_length_1065_cov_33.428571	604	684	28	12	80	0.1500000
NODE_5517_length_1065_cov_33.428571	604	684	29	4	80	0.0500000
NODE_5517_length_1065_cov_33.428571	604	684	36	1	80	0.0125000
NODE_5517_length_1065_cov_33.428571	604	684	37	9	80	0.1125000
NODE_5517_length_1065_cov_33.428571	604	684	42	3	80	0.0375000
NODE_5517_length_1065_cov_33.428571	604	684	44	1	80	0.0125000
NODE_5517_length_1065_cov_33.428571	604	684	45	4	80	0.0500000
NODE_5517_length_1065_cov_33.428571	604	684	47	9	80	0.1125000
NODE_5518_length_1065_cov_31.874741	255	335	0	80	80	1.0000000
NODE_5518_length_1065_cov_31.874741	308	388	0	80	80	1.0000000
NODE_5519_length_1065_cov_21.762940	234	314	0	53	80	0.6625000
NODE_5519_length_1065_cov_21.762940	234	314	2	27	80	0.3375000
NODE_5519_length_1065_cov_21.762940	287	367	0	4	80	0.0500000
NODE_5519_length_1065_cov_21.762940	287	367	1	4	80	0.0500000
NODE_5519_length_1065_cov_21.762940	287	367	2	72	80	0.9000000
NODE_5520_length_1065_cov_19.947205	447	527	0	7	80	0.0875000
NODE_5520_length_1065_cov_19.947205	447	527	2	11	80	0.1375000
NODE_5520_length_1065_cov_19.947205	447	527	4	40	80	0.5000000
NODE_5520_length_1065_cov_19.947205	447	527	6	22	80	0.2750000
NODE_5520_length_1065_cov_19.947205	500	580	0	2	80	0.0250000
NODE_5520_length_1065_cov_19.947205	500	580	2	4	80	0.0500000
NODE_5520_length_1065_cov_19.947205	500	580	4	26	80	0.3250000
NODE_5520_length_1065_cov_19.947205	500	580	6	48	80	0.6000000
NODE_5521_length_1065_cov_14.590062	343	423	2	14	80	0.1750000
NODE_5521_length_1065_cov_14.590062	343	423	4	11	80	0.1375000
NODE_5521_length_1065_cov_14.590062	343	423	6	55	80	0.6875000
NODE_5521_length_1065_cov_14.590062	396	476	0	47	80	0.5875000
NODE_5521_length_1065_cov_14.590062	396	476	2	20	80	0.2500000
NODE_5521_length_1065_cov_14.590062	396	476	4	1	80	0.0125000
NODE_5521_length_1065_cov_14.590062	396	476	6	12	80	0.1500000
NODE_5522_length_1065_cov_13.232919	243	323	2	2	80	0.0250000
NODE_5522_length_1065_cov_13.232919	243	323	4	2	80	0.0250000
NODE_5522_length_1065_cov_13.232919	243	323	5	4	80	0.0500000
NODE_5522_length_1065_cov_13.232919	243	323	6	12	80	0.1500000
NODE_5522_length_1065_cov_13.232919	243	323	8	60	80	0.7500000
NODE_5522_length_1065_cov_13.232919	296	376	0	28	80	0.3500000
NODE_5522_length_1065_cov_13.232919	296	376	2	10	80	0.1250000
NODE_5522_length_1065_cov_13.232919	296	376	4	17	80	0.2125000
NODE_5522_length_1065_cov_13.232919	296	376	8	25	80	0.3125000
NODE_5523_length_1065_cov_10.670807	481	561	0	68	80	0.8500000
NODE_5523_length_1065_cov_10.670807	481	561	2	12	80	0.1500000
NODE_5523_length_1065_cov_10.670807	534	614	0	15	80	0.1875000
NODE_5523_length_1065_cov_10.670807	534	614	2	65	80	0.8125000
NODE_5524_length_1065_cov_10.473085	496	576	0	27	80	0.3375000
NODE_5524_length_1065_cov_10.473085	496	576	2	53	80	0.6625000
NODE_5524_length_1065_cov_10.473085	549	629	0	64	80	0.8000000
NODE_5524_length_1065_cov_10.473085	549	629	2	16	80	0.2000000
NODE_5525_length_1065_cov_9.711180	286	360	0	36	74	0.4864865
NODE_5525_length_1065_cov_9.711180	286	360	2	7	74	0.0945946
NODE_5525_length_1065_cov_9.711180	286	360	3	31	74	0.4189189
NODE_5525_length_1065_cov_9.711180	339	419	3	45	80	0.5625000
NODE_5525_length_1065_cov_9.711180	339	419	4	35	80	0.4375000
NODE_5534_length_1064_cov_59.929534	457	537	0	80	80	1.0000000
NODE_5534_length_1064_cov_59.929534	510	590	0	75	80	0.9375000
NODE_5534_length_1064_cov_59.929534	510	590	2	5	80	0.0625000
NODE_5534_length_1064_cov_59.929534	586	666	2	46	80	0.5750000
NODE_5534_length_1064_cov_59.929534	586	666	4	34	80	0.4250000
NODE_5534_length_1064_cov_59.929534	639	719	2	31	80	0.3875000
NODE_5534_length_1064_cov_59.929534	639	719	4	49	80	0.6125000
NODE_5535_length_1064_cov_36.480829	367	447	0	61	80	0.7625000
NODE_5535_length_1064_cov_36.480829	367	447	4	19	80	0.2375000
NODE_5535_length_1064_cov_36.480829	420	500	0	8	80	0.1000000
NODE_5535_length_1064_cov_36.480829	420	500	4	72	80	0.9000000
NODE_5535_length_1064_cov_36.480829	496	576	0	26	80	0.3250000
NODE_5535_length_1064_cov_36.480829	496	576	4	24	80	0.3000000
NODE_5535_length_1064_cov_36.480829	496	576	6	27	80	0.3375000
NODE_5535_length_1064_cov_36.480829	496	576	8	3	80	0.0375000
NODE_5535_length_1064_cov_36.480829	549	629	2	6	80	0.0750000
NODE_5535_length_1064_cov_36.480829	549	629	6	24	80	0.3000000
NODE_5535_length_1064_cov_36.480829	549	629	8	50	80	0.6250000
NODE_5536_length_1064_cov_32.307772	547	627	8	34	80	0.4250000
NODE_5536_length_1064_cov_32.307772	547	627	14	13	80	0.1625000
NODE_5536_length_1064_cov_32.307772	547	627	29	8	80	0.1000000
NODE_5536_length_1064_cov_32.307772	547	627	33	6	80	0.0750000
NODE_5536_length_1064_cov_32.307772	547	627	35	6	80	0.0750000
NODE_5536_length_1064_cov_32.307772	547	627	36	2	80	0.0250000
NODE_5536_length_1064_cov_32.307772	547	627	37	10	80	0.1250000
NODE_5536_length_1064_cov_32.307772	547	627	38	1	80	0.0125000
NODE_5536_length_1064_cov_32.307772	600	680	29	2	80	0.0250000
NODE_5536_length_1064_cov_32.307772	600	680	33	6	80	0.0750000
NODE_5536_length_1064_cov_32.307772	600	680	35	6	80	0.0750000
NODE_5536_length_1064_cov_32.307772	600	680	36	2	80	0.0250000
NODE_5536_length_1064_cov_32.307772	600	680	37	10	80	0.1250000
NODE_5536_length_1064_cov_32.307772	600	680	38	5	80	0.0625000
NODE_5536_length_1064_cov_32.307772	600	680	41	2	80	0.0250000
NODE_5536_length_1064_cov_32.307772	600	680	43	5	80	0.0625000
NODE_5536_length_1064_cov_32.307772	600	680	45	26	80	0.3250000
NODE_5536_length_1064_cov_32.307772	600	680	46	16	80	0.2000000
NODE_5537_length_1064_cov_25.255959	462	542	0	80	80	1.0000000
NODE_5537_length_1064_cov_25.255959	515	595	0	80	80	1.0000000
NODE_5537_length_1064_cov_25.255959	591	671	0	43	80	0.5375000
NODE_5537_length_1064_cov_25.255959	591	671	2	36	80	0.4500000
NODE_5537_length_1064_cov_25.255959	591	671	4	1	80	0.0125000
NODE_5537_length_1064_cov_25.255959	644	724	2	26	80	0.3250000
NODE_5537_length_1064_cov_25.255959	644	724	4	24	80	0.3000000
NODE_5537_length_1064_cov_25.255959	644	724	6	29	80	0.3625000
NODE_5537_length_1064_cov_25.255959	644	724	8	1	80	0.0125000
NODE_5538_length_1064_cov_23.053886	343	423	0	2	80	0.0250000
NODE_5538_length_1064_cov_23.053886	343	423	2	78	80	0.9750000
NODE_5538_length_1064_cov_23.053886	396	476	0	55	80	0.6875000
NODE_5538_length_1064_cov_23.053886	396	476	2	25	80	0.3125000
NODE_5538_length_1064_cov_23.053886	472	552	0	27	80	0.3375000
NODE_5538_length_1064_cov_23.053886	472	552	6	53	80	0.6625000
NODE_5538_length_1064_cov_23.053886	525	605	4	16	80	0.2000000
NODE_5538_length_1064_cov_23.053886	525	605	6	31	80	0.3875000
NODE_5538_length_1064_cov_23.053886	525	605	10	33	80	0.4125000
NODE_5539_length_1064_cov_22.018653	479	559	0	80	80	1.0000000
NODE_5539_length_1064_cov_22.018653	532	612	0	80	80	1.0000000
NODE_5540_length_1064_cov_12.868394	424	504	0	80	80	1.0000000
NODE_5540_length_1064_cov_12.868394	477	557	0	80	80	1.0000000
NODE_5541_length_1064_cov_10.098446	467	547	0	25	80	0.3125000
NODE_5541_length_1064_cov_10.098446	467	547	2	29	80	0.3625000
NODE_5541_length_1064_cov_10.098446	467	547	4	2	80	0.0250000
NODE_5541_length_1064_cov_10.098446	467	547	5	24	80	0.3000000
NODE_5541_length_1064_cov_10.098446	520	600	2	1	80	0.0125000
NODE_5541_length_1064_cov_10.098446	520	600	3	23	80	0.2875000
NODE_5541_length_1064_cov_10.098446	520	600	4	2	80	0.0250000
NODE_5541_length_1064_cov_10.098446	520	600	5	54	80	0.6750000
NODE_5543_length_1064_cov_2.925389	173	245	4	25	72	0.3472222
NODE_5543_length_1064_cov_2.925389	173	245	6	19	72	0.2638889
NODE_5543_length_1064_cov_2.925389	173	245	7	2	72	0.0277778
NODE_5543_length_1064_cov_2.925389	173	245	8	3	72	0.0416667
NODE_5543_length_1064_cov_2.925389	173	245	10	1	72	0.0138889
NODE_5543_length_1064_cov_2.925389	173	245	12	4	72	0.0555556
NODE_5543_length_1064_cov_2.925389	173	245	14	2	72	0.0277778
NODE_5543_length_1064_cov_2.925389	173	245	18	7	72	0.0972222
NODE_5543_length_1064_cov_2.925389	173	245	22	3	72	0.0416667
NODE_5543_length_1064_cov_2.925389	173	245	26	3	72	0.0416667
NODE_5543_length_1064_cov_2.925389	173	245	28	3	72	0.0416667
NODE_5551_length_1063_cov_104.615145	504	584	0	80	80	1.0000000
NODE_5551_length_1063_cov_104.615145	557	637	0	29	80	0.3625000
NODE_5551_length_1063_cov_104.615145	557	637	9	28	80	0.3500000
NODE_5551_length_1063_cov_104.615145	557	637	10	12	80	0.1500000
NODE_5551_length_1063_cov_104.615145	557	637	12	11	80	0.1375000
NODE_5552_length_1063_cov_36.515560	482	562	0	47	80	0.5875000
NODE_5552_length_1063_cov_36.515560	482	562	2	33	80	0.4125000
NODE_5552_length_1063_cov_36.515560	535	615	0	7	80	0.0875000
NODE_5552_length_1063_cov_36.515560	535	615	2	73	80	0.9125000
NODE_5552_length_1063_cov_36.515560	611	691	0	80	80	1.0000000
NODE_5552_length_1063_cov_36.515560	664	744	0	80	80	1.0000000
NODE_5553_length_1063_cov_30.700207	470	550	0	80	80	1.0000000
NODE_5553_length_1063_cov_30.700207	523	603	0	80	80	1.0000000
NODE_5553_length_1063_cov_30.700207	599	679	0	55	80	0.6875000
NODE_5553_length_1063_cov_30.700207	599	679	2	25	80	0.3125000
NODE_5553_length_1063_cov_30.700207	652	732	0	6	80	0.0750000
NODE_5553_length_1063_cov_30.700207	652	732	2	74	80	0.9250000
NODE_5554_length_1063_cov_24.552905	362	442	0	80	80	1.0000000
NODE_5554_length_1063_cov_24.552905	415	495	0	80	80	1.0000000
NODE_5555_length_1063_cov_21.985477	407	487	0	1	80	0.0125000
NODE_5555_length_1063_cov_21.985477	407	487	4	79	80	0.9875000
NODE_5555_length_1063_cov_21.985477	460	540	0	54	80	0.6750000
NODE_5555_length_1063_cov_21.985477	460	540	4	26	80	0.3250000
NODE_5555_length_1063_cov_21.985477	536	616	0	80	80	1.0000000
NODE_5555_length_1063_cov_21.985477	589	670	0	81	81	1.0000000
NODE_5557_length_1063_cov_15.400415	685	765	0	34	80	0.4250000
NODE_5557_length_1063_cov_15.400415	685	765	2	46	80	0.5750000
NODE_5557_length_1063_cov_15.400415	738	818	0	22	80	0.2750000
NODE_5557_length_1063_cov_15.400415	738	818	2	58	80	0.7250000
NODE_5558_length_1063_cov_13.282158	510	590	0	80	80	1.0000000
NODE_5558_length_1063_cov_13.282158	563	643	0	42	80	0.5250000
NODE_5558_length_1063_cov_13.282158	563	643	2	38	80	0.4750000
NODE_5559_length_1063_cov_12.970954	417	495	0	78	78	1.0000000
NODE_5559_length_1063_cov_12.970954	468	548	0	80	80	1.0000000
NODE_5560_length_1063_cov_7.917012	639	719	0	80	80	1.0000000
NODE_5560_length_1063_cov_7.917012	692	772	0	80	80	1.0000000
NODE_5569_length_1063_cov_1.695021	893	947	18	4	54	0.0740741
NODE_5569_length_1063_cov_1.695021	893	947	22	6	54	0.1111111
NODE_5569_length_1063_cov_1.695021	893	947	24	12	54	0.2222222
NODE_5569_length_1063_cov_1.695021	893	947	26	32	54	0.5925926
NODE_5574_length_1062_cov_43.399792	272	352	0	80	80	1.0000000
NODE_5574_length_1062_cov_43.399792	325	405	0	80	80	1.0000000
NODE_5576_length_1062_cov_19.778816	401	481	11	11	80	0.1375000
NODE_5576_length_1062_cov_19.778816	401	481	13	5	80	0.0625000
NODE_5576_length_1062_cov_19.778816	401	481	15	11	80	0.1375000
NODE_5576_length_1062_cov_19.778816	401	481	19	2	80	0.0250000
NODE_5576_length_1062_cov_19.778816	401	481	23	10	80	0.1250000
NODE_5576_length_1062_cov_19.778816	401	481	25	12	80	0.1500000
NODE_5576_length_1062_cov_19.778816	401	481	26	2	80	0.0250000
NODE_5576_length_1062_cov_19.778816	401	481	27	1	80	0.0125000
NODE_5576_length_1062_cov_19.778816	401	481	28	26	80	0.3250000
NODE_5576_length_1062_cov_19.778816	454	534	11	9	80	0.1125000
NODE_5576_length_1062_cov_19.778816	454	534	13	6	80	0.0750000
NODE_5576_length_1062_cov_19.778816	454	534	17	4	80	0.0500000
NODE_5576_length_1062_cov_19.778816	454	534	21	3	80	0.0375000
NODE_5576_length_1062_cov_19.778816	454	534	22	4	80	0.0500000
NODE_5576_length_1062_cov_19.778816	454	534	23	14	80	0.1750000
NODE_5576_length_1062_cov_19.778816	454	534	26	2	80	0.0250000
NODE_5576_length_1062_cov_19.778816	454	534	28	38	80	0.4750000
NODE_5577_length_1062_cov_16.034268	628	708	0	36	80	0.4500000
NODE_5577_length_1062_cov_16.034268	628	708	4	15	80	0.1875000
NODE_5577_length_1062_cov_16.034268	628	708	5	19	80	0.2375000
NODE_5577_length_1062_cov_16.034268	628	708	6	10	80	0.1250000
NODE_5577_length_1062_cov_16.034268	681	761	2	46	80	0.5750000
NODE_5577_length_1062_cov_16.034268	681	761	5	17	80	0.2125000
NODE_5577_length_1062_cov_16.034268	681	761	6	17	80	0.2125000
NODE_5578_length_1062_cov_13.346833	623	703	0	80	80	1.0000000
NODE_5578_length_1062_cov_13.346833	676	756	0	80	80	1.0000000
NODE_5579_length_1062_cov_9.886812	670	750	0	80	80	1.0000000
NODE_5579_length_1062_cov_9.886812	723	803	0	28	80	0.3500000
NODE_5579_length_1062_cov_9.886812	723	803	2	25	80	0.3125000
NODE_5579_length_1062_cov_9.886812	723	803	4	3	80	0.0375000
NODE_5579_length_1062_cov_9.886812	723	803	6	24	80	0.3000000
NODE_5580_length_1062_cov_9.078920	525	604	0	16	79	0.2025317
NODE_5580_length_1062_cov_9.078920	525	604	2	63	79	0.7974684
NODE_5580_length_1062_cov_9.078920	577	657	0	20	80	0.2500000
NODE_5580_length_1062_cov_9.078920	577	657	2	60	80	0.7500000
NODE_5581_length_1062_cov_8.934579	203	283	0	80	80	1.0000000
NODE_5581_length_1062_cov_8.934579	256	336	0	80	80	1.0000000
NODE_5588_length_1061_cov_22.637214	418	498	14	16	80	0.2000000
NODE_5588_length_1061_cov_22.637214	418	498	16	64	80	0.8000000
NODE_5588_length_1061_cov_22.637214	471	551	2	36	80	0.4500000
NODE_5588_length_1061_cov_22.637214	471	551	14	33	80	0.4125000
NODE_5588_length_1061_cov_22.637214	471	551	16	11	80	0.1375000
NODE_5589_length_1061_cov_22.338877	479	559	0	80	80	1.0000000
NODE_5589_length_1061_cov_22.338877	532	612	0	80	80	1.0000000
NODE_5597_length_1060_cov_31.595213	394	473	0	35	79	0.4430380
NODE_5597_length_1060_cov_31.595213	394	473	2	28	79	0.3544304
NODE_5597_length_1060_cov_31.595213	394	473	6	16	79	0.2025317
NODE_5597_length_1060_cov_31.595213	446	526	2	11	80	0.1375000
NODE_5597_length_1060_cov_31.595213	446	526	6	69	80	0.8625000
NODE_5597_length_1060_cov_31.595213	522	602	0	7	80	0.0875000
NODE_5597_length_1060_cov_31.595213	522	602	2	9	80	0.1125000
NODE_5597_length_1060_cov_31.595213	522	602	4	15	80	0.1875000
NODE_5597_length_1060_cov_31.595213	522	602	6	49	80	0.6125000
NODE_5597_length_1060_cov_31.595213	575	655	0	60	80	0.7500000
NODE_5597_length_1060_cov_31.595213	575	655	2	9	80	0.1125000
NODE_5597_length_1060_cov_31.595213	575	655	4	2	80	0.0250000
NODE_5597_length_1060_cov_31.595213	575	655	6	9	80	0.1125000
NODE_5598_length_1060_cov_26.136316	486	566	0	80	80	1.0000000
NODE_5598_length_1060_cov_26.136316	539	619	0	80	80	1.0000000
NODE_5598_length_1060_cov_26.136316	615	695	0	59	80	0.7375000
NODE_5598_length_1060_cov_26.136316	615	695	2	21	80	0.2625000
NODE_5598_length_1060_cov_26.136316	668	748	0	14	80	0.1750000
NODE_5598_length_1060_cov_26.136316	668	748	2	66	80	0.8250000
NODE_5599_length_1060_cov_25.329865	370	450	0	80	80	1.0000000
NODE_5599_length_1060_cov_25.329865	423	503	0	80	80	1.0000000
NODE_5600_length_1060_cov_16.881374	539	611	4	2	72	0.0277778
NODE_5600_length_1060_cov_16.881374	539	611	8	11	72	0.1527778
NODE_5600_length_1060_cov_16.881374	539	611	9	4	72	0.0555556
NODE_5600_length_1060_cov_16.881374	539	611	11	4	72	0.0555556
NODE_5600_length_1060_cov_16.881374	539	611	12	51	72	0.7083333
NODE_5601_length_1060_cov_14.789802	406	486	0	64	80	0.8000000
NODE_5601_length_1060_cov_14.789802	406	486	2	16	80	0.2000000
NODE_5601_length_1060_cov_14.789802	459	539	0	43	80	0.5375000
NODE_5601_length_1060_cov_14.789802	459	539	2	37	80	0.4625000
NODE_5603_length_1060_cov_5.900104	517	597	0	80	80	1.0000000
NODE_5603_length_1060_cov_5.900104	570	650	0	80	80	1.0000000
NODE_5611_length_1059_cov_16.630208	412	492	2	29	80	0.3625000
NODE_5611_length_1059_cov_16.630208	412	492	4	30	80	0.3750000
NODE_5611_length_1059_cov_16.630208	412	492	6	21	80	0.2625000
NODE_5611_length_1059_cov_16.630208	465	552	4	87	87	1.0000000
NODE_5611_length_1059_cov_16.630208	548	628	0	74	80	0.9250000
NODE_5611_length_1059_cov_16.630208	548	628	4	6	80	0.0750000
NODE_5611_length_1059_cov_16.630208	601	681	0	80	80	1.0000000
NODE_5621_length_1058_cov_60.155370	395	475	2	42	80	0.5250000
NODE_5621_length_1058_cov_60.155370	395	475	4	38	80	0.4750000
NODE_5621_length_1058_cov_60.155370	448	528	0	47	80	0.5875000
NODE_5621_length_1058_cov_60.155370	448	528	2	33	80	0.4125000
NODE_5621_length_1058_cov_60.155370	524	604	0	38	80	0.4750000
NODE_5621_length_1058_cov_60.155370	524	604	4	42	80	0.5250000
NODE_5621_length_1058_cov_60.155370	577	657	0	19	80	0.2375000
NODE_5621_length_1058_cov_60.155370	577	657	4	61	80	0.7625000
NODE_5622_length_1058_cov_31.253389	475	555	8	32	80	0.4000000
NODE_5622_length_1058_cov_31.253389	475	555	10	8	80	0.1000000
NODE_5622_length_1058_cov_31.253389	475	555	11	40	80	0.5000000
NODE_5622_length_1058_cov_31.253389	475	555	8	32	80	0.4000000
NODE_5622_length_1058_cov_31.253389	475	555	10	8	80	0.1000000
NODE_5622_length_1058_cov_31.253389	475	555	11	40	80	0.5000000
NODE_5622_length_1058_cov_31.253389	528	608	0	17	80	0.2125000
NODE_5622_length_1058_cov_31.253389	528	608	6	14	80	0.1750000
NODE_5622_length_1058_cov_31.253389	528	608	8	38	80	0.4750000
NODE_5622_length_1058_cov_31.253389	528	608	10	6	80	0.0750000
NODE_5622_length_1058_cov_31.253389	528	608	11	5	80	0.0625000
NODE_5622_length_1058_cov_31.253389	533	608	0	17	75	0.2266667
NODE_5622_length_1058_cov_31.253389	533	608	6	14	75	0.1866667
NODE_5622_length_1058_cov_31.253389	533	608	8	38	75	0.5066667
NODE_5622_length_1058_cov_31.253389	533	608	10	6	75	0.0800000
NODE_5623_length_1058_cov_24.520334	264	344	0	80	80	1.0000000
NODE_5623_length_1058_cov_24.520334	317	397	0	42	80	0.5250000
NODE_5623_length_1058_cov_24.520334	317	397	1	10	80	0.1250000
NODE_5623_length_1058_cov_24.520334	317	397	2	28	80	0.3500000
NODE_5624_length_1058_cov_24.211679	297	377	0	80	80	1.0000000
NODE_5624_length_1058_cov_24.211679	350	430	0	80	80	1.0000000
NODE_5625_length_1058_cov_18.100104	454	534	0	30	80	0.3750000
NODE_5625_length_1058_cov_18.100104	454	534	5	1	80	0.0125000
NODE_5625_length_1058_cov_18.100104	454	534	6	35	80	0.4375000
NODE_5625_length_1058_cov_18.100104	454	534	7	14	80	0.1750000
NODE_5625_length_1058_cov_18.100104	507	587	6	36	80	0.4500000
NODE_5625_length_1058_cov_18.100104	507	587	7	44	80	0.5500000
NODE_5626_length_1058_cov_11.645464	476	556	2	25	80	0.3125000
NODE_5626_length_1058_cov_11.645464	476	556	4	55	80	0.6875000
NODE_5626_length_1058_cov_11.645464	529	609	0	1	80	0.0125000
NODE_5626_length_1058_cov_11.645464	529	609	2	67	80	0.8375000
NODE_5626_length_1058_cov_11.645464	529	609	4	12	80	0.1500000
NODE_5627_length_1058_cov_9.953076	621	712	2	8	91	0.0879121
NODE_5627_length_1058_cov_9.953076	621	712	4	20	91	0.2197802
NODE_5627_length_1058_cov_9.953076	621	712	6	63	91	0.6923077
NODE_5627_length_1058_cov_9.953076	685	765	4	73	80	0.9125000
NODE_5627_length_1058_cov_9.953076	685	765	6	7	80	0.0875000
NODE_5628_length_1058_cov_6.294056	819	899	0	12	80	0.1500000
NODE_5628_length_1058_cov_6.294056	819	899	2	26	80	0.3250000
NODE_5628_length_1058_cov_6.294056	819	899	4	1	80	0.0125000
NODE_5628_length_1058_cov_6.294056	819	899	6	41	80	0.5125000
NODE_5628_length_1058_cov_6.294056	875	952	0	5	77	0.0649351
NODE_5628_length_1058_cov_6.294056	875	952	2	22	77	0.2857143
NODE_5628_length_1058_cov_6.294056	875	952	4	11	77	0.1428571
NODE_5628_length_1058_cov_6.294056	875	952	6	39	77	0.5064935
NODE_5637_length_1057_cov_43.191023	413	493	0	80	80	1.0000000
NODE_5637_length_1057_cov_43.191023	466	546	0	80	80	1.0000000
NODE_5637_length_1057_cov_43.191023	542	622	0	80	80	1.0000000
NODE_5637_length_1057_cov_43.191023	595	675	0	80	80	1.0000000
NODE_5638_length_1057_cov_27.387265	486	566	8	3	80	0.0375000
NODE_5638_length_1057_cov_27.387265	486	566	14	77	80	0.9625000
NODE_5638_length_1057_cov_27.387265	539	619	0	14	80	0.1750000
NODE_5638_length_1057_cov_27.387265	539	619	6	7	80	0.0875000
NODE_5638_length_1057_cov_27.387265	539	619	14	59	80	0.7375000
NODE_5639_length_1057_cov_16.489562	416	496	0	67	80	0.8375000
NODE_5639_length_1057_cov_16.489562	416	496	2	13	80	0.1625000
NODE_5639_length_1057_cov_16.489562	469	549	0	14	80	0.1750000
NODE_5639_length_1057_cov_16.489562	469	549	2	66	80	0.8250000
NODE_5640_length_1057_cov_13.605428	631	711	17	5	80	0.0625000
NODE_5640_length_1057_cov_13.605428	631	711	21	4	80	0.0500000
NODE_5640_length_1057_cov_13.605428	631	711	22	12	80	0.1500000
NODE_5640_length_1057_cov_13.605428	631	711	23	55	80	0.6875000
NODE_5640_length_1057_cov_13.605428	631	711	24	4	80	0.0500000
NODE_5640_length_1057_cov_13.605428	684	764	2	3	80	0.0375000
NODE_5640_length_1057_cov_13.605428	684	764	4	9	80	0.1125000
NODE_5640_length_1057_cov_13.605428	684	764	18	4	80	0.0500000
NODE_5640_length_1057_cov_13.605428	684	764	19	26	80	0.3250000
NODE_5640_length_1057_cov_13.605428	684	764	22	14	80	0.1750000
NODE_5640_length_1057_cov_13.605428	684	764	23	20	80	0.2500000
NODE_5640_length_1057_cov_13.605428	684	764	24	4	80	0.0500000
NODE_5641_length_1057_cov_12.768267	518	598	6	34	80	0.4250000
NODE_5641_length_1057_cov_12.768267	518	598	9	1	80	0.0125000
NODE_5641_length_1057_cov_12.768267	518	598	10	6	80	0.0750000
NODE_5641_length_1057_cov_12.768267	518	598	12	39	80	0.4875000
NODE_5641_length_1057_cov_12.768267	571	651	0	10	80	0.1250000
NODE_5641_length_1057_cov_12.768267	571	651	3	1	80	0.0125000
NODE_5641_length_1057_cov_12.768267	571	651	4	12	80	0.1500000
NODE_5641_length_1057_cov_12.768267	571	651	6	16	80	0.2000000
NODE_5641_length_1057_cov_12.768267	571	651	12	41	80	0.5125000
NODE_5644_length_1057_cov_7.692067	706	786	0	79	80	0.9875000
NODE_5644_length_1057_cov_7.692067	706	786	2	1	80	0.0125000
NODE_5644_length_1057_cov_7.692067	759	839	0	26	80	0.3250000
NODE_5644_length_1057_cov_7.692067	759	839	2	54	80	0.6750000
NODE_5645_length_1057_cov_6.697286	561	641	0	6	80	0.0750000
NODE_5645_length_1057_cov_6.697286	561	641	2	74	80	0.9250000
NODE_5645_length_1057_cov_6.697286	614	694	0	50	80	0.6250000
NODE_5645_length_1057_cov_6.697286	614	694	2	30	80	0.3750000
NODE_5654_length_1056_cov_57.539185	462	542	9	15	80	0.1875000
NODE_5654_length_1056_cov_57.539185	462	542	14	8	80	0.1000000
NODE_5654_length_1056_cov_57.539185	462	542	16	57	80	0.7125000
NODE_5654_length_1056_cov_57.539185	515	595	0	22	80	0.2750000
NODE_5654_length_1056_cov_57.539185	515	595	7	13	80	0.1625000
NODE_5654_length_1056_cov_57.539185	515	595	9	33	80	0.4125000
NODE_5654_length_1056_cov_57.539185	515	595	16	12	80	0.1500000
NODE_5655_length_1056_cov_35.751306	421	501	2	80	80	1.0000000
NODE_5655_length_1056_cov_35.751306	474	554	0	46	80	0.5750000
NODE_5655_length_1056_cov_35.751306	474	554	2	34	80	0.4250000
NODE_5656_length_1056_cov_29.749216	415	490	0	75	75	1.0000000
NODE_5656_length_1056_cov_29.749216	416	495	0	79	79	1.0000000
NODE_5656_length_1056_cov_29.749216	448	495	0	47	47	1.0000000
NODE_5656_length_1056_cov_29.749216	468	548	0	80	80	1.0000000
NODE_5656_length_1056_cov_29.749216	468	548	0	80	80	1.0000000
NODE_5656_length_1056_cov_29.749216	468	548	0	80	80	1.0000000
NODE_5657_length_1056_cov_25.342738	297	377	0	11	80	0.1375000
NODE_5657_length_1056_cov_25.342738	297	377	2	3	80	0.0375000
NODE_5657_length_1056_cov_25.342738	297	377	4	66	80	0.8250000
NODE_5657_length_1056_cov_25.342738	350	430	4	80	80	1.0000000
NODE_5657_length_1056_cov_25.342738	426	506	2	75	80	0.9375000
NODE_5657_length_1056_cov_25.342738	426	506	4	5	80	0.0625000
NODE_5657_length_1056_cov_25.342738	479	559	0	45	80	0.5625000
NODE_5657_length_1056_cov_25.342738	479	559	2	35	80	0.4375000
NODE_5658_length_1056_cov_24.094044	535	615	0	48	80	0.6000000
NODE_5658_length_1056_cov_24.094044	535	615	2	32	80	0.4000000
NODE_5658_length_1056_cov_24.094044	588	668	0	15	80	0.1875000
NODE_5658_length_1056_cov_24.094044	588	668	2	65	80	0.8125000
NODE_5659_length_1056_cov_20.700104	570	650	2	11	80	0.1375000
NODE_5659_length_1056_cov_20.700104	570	650	8	43	80	0.5375000
NODE_5659_length_1056_cov_20.700104	570	650	10	26	80	0.3250000
NODE_5659_length_1056_cov_20.700104	623	703	0	15	80	0.1875000
NODE_5659_length_1056_cov_20.700104	623	703	8	65	80	0.8125000
NODE_5660_length_1056_cov_14.215256	349	429	0	70	80	0.8750000
NODE_5660_length_1056_cov_14.215256	349	429	2	10	80	0.1250000
NODE_5660_length_1056_cov_14.215256	402	482	0	17	80	0.2125000
NODE_5660_length_1056_cov_14.215256	402	482	2	63	80	0.7875000
NODE_5660_length_1056_cov_14.215256	478	558	0	54	80	0.6750000
NODE_5660_length_1056_cov_14.215256	478	558	2	26	80	0.3250000
NODE_5660_length_1056_cov_14.215256	531	611	0	80	80	1.0000000
NODE_5661_length_1056_cov_13.782654	563	643	0	26	80	0.3250000
NODE_5661_length_1056_cov_13.782654	563	643	2	49	80	0.6125000
NODE_5661_length_1056_cov_13.782654	563	643	4	5	80	0.0625000
NODE_5661_length_1056_cov_13.782654	616	696	2	32	80	0.4000000
NODE_5661_length_1056_cov_13.782654	616	696	4	48	80	0.6000000
NODE_5663_length_1056_cov_9.298851	373	453	10	25	80	0.3125000
NODE_5663_length_1056_cov_9.298851	373	453	16	9	80	0.1125000
NODE_5663_length_1056_cov_9.298851	373	453	18	8	80	0.1000000
NODE_5663_length_1056_cov_9.298851	373	453	21	1	80	0.0125000
NODE_5663_length_1056_cov_9.298851	373	453	22	37	80	0.4625000
NODE_5663_length_1056_cov_9.298851	426	503	0	7	77	0.0909091
NODE_5663_length_1056_cov_9.298851	426	503	8	11	77	0.1428571
NODE_5663_length_1056_cov_9.298851	426	503	10	57	77	0.7402598
NODE_5663_length_1056_cov_9.298851	426	503	16	2	77	0.0259740
NODE_5665_length_1056_cov_6.157785	396	476	0	80	80	1.0000000
NODE_5665_length_1056_cov_6.157785	449	529	0	80	80	1.0000000
NODE_5666_length_1056_cov_6.034483	287	367	0	80	80	1.0000000
NODE_5666_length_1056_cov_6.034483	340	420	0	80	80	1.0000000
NODE_5667_length_1056_cov_3.259143	371	410	0	39	39	1.0000000
NODE_5667_length_1056_cov_3.259143	424	463	0	39	39	1.0000000
NODE_5668_length_1056_cov_2.362591	234	314	4	16	80	0.2000000
NODE_5668_length_1056_cov_2.362591	234	314	8	47	80	0.5875000
NODE_5668_length_1056_cov_2.362591	234	314	10	17	80	0.2125000
NODE_5672_length_1055_cov_36.460251	468	548	0	48	80	0.6000000
NODE_5672_length_1055_cov_36.460251	468	548	2	32	80	0.4000000
NODE_5672_length_1055_cov_36.460251	521	601	2	80	80	1.0000000
NODE_5673_length_1055_cov_31.235356	502	582	0	26	80	0.3250000
NODE_5673_length_1055_cov_31.235356	502	582	2	46	80	0.5750000
NODE_5673_length_1055_cov_31.235356	502	582	3	4	80	0.0500000
NODE_5673_length_1055_cov_31.235356	502	582	4	4	80	0.0500000
NODE_5673_length_1055_cov_31.235356	555	635	0	79	80	0.9875000
NODE_5673_length_1055_cov_31.235356	555	635	2	1	80	0.0125000
NODE_5674_length_1055_cov_23.330544	403	483	2	7	80	0.0875000
NODE_5674_length_1055_cov_23.330544	403	483	4	24	80	0.3000000
NODE_5674_length_1055_cov_23.330544	403	483	6	49	80	0.6125000
NODE_5674_length_1055_cov_23.330544	456	536	0	46	80	0.5750000
NODE_5674_length_1055_cov_23.330544	456	536	2	14	80	0.1750000
NODE_5674_length_1055_cov_23.330544	456	536	6	20	80	0.2500000
NODE_5674_length_1055_cov_23.330544	532	612	0	22	80	0.2750000
NODE_5674_length_1055_cov_23.330544	532	612	2	58	80	0.7250000
NODE_5674_length_1055_cov_23.330544	585	665	0	40	80	0.5000000
NODE_5674_length_1055_cov_23.330544	585	665	2	40	80	0.5000000
NODE_5675_length_1055_cov_19.541841	321	401	0	80	80	1.0000000
NODE_5675_length_1055_cov_19.541841	374	454	0	80	80	1.0000000
NODE_5676_length_1055_cov_15.744770	525	605	4	43	80	0.5375000
NODE_5676_length_1055_cov_15.744770	525	605	6	37	80	0.4625000
NODE_5676_length_1055_cov_15.744770	578	658	2	13	80	0.1625000
NODE_5676_length_1055_cov_15.744770	578	658	4	4	80	0.0500000
NODE_5676_length_1055_cov_15.744770	578	658	6	63	80	0.7875000
NODE_5677_length_1055_cov_10.729079	335	415	2	7	80	0.0875000
NODE_5677_length_1055_cov_10.729079	335	415	3	23	80	0.2875000
NODE_5677_length_1055_cov_10.729079	335	415	4	50	80	0.6250000
NODE_5677_length_1055_cov_10.729079	388	468	4	80	80	1.0000000
NODE_5678_length_1055_cov_7.525105	575	655	6	14	80	0.1750000
NODE_5678_length_1055_cov_7.525105	575	655	8	18	80	0.2250000
NODE_5678_length_1055_cov_7.525105	575	655	10	4	80	0.0500000
NODE_5678_length_1055_cov_7.525105	575	655	12	44	80	0.5500000
NODE_5678_length_1055_cov_7.525105	628	708	0	38	80	0.4750000
NODE_5678_length_1055_cov_7.525105	628	708	2	3	80	0.0375000
NODE_5678_length_1055_cov_7.525105	628	708	4	3	80	0.0375000
NODE_5678_length_1055_cov_7.525105	628	708	6	23	80	0.2875000
NODE_5678_length_1055_cov_7.525105	628	708	8	13	80	0.1625000
NODE_5688_length_1054_cov_45.920419	371	451	0	80	80	1.0000000
NODE_5688_length_1054_cov_45.920419	424	505	0	28	81	0.3456790
NODE_5688_length_1054_cov_45.920419	424	505	2	53	81	0.6543210
NODE_5689_length_1054_cov_30.545550	499	578	0	79	79	1.0000000
NODE_5689_length_1054_cov_30.545550	552	631	0	79	79	1.0000000
NODE_5689_length_1054_cov_30.545550	627	707	0	27	80	0.3375000
NODE_5689_length_1054_cov_30.545550	627	707	2	53	80	0.6625000
NODE_5689_length_1054_cov_30.545550	680	760	0	17	80	0.2125000
NODE_5689_length_1054_cov_30.545550	680	760	2	63	80	0.7875000
NODE_5690_length_1054_cov_16.606283	347	427	6	8	80	0.1000000
NODE_5690_length_1054_cov_16.606283	347	427	9	28	80	0.3500000
NODE_5690_length_1054_cov_16.606283	347	427	12	22	80	0.2750000
NODE_5690_length_1054_cov_16.606283	347	427	13	5	80	0.0625000
NODE_5690_length_1054_cov_16.606283	347	427	15	17	80	0.2125000
NODE_5690_length_1054_cov_16.606283	400	480	0	5	80	0.0625000
NODE_5690_length_1054_cov_16.606283	400	480	1	13	80	0.1625000
NODE_5690_length_1054_cov_16.606283	400	480	3	18	80	0.2250000
NODE_5690_length_1054_cov_16.606283	400	480	4	5	80	0.0625000
NODE_5690_length_1054_cov_16.606283	400	480	6	20	80	0.2500000
NODE_5690_length_1054_cov_16.606283	400	480	9	19	80	0.2375000
NODE_5691_length_1054_cov_11.637696	244	316	0	72	72	1.0000000
NODE_5691_length_1054_cov_11.637696	312	392	0	50	80	0.6250000
NODE_5691_length_1054_cov_11.637696	312	392	4	30	80	0.3750000
NODE_5691_length_1054_cov_11.637696	365	445	4	80	80	1.0000000
NODE_5692_length_1054_cov_10.381152	493	573	0	80	80	1.0000000
NODE_5692_length_1054_cov_10.381152	546	626	0	80	80	1.0000000
NODE_5703_length_1053_cov_57.660377	445	527	9	22	82	0.2682927
NODE_5703_length_1053_cov_57.660377	445	527	10	19	82	0.2317073
NODE_5703_length_1053_cov_57.660377	445	527	11	14	82	0.1707317
NODE_5703_length_1053_cov_57.660377	445	527	12	16	82	0.1951219
NODE_5703_length_1053_cov_57.660377	445	527	13	11	82	0.1341463
NODE_5703_length_1053_cov_57.660377	500	580	2	11	80	0.1375000
NODE_5703_length_1053_cov_57.660377	500	580	4	17	80	0.2125000
NODE_5703_length_1053_cov_57.660377	500	580	8	5	80	0.0625000
NODE_5703_length_1053_cov_57.660377	500	580	10	14	80	0.1750000
NODE_5703_length_1053_cov_57.660377	500	580	12	19	80	0.2375000
NODE_5703_length_1053_cov_57.660377	500	580	13	9	80	0.1125000
NODE_5703_length_1053_cov_57.660377	500	580	14	5	80	0.0625000
NODE_5704_length_1053_cov_33.518868	329	409	2	26	80	0.3250000
NODE_5704_length_1053_cov_33.518868	329	409	4	54	80	0.6750000
NODE_5704_length_1053_cov_33.518868	382	462	2	76	80	0.9500000
NODE_5704_length_1053_cov_33.518868	382	462	4	4	80	0.0500000
NODE_5704_length_1053_cov_33.518868	458	538	0	74	80	0.9250000
NODE_5704_length_1053_cov_33.518868	458	538	2	6	80	0.0750000
NODE_5704_length_1053_cov_33.518868	511	591	0	80	80	1.0000000
NODE_5705_length_1053_cov_32.412998	375	455	0	80	80	1.0000000
NODE_5705_length_1053_cov_32.412998	428	508	0	59	80	0.7375000
NODE_5705_length_1053_cov_32.412998	428	508	2	21	80	0.2625000
NODE_5705_length_1053_cov_32.412998	504	584	2	80	80	1.0000000
NODE_5705_length_1053_cov_32.412998	557	637	0	24	80	0.3000000
NODE_5705_length_1053_cov_32.412998	557	637	2	56	80	0.7000000
NODE_5706_length_1053_cov_26.545073	456	536	0	67	80	0.8375000
NODE_5706_length_1053_cov_26.545073	456	536	2	13	80	0.1625000
NODE_5706_length_1053_cov_26.545073	509	589	0	14	80	0.1750000
NODE_5706_length_1053_cov_26.545073	509	589	2	66	80	0.8250000
NODE_5706_length_1053_cov_26.545073	585	665	0	5	80	0.0625000
NODE_5706_length_1053_cov_26.545073	585	665	2	75	80	0.9375000
NODE_5706_length_1053_cov_26.545073	638	718	0	21	80	0.2625000
NODE_5706_length_1053_cov_26.545073	638	718	2	59	80	0.7375000
NODE_5707_length_1053_cov_20.346960	543	623	0	37	80	0.4625000
NODE_5707_length_1053_cov_20.346960	543	623	2	43	80	0.5375000
NODE_5707_length_1053_cov_20.346960	596	677	0	1	81	0.0123457
NODE_5707_length_1053_cov_20.346960	596	677	2	80	81	0.9876543
NODE_5708_length_1053_cov_11.655136	393	473	0	80	80	1.0000000
NODE_5708_length_1053_cov_11.655136	446	526	0	80	80	1.0000000
NODE_5710_length_1053_cov_4.771488	84	149	4	5	65	0.0769231
NODE_5710_length_1053_cov_4.771488	84	149	10	3	65	0.0461538
NODE_5710_length_1053_cov_4.771488	84	149	12	57	65	0.8769231
NODE_5718_length_1052_cov_18.469045	448	528	0	80	80	1.0000000
NODE_5718_length_1052_cov_18.469045	501	581	0	80	80	1.0000000
NODE_5719_length_1052_cov_13.136411	425	505	2	42	80	0.5250000
NODE_5719_length_1052_cov_13.136411	425	505	4	38	80	0.4750000
NODE_5719_length_1052_cov_13.136411	478	558	0	46	80	0.5750000
NODE_5719_length_1052_cov_13.136411	478	558	2	34	80	0.4250000
NODE_5722_length_1052_cov_3.082896	607	687	0	80	80	1.0000000
NODE_5722_length_1052_cov_3.082896	660	740	0	80	80	1.0000000
NODE_5729_length_1051_cov_34.868697	472	552	0	3	80	0.0375000
NODE_5729_length_1051_cov_34.868697	472	552	2	15	80	0.1875000
NODE_5729_length_1051_cov_34.868697	472	552	4	26	80	0.3250000
NODE_5729_length_1051_cov_34.868697	472	552	8	22	80	0.2750000
NODE_5729_length_1051_cov_34.868697	472	552	10	14	80	0.1750000
NODE_5729_length_1051_cov_34.868697	525	605	2	10	80	0.1250000
NODE_5729_length_1051_cov_34.868697	525	605	6	40	80	0.5000000
NODE_5729_length_1051_cov_34.868697	525	605	8	14	80	0.1750000
NODE_5729_length_1051_cov_34.868697	525	605	10	16	80	0.2000000
NODE_5730_length_1051_cov_19.446429	549	629	0	26	80	0.3250000
NODE_5730_length_1051_cov_19.446429	549	629	2	8	80	0.1000000
NODE_5730_length_1051_cov_19.446429	549	629	6	46	80	0.5750000
NODE_5730_length_1051_cov_19.446429	602	682	0	23	80	0.2875000
NODE_5730_length_1051_cov_19.446429	602	682	2	1	80	0.0125000
NODE_5730_length_1051_cov_19.446429	602	682	4	1	80	0.0125000
NODE_5730_length_1051_cov_19.446429	602	682	6	55	80	0.6875000
NODE_5731_length_1051_cov_4.022059	600	680	0	80	80	1.0000000
NODE_5736_length_1050_cov_31.556257	429	509	5	8	80	0.1000000
NODE_5736_length_1050_cov_31.556257	429	509	8	1	80	0.0125000
NODE_5736_length_1050_cov_31.556257	429	509	9	70	80	0.8750000
NODE_5736_length_1050_cov_31.556257	429	509	10	1	80	0.0125000
NODE_5736_length_1050_cov_31.556257	482	562	0	47	80	0.5875000
NODE_5736_length_1050_cov_31.556257	482	562	4	1	80	0.0125000
NODE_5736_length_1050_cov_31.556257	482	562	5	13	80	0.1625000
NODE_5736_length_1050_cov_31.556257	482	562	8	1	80	0.0125000
NODE_5736_length_1050_cov_31.556257	482	562	9	18	80	0.2250000
NODE_5736_length_1050_cov_31.556257	558	638	0	80	80	1.0000000
NODE_5736_length_1050_cov_31.556257	611	691	0	80	80	1.0000000
NODE_5737_length_1050_cov_16.337539	398	478	0	80	80	1.0000000
NODE_5737_length_1050_cov_16.337539	451	531	0	80	80	1.0000000
NODE_5738_length_1050_cov_13.290221	507	587	0	23	80	0.2875000
NODE_5738_length_1050_cov_13.290221	507	587	2	34	80	0.4250000
NODE_5738_length_1050_cov_13.290221	507	587	8	20	80	0.2500000
NODE_5738_length_1050_cov_13.290221	507	587	10	3	80	0.0375000
NODE_5738_length_1050_cov_13.290221	560	640	2	4	80	0.0500000
NODE_5738_length_1050_cov_13.290221	560	640	8	44	80	0.5500000
NODE_5738_length_1050_cov_13.290221	560	640	10	32	80	0.4000000
NODE_5739_length_1050_cov_11.389064	532	612	0	80	80	1.0000000
NODE_5739_length_1050_cov_11.389064	585	665	0	80	80	1.0000000
NODE_5740_length_1050_cov_11.091483	259	321	0	38	62	0.6129032
NODE_5740_length_1050_cov_11.091483	259	321	2	24	62	0.3870968
NODE_5740_length_1050_cov_11.091483	294	374	0	3	80	0.0375000
NODE_5740_length_1050_cov_11.091483	294	374	2	77	80	0.9625000
NODE_5740_length_1050_cov_11.091483	370	450	0	59	80	0.7375000
NODE_5740_length_1050_cov_11.091483	370	450	2	21	80	0.2625000
NODE_5740_length_1050_cov_11.091483	423	503	0	80	80	1.0000000
NODE_5742_length_1050_cov_2.201893	928	990	2	61	62	0.9838710
NODE_5742_length_1050_cov_2.201893	928	990	4	1	62	0.0161290
NODE_5742_length_1050_cov_2.201893	981	1043	0	33	62	0.5322581
NODE_5742_length_1050_cov_2.201893	981	1043	2	29	62	0.4677419
NODE_5748_length_1050_cov_1.241851	935	990	26	2	55	0.0363636
NODE_5748_length_1050_cov_1.241851	935	990	32	3	55	0.0545455
NODE_5748_length_1050_cov_1.241851	935	990	36	3	55	0.0545455
NODE_5748_length_1050_cov_1.241851	935	990	39	2	55	0.0363636
NODE_5748_length_1050_cov_1.241851	935	990	43	1	55	0.0181818
NODE_5748_length_1050_cov_1.241851	935	990	49	1	55	0.0181818
NODE_5748_length_1050_cov_1.241851	935	990	53	1	55	0.0181818
NODE_5748_length_1050_cov_1.241851	935	990	55	1	55	0.0181818
NODE_5748_length_1050_cov_1.241851	935	990	59	1	55	0.0181818
NODE_5748_length_1050_cov_1.241851	935	990	62	1	55	0.0181818
NODE_5748_length_1050_cov_1.241851	935	990	65	1	55	0.0181818
NODE_5748_length_1050_cov_1.241851	935	990	69	1	55	0.0181818
NODE_5748_length_1050_cov_1.241851	935	990	71	2	55	0.0363636
NODE_5748_length_1050_cov_1.241851	935	990	72	6	55	0.1090909
NODE_5748_length_1050_cov_1.241851	935	990	73	2	55	0.0363636
NODE_5748_length_1050_cov_1.241851	935	990	74	2	55	0.0363636
NODE_5748_length_1050_cov_1.241851	935	990	77	1	55	0.0181818
NODE_5748_length_1050_cov_1.241851	935	990	79	3	55	0.0545455
NODE_5748_length_1050_cov_1.241851	935	990	83	1	55	0.0181818
NODE_5748_length_1050_cov_1.241851	935	990	85	20	55	0.3636364
NODE_5748_length_1050_cov_1.241851	956	1036	44	2	80	0.0250000
NODE_5748_length_1050_cov_1.241851	956	1036	49	1	80	0.0125000
NODE_5748_length_1050_cov_1.241851	956	1036	51	1	80	0.0125000
NODE_5748_length_1050_cov_1.241851	956	1036	57	2	80	0.0250000
NODE_5748_length_1050_cov_1.241851	956	1036	61	2	80	0.0250000
NODE_5748_length_1050_cov_1.241851	956	1036	63	2	80	0.0250000
NODE_5748_length_1050_cov_1.241851	956	1036	69	1	80	0.0125000
NODE_5748_length_1050_cov_1.241851	956	1036	71	2	80	0.0250000
NODE_5748_length_1050_cov_1.241851	956	1036	72	5	80	0.0625000
NODE_5748_length_1050_cov_1.241851	956	1036	73	2	80	0.0250000
NODE_5748_length_1050_cov_1.241851	956	1036	74	2	80	0.0250000
NODE_5748_length_1050_cov_1.241851	956	1036	75	1	80	0.0125000
NODE_5748_length_1050_cov_1.241851	956	1036	76	1	80	0.0125000
NODE_5748_length_1050_cov_1.241851	956	1036	77	1	80	0.0125000
NODE_5748_length_1050_cov_1.241851	956	1036	78	4	80	0.0500000
NODE_5748_length_1050_cov_1.241851	956	1036	79	3	80	0.0375000
NODE_5748_length_1050_cov_1.241851	956	1036	80	3	80	0.0375000
NODE_5748_length_1050_cov_1.241851	956	1036	82	2	80	0.0250000
NODE_5748_length_1050_cov_1.241851	956	1036	83	1	80	0.0125000
NODE_5748_length_1050_cov_1.241851	956	1036	85	42	80	0.5250000
NODE_5752_length_1049_cov_28.174737	446	526	0	80	80	1.0000000
NODE_5752_length_1049_cov_28.174737	499	579	0	36	80	0.4500000
NODE_5752_length_1049_cov_28.174737	499	579	2	44	80	0.5500000
NODE_5753_length_1049_cov_23.186316	389	469	0	9	80	0.1125000
NODE_5753_length_1049_cov_23.186316	389	469	6	38	80	0.4750000
NODE_5753_length_1049_cov_23.186316	389	469	8	33	80	0.4125000
NODE_5753_length_1049_cov_23.186316	442	522	2	13	80	0.1625000
NODE_5753_length_1049_cov_23.186316	442	522	6	1	80	0.0125000
NODE_5753_length_1049_cov_23.186316	442	522	8	66	80	0.8250000
NODE_5753_length_1049_cov_23.186316	518	595	0	71	77	0.9220779
NODE_5753_length_1049_cov_23.186316	518	595	2	6	77	0.0779221
NODE_5753_length_1049_cov_23.186316	568	648	0	80	80	1.0000000
NODE_5754_length_1049_cov_21.097895	532	612	2	12	80	0.1500000
NODE_5754_length_1049_cov_21.097895	532	612	4	68	80	0.8500000
NODE_5754_length_1049_cov_21.097895	585	665	0	51	80	0.6375000
NODE_5754_length_1049_cov_21.097895	585	665	2	4	80	0.0500000
NODE_5754_length_1049_cov_21.097895	585	665	4	25	80	0.3125000
NODE_5755_length_1049_cov_18.964211	375	466	2	19	91	0.2087912
NODE_5755_length_1049_cov_18.964211	375	466	4	13	91	0.1428571
NODE_5755_length_1049_cov_18.964211	375	466	6	59	91	0.6483517
NODE_5755_length_1049_cov_18.964211	439	519	0	14	80	0.1750000
NODE_5755_length_1049_cov_18.964211	439	519	2	58	80	0.7250000
NODE_5755_length_1049_cov_18.964211	439	519	6	8	80	0.1000000
NODE_5755_length_1049_cov_18.964211	515	595	0	80	80	1.0000000
NODE_5755_length_1049_cov_18.964211	568	648	0	80	80	1.0000000
NODE_5756_length_1049_cov_18.075789	437	517	0	80	80	1.0000000
NODE_5756_length_1049_cov_18.075789	490	570	0	64	80	0.8000000
NODE_5756_length_1049_cov_18.075789	490	570	1	11	80	0.1375000
NODE_5756_length_1049_cov_18.075789	490	570	2	5	80	0.0625000
NODE_5756_length_1049_cov_18.075789	566	644	2	18	78	0.2307692
NODE_5756_length_1049_cov_18.075789	566	644	4	60	78	0.7692308
NODE_5756_length_1049_cov_18.075789	620	695	2	39	75	0.5200000
NODE_5756_length_1049_cov_18.075789	620	695	4	36	75	0.4800000
NODE_5757_length_1049_cov_16.194737	569	650	0	60	81	0.7407407
NODE_5757_length_1049_cov_16.194737	569	650	2	21	81	0.2592593
NODE_5757_length_1049_cov_16.194737	623	703	0	80	80	1.0000000
NODE_5757_length_1049_cov_16.194737	699	779	0	80	80	1.0000000
NODE_5757_length_1049_cov_16.194737	752	832	0	80	80	1.0000000
NODE_5759_length_1049_cov_6.323158	588	668	1	58	80	0.7250000
NODE_5759_length_1049_cov_6.323158	588	668	2	22	80	0.2750000
NODE_5759_length_1049_cov_6.323158	641	721	0	38	80	0.4750000
NODE_5759_length_1049_cov_6.323158	641	721	1	42	80	0.5250000
NODE_5770_length_1048_cov_73.887250	535	615	0	6	80	0.0750000
NODE_5770_length_1048_cov_73.887250	535	615	1	14	80	0.1750000
NODE_5770_length_1048_cov_73.887250	535	615	2	21	80	0.2625000
NODE_5770_length_1048_cov_73.887250	535	615	4	1	80	0.0125000
NODE_5770_length_1048_cov_73.887250	535	615	6	14	80	0.1750000
NODE_5770_length_1048_cov_73.887250	535	615	12	2	80	0.0250000
NODE_5770_length_1048_cov_73.887250	535	615	13	1	80	0.0125000
NODE_5770_length_1048_cov_73.887250	535	615	14	21	80	0.2625000
NODE_5770_length_1048_cov_73.887250	588	668	6	3	80	0.0375000
NODE_5770_length_1048_cov_73.887250	588	668	12	2	80	0.0250000
NODE_5770_length_1048_cov_73.887250	588	668	13	1	80	0.0125000
NODE_5770_length_1048_cov_73.887250	588	668	14	74	80	0.9250000
NODE_5770_length_1048_cov_73.887250	664	744	0	41	80	0.5125000
NODE_5770_length_1048_cov_73.887250	664	744	2	16	80	0.2000000
NODE_5770_length_1048_cov_73.887250	664	744	8	6	80	0.0750000
NODE_5770_length_1048_cov_73.887250	664	744	14	17	80	0.2125000
NODE_5770_length_1048_cov_73.887250	717	797	0	80	80	1.0000000
NODE_5770_length_1048_cov_73.887250	899	979	0	80	80	1.0000000
NODE_5771_length_1048_cov_48.242360	407	487	0	80	80	1.0000000
NODE_5771_length_1048_cov_48.242360	460	540	0	63	80	0.7875000
NODE_5771_length_1048_cov_48.242360	460	540	2	17	80	0.2125000
NODE_5771_length_1048_cov_48.242360	536	616	2	14	80	0.1750000
NODE_5771_length_1048_cov_48.242360	536	616	4	66	80	0.8250000
NODE_5771_length_1048_cov_48.242360	589	669	0	39	80	0.4875000
NODE_5771_length_1048_cov_48.242360	589	669	2	20	80	0.2500000
NODE_5771_length_1048_cov_48.242360	589	669	4	21	80	0.2625000
NODE_5772_length_1048_cov_38.430980	352	432	4	8	80	0.1000000
NODE_5772_length_1048_cov_38.430980	352	432	6	37	80	0.4625000
NODE_5772_length_1048_cov_38.430980	352	432	10	2	80	0.0250000
NODE_5772_length_1048_cov_38.430980	352	432	18	22	80	0.2750000
NODE_5772_length_1048_cov_38.430980	352	432	20	11	80	0.1375000
NODE_5772_length_1048_cov_38.430980	405	485	16	14	80	0.1750000
NODE_5772_length_1048_cov_38.430980	405	485	18	21	80	0.2625000
NODE_5772_length_1048_cov_38.430980	405	485	20	45	80	0.5625000
NODE_5773_length_1048_cov_28.179136	548	628	2	5	80	0.0625000
NODE_5773_length_1048_cov_28.179136	548	628	3	1	80	0.0125000
NODE_5773_length_1048_cov_28.179136	548	628	4	59	80	0.7375000
NODE_5773_length_1048_cov_28.179136	548	628	8	15	80	0.1875000
NODE_5773_length_1048_cov_28.179136	601	681	0	17	80	0.2125000
NODE_5773_length_1048_cov_28.179136	601	681	1	1	80	0.0125000
NODE_5773_length_1048_cov_28.179136	601	681	2	31	80	0.3875000
NODE_5773_length_1048_cov_28.179136	601	681	4	31	80	0.3875000
NODE_5773_length_1048_cov_28.179136	677	757	0	80	80	1.0000000
NODE_5773_length_1048_cov_28.179136	730	810	0	80	80	1.0000000
NODE_5774_length_1048_cov_22.985248	409	489	0	80	80	1.0000000
NODE_5774_length_1048_cov_22.985248	462	542	0	80	80	1.0000000
NODE_5774_length_1048_cov_22.985248	538	618	0	23	80	0.2875000
NODE_5774_length_1048_cov_22.985248	538	618	2	57	80	0.7125000
NODE_5774_length_1048_cov_22.985248	591	671	0	16	80	0.2000000
NODE_5774_length_1048_cov_22.985248	591	671	2	64	80	0.8000000
NODE_5775_length_1048_cov_17.883035	500	580	0	80	80	1.0000000
NODE_5775_length_1048_cov_17.883035	553	633	0	80	80	1.0000000
NODE_5776_length_1048_cov_17.444679	377	457	0	65	80	0.8125000
NODE_5776_length_1048_cov_17.444679	377	457	2	15	80	0.1875000
NODE_5776_length_1048_cov_17.444679	430	510	0	12	80	0.1500000
NODE_5776_length_1048_cov_17.444679	430	510	2	68	80	0.8500000
NODE_5777_length_1048_cov_13.387777	518	598	0	27	80	0.3375000
NODE_5777_length_1048_cov_13.387777	518	598	2	53	80	0.6625000
NODE_5777_length_1048_cov_13.387777	571	651	0	15	80	0.1875000
NODE_5777_length_1048_cov_13.387777	571	651	2	65	80	0.8125000
NODE_5778_length_1048_cov_12.934668	716	796	0	80	80	1.0000000
NODE_5778_length_1048_cov_12.934668	769	849	0	58	80	0.7250000
NODE_5778_length_1048_cov_12.934668	769	849	2	5	80	0.0625000
NODE_5778_length_1048_cov_12.934668	769	849	4	17	80	0.2125000
NODE_5778_length_1048_cov_12.934668	845	925	2	11	80	0.1375000
NODE_5778_length_1048_cov_12.934668	845	925	4	69	80	0.8625000
NODE_5778_length_1048_cov_12.934668	898	975	0	37	77	0.4805195
NODE_5778_length_1048_cov_12.934668	898	975	2	24	77	0.3116883
NODE_5778_length_1048_cov_12.934668	898	975	4	16	77	0.2077922
NODE_5779_length_1048_cov_12.712329	330	410	2	2	80	0.0250000
NODE_5779_length_1048_cov_12.712329	330	410	4	78	80	0.9750000
NODE_5779_length_1048_cov_12.712329	384	463	0	49	79	0.6202531
NODE_5779_length_1048_cov_12.712329	384	463	2	3	79	0.0379747
NODE_5779_length_1048_cov_12.712329	384	463	4	27	79	0.3417721
NODE_5779_length_1048_cov_12.712329	459	539	0	1	80	0.0125000
NODE_5779_length_1048_cov_12.712329	459	539	4	40	80	0.5000000
NODE_5779_length_1048_cov_12.712329	459	539	6	19	80	0.2375000
NODE_5779_length_1048_cov_12.712329	459	539	8	8	80	0.1000000
NODE_5779_length_1048_cov_12.712329	459	539	12	12	80	0.1500000
NODE_5779_length_1048_cov_12.712329	512	592	6	7	80	0.0875000
NODE_5779_length_1048_cov_12.712329	512	592	8	52	80	0.6500000
NODE_5779_length_1048_cov_12.712329	512	592	12	21	80	0.2625000
NODE_5780_length_1048_cov_9.232877	305	355	0	50	50	1.0000000
NODE_5786_length_1047_cov_79.917722	540	620	0	60	80	0.7500000
NODE_5786_length_1047_cov_79.917722	540	620	2	20	80	0.2500000
NODE_5786_length_1047_cov_79.917722	593	673	0	7	80	0.0875000
NODE_5786_length_1047_cov_79.917722	593	673	2	73	80	0.9125000
NODE_5787_length_1047_cov_28.527426	582	662	0	16	80	0.2000000
NODE_5787_length_1047_cov_28.527426	582	662	2	64	80	0.8000000
NODE_5787_length_1047_cov_28.527426	635	715	2	80	80	1.0000000
NODE_5788_length_1047_cov_26.068565	372	452	4	54	80	0.6750000
NODE_5788_length_1047_cov_26.068565	372	452	5	4	80	0.0500000
NODE_5788_length_1047_cov_26.068565	372	452	6	22	80	0.2750000
NODE_5788_length_1047_cov_26.068565	425	505	2	43	80	0.5375000
NODE_5788_length_1047_cov_26.068565	425	505	4	25	80	0.3125000
NODE_5788_length_1047_cov_26.068565	425	505	5	4	80	0.0500000
NODE_5788_length_1047_cov_26.068565	425	505	6	8	80	0.1000000
NODE_5789_length_1047_cov_25.946203	424	504	0	20	80	0.2500000
NODE_5789_length_1047_cov_25.946203	424	504	2	60	80	0.7500000
NODE_5789_length_1047_cov_25.946203	477	557	0	14	80	0.1750000
NODE_5789_length_1047_cov_25.946203	477	557	2	66	80	0.8250000
NODE_5790_length_1047_cov_19.255274	458	538	0	80	80	1.0000000
NODE_5790_length_1047_cov_19.255274	511	591	0	80	80	1.0000000
NODE_5791_length_1047_cov_16.618143	467	547	8	68	80	0.8500000
NODE_5791_length_1047_cov_16.618143	467	547	10	9	80	0.1125000
NODE_5791_length_1047_cov_16.618143	467	547	12	3	80	0.0375000
NODE_5791_length_1047_cov_16.618143	520	600	0	17	80	0.2125000
NODE_5791_length_1047_cov_16.618143	520	600	8	63	80	0.7875000
NODE_5792_length_1047_cov_14.246835	643	723	0	8	80	0.1000000
NODE_5792_length_1047_cov_14.246835	643	723	2	22	80	0.2750000
NODE_5792_length_1047_cov_14.246835	643	723	4	50	80	0.6250000
NODE_5792_length_1047_cov_14.246835	696	776	0	1	80	0.0125000
NODE_5792_length_1047_cov_14.246835	696	776	2	15	80	0.1875000
NODE_5792_length_1047_cov_14.246835	696	776	4	64	80	0.8000000
NODE_5793_length_1047_cov_9.869198	414	494	0	17	80	0.2125000
NODE_5793_length_1047_cov_9.869198	414	494	8	63	80	0.7875000
NODE_5793_length_1047_cov_9.869198	467	547	0	10	80	0.1250000
NODE_5793_length_1047_cov_9.869198	467	547	7	2	80	0.0250000
NODE_5793_length_1047_cov_9.869198	467	547	8	68	80	0.8500000
NODE_5794_length_1047_cov_8.513713	300	380	0	80	80	1.0000000
NODE_5794_length_1047_cov_8.513713	353	433	0	80	80	1.0000000
NODE_5795_length_1047_cov_7.412447	442	522	0	23	80	0.2875000
NODE_5795_length_1047_cov_7.412447	442	522	3	1	80	0.0125000
NODE_5795_length_1047_cov_7.412447	442	522	4	56	80	0.7000000
NODE_5795_length_1047_cov_7.412447	495	575	0	24	80	0.3000000
NODE_5795_length_1047_cov_7.412447	495	575	4	56	80	0.7000000
NODE_5803_length_1046_cov_41.392819	587	667	0	80	80	1.0000000
NODE_5803_length_1046_cov_41.392819	640	720	0	80	80	1.0000000
NODE_5804_length_1046_cov_30.317846	382	462	0	44	80	0.5500000
NODE_5804_length_1046_cov_30.317846	382	462	6	36	80	0.4500000
NODE_5804_length_1046_cov_30.317846	435	515	6	80	80	1.0000000
NODE_5805_length_1046_cov_28.184794	346	426	11	24	80	0.3000000
NODE_5805_length_1046_cov_28.184794	346	426	15	39	80	0.4875000
NODE_5805_length_1046_cov_28.184794	346	426	17	17	80	0.2125000
NODE_5805_length_1046_cov_28.184794	399	479	0	14	80	0.1750000
NODE_5805_length_1046_cov_28.184794	399	479	2	15	80	0.1875000
NODE_5805_length_1046_cov_28.184794	399	479	9	9	80	0.1125000
NODE_5805_length_1046_cov_28.184794	399	479	11	39	80	0.4875000
NODE_5805_length_1046_cov_28.184794	399	479	17	3	80	0.0375000
NODE_5806_length_1046_cov_24.595565	501	581	0	3	80	0.0375000
NODE_5806_length_1046_cov_24.595565	501	581	4	77	80	0.9625000
NODE_5806_length_1046_cov_24.595565	554	634	0	56	80	0.7000000
NODE_5806_length_1046_cov_24.595565	554	634	4	24	80	0.3000000
NODE_5807_length_1046_cov_17.958817	447	527	6	3	80	0.0375000
NODE_5807_length_1046_cov_17.958817	447	527	8	38	80	0.4750000
NODE_5807_length_1046_cov_17.958817	447	527	10	15	80	0.1875000
NODE_5807_length_1046_cov_17.958817	447	527	12	24	80	0.3000000
NODE_5807_length_1046_cov_17.958817	500	580	0	18	80	0.2250000
NODE_5807_length_1046_cov_17.958817	500	580	2	19	80	0.2375000
NODE_5807_length_1046_cov_17.958817	500	580	6	15	80	0.1875000
NODE_5807_length_1046_cov_17.958817	500	580	8	16	80	0.2000000
NODE_5807_length_1046_cov_17.958817	500	580	10	12	80	0.1500000
NODE_5808_length_1046_cov_15.494192	385	465	0	80	80	1.0000000
NODE_5808_length_1046_cov_15.494192	438	518	0	80	80	1.0000000
NODE_5809_length_1046_cov_12.639916	554	634	2	2	80	0.0250000
NODE_5809_length_1046_cov_12.639916	554	634	6	63	80	0.7875000
NODE_5809_length_1046_cov_12.639916	554	634	8	15	80	0.1875000
NODE_5809_length_1046_cov_12.639916	607	687	2	21	80	0.2625000
NODE_5809_length_1046_cov_12.639916	607	687	6	44	80	0.5500000
NODE_5809_length_1046_cov_12.639916	607	687	8	15	80	0.1875000
NODE_5810_length_1046_cov_11.238648	471	551	0	53	80	0.6625000
NODE_5810_length_1046_cov_11.238648	471	551	2	27	80	0.3375000
NODE_5810_length_1046_cov_11.238648	524	604	0	7	80	0.0875000
NODE_5810_length_1046_cov_11.238648	524	604	2	73	80	0.9125000
NODE_5811_length_1046_cov_10.744456	459	539	0	61	80	0.7625000
NODE_5811_length_1046_cov_10.744456	459	539	2	19	80	0.2375000
NODE_5811_length_1046_cov_10.744456	512	592	0	8	80	0.1000000
NODE_5811_length_1046_cov_10.744456	512	592	2	72	80	0.9000000
NODE_5812_length_1046_cov_8.689546	302	382	0	80	80	1.0000000
NODE_5812_length_1046_cov_8.689546	355	435	0	80	80	1.0000000
NODE_5823_length_1045_cov_75.975687	359	440	0	21	81	0.2592593
NODE_5823_length_1045_cov_75.975687	359	440	2	60	81	0.7407407
NODE_5823_length_1045_cov_75.975687	412	493	0	74	81	0.9135802
NODE_5823_length_1045_cov_75.975687	412	493	2	7	81	0.0864198
NODE_5823_length_1045_cov_75.975687	489	569	0	60	80	0.7500000
NODE_5823_length_1045_cov_75.975687	489	569	2	20	80	0.2500000
NODE_5823_length_1045_cov_75.975687	542	622	0	7	80	0.0875000
NODE_5823_length_1045_cov_75.975687	542	622	2	26	80	0.3250000
NODE_5823_length_1045_cov_75.975687	542	622	8	24	80	0.3000000
NODE_5823_length_1045_cov_75.975687	542	622	10	23	80	0.2875000
NODE_5824_length_1045_cov_54.419662	434	514	0	80	80	1.0000000
NODE_5824_length_1045_cov_54.419662	487	567	0	45	80	0.5625000
NODE_5824_length_1045_cov_54.419662	487	567	2	18	80	0.2250000
NODE_5824_length_1045_cov_54.419662	487	567	4	17	80	0.2125000
NODE_5824_length_1045_cov_54.419662	563	639	2	22	76	0.2894737
NODE_5824_length_1045_cov_54.419662	563	639	4	54	76	0.7105263
NODE_5824_length_1045_cov_54.419662	616	696	0	37	80	0.4625000
NODE_5824_length_1045_cov_54.419662	616	696	2	42	80	0.5250000
NODE_5824_length_1045_cov_54.419662	616	696	4	1	80	0.0125000
NODE_5825_length_1045_cov_23.188161	395	475	0	28	80	0.3500000
NODE_5825_length_1045_cov_23.188161	395	475	2	52	80	0.6500000
NODE_5825_length_1045_cov_23.188161	448	528	0	36	80	0.4500000
NODE_5825_length_1045_cov_23.188161	448	528	2	44	80	0.5500000
NODE_5826_length_1045_cov_19.686047	571	651	2	78	80	0.9750000
NODE_5826_length_1045_cov_19.686047	571	651	4	2	80	0.0250000
NODE_5826_length_1045_cov_19.686047	624	704	0	5	80	0.0625000
NODE_5826_length_1045_cov_19.686047	624	704	2	75	80	0.9375000
NODE_5827_length_1045_cov_19.378436	478	558	0	21	80	0.2625000
NODE_5827_length_1045_cov_19.378436	478	558	2	59	80	0.7375000
NODE_5827_length_1045_cov_19.378436	531	611	0	17	80	0.2125000
NODE_5827_length_1045_cov_19.378436	531	611	2	10	80	0.1250000
NODE_5827_length_1045_cov_19.378436	531	611	4	5	80	0.0625000
NODE_5827_length_1045_cov_19.378436	531	611	5	1	80	0.0125000
NODE_5827_length_1045_cov_19.378436	531	611	6	47	80	0.5875000
NODE_5828_length_1045_cov_17.601480	359	439	0	10	80	0.1250000
NODE_5828_length_1045_cov_17.601480	359	439	2	70	80	0.8750000
NODE_5828_length_1045_cov_17.601480	412	492	0	13	80	0.1625000
NODE_5828_length_1045_cov_17.601480	412	492	2	67	80	0.8375000
NODE_5829_length_1045_cov_17.372093	633	713	0	44	80	0.5500000
NODE_5829_length_1045_cov_17.372093	633	713	16	1	80	0.0125000
NODE_5829_length_1045_cov_17.372093	633	713	17	2	80	0.0250000
NODE_5829_length_1045_cov_17.372093	633	713	18	33	80	0.4125000
NODE_5829_length_1045_cov_17.372093	686	766	18	80	80	1.0000000
NODE_5830_length_1045_cov_14.828753	433	513	4	80	80	1.0000000
NODE_5830_length_1045_cov_14.828753	486	566	0	5	80	0.0625000
NODE_5830_length_1045_cov_14.828753	486	566	4	75	80	0.9375000
NODE_5831_length_1045_cov_11.673362	664	744	0	80	80	1.0000000
NODE_5831_length_1045_cov_11.673362	717	797	0	80	80	1.0000000
NODE_5843_length_1044_cov_42.600000	344	424	13	20	80	0.2500000
NODE_5843_length_1044_cov_42.600000	344	424	15	60	80	0.7500000
NODE_5843_length_1044_cov_42.600000	397	477	3	28	80	0.3500000
NODE_5843_length_1044_cov_42.600000	397	477	15	52	80	0.6500000
NODE_5844_length_1044_cov_27.653968	454	534	0	58	80	0.7250000
NODE_5844_length_1044_cov_27.653968	454	534	4	22	80	0.2750000
NODE_5844_length_1044_cov_27.653968	507	587	0	5	80	0.0625000
NODE_5844_length_1044_cov_27.653968	507	587	4	75	80	0.9375000
NODE_5845_length_1044_cov_24.561905	297	375	0	78	78	1.0000000
NODE_5845_length_1044_cov_24.561905	348	428	0	80	80	1.0000000
NODE_5845_length_1044_cov_24.561905	424	504	0	80	80	1.0000000
NODE_5845_length_1044_cov_24.561905	477	557	0	80	80	1.0000000
NODE_5846_length_1044_cov_23.720635	294	374	0	4	80	0.0500000
NODE_5846_length_1044_cov_23.720635	294	374	2	57	80	0.7125000
NODE_5846_length_1044_cov_23.720635	294	374	3	17	80	0.2125000
NODE_5846_length_1044_cov_23.720635	294	374	4	2	80	0.0250000
NODE_5846_length_1044_cov_23.720635	347	427	2	35	80	0.4375000
NODE_5846_length_1044_cov_23.720635	347	427	4	45	80	0.5625000
NODE_5846_length_1044_cov_23.720635	423	503	0	65	80	0.8125000
NODE_5846_length_1044_cov_23.720635	423	503	2	15	80	0.1875000
NODE_5846_length_1044_cov_23.720635	476	556	0	80	80	1.0000000
NODE_5847_length_1044_cov_20.871958	462	542	4	80	80	1.0000000
NODE_5847_length_1044_cov_20.871958	515	595	0	30	80	0.3750000
NODE_5847_length_1044_cov_20.871958	515	595	2	4	80	0.0500000
NODE_5847_length_1044_cov_20.871958	515	595	4	46	80	0.5750000
NODE_5847_length_1044_cov_20.871958	591	671	0	41	80	0.5125000
NODE_5847_length_1044_cov_20.871958	591	671	2	36	80	0.4500000
NODE_5847_length_1044_cov_20.871958	591	671	4	3	80	0.0375000
NODE_5847_length_1044_cov_20.871958	644	724	2	24	80	0.3000000
NODE_5847_length_1044_cov_20.871958	644	724	4	56	80	0.7000000
NODE_5848_length_1044_cov_18.596825	433	513	0	80	80	1.0000000
NODE_5848_length_1044_cov_18.596825	486	566	0	80	80	1.0000000
NODE_5849_length_1044_cov_16.102646	414	494	0	80	80	1.0000000
NODE_5849_length_1044_cov_16.102646	467	547	0	46	80	0.5750000
NODE_5849_length_1044_cov_16.102646	467	547	2	34	80	0.4250000
NODE_5850_length_1044_cov_12.156614	578	658	0	66	80	0.8250000
NODE_5850_length_1044_cov_12.156614	578	658	2	14	80	0.1750000
NODE_5850_length_1044_cov_12.156614	631	711	0	13	80	0.1625000
NODE_5850_length_1044_cov_12.156614	631	711	2	32	80	0.4000000
NODE_5850_length_1044_cov_12.156614	631	711	4	35	80	0.4375000
NODE_5851_length_1044_cov_10.661376	506	586	0	24	80	0.3000000
NODE_5851_length_1044_cov_10.661376	506	586	2	56	80	0.7000000
NODE_5851_length_1044_cov_10.661376	559	639	0	52	80	0.6500000
NODE_5851_length_1044_cov_10.661376	559	639	2	28	80	0.3500000
NODE_5852_length_1044_cov_9.534392	461	541	0	29	80	0.3625000
NODE_5852_length_1044_cov_9.534392	461	541	2	51	80	0.6375000
NODE_5852_length_1044_cov_9.534392	514	594	0	36	80	0.4500000
NODE_5852_length_1044_cov_9.534392	514	594	2	44	80	0.5500000
NODE_5853_length_1044_cov_5.517460	434	514	0	80	80	1.0000000
NODE_5853_length_1044_cov_5.517460	487	567	0	80	80	1.0000000
NODE_5856_length_1044_cov_1.502646	769	845	0	76	76	1.0000000
NODE_5860_length_1043_cov_42.288136	452	532	2	5	80	0.0625000
NODE_5860_length_1043_cov_42.288136	452	532	4	55	80	0.6875000
NODE_5860_length_1043_cov_42.288136	452	532	6	20	80	0.2500000
NODE_5860_length_1043_cov_42.288136	505	585	2	53	80	0.6625000
NODE_5860_length_1043_cov_42.288136	505	585	4	23	80	0.2875000
NODE_5860_length_1043_cov_42.288136	505	585	6	4	80	0.0500000
NODE_5861_length_1043_cov_25.987288	350	430	0	7	80	0.0875000
NODE_5861_length_1043_cov_25.987288	350	430	2	14	80	0.1750000
NODE_5861_length_1043_cov_25.987288	350	430	6	5	80	0.0625000
NODE_5861_length_1043_cov_25.987288	350	430	8	17	80	0.2125000
NODE_5861_length_1043_cov_25.987288	350	430	9	2	80	0.0250000
NODE_5861_length_1043_cov_25.987288	350	430	10	3	80	0.0375000
NODE_5861_length_1043_cov_25.987288	350	430	15	2	80	0.0250000
NODE_5861_length_1043_cov_25.987288	350	430	23	4	80	0.0500000
NODE_5861_length_1043_cov_25.987288	350	430	25	3	80	0.0375000
NODE_5861_length_1043_cov_25.987288	350	430	26	23	80	0.2875000
NODE_5861_length_1043_cov_25.987288	403	483	23	1	80	0.0125000
NODE_5861_length_1043_cov_25.987288	403	483	25	3	80	0.0375000
NODE_5861_length_1043_cov_25.987288	403	483	26	37	80	0.4625000
NODE_5861_length_1043_cov_25.987288	403	483	27	19	80	0.2375000
NODE_5861_length_1043_cov_25.987288	403	483	29	1	80	0.0125000
NODE_5861_length_1043_cov_25.987288	403	483	34	1	80	0.0125000
NODE_5861_length_1043_cov_25.987288	403	483	35	18	80	0.2250000
NODE_5861_length_1043_cov_25.987288	479	559	15	2	80	0.0250000
NODE_5861_length_1043_cov_25.987288	479	559	16	9	80	0.1125000
NODE_5861_length_1043_cov_25.987288	479	559	22	3	80	0.0375000
NODE_5861_length_1043_cov_25.987288	479	559	23	2	80	0.0250000
NODE_5861_length_1043_cov_25.987288	479	559	24	2	80	0.0250000
NODE_5861_length_1043_cov_25.987288	479	559	28	9	80	0.1125000
NODE_5861_length_1043_cov_25.987288	479	559	30	6	80	0.0750000
NODE_5861_length_1043_cov_25.987288	479	559	32	5	80	0.0625000
NODE_5861_length_1043_cov_25.987288	479	559	33	17	80	0.2125000
NODE_5861_length_1043_cov_25.987288	479	559	34	16	80	0.2000000
NODE_5861_length_1043_cov_25.987288	479	559	35	9	80	0.1125000
NODE_5861_length_1043_cov_25.987288	532	612	14	18	80	0.2250000
NODE_5861_length_1043_cov_25.987288	532	612	15	37	80	0.4625000
NODE_5861_length_1043_cov_25.987288	532	612	16	9	80	0.1125000
NODE_5861_length_1043_cov_25.987288	532	612	22	3	80	0.0375000
NODE_5861_length_1043_cov_25.987288	532	612	23	2	80	0.0250000
NODE_5861_length_1043_cov_25.987288	532	612	24	2	80	0.0250000
NODE_5861_length_1043_cov_25.987288	532	612	30	4	80	0.0500000
NODE_5861_length_1043_cov_25.987288	532	612	32	5	80	0.0625000
NODE_5862_length_1043_cov_20.838983	561	641	0	54	80	0.6750000
NODE_5862_length_1043_cov_20.838983	561	641	2	26	80	0.3250000
NODE_5862_length_1043_cov_20.838983	614	694	0	1	80	0.0125000
NODE_5862_length_1043_cov_20.838983	614	694	2	79	80	0.9875000
NODE_5863_length_1043_cov_20.312500	489	569	0	12	80	0.1500000
NODE_5863_length_1043_cov_20.312500	489	569	6	4	80	0.0500000
NODE_5863_length_1043_cov_20.312500	489	569	13	3	80	0.0375000
NODE_5863_length_1043_cov_20.312500	489	569	14	61	80	0.7625000
NODE_5863_length_1043_cov_20.312500	542	622	0	11	80	0.1375000
NODE_5863_length_1043_cov_20.312500	542	622	8	24	80	0.3000000
NODE_5863_length_1043_cov_20.312500	542	622	14	45	80	0.5625000
NODE_5864_length_1043_cov_16.320975	569	649	4	23	80	0.2875000
NODE_5864_length_1043_cov_16.320975	569	649	6	57	80	0.7125000
NODE_5864_length_1043_cov_16.320975	622	702	0	36	80	0.4500000
NODE_5864_length_1043_cov_16.320975	622	702	4	40	80	0.5000000
NODE_5864_length_1043_cov_16.320975	622	702	6	4	80	0.0500000
NODE_5865_length_1043_cov_11.176907	521	601	0	80	80	1.0000000
NODE_5865_length_1043_cov_11.176907	574	654	0	80	80	1.0000000
NODE_5866_length_1043_cov_8.146186	530	596	0	66	66	1.0000000
NODE_5866_length_1043_cov_8.146186	569	649	0	80	80	1.0000000
NODE_5868_length_1043_cov_5.347458	646	726	0	80	80	1.0000000
NODE_5868_length_1043_cov_5.347458	699	779	0	80	80	1.0000000
NODE_5879_length_1042_cov_242.728526	820	900	188	2	80	0.0250000
NODE_5879_length_1042_cov_242.728526	820	900	192	1	80	0.0125000
NODE_5879_length_1042_cov_242.728526	820	900	193	1	80	0.0125000
NODE_5879_length_1042_cov_242.728526	820	900	195	1	80	0.0125000
NODE_5879_length_1042_cov_242.728526	820	900	198	2	80	0.0250000
NODE_5879_length_1042_cov_242.728526	820	900	202	1	80	0.0125000
NODE_5879_length_1042_cov_242.728526	820	900	203	1	80	0.0125000
NODE_5879_length_1042_cov_242.728526	820	900	205	1	80	0.0125000
NODE_5879_length_1042_cov_242.728526	820	900	208	2	80	0.0250000
NODE_5879_length_1042_cov_242.728526	820	900	219	1	80	0.0125000
NODE_5879_length_1042_cov_242.728526	820	900	227	1	80	0.0125000
NODE_5879_length_1042_cov_242.728526	820	900	242	1	80	0.0125000
NODE_5879_length_1042_cov_242.728526	820	900	247	1	80	0.0125000
NODE_5879_length_1042_cov_242.728526	820	900	252	1	80	0.0125000
NODE_5879_length_1042_cov_242.728526	820	900	261	2	80	0.0250000
NODE_5879_length_1042_cov_242.728526	820	900	272	1	80	0.0125000
NODE_5879_length_1042_cov_242.728526	820	900	279	1	80	0.0125000
NODE_5879_length_1042_cov_242.728526	820	900	281	1	80	0.0125000
NODE_5879_length_1042_cov_242.728526	820	900	292	1	80	0.0125000
NODE_5879_length_1042_cov_242.728526	820	900	301	1	80	0.0125000
NODE_5879_length_1042_cov_242.728526	820	900	303	2	80	0.0250000
NODE_5879_length_1042_cov_242.728526	820	900	304	2	80	0.0250000
NODE_5879_length_1042_cov_242.728526	820	900	305	1	80	0.0125000
NODE_5879_length_1042_cov_242.728526	820	900	306	3	80	0.0375000
NODE_5879_length_1042_cov_242.728526	820	900	307	1	80	0.0125000
NODE_5879_length_1042_cov_242.728526	820	900	310	1	80	0.0125000
NODE_5879_length_1042_cov_242.728526	820	900	319	1	80	0.0125000
NODE_5879_length_1042_cov_242.728526	820	900	320	1	80	0.0125000
NODE_5879_length_1042_cov_242.728526	820	900	321	1	80	0.0125000
NODE_5879_length_1042_cov_242.728526	820	900	323	2	80	0.0250000
NODE_5879_length_1042_cov_242.728526	820	900	324	1	80	0.0125000
NODE_5879_length_1042_cov_242.728526	820	900	333	1	80	0.0125000
NODE_5879_length_1042_cov_242.728526	820	900	337	1	80	0.0125000
NODE_5879_length_1042_cov_242.728526	820	900	339	1	80	0.0125000
NODE_5879_length_1042_cov_242.728526	820	900	343	2	80	0.0250000
NODE_5879_length_1042_cov_242.728526	820	900	344	1	80	0.0125000
NODE_5879_length_1042_cov_242.728526	820	900	346	1	80	0.0125000
NODE_5879_length_1042_cov_242.728526	820	900	347	1	80	0.0125000
NODE_5879_length_1042_cov_242.728526	820	900	348	1	80	0.0125000
NODE_5879_length_1042_cov_242.728526	820	900	349	1	80	0.0125000
NODE_5879_length_1042_cov_242.728526	820	900	350	4	80	0.0500000
NODE_5879_length_1042_cov_242.728526	820	900	352	1	80	0.0125000
NODE_5879_length_1042_cov_242.728526	820	900	358	3	80	0.0375000
NODE_5879_length_1042_cov_242.728526	820	900	370	2	80	0.0250000
NODE_5879_length_1042_cov_242.728526	820	900	371	1	80	0.0125000
NODE_5879_length_1042_cov_242.728526	820	900	372	1	80	0.0125000
NODE_5879_length_1042_cov_242.728526	820	900	374	1	80	0.0125000
NODE_5879_length_1042_cov_242.728526	820	900	384	2	80	0.0250000
NODE_5879_length_1042_cov_242.728526	820	900	385	1	80	0.0125000
NODE_5879_length_1042_cov_242.728526	820	900	386	4	80	0.0500000
NODE_5879_length_1042_cov_242.728526	820	900	387	3	80	0.0375000
NODE_5879_length_1042_cov_242.728526	820	900	388	3	80	0.0375000
NODE_5879_length_1042_cov_242.728526	820	900	389	2	80	0.0250000
NODE_5879_length_1042_cov_242.728526	820	900	391	2	80	0.0250000
NODE_5879_length_1042_cov_242.728526	873	903	349	1	30	0.0333333
NODE_5879_length_1042_cov_242.728526	873	903	350	1	30	0.0333333
NODE_5879_length_1042_cov_242.728526	873	903	358	3	30	0.1000000
NODE_5879_length_1042_cov_242.728526	873	903	370	2	30	0.0666667
NODE_5879_length_1042_cov_242.728526	873	903	371	1	30	0.0333333
NODE_5879_length_1042_cov_242.728526	873	903	372	1	30	0.0333333
NODE_5879_length_1042_cov_242.728526	873	903	374	1	30	0.0333333
NODE_5879_length_1042_cov_242.728526	873	903	382	2	30	0.0666667
NODE_5879_length_1042_cov_242.728526	873	903	384	2	30	0.0666667
NODE_5879_length_1042_cov_242.728526	873	903	385	1	30	0.0333333
NODE_5879_length_1042_cov_242.728526	873	903	386	4	30	0.1333333
NODE_5879_length_1042_cov_242.728526	873	903	387	3	30	0.1000000
NODE_5879_length_1042_cov_242.728526	873	903	388	3	30	0.1000000
NODE_5879_length_1042_cov_242.728526	873	903	389	3	30	0.1000000
NODE_5879_length_1042_cov_242.728526	873	903	391	2	30	0.0666667
NODE_5880_length_1042_cov_63.214210	355	435	0	30	80	0.3750000
NODE_5880_length_1042_cov_63.214210	355	435	2	50	80	0.6250000
NODE_5880_length_1042_cov_63.214210	408	488	0	80	80	1.0000000
NODE_5881_length_1042_cov_29.581124	497	577	0	80	80	1.0000000
NODE_5881_length_1042_cov_29.581124	550	630	0	80	80	1.0000000
NODE_5882_length_1042_cov_23.861082	519	599	0	80	80	1.0000000
NODE_5882_length_1042_cov_23.861082	572	652	0	80	80	1.0000000
NODE_5882_length_1042_cov_23.861082	648	728	0	80	80	1.0000000
NODE_5882_length_1042_cov_23.861082	701	781	0	80	80	1.0000000
NODE_5883_length_1042_cov_22.247084	555	635	0	45	80	0.5625000
NODE_5883_length_1042_cov_22.247084	555	635	2	2	80	0.0250000
NODE_5883_length_1042_cov_22.247084	555	635	6	33	80	0.4125000
NODE_5883_length_1042_cov_22.247084	608	688	0	6	80	0.0750000
NODE_5883_length_1042_cov_22.247084	608	688	6	74	80	0.9250000
NODE_5884_length_1042_cov_22.117709	335	415	0	3	80	0.0375000
NODE_5884_length_1042_cov_22.117709	335	415	2	13	80	0.1625000
NODE_5884_length_1042_cov_22.117709	335	415	4	64	80	0.8000000
NODE_5884_length_1042_cov_22.117709	388	468	0	56	80	0.7000000
NODE_5884_length_1042_cov_22.117709	388	468	2	13	80	0.1625000
NODE_5884_length_1042_cov_22.117709	388	468	4	11	80	0.1375000
NODE_5884_length_1042_cov_22.117709	464	544	0	12	80	0.1500000
NODE_5884_length_1042_cov_22.117709	464	544	4	68	80	0.8500000
NODE_5884_length_1042_cov_22.117709	517	597	4	80	80	1.0000000
NODE_5885_length_1042_cov_16.831389	27	97	2	11	70	0.1571429
NODE_5885_length_1042_cov_16.831389	27	97	4	18	70	0.2571429
NODE_5885_length_1042_cov_16.831389	27	97	6	3	70	0.0428571
NODE_5885_length_1042_cov_16.831389	27	97	8	3	70	0.0428571
NODE_5885_length_1042_cov_16.831389	27	97	10	5	70	0.0714286
NODE_5885_length_1042_cov_16.831389	27	97	12	30	70	0.4285714
NODE_5885_length_1042_cov_16.831389	372	452	2	80	80	1.0000000
NODE_5885_length_1042_cov_16.831389	425	505	0	42	80	0.5250000
NODE_5885_length_1042_cov_16.831389	425	505	1	10	80	0.1250000
NODE_5885_length_1042_cov_16.831389	425	505	2	28	80	0.3500000
NODE_5886_length_1042_cov_16.662778	416	496	0	61	80	0.7625000
NODE_5886_length_1042_cov_16.662778	416	496	2	19	80	0.2375000
NODE_5886_length_1042_cov_16.662778	469	549	0	8	80	0.1000000
NODE_5886_length_1042_cov_16.662778	469	549	2	72	80	0.9000000
NODE_5887_length_1042_cov_9.474019	361	441	2	80	80	1.0000000
NODE_5887_length_1042_cov_9.474019	414	494	0	41	80	0.5125000
NODE_5887_length_1042_cov_9.474019	414	494	2	39	80	0.4875000
NODE_5888_length_1042_cov_6.725345	356	419	6	6	63	0.0952381
NODE_5888_length_1042_cov_6.725345	356	419	7	35	63	0.5555556
NODE_5888_length_1042_cov_6.725345	356	419	8	22	63	0.3492064
NODE_5888_length_1042_cov_6.725345	392	472	0	23	80	0.2875000
NODE_5888_length_1042_cov_6.725345	392	472	2	15	80	0.1875000
NODE_5888_length_1042_cov_6.725345	392	472	7	42	80	0.5250000
NODE_5896_length_1041_cov_42.960722	335	415	0	45	80	0.5625000
NODE_5896_length_1041_cov_42.960722	335	415	10	1	80	0.0125000
NODE_5896_length_1041_cov_42.960722	335	415	12	34	80	0.4250000
NODE_5896_length_1041_cov_42.960722	388	468	12	80	80	1.0000000
NODE_5896_length_1041_cov_42.960722	464	544	0	23	80	0.2875000
NODE_5896_length_1041_cov_42.960722	464	544	4	15	80	0.1875000
NODE_5896_length_1041_cov_42.960722	464	544	6	8	80	0.1000000
NODE_5896_length_1041_cov_42.960722	464	544	8	6	80	0.0750000
NODE_5896_length_1041_cov_42.960722	464	544	12	28	80	0.3500000
NODE_5896_length_1041_cov_42.960722	517	597	4	13	80	0.1625000
NODE_5896_length_1041_cov_42.960722	517	597	6	8	80	0.1000000
NODE_5896_length_1041_cov_42.960722	517	597	8	59	80	0.7375000
NODE_5897_length_1041_cov_37.331210	513	593	2	10	80	0.1250000
NODE_5897_length_1041_cov_37.331210	513	593	6	2	80	0.0250000
NODE_5897_length_1041_cov_37.331210	513	593	8	1	80	0.0125000
NODE_5897_length_1041_cov_37.331210	513	593	10	16	80	0.2000000
NODE_5897_length_1041_cov_37.331210	513	593	14	2	80	0.0250000
NODE_5897_length_1041_cov_37.331210	513	593	23	3	80	0.0375000
NODE_5897_length_1041_cov_37.331210	513	593	24	3	80	0.0375000
NODE_5897_length_1041_cov_37.331210	513	593	31	3	80	0.0375000
NODE_5897_length_1041_cov_37.331210	513	593	32	1	80	0.0125000
NODE_5897_length_1041_cov_37.331210	513	593	33	39	80	0.4875000
NODE_5897_length_1041_cov_37.331210	566	646	20	5	80	0.0625000
NODE_5897_length_1041_cov_37.331210	566	646	22	10	80	0.1250000
NODE_5897_length_1041_cov_37.331210	566	646	26	28	80	0.3500000
NODE_5897_length_1041_cov_37.331210	566	646	31	13	80	0.1625000
NODE_5897_length_1041_cov_37.331210	566	646	33	24	80	0.3000000
NODE_5897_length_1041_cov_37.331210	642	722	2	2	80	0.0250000
NODE_5897_length_1041_cov_37.331210	642	722	4	20	80	0.2500000
NODE_5897_length_1041_cov_37.331210	642	722	12	6	80	0.0750000
NODE_5897_length_1041_cov_37.331210	642	722	20	32	80	0.4000000
NODE_5897_length_1041_cov_37.331210	642	722	22	20	80	0.2500000
NODE_5897_length_1041_cov_37.331210	695	775	2	31	80	0.3875000
NODE_5897_length_1041_cov_37.331210	695	775	4	44	80	0.5500000
NODE_5897_length_1041_cov_37.331210	695	775	12	5	80	0.0625000
NODE_5898_length_1041_cov_36.477707	455	535	0	25	80	0.3125000
NODE_5898_length_1041_cov_36.477707	455	535	2	19	80	0.2375000
NODE_5898_length_1041_cov_36.477707	455	535	4	36	80	0.4500000
NODE_5898_length_1041_cov_36.477707	508	588	0	5	80	0.0625000
NODE_5898_length_1041_cov_36.477707	508	588	2	34	80	0.4250000
NODE_5898_length_1041_cov_36.477707	508	588	4	41	80	0.5125000
NODE_5898_length_1041_cov_36.477707	584	664	0	80	80	1.0000000
NODE_5898_length_1041_cov_36.477707	637	717	0	80	80	1.0000000
NODE_5898_length_1041_cov_36.477707	753	799	0	46	46	1.0000000
NODE_5899_length_1041_cov_19.286624	468	548	6	80	80	1.0000000
NODE_5899_length_1041_cov_19.286624	521	601	4	35	80	0.4375000
NODE_5899_length_1041_cov_19.286624	521	601	6	39	80	0.4875000
NODE_5899_length_1041_cov_19.286624	521	601	8	3	80	0.0375000
NODE_5899_length_1041_cov_19.286624	521	601	10	3	80	0.0375000
NODE_5900_length_1041_cov_17.072187	578	658	0	16	80	0.2000000
NODE_5900_length_1041_cov_17.072187	578	658	2	64	80	0.8000000
NODE_5900_length_1041_cov_17.072187	631	711	0	60	80	0.7500000
NODE_5900_length_1041_cov_17.072187	631	711	2	20	80	0.2500000
NODE_5901_length_1041_cov_11.887473	437	517	0	80	80	1.0000000
NODE_5901_length_1041_cov_11.887473	490	570	0	80	80	1.0000000
NODE_5902_length_1041_cov_6.957537	354	434	0	65	80	0.8125000
NODE_5902_length_1041_cov_6.957537	354	434	2	15	80	0.1875000
NODE_5902_length_1041_cov_6.957537	407	487	0	12	80	0.1500000
NODE_5902_length_1041_cov_6.957537	407	487	2	56	80	0.7000000
NODE_5902_length_1041_cov_6.957537	407	487	4	12	80	0.1500000
NODE_5913_length_1040_cov_34.618491	478	558	0	40	80	0.5000000
NODE_5913_length_1040_cov_34.618491	478	558	2	40	80	0.5000000
NODE_5913_length_1040_cov_34.618491	531	611	0	16	80	0.2000000
NODE_5913_length_1040_cov_34.618491	531	611	2	64	80	0.8000000
NODE_5914_length_1040_cov_33.061637	485	565	0	39	80	0.4875000
NODE_5914_length_1040_cov_33.061637	485	565	4	41	80	0.5125000
NODE_5914_length_1040_cov_33.061637	538	618	0	16	80	0.2000000
NODE_5914_length_1040_cov_33.061637	538	618	4	64	80	0.8000000
NODE_5915_length_1040_cov_27.818278	402	482	0	30	80	0.3750000
NODE_5915_length_1040_cov_27.818278	402	482	2	50	80	0.6250000
NODE_5915_length_1040_cov_27.818278	455	535	2	58	80	0.7250000
NODE_5915_length_1040_cov_27.818278	455	535	4	8	80	0.1000000
NODE_5915_length_1040_cov_27.818278	455	535	6	14	80	0.1750000
NODE_5916_length_1040_cov_17.933050	487	567	0	27	80	0.3375000
NODE_5916_length_1040_cov_17.933050	487	567	2	53	80	0.6625000
NODE_5916_length_1040_cov_17.933050	540	620	0	80	80	1.0000000
NODE_5917_length_1040_cov_14.327311	237	317	0	80	80	1.0000000
NODE_5917_length_1040_cov_14.327311	290	370	0	80	80	1.0000000
NODE_5917_length_1040_cov_14.327311	366	446	0	80	80	1.0000000
NODE_5917_length_1040_cov_14.327311	419	499	0	80	80	1.0000000
NODE_5918_length_1040_cov_11.910733	369	449	0	80	80	1.0000000
NODE_5918_length_1040_cov_11.910733	422	502	0	80	80	1.0000000
NODE_5919_length_1040_cov_11.521785	355	435	0	80	80	1.0000000
NODE_5919_length_1040_cov_11.521785	408	488	0	36	80	0.4500000
NODE_5919_length_1040_cov_11.521785	408	488	4	44	80	0.5500000
NODE_5920_length_1040_cov_9.573858	632	712	0	6	80	0.0750000
NODE_5920_length_1040_cov_9.573858	632	712	2	4	80	0.0500000
NODE_5920_length_1040_cov_9.573858	632	712	6	70	80	0.8750000
NODE_5920_length_1040_cov_9.573858	685	765	0	28	80	0.3500000
NODE_5920_length_1040_cov_9.573858	685	765	5	1	80	0.0125000
NODE_5920_length_1040_cov_9.573858	685	765	6	51	80	0.6375000
NODE_5921_length_1040_cov_8.148778	349	429	0	80	80	1.0000000
NODE_5921_length_1040_cov_8.148778	402	482	0	41	80	0.5125000
NODE_5921_length_1040_cov_8.148778	402	482	2	39	80	0.4875000
NODE_5922_length_1040_cov_7.927736	282	362	0	80	80	1.0000000
NODE_5922_length_1040_cov_7.927736	335	415	0	80	80	1.0000000
NODE_5927_length_1040_cov_2.317747	2	78	0	31	76	0.4078947
NODE_5927_length_1040_cov_2.317747	2	78	2	45	76	0.5921053
NODE_5934_length_1039_cov_40.150000	487	567	0	80	80	1.0000000
NODE_5934_length_1039_cov_40.150000	540	620	0	80	80	1.0000000
NODE_5934_length_1039_cov_40.150000	616	696	0	34	80	0.4250000
NODE_5934_length_1039_cov_40.150000	616	696	2	46	80	0.5750000
NODE_5934_length_1039_cov_40.150000	669	739	0	6	70	0.0857143
NODE_5934_length_1039_cov_40.150000	669	739	2	64	70	0.9142857
NODE_5935_length_1039_cov_37.940426	175	255	9	7	80	0.0875000
NODE_5935_length_1039_cov_37.940426	175	255	10	28	80	0.3500000
NODE_5935_length_1039_cov_37.940426	175	255	11	34	80	0.4250000
NODE_5935_length_1039_cov_37.940426	175	255	12	11	80	0.1375000
NODE_5935_length_1039_cov_37.940426	228	308	5	9	80	0.1125000
NODE_5935_length_1039_cov_37.940426	228	308	7	3	80	0.0375000
NODE_5935_length_1039_cov_37.940426	228	308	8	10	80	0.1250000
NODE_5935_length_1039_cov_37.940426	228	308	9	10	80	0.1250000
NODE_5935_length_1039_cov_37.940426	228	308	10	13	80	0.1625000
NODE_5935_length_1039_cov_37.940426	228	308	11	35	80	0.4375000
NODE_5935_length_1039_cov_37.940426	304	384	4	3	80	0.0375000
NODE_5935_length_1039_cov_37.940426	304	384	5	10	80	0.1250000
NODE_5935_length_1039_cov_37.940426	304	384	6	49	80	0.6125000
NODE_5935_length_1039_cov_37.940426	304	384	7	18	80	0.2250000
NODE_5935_length_1039_cov_37.940426	357	437	0	31	80	0.3875000
NODE_5935_length_1039_cov_37.940426	357	437	3	18	80	0.2250000
NODE_5935_length_1039_cov_37.940426	357	437	4	7	80	0.0875000
NODE_5935_length_1039_cov_37.940426	357	437	6	24	80	0.3000000
NODE_5936_length_1039_cov_24.567021	371	451	0	30	80	0.3750000
NODE_5936_length_1039_cov_24.567021	371	451	2	50	80	0.6250000
NODE_5936_length_1039_cov_24.567021	424	504	2	65	80	0.8125000
NODE_5936_length_1039_cov_24.567021	424	504	4	15	80	0.1875000
NODE_5937_length_1039_cov_15.790426	293	373	0	35	80	0.4375000
NODE_5937_length_1039_cov_15.790426	293	373	4	10	80	0.1250000
NODE_5937_length_1039_cov_15.790426	293	373	8	35	80	0.4375000
NODE_5937_length_1039_cov_15.790426	346	426	6	3	80	0.0375000
NODE_5937_length_1039_cov_15.790426	346	426	8	61	80	0.7625000
NODE_5937_length_1039_cov_15.790426	346	426	10	16	80	0.2000000
NODE_5938_length_1039_cov_14.670213	591	671	0	54	80	0.6750000
NODE_5938_length_1039_cov_14.670213	591	671	2	26	80	0.3250000
NODE_5938_length_1039_cov_14.670213	644	724	0	29	80	0.3625000
NODE_5938_length_1039_cov_14.670213	644	724	2	51	80	0.6375000
NODE_5939_length_1039_cov_11.568085	439	519	0	23	80	0.2875000
NODE_5939_length_1039_cov_11.568085	439	519	2	57	80	0.7125000
NODE_5939_length_1039_cov_11.568085	492	571	0	75	79	0.9493671
NODE_5939_length_1039_cov_11.568085	492	571	2	4	79	0.0506329
NODE_5947_length_1038_cov_17.191693	549	629	0	4	80	0.0500000
NODE_5947_length_1038_cov_17.191693	549	629	2	76	80	0.9500000
NODE_5947_length_1038_cov_17.191693	602	682	0	21	80	0.2625000
NODE_5947_length_1038_cov_17.191693	602	682	2	59	80	0.7375000
NODE_5948_length_1038_cov_13.520767	516	596	0	75	80	0.9375000
NODE_5948_length_1038_cov_13.520767	516	596	2	5	80	0.0625000
NODE_5948_length_1038_cov_13.520767	569	649	0	80	80	1.0000000
NODE_5949_length_1038_cov_10.541001	487	567	0	8	80	0.1000000
NODE_5949_length_1038_cov_10.541001	487	567	2	72	80	0.9000000
NODE_5949_length_1038_cov_10.541001	540	620	0	50	80	0.6250000
NODE_5949_length_1038_cov_10.541001	540	620	2	30	80	0.3750000
NODE_5950_length_1038_cov_8.826411	432	512	0	80	80	1.0000000
NODE_5950_length_1038_cov_8.826411	485	565	0	80	80	1.0000000
NODE_5952_length_1038_cov_2.587859	673	753	0	80	80	1.0000000
NODE_5952_length_1038_cov_2.587859	726	806	0	80	80	1.0000000
NODE_5963_length_1037_cov_66.968017	402	482	0	4	80	0.0500000
NODE_5963_length_1037_cov_66.968017	402	482	2	7	80	0.0875000
NODE_5963_length_1037_cov_66.968017	402	482	4	15	80	0.1875000
NODE_5963_length_1037_cov_66.968017	402	482	6	54	80	0.6750000
NODE_5963_length_1037_cov_66.968017	455	535	2	15	80	0.1875000
NODE_5963_length_1037_cov_66.968017	455	535	4	41	80	0.5125000
NODE_5963_length_1037_cov_66.968017	455	535	6	24	80	0.3000000
NODE_5964_length_1037_cov_53.639659	527	607	6	38	80	0.4750000
NODE_5964_length_1037_cov_53.639659	527	607	19	14	80	0.1750000
NODE_5964_length_1037_cov_53.639659	527	607	22	4	80	0.0500000
NODE_5964_length_1037_cov_53.639659	527	607	23	18	80	0.2250000
NODE_5964_length_1037_cov_53.639659	527	607	24	6	80	0.0750000
NODE_5964_length_1037_cov_53.639659	580	660	17	17	80	0.2125000
NODE_5964_length_1037_cov_53.639659	580	660	18	13	80	0.1625000
NODE_5964_length_1037_cov_53.639659	580	660	19	37	80	0.4625000
NODE_5964_length_1037_cov_53.639659	580	660	22	4	80	0.0500000
NODE_5964_length_1037_cov_53.639659	580	660	23	9	80	0.1125000
NODE_5965_length_1037_cov_45.353945	542	622	0	80	80	1.0000000
NODE_5965_length_1037_cov_45.353945	595	675	0	80	80	1.0000000
NODE_5966_length_1037_cov_31.078891	356	436	0	17	80	0.2125000
NODE_5966_length_1037_cov_31.078891	356	436	6	30	80	0.3750000
NODE_5966_length_1037_cov_31.078891	356	436	8	33	80	0.4125000
NODE_5966_length_1037_cov_31.078891	409	489	8	80	80	1.0000000
NODE_5967_length_1037_cov_25.453092	421	501	21	31	80	0.3875000
NODE_5967_length_1037_cov_25.453092	421	501	23	40	80	0.5000000
NODE_5967_length_1037_cov_25.453092	421	501	24	9	80	0.1125000
NODE_5967_length_1037_cov_25.453092	474	554	0	4	80	0.0500000
NODE_5967_length_1037_cov_25.453092	474	554	3	2	80	0.0250000
NODE_5967_length_1037_cov_25.453092	474	554	4	14	80	0.1750000
NODE_5967_length_1037_cov_25.453092	474	554	8	26	80	0.3250000
NODE_5967_length_1037_cov_25.453092	474	554	20	1	80	0.0125000
NODE_5967_length_1037_cov_25.453092	474	554	21	33	80	0.4125000
NODE_5967_length_1037_cov_25.453092	550	573	0	23	23	1.0000000
NODE_5968_length_1037_cov_13.740938	348	428	2	28	80	0.3500000
NODE_5968_length_1037_cov_13.740938	348	428	4	6	80	0.0750000
NODE_5968_length_1037_cov_13.740938	348	428	6	10	80	0.1250000
NODE_5968_length_1037_cov_13.740938	348	428	8	36	80	0.4500000
NODE_5968_length_1037_cov_13.740938	401	481	0	12	80	0.1500000
NODE_5968_length_1037_cov_13.740938	401	481	4	12	80	0.1500000
NODE_5968_length_1037_cov_13.740938	401	481	6	39	80	0.4875000
NODE_5968_length_1037_cov_13.740938	401	481	8	17	80	0.2125000
NODE_5969_length_1037_cov_12.632196	564	644	6	1	80	0.0125000
NODE_5969_length_1037_cov_12.632196	564	644	7	26	80	0.3250000
NODE_5969_length_1037_cov_12.632196	564	644	9	12	80	0.1500000
NODE_5969_length_1037_cov_12.632196	564	644	11	41	80	0.5125000
NODE_5969_length_1037_cov_12.632196	617	697	0	22	80	0.2750000
NODE_5969_length_1037_cov_12.632196	617	697	3	4	80	0.0500000
NODE_5969_length_1037_cov_12.632196	617	697	4	18	80	0.2250000
NODE_5969_length_1037_cov_12.632196	617	697	6	10	80	0.1250000
NODE_5969_length_1037_cov_12.632196	617	697	7	26	80	0.3250000
NODE_5970_length_1037_cov_8.904051	640	720	0	7	80	0.0875000
NODE_5970_length_1037_cov_8.904051	640	720	2	73	80	0.9125000
NODE_5970_length_1037_cov_8.904051	693	773	0	54	80	0.6750000
NODE_5970_length_1037_cov_8.904051	693	773	2	26	80	0.3250000
NODE_5978_length_1037_cov_1.859275	31	91	0	60	60	1.0000000
NODE_5986_length_1036_cov_52.270011	493	573	0	3	80	0.0375000
NODE_5986_length_1036_cov_52.270011	493	573	4	40	80	0.5000000
NODE_5986_length_1036_cov_52.270011	493	573	6	37	80	0.4625000
NODE_5986_length_1036_cov_52.270011	546	626	0	16	80	0.2000000
NODE_5986_length_1036_cov_52.270011	546	626	2	25	80	0.3125000
NODE_5986_length_1036_cov_52.270011	546	626	6	39	80	0.4875000
NODE_5987_length_1036_cov_24.080043	369	449	0	1	80	0.0125000
NODE_5987_length_1036_cov_24.080043	369	449	2	47	80	0.5875000
NODE_5987_length_1036_cov_24.080043	369	449	6	19	80	0.2375000
NODE_5987_length_1036_cov_24.080043	369	449	8	13	80	0.1625000
NODE_5987_length_1036_cov_24.080043	422	502	6	72	80	0.9000000
NODE_5987_length_1036_cov_24.080043	422	502	8	8	80	0.1000000
NODE_5988_length_1036_cov_20.533618	513	593	0	80	80	1.0000000
NODE_5988_length_1036_cov_20.533618	566	645	0	79	79	1.0000000
NODE_5988_length_1036_cov_20.533618	648	728	0	80	80	1.0000000
NODE_5988_length_1036_cov_20.533618	701	781	0	80	80	1.0000000
NODE_5989_length_1036_cov_19.715048	467	547	2	3	80	0.0375000
NODE_5989_length_1036_cov_19.715048	467	547	4	18	80	0.2250000
NODE_5989_length_1036_cov_19.715048	467	547	6	39	80	0.4875000
NODE_5989_length_1036_cov_19.715048	467	547	8	20	80	0.2500000
NODE_5989_length_1036_cov_19.715048	520	600	2	18	80	0.2250000
NODE_5989_length_1036_cov_19.715048	520	600	4	45	80	0.5625000
NODE_5989_length_1036_cov_19.715048	520	600	6	11	80	0.1375000
NODE_5989_length_1036_cov_19.715048	520	600	8	6	80	0.0750000
NODE_5990_length_1036_cov_19.452508	399	479	0	14	80	0.1750000
NODE_5990_length_1036_cov_19.452508	399	479	3	24	80	0.3000000
NODE_5990_length_1036_cov_19.452508	399	479	5	42	80	0.5250000
NODE_5990_length_1036_cov_19.452508	452	532	0	67	80	0.8375000
NODE_5990_length_1036_cov_19.452508	452	532	3	13	80	0.1625000
NODE_5990_length_1036_cov_19.452508	528	608	0	49	80	0.6125000
NODE_5990_length_1036_cov_19.452508	528	608	2	31	80	0.3875000
NODE_5990_length_1036_cov_19.452508	581	661	2	80	80	1.0000000
NODE_5991_length_1036_cov_13.840982	635	715	0	8	80	0.1000000
NODE_5991_length_1036_cov_13.840982	635	715	2	50	80	0.6250000
NODE_5991_length_1036_cov_13.840982	635	715	4	22	80	0.2750000
NODE_5991_length_1036_cov_13.840982	688	768	2	5	80	0.0625000
NODE_5991_length_1036_cov_13.840982	688	768	4	75	80	0.9375000
NODE_5992_length_1036_cov_6.913554	424	504	0	13	80	0.1625000
NODE_5992_length_1036_cov_6.913554	424	504	2	41	80	0.5125000
NODE_5992_length_1036_cov_6.913554	424	504	4	26	80	0.3250000
NODE_5992_length_1036_cov_6.913554	477	557	2	1	80	0.0125000
NODE_5992_length_1036_cov_6.913554	477	557	4	38	80	0.4750000
NODE_5992_length_1036_cov_6.913554	477	557	6	41	80	0.5125000
NODE_5993_length_1036_cov_5.880470	436	516	0	80	80	1.0000000
NODE_5993_length_1036_cov_5.880470	489	569	0	80	80	1.0000000
NODE_5994_length_1036_cov_4.638207	531	611	0	80	80	1.0000000
NODE_5994_length_1036_cov_4.638207	584	664	0	80	80	1.0000000
NODE_5998_length_1036_cov_1.293490	19	69	0	50	50	1.0000000
NODE_6001_length_1035_cov_31.941239	590	670	2	24	80	0.3000000
NODE_6001_length_1035_cov_31.941239	590	670	4	56	80	0.7000000
NODE_6001_length_1035_cov_31.941239	643	723	2	19	80	0.2375000
NODE_6001_length_1035_cov_31.941239	643	723	4	18	80	0.2250000
NODE_6001_length_1035_cov_31.941239	643	723	6	18	80	0.2250000
NODE_6001_length_1035_cov_31.941239	643	723	8	25	80	0.3125000
NODE_6002_length_1035_cov_14.917735	396	476	0	80	80	1.0000000
NODE_6002_length_1035_cov_14.917735	449	529	0	80	80	1.0000000
NODE_6003_length_1035_cov_12.552350	467	547	0	24	80	0.3000000
NODE_6003_length_1035_cov_12.552350	467	547	2	56	80	0.7000000
NODE_6003_length_1035_cov_12.552350	520	600	0	27	80	0.3375000
NODE_6003_length_1035_cov_12.552350	520	600	2	53	80	0.6625000
NODE_6004_length_1035_cov_12.050214	40	103	0	1	63	0.0158730
NODE_6004_length_1035_cov_12.050214	40	103	1	2	63	0.0317460
NODE_6004_length_1035_cov_12.050214	40	103	3	3	63	0.0476190
NODE_6004_length_1035_cov_12.050214	40	103	5	3	63	0.0476190
NODE_6004_length_1035_cov_12.050214	40	103	7	3	63	0.0476190
NODE_6004_length_1035_cov_12.050214	40	103	9	37	63	0.5873016
NODE_6004_length_1035_cov_12.050214	40	103	11	7	63	0.1111111
NODE_6004_length_1035_cov_12.050214	40	103	13	7	63	0.1111111
NODE_6004_length_1035_cov_12.050214	138	219	0	3	81	0.0370370
NODE_6004_length_1035_cov_12.050214	138	219	2	1	81	0.0123457
NODE_6004_length_1035_cov_12.050214	138	219	8	3	81	0.0370370
NODE_6004_length_1035_cov_12.050214	138	219	11	7	81	0.0864198
NODE_6004_length_1035_cov_12.050214	138	219	12	8	81	0.0987654
NODE_6004_length_1035_cov_12.050214	138	219	14	5	81	0.0617284
NODE_6004_length_1035_cov_12.050214	138	219	16	8	81	0.0987654
NODE_6004_length_1035_cov_12.050214	138	219	17	10	81	0.1234568
NODE_6004_length_1035_cov_12.050214	138	219	19	1	81	0.0123457
NODE_6004_length_1035_cov_12.050214	138	219	21	9	81	0.1111111
NODE_6004_length_1035_cov_12.050214	138	219	23	12	81	0.1481481
NODE_6004_length_1035_cov_12.050214	138	219	25	1	81	0.0123457
NODE_6004_length_1035_cov_12.050214	138	219	27	13	81	0.1604938
NODE_6005_length_1035_cov_7.020299	350	430	0	80	80	1.0000000
NODE_6005_length_1035_cov_7.020299	403	483	0	80	80	1.0000000
NODE_6006_length_1035_cov_4.726496	531	611	0	28	80	0.3500000
NODE_6006_length_1035_cov_4.726496	531	611	2	52	80	0.6500000
NODE_6006_length_1035_cov_4.726496	584	664	0	80	80	1.0000000
NODE_6018_length_1034_cov_26.810695	322	402	0	80	80	1.0000000
NODE_6018_length_1034_cov_26.810695	375	455	0	63	80	0.7875000
NODE_6018_length_1034_cov_26.810695	375	455	4	17	80	0.2125000
NODE_6018_length_1034_cov_26.810695	451	531	4	59	80	0.7375000
NODE_6018_length_1034_cov_26.810695	451	531	6	3	80	0.0375000
NODE_6018_length_1034_cov_26.810695	451	531	10	18	80	0.2250000
NODE_6018_length_1034_cov_26.810695	504	584	4	6	80	0.0750000
NODE_6018_length_1034_cov_26.810695	504	584	6	54	80	0.6750000
NODE_6018_length_1034_cov_26.810695	504	584	10	20	80	0.2500000
NODE_6032_length_1033_cov_42.574946	462	542	2	20	80	0.2500000
NODE_6032_length_1033_cov_42.574946	462	542	4	42	80	0.5250000
NODE_6032_length_1033_cov_42.574946	462	542	6	18	80	0.2250000
NODE_6032_length_1033_cov_42.574946	515	595	0	22	80	0.2750000
NODE_6032_length_1033_cov_42.574946	515	595	2	51	80	0.6375000
NODE_6032_length_1033_cov_42.574946	515	595	6	7	80	0.0875000
NODE_6033_length_1033_cov_17.073876	464	544	0	80	80	1.0000000
NODE_6033_length_1033_cov_17.073876	517	597	0	80	80	1.0000000
NODE_6034_length_1033_cov_15.791221	309	386	0	49	77	0.6363636
NODE_6034_length_1033_cov_15.791221	309	386	6	24	77	0.3116883
NODE_6034_length_1033_cov_15.791221	309	386	8	4	77	0.0519481
NODE_6034_length_1033_cov_15.791221	359	439	6	23	80	0.2875000
NODE_6034_length_1033_cov_15.791221	359	439	8	57	80	0.7125000
NODE_6035_length_1033_cov_11.340471	437	517	0	56	80	0.7000000
NODE_6035_length_1033_cov_11.340471	437	517	4	23	80	0.2875000
NODE_6035_length_1033_cov_11.340471	437	517	11	1	80	0.0125000
NODE_6035_length_1033_cov_11.340471	490	570	0	3	80	0.0375000
NODE_6035_length_1033_cov_11.340471	490	570	4	23	80	0.2875000
NODE_6035_length_1033_cov_11.340471	490	570	8	16	80	0.2000000
NODE_6035_length_1033_cov_11.340471	490	570	11	1	80	0.0125000
NODE_6035_length_1033_cov_11.340471	490	570	12	37	80	0.4625000
NODE_6045_length_1032_cov_56.511254	466	546	0	26	80	0.3250000
NODE_6045_length_1032_cov_56.511254	466	546	4	54	80	0.6750000
NODE_6045_length_1032_cov_56.511254	519	599	4	44	80	0.5500000
NODE_6045_length_1032_cov_56.511254	519	599	6	36	80	0.4500000
NODE_6046_length_1032_cov_20.752412	479	559	2	29	80	0.3625000
NODE_6046_length_1032_cov_20.752412	479	559	4	51	80	0.6375000
NODE_6046_length_1032_cov_20.752412	532	612	0	46	80	0.5750000
NODE_6046_length_1032_cov_20.752412	532	612	2	22	80	0.2750000
NODE_6046_length_1032_cov_20.752412	532	612	4	12	80	0.1500000
NODE_6047_length_1032_cov_8.166131	257	337	0	17	80	0.2125000
NODE_6047_length_1032_cov_8.166131	257	337	2	63	80	0.7875000
NODE_6047_length_1032_cov_8.166131	310	390	0	70	80	0.8750000
NODE_6047_length_1032_cov_8.166131	310	390	2	10	80	0.1250000
NODE_6048_length_1032_cov_7.991426	277	357	0	80	80	1.0000000
NODE_6048_length_1032_cov_7.991426	330	410	0	80	80	1.0000000
NODE_6049_length_1032_cov_5.276527	371	451	0	65	80	0.8125000
NODE_6049_length_1032_cov_5.276527	371	451	2	15	80	0.1875000
NODE_6049_length_1032_cov_5.276527	424	504	0	80	80	1.0000000
NODE_6055_length_1031_cov_71.154506	586	654	18	21	68	0.3088235
NODE_6055_length_1031_cov_71.154506	586	654	20	2	68	0.0294118
NODE_6055_length_1031_cov_71.154506	586	654	24	27	68	0.3970588
NODE_6055_length_1031_cov_71.154506	586	654	26	16	68	0.2352941
NODE_6055_length_1031_cov_71.154506	586	654	28	2	68	0.0294118
NODE_6055_length_1031_cov_71.154506	616	696	8	1	80	0.0125000
NODE_6055_length_1031_cov_71.154506	616	696	10	4	80	0.0500000
NODE_6055_length_1031_cov_71.154506	616	696	12	6	80	0.0750000
NODE_6055_length_1031_cov_71.154506	616	696	18	5	80	0.0625000
NODE_6055_length_1031_cov_71.154506	616	696	20	7	80	0.0875000
NODE_6055_length_1031_cov_71.154506	616	696	24	30	80	0.3750000
NODE_6055_length_1031_cov_71.154506	616	696	26	18	80	0.2250000
NODE_6055_length_1031_cov_71.154506	616	696	28	9	80	0.1125000
NODE_6055_length_1031_cov_71.154506	669	749	2	15	80	0.1875000
NODE_6055_length_1031_cov_71.154506	669	749	6	20	80	0.2500000
NODE_6055_length_1031_cov_71.154506	669	749	8	19	80	0.2375000
NODE_6055_length_1031_cov_71.154506	669	749	10	4	80	0.0500000
NODE_6055_length_1031_cov_71.154506	669	749	12	6	80	0.0750000
NODE_6055_length_1031_cov_71.154506	669	749	18	5	80	0.0625000
NODE_6055_length_1031_cov_71.154506	669	749	20	7	80	0.0875000
NODE_6055_length_1031_cov_71.154506	669	749	24	4	80	0.0500000
NODE_6056_length_1031_cov_70.221030	409	489	4	33	80	0.4125000
NODE_6056_length_1031_cov_70.221030	409	489	6	41	80	0.5125000
NODE_6056_length_1031_cov_70.221030	409	489	8	6	80	0.0750000
NODE_6056_length_1031_cov_70.221030	462	542	0	19	80	0.2375000
NODE_6056_length_1031_cov_70.221030	462	542	4	39	80	0.4875000
NODE_6056_length_1031_cov_70.221030	462	542	6	22	80	0.2750000
NODE_6056_length_1031_cov_70.221030	538	618	0	16	80	0.2000000
NODE_6056_length_1031_cov_70.221030	538	618	2	64	80	0.8000000
NODE_6056_length_1031_cov_70.221030	591	671	0	48	80	0.6000000
NODE_6056_length_1031_cov_70.221030	591	671	2	32	80	0.4000000
NODE_6057_length_1031_cov_43.618026	462	542	2	78	80	0.9750000
NODE_6057_length_1031_cov_43.618026	462	542	4	2	80	0.0250000
NODE_6057_length_1031_cov_43.618026	515	595	2	77	80	0.9625000
NODE_6057_length_1031_cov_43.618026	515	595	4	3	80	0.0375000
NODE_6058_length_1031_cov_43.581545	303	383	0	80	80	1.0000000
NODE_6058_length_1031_cov_43.581545	356	436	0	80	80	1.0000000
NODE_6058_length_1031_cov_43.581545	432	512	0	64	80	0.8000000
NODE_6058_length_1031_cov_43.581545	432	512	4	16	80	0.2000000
NODE_6058_length_1031_cov_43.581545	485	565	0	11	80	0.1375000
NODE_6058_length_1031_cov_43.581545	485	565	4	36	80	0.4500000
NODE_6058_length_1031_cov_43.581545	485	565	9	1	80	0.0125000
NODE_6058_length_1031_cov_43.581545	485	565	10	32	80	0.4000000
NODE_6059_length_1031_cov_22.310086	382	462	0	36	80	0.4500000
NODE_6059_length_1031_cov_22.310086	382	462	2	44	80	0.5500000
NODE_6059_length_1031_cov_22.310086	435	515	0	11	80	0.1375000
NODE_6059_length_1031_cov_22.310086	435	515	2	69	80	0.8625000
NODE_6060_length_1031_cov_11.547210	481	561	0	80	80	1.0000000
NODE_6060_length_1031_cov_11.547210	534	614	0	80	80	1.0000000
NODE_6066_length_1030_cov_54.380236	363	443	0	80	80	1.0000000
NODE_6066_length_1030_cov_54.380236	416	496	0	80	80	1.0000000
NODE_6066_length_1030_cov_54.380236	492	572	0	7	80	0.0875000
NODE_6066_length_1030_cov_54.380236	492	572	2	60	80	0.7500000
NODE_6066_length_1030_cov_54.380236	492	572	4	13	80	0.1625000
NODE_6066_length_1030_cov_54.380236	545	625	2	67	80	0.8375000
NODE_6066_length_1030_cov_54.380236	545	625	4	13	80	0.1625000
NODE_6067_length_1030_cov_45.040816	334	414	0	22	80	0.2750000
NODE_6067_length_1030_cov_45.040816	334	414	4	3	80	0.0375000
NODE_6067_length_1030_cov_45.040816	334	414	8	12	80	0.1500000
NODE_6067_length_1030_cov_45.040816	334	414	10	9	80	0.1125000
NODE_6067_length_1030_cov_45.040816	334	414	14	34	80	0.4250000
NODE_6067_length_1030_cov_45.040816	387	467	0	75	80	0.9375000
NODE_6067_length_1030_cov_45.040816	387	467	4	3	80	0.0375000
NODE_6067_length_1030_cov_45.040816	387	467	8	2	80	0.0250000
NODE_6067_length_1030_cov_45.040816	463	543	0	15	80	0.1875000
NODE_6067_length_1030_cov_45.040816	463	543	2	7	80	0.0875000
NODE_6067_length_1030_cov_45.040816	463	543	4	32	80	0.4000000
NODE_6067_length_1030_cov_45.040816	463	543	10	1	80	0.0125000
NODE_6067_length_1030_cov_45.040816	463	543	12	25	80	0.3125000
NODE_6067_length_1030_cov_45.040816	516	596	4	1	80	0.0125000
NODE_6067_length_1030_cov_45.040816	516	596	8	26	80	0.3250000
NODE_6067_length_1030_cov_45.040816	516	596	10	18	80	0.2250000
NODE_6067_length_1030_cov_45.040816	516	596	12	35	80	0.4375000
NODE_6068_length_1030_cov_20.491944	511	591	0	80	80	1.0000000
NODE_6068_length_1030_cov_20.491944	564	644	0	80	80	1.0000000
NODE_6069_length_1030_cov_17.253491	524	604	0	80	80	1.0000000
NODE_6069_length_1030_cov_17.253491	577	657	0	80	80	1.0000000
NODE_6070_length_1030_cov_14.337272	564	644	0	80	80	1.0000000
NODE_6070_length_1030_cov_14.337272	617	697	0	80	80	1.0000000
NODE_6071_length_1030_cov_5.742213	474	554	0	78	80	0.9750000
NODE_6071_length_1030_cov_5.742213	474	554	1	2	80	0.0250000
NODE_6071_length_1030_cov_5.742213	527	607	0	80	80	1.0000000
NODE_6073_length_1030_cov_5.208378	978	1030	0	27	52	0.5192308
NODE_6073_length_1030_cov_5.208378	978	1030	2	13	52	0.2500000
NODE_6073_length_1030_cov_5.208378	978	1030	4	12	52	0.2307692
NODE_6077_length_1030_cov_2.146079	979	1010	0	31	31	1.0000000
NODE_6083_length_1029_cov_236.527957	584	666	16	4	82	0.0487805
NODE_6083_length_1029_cov_236.527957	584	666	19	1	82	0.0121951
NODE_6083_length_1029_cov_236.527957	584	666	21	7	82	0.0853659
NODE_6083_length_1029_cov_236.527957	584	666	23	4	82	0.0487805
NODE_6083_length_1029_cov_236.527957	584	666	24	1	82	0.0121951
NODE_6083_length_1029_cov_236.527957	584	666	25	5	82	0.0609756
NODE_6083_length_1029_cov_236.527957	584	666	28	18	82	0.2195122
NODE_6083_length_1029_cov_236.527957	584	666	30	11	82	0.1341463
NODE_6083_length_1029_cov_236.527957	584	666	32	26	82	0.3170732
NODE_6083_length_1029_cov_236.527957	584	666	34	5	82	0.0609756
NODE_6083_length_1029_cov_236.527957	639	702	8	2	63	0.0317460
NODE_6083_length_1029_cov_236.527957	639	702	10	4	63	0.0634921
NODE_6083_length_1029_cov_236.527957	639	702	11	1	63	0.0158730
NODE_6083_length_1029_cov_236.527957	639	702	12	10	63	0.1587302
NODE_6083_length_1029_cov_236.527957	639	702	16	6	63	0.0952381
NODE_6083_length_1029_cov_236.527957	639	702	18	9	63	0.1428571
NODE_6083_length_1029_cov_236.527957	639	702	20	2	63	0.0317460
NODE_6083_length_1029_cov_236.527957	639	702	24	3	63	0.0476190
NODE_6083_length_1029_cov_236.527957	639	702	28	18	63	0.2857143
NODE_6083_length_1029_cov_236.527957	639	702	32	3	63	0.0476190
NODE_6083_length_1029_cov_236.527957	639	702	34	5	63	0.0793651
NODE_6084_length_1029_cov_41.650538	364	444	2	45	80	0.5625000
NODE_6084_length_1029_cov_41.650538	364	444	4	35	80	0.4375000
NODE_6084_length_1029_cov_41.650538	417	497	2	30	80	0.3750000
NODE_6084_length_1029_cov_41.650538	417	497	4	22	80	0.2750000
NODE_6084_length_1029_cov_41.650538	417	497	6	28	80	0.3500000
NODE_6084_length_1029_cov_41.650538	493	573	4	10	80	0.1250000
NODE_6084_length_1029_cov_41.650538	493	573	6	70	80	0.8750000
NODE_6084_length_1029_cov_41.650538	546	626	0	24	80	0.3000000
NODE_6084_length_1029_cov_41.650538	546	626	4	13	80	0.1625000
NODE_6084_length_1029_cov_41.650538	546	626	6	43	80	0.5375000
NODE_6085_length_1029_cov_34.940860	314	360	0	46	46	1.0000000
NODE_6085_length_1029_cov_34.940860	371	451	0	80	80	1.0000000
NODE_6085_length_1029_cov_34.940860	424	502	0	78	78	1.0000000
NODE_6086_length_1029_cov_28.752688	255	335	0	80	80	1.0000000
NODE_6086_length_1029_cov_28.752688	308	388	0	80	80	1.0000000
NODE_6086_length_1029_cov_28.752688	384	464	0	63	80	0.7875000
NODE_6086_length_1029_cov_28.752688	384	464	2	6	80	0.0750000
NODE_6086_length_1029_cov_28.752688	384	464	6	11	80	0.1375000
NODE_6086_length_1029_cov_28.752688	437	517	0	10	80	0.1250000
NODE_6086_length_1029_cov_28.752688	437	517	2	6	80	0.0750000
NODE_6086_length_1029_cov_28.752688	437	517	6	64	80	0.8000000
NODE_6087_length_1029_cov_28.523656	409	489	0	35	80	0.4375000
NODE_6087_length_1029_cov_28.523656	409	489	2	1	80	0.0125000
NODE_6087_length_1029_cov_28.523656	409	489	10	44	80	0.5500000
NODE_6087_length_1029_cov_28.523656	462	542	10	80	80	1.0000000
NODE_6088_length_1029_cov_28.283871	281	361	2	80	80	1.0000000
NODE_6088_length_1029_cov_28.283871	334	414	0	29	80	0.3625000
NODE_6088_length_1029_cov_28.283871	334	414	2	51	80	0.6375000
NODE_6088_length_1029_cov_28.283871	410	490	0	49	80	0.6125000
NODE_6088_length_1029_cov_28.283871	410	490	2	24	80	0.3000000
NODE_6088_length_1029_cov_28.283871	410	490	4	7	80	0.0875000
NODE_6088_length_1029_cov_28.283871	463	546	2	20	83	0.2409639
NODE_6088_length_1029_cov_28.283871	463	546	4	63	83	0.7590361
NODE_6089_length_1029_cov_26.883871	434	514	0	17	80	0.2125000
NODE_6089_length_1029_cov_26.883871	434	514	4	63	80	0.7875000
NODE_6089_length_1029_cov_26.883871	487	567	0	70	80	0.8750000
NODE_6089_length_1029_cov_26.883871	487	567	4	10	80	0.1250000
NODE_6090_length_1029_cov_23.552688	305	385	2	8	80	0.1000000
NODE_6090_length_1029_cov_23.552688	305	385	4	63	80	0.7875000
NODE_6090_length_1029_cov_23.552688	305	385	6	9	80	0.1125000
NODE_6090_length_1029_cov_23.552688	358	438	0	29	80	0.3625000
NODE_6090_length_1029_cov_23.552688	358	438	2	13	80	0.1625000
NODE_6090_length_1029_cov_23.552688	358	438	4	38	80	0.4750000
NODE_6090_length_1029_cov_23.552688	434	514	0	80	80	1.0000000
NODE_6090_length_1029_cov_23.552688	487	567	0	80	80	1.0000000
NODE_6091_length_1029_cov_22.520430	434	514	0	6	80	0.0750000
NODE_6091_length_1029_cov_22.520430	434	514	2	74	80	0.9250000
NODE_6091_length_1029_cov_22.520430	487	567	0	59	80	0.7375000
NODE_6091_length_1029_cov_22.520430	487	567	2	21	80	0.2625000
NODE_6092_length_1029_cov_21.924731	335	415	0	80	80	1.0000000
NODE_6092_length_1029_cov_21.924731	388	468	0	80	80	1.0000000
NODE_6093_length_1029_cov_17.101075	501	581	0	21	80	0.2625000
NODE_6093_length_1029_cov_17.101075	501	581	2	59	80	0.7375000
NODE_6093_length_1029_cov_17.101075	554	634	0	74	80	0.9250000
NODE_6093_length_1029_cov_17.101075	554	634	2	6	80	0.0750000
NODE_6093_length_1029_cov_17.101075	630	710	0	80	80	1.0000000
NODE_6093_length_1029_cov_17.101075	683	755	0	72	72	1.0000000
NODE_6094_length_1029_cov_14.052688	405	485	0	41	80	0.5125000
NODE_6094_length_1029_cov_14.052688	405	485	2	39	80	0.4875000
NODE_6094_length_1029_cov_14.052688	458	538	0	10	80	0.1250000
NODE_6094_length_1029_cov_14.052688	458	538	2	70	80	0.8750000
NODE_6095_length_1029_cov_11.119355	291	369	0	17	78	0.2179487
NODE_6095_length_1029_cov_11.119355	291	369	4	1	78	0.0128205
NODE_6095_length_1029_cov_11.119355	291	369	6	60	78	0.7692308
NODE_6095_length_1029_cov_11.119355	342	422	0	31	80	0.3875000
NODE_6095_length_1029_cov_11.119355	342	422	4	17	80	0.2125000
NODE_6095_length_1029_cov_11.119355	342	422	6	32	80	0.4000000
NODE_6097_length_1029_cov_3.850538	231	311	0	80	80	1.0000000
NODE_6097_length_1029_cov_3.850538	284	364	0	80	80	1.0000000
NODE_6104_length_1028_cov_19.625404	495	575	0	80	80	1.0000000
NODE_6104_length_1028_cov_19.625404	548	628	0	80	80	1.0000000
NODE_6105_length_1028_cov_17.497309	533	613	0	24	80	0.3000000
NODE_6105_length_1028_cov_17.497309	533	613	2	56	80	0.7000000
NODE_6105_length_1028_cov_17.497309	586	666	0	31	80	0.3875000
NODE_6105_length_1028_cov_17.497309	586	666	2	49	80	0.6125000
NODE_6106_length_1028_cov_16.528525	497	577	2	25	80	0.3125000
NODE_6106_length_1028_cov_16.528525	497	577	4	55	80	0.6875000
NODE_6106_length_1028_cov_16.528525	550	630	0	11	80	0.1375000
NODE_6106_length_1028_cov_16.528525	550	630	1	6	80	0.0750000
NODE_6106_length_1028_cov_16.528525	550	630	3	1	80	0.0125000
NODE_6106_length_1028_cov_16.528525	550	630	4	62	80	0.7750000
NODE_6107_length_1028_cov_10.212056	463	543	0	80	80	1.0000000
NODE_6107_length_1028_cov_10.212056	516	596	0	80	80	1.0000000
NODE_6108_length_1028_cov_10.131324	399	479	0	80	80	1.0000000
NODE_6108_length_1028_cov_10.131324	452	532	0	80	80	1.0000000
NODE_6109_length_1028_cov_9.773950	482	562	0	78	80	0.9750000
NODE_6109_length_1028_cov_9.773950	482	562	2	2	80	0.0250000
NODE_6109_length_1028_cov_9.773950	535	615	0	25	80	0.3125000
NODE_6109_length_1028_cov_9.773950	535	615	2	55	80	0.6875000
NODE_6110_length_1028_cov_8.079656	399	479	0	80	80	1.0000000
NODE_6110_length_1028_cov_8.079656	452	532	0	80	80	1.0000000
NODE_6111_length_1028_cov_7.092573	439	519	2	18	80	0.2250000
NODE_6111_length_1028_cov_7.092573	439	519	4	2	80	0.0250000
NODE_6111_length_1028_cov_7.092573	439	519	6	60	80	0.7500000
NODE_6111_length_1028_cov_7.092573	492	572	0	28	80	0.3500000
NODE_6111_length_1028_cov_7.092573	492	572	2	4	80	0.0500000
NODE_6111_length_1028_cov_7.092573	492	572	4	7	80	0.0875000
NODE_6111_length_1028_cov_7.092573	492	572	6	41	80	0.5125000
NODE_6112_length_1028_cov_4.727664	416	488	0	71	72	0.9861111
NODE_6112_length_1028_cov_4.727664	416	488	2	1	72	0.0138889
NODE_6112_length_1028_cov_4.727664	461	541	0	26	80	0.3250000
NODE_6112_length_1028_cov_4.727664	461	541	2	54	80	0.6750000
NODE_6125_length_1027_cov_51.341595	399	479	0	80	80	1.0000000
NODE_6125_length_1027_cov_51.341595	452	532	0	80	80	1.0000000
NODE_6125_length_1027_cov_51.341595	528	608	0	80	80	1.0000000
NODE_6125_length_1027_cov_51.341595	581	661	0	67	80	0.8375000
NODE_6125_length_1027_cov_51.341595	581	661	2	13	80	0.1625000
NODE_6126_length_1027_cov_45.613147	347	427	2	48	80	0.6000000
NODE_6126_length_1027_cov_45.613147	347	427	4	32	80	0.4000000
NODE_6126_length_1027_cov_45.613147	400	480	0	26	80	0.3250000
NODE_6126_length_1027_cov_45.613147	400	480	2	1	80	0.0125000
NODE_6126_length_1027_cov_45.613147	400	480	3	1	80	0.0125000
NODE_6126_length_1027_cov_45.613147	400	480	4	52	80	0.6500000
NODE_6126_length_1027_cov_45.613147	476	556	0	6	80	0.0750000
NODE_6126_length_1027_cov_45.613147	476	556	2	13	80	0.1625000
NODE_6126_length_1027_cov_45.613147	476	556	3	14	80	0.1750000
NODE_6126_length_1027_cov_45.613147	476	556	5	17	80	0.2125000
NODE_6126_length_1027_cov_45.613147	476	556	6	5	80	0.0625000
NODE_6126_length_1027_cov_45.613147	476	556	8	7	80	0.0875000
NODE_6126_length_1027_cov_45.613147	476	556	10	18	80	0.2250000
NODE_6126_length_1027_cov_45.613147	529	609	4	8	80	0.1000000
NODE_6126_length_1027_cov_45.613147	529	609	6	3	80	0.0375000
NODE_6126_length_1027_cov_45.613147	529	609	8	14	80	0.1750000
NODE_6126_length_1027_cov_45.613147	529	609	9	2	80	0.0250000
NODE_6126_length_1027_cov_45.613147	529	609	10	53	80	0.6625000
NODE_6127_length_1027_cov_35.435345	431	511	42	1	80	0.0125000
NODE_6127_length_1027_cov_35.435345	431	511	50	1	80	0.0125000
NODE_6127_length_1027_cov_35.435345	431	511	52	12	80	0.1500000
NODE_6127_length_1027_cov_35.435345	431	511	53	7	80	0.0875000
NODE_6127_length_1027_cov_35.435345	431	511	54	16	80	0.2000000
NODE_6127_length_1027_cov_35.435345	431	511	56	28	80	0.3500000
NODE_6127_length_1027_cov_35.435345	431	511	57	12	80	0.1500000
NODE_6127_length_1027_cov_35.435345	431	511	59	2	80	0.0250000
NODE_6127_length_1027_cov_35.435345	431	511	60	1	80	0.0125000
NODE_6127_length_1027_cov_35.435345	484	564	33	6	80	0.0750000
NODE_6127_length_1027_cov_35.435345	484	564	35	13	80	0.1625000
NODE_6127_length_1027_cov_35.435345	484	564	37	1	80	0.0125000
NODE_6127_length_1027_cov_35.435345	484	564	39	3	80	0.0375000
NODE_6127_length_1027_cov_35.435345	484	564	50	3	80	0.0375000
NODE_6127_length_1027_cov_35.435345	484	564	51	16	80	0.2000000
NODE_6127_length_1027_cov_35.435345	484	564	52	3	80	0.0375000
NODE_6127_length_1027_cov_35.435345	484	564	56	8	80	0.1000000
NODE_6127_length_1027_cov_35.435345	484	564	57	24	80	0.3000000
NODE_6127_length_1027_cov_35.435345	484	564	59	2	80	0.0250000
NODE_6127_length_1027_cov_35.435345	484	564	60	1	80	0.0125000
NODE_6135_length_1026_cov_39.737864	374	454	0	80	80	1.0000000
NODE_6135_length_1026_cov_39.737864	427	509	0	82	82	1.0000000
NODE_6135_length_1026_cov_39.737864	505	585	0	80	80	1.0000000
NODE_6135_length_1026_cov_39.737864	558	638	0	39	80	0.4875000
NODE_6135_length_1026_cov_39.737864	558	638	8	41	80	0.5125000
NODE_6136_length_1026_cov_26.400216	423	503	0	80	80	1.0000000
NODE_6136_length_1026_cov_26.400216	476	556	0	80	80	1.0000000
NODE_6137_length_1026_cov_25.325782	477	557	0	80	80	1.0000000
NODE_6137_length_1026_cov_25.325782	530	610	0	44	80	0.5500000
NODE_6137_length_1026_cov_25.325782	530	610	6	16	80	0.2000000
NODE_6137_length_1026_cov_25.325782	530	610	17	3	80	0.0375000
NODE_6137_length_1026_cov_25.325782	530	610	18	17	80	0.2125000
NODE_6137_length_1026_cov_25.325782	606	686	18	4	80	0.0500000
NODE_6137_length_1026_cov_25.325782	606	686	26	1	80	0.0125000
NODE_6137_length_1026_cov_25.325782	606	686	28	16	80	0.2000000
NODE_6137_length_1026_cov_25.325782	606	686	30	5	80	0.0625000
NODE_6137_length_1026_cov_25.325782	606	686	34	12	80	0.1500000
NODE_6137_length_1026_cov_25.325782	606	686	35	28	80	0.3500000
NODE_6137_length_1026_cov_25.325782	606	686	36	14	80	0.1750000
NODE_6137_length_1026_cov_25.325782	659	739	0	26	80	0.3250000
NODE_6137_length_1026_cov_25.325782	659	739	8	1	80	0.0125000
NODE_6137_length_1026_cov_25.325782	659	739	9	1	80	0.0125000
NODE_6137_length_1026_cov_25.325782	659	739	14	10	80	0.1250000
NODE_6137_length_1026_cov_25.325782	659	739	16	3	80	0.0375000
NODE_6137_length_1026_cov_25.325782	659	739	27	6	80	0.0750000
NODE_6137_length_1026_cov_25.325782	659	739	28	22	80	0.2750000
NODE_6137_length_1026_cov_25.325782	659	739	34	11	80	0.1375000
NODE_6138_length_1026_cov_22.218986	408	488	0	25	80	0.3125000
NODE_6138_length_1026_cov_22.218986	408	488	2	55	80	0.6875000
NODE_6138_length_1026_cov_22.218986	461	541	0	78	80	0.9750000
NODE_6138_length_1026_cov_22.218986	461	541	2	2	80	0.0250000
NODE_6138_length_1026_cov_22.218986	537	617	0	80	80	1.0000000
NODE_6138_length_1026_cov_22.218986	590	670	0	80	80	1.0000000
NODE_6139_length_1026_cov_15.640777	450	530	0	80	80	1.0000000
NODE_6139_length_1026_cov_15.640777	503	583	0	80	80	1.0000000
NODE_6140_length_1026_cov_12.062567	165	245	6	80	80	1.0000000
NODE_6140_length_1026_cov_12.062567	218	298	0	8	80	0.1000000
NODE_6140_length_1026_cov_12.062567	218	298	2	8	80	0.1000000
NODE_6140_length_1026_cov_12.062567	218	298	6	27	80	0.3375000
NODE_6140_length_1026_cov_12.062567	218	298	8	37	80	0.4625000
NODE_6142_length_1026_cov_5.002157	335	415	0	80	80	1.0000000
NODE_6142_length_1026_cov_5.002157	388	468	0	80	80	1.0000000
NODE_6155_length_1025_cov_52.053996	366	446	0	80	80	1.0000000
NODE_6155_length_1025_cov_52.053996	419	499	0	80	80	1.0000000
NODE_6155_length_1025_cov_52.053996	495	575	0	19	80	0.2375000
NODE_6155_length_1025_cov_52.053996	495	575	6	61	80	0.7625000
NODE_6155_length_1025_cov_52.053996	548	628	0	37	80	0.4625000
NODE_6155_length_1025_cov_52.053996	548	628	6	43	80	0.5375000
NODE_6156_length_1025_cov_35.980562	318	375	0	57	57	1.0000000
NODE_6156_length_1025_cov_35.980562	348	428	0	41	80	0.5125000
NODE_6156_length_1025_cov_35.980562	348	428	4	1	80	0.0125000
NODE_6156_length_1025_cov_35.980562	348	428	5	1	80	0.0125000
NODE_6156_length_1025_cov_35.980562	348	428	6	37	80	0.4625000
NODE_6156_length_1025_cov_35.980562	425	482	6	57	57	1.0000000
NODE_6156_length_1025_cov_35.980562	455	521	0	39	66	0.5909091
NODE_6156_length_1025_cov_35.980562	455	521	6	27	66	0.4090909
NODE_6157_length_1025_cov_26.954644	607	687	0	80	80	1.0000000
NODE_6157_length_1025_cov_26.954644	660	740	0	80	80	1.0000000
NODE_6158_length_1025_cov_20.576674	428	508	2	34	80	0.4250000
NODE_6158_length_1025_cov_20.576674	428	508	4	28	80	0.3500000
NODE_6158_length_1025_cov_20.576674	428	508	6	18	80	0.2250000
NODE_6158_length_1025_cov_20.576674	481	561	0	20	80	0.2500000
NODE_6158_length_1025_cov_20.576674	481	561	4	60	80	0.7500000
NODE_6159_length_1025_cov_15.525918	415	495	4	27	80	0.3375000
NODE_6159_length_1025_cov_15.525918	415	495	8	53	80	0.6625000
NODE_6159_length_1025_cov_15.525918	468	548	0	46	80	0.5750000
NODE_6159_length_1025_cov_15.525918	468	548	4	19	80	0.2375000
NODE_6159_length_1025_cov_15.525918	468	548	8	15	80	0.1875000
NODE_6160_length_1025_cov_7.044276	240	320	0	80	80	1.0000000
NODE_6161_length_1025_cov_6.688985	334	414	0	80	80	1.0000000
NODE_6161_length_1025_cov_6.688985	387	467	0	80	80	1.0000000
NODE_6170_length_1024_cov_28.681081	264	344	0	8	80	0.1000000
NODE_6170_length_1024_cov_28.681081	264	344	2	72	80	0.9000000
NODE_6170_length_1024_cov_28.681081	317	397	0	40	80	0.5000000
NODE_6170_length_1024_cov_28.681081	317	397	2	40	80	0.5000000
NODE_6170_length_1024_cov_28.681081	393	477	0	84	84	1.0000000
NODE_6171_length_1024_cov_17.922162	324	404	2	80	80	1.0000000
NODE_6171_length_1024_cov_17.922162	377	457	0	43	80	0.5375000
NODE_6171_length_1024_cov_17.922162	377	457	2	37	80	0.4625000
NODE_6173_length_1024_cov_12.018378	368	448	0	20	80	0.2500000
NODE_6173_length_1024_cov_12.018378	368	448	2	24	80	0.3000000
NODE_6173_length_1024_cov_12.018378	368	448	4	26	80	0.3250000
NODE_6173_length_1024_cov_12.018378	368	448	6	10	80	0.1250000
NODE_6173_length_1024_cov_12.018378	421	501	2	20	80	0.2500000
NODE_6173_length_1024_cov_12.018378	421	501	4	31	80	0.3875000
NODE_6173_length_1024_cov_12.018378	421	501	6	29	80	0.3625000
NODE_6174_length_1024_cov_8.800000	517	597	0	80	80	1.0000000
NODE_6174_length_1024_cov_8.800000	570	650	0	80	80	1.0000000
NODE_6175_length_1024_cov_6.207568	318	398	0	80	80	1.0000000
NODE_6175_length_1024_cov_6.207568	371	451	0	80	80	1.0000000
NODE_6178_length_1024_cov_2.468108	274	324	0	50	50	1.0000000
NODE_6178_length_1024_cov_2.468108	274	322	0	48	48	1.0000000
NODE_6178_length_1024_cov_2.468108	274	324	0	50	50	1.0000000
NODE_6178_length_1024_cov_2.468108	274	323	0	49	49	1.0000000
NODE_6178_length_1024_cov_2.468108	274	322	0	48	48	1.0000000
NODE_6185_length_1023_cov_100.366883	441	521	6	80	80	1.0000000
NODE_6185_length_1023_cov_100.366883	494	574	0	23	80	0.2875000
NODE_6185_length_1023_cov_100.366883	494	574	6	57	80	0.7125000
NODE_6186_length_1023_cov_64.271645	349	429	0	80	80	1.0000000
NODE_6186_length_1023_cov_64.271645	402	482	0	80	80	1.0000000
NODE_6186_length_1023_cov_64.271645	478	558	0	24	80	0.3000000
NODE_6186_length_1023_cov_64.271645	478	558	6	42	80	0.5250000
NODE_6186_length_1023_cov_64.271645	478	558	8	14	80	0.1750000
NODE_6186_length_1023_cov_64.271645	531	611	6	25	80	0.3125000
NODE_6186_length_1023_cov_64.271645	531	611	8	19	80	0.2375000
NODE_6186_length_1023_cov_64.271645	531	611	9	2	80	0.0250000
NODE_6186_length_1023_cov_64.271645	531	611	11	2	80	0.0250000
NODE_6186_length_1023_cov_64.271645	531	611	12	32	80	0.4000000
NODE_6187_length_1023_cov_32.695887	318	398	4	80	80	1.0000000
NODE_6187_length_1023_cov_32.695887	371	451	0	44	80	0.5500000
NODE_6187_length_1023_cov_32.695887	371	451	4	36	80	0.4500000
NODE_6187_length_1023_cov_32.695887	447	527	0	80	80	1.0000000
NODE_6187_length_1023_cov_32.695887	500	580	0	80	80	1.0000000
NODE_6188_length_1023_cov_16.244589	601	681	0	80	80	1.0000000
NODE_6188_length_1023_cov_16.244589	654	734	0	80	80	1.0000000
NODE_6189_length_1023_cov_15.876623	371	451	0	20	80	0.2500000
NODE_6189_length_1023_cov_15.876623	371	451	2	11	80	0.1375000
NODE_6189_length_1023_cov_15.876623	371	451	4	49	80	0.6125000
NODE_6189_length_1023_cov_15.876623	424	504	0	31	80	0.3875000
NODE_6189_length_1023_cov_15.876623	424	504	2	9	80	0.1125000
NODE_6189_length_1023_cov_15.876623	424	504	4	40	80	0.5000000
NODE_6189_length_1023_cov_15.876623	500	580	0	23	80	0.2875000
NODE_6189_length_1023_cov_15.876623	500	580	2	57	80	0.7125000
NODE_6189_length_1023_cov_15.876623	553	633	2	80	80	1.0000000
NODE_6190_length_1023_cov_14.678571	555	635	0	80	80	1.0000000
NODE_6190_length_1023_cov_14.678571	608	688	0	80	80	1.0000000
NODE_6191_length_1023_cov_14.443723	406	486	0	60	80	0.7500000
NODE_6191_length_1023_cov_14.443723	406	486	2	20	80	0.2500000
NODE_6191_length_1023_cov_14.443723	459	539	0	80	80	1.0000000
NODE_6192_length_1023_cov_10.984848	590	670	0	72	80	0.9000000
NODE_6192_length_1023_cov_10.984848	590	670	1	8	80	0.1000000
NODE_6192_length_1023_cov_10.984848	643	723	0	57	80	0.7125000
NODE_6192_length_1023_cov_10.984848	643	723	2	23	80	0.2875000
NODE_6202_length_1022_cov_42.952329	555	636	0	35	81	0.4320988
NODE_6202_length_1022_cov_42.952329	555	636	4	46	81	0.5679013
NODE_6202_length_1022_cov_42.952329	609	689	4	80	80	1.0000000
NODE_6202_length_1022_cov_42.952329	685	765	0	11	80	0.1375000
NODE_6202_length_1022_cov_42.952329	685	765	2	63	80	0.7875000
NODE_6202_length_1022_cov_42.952329	685	765	4	6	80	0.0750000
NODE_6202_length_1022_cov_42.952329	738	818	2	72	80	0.9000000
NODE_6202_length_1022_cov_42.952329	738	818	4	8	80	0.1000000
NODE_6203_length_1022_cov_29.949079	510	590	0	71	80	0.8875000
NODE_6203_length_1022_cov_29.949079	510	590	2	4	80	0.0500000
NODE_6203_length_1022_cov_29.949079	510	590	4	5	80	0.0625000
NODE_6203_length_1022_cov_29.949079	563	643	0	18	80	0.2250000
NODE_6203_length_1022_cov_29.949079	563	643	2	4	80	0.0500000
NODE_6203_length_1022_cov_29.949079	563	643	4	58	80	0.7250000
NODE_6204_length_1022_cov_7.672806	461	541	0	78	80	0.9750000
NODE_6204_length_1022_cov_7.672806	461	541	2	2	80	0.0250000
NODE_6204_length_1022_cov_7.672806	514	594	0	25	80	0.3125000
NODE_6204_length_1022_cov_7.672806	514	594	2	55	80	0.6875000
NODE_6213_length_1021_cov_47.379610	341	421	21	23	80	0.2875000
NODE_6213_length_1021_cov_47.379610	341	421	22	24	80	0.3000000
NODE_6213_length_1021_cov_47.379610	341	421	24	33	80	0.4125000
NODE_6213_length_1021_cov_47.379610	394	474	19	5	80	0.0625000
NODE_6213_length_1021_cov_47.379610	394	474	21	71	80	0.8875000
NODE_6213_length_1021_cov_47.379610	394	474	22	4	80	0.0500000
NODE_6213_length_1021_cov_47.379610	470	550	2	22	80	0.2750000
NODE_6213_length_1021_cov_47.379610	470	550	4	46	80	0.5750000
NODE_6213_length_1021_cov_47.379610	470	550	5	3	80	0.0375000
NODE_6213_length_1021_cov_47.379610	470	550	7	1	80	0.0125000
NODE_6213_length_1021_cov_47.379610	470	550	9	2	80	0.0250000
NODE_6213_length_1021_cov_47.379610	470	550	18	1	80	0.0125000
NODE_6213_length_1021_cov_47.379610	470	550	19	5	80	0.0625000
NODE_6213_length_1021_cov_47.379610	523	603	0	29	80	0.3625000
NODE_6213_length_1021_cov_47.379610	523	603	2	25	80	0.3125000
NODE_6213_length_1021_cov_47.379610	523	603	4	26	80	0.3250000
NODE_6214_length_1021_cov_33.255965	588	668	2	80	80	1.0000000
NODE_6214_length_1021_cov_33.255965	641	721	0	29	80	0.3625000
NODE_6214_length_1021_cov_33.255965	641	721	2	51	80	0.6375000
NODE_6227_length_1020_cov_24.565689	485	565	0	80	80	1.0000000
NODE_6227_length_1020_cov_24.565689	538	618	0	80	80	1.0000000
NODE_6228_length_1020_cov_20.825190	395	475	0	13	80	0.1625000
NODE_6228_length_1020_cov_20.825190	395	475	2	10	80	0.1250000
NODE_6228_length_1020_cov_20.825190	395	475	6	57	80	0.7125000
NODE_6228_length_1020_cov_20.825190	448	528	0	66	80	0.8250000
NODE_6228_length_1020_cov_20.825190	448	528	2	10	80	0.1250000
NODE_6228_length_1020_cov_20.825190	448	528	6	4	80	0.0500000
NODE_6229_length_1020_cov_20.305103	285	365	0	63	80	0.7875000
NODE_6229_length_1020_cov_20.305103	285	365	3	1	80	0.0125000
NODE_6229_length_1020_cov_20.305103	285	365	4	16	80	0.2000000
NODE_6229_length_1020_cov_20.305103	338	418	0	80	80	1.0000000
NODE_6229_length_1020_cov_20.305103	414	494	0	64	80	0.8000000
NODE_6229_length_1020_cov_20.305103	414	494	2	16	80	0.2000000
NODE_6229_length_1020_cov_20.305103	467	548	0	11	81	0.1358025
NODE_6229_length_1020_cov_20.305103	467	548	2	70	81	0.8641976
NODE_6230_length_1020_cov_17.919653	408	488	0	46	80	0.5750000
NODE_6230_length_1020_cov_17.919653	408	488	2	34	80	0.4250000
NODE_6230_length_1020_cov_17.919653	461	541	0	17	80	0.2125000
NODE_6230_length_1020_cov_17.919653	461	541	2	63	80	0.7875000
NODE_6231_length_1020_cov_13.972856	436	516	0	4	80	0.0500000
NODE_6231_length_1020_cov_13.972856	436	516	6	76	80	0.9500000
NODE_6231_length_1020_cov_13.972856	489	569	0	55	80	0.6875000
NODE_6231_length_1020_cov_13.972856	489	569	6	25	80	0.3125000
NODE_6232_length_1020_cov_10.472313	407	487	0	80	80	1.0000000
NODE_6232_length_1020_cov_10.472313	460	540	0	80	80	1.0000000
NODE_6235_length_1020_cov_3.707926	821	901	0	80	80	1.0000000
NODE_6235_length_1020_cov_3.707926	874	954	0	80	80	1.0000000
NODE_6238_length_1020_cov_2.648208	0	70	0	70	70	1.0000000
NODE_6238_length_1020_cov_2.648208	43	88	0	45	45	1.0000000
NODE_6248_length_1019_cov_30.164130	476	556	0	26	80	0.3250000
NODE_6248_length_1019_cov_30.164130	476	556	2	54	80	0.6750000
NODE_6248_length_1019_cov_30.164130	529	609	2	61	80	0.7625000
NODE_6248_length_1019_cov_30.164130	529	609	4	19	80	0.2375000
NODE_6248_length_1019_cov_30.164130	605	685	2	60	80	0.7500000
NODE_6248_length_1019_cov_30.164130	605	685	4	20	80	0.2500000
NODE_6248_length_1019_cov_30.164130	658	738	2	60	80	0.7500000
NODE_6248_length_1019_cov_30.164130	658	738	4	20	80	0.2500000
NODE_6249_length_1019_cov_22.845652	343	423	0	19	80	0.2375000
NODE_6249_length_1019_cov_22.845652	343	423	2	61	80	0.7625000
NODE_6249_length_1019_cov_22.845652	396	476	0	29	80	0.3625000
NODE_6249_length_1019_cov_22.845652	396	476	2	51	80	0.6375000
NODE_6249_length_1019_cov_22.845652	472	552	2	59	80	0.7375000
NODE_6249_length_1019_cov_22.845652	472	552	4	21	80	0.2625000
NODE_6249_length_1019_cov_22.845652	525	605	0	33	80	0.4125000
NODE_6249_length_1019_cov_22.845652	525	605	2	47	80	0.5875000
NODE_6250_length_1019_cov_8.098913	523	601	0	23	78	0.2948718
NODE_6250_length_1019_cov_8.098913	523	601	2	55	78	0.7051282
NODE_6250_length_1019_cov_8.098913	574	654	0	33	80	0.4125000
NODE_6250_length_1019_cov_8.098913	574	654	2	47	80	0.5875000
NODE_6251_length_1019_cov_7.896739	423	503	0	80	80	1.0000000
NODE_6251_length_1019_cov_7.896739	476	556	0	80	80	1.0000000
NODE_6252_length_1019_cov_4.597826	625	696	10	8	71	0.1126761
NODE_6252_length_1019_cov_4.597826	625	696	15	1	71	0.0140845
NODE_6252_length_1019_cov_4.597826	625	696	16	6	71	0.0845070
NODE_6252_length_1019_cov_4.597826	625	696	18	15	71	0.2112676
NODE_6252_length_1019_cov_4.597826	625	696	19	1	71	0.0140845
NODE_6252_length_1019_cov_4.597826	625	696	20	1	71	0.0140845
NODE_6252_length_1019_cov_4.597826	625	696	27	39	71	0.5492958
NODE_6263_length_1019_cov_1.139130	89	165	4	9	76	0.1184211
NODE_6263_length_1019_cov_1.139130	89	165	8	2	76	0.0263158
NODE_6263_length_1019_cov_1.139130	89	165	10	13	76	0.1710526
NODE_6263_length_1019_cov_1.139130	89	165	12	5	76	0.0657895
NODE_6263_length_1019_cov_1.139130	89	165	14	35	76	0.4605263
NODE_6263_length_1019_cov_1.139130	89	165	16	12	76	0.1578947
NODE_6265_length_1018_cov_33.494015	212	292	9	4	80	0.0500000
NODE_6265_length_1018_cov_33.494015	212	292	11	2	80	0.0250000
NODE_6265_length_1018_cov_33.494015	212	292	13	1	80	0.0125000
NODE_6265_length_1018_cov_33.494015	212	292	15	2	80	0.0250000
NODE_6265_length_1018_cov_33.494015	212	292	23	1	80	0.0125000
NODE_6265_length_1018_cov_33.494015	212	292	25	3	80	0.0375000
NODE_6265_length_1018_cov_33.494015	212	292	29	13	80	0.1625000
NODE_6265_length_1018_cov_33.494015	212	292	31	4	80	0.0500000
NODE_6265_length_1018_cov_33.494015	212	292	32	1	80	0.0125000
NODE_6265_length_1018_cov_33.494015	212	292	33	6	80	0.0750000
NODE_6265_length_1018_cov_33.494015	212	292	34	9	80	0.1125000
NODE_6265_length_1018_cov_33.494015	212	292	36	8	80	0.1000000
NODE_6265_length_1018_cov_33.494015	212	292	38	8	80	0.1000000
NODE_6265_length_1018_cov_33.494015	212	292	39	18	80	0.2250000
NODE_6265_length_1018_cov_33.494015	265	345	0	30	80	0.3750000
NODE_6265_length_1018_cov_33.494015	265	345	4	13	80	0.1625000
NODE_6265_length_1018_cov_33.494015	265	345	6	1	80	0.0125000
NODE_6265_length_1018_cov_33.494015	265	345	8	4	80	0.0500000
NODE_6265_length_1018_cov_33.494015	265	345	9	9	80	0.1125000
NODE_6265_length_1018_cov_33.494015	265	345	11	2	80	0.0250000
NODE_6265_length_1018_cov_33.494015	265	345	13	1	80	0.0125000
NODE_6265_length_1018_cov_33.494015	265	345	15	2	80	0.0250000
NODE_6265_length_1018_cov_33.494015	265	345	25	3	80	0.0375000
NODE_6265_length_1018_cov_33.494015	265	345	29	2	80	0.0250000
NODE_6265_length_1018_cov_33.494015	265	345	32	1	80	0.0125000
NODE_6265_length_1018_cov_33.494015	265	345	33	6	80	0.0750000
NODE_6265_length_1018_cov_33.494015	265	345	34	6	80	0.0750000
NODE_6266_length_1018_cov_22.776931	372	452	0	80	80	1.0000000
NODE_6266_length_1018_cov_22.776931	425	505	0	80	80	1.0000000
NODE_6268_length_1018_cov_8.486398	404	484	0	80	80	1.0000000
NODE_6268_length_1018_cov_8.486398	457	537	0	80	80	1.0000000
NODE_6270_length_1018_cov_7.737758	357	437	0	80	80	1.0000000
NODE_6270_length_1018_cov_7.737758	410	490	0	80	80	1.0000000
NODE_6286_length_1017_cov_207.523965	0	41	14	3	41	0.0731707
NODE_6286_length_1017_cov_207.523965	0	41	16	12	41	0.2926829
NODE_6286_length_1017_cov_207.523965	0	41	20	1	41	0.0243902
NODE_6286_length_1017_cov_207.523965	0	41	22	1	41	0.0243902
NODE_6286_length_1017_cov_207.523965	0	41	24	1	41	0.0243902
NODE_6286_length_1017_cov_207.523965	0	41	26	6	41	0.1463415
NODE_6286_length_1017_cov_207.523965	0	41	30	2	41	0.0487805
NODE_6286_length_1017_cov_207.523965	0	41	32	4	41	0.0975610
NODE_6286_length_1017_cov_207.523965	0	41	36	1	41	0.0243902
NODE_6286_length_1017_cov_207.523965	0	41	40	7	41	0.1707317
NODE_6286_length_1017_cov_207.523965	0	41	42	3	41	0.0731707
NODE_6286_length_1017_cov_207.523965	14	94	16	1	80	0.0125000
NODE_6286_length_1017_cov_207.523965	14	94	20	1	80	0.0125000
NODE_6286_length_1017_cov_207.523965	14	94	22	1	80	0.0125000
NODE_6286_length_1017_cov_207.523965	14	94	24	1	80	0.0125000
NODE_6286_length_1017_cov_207.523965	14	94	26	6	80	0.0750000
NODE_6286_length_1017_cov_207.523965	14	94	30	2	80	0.0250000
NODE_6286_length_1017_cov_207.523965	14	94	32	4	80	0.0500000
NODE_6286_length_1017_cov_207.523965	14	94	36	1	80	0.0125000
NODE_6286_length_1017_cov_207.523965	14	94	40	7	80	0.0875000
NODE_6286_length_1017_cov_207.523965	14	94	42	3	80	0.0375000
NODE_6286_length_1017_cov_207.523965	14	94	44	9	80	0.1125000
NODE_6286_length_1017_cov_207.523965	14	94	46	1	80	0.0125000
NODE_6286_length_1017_cov_207.523965	14	94	48	4	80	0.0500000
NODE_6286_length_1017_cov_207.523965	14	94	50	33	80	0.4125000
NODE_6286_length_1017_cov_207.523965	14	94	52	6	80	0.0750000
NODE_6287_length_1017_cov_18.824619	490	570	2	80	80	1.0000000
NODE_6287_length_1017_cov_18.824619	543	623	0	41	80	0.5125000
NODE_6287_length_1017_cov_18.824619	543	623	2	39	80	0.4875000
NODE_6288_length_1017_cov_14.794118	428	508	0	80	80	1.0000000
NODE_6288_length_1017_cov_14.794118	481	561	0	80	80	1.0000000
NODE_6288_length_1017_cov_14.794118	557	637	0	80	80	1.0000000
NODE_6288_length_1017_cov_14.794118	610	690	0	80	80	1.0000000
NODE_6297_length_1016_cov_22.267176	577	657	4	80	80	1.0000000
NODE_6297_length_1016_cov_22.267176	630	710	0	40	80	0.5000000
NODE_6297_length_1016_cov_22.267176	630	710	4	40	80	0.5000000
NODE_6298_length_1016_cov_21.134133	625	705	0	6	80	0.0750000
NODE_6298_length_1016_cov_21.134133	625	705	2	4	80	0.0500000
NODE_6298_length_1016_cov_21.134133	625	705	4	70	80	0.8750000
NODE_6298_length_1016_cov_21.134133	678	758	0	59	80	0.7375000
NODE_6298_length_1016_cov_21.134133	678	758	2	4	80	0.0500000
NODE_6298_length_1016_cov_21.134133	678	758	4	17	80	0.2125000
NODE_6299_length_1016_cov_20.392585	504	584	0	80	80	1.0000000
NODE_6299_length_1016_cov_20.392585	557	637	0	80	80	1.0000000
NODE_6299_length_1016_cov_20.392585	633	713	0	48	80	0.6000000
NODE_6299_length_1016_cov_20.392585	633	713	6	32	80	0.4000000
NODE_6299_length_1016_cov_20.392585	686	766	6	80	80	1.0000000
NODE_6300_length_1016_cov_16.917121	524	604	0	80	80	1.0000000
NODE_6300_length_1016_cov_16.917121	577	657	0	80	80	1.0000000
NODE_6301_length_1016_cov_8.243184	438	518	0	80	80	1.0000000
NODE_6301_length_1016_cov_8.243184	491	571	0	80	80	1.0000000
NODE_6301_length_1016_cov_8.243184	567	647	0	80	80	1.0000000
NODE_6301_length_1016_cov_8.243184	620	700	0	80	80	1.0000000
NODE_6302_length_1016_cov_8.141767	166	256	8	1	90	0.0111111
NODE_6302_length_1016_cov_8.141767	166	256	10	1	90	0.0111111
NODE_6302_length_1016_cov_8.141767	166	256	12	26	90	0.2888889
NODE_6302_length_1016_cov_8.141767	166	256	14	10	90	0.1111111
NODE_6302_length_1016_cov_8.141767	166	256	18	52	90	0.5777778
NODE_6303_length_1016_cov_7.466739	576	656	0	4	80	0.0500000
NODE_6303_length_1016_cov_7.466739	576	656	2	76	80	0.9500000
NODE_6303_length_1016_cov_7.466739	629	709	0	10	80	0.1250000
NODE_6303_length_1016_cov_7.466739	629	709	2	70	80	0.8750000
NODE_6318_length_1015_cov_24.680131	459	539	6	27	80	0.3375000
NODE_6318_length_1015_cov_24.680131	459	539	8	53	80	0.6625000
NODE_6318_length_1015_cov_24.680131	512	592	2	17	80	0.2125000
NODE_6318_length_1015_cov_24.680131	512	592	4	17	80	0.2125000
NODE_6318_length_1015_cov_24.680131	512	592	8	46	80	0.5750000
NODE_6318_length_1015_cov_24.680131	588	668	2	68	80	0.8500000
NODE_6318_length_1015_cov_24.680131	588	668	4	12	80	0.1500000
NODE_6318_length_1015_cov_24.680131	641	721	0	24	80	0.3000000
NODE_6318_length_1015_cov_24.680131	641	721	2	50	80	0.6250000
NODE_6318_length_1015_cov_24.680131	641	721	4	6	80	0.0750000
NODE_6319_length_1015_cov_23.198690	407	487	6	4	80	0.0500000
NODE_6319_length_1015_cov_23.198690	407	487	8	76	80	0.9500000
NODE_6319_length_1015_cov_23.198690	460	540	0	45	80	0.5625000
NODE_6319_length_1015_cov_23.198690	460	540	4	2	80	0.0250000
NODE_6319_length_1015_cov_23.198690	460	540	6	10	80	0.1250000
NODE_6319_length_1015_cov_23.198690	460	540	8	23	80	0.2875000
NODE_6319_length_1015_cov_23.198690	536	616	0	80	80	1.0000000
NODE_6319_length_1015_cov_23.198690	589	669	0	80	80	1.0000000
NODE_6320_length_1015_cov_22.544760	490	570	0	80	80	1.0000000
NODE_6320_length_1015_cov_22.544760	543	623	0	80	80	1.0000000
NODE_6321_length_1015_cov_17.994541	510	590	0	80	80	1.0000000
NODE_6321_length_1015_cov_17.994541	563	643	0	80	80	1.0000000
NODE_6322_length_1015_cov_16.594978	437	517	0	12	80	0.1500000
NODE_6322_length_1015_cov_16.594978	437	517	4	31	80	0.3875000
NODE_6322_length_1015_cov_16.594978	437	517	6	37	80	0.4625000
NODE_6322_length_1015_cov_16.594978	490	570	0	65	80	0.8125000
NODE_6322_length_1015_cov_16.594978	490	570	4	15	80	0.1875000
NODE_6323_length_1015_cov_14.000000	505	585	0	80	80	1.0000000
NODE_6323_length_1015_cov_14.000000	558	638	0	80	80	1.0000000
NODE_6324_length_1015_cov_9.978166	345	425	10	80	80	1.0000000
NODE_6324_length_1015_cov_9.978166	398	478	0	34	80	0.4250000
NODE_6324_length_1015_cov_9.978166	398	478	10	46	80	0.5750000
NODE_6325_length_1015_cov_6.844978	393	473	0	80	80	1.0000000
NODE_6325_length_1015_cov_6.844978	446	526	0	80	80	1.0000000
NODE_6337_length_1014_cov_95.709290	259	335	0	76	76	1.0000000
NODE_6337_length_1014_cov_95.709290	310	390	0	80	80	1.0000000
NODE_6337_length_1014_cov_95.709290	386	466	0	80	80	1.0000000
NODE_6337_length_1014_cov_95.709290	439	519	0	80	80	1.0000000
NODE_6338_length_1014_cov_67.918033	182	262	0	80	80	1.0000000
NODE_6338_length_1014_cov_67.918033	235	315	0	28	80	0.3500000
NODE_6338_length_1014_cov_67.918033	235	315	6	52	80	0.6500000
NODE_6338_length_1014_cov_67.918033	311	391	4	15	80	0.1875000
NODE_6338_length_1014_cov_67.918033	311	391	6	16	80	0.2000000
NODE_6338_length_1014_cov_67.918033	311	391	10	49	80	0.6125000
NODE_6338_length_1014_cov_67.918033	364	444	0	45	80	0.5625000
NODE_6338_length_1014_cov_67.918033	364	444	4	23	80	0.2875000
NODE_6338_length_1014_cov_67.918033	364	444	10	12	80	0.1500000
NODE_6339_length_1014_cov_44.802186	418	498	0	15	80	0.1875000
NODE_6339_length_1014_cov_44.802186	418	498	8	5	80	0.0625000
NODE_6339_length_1014_cov_44.802186	418	498	10	33	80	0.4125000
NODE_6339_length_1014_cov_44.802186	418	498	13	7	80	0.0875000
NODE_6339_length_1014_cov_44.802186	418	498	14	20	80	0.2500000
NODE_6339_length_1014_cov_44.802186	471	551	9	11	80	0.1375000
NODE_6339_length_1014_cov_44.802186	471	551	13	49	80	0.6125000
NODE_6339_length_1014_cov_44.802186	471	551	14	20	80	0.2500000
NODE_6340_length_1014_cov_36.349727	369	449	4	71	80	0.8875000
NODE_6340_length_1014_cov_36.349727	369	449	8	9	80	0.1125000
NODE_6340_length_1014_cov_36.349727	422	502	4	18	80	0.2250000
NODE_6340_length_1014_cov_36.349727	422	502	6	10	80	0.1250000
NODE_6340_length_1014_cov_36.349727	422	502	8	42	80	0.5250000
NODE_6340_length_1014_cov_36.349727	422	502	9	1	80	0.0125000
NODE_6340_length_1014_cov_36.349727	422	502	10	9	80	0.1125000
NODE_6340_length_1014_cov_36.349727	498	578	4	25	80	0.3125000
NODE_6340_length_1014_cov_36.349727	498	578	6	40	80	0.5000000
NODE_6340_length_1014_cov_36.349727	498	578	8	15	80	0.1875000
NODE_6340_length_1014_cov_36.349727	551	631	0	20	80	0.2500000
NODE_6340_length_1014_cov_36.349727	551	631	2	29	80	0.3625000
NODE_6340_length_1014_cov_36.349727	551	631	4	29	80	0.3625000
NODE_6340_length_1014_cov_36.349727	551	631	8	2	80	0.0250000
NODE_6341_length_1014_cov_35.547541	363	441	2	35	78	0.4487180
NODE_6341_length_1014_cov_35.547541	363	441	4	43	78	0.5512820
NODE_6341_length_1014_cov_35.547541	416	494	0	32	78	0.4102564
NODE_6341_length_1014_cov_35.547541	416	494	2	26	78	0.3333333
NODE_6341_length_1014_cov_35.547541	416	494	4	20	78	0.2564103
NODE_6342_length_1014_cov_32.266667	428	508	0	80	80	1.0000000
NODE_6342_length_1014_cov_32.266667	481	561	0	80	80	1.0000000
NODE_6343_length_1014_cov_28.493989	480	560	0	48	80	0.6000000
NODE_6343_length_1014_cov_28.493989	480	560	4	32	80	0.4000000
NODE_6343_length_1014_cov_28.493989	533	613	0	1	80	0.0125000
NODE_6343_length_1014_cov_28.493989	533	613	4	79	80	0.9875000
NODE_6343_length_1014_cov_28.493989	609	689	0	77	80	0.9625000
NODE_6343_length_1014_cov_28.493989	609	689	4	3	80	0.0375000
NODE_6343_length_1014_cov_28.493989	662	742	0	80	80	1.0000000
NODE_6344_length_1014_cov_25.171585	500	580	2	8	80	0.1000000
NODE_6344_length_1014_cov_25.171585	500	580	5	1	80	0.0125000
NODE_6344_length_1014_cov_25.171585	500	580	6	13	80	0.1625000
NODE_6344_length_1014_cov_25.171585	500	580	8	42	80	0.5250000
NODE_6344_length_1014_cov_25.171585	500	580	10	16	80	0.2000000
NODE_6344_length_1014_cov_25.171585	553	633	4	4	80	0.0500000
NODE_6344_length_1014_cov_25.171585	553	633	6	42	80	0.5250000
NODE_6344_length_1014_cov_25.171585	553	633	8	27	80	0.3375000
NODE_6344_length_1014_cov_25.171585	553	633	10	7	80	0.0875000
NODE_6345_length_1014_cov_22.437158	534	614	0	39	80	0.4875000
NODE_6345_length_1014_cov_22.437158	534	614	2	41	80	0.5125000
NODE_6345_length_1014_cov_22.437158	587	667	2	80	80	1.0000000
NODE_6346_length_1014_cov_19.238251	379	459	0	80	80	1.0000000
NODE_6346_length_1014_cov_19.238251	432	512	0	56	80	0.7000000
NODE_6346_length_1014_cov_19.238251	432	512	2	24	80	0.3000000
NODE_6346_length_1014_cov_19.238251	508	585	0	23	77	0.2987013
NODE_6346_length_1014_cov_19.238251	508	585	2	54	77	0.7012987
NODE_6346_length_1014_cov_19.238251	558	638	0	34	80	0.4250000
NODE_6346_length_1014_cov_19.238251	558	638	2	46	80	0.5750000
NODE_6347_length_1014_cov_15.926776	594	674	0	17	80	0.2125000
NODE_6347_length_1014_cov_15.926776	594	674	4	18	80	0.2250000
NODE_6347_length_1014_cov_15.926776	594	674	14	4	80	0.0500000
NODE_6347_length_1014_cov_15.926776	594	674	16	41	80	0.5125000
NODE_6347_length_1014_cov_15.926776	647	727	10	14	80	0.1750000
NODE_6347_length_1014_cov_15.926776	647	727	12	15	80	0.1875000
NODE_6347_length_1014_cov_15.926776	647	727	16	51	80	0.6375000
NODE_6348_length_1014_cov_8.691803	285	365	0	21	80	0.2625000
NODE_6348_length_1014_cov_8.691803	285	365	2	4	80	0.0500000
NODE_6348_length_1014_cov_8.691803	285	365	4	55	80	0.6875000
NODE_6348_length_1014_cov_8.691803	338	418	0	18	80	0.2250000
NODE_6348_length_1014_cov_8.691803	338	418	2	4	80	0.0500000
NODE_6348_length_1014_cov_8.691803	338	418	4	58	80	0.7250000
NODE_6349_length_1014_cov_7.959563	531	611	2	2	80	0.0250000
NODE_6349_length_1014_cov_7.959563	531	611	6	75	80	0.9375000
NODE_6349_length_1014_cov_7.959563	531	611	8	3	80	0.0375000
NODE_6349_length_1014_cov_7.959563	584	664	2	55	80	0.6875000
NODE_6349_length_1014_cov_7.959563	584	664	6	22	80	0.2750000
NODE_6349_length_1014_cov_7.959563	584	664	8	3	80	0.0375000
NODE_6351_length_1014_cov_7.608743	298	378	4	26	80	0.3250000
NODE_6351_length_1014_cov_7.608743	298	378	6	19	80	0.2375000
NODE_6351_length_1014_cov_7.608743	298	378	7	11	80	0.1375000
NODE_6351_length_1014_cov_7.608743	298	378	8	7	80	0.0875000
NODE_6351_length_1014_cov_7.608743	298	378	10	17	80	0.2125000
NODE_6351_length_1014_cov_7.608743	351	431	5	30	80	0.3750000
NODE_6351_length_1014_cov_7.608743	351	431	6	42	80	0.5250000
NODE_6351_length_1014_cov_7.608743	351	431	8	7	80	0.0875000
NODE_6351_length_1014_cov_7.608743	351	431	10	1	80	0.0125000
NODE_6352_length_1014_cov_6.209836	321	401	0	67	80	0.8375000
NODE_6352_length_1014_cov_6.209836	321	401	2	13	80	0.1625000
NODE_6352_length_1014_cov_6.209836	374	454	0	14	80	0.1750000
NODE_6352_length_1014_cov_6.209836	374	454	2	66	80	0.8250000
NODE_6364_length_1013_cov_32.695842	423	503	0	80	80	1.0000000
NODE_6364_length_1013_cov_32.695842	476	556	0	80	80	1.0000000
NODE_6364_length_1013_cov_32.695842	552	632	0	66	80	0.8250000
NODE_6364_length_1013_cov_32.695842	552	632	4	14	80	0.1750000
NODE_6364_length_1013_cov_32.695842	605	685	0	13	80	0.1625000
NODE_6364_length_1013_cov_32.695842	605	685	4	67	80	0.8375000
NODE_6365_length_1013_cov_21.935449	424	503	0	79	79	1.0000000
NODE_6365_length_1013_cov_21.935449	476	556	0	80	80	1.0000000
NODE_6366_length_1013_cov_17.532823	440	520	0	21	80	0.2625000
NODE_6366_length_1013_cov_17.532823	440	520	4	59	80	0.7375000
NODE_6366_length_1013_cov_17.532823	493	573	2	25	80	0.3125000
NODE_6366_length_1013_cov_17.532823	493	573	4	49	80	0.6125000
NODE_6366_length_1013_cov_17.532823	493	573	6	6	80	0.0750000
NODE_6367_length_1013_cov_14.555799	478	558	0	17	80	0.2125000
NODE_6367_length_1013_cov_14.555799	478	558	4	63	80	0.7875000
NODE_6367_length_1013_cov_14.555799	531	611	0	70	80	0.8750000
NODE_6367_length_1013_cov_14.555799	531	611	4	10	80	0.1250000
NODE_6368_length_1013_cov_13.142232	476	556	4	7	80	0.0875000
NODE_6368_length_1013_cov_13.142232	476	556	8	69	80	0.8625000
NODE_6368_length_1013_cov_13.142232	476	556	10	4	80	0.0500000
NODE_6368_length_1013_cov_13.142232	529	609	0	26	80	0.3250000
NODE_6368_length_1013_cov_13.142232	529	609	2	19	80	0.2375000
NODE_6368_length_1013_cov_13.142232	529	609	4	15	80	0.1875000
NODE_6368_length_1013_cov_13.142232	529	609	8	20	80	0.2500000
NODE_6369_length_1013_cov_7.756018	538	618	0	80	80	1.0000000
NODE_6369_length_1013_cov_7.756018	591	671	0	80	80	1.0000000
NODE_6371_length_1013_cov_4.368709	550	630	2	80	80	1.0000000
NODE_6371_length_1013_cov_4.368709	603	683	0	16	80	0.2000000
NODE_6371_length_1013_cov_4.368709	603	683	2	64	80	0.8000000
NODE_6380_length_1012_cov_91.547645	378	458	0	29	80	0.3625000
NODE_6380_length_1012_cov_91.547645	378	458	2	51	80	0.6375000
NODE_6380_length_1012_cov_91.547645	431	511	0	26	80	0.3250000
NODE_6380_length_1012_cov_91.547645	431	511	2	54	80	0.6750000
NODE_6380_length_1012_cov_91.547645	507	587	0	80	80	1.0000000
NODE_6380_length_1012_cov_91.547645	560	640	0	80	80	1.0000000
NODE_6381_length_1012_cov_64.409639	345	425	0	80	80	1.0000000
NODE_6381_length_1012_cov_64.409639	398	478	0	29	80	0.3625000
NODE_6381_length_1012_cov_64.409639	398	478	2	51	80	0.6375000
NODE_6382_length_1012_cov_63.035049	438	518	0	41	80	0.5125000
NODE_6382_length_1012_cov_63.035049	438	518	2	17	80	0.2125000
NODE_6382_length_1012_cov_63.035049	438	518	4	2	80	0.0250000
NODE_6382_length_1012_cov_63.035049	438	518	8	11	80	0.1375000
NODE_6382_length_1012_cov_63.035049	438	518	10	1	80	0.0125000
NODE_6382_length_1012_cov_63.035049	438	518	11	8	80	0.1000000
NODE_6382_length_1012_cov_63.035049	491	571	2	5	80	0.0625000
NODE_6382_length_1012_cov_63.035049	491	571	4	2	80	0.0250000
NODE_6382_length_1012_cov_63.035049	491	571	8	11	80	0.1375000
NODE_6382_length_1012_cov_63.035049	491	571	10	14	80	0.1750000
NODE_6382_length_1012_cov_63.035049	491	571	11	16	80	0.2000000
NODE_6382_length_1012_cov_63.035049	491	571	12	32	80	0.4000000
NODE_6383_length_1012_cov_53.686747	276	356	0	80	80	1.0000000
NODE_6383_length_1012_cov_53.686747	329	409	0	34	80	0.4250000
NODE_6383_length_1012_cov_53.686747	329	409	9	46	80	0.5750000
NODE_6383_length_1012_cov_53.686747	405	485	9	21	80	0.2625000
NODE_6383_length_1012_cov_53.686747	405	485	10	50	80	0.6250000
NODE_6383_length_1012_cov_53.686747	405	485	11	9	80	0.1125000
NODE_6383_length_1012_cov_53.686747	458	538	2	36	80	0.4500000
NODE_6383_length_1012_cov_53.686747	458	538	9	2	80	0.0250000
NODE_6383_length_1012_cov_53.686747	458	538	10	16	80	0.2000000
NODE_6383_length_1012_cov_53.686747	458	538	11	26	80	0.3250000
NODE_6384_length_1012_cov_35.861993	453	533	0	80	80	1.0000000
NODE_6384_length_1012_cov_35.861993	506	581	0	75	75	1.0000000
NODE_6385_length_1012_cov_16.125958	510	590	0	28	80	0.3500000
NODE_6385_length_1012_cov_16.125958	510	590	2	52	80	0.6500000
NODE_6385_length_1012_cov_16.125958	563	643	0	2	80	0.0250000
NODE_6385_length_1012_cov_16.125958	563	643	2	78	80	0.9750000
NODE_6386_length_1012_cov_15.395400	501	581	0	11	80	0.1375000
NODE_6386_length_1012_cov_15.395400	501	581	2	4	80	0.0500000
NODE_6386_length_1012_cov_15.395400	501	581	4	9	80	0.1125000
NODE_6386_length_1012_cov_15.395400	501	581	6	56	80	0.7000000
NODE_6386_length_1012_cov_15.395400	554	634	2	22	80	0.2750000
NODE_6386_length_1012_cov_15.395400	554	634	4	7	80	0.0875000
NODE_6386_length_1012_cov_15.395400	554	634	6	51	80	0.6375000
NODE_6388_length_1012_cov_6.409639	528	608	0	1	80	0.0125000
NODE_6388_length_1012_cov_6.409639	528	608	2	1	80	0.0125000
NODE_6388_length_1012_cov_6.409639	528	608	4	18	80	0.2250000
NODE_6388_length_1012_cov_6.409639	528	608	6	60	80	0.7500000
NODE_6388_length_1012_cov_6.409639	581	661	0	24	80	0.3000000
NODE_6388_length_1012_cov_6.409639	581	661	2	20	80	0.2500000
NODE_6388_length_1012_cov_6.409639	581	661	6	36	80	0.4500000
NODE_6398_length_1011_cov_53.032895	515	595	4	80	80	1.0000000
NODE_6398_length_1011_cov_53.032895	568	648	0	28	80	0.3500000
NODE_6398_length_1011_cov_53.032895	568	648	4	52	80	0.6500000
NODE_6399_length_1011_cov_25.838816	366	446	0	45	80	0.5625000
NODE_6399_length_1011_cov_25.838816	366	446	2	22	80	0.2750000
NODE_6399_length_1011_cov_25.838816	366	446	6	13	80	0.1625000
NODE_6399_length_1011_cov_25.838816	419	499	2	14	80	0.1750000
NODE_6399_length_1011_cov_25.838816	419	499	4	11	80	0.1375000
NODE_6399_length_1011_cov_25.838816	419	499	6	55	80	0.6875000
NODE_6400_length_1011_cov_22.734649	426	506	0	80	80	1.0000000
NODE_6400_length_1011_cov_22.734649	479	559	0	80	80	1.0000000
NODE_6400_length_1011_cov_22.734649	555	636	0	81	81	1.0000000
NODE_6400_length_1011_cov_22.734649	609	689	0	80	80	1.0000000
NODE_6401_length_1011_cov_18.127193	389	469	0	72	80	0.9000000
NODE_6401_length_1011_cov_18.127193	389	469	2	8	80	0.1000000
NODE_6401_length_1011_cov_18.127193	442	520	0	19	78	0.2435897
NODE_6401_length_1011_cov_18.127193	442	520	2	59	78	0.7564102
NODE_6401_length_1011_cov_18.127193	516	596	0	60	80	0.7500000
NODE_6401_length_1011_cov_18.127193	516	596	2	20	80	0.2500000
NODE_6401_length_1011_cov_18.127193	569	649	0	80	80	1.0000000
NODE_6402_length_1011_cov_12.709430	309	389	0	80	80	1.0000000
NODE_6402_length_1011_cov_12.709430	362	442	0	80	80	1.0000000
NODE_6403_length_1011_cov_8.731360	441	521	0	80	80	1.0000000
NODE_6403_length_1011_cov_8.731360	494	574	0	80	80	1.0000000
NODE_6405_length_1011_cov_7.212719	219	299	0	74	80	0.9250000
NODE_6405_length_1011_cov_7.212719	219	299	2	6	80	0.0750000
NODE_6408_length_1011_cov_3.569079	173	253	0	80	80	1.0000000
NODE_6408_length_1011_cov_3.569079	226	306	0	80	80	1.0000000
NODE_6409_length_1011_cov_1.703947	779	851	10	1	72	0.0138889
NODE_6409_length_1011_cov_1.703947	779	851	12	2	72	0.0277778
NODE_6409_length_1011_cov_1.703947	779	851	14	1	72	0.0138889
NODE_6409_length_1011_cov_1.703947	779	851	16	1	72	0.0138889
NODE_6409_length_1011_cov_1.703947	779	851	22	1	72	0.0138889
NODE_6409_length_1011_cov_1.703947	779	851	28	6	72	0.0833333
NODE_6409_length_1011_cov_1.703947	779	851	30	7	72	0.0972222
NODE_6409_length_1011_cov_1.703947	779	851	32	3	72	0.0416667
NODE_6409_length_1011_cov_1.703947	779	851	33	1	72	0.0138889
NODE_6409_length_1011_cov_1.703947	779	851	35	9	72	0.1250000
NODE_6409_length_1011_cov_1.703947	779	851	37	5	72	0.0694444
NODE_6409_length_1011_cov_1.703947	779	851	39	13	72	0.1805556
NODE_6409_length_1011_cov_1.703947	779	851	41	8	72	0.1111111
NODE_6409_length_1011_cov_1.703947	779	851	43	8	72	0.1111111
NODE_6409_length_1011_cov_1.703947	779	851	45	6	72	0.0833333
NODE_6416_length_1010_cov_51.841932	335	415	0	80	80	1.0000000
NODE_6416_length_1010_cov_51.841932	388	468	0	80	80	1.0000000
NODE_6417_length_1010_cov_35.860593	576	656	0	80	80	1.0000000
NODE_6417_length_1010_cov_35.860593	629	709	0	41	80	0.5125000
NODE_6417_length_1010_cov_35.860593	629	709	2	39	80	0.4875000
NODE_6418_length_1010_cov_30.043908	509	589	2	7	80	0.0875000
NODE_6418_length_1010_cov_30.043908	509	589	4	73	80	0.9125000
NODE_6418_length_1010_cov_30.043908	562	642	0	24	80	0.3000000
NODE_6418_length_1010_cov_30.043908	562	642	2	28	80	0.3500000
NODE_6418_length_1010_cov_30.043908	562	642	4	28	80	0.3500000
NODE_6418_length_1010_cov_30.043908	638	718	0	36	80	0.4500000
NODE_6418_length_1010_cov_30.043908	638	718	2	44	80	0.5500000
NODE_6418_length_1010_cov_30.043908	691	771	2	54	80	0.6750000
NODE_6418_length_1010_cov_30.043908	691	771	4	26	80	0.3250000
NODE_6420_length_1010_cov_15.156970	364	444	0	80	80	1.0000000
NODE_6420_length_1010_cov_15.156970	417	497	0	80	80	1.0000000
NODE_6421_length_1010_cov_13.546652	385	465	0	16	80	0.2000000
NODE_6421_length_1010_cov_13.546652	385	465	2	11	80	0.1375000
NODE_6421_length_1010_cov_13.546652	385	465	4	6	80	0.0750000
NODE_6421_length_1010_cov_13.546652	385	465	8	47	80	0.5875000
NODE_6421_length_1010_cov_13.546652	438	518	4	15	80	0.1875000
NODE_6421_length_1010_cov_13.546652	438	518	6	14	80	0.1750000
NODE_6421_length_1010_cov_13.546652	438	518	8	51	80	0.6375000
NODE_6422_length_1010_cov_13.317234	480	560	2	65	80	0.8125000
NODE_6422_length_1010_cov_13.317234	480	560	4	15	80	0.1875000
NODE_6422_length_1010_cov_13.317234	533	613	2	12	80	0.1500000
NODE_6422_length_1010_cov_13.317234	533	613	4	68	80	0.8500000
NODE_6423_length_1010_cov_12.900110	427	507	0	80	80	1.0000000
NODE_6423_length_1010_cov_12.900110	480	560	0	59	80	0.7375000
NODE_6423_length_1010_cov_12.900110	480	560	2	21	80	0.2625000
NODE_6424_length_1010_cov_11.423710	631	711	2	3	80	0.0375000
NODE_6424_length_1010_cov_11.423710	631	711	4	77	80	0.9625000
NODE_6424_length_1010_cov_11.423710	684	764	0	52	80	0.6500000
NODE_6424_length_1010_cov_11.423710	684	764	2	4	80	0.0500000
NODE_6424_length_1010_cov_11.423710	684	764	4	24	80	0.3000000
NODE_6425_length_1010_cov_11.256861	492	572	0	80	80	1.0000000
NODE_6425_length_1010_cov_11.256861	545	625	0	80	80	1.0000000
NODE_6426_length_1010_cov_11.000000	455	535	0	80	80	1.0000000
NODE_6426_length_1010_cov_11.000000	508	588	0	80	80	1.0000000
NODE_6428_length_1010_cov_4.990121	476	556	2	24	80	0.3000000
NODE_6428_length_1010_cov_4.990121	476	556	4	20	80	0.2500000
NODE_6428_length_1010_cov_4.990121	476	556	6	36	80	0.4500000
NODE_6428_length_1010_cov_4.990121	529	609	5	30	80	0.3750000
NODE_6428_length_1010_cov_4.990121	529	609	6	47	80	0.5875000
NODE_6428_length_1010_cov_4.990121	529	609	7	3	80	0.0375000
NODE_6430_length_1010_cov_4.892426	476	556	0	80	80	1.0000000
NODE_6430_length_1010_cov_4.892426	529	609	0	80	80	1.0000000
NODE_6431_length_1010_cov_3.624588	157	196	0	22	39	0.5641026
NODE_6431_length_1010_cov_3.624588	157	196	2	17	39	0.4358974
NODE_6435_length_1010_cov_1.440176	1	58	0	57	57	1.0000000
NODE_6436_length_1009_cov_44.626374	288	362	0	74	74	1.0000000
NODE_6436_length_1009_cov_44.626374	335	415	0	80	80	1.0000000
NODE_6436_length_1009_cov_44.626374	411	491	0	18	80	0.2250000
NODE_6436_length_1009_cov_44.626374	411	491	2	62	80	0.7750000
NODE_6436_length_1009_cov_44.626374	464	544	0	27	80	0.3375000
NODE_6436_length_1009_cov_44.626374	464	544	2	53	80	0.6625000
NODE_6437_length_1009_cov_31.828571	412	492	0	37	80	0.4625000
NODE_6437_length_1009_cov_31.828571	412	492	4	43	80	0.5375000
NODE_6437_length_1009_cov_31.828571	465	545	4	80	80	1.0000000
NODE_6438_length_1009_cov_28.539560	571	651	2	23	80	0.2875000
NODE_6438_length_1009_cov_28.539560	571	651	4	39	80	0.4875000
NODE_6438_length_1009_cov_28.539560	571	651	6	18	80	0.2250000
NODE_6438_length_1009_cov_28.539560	624	704	0	18	80	0.2250000
NODE_6438_length_1009_cov_28.539560	624	704	2	58	80	0.7250000
NODE_6438_length_1009_cov_28.539560	624	704	4	4	80	0.0500000
NODE_6439_length_1009_cov_20.281319	577	657	16	6	80	0.0750000
NODE_6439_length_1009_cov_20.281319	577	657	19	35	80	0.4375000
NODE_6439_length_1009_cov_20.281319	577	657	21	13	80	0.1625000
NODE_6439_length_1009_cov_20.281319	577	657	25	26	80	0.3250000
NODE_6439_length_1009_cov_20.281319	630	710	4	8	80	0.1000000
NODE_6439_length_1009_cov_20.281319	630	710	7	1	80	0.0125000
NODE_6439_length_1009_cov_20.281319	630	710	9	1	80	0.0125000
NODE_6439_length_1009_cov_20.281319	630	710	10	11	80	0.1375000
NODE_6439_length_1009_cov_20.281319	630	710	15	1	80	0.0125000
NODE_6439_length_1009_cov_20.281319	630	710	16	4	80	0.0500000
NODE_6439_length_1009_cov_20.281319	630	710	18	24	80	0.3000000
NODE_6439_length_1009_cov_20.281319	630	710	21	1	80	0.0125000
NODE_6439_length_1009_cov_20.281319	630	710	25	29	80	0.3625000
NODE_6440_length_1009_cov_18.649451	430	510	8	4	80	0.0500000
NODE_6440_length_1009_cov_18.649451	430	510	11	17	80	0.2125000
NODE_6440_length_1009_cov_18.649451	430	510	15	28	80	0.3500000
NODE_6440_length_1009_cov_18.649451	430	510	18	1	80	0.0125000
NODE_6440_length_1009_cov_18.649451	430	510	19	30	80	0.3750000
NODE_6440_length_1009_cov_18.649451	483	563	2	4	80	0.0500000
NODE_6440_length_1009_cov_18.649451	483	563	11	24	80	0.3000000
NODE_6440_length_1009_cov_18.649451	483	563	12	32	80	0.4000000
NODE_6440_length_1009_cov_18.649451	483	563	14	10	80	0.1250000
NODE_6440_length_1009_cov_18.649451	483	563	15	10	80	0.1250000
NODE_6442_length_1009_cov_3.767033	647	727	0	80	80	1.0000000
NODE_6442_length_1009_cov_3.767033	700	780	0	80	80	1.0000000
NODE_6443_length_1009_cov_2.903297	36	63	0	27	27	1.0000000
NODE_6451_length_1008_cov_44.825083	399	479	0	71	80	0.8875000
NODE_6451_length_1008_cov_44.825083	399	479	2	9	80	0.1125000
NODE_6451_length_1008_cov_44.825083	452	532	0	18	80	0.2250000
NODE_6451_length_1008_cov_44.825083	452	532	2	42	80	0.5250000
NODE_6451_length_1008_cov_44.825083	452	532	4	20	80	0.2500000
NODE_6452_length_1008_cov_41.030803	280	360	0	80	80	1.0000000
NODE_6452_length_1008_cov_41.030803	333	413	0	80	80	1.0000000
NODE_6452_length_1008_cov_41.030803	409	489	0	59	80	0.7375000
NODE_6452_length_1008_cov_41.030803	409	489	2	7	80	0.0875000
NODE_6452_length_1008_cov_41.030803	409	489	4	14	80	0.1750000
NODE_6452_length_1008_cov_41.030803	462	542	0	6	80	0.0750000
NODE_6452_length_1008_cov_41.030803	462	542	2	7	80	0.0875000
NODE_6452_length_1008_cov_41.030803	462	542	4	60	80	0.7500000
NODE_6452_length_1008_cov_41.030803	462	542	6	7	80	0.0875000
NODE_6453_length_1008_cov_39.377338	311	391	0	15	80	0.1875000
NODE_6453_length_1008_cov_39.377338	311	391	2	41	80	0.5125000
NODE_6453_length_1008_cov_39.377338	311	391	4	18	80	0.2250000
NODE_6453_length_1008_cov_39.377338	311	391	6	6	80	0.0750000
NODE_6453_length_1008_cov_39.377338	364	444	0	3	80	0.0375000
NODE_6453_length_1008_cov_39.377338	364	444	4	18	80	0.2250000
NODE_6453_length_1008_cov_39.377338	364	444	6	59	80	0.7375000
NODE_6453_length_1008_cov_39.377338	440	520	0	35	80	0.4375000
NODE_6453_length_1008_cov_39.377338	440	520	2	14	80	0.1750000
NODE_6453_length_1008_cov_39.377338	440	520	6	31	80	0.3875000
NODE_6453_length_1008_cov_39.377338	493	573	0	37	80	0.4625000
NODE_6453_length_1008_cov_39.377338	493	573	1	8	80	0.1000000
NODE_6453_length_1008_cov_39.377338	493	573	2	35	80	0.4375000
NODE_6454_length_1008_cov_27.836084	405	485	10	80	80	1.0000000
NODE_6454_length_1008_cov_27.836084	458	538	0	3	80	0.0375000
NODE_6454_length_1008_cov_27.836084	458	538	8	47	80	0.5875000
NODE_6454_length_1008_cov_27.836084	458	538	10	30	80	0.3750000
NODE_6454_length_1008_cov_27.836084	534	614	8	80	80	1.0000000
NODE_6454_length_1008_cov_27.836084	587	667	0	26	80	0.3250000
NODE_6454_length_1008_cov_27.836084	587	667	8	54	80	0.6750000
NODE_6455_length_1008_cov_24.741474	485	565	2	80	80	1.0000000
NODE_6455_length_1008_cov_24.741474	538	618	0	45	80	0.5625000
NODE_6455_length_1008_cov_24.741474	538	618	2	35	80	0.4375000
NODE_6456_length_1008_cov_20.278328	401	481	2	6	80	0.0750000
NODE_6456_length_1008_cov_20.278328	401	481	4	2	80	0.0250000
NODE_6456_length_1008_cov_20.278328	401	481	6	13	80	0.1625000
NODE_6456_length_1008_cov_20.278328	401	481	8	59	80	0.7375000
NODE_6456_length_1008_cov_20.278328	454	534	0	6	80	0.0750000
NODE_6456_length_1008_cov_20.278328	454	534	2	15	80	0.1875000
NODE_6456_length_1008_cov_20.278328	454	534	4	16	80	0.2000000
NODE_6456_length_1008_cov_20.278328	454	534	7	1	80	0.0125000
NODE_6456_length_1008_cov_20.278328	454	534	8	42	80	0.5250000
NODE_6457_length_1008_cov_6.071507	460	540	0	80	80	1.0000000
NODE_6457_length_1008_cov_6.071507	513	593	0	80	80	1.0000000
NODE_6466_length_1008_cov_1.798680	0	64	0	64	64	1.0000000
NODE_6466_length_1008_cov_1.798680	37	104	0	67	67	1.0000000
NODE_6473_length_1007_cov_27.011013	294	371	0	77	77	1.0000000
NODE_6473_length_1007_cov_27.011013	347	424	0	77	77	1.0000000
NODE_6474_length_1007_cov_24.668502	369	449	0	19	80	0.2375000
NODE_6474_length_1007_cov_24.668502	369	449	2	61	80	0.7625000
NODE_6474_length_1007_cov_24.668502	422	502	0	72	80	0.9000000
NODE_6474_length_1007_cov_24.668502	422	502	2	8	80	0.1000000
NODE_6474_length_1007_cov_24.668502	498	578	0	80	80	1.0000000
NODE_6474_length_1007_cov_24.668502	551	631	0	80	80	1.0000000
NODE_6475_length_1007_cov_21.729075	454	534	2	20	80	0.2500000
NODE_6475_length_1007_cov_21.729075	454	534	4	2	80	0.0250000
NODE_6475_length_1007_cov_21.729075	454	534	6	58	80	0.7250000
NODE_6475_length_1007_cov_21.729075	507	587	2	2	80	0.0250000
NODE_6475_length_1007_cov_21.729075	507	587	4	50	80	0.6250000
NODE_6475_length_1007_cov_21.729075	507	587	6	28	80	0.3500000
NODE_6475_length_1007_cov_21.729075	583	663	2	78	80	0.9750000
NODE_6475_length_1007_cov_21.729075	583	663	6	2	80	0.0250000
NODE_6475_length_1007_cov_21.729075	636	716	0	28	80	0.3500000
NODE_6475_length_1007_cov_21.729075	636	716	2	52	80	0.6500000
NODE_6476_length_1007_cov_14.515419	400	480	0	69	80	0.8625000
NODE_6476_length_1007_cov_14.515419	400	480	1	11	80	0.1375000
NODE_6476_length_1007_cov_14.515419	453	533	0	80	80	1.0000000
NODE_6477_length_1007_cov_13.685022	376	456	0	80	80	1.0000000
NODE_6477_length_1007_cov_13.685022	429	509	0	80	80	1.0000000
NODE_6478_length_1007_cov_9.189427	438	518	0	44	80	0.5500000
NODE_6478_length_1007_cov_9.189427	438	518	2	36	80	0.4500000
NODE_6478_length_1007_cov_9.189427	491	571	0	80	80	1.0000000
NODE_6491_length_1006_cov_59.773980	379	459	2	14	80	0.1750000
NODE_6491_length_1006_cov_59.773980	379	459	4	10	80	0.1250000
NODE_6491_length_1006_cov_59.773980	379	459	10	15	80	0.1875000
NODE_6491_length_1006_cov_59.773980	379	459	12	41	80	0.5125000
NODE_6491_length_1006_cov_59.773980	432	512	10	59	80	0.7375000
NODE_6491_length_1006_cov_59.773980	432	512	12	21	80	0.2625000
NODE_6491_length_1006_cov_59.773980	508	588	2	18	80	0.2250000
NODE_6491_length_1006_cov_59.773980	508	588	4	36	80	0.4500000
NODE_6491_length_1006_cov_59.773980	508	588	10	17	80	0.2125000
NODE_6491_length_1006_cov_59.773980	508	588	11	5	80	0.0625000
NODE_6491_length_1006_cov_59.773980	508	588	12	4	80	0.0500000
NODE_6491_length_1006_cov_59.773980	561	641	0	19	80	0.2375000
NODE_6491_length_1006_cov_59.773980	561	641	2	32	80	0.4000000
NODE_6491_length_1006_cov_59.773980	561	641	4	29	80	0.3625000
NODE_6492_length_1006_cov_34.762955	482	562	2	55	80	0.6875000
NODE_6492_length_1006_cov_34.762955	482	562	3	13	80	0.1625000
NODE_6492_length_1006_cov_34.762955	482	562	5	12	80	0.1500000
NODE_6492_length_1006_cov_34.762955	535	615	2	2	80	0.0250000
NODE_6492_length_1006_cov_34.762955	535	615	3	13	80	0.1625000
NODE_6492_length_1006_cov_34.762955	535	615	5	13	80	0.1625000
NODE_6492_length_1006_cov_34.762955	535	615	6	52	80	0.6500000
NODE_6493_length_1006_cov_21.776185	516	596	0	6	80	0.0750000
NODE_6493_length_1006_cov_21.776185	516	596	2	1	80	0.0125000
NODE_6493_length_1006_cov_21.776185	516	596	4	9	80	0.1125000
NODE_6493_length_1006_cov_21.776185	516	596	6	6	80	0.0750000
NODE_6493_length_1006_cov_21.776185	516	596	8	23	80	0.2875000
NODE_6493_length_1006_cov_21.776185	516	596	10	35	80	0.4375000
NODE_6493_length_1006_cov_21.776185	569	649	6	32	80	0.4000000
NODE_6493_length_1006_cov_21.776185	569	649	8	2	80	0.0250000
NODE_6493_length_1006_cov_21.776185	569	649	10	46	80	0.5750000
NODE_6494_length_1006_cov_19.690187	371	451	0	53	80	0.6625000
NODE_6494_length_1006_cov_19.690187	371	451	4	27	80	0.3375000
NODE_6494_length_1006_cov_19.690187	424	504	0	80	80	1.0000000
NODE_6495_length_1006_cov_19.299890	495	575	0	80	80	1.0000000
NODE_6495_length_1006_cov_19.299890	548	628	0	80	80	1.0000000
NODE_6496_length_1006_cov_13.187431	245	325	0	80	80	1.0000000
NODE_6496_length_1006_cov_13.187431	298	378	0	80	80	1.0000000
NODE_6497_length_1006_cov_12.862183	383	463	0	80	80	1.0000000
NODE_6497_length_1006_cov_12.862183	436	516	0	80	80	1.0000000
NODE_6498_length_1006_cov_10.986770	762	842	0	18	80	0.2250000
NODE_6498_length_1006_cov_10.986770	762	842	4	62	80	0.7750000
NODE_6498_length_1006_cov_10.986770	815	895	0	12	80	0.1500000
NODE_6498_length_1006_cov_10.986770	815	895	4	68	80	0.8500000
NODE_6499_length_1006_cov_8.633958	314	394	0	32	80	0.4000000
NODE_6499_length_1006_cov_8.633958	314	394	4	48	80	0.6000000
NODE_6499_length_1006_cov_8.633958	367	447	0	39	80	0.4875000
NODE_6499_length_1006_cov_8.633958	367	447	4	41	80	0.5125000
NODE_6515_length_1005_cov_80.271523	509	589	6	3	80	0.0375000
NODE_6515_length_1005_cov_80.271523	509	589	18	6	80	0.0750000
NODE_6515_length_1005_cov_80.271523	509	589	20	71	80	0.8875000
NODE_6515_length_1005_cov_80.271523	562	642	0	12	80	0.1500000
NODE_6515_length_1005_cov_80.271523	562	642	2	27	80	0.3375000
NODE_6515_length_1005_cov_80.271523	562	642	4	8	80	0.1000000
NODE_6515_length_1005_cov_80.271523	562	642	6	9	80	0.1125000
NODE_6515_length_1005_cov_80.271523	562	642	18	4	80	0.0500000
NODE_6515_length_1005_cov_80.271523	562	642	20	20	80	0.2500000
NODE_6516_length_1005_cov_45.008830	357	437	0	41	80	0.5125000
NODE_6516_length_1005_cov_45.008830	357	437	2	39	80	0.4875000
NODE_6516_length_1005_cov_45.008830	410	490	2	80	80	1.0000000
NODE_6517_length_1005_cov_36.636865	567	647	0	7	80	0.0875000
NODE_6517_length_1005_cov_36.636865	567	647	2	73	80	0.9125000
NODE_6517_length_1005_cov_36.636865	620	700	0	22	80	0.2750000
NODE_6517_length_1005_cov_36.636865	620	700	2	58	80	0.7250000
NODE_6518_length_1005_cov_21.222958	389	409	0	20	20	1.0000000
NODE_6518_length_1005_cov_21.222958	451	519	4	68	68	1.0000000
NODE_6518_length_1005_cov_21.222958	515	595	1	5	80	0.0625000
NODE_6518_length_1005_cov_21.222958	515	595	2	63	80	0.7875000
NODE_6518_length_1005_cov_21.222958	515	595	3	5	80	0.0625000
NODE_6518_length_1005_cov_21.222958	515	595	4	7	80	0.0875000
NODE_6518_length_1005_cov_21.222958	568	648	0	41	80	0.5125000
NODE_6518_length_1005_cov_21.222958	568	648	2	39	80	0.4875000
NODE_6520_length_1005_cov_14.278146	480	560	2	10	80	0.1250000
NODE_6520_length_1005_cov_14.278146	480	560	4	31	80	0.3875000
NODE_6520_length_1005_cov_14.278146	480	560	6	39	80	0.4875000
NODE_6520_length_1005_cov_14.278146	533	613	0	26	80	0.3250000
NODE_6520_length_1005_cov_14.278146	533	613	2	20	80	0.2500000
NODE_6520_length_1005_cov_14.278146	533	613	4	20	80	0.2500000
NODE_6520_length_1005_cov_14.278146	533	613	6	14	80	0.1750000
NODE_6521_length_1005_cov_13.215232	511	591	0	80	80	1.0000000
NODE_6521_length_1005_cov_13.215232	564	644	0	80	80	1.0000000
NODE_6523_length_1005_cov_5.579470	534	614	0	80	80	1.0000000
NODE_6523_length_1005_cov_5.579470	587	667	0	80	80	1.0000000
NODE_6536_length_1004_cov_45.470718	343	423	0	51	80	0.6375000
NODE_6536_length_1004_cov_45.470718	343	423	2	28	80	0.3500000
NODE_6536_length_1004_cov_45.470718	343	423	4	1	80	0.0125000
NODE_6536_length_1004_cov_45.470718	396	476	0	79	80	0.9875000
NODE_6536_length_1004_cov_45.470718	396	476	2	1	80	0.0125000
NODE_6536_length_1004_cov_45.470718	472	552	0	3	80	0.0375000
NODE_6536_length_1004_cov_45.470718	472	552	2	48	80	0.6000000
NODE_6536_length_1004_cov_45.470718	472	552	4	29	80	0.3625000
NODE_6536_length_1004_cov_45.470718	525	605	2	44	80	0.5500000
NODE_6536_length_1004_cov_45.470718	525	605	4	36	80	0.4500000
NODE_6537_length_1004_cov_34.565746	419	499	0	8	80	0.1000000
NODE_6537_length_1004_cov_34.565746	419	499	2	10	80	0.1250000
NODE_6537_length_1004_cov_34.565746	419	499	4	25	80	0.3125000
NODE_6537_length_1004_cov_34.565746	419	499	6	37	80	0.4625000
NODE_6537_length_1004_cov_34.565746	472	552	2	41	80	0.5125000
NODE_6537_length_1004_cov_34.565746	472	552	4	2	80	0.0250000
NODE_6537_length_1004_cov_34.565746	472	552	6	37	80	0.4625000
NODE_6538_length_1004_cov_28.710497	385	465	0	3	80	0.0375000
NODE_6538_length_1004_cov_28.710497	385	465	2	17	80	0.2125000
NODE_6538_length_1004_cov_28.710497	385	465	4	2	80	0.0250000
NODE_6538_length_1004_cov_28.710497	385	465	6	3	80	0.0375000
NODE_6538_length_1004_cov_28.710497	385	465	8	55	80	0.6875000
NODE_6538_length_1004_cov_28.710497	438	518	0	56	80	0.7000000
NODE_6538_length_1004_cov_28.710497	438	518	2	17	80	0.2125000
NODE_6538_length_1004_cov_28.710497	438	518	4	2	80	0.0250000
NODE_6538_length_1004_cov_28.710497	438	518	8	5	80	0.0625000
NODE_6538_length_1004_cov_28.710497	514	594	0	80	80	1.0000000
NODE_6538_length_1004_cov_28.710497	567	647	0	72	80	0.9000000
NODE_6538_length_1004_cov_28.710497	567	647	2	8	80	0.1000000
NODE_6539_length_1004_cov_12.745856	432	512	0	51	80	0.6375000
NODE_6539_length_1004_cov_12.745856	432	512	2	29	80	0.3625000
NODE_6539_length_1004_cov_12.745856	485	565	2	80	80	1.0000000
NODE_6550_length_1003_cov_47.014381	383	463	3	18	80	0.2250000
NODE_6550_length_1003_cov_47.014381	383	463	4	62	80	0.7750000
NODE_6550_length_1003_cov_47.014381	436	516	0	13	80	0.1625000
NODE_6550_length_1003_cov_47.014381	436	516	3	58	80	0.7250000
NODE_6550_length_1003_cov_47.014381	436	516	4	9	80	0.1125000
NODE_6550_length_1003_cov_47.014381	512	592	0	80	80	1.0000000
NODE_6550_length_1003_cov_47.014381	565	645	0	80	80	1.0000000
NODE_6551_length_1003_cov_35.329646	372	452	0	43	80	0.5375000
NODE_6551_length_1003_cov_35.329646	372	452	2	3	80	0.0375000
NODE_6551_length_1003_cov_35.329646	372	452	4	34	80	0.4250000
NODE_6551_length_1003_cov_35.329646	425	505	0	26	80	0.3250000
NODE_6551_length_1003_cov_35.329646	425	505	2	30	80	0.3750000
NODE_6551_length_1003_cov_35.329646	425	505	4	24	80	0.3000000
NODE_6552_length_1003_cov_32.721239	357	437	10	8	80	0.1000000
NODE_6552_length_1003_cov_32.721239	357	437	11	1	80	0.0125000
NODE_6552_length_1003_cov_32.721239	357	437	12	12	80	0.1500000
NODE_6552_length_1003_cov_32.721239	357	437	16	28	80	0.3500000
NODE_6552_length_1003_cov_32.721239	357	437	18	24	80	0.3000000
NODE_6552_length_1003_cov_32.721239	357	437	20	7	80	0.0875000
NODE_6552_length_1003_cov_32.721239	410	490	4	13	80	0.1625000
NODE_6552_length_1003_cov_32.721239	410	490	6	5	80	0.0625000
NODE_6552_length_1003_cov_32.721239	410	490	17	2	80	0.0250000
NODE_6552_length_1003_cov_32.721239	410	490	18	57	80	0.7125000
NODE_6552_length_1003_cov_32.721239	410	490	20	3	80	0.0375000
NODE_6553_length_1003_cov_23.758850	467	547	0	4	80	0.0500000
NODE_6553_length_1003_cov_23.758850	467	547	4	35	80	0.4375000
NODE_6553_length_1003_cov_23.758850	467	547	6	41	80	0.5125000
NODE_6553_length_1003_cov_23.758850	520	600	0	57	80	0.7125000
NODE_6553_length_1003_cov_23.758850	520	600	4	23	80	0.2875000
NODE_6554_length_1003_cov_19.939159	240	320	0	80	80	1.0000000
NODE_6554_length_1003_cov_19.939159	293	373	0	80	80	1.0000000
NODE_6555_length_1003_cov_16.618363	524	604	0	2	80	0.0250000
NODE_6555_length_1003_cov_16.618363	524	604	2	78	80	0.9750000
NODE_6555_length_1003_cov_16.618363	577	657	0	55	80	0.6875000
NODE_6555_length_1003_cov_16.618363	577	657	2	25	80	0.3125000
NODE_6555_length_1003_cov_16.618363	653	733	0	80	80	1.0000000
NODE_6555_length_1003_cov_16.618363	706	786	0	80	80	1.0000000
NODE_6556_length_1003_cov_13.863938	537	617	0	63	80	0.7875000
NODE_6556_length_1003_cov_13.863938	537	617	2	17	80	0.2125000
NODE_6556_length_1003_cov_13.863938	590	670	0	10	80	0.1250000
NODE_6556_length_1003_cov_13.863938	590	670	2	70	80	0.8750000
NODE_6557_length_1003_cov_12.363938	529	609	0	16	80	0.2000000
NODE_6557_length_1003_cov_12.363938	529	609	2	4	80	0.0500000
NODE_6557_length_1003_cov_12.363938	529	609	8	60	80	0.7500000
NODE_6557_length_1003_cov_12.363938	582	662	0	6	80	0.0750000
NODE_6557_length_1003_cov_12.363938	582	662	6	31	80	0.3875000
NODE_6557_length_1003_cov_12.363938	582	662	8	43	80	0.5375000
NODE_6567_length_1002_cov_65.513843	387	467	2	43	80	0.5375000
NODE_6567_length_1002_cov_65.513843	387	467	6	3	80	0.0375000
NODE_6567_length_1002_cov_65.513843	387	467	8	20	80	0.2500000
NODE_6567_length_1002_cov_65.513843	387	467	10	14	80	0.1750000
NODE_6567_length_1002_cov_65.513843	440	520	4	6	80	0.0750000
NODE_6567_length_1002_cov_65.513843	440	520	8	67	80	0.8375000
NODE_6567_length_1002_cov_65.513843	440	520	10	7	80	0.0875000
NODE_6567_length_1002_cov_65.513843	516	596	0	23	80	0.2875000
NODE_6567_length_1002_cov_65.513843	516	596	4	21	80	0.2625000
NODE_6567_length_1002_cov_65.513843	516	596	5	1	80	0.0125000
NODE_6567_length_1002_cov_65.513843	516	596	6	35	80	0.4375000
NODE_6567_length_1002_cov_65.513843	569	649	5	31	80	0.3875000
NODE_6567_length_1002_cov_65.513843	569	649	6	49	80	0.6125000
NODE_6568_length_1002_cov_41.995570	408	488	0	80	80	1.0000000
NODE_6568_length_1002_cov_41.995570	461	541	0	80	80	1.0000000
NODE_6569_length_1002_cov_19.966777	401	481	1	2	80	0.0250000
NODE_6569_length_1002_cov_19.966777	401	481	5	13	80	0.1625000
NODE_6569_length_1002_cov_19.966777	401	481	7	65	80	0.8125000
NODE_6569_length_1002_cov_19.966777	454	534	1	33	80	0.4125000
NODE_6569_length_1002_cov_19.966777	454	534	3	1	80	0.0125000
NODE_6569_length_1002_cov_19.966777	454	534	4	14	80	0.1750000
NODE_6569_length_1002_cov_19.966777	454	534	7	32	80	0.4000000
NODE_6570_length_1002_cov_19.539313	334	414	0	80	80	1.0000000
NODE_6570_length_1002_cov_19.539313	335	414	0	79	79	1.0000000
NODE_6570_length_1002_cov_19.539313	387	467	0	80	80	1.0000000
NODE_6570_length_1002_cov_19.539313	387	467	0	80	80	1.0000000
NODE_6570_length_1002_cov_19.539313	396	467	0	71	71	1.0000000
NODE_6570_length_1002_cov_19.539313	463	543	0	40	80	0.5000000
NODE_6570_length_1002_cov_19.539313	463	543	2	40	80	0.5000000
NODE_6570_length_1002_cov_19.539313	516	596	2	80	80	1.0000000
NODE_6571_length_1002_cov_17.780731	631	711	2	17	80	0.2125000
NODE_6571_length_1002_cov_17.780731	631	711	3	39	80	0.4875000
NODE_6571_length_1002_cov_17.780731	631	711	4	24	80	0.3000000
NODE_6571_length_1002_cov_17.780731	684	764	0	24	80	0.3000000
NODE_6571_length_1002_cov_17.780731	684	764	2	35	80	0.4375000
NODE_6571_length_1002_cov_17.780731	684	764	3	21	80	0.2625000
NODE_6572_length_1002_cov_17.590255	0	58	0	58	58	1.0000000
NODE_6572_length_1002_cov_17.590255	31	77	0	46	46	1.0000000
NODE_6573_length_1002_cov_17.105205	522	602	0	80	80	1.0000000
NODE_6573_length_1002_cov_17.105205	575	655	0	80	80	1.0000000
NODE_6574_length_1002_cov_11.954596	480	560	0	51	80	0.6375000
NODE_6574_length_1002_cov_11.954596	480	560	4	29	80	0.3625000
NODE_6574_length_1002_cov_11.954596	533	613	4	80	80	1.0000000
NODE_6575_length_1002_cov_11.823920	471	551	0	80	80	1.0000000
NODE_6575_length_1002_cov_11.823920	524	614	0	90	90	1.0000000
NODE_6577_length_1002_cov_6.596899	422	502	0	80	80	1.0000000
NODE_6577_length_1002_cov_6.596899	475	555	0	80	80	1.0000000
NODE_6588_length_1002_cov_2.102990	29	110	4	13	81	0.1604938
NODE_6588_length_1002_cov_2.102990	29	110	6	2	81	0.0246914
NODE_6588_length_1002_cov_2.102990	29	110	10	3	81	0.0370370
NODE_6588_length_1002_cov_2.102990	29	110	14	1	81	0.0123457
NODE_6588_length_1002_cov_2.102990	29	110	18	28	81	0.3456790
NODE_6588_length_1002_cov_2.102990	29	110	20	34	81	0.4197531
NODE_6596_length_1001_cov_41.914634	549	629	0	20	80	0.2500000
NODE_6596_length_1001_cov_41.914634	549	629	4	60	80	0.7500000
NODE_6596_length_1001_cov_41.914634	602	682	0	18	80	0.2250000
NODE_6596_length_1001_cov_41.914634	602	682	4	62	80	0.7750000
NODE_6597_length_1001_cov_30.378049	306	386	0	63	80	0.7875000
NODE_6597_length_1001_cov_30.378049	306	386	4	11	80	0.1375000
NODE_6597_length_1001_cov_30.378049	306	386	6	6	80	0.0750000
NODE_6597_length_1001_cov_30.378049	359	439	0	10	80	0.1250000
NODE_6597_length_1001_cov_30.378049	359	439	2	5	80	0.0625000
NODE_6597_length_1001_cov_30.378049	359	439	4	11	80	0.1375000
NODE_6597_length_1001_cov_30.378049	359	439	6	54	80	0.6750000
NODE_6597_length_1001_cov_30.378049	369	439	2	5	70	0.0714286
NODE_6597_length_1001_cov_30.378049	369	439	4	11	70	0.1571429
NODE_6597_length_1001_cov_30.378049	369	439	6	54	70	0.7714286
NODE_6597_length_1001_cov_30.378049	435	515	2	11	80	0.1375000
NODE_6597_length_1001_cov_30.378049	435	515	4	36	80	0.4500000
NODE_6597_length_1001_cov_30.378049	435	515	6	33	80	0.4125000
NODE_6597_length_1001_cov_30.378049	488	568	0	36	80	0.4500000
NODE_6597_length_1001_cov_30.378049	488	568	4	44	80	0.5500000
NODE_6598_length_1001_cov_22.517738	536	616	0	17	80	0.2125000
NODE_6598_length_1001_cov_22.517738	536	616	2	21	80	0.2625000
NODE_6598_length_1001_cov_22.517738	536	616	7	20	80	0.2500000
NODE_6598_length_1001_cov_22.517738	536	616	12	22	80	0.2750000
NODE_6598_length_1001_cov_22.517738	589	670	7	5	81	0.0617284
NODE_6598_length_1001_cov_22.517738	589	670	10	43	81	0.5308642
NODE_6598_length_1001_cov_22.517738	589	670	12	33	81	0.4074074
NODE_6599_length_1001_cov_17.996674	414	456	0	42	42	1.0000000
NODE_6599_length_1001_cov_17.996674	429	509	0	80	80	1.0000000
NODE_6599_length_1001_cov_17.996674	505	585	0	80	80	1.0000000
NODE_6599_length_1001_cov_17.996674	558	638	0	80	80	1.0000000
NODE_6600_length_1001_cov_16.798226	422	502	0	31	80	0.3875000
NODE_6600_length_1001_cov_16.798226	422	502	2	49	80	0.6125000
NODE_6600_length_1001_cov_16.798226	475	555	2	80	80	1.0000000
NODE_6600_length_1001_cov_16.798226	551	631	0	10	80	0.1250000
NODE_6600_length_1001_cov_16.798226	551	631	2	70	80	0.8750000
NODE_6600_length_1001_cov_16.798226	604	684	2	80	80	1.0000000
NODE_6601_length_1001_cov_12.778271	348	428	0	80	80	1.0000000
NODE_6601_length_1001_cov_12.778271	401	481	0	80	80	1.0000000
NODE_6602_length_1001_cov_12.305987	255	335	0	52	80	0.6500000
NODE_6602_length_1001_cov_12.305987	255	335	2	28	80	0.3500000
NODE_6602_length_1001_cov_12.305987	308	388	2	53	80	0.6625000
NODE_6602_length_1001_cov_12.305987	308	388	4	27	80	0.3375000
NODE_6603_length_1001_cov_11.955654	485	569	0	3	84	0.0357143
NODE_6603_length_1001_cov_11.955654	485	569	2	57	84	0.6785714
NODE_6603_length_1001_cov_11.955654	485	569	6	24	84	0.2857143
NODE_6603_length_1001_cov_11.955654	542	622	0	3	80	0.0375000
NODE_6603_length_1001_cov_11.955654	542	622	6	59	80	0.7375000
NODE_6603_length_1001_cov_11.955654	542	622	8	18	80	0.2250000
NODE_6604_length_1001_cov_10.156319	587	667	0	5	80	0.0625000
NODE_6604_length_1001_cov_10.156319	587	667	2	75	80	0.9375000
NODE_6604_length_1001_cov_10.156319	640	720	0	58	80	0.7250000
NODE_6604_length_1001_cov_10.156319	640	720	2	22	80	0.2750000
NODE_6605_length_1001_cov_9.754989	377	457	0	80	80	1.0000000
NODE_6605_length_1001_cov_9.754989	430	510	0	53	80	0.6625000
NODE_6605_length_1001_cov_9.754989	430	510	2	27	80	0.3375000
NODE_6607_length_1001_cov_4.616408	408	488	0	80	80	1.0000000
NODE_6607_length_1001_cov_4.616408	461	541	0	80	80	1.0000000
NODE_6616_length_1000_cov_55.578246	393	473	0	24	80	0.3000000
NODE_6616_length_1000_cov_55.578246	393	473	4	56	80	0.7000000
NODE_6616_length_1000_cov_55.578246	446	526	0	54	80	0.6750000
NODE_6616_length_1000_cov_55.578246	446	526	4	26	80	0.3250000
NODE_6616_length_1000_cov_55.578246	522	598	0	76	76	1.0000000
NODE_6616_length_1000_cov_55.578246	575	649	0	74	74	1.0000000
NODE_6617_length_1000_cov_51.534961	432	512	0	80	80	1.0000000
NODE_6617_length_1000_cov_51.534961	485	565	0	74	80	0.9250000
NODE_6617_length_1000_cov_51.534961	485	565	9	1	80	0.0125000
NODE_6617_length_1000_cov_51.534961	485	565	10	5	80	0.0625000
NODE_6617_length_1000_cov_51.534961	561	641	10	80	80	1.0000000
NODE_6617_length_1000_cov_51.534961	614	694	0	24	80	0.3000000
NODE_6617_length_1000_cov_51.534961	614	694	10	56	80	0.7000000
NODE_6618_length_1000_cov_39.011099	186	266	0	8	80	0.1000000
NODE_6618_length_1000_cov_39.011099	186	266	2	72	80	0.9000000
NODE_6618_length_1000_cov_39.011099	239	319	0	61	80	0.7625000
NODE_6618_length_1000_cov_39.011099	239	319	2	19	80	0.2375000
NODE_6619_length_1000_cov_19.897891	451	531	12	78	80	0.9750000
NODE_6619_length_1000_cov_19.897891	451	531	14	2	80	0.0250000
NODE_6619_length_1000_cov_19.897891	504	584	2	47	80	0.5875000
NODE_6619_length_1000_cov_19.897891	504	584	12	26	80	0.3250000
NODE_6619_length_1000_cov_19.897891	504	584	14	7	80	0.0875000
NODE_6619_length_1000_cov_19.897891	580	660	2	12	80	0.1500000
NODE_6619_length_1000_cov_19.897891	580	660	4	39	80	0.4875000
NODE_6619_length_1000_cov_19.897891	580	660	6	29	80	0.3625000
NODE_6619_length_1000_cov_19.897891	633	713	4	27	80	0.3375000
NODE_6619_length_1000_cov_19.897891	633	713	6	53	80	0.6625000
NODE_6620_length_1000_cov_13.349612	324	404	0	80	80	1.0000000
NODE_6620_length_1000_cov_13.349612	377	457	0	80	80	1.0000000
NODE_6621_length_1000_cov_11.463929	382	462	0	80	80	1.0000000
NODE_6621_length_1000_cov_11.463929	435	515	0	80	80	1.0000000
NODE_6622_length_1000_cov_9.675916	625	705	1	2	80	0.0250000
NODE_6622_length_1000_cov_9.675916	625	705	2	78	80	0.9750000
NODE_6622_length_1000_cov_9.675916	678	758	0	31	80	0.3875000
NODE_6622_length_1000_cov_9.675916	678	758	1	24	80	0.3000000
NODE_6622_length_1000_cov_9.675916	678	758	2	25	80	0.3125000
NODE_6623_length_1000_cov_7.051054	358	438	7	24	80	0.3000000
NODE_6623_length_1000_cov_7.051054	358	438	13	23	80	0.2875000
NODE_6623_length_1000_cov_7.051054	358	438	14	2	80	0.0250000
NODE_6623_length_1000_cov_7.051054	358	438	17	27	80	0.3375000
NODE_6623_length_1000_cov_7.051054	358	438	18	4	80	0.0500000
NODE_6623_length_1000_cov_7.051054	411	491	0	43	80	0.5375000
NODE_6623_length_1000_cov_7.051054	411	491	7	34	80	0.4250000
NODE_6623_length_1000_cov_7.051054	411	491	13	3	80	0.0375000
NODE_6626_length_1000_cov_3.652608	203	265	0	62	62	1.0000000
NODE_6639_length_999_cov_47.442222	604	684	12	2	80	0.0250000
NODE_6639_length_999_cov_47.442222	604	684	19	1	80	0.0125000
NODE_6639_length_999_cov_47.442222	604	684	22	31	80	0.3875000
NODE_6639_length_999_cov_47.442222	604	684	28	13	80	0.1625000
NODE_6639_length_999_cov_47.442222	604	684	30	2	80	0.0250000
NODE_6639_length_999_cov_47.442222	604	684	32	28	80	0.3500000
NODE_6639_length_999_cov_47.442222	604	684	34	3	80	0.0375000
NODE_6639_length_999_cov_47.442222	657	723	32	66	66	1.0000000
NODE_6640_length_999_cov_33.055556	458	540	0	35	82	0.4268293
NODE_6640_length_999_cov_33.055556	458	540	2	3	82	0.0365854
NODE_6640_length_999_cov_33.055556	458	540	5	16	82	0.1951219
NODE_6640_length_999_cov_33.055556	458	540	6	1	82	0.0121951
NODE_6640_length_999_cov_33.055556	458	540	7	27	82	0.3292683
NODE_6640_length_999_cov_33.055556	513	593	5	14	80	0.1750000
NODE_6640_length_999_cov_33.055556	513	593	7	66	80	0.8250000
NODE_6641_length_999_cov_22.755556	493	573	0	37	80	0.4625000
NODE_6641_length_999_cov_22.755556	493	573	4	43	80	0.5375000
NODE_6641_length_999_cov_22.755556	546	626	4	80	80	1.0000000
NODE_6642_length_999_cov_21.842222	359	439	0	5	80	0.0625000
NODE_6642_length_999_cov_21.842222	359	439	5	1	80	0.0125000
NODE_6642_length_999_cov_21.842222	359	439	6	5	80	0.0625000
NODE_6642_length_999_cov_21.842222	359	439	11	10	80	0.1250000
NODE_6642_length_999_cov_21.842222	359	439	12	59	80	0.7375000
NODE_6642_length_999_cov_21.842222	412	492	11	63	80	0.7875000
NODE_6642_length_999_cov_21.842222	412	492	12	17	80	0.2125000
NODE_6643_length_999_cov_20.006667	361	441	0	31	80	0.3875000
NODE_6643_length_999_cov_20.006667	361	441	2	49	80	0.6125000
NODE_6643_length_999_cov_20.006667	414	494	2	80	80	1.0000000
NODE_6643_length_999_cov_20.006667	490	570	0	32	80	0.4000000
NODE_6643_length_999_cov_20.006667	490	570	2	48	80	0.6000000
NODE_6643_length_999_cov_20.006667	543	623	0	80	80	1.0000000
NODE_6645_length_999_cov_16.794444	438	518	0	47	80	0.5875000
NODE_6645_length_999_cov_16.794444	438	518	2	33	80	0.4125000
NODE_6645_length_999_cov_16.794444	491	571	2	80	80	1.0000000
NODE_6646_length_999_cov_15.146667	464	544	0	80	80	1.0000000
NODE_6646_length_999_cov_15.146667	517	597	0	80	80	1.0000000
NODE_6648_length_999_cov_8.771111	361	441	0	80	80	1.0000000
NODE_6648_length_999_cov_8.771111	414	492	0	78	78	1.0000000
NODE_6649_length_999_cov_5.171111	417	497	0	39	80	0.4875000
NODE_6649_length_999_cov_5.171111	417	497	4	41	80	0.5125000
NODE_6649_length_999_cov_5.171111	470	550	4	80	80	1.0000000
NODE_6650_length_999_cov_2.854444	35	101	2	62	66	0.9393939
NODE_6650_length_999_cov_2.854444	35	101	9	4	66	0.0606061
NODE_6657_length_998_cov_30.697442	404	484	0	24	80	0.3000000
NODE_6657_length_998_cov_30.697442	404	484	2	56	80	0.7000000
NODE_6657_length_998_cov_30.697442	457	537	0	77	80	0.9625000
NODE_6657_length_998_cov_30.697442	457	537	2	3	80	0.0375000
NODE_6657_length_998_cov_30.697442	533	613	0	80	80	1.0000000
NODE_6657_length_998_cov_30.697442	586	666	0	80	80	1.0000000
NODE_6658_length_998_cov_23.703003	235	315	0	18	80	0.2250000
NODE_6658_length_998_cov_23.703003	235	315	4	11	80	0.1375000
NODE_6658_length_998_cov_23.703003	235	315	7	2	80	0.0250000
NODE_6658_length_998_cov_23.703003	235	315	8	9	80	0.1125000
NODE_6658_length_998_cov_23.703003	235	315	10	10	80	0.1250000
NODE_6658_length_998_cov_23.703003	235	315	11	1	80	0.0125000
NODE_6658_length_998_cov_23.703003	235	315	12	17	80	0.2125000
NODE_6658_length_998_cov_23.703003	235	315	18	12	80	0.1500000
NODE_6658_length_998_cov_23.703003	288	368	12	15	80	0.1875000
NODE_6658_length_998_cov_23.703003	288	368	16	19	80	0.2375000
NODE_6658_length_998_cov_23.703003	288	368	18	46	80	0.5750000
NODE_6659_length_998_cov_22.692992	531	611	0	5	80	0.0625000
NODE_6659_length_998_cov_22.692992	531	611	2	35	80	0.4375000
NODE_6659_length_998_cov_22.692992	531	611	4	40	80	0.5000000
NODE_6659_length_998_cov_22.692992	584	664	0	7	80	0.0875000
NODE_6659_length_998_cov_22.692992	584	664	2	54	80	0.6750000
NODE_6659_length_998_cov_22.692992	584	664	4	19	80	0.2375000
NODE_6660_length_998_cov_11.152392	514	594	2	53	80	0.6625000
NODE_6660_length_998_cov_11.152392	514	594	4	22	80	0.2750000
NODE_6660_length_998_cov_11.152392	514	594	6	5	80	0.0625000
NODE_6660_length_998_cov_11.152392	567	640	4	68	73	0.9315069
NODE_6660_length_998_cov_11.152392	567	640	6	5	73	0.0684932
NODE_6660_length_998_cov_11.152392	636	716	0	16	80	0.2000000
NODE_6660_length_998_cov_11.152392	636	716	4	64	80	0.8000000
NODE_6660_length_998_cov_11.152392	689	769	0	69	80	0.8625000
NODE_6660_length_998_cov_11.152392	689	769	4	11	80	0.1375000
NODE_6661_length_998_cov_10.061179	422	502	0	80	80	1.0000000
NODE_6661_length_998_cov_10.061179	475	555	0	80	80	1.0000000
NODE_6662_length_998_cov_7.126808	353	430	0	77	77	1.0000000
NODE_6662_length_998_cov_7.126808	403	483	0	80	80	1.0000000
NODE_6669_length_997_cov_48.518931	445	525	0	30	80	0.3750000
NODE_6669_length_997_cov_48.518931	445	525	4	50	80	0.6250000
NODE_6669_length_997_cov_48.518931	498	578	0	16	80	0.2000000
NODE_6669_length_997_cov_48.518931	498	578	4	64	80	0.8000000
NODE_6670_length_997_cov_36.721604	400	480	0	65	80	0.8125000
NODE_6670_length_997_cov_36.721604	400	480	4	15	80	0.1875000
NODE_6670_length_997_cov_36.721604	453	533	0	12	80	0.1500000
NODE_6670_length_997_cov_36.721604	453	533	4	61	80	0.7625000
NODE_6670_length_997_cov_36.721604	453	533	6	7	80	0.0875000
NODE_6671_length_997_cov_22.646993	328	408	0	80	80	1.0000000
NODE_6671_length_997_cov_22.646993	381	461	0	80	80	1.0000000
NODE_6672_length_997_cov_19.709354	420	500	0	6	80	0.0750000
NODE_6672_length_997_cov_19.709354	420	500	1	1	80	0.0125000
NODE_6672_length_997_cov_19.709354	420	500	2	73	80	0.9125000
NODE_6672_length_997_cov_19.709354	473	553	0	59	80	0.7375000
NODE_6672_length_997_cov_19.709354	473	553	1	1	80	0.0125000
NODE_6672_length_997_cov_19.709354	473	553	2	20	80	0.2500000
NODE_6672_length_997_cov_19.709354	549	629	0	80	80	1.0000000
NODE_6672_length_997_cov_19.709354	602	682	0	80	80	1.0000000
NODE_6673_length_997_cov_17.947661	465	545	0	80	80	1.0000000
NODE_6673_length_997_cov_17.947661	518	598	0	80	80	1.0000000
NODE_6673_length_997_cov_17.947661	594	674	0	80	80	1.0000000
NODE_6673_length_997_cov_17.947661	647	727	0	80	80	1.0000000
NODE_6674_length_997_cov_14.718263	388	468	0	68	80	0.8500000
NODE_6674_length_997_cov_14.718263	388	468	2	12	80	0.1500000
NODE_6674_length_997_cov_14.718263	441	521	0	80	80	1.0000000
NODE_6675_length_997_cov_7.114699	307	387	4	42	80	0.5250000
NODE_6675_length_997_cov_7.114699	307	387	6	25	80	0.3125000
NODE_6675_length_997_cov_7.114699	307	387	8	13	80	0.1625000
NODE_6675_length_997_cov_7.114699	360	440	4	38	80	0.4750000
NODE_6675_length_997_cov_7.114699	360	440	6	14	80	0.1750000
NODE_6675_length_997_cov_7.114699	360	440	8	28	80	0.3500000
NODE_6694_length_996_cov_59.568562	387	467	0	8	80	0.1000000
NODE_6694_length_996_cov_59.568562	387	467	2	72	80	0.9000000
NODE_6694_length_996_cov_59.568562	440	520	0	8	80	0.1000000
NODE_6694_length_996_cov_59.568562	440	520	2	28	80	0.3500000
NODE_6694_length_996_cov_59.568562	440	520	3	39	80	0.4875000
NODE_6694_length_996_cov_59.568562	440	520	4	5	80	0.0625000
NODE_6695_length_996_cov_32.462653	503	583	0	32	80	0.4000000
NODE_6695_length_996_cov_32.462653	503	583	2	13	80	0.1625000
NODE_6695_length_996_cov_32.462653	503	583	3	35	80	0.4375000
NODE_6695_length_996_cov_32.462653	556	636	2	31	80	0.3875000
NODE_6695_length_996_cov_32.462653	556	636	3	39	80	0.4875000
NODE_6695_length_996_cov_32.462653	556	636	4	10	80	0.1250000
NODE_6696_length_996_cov_23.312152	571	651	0	9	80	0.1125000
NODE_6696_length_996_cov_23.312152	571	651	2	1	80	0.0125000
NODE_6696_length_996_cov_23.312152	571	651	3	1	80	0.0125000
NODE_6696_length_996_cov_23.312152	571	651	7	25	80	0.3125000
NODE_6696_length_996_cov_23.312152	571	651	9	1	80	0.0125000
NODE_6696_length_996_cov_23.312152	571	651	10	43	80	0.5375000
NODE_6696_length_996_cov_23.312152	624	704	0	62	80	0.7750000
NODE_6696_length_996_cov_23.312152	624	704	2	1	80	0.0125000
NODE_6696_length_996_cov_23.312152	624	704	3	1	80	0.0125000
NODE_6696_length_996_cov_23.312152	624	704	7	16	80	0.2000000
NODE_6697_length_996_cov_20.979933	533	613	0	80	80	1.0000000
NODE_6697_length_996_cov_20.979933	586	666	0	56	80	0.7000000
NODE_6697_length_996_cov_20.979933	586	666	5	24	80	0.3000000
NODE_6698_length_996_cov_17.865106	535	615	0	12	80	0.1500000
NODE_6698_length_996_cov_17.865106	535	615	2	68	80	0.8500000
NODE_6698_length_996_cov_17.865106	588	668	0	65	80	0.8125000
NODE_6698_length_996_cov_17.865106	588	668	2	15	80	0.1875000
NODE_6699_length_996_cov_10.297659	499	579	2	76	80	0.9500000
NODE_6699_length_996_cov_10.297659	499	579	4	4	80	0.0500000
NODE_6699_length_996_cov_10.297659	552	630	0	21	78	0.2692308
NODE_6699_length_996_cov_10.297659	552	630	2	57	78	0.7307692
NODE_6702_length_996_cov_3.205128	499	555	0	56	56	1.0000000
NODE_6707_length_995_cov_26.131696	543	623	0	80	80	1.0000000
NODE_6707_length_995_cov_26.131696	596	676	0	80	80	1.0000000
NODE_6708_length_995_cov_20.262277	457	537	2	80	80	1.0000000
NODE_6708_length_995_cov_20.262277	510	590	0	20	80	0.2500000
NODE_6708_length_995_cov_20.262277	510	590	1	14	80	0.1750000
NODE_6708_length_995_cov_20.262277	510	590	2	46	80	0.5750000
NODE_6709_length_995_cov_19.382812	457	537	0	74	80	0.9250000
NODE_6709_length_995_cov_19.382812	457	537	2	6	80	0.0750000
NODE_6709_length_995_cov_19.382812	510	590	0	80	80	1.0000000
NODE_6710_length_995_cov_19.034598	453	533	7	6	80	0.0750000
NODE_6710_length_995_cov_19.034598	453	533	9	1	80	0.0125000
NODE_6710_length_995_cov_19.034598	453	533	10	73	80	0.9125000
NODE_6710_length_995_cov_19.034598	506	586	0	28	80	0.3500000
NODE_6710_length_995_cov_19.034598	506	586	6	1	80	0.0125000
NODE_6710_length_995_cov_19.034598	506	586	7	30	80	0.3750000
NODE_6710_length_995_cov_19.034598	506	586	9	1	80	0.0125000
NODE_6710_length_995_cov_19.034598	506	586	10	20	80	0.2500000
NODE_6711_length_995_cov_9.734375	222	323	0	59	101	0.5841584
NODE_6711_length_995_cov_9.734375	222	323	3	1	101	0.0099010
NODE_6711_length_995_cov_9.734375	222	323	4	27	101	0.2673267
NODE_6711_length_995_cov_9.734375	222	323	6	14	101	0.1386139
NODE_6711_length_995_cov_9.734375	296	376	2	10	80	0.1250000
NODE_6711_length_995_cov_9.734375	296	376	4	13	80	0.1625000
NODE_6711_length_995_cov_9.734375	296	376	6	57	80	0.7125000
NODE_6723_length_994_cov_74.678212	362	442	16	30	80	0.3750000
NODE_6723_length_994_cov_74.678212	362	442	18	33	80	0.4125000
NODE_6723_length_994_cov_74.678212	362	442	20	17	80	0.2125000
NODE_6723_length_994_cov_74.678212	415	495	0	10	80	0.1250000
NODE_6723_length_994_cov_74.678212	415	495	4	7	80	0.0875000
NODE_6723_length_994_cov_74.678212	415	495	14	1	80	0.0125000
NODE_6723_length_994_cov_74.678212	415	495	16	58	80	0.7250000
NODE_6723_length_994_cov_74.678212	415	495	18	4	80	0.0500000
NODE_6723_length_994_cov_74.678212	491	571	0	71	80	0.8875000
NODE_6723_length_994_cov_74.678212	491	571	9	9	80	0.1125000
NODE_6723_length_994_cov_74.678212	544	624	0	18	80	0.2250000
NODE_6723_length_994_cov_74.678212	544	624	9	22	80	0.2750000
NODE_6723_length_994_cov_74.678212	544	624	10	40	80	0.5000000
NODE_6724_length_994_cov_26.045810	442	522	0	80	80	1.0000000
NODE_6724_length_994_cov_26.045810	495	575	0	80	80	1.0000000
NODE_6725_length_994_cov_25.240223	504	584	4	17	80	0.2125000
NODE_6725_length_994_cov_25.240223	504	584	8	63	80	0.7875000
NODE_6725_length_994_cov_25.240223	557	637	0	23	80	0.2875000
NODE_6725_length_994_cov_25.240223	557	637	4	4	80	0.0500000
NODE_6725_length_994_cov_25.240223	557	637	8	53	80	0.6625000
NODE_6726_length_994_cov_24.615642	422	502	0	56	80	0.7000000
NODE_6726_length_994_cov_24.615642	422	502	2	24	80	0.3000000
NODE_6726_length_994_cov_24.615642	475	555	0	7	80	0.0875000
NODE_6726_length_994_cov_24.615642	475	555	2	73	80	0.9125000
NODE_6726_length_994_cov_24.615642	551	631	0	26	80	0.3250000
NODE_6726_length_994_cov_24.615642	551	631	1	20	80	0.2500000
NODE_6726_length_994_cov_24.615642	551	631	2	34	80	0.4250000
NODE_6726_length_994_cov_24.615642	604	684	2	32	80	0.4000000
NODE_6726_length_994_cov_24.615642	604	684	4	6	80	0.0750000
NODE_6726_length_994_cov_24.615642	604	684	5	42	80	0.5250000
NODE_6727_length_994_cov_22.593296	323	403	0	80	80	1.0000000
NODE_6727_length_994_cov_22.593296	376	456	0	80	80	1.0000000
NODE_6727_length_994_cov_22.593296	452	532	0	80	80	1.0000000
NODE_6727_length_994_cov_22.593296	505	585	0	80	80	1.0000000
NODE_6728_length_994_cov_6.985475	0	58	0	47	58	0.8103448
NODE_6728_length_994_cov_6.985475	0	58	2	11	58	0.1896552
NODE_6728_length_994_cov_6.985475	15	95	0	32	80	0.4000000
NODE_6728_length_994_cov_6.985475	15	95	2	48	80	0.6000000
NODE_6728_length_994_cov_6.985475	68	148	0	4	80	0.0500000
NODE_6728_length_994_cov_6.985475	68	148	2	76	80	0.9500000
NODE_6740_length_993_cov_56.321029	266	346	0	80	80	1.0000000
NODE_6740_length_993_cov_56.321029	319	399	0	31	80	0.3875000
NODE_6740_length_993_cov_56.321029	319	399	4	49	80	0.6125000
NODE_6740_length_993_cov_56.321029	400	470	0	32	70	0.4571429
NODE_6740_length_993_cov_56.321029	400	470	4	38	70	0.5428572
NODE_6740_length_993_cov_56.321029	443	523	0	80	80	1.0000000
NODE_6741_length_993_cov_44.695749	385	465	2	17	80	0.2125000
NODE_6741_length_993_cov_44.695749	385	465	4	63	80	0.7875000
NODE_6741_length_993_cov_44.695749	438	518	0	43	80	0.5375000
NODE_6741_length_993_cov_44.695749	438	518	2	27	80	0.3375000
NODE_6741_length_993_cov_44.695749	438	518	4	10	80	0.1250000
NODE_6742_length_993_cov_40.574944	417	497	0	52	80	0.6500000
NODE_6742_length_993_cov_40.574944	417	497	2	28	80	0.3500000
NODE_6742_length_993_cov_40.574944	470	550	2	80	80	1.0000000
NODE_6742_length_993_cov_40.574944	546	628	2	42	82	0.5121951
NODE_6742_length_993_cov_40.574944	546	628	4	40	82	0.4878049
NODE_6742_length_993_cov_40.574944	601	681	2	13	80	0.1625000
NODE_6742_length_993_cov_40.574944	601	681	4	67	80	0.8375000
NODE_6743_length_993_cov_39.817673	3	83	0	8	80	0.1000000
NODE_6743_length_993_cov_39.817673	3	83	2	1	80	0.0125000
NODE_6743_length_993_cov_39.817673	3	83	6	71	80	0.8875000
NODE_6744_length_993_cov_30.128635	477	557	0	80	80	1.0000000
NODE_6744_length_993_cov_30.128635	530	610	0	56	80	0.7000000
NODE_6744_length_993_cov_30.128635	530	610	2	24	80	0.3000000
NODE_6745_length_993_cov_17.435123	573	653	0	80	80	1.0000000
NODE_6745_length_993_cov_17.435123	626	706	0	80	80	1.0000000
NODE_6746_length_993_cov_13.074944	483	563	0	80	80	1.0000000
NODE_6746_length_993_cov_13.074944	536	616	0	80	80	1.0000000
NODE_6747_length_993_cov_10.190157	500	580	0	80	80	1.0000000
NODE_6747_length_993_cov_10.190157	553	633	0	57	80	0.7125000
NODE_6747_length_993_cov_10.190157	553	633	4	23	80	0.2875000
NODE_6756_length_993_cov_0.909396	16	73	0	57	57	1.0000000
NODE_6757_length_992_cov_36.119821	354	434	0	4	80	0.0500000
NODE_6757_length_992_cov_36.119821	354	434	2	3	80	0.0375000
NODE_6757_length_992_cov_36.119821	354	434	4	37	80	0.4625000
NODE_6757_length_992_cov_36.119821	354	434	6	36	80	0.4500000
NODE_6757_length_992_cov_36.119821	407	487	2	56	80	0.7000000
NODE_6757_length_992_cov_36.119821	407	487	6	24	80	0.3000000
NODE_6757_length_992_cov_36.119821	483	563	0	55	80	0.6875000
NODE_6757_length_992_cov_36.119821	483	563	2	25	80	0.3125000
NODE_6757_length_992_cov_36.119821	536	616	0	48	80	0.6000000
NODE_6757_length_992_cov_36.119821	536	616	2	32	80	0.4000000
NODE_6758_length_992_cov_34.802912	443	523	0	16	80	0.2000000
NODE_6758_length_992_cov_34.802912	443	523	2	64	80	0.8000000
NODE_6758_length_992_cov_34.802912	496	576	0	69	80	0.8625000
NODE_6758_length_992_cov_34.802912	496	576	2	11	80	0.1375000
NODE_6759_length_992_cov_33.047032	381	461	2	31	80	0.3875000
NODE_6759_length_992_cov_33.047032	381	461	3	5	80	0.0625000
NODE_6759_length_992_cov_33.047032	381	461	4	36	80	0.4500000
NODE_6759_length_992_cov_33.047032	381	461	5	8	80	0.1000000
NODE_6759_length_992_cov_33.047032	434	514	1	18	80	0.2250000
NODE_6759_length_992_cov_33.047032	434	514	2	26	80	0.3250000
NODE_6759_length_992_cov_33.047032	434	514	3	36	80	0.4500000
NODE_6759_length_992_cov_33.047032	510	590	0	23	80	0.2875000
NODE_6759_length_992_cov_33.047032	510	590	1	57	80	0.7125000
NODE_6759_length_992_cov_33.047032	563	643	0	76	80	0.9500000
NODE_6759_length_992_cov_33.047032	563	643	1	4	80	0.0500000
NODE_6760_length_992_cov_23.543113	435	515	0	29	80	0.3625000
NODE_6760_length_992_cov_23.543113	435	515	7	10	80	0.1250000
NODE_6760_length_992_cov_23.543113	435	515	13	1	80	0.0125000
NODE_6760_length_992_cov_23.543113	435	515	14	40	80	0.5000000
NODE_6760_length_992_cov_23.543113	488	568	14	29	80	0.3625000
NODE_6760_length_992_cov_23.543113	488	568	16	51	80	0.6375000
NODE_6761_length_992_cov_22.608063	440	520	0	19	80	0.2375000
NODE_6761_length_992_cov_22.608063	440	520	2	22	80	0.2750000
NODE_6761_length_992_cov_22.608063	440	520	4	39	80	0.4875000
NODE_6761_length_992_cov_22.608063	493	573	0	72	80	0.9000000
NODE_6761_length_992_cov_22.608063	493	573	2	8	80	0.1000000
NODE_6762_length_992_cov_21.427772	216	296	0	6	80	0.0750000
NODE_6762_length_992_cov_21.427772	216	296	2	74	80	0.9250000
NODE_6762_length_992_cov_21.427772	269	349	0	1	80	0.0125000
NODE_6762_length_992_cov_21.427772	269	349	2	79	80	0.9875000
NODE_6763_length_992_cov_20.010078	312	392	0	16	80	0.2000000
NODE_6763_length_992_cov_20.010078	312	392	2	64	80	0.8000000
NODE_6763_length_992_cov_20.010078	365	445	0	51	80	0.6375000
NODE_6763_length_992_cov_20.010078	365	445	2	29	80	0.3625000
NODE_6764_length_992_cov_16.524076	465	545	0	6	80	0.0750000
NODE_6764_length_992_cov_16.524076	465	545	4	74	80	0.9250000
NODE_6764_length_992_cov_16.524076	518	598	0	33	80	0.4125000
NODE_6764_length_992_cov_16.524076	518	598	2	26	80	0.3250000
NODE_6764_length_992_cov_16.524076	518	598	4	21	80	0.2625000
NODE_6765_length_992_cov_16.266517	396	476	0	28	80	0.3500000
NODE_6765_length_992_cov_16.266517	396	476	2	52	80	0.6500000
NODE_6765_length_992_cov_16.266517	449	529	0	44	80	0.5500000
NODE_6765_length_992_cov_16.266517	449	529	2	36	80	0.4500000
NODE_6766_length_992_cov_16.146697	272	352	0	80	80	1.0000000
NODE_6766_length_992_cov_16.146697	325	405	0	80	80	1.0000000
NODE_6767_length_992_cov_15.212766	354	434	0	80	80	1.0000000
NODE_6767_length_992_cov_15.212766	407	487	0	75	80	0.9375000
NODE_6767_length_992_cov_15.212766	407	487	1	5	80	0.0625000
NODE_6767_length_992_cov_15.212766	483	563	1	10	80	0.1250000
NODE_6767_length_992_cov_15.212766	483	563	2	30	80	0.3750000
NODE_6767_length_992_cov_15.212766	483	563	4	21	80	0.2625000
NODE_6767_length_992_cov_15.212766	483	563	6	19	80	0.2375000
NODE_6767_length_992_cov_15.212766	536	616	2	4	80	0.0500000
NODE_6767_length_992_cov_15.212766	536	616	3	1	80	0.0125000
NODE_6767_length_992_cov_15.212766	536	616	4	8	80	0.1000000
NODE_6767_length_992_cov_15.212766	536	616	6	67	80	0.8375000
NODE_6781_length_991_cov_48.582960	451	531	10	11	80	0.1375000
NODE_6781_length_991_cov_48.582960	451	531	30	2	80	0.0250000
NODE_6781_length_991_cov_48.582960	451	531	31	22	80	0.2750000
NODE_6781_length_991_cov_48.582960	451	531	32	28	80	0.3500000
NODE_6781_length_991_cov_48.582960	451	531	33	8	80	0.1000000
NODE_6781_length_991_cov_48.582960	451	531	37	4	80	0.0500000
NODE_6781_length_991_cov_48.582960	451	531	40	5	80	0.0625000
NODE_6781_length_991_cov_48.582960	504	584	29	31	80	0.3875000
NODE_6781_length_991_cov_48.582960	504	584	31	31	80	0.3875000
NODE_6781_length_991_cov_48.582960	504	584	32	1	80	0.0125000
NODE_6781_length_991_cov_48.582960	504	584	33	8	80	0.1000000
NODE_6781_length_991_cov_48.582960	504	584	37	4	80	0.0500000
NODE_6781_length_991_cov_48.582960	504	584	40	5	80	0.0625000
NODE_6782_length_991_cov_25.891256	340	420	0	80	80	1.0000000
NODE_6782_length_991_cov_25.891256	393	473	0	80	80	1.0000000
NODE_6782_length_991_cov_25.891256	469	549	0	80	80	1.0000000
NODE_6782_length_991_cov_25.891256	522	602	0	80	80	1.0000000
NODE_6783_length_991_cov_25.392377	377	457	0	55	80	0.6875000
NODE_6783_length_991_cov_25.392377	377	457	2	25	80	0.3125000
NODE_6783_length_991_cov_25.392377	430	510	0	2	80	0.0250000
NODE_6783_length_991_cov_25.392377	430	510	2	78	80	0.9750000
NODE_6783_length_991_cov_25.392377	506	586	0	63	80	0.7875000
NODE_6783_length_991_cov_25.392377	506	586	1	2	80	0.0250000
NODE_6783_length_991_cov_25.392377	506	586	2	15	80	0.1875000
NODE_6783_length_991_cov_25.392377	559	639	0	20	80	0.2500000
NODE_6783_length_991_cov_25.392377	559	639	1	2	80	0.0250000
NODE_6783_length_991_cov_25.392377	559	639	2	58	80	0.7250000
NODE_6784_length_991_cov_22.210762	421	501	0	3	80	0.0375000
NODE_6784_length_991_cov_22.210762	421	501	2	77	80	0.9625000
NODE_6784_length_991_cov_22.210762	474	554	0	56	80	0.7000000
NODE_6784_length_991_cov_22.210762	474	554	2	24	80	0.3000000
NODE_6785_length_991_cov_18.008969	366	446	0	80	80	1.0000000
NODE_6785_length_991_cov_18.008969	419	499	0	80	80	1.0000000
NODE_6785_length_991_cov_18.008969	495	575	0	23	80	0.2875000
NODE_6785_length_991_cov_18.008969	495	575	5	1	80	0.0125000
NODE_6785_length_991_cov_18.008969	495	575	6	56	80	0.7000000
NODE_6785_length_991_cov_18.008969	548	629	6	71	81	0.8765432
NODE_6785_length_991_cov_18.008969	548	629	8	10	81	0.1234568
NODE_6786_length_991_cov_14.727578	426	506	2	33	80	0.4125000
NODE_6786_length_991_cov_14.727578	426	506	4	1	80	0.0125000
NODE_6786_length_991_cov_14.727578	426	506	6	6	80	0.0750000
NODE_6786_length_991_cov_14.727578	426	506	8	1	80	0.0125000
NODE_6786_length_991_cov_14.727578	426	506	10	30	80	0.3750000
NODE_6786_length_991_cov_14.727578	426	506	11	1	80	0.0125000
NODE_6786_length_991_cov_14.727578	426	506	13	8	80	0.1000000
NODE_6786_length_991_cov_14.727578	479	559	10	18	80	0.2250000
NODE_6786_length_991_cov_14.727578	479	559	11	1	80	0.0125000
NODE_6786_length_991_cov_14.727578	479	559	13	20	80	0.2500000
NODE_6786_length_991_cov_14.727578	479	559	14	4	80	0.0500000
NODE_6786_length_991_cov_14.727578	479	559	15	3	80	0.0375000
NODE_6786_length_991_cov_14.727578	479	559	17	34	80	0.4250000
NODE_6787_length_991_cov_13.081839	240	320	0	80	80	1.0000000
NODE_6787_length_991_cov_13.081839	293	373	0	80	80	1.0000000
NODE_6788_length_991_cov_12.693946	425	505	0	80	80	1.0000000
NODE_6788_length_991_cov_12.693946	478	558	0	80	80	1.0000000
NODE_6789_length_991_cov_9.647982	436	516	0	80	80	1.0000000
NODE_6789_length_991_cov_9.647982	489	569	0	80	80	1.0000000
NODE_6790_length_991_cov_5.176009	538	618	0	80	80	1.0000000
NODE_6790_length_991_cov_5.176009	591	671	0	80	80	1.0000000
NODE_6801_length_990_cov_39.386083	402	482	0	80	80	1.0000000
NODE_6801_length_990_cov_39.386083	455	535	0	80	80	1.0000000
NODE_6802_length_990_cov_35.993266	321	401	0	80	80	1.0000000
NODE_6802_length_990_cov_35.993266	374	454	0	78	80	0.9750000
NODE_6802_length_990_cov_35.993266	374	454	2	2	80	0.0250000
NODE_6802_length_990_cov_35.993266	450	530	0	2	80	0.0250000
NODE_6802_length_990_cov_35.993266	450	530	2	78	80	0.9750000
NODE_6802_length_990_cov_35.993266	503	583	0	30	80	0.3750000
NODE_6802_length_990_cov_35.993266	503	583	2	50	80	0.6250000
NODE_6803_length_990_cov_24.445567	588	668	2	77	80	0.9625000
NODE_6803_length_990_cov_24.445567	588	668	4	3	80	0.0375000
NODE_6803_length_990_cov_24.445567	641	721	0	49	80	0.6125000
NODE_6803_length_990_cov_24.445567	641	721	2	31	80	0.3875000
NODE_6805_length_990_cov_22.378227	430	510	0	37	80	0.4625000
NODE_6805_length_990_cov_22.378227	430	510	2	28	80	0.3500000
NODE_6805_length_990_cov_22.378227	430	510	4	15	80	0.1875000
NODE_6805_length_990_cov_22.378227	483	563	0	80	80	1.0000000
NODE_6806_length_990_cov_20.150393	408	488	2	59	80	0.7375000
NODE_6806_length_990_cov_20.150393	408	488	4	21	80	0.2625000
NODE_6806_length_990_cov_20.150393	461	541	2	9	80	0.1125000
NODE_6806_length_990_cov_20.150393	461	541	4	71	80	0.8875000
NODE_6807_length_990_cov_18.154882	434	514	0	80	80	1.0000000
NODE_6807_length_990_cov_18.154882	487	567	0	80	80	1.0000000
NODE_6808_length_990_cov_17.250281	329	409	0	5	80	0.0625000
NODE_6808_length_990_cov_17.250281	329	409	2	75	80	0.9375000
NODE_6808_length_990_cov_17.250281	382	462	0	46	80	0.5750000
NODE_6808_length_990_cov_17.250281	382	462	2	22	80	0.2750000
NODE_6808_length_990_cov_17.250281	382	462	4	12	80	0.1500000
NODE_6808_length_990_cov_17.250281	458	538	2	21	80	0.2625000
NODE_6808_length_990_cov_17.250281	458	538	4	57	80	0.7125000
NODE_6808_length_990_cov_17.250281	458	538	6	2	80	0.0250000
NODE_6808_length_990_cov_17.250281	511	591	2	31	80	0.3875000
NODE_6808_length_990_cov_17.250281	511	591	4	47	80	0.5875000
NODE_6808_length_990_cov_17.250281	511	591	6	2	80	0.0250000
NODE_6809_length_990_cov_14.977553	448	528	2	80	80	1.0000000
NODE_6809_length_990_cov_14.977553	501	581	0	48	80	0.6000000
NODE_6809_length_990_cov_14.977553	501	581	2	32	80	0.4000000
NODE_6810_length_990_cov_13.846240	482	562	0	22	80	0.2750000
NODE_6810_length_990_cov_13.846240	482	562	3	1	80	0.0125000
NODE_6810_length_990_cov_13.846240	482	562	4	57	80	0.7125000
NODE_6810_length_990_cov_13.846240	535	615	4	80	80	1.0000000
NODE_6821_length_990_cov_0.978676	79	151	0	2	72	0.0277778
NODE_6821_length_990_cov_0.978676	79	151	4	5	72	0.0694444
NODE_6821_length_990_cov_0.978676	79	151	6	5	72	0.0694444
NODE_6821_length_990_cov_0.978676	79	151	8	2	72	0.0277778
NODE_6821_length_990_cov_0.978676	79	151	10	3	72	0.0416667
NODE_6821_length_990_cov_0.978676	79	151	12	55	72	0.7638889
NODE_6821_length_990_cov_0.978676	82	152	0	3	70	0.0428571
NODE_6821_length_990_cov_0.978676	82	152	4	5	70	0.0714286
NODE_6821_length_990_cov_0.978676	82	152	6	5	70	0.0714286
NODE_6821_length_990_cov_0.978676	82	152	8	2	70	0.0285714
NODE_6821_length_990_cov_0.978676	82	152	10	3	70	0.0428571
NODE_6821_length_990_cov_0.978676	82	152	12	52	70	0.7428572
NODE_6823_length_989_cov_45.902247	47	127	0	1	80	0.0125000
NODE_6823_length_989_cov_45.902247	47	127	8	2	80	0.0250000
NODE_6823_length_989_cov_45.902247	47	127	12	1	80	0.0125000
NODE_6823_length_989_cov_45.902247	47	127	16	1	80	0.0125000
NODE_6823_length_989_cov_45.902247	47	127	20	1	80	0.0125000
NODE_6823_length_989_cov_45.902247	47	127	30	1	80	0.0125000
NODE_6823_length_989_cov_45.902247	47	127	34	3	80	0.0375000
NODE_6823_length_989_cov_45.902247	47	127	36	1	80	0.0125000
NODE_6823_length_989_cov_45.902247	47	127	38	3	80	0.0375000
NODE_6823_length_989_cov_45.902247	47	127	40	3	80	0.0375000
NODE_6823_length_989_cov_45.902247	47	127	42	3	80	0.0375000
NODE_6823_length_989_cov_45.902247	47	127	44	1	80	0.0125000
NODE_6823_length_989_cov_45.902247	47	127	46	1	80	0.0125000
NODE_6823_length_989_cov_45.902247	47	127	50	1	80	0.0125000
NODE_6823_length_989_cov_45.902247	47	127	52	2	80	0.0250000
NODE_6823_length_989_cov_45.902247	47	127	54	1	80	0.0125000
NODE_6823_length_989_cov_45.902247	47	127	56	54	80	0.6750000
NODE_6823_length_989_cov_45.902247	330	410	0	55	80	0.6875000
NODE_6823_length_989_cov_45.902247	330	410	2	25	80	0.3125000
NODE_6823_length_989_cov_45.902247	383	463	0	13	80	0.1625000
NODE_6823_length_989_cov_45.902247	383	463	2	67	80	0.8375000
NODE_6824_length_989_cov_35.430337	412	492	0	27	80	0.3375000
NODE_6824_length_989_cov_35.430337	412	492	4	2	80	0.0250000
NODE_6824_length_989_cov_35.430337	412	492	8	28	80	0.3500000
NODE_6824_length_989_cov_35.430337	412	492	10	1	80	0.0125000
NODE_6824_length_989_cov_35.430337	412	492	12	22	80	0.2750000
NODE_6824_length_989_cov_35.430337	465	545	4	22	80	0.2750000
NODE_6824_length_989_cov_35.430337	465	545	7	1	80	0.0125000
NODE_6824_length_989_cov_35.430337	465	545	8	23	80	0.2875000
NODE_6824_length_989_cov_35.430337	465	545	10	1	80	0.0125000
NODE_6824_length_989_cov_35.430337	465	545	12	33	80	0.4125000
NODE_6825_length_989_cov_30.124719	477	557	0	80	80	1.0000000
NODE_6825_length_989_cov_30.124719	530	610	0	80	80	1.0000000
NODE_6826_length_989_cov_29.347191	447	527	0	80	80	1.0000000
NODE_6826_length_989_cov_29.347191	500	580	0	80	80	1.0000000
NODE_6826_length_989_cov_29.347191	576	656	0	80	80	1.0000000
NODE_6826_length_989_cov_29.347191	629	709	0	80	80	1.0000000
NODE_6827_length_989_cov_27.886517	245	325	2	30	80	0.3750000
NODE_6827_length_989_cov_27.886517	245	325	6	6	80	0.0750000
NODE_6827_length_989_cov_27.886517	245	325	8	44	80	0.5500000
NODE_6827_length_989_cov_27.886517	298	378	4	6	80	0.0750000
NODE_6827_length_989_cov_27.886517	298	378	8	74	80	0.9250000
NODE_6827_length_989_cov_27.886517	374	454	4	57	80	0.7125000
NODE_6827_length_989_cov_27.886517	374	454	6	23	80	0.2875000
NODE_6827_length_989_cov_27.886517	427	507	0	25	80	0.3125000
NODE_6827_length_989_cov_27.886517	427	507	2	11	80	0.1375000
NODE_6827_length_989_cov_27.886517	427	507	4	44	80	0.5500000
NODE_6828_length_989_cov_27.515730	393	473	2	26	80	0.3250000
NODE_6828_length_989_cov_27.515730	393	473	4	54	80	0.6750000
NODE_6828_length_989_cov_27.515730	446	526	0	45	80	0.5625000
NODE_6828_length_989_cov_27.515730	446	526	2	34	80	0.4250000
NODE_6828_length_989_cov_27.515730	446	526	4	1	80	0.0125000
NODE_6828_length_989_cov_27.515730	522	602	0	80	80	1.0000000
NODE_6828_length_989_cov_27.515730	575	655	0	80	80	1.0000000
NODE_6829_length_989_cov_23.844944	312	392	0	46	80	0.5750000
NODE_6829_length_989_cov_23.844944	312	392	4	1	80	0.0125000
NODE_6829_length_989_cov_23.844944	312	392	12	3	80	0.0375000
NODE_6829_length_989_cov_23.844944	312	392	14	30	80	0.3750000
NODE_6829_length_989_cov_23.844944	365	445	12	4	80	0.0500000
NODE_6829_length_989_cov_23.844944	365	445	14	76	80	0.9500000
NODE_6830_length_989_cov_23.131461	475	555	0	80	80	1.0000000
NODE_6830_length_989_cov_23.131461	528	608	0	80	80	1.0000000
NODE_6831_length_989_cov_20.189888	500	580	0	33	80	0.4125000
NODE_6831_length_989_cov_20.189888	500	580	2	47	80	0.5875000
NODE_6831_length_989_cov_20.189888	553	633	0	37	80	0.4625000
NODE_6831_length_989_cov_20.189888	553	633	2	43	80	0.5375000
NODE_6832_length_989_cov_18.429213	190	270	0	76	80	0.9500000
NODE_6832_length_989_cov_18.429213	190	270	2	4	80	0.0500000
NODE_6832_length_989_cov_18.429213	258	323	0	8	65	0.1230769
NODE_6832_length_989_cov_18.429213	258	323	2	14	65	0.2153846
NODE_6832_length_989_cov_18.429213	258	323	4	2	65	0.0307692
NODE_6832_length_989_cov_18.429213	258	323	7	1	65	0.0153846
NODE_6832_length_989_cov_18.429213	258	323	8	40	65	0.6153846
NODE_6832_length_989_cov_18.429213	319	399	8	63	80	0.7875000
NODE_6832_length_989_cov_18.429213	319	399	10	17	80	0.2125000
NODE_6832_length_989_cov_18.429213	372	412	2	1	40	0.0250000
NODE_6832_length_989_cov_18.429213	372	412	6	7	40	0.1750000
NODE_6832_length_989_cov_18.429213	372	412	8	15	40	0.3750000
NODE_6832_length_989_cov_18.429213	372	412	10	17	40	0.4250000
NODE_6833_length_989_cov_10.307865	433	513	0	49	80	0.6125000
NODE_6833_length_989_cov_10.307865	433	513	2	31	80	0.3875000
NODE_6833_length_989_cov_10.307865	486	570	2	84	84	1.0000000
NODE_6833_length_989_cov_10.307865	566	642	0	49	76	0.6447368
NODE_6833_length_989_cov_10.307865	566	642	2	27	76	0.3552631
NODE_6833_length_989_cov_10.307865	615	695	0	39	80	0.4875000
NODE_6833_length_989_cov_10.307865	615	695	2	33	80	0.4125000
NODE_6833_length_989_cov_10.307865	615	695	4	6	80	0.0750000
NODE_6833_length_989_cov_10.307865	615	695	6	2	80	0.0250000
NODE_6834_length_989_cov_8.941573	528	608	0	80	80	1.0000000
NODE_6834_length_989_cov_8.941573	581	661	0	35	80	0.4375000
NODE_6834_length_989_cov_8.941573	581	661	2	45	80	0.5625000
NODE_6835_length_989_cov_5.132584	459	524	0	65	65	1.0000000
NODE_6838_length_989_cov_2.540449	703	783	0	55	80	0.6875000
NODE_6838_length_989_cov_2.540449	703	783	2	25	80	0.3125000
NODE_6845_length_988_cov_52.168729	361	441	0	36	80	0.4500000
NODE_6845_length_988_cov_52.168729	361	441	2	44	80	0.5500000
NODE_6845_length_988_cov_52.168729	414	494	0	80	80	1.0000000
NODE_6845_length_988_cov_52.168729	490	570	0	20	80	0.2500000
NODE_6845_length_988_cov_52.168729	490	570	2	39	80	0.4875000
NODE_6845_length_988_cov_52.168729	490	570	6	21	80	0.2625000
NODE_6845_length_988_cov_52.168729	543	623	0	9	80	0.1125000
NODE_6845_length_988_cov_52.168729	543	623	2	6	80	0.0750000
NODE_6845_length_988_cov_52.168729	543	623	4	5	80	0.0625000
NODE_6845_length_988_cov_52.168729	543	623	6	60	80	0.7500000
NODE_6846_length_988_cov_36.733408	390	470	0	8	80	0.1000000
NODE_6846_length_988_cov_36.733408	390	470	2	72	80	0.9000000
NODE_6846_length_988_cov_36.733408	443	523	0	2	80	0.0250000
NODE_6846_length_988_cov_36.733408	443	523	2	59	80	0.7375000
NODE_6846_length_988_cov_36.733408	443	523	4	19	80	0.2375000
NODE_6847_length_988_cov_36.221597	478	558	0	34	80	0.4250000
NODE_6847_length_988_cov_36.221597	478	558	4	38	80	0.4750000
NODE_6847_length_988_cov_36.221597	478	558	8	8	80	0.1000000
NODE_6847_length_988_cov_36.221597	531	611	4	39	80	0.4875000
NODE_6847_length_988_cov_36.221597	531	611	6	26	80	0.3250000
NODE_6847_length_988_cov_36.221597	531	611	8	15	80	0.1875000
NODE_6848_length_988_cov_25.895388	389	469	0	12	80	0.1500000
NODE_6848_length_988_cov_25.895388	389	469	2	68	80	0.8500000
NODE_6848_length_988_cov_25.895388	442	522	0	54	80	0.6750000
NODE_6848_length_988_cov_25.895388	442	522	2	26	80	0.3250000
NODE_6848_length_988_cov_25.895388	518	598	0	80	80	1.0000000
NODE_6848_length_988_cov_25.895388	571	651	0	80	80	1.0000000
NODE_6849_length_988_cov_20.250844	423	503	6	9	80	0.1125000
NODE_6849_length_988_cov_20.250844	423	503	8	5	80	0.0625000
NODE_6849_length_988_cov_20.250844	423	503	10	35	80	0.4375000
NODE_6849_length_988_cov_20.250844	423	503	12	12	80	0.1500000
NODE_6849_length_988_cov_20.250844	423	503	13	6	80	0.0750000
NODE_6849_length_988_cov_20.250844	423	503	15	7	80	0.0875000
NODE_6849_length_988_cov_20.250844	423	503	16	6	80	0.0750000
NODE_6849_length_988_cov_20.250844	476	556	4	3	80	0.0375000
NODE_6849_length_988_cov_20.250844	476	556	6	3	80	0.0375000
NODE_6849_length_988_cov_20.250844	476	556	8	8	80	0.1000000
NODE_6849_length_988_cov_20.250844	476	556	10	51	80	0.6375000
NODE_6849_length_988_cov_20.250844	476	556	13	2	80	0.0250000
NODE_6849_length_988_cov_20.250844	476	556	15	7	80	0.0875000
NODE_6849_length_988_cov_20.250844	476	556	16	6	80	0.0750000
NODE_6850_length_988_cov_15.812148	474	554	0	21	80	0.2625000
NODE_6850_length_988_cov_15.812148	474	554	4	21	80	0.2625000
NODE_6850_length_988_cov_15.812148	474	554	6	31	80	0.3875000
NODE_6850_length_988_cov_15.812148	474	554	8	7	80	0.0875000
NODE_6850_length_988_cov_15.812148	527	607	2	12	80	0.1500000
NODE_6850_length_988_cov_15.812148	527	607	4	4	80	0.0500000
NODE_6850_length_988_cov_15.812148	527	607	6	57	80	0.7125000
NODE_6850_length_988_cov_15.812148	527	607	8	7	80	0.0875000
NODE_6851_length_988_cov_15.082115	435	517	3	32	82	0.3902439
NODE_6851_length_988_cov_15.082115	435	517	4	50	82	0.6097561
NODE_6851_length_988_cov_15.082115	490	570	0	16	80	0.2000000
NODE_6851_length_988_cov_15.082115	490	570	3	64	80	0.8000000
NODE_6852_length_988_cov_14.697413	467	547	3	80	80	1.0000000
NODE_6852_length_988_cov_14.697413	520	600	0	42	80	0.5250000
NODE_6852_length_988_cov_14.697413	520	600	2	9	80	0.1125000
NODE_6852_length_988_cov_14.697413	520	600	3	29	80	0.3625000
NODE_6853_length_988_cov_7.730034	562	642	0	35	80	0.4375000
NODE_6853_length_988_cov_7.730034	562	642	2	45	80	0.5625000
NODE_6853_length_988_cov_7.730034	615	695	0	19	80	0.2375000
NODE_6853_length_988_cov_7.730034	615	695	2	61	80	0.7625000
NODE_6862_length_987_cov_42.784910	383	476	0	87	93	0.9354839
NODE_6862_length_987_cov_42.784910	383	476	2	6	93	0.0645161
NODE_6862_length_987_cov_42.784910	449	529	0	21	80	0.2625000
NODE_6862_length_987_cov_42.784910	449	529	2	59	80	0.7375000
NODE_6863_length_987_cov_39.716216	290	370	0	2	80	0.0250000
NODE_6863_length_987_cov_39.716216	290	370	4	78	80	0.9750000
NODE_6863_length_987_cov_39.716216	343	423	0	55	80	0.6875000
NODE_6863_length_987_cov_39.716216	343	423	4	25	80	0.3125000
NODE_6863_length_987_cov_39.716216	419	499	0	39	80	0.4875000
NODE_6863_length_987_cov_39.716216	419	499	2	35	80	0.4375000
NODE_6863_length_987_cov_39.716216	419	499	4	6	80	0.0750000
NODE_6863_length_987_cov_39.716216	472	552	2	24	80	0.3000000
NODE_6863_length_987_cov_39.716216	472	552	4	56	80	0.7000000
NODE_6864_length_987_cov_28.171171	406	486	2	29	80	0.3625000
NODE_6864_length_987_cov_28.171171	406	486	4	51	80	0.6375000
NODE_6864_length_987_cov_28.171171	459	539	0	22	80	0.2750000
NODE_6864_length_987_cov_28.171171	459	539	2	58	80	0.7250000
NODE_6864_length_987_cov_28.171171	535	615	0	22	80	0.2750000
NODE_6864_length_987_cov_28.171171	535	615	2	26	80	0.3250000
NODE_6864_length_987_cov_28.171171	535	615	4	32	80	0.4000000
NODE_6864_length_987_cov_28.171171	588	668	0	3	80	0.0375000
NODE_6864_length_987_cov_28.171171	588	668	2	2	80	0.0250000
NODE_6864_length_987_cov_28.171171	588	668	4	75	80	0.9375000
NODE_6865_length_987_cov_23.627252	331	411	0	18	80	0.2250000
NODE_6865_length_987_cov_23.627252	331	411	2	62	80	0.7750000
NODE_6865_length_987_cov_23.627252	384	464	0	71	80	0.8875000
NODE_6865_length_987_cov_23.627252	384	464	2	9	80	0.1125000
NODE_6866_length_987_cov_18.797297	437	517	4	80	80	1.0000000
NODE_6866_length_987_cov_18.797297	490	570	0	27	80	0.3375000
NODE_6866_length_987_cov_18.797297	490	570	4	53	80	0.6625000
NODE_6867_length_987_cov_15.628378	369	449	0	21	80	0.2625000
NODE_6867_length_987_cov_15.628378	369	449	13	1	80	0.0125000
NODE_6867_length_987_cov_15.628378	369	449	14	1	80	0.0125000
NODE_6867_length_987_cov_15.628378	369	449	15	57	80	0.7125000
NODE_6867_length_987_cov_15.628378	422	502	2	2	80	0.0250000
NODE_6867_length_987_cov_15.628378	422	502	14	24	80	0.3000000
NODE_6867_length_987_cov_15.628378	422	502	15	54	80	0.6750000
NODE_6868_length_987_cov_15.439189	438	518	0	41	80	0.5125000
NODE_6868_length_987_cov_15.439189	438	518	4	39	80	0.4875000
NODE_6868_length_987_cov_15.439189	491	571	0	10	80	0.1250000
NODE_6868_length_987_cov_15.439189	491	571	4	70	80	0.8750000
NODE_6869_length_987_cov_14.343468	506	586	0	24	80	0.3000000
NODE_6869_length_987_cov_14.343468	506	586	2	56	80	0.7000000
NODE_6869_length_987_cov_14.343468	559	639	0	77	80	0.9625000
NODE_6869_length_987_cov_14.343468	559	639	2	3	80	0.0375000
NODE_6870_length_987_cov_13.515766	475	555	0	49	80	0.6125000
NODE_6870_length_987_cov_13.515766	475	555	2	31	80	0.3875000
NODE_6870_length_987_cov_13.515766	528	608	0	21	80	0.2625000
NODE_6870_length_987_cov_13.515766	528	608	2	59	80	0.7375000
NODE_6871_length_987_cov_9.521396	408	482	0	74	74	1.0000000
NODE_6871_length_987_cov_9.521396	455	535	0	80	80	1.0000000
NODE_6872_length_987_cov_9.054054	440	520	0	33	80	0.4125000
NODE_6872_length_987_cov_9.054054	440	520	2	46	80	0.5750000
NODE_6872_length_987_cov_9.054054	440	520	4	1	80	0.0125000
NODE_6872_length_987_cov_9.054054	493	573	2	50	80	0.6250000
NODE_6872_length_987_cov_9.054054	493	573	4	30	80	0.3750000
NODE_6875_length_987_cov_5.378378	509	589	0	50	80	0.6250000
NODE_6875_length_987_cov_5.378378	509	589	2	30	80	0.3750000
NODE_6875_length_987_cov_5.378378	562	642	0	80	80	1.0000000
NODE_6889_length_986_cov_36.937993	327	407	0	20	80	0.2500000
NODE_6889_length_986_cov_36.937993	327	407	4	60	80	0.7500000
NODE_6889_length_986_cov_36.937993	380	460	0	73	80	0.9125000
NODE_6889_length_986_cov_36.937993	380	460	4	7	80	0.0875000
NODE_6889_length_986_cov_36.937993	456	536	0	77	80	0.9625000
NODE_6889_length_986_cov_36.937993	456	536	2	3	80	0.0375000
NODE_6889_length_986_cov_36.937993	509	589	0	24	80	0.3000000
NODE_6889_length_986_cov_36.937993	509	589	2	56	80	0.7000000
NODE_6890_length_986_cov_35.130778	325	405	0	3	80	0.0375000
NODE_6890_length_986_cov_35.130778	325	405	2	1	80	0.0125000
NODE_6890_length_986_cov_35.130778	325	405	6	76	80	0.9500000
NODE_6890_length_986_cov_35.130778	378	458	0	56	80	0.7000000
NODE_6890_length_986_cov_35.130778	378	458	2	1	80	0.0125000
NODE_6890_length_986_cov_35.130778	378	458	6	23	80	0.2875000
NODE_6890_length_986_cov_35.130778	454	534	0	80	80	1.0000000
NODE_6890_length_986_cov_35.130778	507	587	0	80	80	1.0000000
NODE_6891_length_986_cov_24.037204	602	682	0	80	80	1.0000000
NODE_6891_length_986_cov_24.037204	655	735	0	36	80	0.4500000
NODE_6891_length_986_cov_24.037204	655	735	2	44	80	0.5500000
NODE_6891_length_986_cov_24.037204	731	811	2	42	80	0.5250000
NODE_6891_length_986_cov_24.037204	731	811	4	38	80	0.4750000
NODE_6891_length_986_cov_24.037204	784	864	1	3	80	0.0375000
NODE_6891_length_986_cov_24.037204	784	864	2	64	80	0.8000000
NODE_6891_length_986_cov_24.037204	784	864	3	1	80	0.0125000
NODE_6891_length_986_cov_24.037204	784	864	4	12	80	0.1500000
NODE_6892_length_986_cov_20.591883	395	475	0	80	80	1.0000000
NODE_6892_length_986_cov_20.591883	448	528	0	41	80	0.5125000
NODE_6892_length_986_cov_20.591883	448	528	4	6	80	0.0750000
NODE_6892_length_986_cov_20.591883	448	528	6	33	80	0.4125000
NODE_6893_length_986_cov_16.815107	389	469	7	7	80	0.0875000
NODE_6893_length_986_cov_16.815107	389	469	8	6	80	0.0750000
NODE_6893_length_986_cov_16.815107	389	469	11	1	80	0.0125000
NODE_6893_length_986_cov_16.815107	389	469	12	9	80	0.1125000
NODE_6893_length_986_cov_16.815107	389	469	14	57	80	0.7125000
NODE_6893_length_986_cov_16.815107	442	522	0	35	80	0.4375000
NODE_6893_length_986_cov_16.815107	442	522	2	4	80	0.0500000
NODE_6893_length_986_cov_16.815107	442	522	3	10	80	0.1250000
NODE_6893_length_986_cov_16.815107	442	522	7	11	80	0.1375000
NODE_6893_length_986_cov_16.815107	442	522	8	6	80	0.0750000
NODE_6893_length_986_cov_16.815107	442	522	11	1	80	0.0125000
NODE_6893_length_986_cov_16.815107	442	522	12	4	80	0.0500000
NODE_6893_length_986_cov_16.815107	442	522	14	9	80	0.1125000
NODE_6894_length_986_cov_11.021421	474	554	2	80	80	1.0000000
NODE_6894_length_986_cov_11.021421	527	607	0	53	80	0.6625000
NODE_6894_length_986_cov_11.021421	527	607	2	27	80	0.3375000
NODE_6905_length_985_cov_41.707675	443	523	0	80	80	1.0000000
NODE_6905_length_985_cov_41.707675	496	576	0	80	80	1.0000000
NODE_6911_length_984_cov_64.531073	412	481	0	69	69	1.0000000
NODE_6911_length_984_cov_64.531073	454	534	0	42	80	0.5250000
NODE_6911_length_984_cov_64.531073	454	534	4	38	80	0.4750000
NODE_6911_length_984_cov_64.531073	475	555	0	21	80	0.2625000
NODE_6911_length_984_cov_64.531073	475	555	4	59	80	0.7375000
NODE_6911_length_984_cov_64.531073	528	608	4	62	80	0.7750000
NODE_6911_length_984_cov_64.531073	528	608	7	1	80	0.0125000
NODE_6911_length_984_cov_64.531073	528	608	8	17	80	0.2125000
NODE_6911_length_984_cov_64.531073	549	629	4	62	80	0.7750000
NODE_6911_length_984_cov_64.531073	549	629	7	1	80	0.0125000
NODE_6911_length_984_cov_64.531073	549	629	8	17	80	0.2125000
NODE_6912_length_984_cov_28.832768	430	510	0	71	80	0.8875000
NODE_6912_length_984_cov_28.832768	430	510	2	9	80	0.1125000
NODE_6912_length_984_cov_28.832768	483	563	0	18	80	0.2250000
NODE_6912_length_984_cov_28.832768	483	563	2	62	80	0.7750000
NODE_6913_length_984_cov_27.247458	203	283	0	67	80	0.8375000
NODE_6913_length_984_cov_27.247458	203	283	2	13	80	0.1625000
NODE_6913_length_984_cov_27.247458	256	336	0	80	80	1.0000000
NODE_6913_length_984_cov_27.247458	332	412	0	17	80	0.2125000
NODE_6913_length_984_cov_27.247458	332	412	2	5	80	0.0625000
NODE_6913_length_984_cov_27.247458	332	412	4	58	80	0.7250000
NODE_6913_length_984_cov_27.247458	385	465	2	32	80	0.4000000
NODE_6913_length_984_cov_27.247458	385	465	4	48	80	0.6000000
NODE_6914_length_984_cov_25.944633	483	563	0	66	80	0.8250000
NODE_6914_length_984_cov_25.944633	483	563	2	14	80	0.1750000
NODE_6914_length_984_cov_25.944633	536	616	0	23	80	0.2875000
NODE_6914_length_984_cov_25.944633	536	616	2	57	80	0.7125000
NODE_6915_length_984_cov_16.611299	351	431	8	17	80	0.2125000
NODE_6915_length_984_cov_16.611299	351	431	12	3	80	0.0375000
NODE_6915_length_984_cov_16.611299	351	431	13	1	80	0.0125000
NODE_6915_length_984_cov_16.611299	351	431	19	53	80	0.6625000
NODE_6915_length_984_cov_16.611299	351	431	21	6	80	0.0750000
NODE_6915_length_984_cov_16.611299	404	484	0	6	80	0.0750000
NODE_6915_length_984_cov_16.611299	404	484	2	29	80	0.3625000
NODE_6915_length_984_cov_16.611299	404	484	8	35	80	0.4375000
NODE_6915_length_984_cov_16.611299	404	484	12	3	80	0.0375000
NODE_6915_length_984_cov_16.611299	404	484	13	1	80	0.0125000
NODE_6915_length_984_cov_16.611299	404	484	21	6	80	0.0750000
NODE_6917_length_984_cov_6.414689	415	495	0	40	80	0.5000000
NODE_6917_length_984_cov_6.414689	415	495	2	40	80	0.5000000
NODE_6917_length_984_cov_6.414689	468	548	0	32	80	0.4000000
NODE_6917_length_984_cov_6.414689	468	548	2	48	80	0.6000000
NODE_6918_length_984_cov_4.720904	494	574	0	80	80	1.0000000
NODE_6918_length_984_cov_4.720904	547	627	0	80	80	1.0000000
NODE_6927_length_984_cov_1.333333	922	971	4	33	49	0.6734694
NODE_6927_length_984_cov_1.333333	922	971	5	16	49	0.3265306
NODE_6931_length_983_cov_34.566742	466	546	4	9	80	0.1125000
NODE_6931_length_983_cov_34.566742	466	546	8	15	80	0.1875000
NODE_6931_length_983_cov_34.566742	466	546	10	22	80	0.2750000
NODE_6931_length_983_cov_34.566742	466	546	14	34	80	0.4250000
NODE_6931_length_983_cov_34.566742	519	599	4	11	80	0.1375000
NODE_6931_length_983_cov_34.566742	519	599	7	2	80	0.0250000
NODE_6931_length_983_cov_34.566742	519	599	8	11	80	0.1375000
NODE_6931_length_983_cov_34.566742	519	599	10	30	80	0.3750000
NODE_6931_length_983_cov_34.566742	519	599	14	26	80	0.3250000
NODE_6932_length_983_cov_26.011312	449	529	0	80	80	1.0000000
NODE_6932_length_983_cov_26.011312	502	582	0	80	80	1.0000000
NODE_6932_length_983_cov_26.011312	578	658	0	80	80	1.0000000
NODE_6932_length_983_cov_26.011312	631	711	0	80	80	1.0000000
NODE_6933_length_983_cov_24.694570	539	619	0	19	80	0.2375000
NODE_6933_length_983_cov_24.694570	539	619	4	11	80	0.1375000
NODE_6933_length_983_cov_24.694570	539	619	5	2	80	0.0250000
NODE_6933_length_983_cov_24.694570	539	619	8	48	80	0.6000000
NODE_6933_length_983_cov_24.694570	592	672	0	21	80	0.2625000
NODE_6933_length_983_cov_24.694570	592	672	4	5	80	0.0625000
NODE_6933_length_983_cov_24.694570	592	672	8	54	80	0.6750000
NODE_6934_length_983_cov_22.214932	395	475	0	63	80	0.7875000
NODE_6934_length_983_cov_22.214932	395	475	2	17	80	0.2125000
NODE_6934_length_983_cov_22.214932	448	528	0	28	80	0.3500000
NODE_6934_length_983_cov_22.214932	448	528	2	52	80	0.6500000
NODE_6935_length_983_cov_19.132353	377	457	0	80	80	1.0000000
NODE_6935_length_983_cov_19.132353	430	510	0	80	80	1.0000000
NODE_6936_length_983_cov_16.875566	419	499	4	62	80	0.7750000
NODE_6936_length_983_cov_16.875566	419	499	6	18	80	0.2250000
NODE_6936_length_983_cov_16.875566	472	552	2	21	80	0.2625000
NODE_6936_length_983_cov_16.875566	472	552	4	30	80	0.3750000
NODE_6936_length_983_cov_16.875566	472	552	6	29	80	0.3625000
NODE_6936_length_983_cov_16.875566	548	628	2	46	80	0.5750000
NODE_6936_length_983_cov_16.875566	548	628	4	34	80	0.4250000
NODE_6936_length_983_cov_16.875566	601	681	0	49	80	0.6125000
NODE_6936_length_983_cov_16.875566	601	681	2	31	80	0.3875000
NODE_6937_length_983_cov_7.240950	487	567	0	80	80	1.0000000
NODE_6937_length_983_cov_7.240950	540	620	0	80	80	1.0000000
NODE_6949_length_982_cov_30.750849	357	437	2	25	80	0.3125000
NODE_6949_length_982_cov_30.750849	357	437	6	43	80	0.5375000
NODE_6949_length_982_cov_30.750849	357	437	8	12	80	0.1500000
NODE_6949_length_982_cov_30.750849	410	490	0	50	80	0.6250000
NODE_6949_length_982_cov_30.750849	410	490	2	28	80	0.3500000
NODE_6949_length_982_cov_30.750849	410	490	6	2	80	0.0250000
NODE_6950_length_982_cov_29.901472	516	596	0	80	80	1.0000000
NODE_6950_length_982_cov_29.901472	569	649	0	80	80	1.0000000
NODE_6951_length_982_cov_18.251416	356	436	0	21	80	0.2625000
NODE_6951_length_982_cov_18.251416	356	436	2	18	80	0.2250000
NODE_6951_length_982_cov_18.251416	356	436	4	24	80	0.3000000
NODE_6951_length_982_cov_18.251416	356	436	6	17	80	0.2125000
NODE_6951_length_982_cov_18.251416	409	489	0	74	80	0.9250000
NODE_6951_length_982_cov_18.251416	409	489	2	6	80	0.0750000
NODE_6951_length_982_cov_18.251416	485	565	0	15	80	0.1875000
NODE_6951_length_982_cov_18.251416	485	565	8	65	80	0.8125000
NODE_6951_length_982_cov_18.251416	538	618	8	32	80	0.4000000
NODE_6951_length_982_cov_18.251416	538	618	12	48	80	0.6000000
NODE_6952_length_982_cov_13.840317	608	688	0	14	80	0.1750000
NODE_6952_length_982_cov_13.840317	608	688	4	66	80	0.8250000
NODE_6952_length_982_cov_13.840317	661	741	0	33	80	0.4125000
NODE_6952_length_982_cov_13.840317	661	741	3	1	80	0.0125000
NODE_6952_length_982_cov_13.840317	661	741	4	46	80	0.5750000
NODE_6953_length_982_cov_13.227633	317	397	8	19	80	0.2375000
NODE_6953_length_982_cov_13.227633	317	397	9	26	80	0.3250000
NODE_6953_length_982_cov_13.227633	317	397	12	1	80	0.0125000
NODE_6953_length_982_cov_13.227633	317	397	13	24	80	0.3000000
NODE_6953_length_982_cov_13.227633	317	397	14	10	80	0.1250000
NODE_6953_length_982_cov_13.227633	370	450	3	17	80	0.2125000
NODE_6953_length_982_cov_13.227633	370	450	5	1	80	0.0125000
NODE_6953_length_982_cov_13.227633	370	450	12	36	80	0.4500000
NODE_6953_length_982_cov_13.227633	370	450	13	24	80	0.3000000
NODE_6953_length_982_cov_13.227633	370	450	14	2	80	0.0250000
NODE_6954_length_982_cov_10.918460	209	289	0	80	80	1.0000000
NODE_6954_length_982_cov_10.918460	262	342	0	80	80	1.0000000
NODE_6956_length_982_cov_7.210646	216	296	0	80	80	1.0000000
NODE_6956_length_982_cov_7.210646	269	349	0	80	80	1.0000000
NODE_6973_length_981_cov_55.260771	410	490	0	31	80	0.3875000
NODE_6973_length_981_cov_55.260771	410	490	4	49	80	0.6125000
NODE_6973_length_981_cov_55.260771	463	543	0	80	80	1.0000000
NODE_6973_length_981_cov_55.260771	539	619	0	80	80	1.0000000
NODE_6973_length_981_cov_55.260771	592	672	0	80	80	1.0000000
NODE_6974_length_981_cov_33.287982	362	441	0	79	79	1.0000000
NODE_6974_length_981_cov_33.287982	414	495	0	81	81	1.0000000
NODE_6974_length_981_cov_33.287982	491	571	0	80	80	1.0000000
NODE_6974_length_981_cov_33.287982	544	624	0	80	80	1.0000000
NODE_6975_length_981_cov_33.121315	269	349	0	80	80	1.0000000
NODE_6975_length_981_cov_33.121315	322	402	0	80	80	1.0000000
NODE_6975_length_981_cov_33.121315	398	478	0	38	80	0.4750000
NODE_6975_length_981_cov_33.121315	398	478	6	42	80	0.5250000
NODE_6975_length_981_cov_33.121315	451	531	0	16	80	0.2000000
NODE_6975_length_981_cov_33.121315	451	531	6	64	80	0.8000000
NODE_6976_length_981_cov_26.732426	397	477	0	26	80	0.3250000
NODE_6976_length_981_cov_26.732426	397	477	4	19	80	0.2375000
NODE_6976_length_981_cov_26.732426	397	477	6	35	80	0.4375000
NODE_6976_length_981_cov_26.732426	450	530	4	24	80	0.3000000
NODE_6976_length_981_cov_26.732426	450	530	6	56	80	0.7000000
NODE_6977_length_981_cov_24.304989	390	470	0	50	80	0.6250000
NODE_6977_length_981_cov_24.304989	390	470	8	30	80	0.3750000
NODE_6977_length_981_cov_24.304989	443	523	0	10	80	0.1250000
NODE_6977_length_981_cov_24.304989	443	523	8	70	80	0.8750000
NODE_6978_length_981_cov_10.485261	363	443	0	80	80	1.0000000
NODE_6978_length_981_cov_10.485261	416	496	0	80	80	1.0000000
NODE_6980_length_981_cov_5.328798	821	885	2	1	64	0.0156250
NODE_6980_length_981_cov_5.328798	821	885	6	25	64	0.3906250
NODE_6980_length_981_cov_5.328798	821	885	8	10	64	0.1562500
NODE_6980_length_981_cov_5.328798	821	885	10	4	64	0.0625000
NODE_6980_length_981_cov_5.328798	821	885	12	24	64	0.3750000
NODE_6980_length_981_cov_5.328798	847	884	6	25	37	0.6756757
NODE_6980_length_981_cov_5.328798	847	884	8	10	37	0.2702703
NODE_6980_length_981_cov_5.328798	847	884	10	2	37	0.0540541
NODE_6998_length_980_cov_40.710556	329	409	4	80	80	1.0000000
NODE_6998_length_980_cov_40.710556	382	462	0	22	80	0.2750000
NODE_6998_length_980_cov_40.710556	382	462	4	58	80	0.7250000
NODE_6998_length_980_cov_40.710556	458	538	0	80	80	1.0000000
NODE_6998_length_980_cov_40.710556	511	591	0	80	80	1.0000000
NODE_6999_length_980_cov_37.634506	666	746	0	80	80	1.0000000
NODE_6999_length_980_cov_37.634506	719	799	0	80	80	1.0000000
NODE_7000_length_980_cov_36.261067	331	411	13	26	80	0.3250000
NODE_7000_length_980_cov_36.261067	331	411	15	20	80	0.2500000
NODE_7000_length_980_cov_36.261067	331	411	17	16	80	0.2000000
NODE_7000_length_980_cov_36.261067	331	411	18	16	80	0.2000000
NODE_7000_length_980_cov_36.261067	331	411	19	2	80	0.0250000
NODE_7000_length_980_cov_36.261067	384	453	0	18	69	0.2608696
NODE_7000_length_980_cov_36.261067	384	453	11	10	69	0.1449275
NODE_7000_length_980_cov_36.261067	384	453	13	40	69	0.5797101
NODE_7000_length_980_cov_36.261067	384	453	15	1	69	0.0144928
NODE_7000_length_980_cov_36.261067	465	545	0	23	80	0.2875000
NODE_7000_length_980_cov_36.261067	465	545	4	57	80	0.7125000
NODE_7000_length_980_cov_36.261067	518	598	0	21	80	0.2625000
NODE_7000_length_980_cov_36.261067	518	598	4	59	80	0.7375000
NODE_7001_length_980_cov_28.514188	430	510	0	80	80	1.0000000
NODE_7001_length_980_cov_28.514188	483	563	0	80	80	1.0000000
NODE_7002_length_980_cov_25.205448	497	577	0	80	80	1.0000000
NODE_7002_length_980_cov_25.205448	550	630	0	80	80	1.0000000
NODE_7003_length_980_cov_24.321226	417	497	0	80	80	1.0000000
NODE_7003_length_980_cov_24.321226	470	550	0	80	80	1.0000000
NODE_7004_length_980_cov_20.460840	388	468	0	36	80	0.4500000
NODE_7004_length_980_cov_20.460840	388	468	2	7	80	0.0875000
NODE_7004_length_980_cov_20.460840	388	468	4	25	80	0.3125000
NODE_7004_length_980_cov_20.460840	388	468	8	12	80	0.1500000
NODE_7004_length_980_cov_20.460840	441	521	4	30	80	0.3750000
NODE_7004_length_980_cov_20.460840	441	521	6	6	80	0.0750000
NODE_7004_length_980_cov_20.460840	441	521	8	44	80	0.5500000
NODE_7005_length_980_cov_19.969353	486	566	0	39	80	0.4875000
NODE_7005_length_980_cov_19.969353	486	566	2	41	80	0.5125000
NODE_7005_length_980_cov_19.969353	539	619	0	80	80	1.0000000
NODE_7006_length_980_cov_13.736663	350	430	0	8	80	0.1000000
NODE_7006_length_980_cov_13.736663	350	430	2	72	80	0.9000000
NODE_7006_length_980_cov_13.736663	403	483	0	40	80	0.5000000
NODE_7006_length_980_cov_13.736663	403	483	2	40	80	0.5000000
NODE_7006_length_980_cov_13.736663	479	559	0	80	80	1.0000000
NODE_7006_length_980_cov_13.736663	532	612	0	80	80	1.0000000
NODE_7008_length_980_cov_10.842225	517	597	4	32	80	0.4000000
NODE_7008_length_980_cov_10.842225	517	597	6	48	80	0.6000000
NODE_7008_length_980_cov_10.842225	570	650	0	24	80	0.3000000
NODE_7008_length_980_cov_10.842225	570	650	2	27	80	0.3375000
NODE_7008_length_980_cov_10.842225	570	650	6	29	80	0.3625000
NODE_7009_length_980_cov_10.087401	341	424	0	2	83	0.0240964
NODE_7009_length_980_cov_10.087401	341	424	2	3	83	0.0361446
NODE_7009_length_980_cov_10.087401	341	424	6	1	83	0.0120482
NODE_7009_length_980_cov_10.087401	341	424	7	8	83	0.0963855
NODE_7009_length_980_cov_10.087401	341	424	9	13	83	0.1566265
NODE_7009_length_980_cov_10.087401	341	424	10	56	83	0.6746988
NODE_7009_length_980_cov_10.087401	397	477	0	45	80	0.5625000
NODE_7009_length_980_cov_10.087401	397	477	2	11	80	0.1375000
NODE_7009_length_980_cov_10.087401	397	477	10	24	80	0.3000000
NODE_7010_length_980_cov_9.643587	267	347	0	80	80	1.0000000
NODE_7010_length_980_cov_9.643587	320	400	0	80	80	1.0000000
NODE_7010_length_980_cov_9.643587	396	476	0	47	80	0.5875000
NODE_7010_length_980_cov_9.643587	396	476	2	18	80	0.2250000
NODE_7010_length_980_cov_9.643587	396	476	4	15	80	0.1875000
NODE_7010_length_980_cov_9.643587	449	529	2	15	80	0.1875000
NODE_7010_length_980_cov_9.643587	449	529	4	65	80	0.8125000
NODE_7026_length_979_cov_22.576136	442	522	0	4	80	0.0500000
NODE_7026_length_979_cov_22.576136	442	522	2	76	80	0.9500000
NODE_7026_length_979_cov_22.576136	495	575	0	36	80	0.4500000
NODE_7026_length_979_cov_22.576136	495	575	1	12	80	0.1500000
NODE_7026_length_979_cov_22.576136	495	575	2	32	80	0.4000000
NODE_7027_length_979_cov_19.739773	445	524	0	79	79	1.0000000
NODE_7027_length_979_cov_19.739773	497	577	0	80	80	1.0000000
NODE_7028_length_979_cov_19.480682	436	516	0	61	80	0.7625000
NODE_7028_length_979_cov_19.480682	436	516	2	19	80	0.2375000
NODE_7028_length_979_cov_19.480682	489	569	0	80	80	1.0000000
NODE_7028_length_979_cov_19.480682	565	645	0	59	80	0.7375000
NODE_7028_length_979_cov_19.480682	565	645	2	21	80	0.2625000
NODE_7028_length_979_cov_19.480682	618	698	0	8	80	0.1000000
NODE_7028_length_979_cov_19.480682	618	698	2	72	80	0.9000000
NODE_7029_length_979_cov_18.901136	470	550	0	80	80	1.0000000
NODE_7029_length_979_cov_18.901136	523	603	0	80	80	1.0000000
NODE_7031_length_979_cov_3.519318	101	168	2	27	67	0.4029851
NODE_7031_length_979_cov_3.519318	101	168	4	18	67	0.2686567
NODE_7031_length_979_cov_3.519318	101	168	8	22	67	0.3283582
NODE_7040_length_978_cov_23.195677	424	504	0	21	80	0.2625000
NODE_7040_length_978_cov_23.195677	424	504	2	59	80	0.7375000
NODE_7040_length_978_cov_23.195677	477	557	2	80	80	1.0000000
NODE_7041_length_978_cov_18.866894	440	520	11	13	80	0.1625000
NODE_7041_length_978_cov_18.866894	440	520	12	22	80	0.2750000
NODE_7041_length_978_cov_18.866894	440	520	13	3	80	0.0375000
NODE_7041_length_978_cov_18.866894	440	520	15	6	80	0.0750000
NODE_7041_length_978_cov_18.866894	440	520	16	6	80	0.0750000
NODE_7041_length_978_cov_18.866894	440	520	17	14	80	0.1750000
NODE_7041_length_978_cov_18.866894	440	520	19	16	80	0.2000000
NODE_7041_length_978_cov_18.866894	493	573	8	19	80	0.2375000
NODE_7041_length_978_cov_18.866894	493	573	15	6	80	0.0750000
NODE_7041_length_978_cov_18.866894	493	573	16	7	80	0.0875000
NODE_7041_length_978_cov_18.866894	493	573	17	47	80	0.5875000
NODE_7041_length_978_cov_18.866894	493	573	19	1	80	0.0125000
NODE_7042_length_978_cov_15.614334	341	421	6	80	80	1.0000000
NODE_7042_length_978_cov_15.614334	394	474	0	20	80	0.2500000
NODE_7042_length_978_cov_15.614334	394	474	2	12	80	0.1500000
NODE_7042_length_978_cov_15.614334	394	474	3	2	80	0.0250000
NODE_7042_length_978_cov_15.614334	394	474	4	1	80	0.0125000
NODE_7042_length_978_cov_15.614334	394	474	6	45	80	0.5625000
NODE_7042_length_978_cov_15.614334	470	550	0	6	80	0.0750000
NODE_7042_length_978_cov_15.614334	470	550	2	74	80	0.9250000
NODE_7042_length_978_cov_15.614334	523	603	0	49	80	0.6125000
NODE_7042_length_978_cov_15.614334	523	603	2	31	80	0.3875000
NODE_7043_length_978_cov_15.253697	327	407	0	80	80	1.0000000
NODE_7043_length_978_cov_15.253697	380	460	0	80	80	1.0000000
NODE_7043_length_978_cov_15.253697	456	536	0	80	80	1.0000000
NODE_7043_length_978_cov_15.253697	509	589	0	80	80	1.0000000
NODE_7044_length_978_cov_14.730375	407	487	0	7	80	0.0875000
NODE_7044_length_978_cov_14.730375	407	487	2	73	80	0.9125000
NODE_7044_length_978_cov_14.730375	460	540	0	60	80	0.7500000
NODE_7044_length_978_cov_14.730375	460	540	2	20	80	0.2500000
NODE_7045_length_978_cov_7.257110	571	651	0	80	80	1.0000000
NODE_7045_length_978_cov_7.257110	624	704	0	80	80	1.0000000
NODE_7062_length_977_cov_47.484055	427	507	0	80	80	1.0000000
NODE_7062_length_977_cov_47.484055	480	560	0	80	80	1.0000000
NODE_7063_length_977_cov_47.116173	428	508	0	2	80	0.0250000
NODE_7063_length_977_cov_47.116173	428	508	10	61	80	0.7625000
NODE_7063_length_977_cov_47.116173	428	508	12	17	80	0.2125000
NODE_7063_length_977_cov_47.116173	481	561	2	11	80	0.1375000
NODE_7063_length_977_cov_47.116173	481	561	10	10	80	0.1250000
NODE_7063_length_977_cov_47.116173	481	561	12	59	80	0.7375000
NODE_7063_length_977_cov_47.116173	557	637	0	53	80	0.6625000
NODE_7063_length_977_cov_47.116173	557	637	2	27	80	0.3375000
NODE_7063_length_977_cov_47.116173	610	690	0	80	80	1.0000000
NODE_7064_length_977_cov_32.542141	486	566	0	19	80	0.2375000
NODE_7064_length_977_cov_32.542141	486	566	10	61	80	0.7625000
NODE_7064_length_977_cov_32.542141	539	619	0	29	80	0.3625000
NODE_7064_length_977_cov_32.542141	539	619	4	13	80	0.1625000
NODE_7064_length_977_cov_32.542141	539	619	10	38	80	0.4750000
NODE_7065_length_977_cov_30.676538	361	441	0	80	80	1.0000000
NODE_7065_length_977_cov_30.676538	414	494	0	80	80	1.0000000
NODE_7066_length_977_cov_28.348519	455	535	0	33	80	0.4125000
NODE_7066_length_977_cov_28.348519	455	535	2	47	80	0.5875000
NODE_7066_length_977_cov_28.348519	508	588	0	21	80	0.2625000
NODE_7066_length_977_cov_28.348519	508	588	1	8	80	0.1000000
NODE_7066_length_977_cov_28.348519	508	588	2	51	80	0.6375000
NODE_7067_length_977_cov_26.571754	343	423	24	40	80	0.5000000
NODE_7067_length_977_cov_26.571754	343	423	27	3	80	0.0375000
NODE_7067_length_977_cov_26.571754	343	423	29	11	80	0.1375000
NODE_7067_length_977_cov_26.571754	343	423	30	26	80	0.3250000
NODE_7067_length_977_cov_26.571754	396	476	6	22	80	0.2750000
NODE_7067_length_977_cov_26.571754	396	476	23	28	80	0.3500000
NODE_7067_length_977_cov_26.571754	396	476	25	2	80	0.0250000
NODE_7067_length_977_cov_26.571754	396	476	27	4	80	0.0500000
NODE_7067_length_977_cov_26.571754	396	476	29	11	80	0.1375000
NODE_7067_length_977_cov_26.571754	396	476	30	13	80	0.1625000
NODE_7067_length_977_cov_26.571754	472	552	0	33	80	0.4125000
NODE_7067_length_977_cov_26.571754	472	552	6	47	80	0.5875000
NODE_7067_length_977_cov_26.571754	525	600	0	75	75	1.0000000
NODE_7068_length_977_cov_24.898633	470	550	0	80	80	1.0000000
NODE_7068_length_977_cov_24.898633	523	603	0	80	80	1.0000000
NODE_7069_length_977_cov_22.986333	313	393	0	5	80	0.0625000
NODE_7069_length_977_cov_22.986333	313	393	4	48	80	0.6000000
NODE_7069_length_977_cov_22.986333	313	393	9	27	80	0.3375000
NODE_7069_length_977_cov_22.986333	366	446	1	3	80	0.0375000
NODE_7069_length_977_cov_22.986333	366	446	5	45	80	0.5625000
NODE_7069_length_977_cov_22.986333	366	446	9	32	80	0.4000000
NODE_7069_length_977_cov_22.986333	442	522	1	28	80	0.3500000
NODE_7069_length_977_cov_22.986333	442	522	2	35	80	0.4375000
NODE_7069_length_977_cov_22.986333	442	522	3	16	80	0.2000000
NODE_7069_length_977_cov_22.986333	442	522	5	1	80	0.0125000
NODE_7069_length_977_cov_22.986333	495	575	0	29	80	0.3625000
NODE_7069_length_977_cov_22.986333	495	575	2	51	80	0.6375000
NODE_7070_length_977_cov_10.753986	290	370	3	1	80	0.0125000
NODE_7070_length_977_cov_10.753986	290	370	5	2	80	0.0250000
NODE_7070_length_977_cov_10.753986	290	370	6	31	80	0.3875000
NODE_7070_length_977_cov_10.753986	290	370	7	4	80	0.0500000
NODE_7070_length_977_cov_10.753986	290	370	8	1	80	0.0125000
NODE_7070_length_977_cov_10.753986	290	370	9	38	80	0.4750000
NODE_7070_length_977_cov_10.753986	290	370	11	3	80	0.0375000
NODE_7070_length_977_cov_10.753986	343	423	2	13	80	0.1625000
NODE_7070_length_977_cov_10.753986	343	423	4	38	80	0.4750000
NODE_7070_length_977_cov_10.753986	343	423	7	3	80	0.0375000
NODE_7070_length_977_cov_10.753986	343	423	9	23	80	0.2875000
NODE_7070_length_977_cov_10.753986	343	423	11	3	80	0.0375000
NODE_7071_length_977_cov_9.924829	401	456	2	6	55	0.1090909
NODE_7071_length_977_cov_9.924829	401	456	4	33	55	0.6000000
NODE_7071_length_977_cov_9.924829	401	456	6	16	55	0.2909091
NODE_7073_length_977_cov_6.391800	483	563	0	80	80	1.0000000
NODE_7073_length_977_cov_6.391800	536	616	0	80	80	1.0000000
NODE_7075_length_977_cov_2.907745	191	241	16	50	50	1.0000000
NODE_7085_length_976_cov_38.192702	326	406	7	3	80	0.0375000
NODE_7085_length_976_cov_38.192702	326	406	9	29	80	0.3625000
NODE_7085_length_976_cov_38.192702	326	406	11	48	80	0.6000000
NODE_7085_length_976_cov_38.192702	379	459	3	14	80	0.1750000
NODE_7085_length_976_cov_38.192702	379	459	5	2	80	0.0250000
NODE_7085_length_976_cov_38.192702	379	459	7	18	80	0.2250000
NODE_7085_length_976_cov_38.192702	379	459	9	33	80	0.4125000
NODE_7085_length_976_cov_38.192702	379	459	11	13	80	0.1625000
NODE_7085_length_976_cov_38.192702	455	535	0	60	80	0.7500000
NODE_7085_length_976_cov_38.192702	455	535	3	20	80	0.2500000
NODE_7085_length_976_cov_38.192702	455	536	0	61	81	0.7530864
NODE_7085_length_976_cov_38.192702	455	536	3	20	81	0.2469136
NODE_7085_length_976_cov_38.192702	455	519	0	44	64	0.6875000
NODE_7085_length_976_cov_38.192702	455	519	3	20	64	0.3125000
NODE_7085_length_976_cov_38.192702	508	588	0	80	80	1.0000000
NODE_7086_length_976_cov_26.275941	499	579	2	3	80	0.0375000
NODE_7086_length_976_cov_26.275941	499	579	4	20	80	0.2500000
NODE_7086_length_976_cov_26.275941	499	579	6	36	80	0.4500000
NODE_7086_length_976_cov_26.275941	499	579	8	21	80	0.2625000
NODE_7086_length_976_cov_26.275941	552	632	2	27	80	0.3375000
NODE_7086_length_976_cov_26.275941	552	632	4	49	80	0.6125000
NODE_7086_length_976_cov_26.275941	552	632	8	4	80	0.0500000
NODE_7087_length_976_cov_25.559863	376	456	0	43	80	0.5375000
NODE_7087_length_976_cov_25.559863	376	456	2	37	80	0.4625000
NODE_7087_length_976_cov_25.559863	429	509	2	34	80	0.4250000
NODE_7087_length_976_cov_25.559863	429	509	3	10	80	0.1250000
NODE_7087_length_976_cov_25.559863	429	509	5	36	80	0.4500000
NODE_7088_length_976_cov_17.961231	572	652	2	60	80	0.7500000
NODE_7088_length_976_cov_17.961231	572	652	4	20	80	0.2500000
NODE_7088_length_976_cov_17.961231	625	705	0	43	80	0.5375000
NODE_7088_length_976_cov_17.961231	625	705	2	37	80	0.4625000
NODE_7089_length_976_cov_5.567845	789	851	6	3	62	0.0483871
NODE_7089_length_976_cov_5.567845	789	851	7	15	62	0.2419355
NODE_7089_length_976_cov_5.567845	789	851	8	19	62	0.3064516
NODE_7089_length_976_cov_5.567845	789	851	10	25	62	0.4032258
NODE_7089_length_976_cov_5.567845	842	904	6	8	62	0.1290323
NODE_7089_length_976_cov_5.567845	842	904	8	7	62	0.1129032
NODE_7089_length_976_cov_5.567845	842	904	10	47	62	0.7580645
NODE_7101_length_975_cov_192.211187	722	802	81	1	80	0.0125000
NODE_7101_length_975_cov_192.211187	722	802	83	1	80	0.0125000
NODE_7101_length_975_cov_192.211187	722	802	84	1	80	0.0125000
NODE_7101_length_975_cov_192.211187	722	802	85	5	80	0.0625000
NODE_7101_length_975_cov_192.211187	722	802	86	3	80	0.0375000
NODE_7101_length_975_cov_192.211187	722	802	87	5	80	0.0625000
NODE_7101_length_975_cov_192.211187	722	802	88	5	80	0.0625000
NODE_7101_length_975_cov_192.211187	722	802	89	7	80	0.0875000
NODE_7101_length_975_cov_192.211187	722	802	90	5	80	0.0625000
NODE_7101_length_975_cov_192.211187	722	802	91	2	80	0.0250000
NODE_7101_length_975_cov_192.211187	722	802	92	6	80	0.0750000
NODE_7101_length_975_cov_192.211187	722	802	93	4	80	0.0500000
NODE_7101_length_975_cov_192.211187	722	802	94	6	80	0.0750000
NODE_7101_length_975_cov_192.211187	722	802	96	2	80	0.0250000
NODE_7101_length_975_cov_192.211187	722	802	98	3	80	0.0375000
NODE_7101_length_975_cov_192.211187	722	802	100	3	80	0.0375000
NODE_7101_length_975_cov_192.211187	722	802	102	2	80	0.0250000
NODE_7101_length_975_cov_192.211187	722	802	107	2	80	0.0250000
NODE_7101_length_975_cov_192.211187	722	802	112	1	80	0.0125000
NODE_7101_length_975_cov_192.211187	722	802	115	5	80	0.0625000
NODE_7101_length_975_cov_192.211187	722	802	116	2	80	0.0250000
NODE_7101_length_975_cov_192.211187	722	802	118	3	80	0.0375000
NODE_7101_length_975_cov_192.211187	722	802	120	1	80	0.0125000
NODE_7101_length_975_cov_192.211187	722	802	121	1	80	0.0125000
NODE_7101_length_975_cov_192.211187	722	802	125	1	80	0.0125000
NODE_7101_length_975_cov_192.211187	722	802	126	1	80	0.0125000
NODE_7101_length_975_cov_192.211187	722	802	130	1	80	0.0125000
NODE_7101_length_975_cov_192.211187	722	802	132	1	80	0.0125000
NODE_7102_length_975_cov_41.446347	414	494	0	31	80	0.3875000
NODE_7102_length_975_cov_41.446347	414	494	2	21	80	0.2625000
NODE_7102_length_975_cov_41.446347	414	494	4	28	80	0.3500000
NODE_7102_length_975_cov_41.446347	467	547	4	80	80	1.0000000
NODE_7103_length_975_cov_37.618721	375	455	2	6	80	0.0750000
NODE_7103_length_975_cov_37.618721	375	455	4	74	80	0.9250000
NODE_7103_length_975_cov_37.618721	428	508	0	19	80	0.2375000
NODE_7103_length_975_cov_37.618721	428	508	2	40	80	0.5000000
NODE_7103_length_975_cov_37.618721	428	508	4	21	80	0.2625000
NODE_7104_length_975_cov_34.265982	424	504	2	60	80	0.7500000
NODE_7104_length_975_cov_34.265982	424	504	4	20	80	0.2500000
NODE_7104_length_975_cov_34.265982	477	557	2	46	80	0.5750000
NODE_7104_length_975_cov_34.265982	477	557	4	34	80	0.4250000
NODE_7105_length_975_cov_31.888128	461	541	0	6	80	0.0750000
NODE_7105_length_975_cov_31.888128	461	541	2	46	80	0.5750000
NODE_7105_length_975_cov_31.888128	461	541	4	28	80	0.3500000
NODE_7105_length_975_cov_31.888128	514	594	0	9	80	0.1125000
NODE_7105_length_975_cov_31.888128	514	594	2	40	80	0.5000000
NODE_7105_length_975_cov_31.888128	514	594	4	31	80	0.3875000
NODE_7106_length_975_cov_22.093607	392	472	0	80	80	1.0000000
NODE_7106_length_975_cov_22.093607	445	525	0	80	80	1.0000000
NODE_7107_length_975_cov_15.091324	403	483	0	18	80	0.2250000
NODE_7107_length_975_cov_15.091324	403	483	2	62	80	0.7750000
NODE_7107_length_975_cov_15.091324	456	536	0	70	80	0.8750000
NODE_7107_length_975_cov_15.091324	456	536	2	10	80	0.1250000
NODE_7108_length_975_cov_15.046804	63	143	0	48	80	0.6000000
NODE_7108_length_975_cov_15.046804	63	143	1	1	80	0.0125000
NODE_7108_length_975_cov_15.046804	63	143	2	31	80	0.3875000
NODE_7108_length_975_cov_15.046804	116	196	2	80	80	1.0000000
NODE_7109_length_975_cov_12.043379	535	615	0	80	80	1.0000000
NODE_7109_length_975_cov_12.043379	588	668	0	80	80	1.0000000
NODE_7110_length_975_cov_11.772831	276	354	0	25	78	0.3205128
NODE_7110_length_975_cov_11.772831	276	354	2	53	78	0.6794872
NODE_7110_length_975_cov_11.772831	327	407	2	80	80	1.0000000
NODE_7111_length_975_cov_10.599315	405	485	0	80	80	1.0000000
NODE_7111_length_975_cov_10.599315	458	538	0	80	80	1.0000000
NODE_7112_length_975_cov_8.089041	430	510	0	80	80	1.0000000
NODE_7112_length_975_cov_8.089041	483	563	0	80	80	1.0000000
NODE_7114_length_975_cov_3.728311	254	334	0	43	80	0.5375000
NODE_7114_length_975_cov_3.728311	254	334	2	37	80	0.4625000
NODE_7114_length_975_cov_3.728311	307	387	0	80	80	1.0000000
NODE_7125_length_974_cov_293.334857	564	642	421	1	78	0.0128205
NODE_7125_length_974_cov_293.334857	564	642	427	1	78	0.0128205
NODE_7125_length_974_cov_293.334857	564	642	432	1	78	0.0128205
NODE_7125_length_974_cov_293.334857	564	642	434	1	78	0.0128205
NODE_7125_length_974_cov_293.334857	564	642	438	1	78	0.0128205
NODE_7125_length_974_cov_293.334857	564	642	440	1	78	0.0128205
NODE_7125_length_974_cov_293.334857	564	642	443	2	78	0.0256410
NODE_7125_length_974_cov_293.334857	564	642	444	2	78	0.0256410
NODE_7125_length_974_cov_293.334857	564	642	445	4	78	0.0512821
NODE_7125_length_974_cov_293.334857	564	642	447	2	78	0.0256410
NODE_7125_length_974_cov_293.334857	564	642	449	1	78	0.0128205
NODE_7125_length_974_cov_293.334857	564	642	451	1	78	0.0128205
NODE_7125_length_974_cov_293.334857	564	642	452	2	78	0.0256410
NODE_7125_length_974_cov_293.334857	564	642	453	4	78	0.0512821
NODE_7125_length_974_cov_293.334857	564	642	454	2	78	0.0256410
NODE_7125_length_974_cov_293.334857	564	642	455	2	78	0.0256410
NODE_7125_length_974_cov_293.334857	564	642	456	2	78	0.0256410
NODE_7125_length_974_cov_293.334857	564	642	457	3	78	0.0384615
NODE_7125_length_974_cov_293.334857	564	642	458	2	78	0.0256410
NODE_7125_length_974_cov_293.334857	564	642	459	3	78	0.0384615
NODE_7125_length_974_cov_293.334857	564	642	460	4	78	0.0512821
NODE_7125_length_974_cov_293.334857	564	642	461	4	78	0.0512821
NODE_7125_length_974_cov_293.334857	564	642	462	4	78	0.0512821
NODE_7125_length_974_cov_293.334857	564	642	463	1	78	0.0128205
NODE_7125_length_974_cov_293.334857	564	642	464	5	78	0.0641026
NODE_7125_length_974_cov_293.334857	564	642	465	3	78	0.0384615
NODE_7125_length_974_cov_293.334857	564	642	466	2	78	0.0256410
NODE_7125_length_974_cov_293.334857	564	642	467	3	78	0.0384615
NODE_7125_length_974_cov_293.334857	564	642	472	1	78	0.0128205
NODE_7125_length_974_cov_293.334857	564	642	476	2	78	0.0256410
NODE_7125_length_974_cov_293.334857	564	642	480	1	78	0.0128205
NODE_7125_length_974_cov_293.334857	564	642	482	1	78	0.0128205
NODE_7125_length_974_cov_293.334857	564	642	485	1	78	0.0128205
NODE_7125_length_974_cov_293.334857	564	642	490	1	78	0.0128205
NODE_7125_length_974_cov_293.334857	564	642	493	2	78	0.0256410
NODE_7125_length_974_cov_293.334857	564	642	498	1	78	0.0128205
NODE_7125_length_974_cov_293.334857	564	642	500	1	78	0.0128205
NODE_7125_length_974_cov_293.334857	564	642	506	1	78	0.0128205
NODE_7125_length_974_cov_293.334857	564	642	514	1	78	0.0128205
NODE_7125_length_974_cov_293.334857	564	642	523	1	78	0.0128205
NODE_7125_length_974_cov_293.334857	564	642	421	1	78	0.0128205
NODE_7125_length_974_cov_293.334857	564	642	427	1	78	0.0128205
NODE_7125_length_974_cov_293.334857	564	642	432	1	78	0.0128205
NODE_7125_length_974_cov_293.334857	564	642	434	1	78	0.0128205
NODE_7125_length_974_cov_293.334857	564	642	438	1	78	0.0128205
NODE_7125_length_974_cov_293.334857	564	642	440	1	78	0.0128205
NODE_7125_length_974_cov_293.334857	564	642	443	2	78	0.0256410
NODE_7125_length_974_cov_293.334857	564	642	444	2	78	0.0256410
NODE_7125_length_974_cov_293.334857	564	642	445	4	78	0.0512821
NODE_7125_length_974_cov_293.334857	564	642	447	2	78	0.0256410
NODE_7125_length_974_cov_293.334857	564	642	449	1	78	0.0128205
NODE_7125_length_974_cov_293.334857	564	642	451	1	78	0.0128205
NODE_7125_length_974_cov_293.334857	564	642	452	2	78	0.0256410
NODE_7125_length_974_cov_293.334857	564	642	453	4	78	0.0512821
NODE_7125_length_974_cov_293.334857	564	642	454	2	78	0.0256410
NODE_7125_length_974_cov_293.334857	564	642	455	2	78	0.0256410
NODE_7125_length_974_cov_293.334857	564	642	456	2	78	0.0256410
NODE_7125_length_974_cov_293.334857	564	642	457	3	78	0.0384615
NODE_7125_length_974_cov_293.334857	564	642	458	2	78	0.0256410
NODE_7125_length_974_cov_293.334857	564	642	459	3	78	0.0384615
NODE_7125_length_974_cov_293.334857	564	642	460	4	78	0.0512821
NODE_7125_length_974_cov_293.334857	564	642	461	4	78	0.0512821
NODE_7125_length_974_cov_293.334857	564	642	462	4	78	0.0512821
NODE_7125_length_974_cov_293.334857	564	642	463	1	78	0.0128205
NODE_7125_length_974_cov_293.334857	564	642	464	5	78	0.0641026
NODE_7125_length_974_cov_293.334857	564	642	465	3	78	0.0384615
NODE_7125_length_974_cov_293.334857	564	642	466	2	78	0.0256410
NODE_7125_length_974_cov_293.334857	564	642	467	3	78	0.0384615
NODE_7125_length_974_cov_293.334857	564	642	472	1	78	0.0128205
NODE_7125_length_974_cov_293.334857	564	642	476	2	78	0.0256410
NODE_7125_length_974_cov_293.334857	564	642	480	1	78	0.0128205
NODE_7125_length_974_cov_293.334857	564	642	482	1	78	0.0128205
NODE_7125_length_974_cov_293.334857	564	642	485	1	78	0.0128205
NODE_7125_length_974_cov_293.334857	564	642	490	1	78	0.0128205
NODE_7125_length_974_cov_293.334857	564	642	493	2	78	0.0256410
NODE_7125_length_974_cov_293.334857	564	642	498	1	78	0.0128205
NODE_7125_length_974_cov_293.334857	564	642	500	1	78	0.0128205
NODE_7125_length_974_cov_293.334857	564	642	506	1	78	0.0128205
NODE_7125_length_974_cov_293.334857	564	642	514	1	78	0.0128205
NODE_7125_length_974_cov_293.334857	564	642	523	1	78	0.0128205
NODE_7125_length_974_cov_293.334857	564	633	421	1	69	0.0144928
NODE_7125_length_974_cov_293.334857	564	633	427	1	69	0.0144928
NODE_7125_length_974_cov_293.334857	564	633	432	1	69	0.0144928
NODE_7125_length_974_cov_293.334857	564	633	434	1	69	0.0144928
NODE_7125_length_974_cov_293.334857	564	633	438	1	69	0.0144928
NODE_7125_length_974_cov_293.334857	564	633	440	1	69	0.0144928
NODE_7125_length_974_cov_293.334857	564	633	443	2	69	0.0289855
NODE_7125_length_974_cov_293.334857	564	633	444	2	69	0.0289855
NODE_7125_length_974_cov_293.334857	564	633	445	4	69	0.0579710
NODE_7125_length_974_cov_293.334857	564	633	447	2	69	0.0289855
NODE_7125_length_974_cov_293.334857	564	633	449	1	69	0.0144928
NODE_7125_length_974_cov_293.334857	564	633	451	1	69	0.0144928
NODE_7125_length_974_cov_293.334857	564	633	452	2	69	0.0289855
NODE_7125_length_974_cov_293.334857	564	633	453	2	69	0.0289855
NODE_7125_length_974_cov_293.334857	564	633	455	1	69	0.0144928
NODE_7125_length_974_cov_293.334857	564	633	456	1	69	0.0144928
NODE_7125_length_974_cov_293.334857	564	633	457	3	69	0.0434783
NODE_7125_length_974_cov_293.334857	564	633	458	2	69	0.0289855
NODE_7125_length_974_cov_293.334857	564	633	459	3	69	0.0434783
NODE_7125_length_974_cov_293.334857	564	633	460	3	69	0.0434783
NODE_7125_length_974_cov_293.334857	564	633	461	3	69	0.0434783
NODE_7125_length_974_cov_293.334857	564	633	462	4	69	0.0579710
NODE_7125_length_974_cov_293.334857	564	633	463	1	69	0.0144928
NODE_7125_length_974_cov_293.334857	564	633	464	5	69	0.0724638
NODE_7125_length_974_cov_293.334857	564	633	465	2	69	0.0289855
NODE_7125_length_974_cov_293.334857	564	633	466	2	69	0.0289855
NODE_7125_length_974_cov_293.334857	564	633	467	3	69	0.0434783
NODE_7125_length_974_cov_293.334857	564	633	472	1	69	0.0144928
NODE_7125_length_974_cov_293.334857	564	633	476	2	69	0.0289855
NODE_7125_length_974_cov_293.334857	564	633	480	1	69	0.0144928
NODE_7125_length_974_cov_293.334857	564	633	482	1	69	0.0144928
NODE_7125_length_974_cov_293.334857	564	633	485	1	69	0.0144928
NODE_7125_length_974_cov_293.334857	564	633	490	1	69	0.0144928
NODE_7125_length_974_cov_293.334857	564	633	493	2	69	0.0289855
NODE_7125_length_974_cov_293.334857	564	633	498	1	69	0.0144928
NODE_7125_length_974_cov_293.334857	564	633	500	1	69	0.0144928
NODE_7125_length_974_cov_293.334857	564	633	506	1	69	0.0144928
NODE_7125_length_974_cov_293.334857	564	633	514	1	69	0.0144928
NODE_7125_length_974_cov_293.334857	564	633	523	1	69	0.0144928
NODE_7126_length_974_cov_49.884571	459	539	0	41	80	0.5125000
NODE_7126_length_974_cov_49.884571	459	539	2	39	80	0.4875000
NODE_7126_length_974_cov_49.884571	512	592	0	52	80	0.6500000
NODE_7126_length_974_cov_49.884571	512	592	2	28	80	0.3500000
NODE_7127_length_974_cov_38.384000	430	508	0	78	78	1.0000000
NODE_7127_length_974_cov_38.384000	483	561	0	78	78	1.0000000
NODE_7128_length_974_cov_26.008000	391	471	0	53	80	0.6625000
NODE_7128_length_974_cov_26.008000	391	471	2	11	80	0.1375000
NODE_7128_length_974_cov_26.008000	391	471	4	16	80	0.2000000
NODE_7128_length_974_cov_26.008000	444	524	2	11	80	0.1375000
NODE_7128_length_974_cov_26.008000	444	524	4	68	80	0.8500000
NODE_7128_length_974_cov_26.008000	444	524	6	1	80	0.0125000
NODE_7128_length_974_cov_26.008000	520	600	4	3	80	0.0375000
NODE_7128_length_974_cov_26.008000	520	600	6	36	80	0.4500000
NODE_7128_length_974_cov_26.008000	520	600	8	19	80	0.2375000
NODE_7128_length_974_cov_26.008000	520	600	10	22	80	0.2750000
NODE_7128_length_974_cov_26.008000	573	653	6	31	80	0.3875000
NODE_7128_length_974_cov_26.008000	573	653	8	26	80	0.3250000
NODE_7128_length_974_cov_26.008000	573	653	10	23	80	0.2875000
NODE_7129_length_974_cov_21.160000	460	540	0	6	80	0.0750000
NODE_7129_length_974_cov_21.160000	460	540	4	39	80	0.4875000
NODE_7129_length_974_cov_21.160000	460	540	6	11	80	0.1375000
NODE_7129_length_974_cov_21.160000	460	540	8	24	80	0.3000000
NODE_7129_length_974_cov_21.160000	513	593	2	22	80	0.2750000
NODE_7129_length_974_cov_21.160000	513	593	4	31	80	0.3875000
NODE_7129_length_974_cov_21.160000	513	593	6	3	80	0.0375000
NODE_7129_length_974_cov_21.160000	513	593	8	24	80	0.3000000
NODE_7131_length_974_cov_11.384000	290	370	0	33	80	0.4125000
NODE_7131_length_974_cov_11.384000	290	370	4	45	80	0.5625000
NODE_7131_length_974_cov_11.384000	290	370	6	2	80	0.0250000
NODE_7131_length_974_cov_11.384000	343	423	2	6	80	0.0750000
NODE_7131_length_974_cov_11.384000	343	423	4	25	80	0.3125000
NODE_7131_length_974_cov_11.384000	343	423	6	49	80	0.6125000
NODE_7132_length_974_cov_11.216000	543	623	2	16	80	0.2000000
NODE_7132_length_974_cov_11.216000	543	623	4	64	80	0.8000000
NODE_7132_length_974_cov_11.216000	596	668	0	2	72	0.0277778
NODE_7132_length_974_cov_11.216000	596	668	1	13	72	0.1805556
NODE_7132_length_974_cov_11.216000	596	668	2	46	72	0.6388889
NODE_7132_length_974_cov_11.216000	596	668	4	11	72	0.1527778
NODE_7133_length_974_cov_9.601143	436	516	0	28	80	0.3500000
NODE_7133_length_974_cov_9.601143	436	516	2	52	80	0.6500000
NODE_7133_length_974_cov_9.601143	489	569	0	50	80	0.6250000
NODE_7133_length_974_cov_9.601143	489	569	2	30	80	0.3750000
NODE_7134_length_974_cov_7.436571	382	462	0	80	80	1.0000000
NODE_7134_length_974_cov_7.436571	436	515	0	79	79	1.0000000
NODE_7147_length_973_cov_46.012586	349	429	2	44	80	0.5500000
NODE_7147_length_973_cov_46.012586	349	429	4	36	80	0.4500000
NODE_7147_length_973_cov_46.012586	402	482	0	37	80	0.4625000
NODE_7147_length_973_cov_46.012586	402	482	2	43	80	0.5375000
NODE_7147_length_973_cov_46.012586	478	558	0	26	80	0.3250000
NODE_7147_length_973_cov_46.012586	478	558	2	24	80	0.3000000
NODE_7147_length_973_cov_46.012586	478	558	4	30	80	0.3750000
NODE_7147_length_973_cov_46.012586	531	611	4	80	80	1.0000000
NODE_7148_length_973_cov_40.305492	364	444	0	32	80	0.4000000
NODE_7148_length_973_cov_40.305492	364	444	2	48	80	0.6000000
NODE_7148_length_973_cov_40.305492	417	497	0	6	80	0.0750000
NODE_7148_length_973_cov_40.305492	417	497	2	74	80	0.9250000
NODE_7149_length_973_cov_24.105263	460	540	0	32	80	0.4000000
NODE_7149_length_973_cov_24.105263	460	540	4	48	80	0.6000000
NODE_7149_length_973_cov_24.105263	513	593	0	21	80	0.2625000
NODE_7149_length_973_cov_24.105263	513	593	4	59	80	0.7375000
NODE_7150_length_973_cov_22.106407	342	422	2	80	80	1.0000000
NODE_7150_length_973_cov_22.106407	395	475	0	48	80	0.6000000
NODE_7150_length_973_cov_22.106407	395	475	2	32	80	0.4000000
NODE_7150_length_973_cov_22.106407	471	550	0	79	79	1.0000000
NODE_7150_length_973_cov_22.106407	526	604	0	78	78	1.0000000
NODE_7151_length_973_cov_10.994279	430	510	0	11	80	0.1375000
NODE_7151_length_973_cov_10.994279	430	510	2	69	80	0.8625000
NODE_7151_length_973_cov_10.994279	483	563	0	57	80	0.7125000
NODE_7151_length_973_cov_10.994279	483	563	2	23	80	0.2875000
NODE_7151_length_973_cov_10.994279	559	635	0	76	76	1.0000000
NODE_7151_length_973_cov_10.994279	608	688	0	80	80	1.0000000
NODE_7153_length_973_cov_2.973684	734	814	0	17	80	0.2125000
NODE_7153_length_973_cov_2.973684	734	814	2	34	80	0.4250000
NODE_7153_length_973_cov_2.973684	734	814	4	27	80	0.3375000
NODE_7153_length_973_cov_2.973684	734	814	8	2	80	0.0250000
NODE_7153_length_973_cov_2.973684	820	890	6	21	70	0.3000000
NODE_7153_length_973_cov_2.973684	820	890	8	31	70	0.4428571
NODE_7153_length_973_cov_2.973684	820	890	10	18	70	0.2571429
NODE_7153_length_973_cov_2.973684	863	944	0	8	81	0.0987654
NODE_7153_length_973_cov_2.973684	863	944	2	16	81	0.1975309
NODE_7153_length_973_cov_2.973684	863	944	6	51	81	0.6296296
NODE_7153_length_973_cov_2.973684	863	944	8	6	81	0.0740741
NODE_7166_length_972_cov_32.547537	299	379	0	9	80	0.1125000
NODE_7166_length_972_cov_32.547537	299	379	2	11	80	0.1375000
NODE_7166_length_972_cov_32.547537	299	379	4	60	80	0.7500000
NODE_7166_length_972_cov_32.547537	352	432	0	62	80	0.7750000
NODE_7166_length_972_cov_32.547537	352	432	2	5	80	0.0625000
NODE_7166_length_972_cov_32.547537	352	432	4	13	80	0.1625000
NODE_7166_length_972_cov_32.547537	428	508	0	80	80	1.0000000
NODE_7166_length_972_cov_32.547537	481	561	0	80	80	1.0000000
NODE_7167_length_972_cov_31.010309	474	554	4	18	80	0.2250000
NODE_7167_length_972_cov_31.010309	474	554	6	47	80	0.5875000
NODE_7167_length_972_cov_31.010309	474	554	8	15	80	0.1875000
NODE_7167_length_972_cov_31.010309	527	607	0	30	80	0.3750000
NODE_7167_length_972_cov_31.010309	527	607	4	27	80	0.3375000
NODE_7167_length_972_cov_31.010309	527	607	6	23	80	0.2875000
NODE_7168_length_972_cov_29.810997	481	561	2	71	80	0.8875000
NODE_7168_length_972_cov_29.810997	481	561	4	9	80	0.1125000
NODE_7168_length_972_cov_29.810997	534	614	2	80	80	1.0000000
NODE_7169_length_972_cov_23.438717	442	522	0	24	80	0.3000000
NODE_7169_length_972_cov_23.438717	442	522	2	56	80	0.7000000
NODE_7169_length_972_cov_23.438717	495	575	0	13	80	0.1625000
NODE_7169_length_972_cov_23.438717	495	575	2	67	80	0.8375000
NODE_7170_length_972_cov_18.886598	453	533	0	35	80	0.4375000
NODE_7170_length_972_cov_18.886598	453	533	2	5	80	0.0625000
NODE_7170_length_972_cov_18.886598	453	533	4	40	80	0.5000000
NODE_7170_length_972_cov_18.886598	506	585	4	79	79	1.0000000
NODE_7171_length_972_cov_15.100802	329	409	0	80	80	1.0000000
NODE_7171_length_972_cov_15.100802	382	462	0	80	80	1.0000000
NODE_7172_length_972_cov_12.674685	444	524	0	80	80	1.0000000
NODE_7172_length_972_cov_12.674685	497	577	0	80	80	1.0000000
NODE_7173_length_972_cov_11.235968	504	584	0	57	80	0.7125000
NODE_7173_length_972_cov_11.235968	504	584	3	23	80	0.2875000
NODE_7173_length_972_cov_11.235968	557	637	0	4	80	0.0500000
NODE_7173_length_972_cov_11.235968	557	637	3	59	80	0.7375000
NODE_7173_length_972_cov_11.235968	557	637	4	17	80	0.2125000
NODE_7174_length_972_cov_10.983963	402	482	0	80	80	1.0000000
NODE_7174_length_972_cov_10.983963	455	535	0	80	80	1.0000000
NODE_7175_length_972_cov_8.887743	302	382	0	12	80	0.1500000
NODE_7175_length_972_cov_8.887743	302	382	2	18	80	0.2250000
NODE_7175_length_972_cov_8.887743	302	382	5	50	80	0.6250000
NODE_7175_length_972_cov_8.887743	355	430	4	31	75	0.4133333
NODE_7175_length_972_cov_8.887743	355	430	5	44	75	0.5866666
NODE_7176_length_972_cov_8.265750	488	568	0	48	80	0.6000000
NODE_7176_length_972_cov_8.265750	488	568	2	32	80	0.4000000
NODE_7176_length_972_cov_8.265750	541	621	0	1	80	0.0125000
NODE_7176_length_972_cov_8.265750	541	621	2	79	80	0.9875000
NODE_7182_length_972_cov_2.714777	165	241	4	12	76	0.1578947
NODE_7182_length_972_cov_2.714777	165	241	6	16	76	0.2105263
NODE_7182_length_972_cov_2.714777	165	241	8	19	76	0.2500000
NODE_7182_length_972_cov_2.714777	165	241	10	29	76	0.3815790
NODE_7195_length_971_cov_52.575688	398	478	2	59	80	0.7375000
NODE_7195_length_971_cov_52.575688	398	478	6	18	80	0.2250000
NODE_7195_length_971_cov_52.575688	398	478	10	3	80	0.0375000
NODE_7195_length_971_cov_52.575688	451	531	2	6	80	0.0750000
NODE_7195_length_971_cov_52.575688	451	531	6	25	80	0.3125000
NODE_7195_length_971_cov_52.575688	451	531	10	49	80	0.6125000
NODE_7195_length_971_cov_52.575688	527	607	0	17	80	0.2125000
NODE_7195_length_971_cov_52.575688	527	607	2	1	80	0.0125000
NODE_7195_length_971_cov_52.575688	527	607	4	53	80	0.6625000
NODE_7195_length_971_cov_52.575688	527	607	6	9	80	0.1125000
NODE_7195_length_971_cov_52.575688	580	660	0	16	80	0.2000000
NODE_7195_length_971_cov_52.575688	580	660	2	1	80	0.0125000
NODE_7195_length_971_cov_52.575688	580	660	4	63	80	0.7875000
NODE_7196_length_971_cov_44.464450	280	360	0	80	80	1.0000000
NODE_7196_length_971_cov_44.464450	333	413	0	80	80	1.0000000
NODE_7196_length_971_cov_44.464450	409	489	0	8	80	0.1000000
NODE_7196_length_971_cov_44.464450	409	489	2	11	80	0.1375000
NODE_7196_length_971_cov_44.464450	409	489	4	4	80	0.0500000
NODE_7196_length_971_cov_44.464450	409	489	10	22	80	0.2750000
NODE_7196_length_971_cov_44.464450	409	489	21	6	80	0.0750000
NODE_7196_length_971_cov_44.464450	409	489	23	29	80	0.3625000
NODE_7196_length_971_cov_44.464450	462	542	19	22	80	0.2750000
NODE_7196_length_971_cov_44.464450	462	542	21	37	80	0.4625000
NODE_7196_length_971_cov_44.464450	462	542	23	21	80	0.2625000
NODE_7197_length_971_cov_32.721330	509	589	0	80	80	1.0000000
NODE_7197_length_971_cov_32.721330	562	642	0	80	80	1.0000000
NODE_7198_length_971_cov_30.264908	474	554	0	80	80	1.0000000
NODE_7198_length_971_cov_30.264908	527	607	0	80	80	1.0000000
NODE_7199_length_971_cov_26.631881	434	514	0	18	80	0.2250000
NODE_7199_length_971_cov_26.631881	434	514	4	2	80	0.0250000
NODE_7199_length_971_cov_26.631881	434	514	6	60	80	0.7500000
NODE_7199_length_971_cov_26.631881	487	567	0	71	80	0.8875000
NODE_7199_length_971_cov_26.631881	487	567	4	2	80	0.0250000
NODE_7199_length_971_cov_26.631881	487	567	6	7	80	0.0875000
NODE_7200_length_971_cov_25.635321	404	484	0	80	80	1.0000000
NODE_7200_length_971_cov_25.635321	457	537	0	80	80	1.0000000
NODE_7201_length_971_cov_23.334862	363	443	5	17	80	0.2125000
NODE_7201_length_971_cov_23.334862	363	443	6	63	80	0.7875000
NODE_7201_length_971_cov_23.334862	416	497	0	48	81	0.5925926
NODE_7201_length_971_cov_23.334862	416	497	6	33	81	0.4074074
NODE_7202_length_971_cov_18.254587	468	548	0	24	80	0.3000000
NODE_7202_length_971_cov_18.254587	468	548	2	56	80	0.7000000
NODE_7202_length_971_cov_18.254587	521	601	0	14	80	0.1750000
NODE_7202_length_971_cov_18.254587	521	601	2	66	80	0.8250000
NODE_7203_length_971_cov_18.229358	392	472	0	47	80	0.5875000
NODE_7203_length_971_cov_18.229358	392	472	2	33	80	0.4125000
NODE_7203_length_971_cov_18.229358	445	525	0	45	80	0.5625000
NODE_7203_length_971_cov_18.229358	445	525	2	35	80	0.4375000
NODE_7204_length_971_cov_16.591743	481	561	0	5	80	0.0625000
NODE_7204_length_971_cov_16.591743	481	561	2	75	80	0.9375000
NODE_7204_length_971_cov_16.591743	534	614	0	31	80	0.3875000
NODE_7204_length_971_cov_16.591743	534	614	2	49	80	0.6125000
NODE_7205_length_971_cov_15.563073	463	543	0	80	80	1.0000000
NODE_7205_length_971_cov_15.563073	516	596	0	80	80	1.0000000
NODE_7206_length_971_cov_12.141055	415	495	0	8	80	0.1000000
NODE_7206_length_971_cov_12.141055	415	495	2	72	80	0.9000000
NODE_7206_length_971_cov_12.141055	468	548	0	5	80	0.0625000
NODE_7206_length_971_cov_12.141055	468	548	2	75	80	0.9375000
NODE_7222_length_970_cov_34.928817	438	518	2	80	80	1.0000000
NODE_7222_length_970_cov_34.928817	491	571	0	31	80	0.3875000
NODE_7222_length_970_cov_34.928817	491	571	2	49	80	0.6125000
NODE_7223_length_970_cov_34.445465	540	620	8	31	80	0.3875000
NODE_7223_length_970_cov_34.445465	540	620	10	17	80	0.2125000
NODE_7223_length_970_cov_34.445465	540	620	12	32	80	0.4000000
NODE_7223_length_970_cov_34.445465	593	673	2	26	80	0.3250000
NODE_7223_length_970_cov_34.445465	593	673	6	26	80	0.3250000
NODE_7223_length_970_cov_34.445465	593	673	8	21	80	0.2625000
NODE_7223_length_970_cov_34.445465	593	673	12	7	80	0.0875000
NODE_7224_length_970_cov_34.257176	352	432	0	66	80	0.8250000
NODE_7224_length_970_cov_34.257176	352	432	2	14	80	0.1750000
NODE_7224_length_970_cov_34.257176	405	485	0	80	80	1.0000000
NODE_7225_length_970_cov_26.904707	297	372	4	75	75	1.0000000
NODE_7225_length_970_cov_26.904707	303	376	4	73	73	1.0000000
NODE_7225_length_970_cov_26.904707	311	377	4	66	66	1.0000000
NODE_7225_length_970_cov_26.904707	350	429	0	36	79	0.4556962
NODE_7225_length_970_cov_26.904707	350	429	2	1	79	0.0126582
NODE_7225_length_970_cov_26.904707	350	429	3	11	79	0.1392405
NODE_7225_length_970_cov_26.904707	350	429	4	31	79	0.3924051
NODE_7225_length_970_cov_26.904707	350	429	0	36	79	0.4556962
NODE_7225_length_970_cov_26.904707	350	429	2	1	79	0.0126582
NODE_7225_length_970_cov_26.904707	350	429	3	11	79	0.1392405
NODE_7225_length_970_cov_26.904707	350	429	4	31	79	0.3924051
NODE_7225_length_970_cov_26.904707	350	429	0	36	79	0.4556962
NODE_7225_length_970_cov_26.904707	350	429	2	1	79	0.0126582
NODE_7225_length_970_cov_26.904707	350	429	3	11	79	0.1392405
NODE_7225_length_970_cov_26.904707	350	429	4	31	79	0.3924051
NODE_7226_length_970_cov_26.040184	266	346	0	80	80	1.0000000
NODE_7226_length_970_cov_26.040184	319	399	0	80	80	1.0000000
NODE_7226_length_970_cov_26.040184	395	475	0	80	80	1.0000000
NODE_7226_length_970_cov_26.040184	448	528	0	80	80	1.0000000
NODE_7227_length_970_cov_19.291619	415	495	0	9	80	0.1125000
NODE_7227_length_970_cov_19.291619	415	495	2	71	80	0.8875000
NODE_7227_length_970_cov_19.291619	468	548	0	54	80	0.6750000
NODE_7227_length_970_cov_19.291619	468	548	2	26	80	0.3250000
NODE_7228_length_970_cov_17.731343	557	637	0	12	80	0.1500000
NODE_7228_length_970_cov_17.731343	557	637	4	68	80	0.8500000
NODE_7228_length_970_cov_17.731343	610	690	0	65	80	0.8125000
NODE_7228_length_970_cov_17.731343	610	690	4	15	80	0.1875000
NODE_7229_length_970_cov_15.135476	407	487	0	80	80	1.0000000
NODE_7229_length_970_cov_15.135476	460	540	0	80	80	1.0000000
NODE_7230_length_970_cov_12.675086	534	614	0	80	80	1.0000000
NODE_7230_length_970_cov_12.675086	587	667	0	80	80	1.0000000
NODE_7231_length_970_cov_8.095293	487	567	0	12	80	0.1500000
NODE_7231_length_970_cov_8.095293	487	567	2	68	80	0.8500000
NODE_7231_length_970_cov_8.095293	540	620	0	65	80	0.8125000
NODE_7231_length_970_cov_8.095293	540	620	2	15	80	0.1875000
NODE_7233_length_970_cov_7.127440	336	416	0	80	80	1.0000000
NODE_7233_length_970_cov_7.127440	389	469	0	80	80	1.0000000
NODE_7234_length_970_cov_5.824340	0	56	4	51	56	0.9107143
NODE_7234_length_970_cov_5.824340	0	56	6	5	56	0.0892857
NODE_7246_length_969_cov_47.172414	419	499	0	20	80	0.2500000
NODE_7246_length_969_cov_47.172414	419	499	2	12	80	0.1500000
NODE_7246_length_969_cov_47.172414	419	499	4	48	80	0.6000000
NODE_7246_length_969_cov_47.172414	472	552	0	26	80	0.3250000
NODE_7246_length_969_cov_47.172414	472	552	4	54	80	0.6750000
NODE_7247_length_969_cov_28.234483	327	407	0	64	80	0.8000000
NODE_7247_length_969_cov_28.234483	327	407	2	16	80	0.2000000
NODE_7247_length_969_cov_28.234483	380	460	0	80	80	1.0000000
NODE_7248_length_969_cov_27.131034	392	472	0	34	80	0.4250000
NODE_7248_length_969_cov_27.131034	392	472	2	22	80	0.2750000
NODE_7248_length_969_cov_27.131034	392	472	4	24	80	0.3000000
NODE_7248_length_969_cov_27.131034	445	525	2	3	80	0.0375000
NODE_7248_length_969_cov_27.131034	445	525	4	77	80	0.9625000
NODE_7249_length_969_cov_26.345977	466	542	0	25	76	0.3289474
NODE_7249_length_969_cov_26.345977	466	542	4	1	76	0.0131579
NODE_7249_length_969_cov_26.345977	466	542	6	50	76	0.6578947
NODE_7249_length_969_cov_26.345977	515	595	0	12	80	0.1500000
NODE_7249_length_969_cov_26.345977	515	595	6	68	80	0.8500000
NODE_7250_length_969_cov_18.954023	274	354	0	18	80	0.2250000
NODE_7250_length_969_cov_18.954023	274	354	2	62	80	0.7750000
NODE_7250_length_969_cov_18.954023	327	407	0	33	80	0.4125000
NODE_7250_length_969_cov_18.954023	327	407	2	47	80	0.5875000
NODE_7251_length_969_cov_17.952874	410	490	0	57	80	0.7125000
NODE_7251_length_969_cov_17.952874	410	490	2	23	80	0.2875000
NODE_7251_length_969_cov_17.952874	463	543	0	4	80	0.0500000
NODE_7251_length_969_cov_17.952874	463	543	2	76	80	0.9500000
NODE_7251_length_969_cov_17.952874	693	773	0	43	80	0.5375000
NODE_7251_length_969_cov_17.952874	693	773	2	31	80	0.3875000
NODE_7251_length_969_cov_17.952874	693	773	6	6	80	0.0750000
NODE_7251_length_969_cov_17.952874	746	826	2	21	80	0.2625000
NODE_7251_length_969_cov_17.952874	746	826	6	17	80	0.2125000
NODE_7251_length_969_cov_17.952874	746	826	7	4	80	0.0500000
NODE_7251_length_969_cov_17.952874	746	826	8	38	80	0.4750000
NODE_7252_length_969_cov_15.942529	446	526	5	10	80	0.1250000
NODE_7252_length_969_cov_15.942529	446	526	6	70	80	0.8750000
NODE_7252_length_969_cov_15.942529	499	579	0	51	80	0.6375000
NODE_7252_length_969_cov_15.942529	499	579	4	1	80	0.0125000
NODE_7252_length_969_cov_15.942529	499	579	6	28	80	0.3500000
NODE_7253_length_969_cov_9.926437	573	653	0	80	80	1.0000000
NODE_7253_length_969_cov_9.926437	626	706	0	80	80	1.0000000
NODE_7265_length_968_cov_59.162255	376	456	0	41	80	0.5125000
NODE_7265_length_968_cov_59.162255	376	456	2	1	80	0.0125000
NODE_7265_length_968_cov_59.162255	376	456	4	38	80	0.4750000
NODE_7265_length_968_cov_59.162255	429	509	0	10	80	0.1250000
NODE_7265_length_968_cov_59.162255	429	509	2	6	80	0.0750000
NODE_7265_length_968_cov_59.162255	429	509	4	64	80	0.8000000
NODE_7265_length_968_cov_59.162255	505	585	0	54	80	0.6750000
NODE_7265_length_968_cov_59.162255	505	585	4	17	80	0.2125000
NODE_7265_length_968_cov_59.162255	505	585	10	9	80	0.1125000
NODE_7265_length_968_cov_59.162255	558	638	0	1	80	0.0125000
NODE_7265_length_968_cov_59.162255	558	638	4	17	80	0.2125000
NODE_7265_length_968_cov_59.162255	558	638	10	62	80	0.7750000
NODE_7266_length_968_cov_40.005754	514	594	0	16	80	0.2000000
NODE_7266_length_968_cov_40.005754	514	594	2	25	80	0.3125000
NODE_7266_length_968_cov_40.005754	514	594	4	39	80	0.4875000
NODE_7266_length_968_cov_40.005754	567	647	0	11	80	0.1375000
NODE_7266_length_968_cov_40.005754	567	647	2	8	80	0.1000000
NODE_7266_length_968_cov_40.005754	567	647	4	61	80	0.7625000
NODE_7267_length_968_cov_36.521289	450	530	0	32	80	0.4000000
NODE_7267_length_968_cov_36.521289	450	530	2	31	80	0.3875000
NODE_7267_length_968_cov_36.521289	450	530	4	17	80	0.2125000
NODE_7267_length_968_cov_36.521289	503	583	2	47	80	0.5875000
NODE_7267_length_968_cov_36.521289	503	583	4	33	80	0.4125000
NODE_7268_length_968_cov_34.799770	474	554	6	15	80	0.1875000
NODE_7268_length_968_cov_34.799770	474	554	8	65	80	0.8125000
NODE_7268_length_968_cov_34.799770	527	607	0	31	80	0.3875000
NODE_7268_length_968_cov_34.799770	527	607	6	37	80	0.4625000
NODE_7268_length_968_cov_34.799770	527	607	8	12	80	0.1500000
NODE_7269_length_968_cov_26.929804	293	372	0	78	79	0.9873418
NODE_7269_length_968_cov_26.929804	293	372	2	1	79	0.0126582
NODE_7269_length_968_cov_26.929804	345	425	0	26	80	0.3250000
NODE_7269_length_968_cov_26.929804	345	425	2	34	80	0.4250000
NODE_7269_length_968_cov_26.929804	345	425	4	20	80	0.2500000
NODE_7269_length_968_cov_26.929804	421	501	2	1	80	0.0125000
NODE_7269_length_968_cov_26.929804	421	501	4	37	80	0.4625000
NODE_7269_length_968_cov_26.929804	421	501	6	42	80	0.5250000
NODE_7269_length_968_cov_26.929804	474	554	0	18	80	0.2250000
NODE_7269_length_968_cov_26.929804	474	554	2	36	80	0.4500000
NODE_7269_length_968_cov_26.929804	474	554	4	7	80	0.0875000
NODE_7269_length_968_cov_26.929804	474	554	6	19	80	0.2375000
NODE_7270_length_968_cov_24.468354	434	514	2	80	80	1.0000000
NODE_7270_length_968_cov_24.468354	487	567	0	46	80	0.5750000
NODE_7270_length_968_cov_24.468354	487	567	2	34	80	0.4250000
NODE_7271_length_968_cov_23.204833	344	424	0	42	80	0.5250000
NODE_7271_length_968_cov_23.204833	344	424	2	38	80	0.4750000
NODE_7271_length_968_cov_23.204833	397	477	2	80	80	1.0000000
NODE_7271_length_968_cov_23.204833	473	553	0	60	80	0.7500000
NODE_7271_length_968_cov_23.204833	473	553	1	1	80	0.0125000
NODE_7271_length_968_cov_23.204833	473	553	2	19	80	0.2375000
NODE_7271_length_968_cov_23.204833	526	606	0	80	80	1.0000000
NODE_7272_length_968_cov_22.321059	417	497	0	15	80	0.1875000
NODE_7272_length_968_cov_22.321059	417	497	1	5	80	0.0625000
NODE_7272_length_968_cov_22.321059	417	497	4	1	80	0.0125000
NODE_7272_length_968_cov_22.321059	417	497	6	59	80	0.7375000
NODE_7272_length_968_cov_22.321059	470	550	0	15	80	0.1875000
NODE_7272_length_968_cov_22.321059	470	550	2	17	80	0.2125000
NODE_7272_length_968_cov_22.321059	470	550	6	48	80	0.6000000
NODE_7273_length_968_cov_20.897583	313	393	6	48	80	0.6000000
NODE_7273_length_968_cov_20.897583	313	393	8	32	80	0.4000000
NODE_7273_length_968_cov_20.897583	366	446	0	25	80	0.3125000
NODE_7273_length_968_cov_20.897583	366	446	2	18	80	0.2250000
NODE_7273_length_968_cov_20.897583	366	446	6	37	80	0.4625000
NODE_7274_length_968_cov_19.296893	401	481	2	53	80	0.6625000
NODE_7274_length_968_cov_19.296893	401	481	4	15	80	0.1875000
NODE_7274_length_968_cov_19.296893	401	481	6	12	80	0.1500000
NODE_7274_length_968_cov_19.296893	454	534	4	68	80	0.8500000
NODE_7274_length_968_cov_19.296893	454	534	6	12	80	0.1500000
NODE_7275_length_968_cov_18.100115	573	653	0	24	80	0.3000000
NODE_7275_length_968_cov_18.100115	573	653	2	17	80	0.2125000
NODE_7275_length_968_cov_18.100115	573	653	4	39	80	0.4875000
NODE_7275_length_968_cov_18.100115	626	706	0	77	80	0.9625000
NODE_7275_length_968_cov_18.100115	626	706	2	3	80	0.0375000
NODE_7276_length_968_cov_15.576525	472	552	0	80	80	1.0000000
NODE_7276_length_968_cov_15.576525	525	605	0	80	80	1.0000000
NODE_7277_length_968_cov_15.024166	329	409	0	4	80	0.0500000
NODE_7277_length_968_cov_15.024166	329	409	2	76	80	0.9500000
NODE_7277_length_968_cov_15.024166	382	462	0	30	80	0.3750000
NODE_7277_length_968_cov_15.024166	382	462	2	50	80	0.6250000
NODE_7277_length_968_cov_15.024166	458	538	0	80	80	1.0000000
NODE_7277_length_968_cov_15.024166	511	591	0	80	80	1.0000000
NODE_7278_length_968_cov_13.911392	674	754	2	80	80	1.0000000
NODE_7278_length_968_cov_13.911392	727	807	0	26	80	0.3250000
NODE_7278_length_968_cov_13.911392	727	807	2	54	80	0.6750000
NODE_7279_length_968_cov_11.698504	598	678	0	33	80	0.4125000
NODE_7279_length_968_cov_11.698504	598	678	2	47	80	0.5875000
NODE_7279_length_968_cov_11.698504	651	731	0	16	80	0.2000000
NODE_7279_length_968_cov_11.698504	651	731	2	64	80	0.8000000
NODE_7280_length_968_cov_6.490219	538	618	0	80	80	1.0000000
NODE_7280_length_968_cov_6.490219	591	671	0	80	80	1.0000000
NODE_7294_length_967_cov_25.572581	332	412	0	12	80	0.1500000
NODE_7294_length_967_cov_25.572581	332	412	6	49	80	0.6125000
NODE_7294_length_967_cov_25.572581	332	412	8	19	80	0.2375000
NODE_7294_length_967_cov_25.572581	385	465	4	20	80	0.2500000
NODE_7294_length_967_cov_25.572581	385	465	6	8	80	0.1000000
NODE_7294_length_967_cov_25.572581	385	465	8	20	80	0.2500000
NODE_7294_length_967_cov_25.572581	385	465	10	32	80	0.4000000
NODE_7295_length_967_cov_24.919355	396	476	0	41	80	0.5125000
NODE_7295_length_967_cov_24.919355	396	476	2	39	80	0.4875000
NODE_7295_length_967_cov_24.919355	449	529	0	80	80	1.0000000
NODE_7296_length_967_cov_19.137097	374	454	0	7	80	0.0875000
NODE_7296_length_967_cov_19.137097	374	454	2	10	80	0.1250000
NODE_7296_length_967_cov_19.137097	374	454	4	63	80	0.7875000
NODE_7296_length_967_cov_19.137097	427	507	0	35	80	0.4375000
NODE_7296_length_967_cov_19.137097	427	507	2	23	80	0.2875000
NODE_7296_length_967_cov_19.137097	427	507	4	22	80	0.2750000
NODE_7296_length_967_cov_19.137097	503	583	0	80	80	1.0000000
NODE_7296_length_967_cov_19.137097	556	636	0	80	80	1.0000000
NODE_7297_length_967_cov_14.654378	453	533	0	74	80	0.9250000
NODE_7297_length_967_cov_14.654378	453	533	2	6	80	0.0750000
NODE_7297_length_967_cov_14.654378	506	586	0	21	80	0.2625000
NODE_7297_length_967_cov_14.654378	506	586	2	59	80	0.7375000
NODE_7298_length_967_cov_8.027650	280	360	0	80	80	1.0000000
NODE_7298_length_967_cov_8.027650	333	413	0	75	80	0.9375000
NODE_7298_length_967_cov_8.027650	333	413	2	5	80	0.0625000
NODE_7310_length_966_cov_43.154556	401	474	5	73	73	1.0000000
NODE_7310_length_966_cov_43.154556	447	527	2	3	80	0.0375000
NODE_7310_length_966_cov_43.154556	447	527	3	24	80	0.3000000
NODE_7310_length_966_cov_43.154556	447	527	4	4	80	0.0500000
NODE_7310_length_966_cov_43.154556	447	527	5	49	80	0.6125000
NODE_7311_length_966_cov_42.877739	477	557	0	19	80	0.2375000
NODE_7311_length_966_cov_42.877739	477	557	2	61	80	0.7625000
NODE_7311_length_966_cov_42.877739	530	610	0	72	80	0.9000000
NODE_7311_length_966_cov_42.877739	530	610	2	8	80	0.1000000
NODE_7312_length_966_cov_39.956171	283	363	0	73	80	0.9125000
NODE_7312_length_966_cov_39.956171	283	363	4	7	80	0.0875000
NODE_7312_length_966_cov_39.956171	336	416	0	80	80	1.0000000
NODE_7312_length_966_cov_39.956171	412	494	0	82	82	1.0000000
NODE_7312_length_966_cov_39.956171	467	547	0	80	80	1.0000000
NODE_7313_length_966_cov_36.160323	461	541	2	59	80	0.7375000
NODE_7313_length_966_cov_36.160323	461	541	4	21	80	0.2625000
NODE_7313_length_966_cov_36.160323	461	541	2	59	80	0.7375000
NODE_7313_length_966_cov_36.160323	461	541	4	21	80	0.2625000
NODE_7313_length_966_cov_36.160323	514	594	2	17	80	0.2125000
NODE_7313_length_966_cov_36.160323	514	594	4	51	80	0.6375000
NODE_7313_length_966_cov_36.160323	514	594	6	12	80	0.1500000
NODE_7314_length_966_cov_18.658593	408	488	2	52	80	0.6500000
NODE_7314_length_966_cov_18.658593	408	488	4	27	80	0.3375000
NODE_7314_length_966_cov_18.658593	408	488	6	1	80	0.0125000
NODE_7314_length_966_cov_18.658593	461	541	4	26	80	0.3250000
NODE_7314_length_966_cov_18.658593	461	541	6	18	80	0.2250000
NODE_7314_length_966_cov_18.658593	461	541	7	20	80	0.2500000
NODE_7314_length_966_cov_18.658593	461	541	8	16	80	0.2000000
NODE_7315_length_966_cov_17.606690	341	421	2	80	80	1.0000000
NODE_7315_length_966_cov_17.606690	394	474	0	41	80	0.5125000
NODE_7315_length_966_cov_17.606690	394	474	2	39	80	0.4875000
NODE_7316_length_966_cov_16.064591	296	376	0	5	80	0.0625000
NODE_7316_length_966_cov_16.064591	296	376	2	64	80	0.8000000
NODE_7316_length_966_cov_16.064591	296	376	4	11	80	0.1375000
NODE_7316_length_966_cov_16.064591	349	429	2	25	80	0.3125000
NODE_7316_length_966_cov_16.064591	349	429	4	55	80	0.6875000
NODE_7317_length_966_cov_15.155709	562	642	0	80	80	1.0000000
NODE_7317_length_966_cov_15.155709	615	695	0	80	80	1.0000000
NODE_7318_length_966_cov_7.726644	280	360	4	10	80	0.1250000
NODE_7318_length_966_cov_7.726644	280	360	6	35	80	0.4375000
NODE_7318_length_966_cov_7.726644	280	360	8	35	80	0.4375000
NODE_7318_length_966_cov_7.726644	334	414	2	2	80	0.0250000
NODE_7318_length_966_cov_7.726644	334	414	4	13	80	0.1625000
NODE_7318_length_966_cov_7.726644	334	414	6	21	80	0.2625000
NODE_7318_length_966_cov_7.726644	334	414	8	44	80	0.5500000
NODE_7335_length_965_cov_51.524249	197	277	0	8	80	0.1000000
NODE_7335_length_965_cov_51.524249	197	277	2	72	80	0.9000000
NODE_7335_length_965_cov_51.524249	250	327	0	12	77	0.1558442
NODE_7335_length_965_cov_51.524249	250	327	2	65	77	0.8441558
NODE_7335_length_965_cov_51.524249	329	406	0	54	77	0.7012987
NODE_7335_length_965_cov_51.524249	329	406	2	5	77	0.0649351
NODE_7335_length_965_cov_51.524249	329	406	4	18	77	0.2337662
NODE_7335_length_965_cov_51.524249	379	459	0	9	80	0.1125000
NODE_7335_length_965_cov_51.524249	379	459	4	71	80	0.8875000
NODE_7336_length_965_cov_18.072748	515	595	0	28	80	0.3500000
NODE_7336_length_965_cov_18.072748	515	595	2	41	80	0.5125000
NODE_7336_length_965_cov_18.072748	515	595	4	11	80	0.1375000
NODE_7336_length_965_cov_18.072748	568	648	2	41	80	0.5125000
NODE_7336_length_965_cov_18.072748	568	648	4	39	80	0.4875000
NODE_7337_length_965_cov_14.277136	342	422	0	23	80	0.2875000
NODE_7337_length_965_cov_14.277136	342	422	4	41	80	0.5125000
NODE_7337_length_965_cov_14.277136	342	422	5	16	80	0.2000000
NODE_7337_length_965_cov_14.277136	395	470	0	71	75	0.9466667
NODE_7337_length_965_cov_14.277136	395	470	4	4	75	0.0533333
NODE_7338_length_965_cov_7.808314	567	647	0	80	80	1.0000000
NODE_7338_length_965_cov_7.808314	620	700	0	80	80	1.0000000
NODE_7344_length_964_cov_60.153757	197	277	18	48	80	0.6000000
NODE_7344_length_964_cov_60.153757	197	277	20	3	80	0.0375000
NODE_7344_length_964_cov_60.153757	197	277	22	4	80	0.0500000
NODE_7344_length_964_cov_60.153757	197	277	23	6	80	0.0750000
NODE_7344_length_964_cov_60.153757	197	277	24	2	80	0.0250000
NODE_7344_length_964_cov_60.153757	197	277	26	4	80	0.0500000
NODE_7344_length_964_cov_60.153757	197	277	28	7	80	0.0875000
NODE_7344_length_964_cov_60.153757	197	277	30	6	80	0.0750000
NODE_7344_length_964_cov_60.153757	250	314	4	7	64	0.1093750
NODE_7344_length_964_cov_60.153757	250	314	6	7	64	0.1093750
NODE_7344_length_964_cov_60.153757	250	314	10	1	64	0.0156250
NODE_7344_length_964_cov_60.153757	250	314	14	1	64	0.0156250
NODE_7344_length_964_cov_60.153757	250	314	16	13	64	0.2031250
NODE_7344_length_964_cov_60.153757	250	314	18	35	64	0.5468750
NODE_7344_length_964_cov_60.153757	672	752	0	80	80	1.0000000
NODE_7344_length_964_cov_60.153757	725	805	0	80	80	1.0000000
NODE_7345_length_964_cov_45.564162	314	394	0	61	80	0.7625000
NODE_7345_length_964_cov_45.564162	314	394	1	19	80	0.2375000
NODE_7345_length_964_cov_45.564162	367	447	0	8	80	0.1000000
NODE_7345_length_964_cov_45.564162	367	447	1	72	80	0.9000000
NODE_7345_length_964_cov_45.564162	443	523	0	4	80	0.0500000
NODE_7345_length_964_cov_45.564162	443	523	1	12	80	0.1500000
NODE_7345_length_964_cov_45.564162	443	523	3	64	80	0.8000000
NODE_7345_length_964_cov_45.564162	496	566	0	47	70	0.6714286
NODE_7345_length_964_cov_45.564162	496	566	1	3	70	0.0428571
NODE_7345_length_964_cov_45.564162	496	566	3	20	70	0.2857143
NODE_7346_length_964_cov_33.487861	363	443	0	80	80	1.0000000
NODE_7346_length_964_cov_33.487861	416	496	0	80	80	1.0000000
NODE_7347_length_964_cov_33.077457	408	488	0	80	80	1.0000000
NODE_7347_length_964_cov_33.077457	461	541	0	80	80	1.0000000
NODE_7347_length_964_cov_33.077457	537	617	0	80	80	1.0000000
NODE_7347_length_964_cov_33.077457	590	670	0	80	80	1.0000000
NODE_7348_length_964_cov_29.250867	419	499	3	1	80	0.0125000
NODE_7348_length_964_cov_29.250867	419	499	6	2	80	0.0250000
NODE_7348_length_964_cov_29.250867	419	499	10	77	80	0.9625000
NODE_7348_length_964_cov_29.250867	472	552	6	40	80	0.5000000
NODE_7348_length_964_cov_29.250867	472	552	10	40	80	0.5000000
NODE_7349_length_964_cov_20.191908	228	301	0	73	73	1.0000000
NODE_7349_length_964_cov_20.191908	349	429	0	49	80	0.6125000
NODE_7349_length_964_cov_20.191908	349	429	2	31	80	0.3875000
NODE_7349_length_964_cov_20.191908	402	482	2	59	80	0.7375000
NODE_7349_length_964_cov_20.191908	402	482	4	21	80	0.2625000
NODE_7350_length_964_cov_18.510983	486	566	1	24	80	0.3000000
NODE_7350_length_964_cov_18.510983	486	566	2	24	80	0.3000000
NODE_7350_length_964_cov_18.510983	486	566	3	32	80	0.4000000
NODE_7350_length_964_cov_18.510983	539	619	0	27	80	0.3375000
NODE_7350_length_964_cov_18.510983	539	619	2	34	80	0.4250000
NODE_7350_length_964_cov_18.510983	539	619	3	19	80	0.2375000
NODE_7351_length_964_cov_16.613873	464	544	0	80	80	1.0000000
NODE_7351_length_964_cov_16.613873	517	597	0	41	80	0.5125000
NODE_7351_length_964_cov_16.613873	517	597	2	39	80	0.4875000
NODE_7352_length_964_cov_15.717919	411	491	0	80	80	1.0000000
NODE_7352_length_964_cov_15.717919	464	544	0	80	80	1.0000000
NODE_7352_length_964_cov_15.717919	540	620	0	80	80	1.0000000
NODE_7352_length_964_cov_15.717919	593	668	0	75	75	1.0000000
NODE_7353_length_964_cov_14.591908	521	601	0	80	80	1.0000000
NODE_7353_length_964_cov_14.591908	574	654	0	80	80	1.0000000
NODE_7354_length_964_cov_11.589595	475	555	0	12	80	0.1500000
NODE_7354_length_964_cov_11.589595	475	555	2	68	80	0.8500000
NODE_7354_length_964_cov_11.589595	528	608	0	65	80	0.8125000
NODE_7354_length_964_cov_11.589595	528	608	2	15	80	0.1875000
NODE_7355_length_964_cov_7.639306	420	500	0	55	80	0.6875000
NODE_7355_length_964_cov_7.639306	420	500	6	25	80	0.3125000
NODE_7355_length_964_cov_7.639306	473	553	0	2	80	0.0250000
NODE_7355_length_964_cov_7.639306	473	553	6	78	80	0.9750000
NODE_7356_length_964_cov_7.596532	534	614	0	45	80	0.5625000
NODE_7356_length_964_cov_7.596532	534	614	4	35	80	0.4375000
NODE_7356_length_964_cov_7.596532	587	667	4	80	80	1.0000000
NODE_7357_length_964_cov_6.568786	368	448	0	80	80	1.0000000
NODE_7357_length_964_cov_6.568786	421	501	0	80	80	1.0000000
NODE_7359_length_964_cov_6.027746	890	940	12	9	50	0.1800000
NODE_7359_length_964_cov_6.027746	890	940	14	2	50	0.0400000
NODE_7359_length_964_cov_6.027746	890	940	16	4	50	0.0800000
NODE_7359_length_964_cov_6.027746	890	940	18	9	50	0.1800000
NODE_7359_length_964_cov_6.027746	890	940	20	26	50	0.5200000
NODE_7361_length_964_cov_4.665896	706	772	0	66	66	1.0000000
NODE_7376_length_963_cov_66.251157	456	536	0	16	80	0.2000000
NODE_7376_length_963_cov_66.251157	456	536	2	25	80	0.3125000
NODE_7376_length_963_cov_66.251157	456	536	4	39	80	0.4875000
NODE_7376_length_963_cov_66.251157	509	589	0	62	80	0.7750000
NODE_7376_length_963_cov_66.251157	509	589	2	11	80	0.1375000
NODE_7376_length_963_cov_66.251157	509	589	4	7	80	0.0875000
NODE_7376_length_963_cov_66.251157	585	665	4	8	80	0.1000000
NODE_7376_length_963_cov_66.251157	585	665	12	30	80	0.3750000
NODE_7376_length_963_cov_66.251157	585	665	13	12	80	0.1500000
NODE_7376_length_963_cov_66.251157	585	665	14	30	80	0.3750000
NODE_7376_length_963_cov_66.251157	638	718	0	14	80	0.1750000
NODE_7376_length_963_cov_66.251157	638	718	8	20	80	0.2500000
NODE_7376_length_963_cov_66.251157	638	718	11	10	80	0.1250000
NODE_7376_length_963_cov_66.251157	638	718	13	21	80	0.2625000
NODE_7376_length_963_cov_66.251157	638	718	14	15	80	0.1875000
NODE_7377_length_963_cov_35.638889	381	461	2	18	80	0.2250000
NODE_7377_length_963_cov_35.638889	381	461	4	15	80	0.1875000
NODE_7377_length_963_cov_35.638889	381	461	5	1	80	0.0125000
NODE_7377_length_963_cov_35.638889	381	461	6	46	80	0.5750000
NODE_7377_length_963_cov_35.638889	434	514	0	24	80	0.3000000
NODE_7377_length_963_cov_35.638889	434	514	2	47	80	0.5875000
NODE_7377_length_963_cov_35.638889	434	514	5	1	80	0.0125000
NODE_7377_length_963_cov_35.638889	434	514	6	8	80	0.1000000
NODE_7377_length_963_cov_35.638889	510	590	0	33	80	0.4125000
NODE_7377_length_963_cov_35.638889	510	590	2	47	80	0.5875000
NODE_7377_length_963_cov_35.638889	563	643	2	80	80	1.0000000
NODE_7378_length_963_cov_33.642361	347	427	0	80	80	1.0000000
NODE_7378_length_963_cov_33.642361	400	480	0	34	80	0.4250000
NODE_7378_length_963_cov_33.642361	400	480	2	46	80	0.5750000
NODE_7379_length_963_cov_18.626157	392	472	2	19	80	0.2375000
NODE_7379_length_963_cov_18.626157	392	472	4	61	80	0.7625000
NODE_7379_length_963_cov_18.626157	445	525	0	41	80	0.5125000
NODE_7379_length_963_cov_18.626157	445	525	2	4	80	0.0500000
NODE_7379_length_963_cov_18.626157	445	525	4	35	80	0.4375000
NODE_7380_length_963_cov_17.750000	402	482	14	5	80	0.0625000
NODE_7380_length_963_cov_17.750000	402	482	16	4	80	0.0500000
NODE_7380_length_963_cov_17.750000	402	482	17	9	80	0.1125000
NODE_7380_length_963_cov_17.750000	402	482	19	28	80	0.3500000
NODE_7380_length_963_cov_17.750000	402	482	20	34	80	0.4250000
NODE_7380_length_963_cov_17.750000	455	535	0	37	80	0.4625000
NODE_7380_length_963_cov_17.750000	455	535	10	5	80	0.0625000
NODE_7380_length_963_cov_17.750000	455	535	14	16	80	0.2000000
NODE_7380_length_963_cov_17.750000	455	535	16	4	80	0.0500000
NODE_7380_length_963_cov_17.750000	455	535	20	18	80	0.2250000
NODE_7381_length_963_cov_17.023148	542	622	0	15	80	0.1875000
NODE_7381_length_963_cov_17.023148	542	622	10	65	80	0.8125000
NODE_7381_length_963_cov_17.023148	595	675	10	80	80	1.0000000
NODE_7382_length_963_cov_16.642361	481	561	0	80	80	1.0000000
NODE_7382_length_963_cov_16.642361	534	614	0	58	80	0.7250000
NODE_7382_length_963_cov_16.642361	534	614	2	22	80	0.2750000
NODE_7382_length_963_cov_16.642361	572	629	0	20	57	0.3508772
NODE_7382_length_963_cov_16.642361	572	629	2	37	57	0.6491228
NODE_7383_length_963_cov_14.961806	283	363	0	80	80	1.0000000
NODE_7383_length_963_cov_14.961806	336	416	0	80	80	1.0000000
NODE_7384_length_963_cov_13.341435	558	638	0	80	80	1.0000000
NODE_7384_length_963_cov_13.341435	611	691	0	80	80	1.0000000
NODE_7386_length_963_cov_9.520833	459	539	0	80	80	1.0000000
NODE_7386_length_963_cov_9.520833	512	592	0	80	80	1.0000000
NODE_7386_length_963_cov_9.520833	588	662	0	74	74	1.0000000
NODE_7386_length_963_cov_9.520833	641	724	0	83	83	1.0000000
NODE_7388_length_963_cov_7.510417	781	842	17	2	61	0.0327869
NODE_7388_length_963_cov_7.510417	781	842	22	2	61	0.0327869
NODE_7388_length_963_cov_7.510417	781	842	26	3	61	0.0491803
NODE_7388_length_963_cov_7.510417	781	842	32	1	61	0.0163934
NODE_7388_length_963_cov_7.510417	781	842	34	6	61	0.0983607
NODE_7388_length_963_cov_7.510417	781	842	36	2	61	0.0327869
NODE_7388_length_963_cov_7.510417	781	842	49	2	61	0.0327869
NODE_7388_length_963_cov_7.510417	781	842	51	4	61	0.0655738
NODE_7388_length_963_cov_7.510417	781	842	62	1	61	0.0163934
NODE_7388_length_963_cov_7.510417	781	842	64	1	61	0.0163934
NODE_7388_length_963_cov_7.510417	781	842	70	1	61	0.0163934
NODE_7388_length_963_cov_7.510417	781	842	74	8	61	0.1311475
NODE_7388_length_963_cov_7.510417	781	842	78	4	61	0.0655738
NODE_7388_length_963_cov_7.510417	781	842	79	1	61	0.0163934
NODE_7388_length_963_cov_7.510417	781	842	80	1	61	0.0163934
NODE_7388_length_963_cov_7.510417	781	842	82	4	61	0.0655738
NODE_7388_length_963_cov_7.510417	781	842	96	14	61	0.2295082
NODE_7388_length_963_cov_7.510417	781	842	98	4	61	0.0655738
NODE_7388_length_963_cov_7.510417	815	894	78	3	79	0.0379747
NODE_7388_length_963_cov_7.510417	815	894	79	1	79	0.0126582
NODE_7388_length_963_cov_7.510417	815	894	80	1	79	0.0126582
NODE_7388_length_963_cov_7.510417	815	894	82	4	79	0.0506329
NODE_7388_length_963_cov_7.510417	815	894	89	7	79	0.0886076
NODE_7388_length_963_cov_7.510417	815	894	91	2	79	0.0253165
NODE_7388_length_963_cov_7.510417	815	894	96	14	79	0.1772152
NODE_7388_length_963_cov_7.510417	815	894	97	14	79	0.1772152
NODE_7388_length_963_cov_7.510417	815	894	98	10	79	0.1265823
NODE_7388_length_963_cov_7.510417	815	894	99	23	79	0.2911392
NODE_7392_length_963_cov_3.755787	378	458	0	14	80	0.1750000
NODE_7392_length_963_cov_3.755787	378	458	2	66	80	0.8250000
NODE_7392_length_963_cov_3.755787	431	511	2	80	80	1.0000000
NODE_7397_length_963_cov_1.931713	426	485	2	44	59	0.7457627
NODE_7397_length_963_cov_1.931713	426	485	4	15	59	0.2542373
NODE_7404_length_962_cov_37.169177	356	436	0	15	80	0.1875000
NODE_7404_length_962_cov_37.169177	356	436	2	23	80	0.2875000
NODE_7404_length_962_cov_37.169177	356	436	4	17	80	0.2125000
NODE_7404_length_962_cov_37.169177	356	436	6	25	80	0.3125000
NODE_7404_length_962_cov_37.169177	409	489	4	50	80	0.6250000
NODE_7404_length_962_cov_37.169177	409	489	6	30	80	0.3750000
NODE_7405_length_962_cov_28.852839	474	554	0	59	80	0.7375000
NODE_7405_length_962_cov_28.852839	474	554	2	21	80	0.2625000
NODE_7405_length_962_cov_28.852839	527	607	0	6	80	0.0750000
NODE_7405_length_962_cov_28.852839	527	607	2	74	80	0.9250000
NODE_7405_length_962_cov_28.852839	603	683	0	63	80	0.7875000
NODE_7405_length_962_cov_28.852839	603	683	2	17	80	0.2125000
NODE_7405_length_962_cov_28.852839	656	736	0	80	80	1.0000000
NODE_7406_length_962_cov_27.859791	441	521	0	13	80	0.1625000
NODE_7406_length_962_cov_27.859791	441	521	1	25	80	0.3125000
NODE_7406_length_962_cov_27.859791	441	521	2	26	80	0.3250000
NODE_7406_length_962_cov_27.859791	441	521	4	16	80	0.2000000
NODE_7406_length_962_cov_27.859791	494	574	2	47	80	0.5875000
NODE_7406_length_962_cov_27.859791	494	574	4	33	80	0.4125000
NODE_7407_length_962_cov_21.019699	318	398	2	74	80	0.9250000
NODE_7407_length_962_cov_21.019699	318	398	4	6	80	0.0750000
NODE_7407_length_962_cov_21.019699	371	451	2	68	80	0.8500000
NODE_7407_length_962_cov_21.019699	371	451	4	12	80	0.1500000
NODE_7408_length_962_cov_16.792584	350	430	2	74	80	0.9250000
NODE_7408_length_962_cov_16.792584	350	430	4	6	80	0.0750000
NODE_7408_length_962_cov_16.792584	403	483	2	55	80	0.6875000
NODE_7408_length_962_cov_16.792584	403	483	4	25	80	0.3125000
NODE_7409_length_962_cov_14.650058	477	557	4	80	80	1.0000000
NODE_7409_length_962_cov_14.650058	530	610	0	27	80	0.3375000
NODE_7409_length_962_cov_14.650058	530	610	4	53	80	0.6625000
NODE_7410_length_962_cov_7.993048	308	345	2	37	37	1.0000000
NODE_7411_length_962_cov_7.835458	447	527	0	10	80	0.1250000
NODE_7411_length_962_cov_7.835458	447	527	2	41	80	0.5125000
NODE_7411_length_962_cov_7.835458	447	527	4	29	80	0.3625000
NODE_7411_length_962_cov_7.835458	500	580	2	45	80	0.5625000
NODE_7411_length_962_cov_7.835458	500	580	4	35	80	0.4375000
NODE_7412_length_962_cov_6.855156	490	570	2	51	80	0.6375000
NODE_7412_length_962_cov_6.855156	490	570	4	29	80	0.3625000
NODE_7412_length_962_cov_6.855156	543	623	0	7	80	0.0875000
NODE_7412_length_962_cov_6.855156	543	623	1	11	80	0.1375000
NODE_7412_length_962_cov_6.855156	543	623	2	59	80	0.7375000
NODE_7412_length_962_cov_6.855156	543	623	4	3	80	0.0375000
NODE_7417_length_962_cov_1.840093	88	151	2	2	63	0.0317460
NODE_7417_length_962_cov_1.840093	88	151	8	1	63	0.0158730
NODE_7417_length_962_cov_1.840093	88	151	16	1	63	0.0158730
NODE_7417_length_962_cov_1.840093	88	151	22	2	63	0.0317460
NODE_7417_length_962_cov_1.840093	88	151	30	1	63	0.0158730
NODE_7417_length_962_cov_1.840093	88	151	39	1	63	0.0158730
NODE_7417_length_962_cov_1.840093	88	151	42	1	63	0.0158730
NODE_7417_length_962_cov_1.840093	88	151	46	1	63	0.0158730
NODE_7417_length_962_cov_1.840093	88	151	52	2	63	0.0317460
NODE_7417_length_962_cov_1.840093	88	151	60	1	63	0.0158730
NODE_7417_length_962_cov_1.840093	88	151	62	4	63	0.0634921
NODE_7417_length_962_cov_1.840093	88	151	74	2	63	0.0317460
NODE_7417_length_962_cov_1.840093	88	151	82	3	63	0.0476190
NODE_7417_length_962_cov_1.840093	88	151	86	1	63	0.0158730
NODE_7417_length_962_cov_1.840093	88	151	88	8	63	0.1269841
NODE_7417_length_962_cov_1.840093	88	151	92	6	63	0.0952381
NODE_7417_length_962_cov_1.840093	88	151	94	1	63	0.0158730
NODE_7417_length_962_cov_1.840093	88	151	96	8	63	0.1269841
NODE_7417_length_962_cov_1.840093	88	151	98	1	63	0.0158730
NODE_7417_length_962_cov_1.840093	88	151	100	1	63	0.0158730
NODE_7417_length_962_cov_1.840093	88	151	102	1	63	0.0158730
NODE_7417_length_962_cov_1.840093	88	151	106	3	63	0.0476190
NODE_7417_length_962_cov_1.840093	88	151	108	6	63	0.0952381
NODE_7417_length_962_cov_1.840093	88	151	112	5	63	0.0793651
NODE_7422_length_961_cov_61.019722	453	533	0	66	80	0.8250000
NODE_7422_length_961_cov_61.019722	453	533	10	14	80	0.1750000
NODE_7422_length_961_cov_61.019722	506	586	0	13	80	0.1625000
NODE_7422_length_961_cov_61.019722	506	586	9	1	80	0.0125000
NODE_7422_length_961_cov_61.019722	506	586	10	66	80	0.8250000
NODE_7422_length_961_cov_61.019722	614	672	0	58	58	1.0000000
NODE_7423_length_961_cov_51.005800	334	414	32	15	80	0.1875000
NODE_7423_length_961_cov_51.005800	334	414	34	11	80	0.1375000
NODE_7423_length_961_cov_51.005800	334	414	35	10	80	0.1250000
NODE_7423_length_961_cov_51.005800	334	414	36	44	80	0.5500000
NODE_7423_length_961_cov_51.005800	387	467	0	21	80	0.2625000
NODE_7423_length_961_cov_51.005800	387	467	17	1	80	0.0125000
NODE_7423_length_961_cov_51.005800	387	467	18	14	80	0.1750000
NODE_7423_length_961_cov_51.005800	387	467	19	1	80	0.0125000
NODE_7423_length_961_cov_51.005800	387	467	28	1	80	0.0125000
NODE_7423_length_961_cov_51.005800	387	467	33	14	80	0.1750000
NODE_7423_length_961_cov_51.005800	387	467	34	7	80	0.0875000
NODE_7423_length_961_cov_51.005800	387	467	36	21	80	0.2625000
NODE_7424_length_961_cov_45.923434	391	471	4	3	80	0.0375000
NODE_7424_length_961_cov_45.923434	391	471	6	47	80	0.5875000
NODE_7424_length_961_cov_45.923434	391	471	17	1	80	0.0125000
NODE_7424_length_961_cov_45.923434	391	471	25	1	80	0.0125000
NODE_7424_length_961_cov_45.923434	391	471	27	28	80	0.3500000
NODE_7424_length_961_cov_45.923434	444	524	25	6	80	0.0750000
NODE_7424_length_961_cov_45.923434	444	524	26	10	80	0.1250000
NODE_7424_length_961_cov_45.923434	444	524	27	32	80	0.4000000
NODE_7424_length_961_cov_45.923434	444	524	28	31	80	0.3875000
NODE_7424_length_961_cov_45.923434	444	524	29	1	80	0.0125000
NODE_7426_length_961_cov_21.410673	313	393	0	80	80	1.0000000
NODE_7426_length_961_cov_21.410673	366	446	0	80	80	1.0000000
NODE_7427_length_961_cov_18.592807	403	483	0	80	80	1.0000000
NODE_7427_length_961_cov_18.592807	456	536	0	80	80	1.0000000
NODE_7428_length_961_cov_17.701856	433	513	2	15	80	0.1875000
NODE_7428_length_961_cov_17.701856	433	513	4	65	80	0.8125000
NODE_7428_length_961_cov_17.701856	486	566	2	39	80	0.4875000
NODE_7428_length_961_cov_17.701856	486	566	4	41	80	0.5125000
NODE_7429_length_961_cov_17.020882	505	585	0	80	80	1.0000000
NODE_7429_length_961_cov_17.020882	558	638	0	80	80	1.0000000
NODE_7430_length_961_cov_16.235499	328	408	0	80	80	1.0000000
NODE_7430_length_961_cov_16.235499	381	461	0	66	80	0.8250000
NODE_7430_length_961_cov_16.235499	381	461	2	14	80	0.1750000
NODE_7432_length_961_cov_12.968677	347	427	0	80	80	1.0000000
NODE_7432_length_961_cov_12.968677	400	480	0	80	80	1.0000000
NODE_7433_length_961_cov_9.875870	439	519	2	80	80	1.0000000
NODE_7433_length_961_cov_9.875870	492	572	0	28	80	0.3500000
NODE_7433_length_961_cov_9.875870	492	572	2	52	80	0.6500000
NODE_7434_length_961_cov_6.172854	624	704	0	80	80	1.0000000
NODE_7434_length_961_cov_6.172854	677	757	0	80	80	1.0000000
NODE_7435_length_961_cov_4.553364	451	531	0	80	80	1.0000000
NODE_7435_length_961_cov_4.553364	504	584	0	80	80	1.0000000
NODE_7440_length_960_cov_35.649245	65	145	0	80	80	1.0000000
NODE_7440_length_960_cov_35.649245	118	198	0	27	80	0.3375000
NODE_7440_length_960_cov_35.649245	118	198	2	6	80	0.0750000
NODE_7440_length_960_cov_35.649245	118	198	4	47	80	0.5875000
NODE_7440_length_960_cov_35.649245	446	526	0	30	80	0.3750000
NODE_7440_length_960_cov_35.649245	446	526	2	50	80	0.6250000
NODE_7440_length_960_cov_35.649245	499	579	0	80	80	1.0000000
NODE_7441_length_960_cov_34.886179	386	466	0	3	80	0.0375000
NODE_7441_length_960_cov_34.886179	386	466	6	5	80	0.0625000
NODE_7441_length_960_cov_34.886179	386	466	8	72	80	0.9000000
NODE_7441_length_960_cov_34.886179	439	519	0	56	80	0.7000000
NODE_7441_length_960_cov_34.886179	439	519	6	5	80	0.0625000
NODE_7441_length_960_cov_34.886179	439	519	8	19	80	0.2375000
NODE_7443_length_960_cov_25.133566	413	493	0	80	80	1.0000000
NODE_7443_length_960_cov_25.133566	466	546	0	28	80	0.3500000
NODE_7443_length_960_cov_25.133566	466	546	2	38	80	0.4750000
NODE_7443_length_960_cov_25.133566	466	546	4	14	80	0.1750000
NODE_7444_length_960_cov_19.336818	385	465	4	21	80	0.2625000
NODE_7444_length_960_cov_19.336818	385	465	7	25	80	0.3125000
NODE_7444_length_960_cov_19.336818	385	465	8	21	80	0.2625000
NODE_7444_length_960_cov_19.336818	385	465	9	4	80	0.0500000
NODE_7444_length_960_cov_19.336818	385	465	12	9	80	0.1125000
NODE_7444_length_960_cov_19.336818	438	518	6	12	80	0.1500000
NODE_7444_length_960_cov_19.336818	438	518	8	62	80	0.7750000
NODE_7444_length_960_cov_19.336818	438	518	12	6	80	0.0750000
NODE_7445_length_960_cov_13.221835	460	539	3	77	79	0.9746835
NODE_7445_length_960_cov_13.221835	460	539	5	2	79	0.0253165
NODE_7445_length_960_cov_13.221835	512	592	3	33	80	0.4125000
NODE_7445_length_960_cov_13.221835	512	592	5	47	80	0.5875000
NODE_7446_length_960_cov_12.804878	347	427	0	47	80	0.5875000
NODE_7446_length_960_cov_12.804878	347	427	2	33	80	0.4125000
NODE_7446_length_960_cov_12.804878	400	480	0	16	80	0.2000000
NODE_7446_length_960_cov_12.804878	400	480	2	64	80	0.8000000
NODE_7462_length_959_cov_39.394186	326	406	0	30	80	0.3750000
NODE_7462_length_959_cov_39.394186	326	406	2	50	80	0.6250000
NODE_7462_length_959_cov_39.394186	379	459	0	80	80	1.0000000
NODE_7463_length_959_cov_28.895349	327	407	0	15	80	0.1875000
NODE_7463_length_959_cov_28.895349	327	407	2	65	80	0.8125000
NODE_7463_length_959_cov_28.895349	380	460	0	22	80	0.2750000
NODE_7463_length_959_cov_28.895349	380	460	2	58	80	0.7250000
NODE_7464_length_959_cov_26.634884	563	643	0	6	80	0.0750000
NODE_7464_length_959_cov_26.634884	563	643	4	74	80	0.9250000
NODE_7464_length_959_cov_26.634884	616	696	0	59	80	0.7375000
NODE_7464_length_959_cov_26.634884	616	696	4	21	80	0.2625000
NODE_7464_length_959_cov_26.634884	692	772	0	43	80	0.5375000
NODE_7464_length_959_cov_26.634884	692	772	2	37	80	0.4625000
NODE_7464_length_959_cov_26.634884	745	825	0	17	80	0.2125000
NODE_7464_length_959_cov_26.634884	745	825	2	63	80	0.7875000
NODE_7465_length_959_cov_18.862791	320	400	0	80	80	1.0000000
NODE_7465_length_959_cov_18.862791	373	453	0	80	80	1.0000000
NODE_7466_length_959_cov_17.910465	358	438	0	80	80	1.0000000
NODE_7466_length_959_cov_17.910465	411	491	0	80	80	1.0000000
NODE_7467_length_959_cov_15.337209	267	347	0	55	80	0.6875000
NODE_7467_length_959_cov_15.337209	267	347	2	7	80	0.0875000
NODE_7467_length_959_cov_15.337209	267	347	4	4	80	0.0500000
NODE_7467_length_959_cov_15.337209	267	347	6	1	80	0.0125000
NODE_7467_length_959_cov_15.337209	267	347	8	13	80	0.1625000
NODE_7467_length_959_cov_15.337209	320	400	0	2	80	0.0250000
NODE_7467_length_959_cov_15.337209	320	400	2	7	80	0.0875000
NODE_7467_length_959_cov_15.337209	320	400	4	4	80	0.0500000
NODE_7467_length_959_cov_15.337209	320	400	6	1	80	0.0125000
NODE_7467_length_959_cov_15.337209	320	400	8	30	80	0.3750000
NODE_7467_length_959_cov_15.337209	320	400	11	34	80	0.4250000
NODE_7467_length_959_cov_15.337209	320	400	12	2	80	0.0250000
NODE_7468_length_959_cov_9.005814	529	609	4	62	80	0.7750000
NODE_7468_length_959_cov_9.005814	529	609	6	18	80	0.2250000
NODE_7468_length_959_cov_9.005814	582	662	2	48	80	0.6000000
NODE_7468_length_959_cov_9.005814	582	662	4	9	80	0.1125000
NODE_7468_length_959_cov_9.005814	582	662	6	23	80	0.2875000
NODE_7469_length_959_cov_8.163953	392	472	1	3	80	0.0375000
NODE_7469_length_959_cov_8.163953	392	472	4	57	80	0.7125000
NODE_7469_length_959_cov_8.163953	392	472	5	20	80	0.2500000
NODE_7469_length_959_cov_8.163953	445	525	0	9	80	0.1125000
NODE_7469_length_959_cov_8.163953	445	525	4	71	80	0.8875000
NODE_7470_length_959_cov_7.097674	401	481	0	80	80	1.0000000
NODE_7470_length_959_cov_7.097674	454	534	0	80	80	1.0000000
NODE_7472_length_959_cov_4.603488	596	676	0	47	80	0.5875000
NODE_7472_length_959_cov_4.603488	596	676	2	20	80	0.2500000
NODE_7472_length_959_cov_4.603488	596	676	4	13	80	0.1625000
NODE_7472_length_959_cov_4.603488	649	729	2	14	80	0.1750000
NODE_7472_length_959_cov_4.603488	649	729	4	15	80	0.1875000
NODE_7472_length_959_cov_4.603488	649	729	8	11	80	0.1375000
NODE_7472_length_959_cov_4.603488	649	729	10	40	80	0.5000000
NODE_7486_length_958_cov_57.015134	328	408	0	31	80	0.3875000
NODE_7486_length_958_cov_57.015134	328	408	2	34	80	0.4250000
NODE_7486_length_958_cov_57.015134	328	408	4	15	80	0.1875000
NODE_7486_length_958_cov_57.015134	381	461	2	31	80	0.3875000
NODE_7486_length_958_cov_57.015134	381	461	4	49	80	0.6125000
NODE_7486_length_958_cov_57.015134	457	537	0	63	80	0.7875000
NODE_7486_length_958_cov_57.015134	457	537	2	17	80	0.2125000
NODE_7486_length_958_cov_57.015134	510	590	0	22	80	0.2750000
NODE_7486_length_958_cov_57.015134	510	590	2	58	80	0.7250000
NODE_7487_length_958_cov_42.265425	418	498	4	16	80	0.2000000
NODE_7487_length_958_cov_42.265425	418	498	6	58	80	0.7250000
NODE_7487_length_958_cov_42.265425	418	498	8	6	80	0.0750000
NODE_7487_length_958_cov_42.265425	471	551	2	45	80	0.5625000
NODE_7487_length_958_cov_42.265425	471	551	4	4	80	0.0500000
NODE_7487_length_958_cov_42.265425	471	551	6	21	80	0.2625000
NODE_7487_length_958_cov_42.265425	471	551	8	10	80	0.1250000
NODE_7488_length_958_cov_28.618161	336	416	19	21	80	0.2625000
NODE_7488_length_958_cov_28.618161	336	416	26	42	80	0.5250000
NODE_7488_length_958_cov_28.618161	336	416	27	11	80	0.1375000
NODE_7488_length_958_cov_28.618161	336	416	28	4	80	0.0500000
NODE_7488_length_958_cov_28.618161	336	416	29	2	80	0.0250000
NODE_7488_length_958_cov_28.618161	389	469	2	2	80	0.0250000
NODE_7488_length_958_cov_28.618161	389	469	4	21	80	0.2625000
NODE_7488_length_958_cov_28.618161	389	469	18	26	80	0.3250000
NODE_7488_length_958_cov_28.618161	389	469	19	25	80	0.3125000
NODE_7488_length_958_cov_28.618161	389	469	27	4	80	0.0500000
NODE_7488_length_958_cov_28.618161	389	469	29	2	80	0.0250000
NODE_7488_length_958_cov_28.618161	465	545	0	67	80	0.8375000
NODE_7488_length_958_cov_28.618161	465	545	2	6	80	0.0750000
NODE_7488_length_958_cov_28.618161	465	545	4	7	80	0.0875000
NODE_7488_length_958_cov_28.618161	518	598	0	22	80	0.2750000
NODE_7488_length_958_cov_28.618161	518	598	4	58	80	0.7250000
NODE_7489_length_958_cov_16.452852	446	526	2	4	80	0.0500000
NODE_7489_length_958_cov_16.452852	446	526	4	13	80	0.1625000
NODE_7489_length_958_cov_16.452852	446	526	6	57	80	0.7125000
NODE_7489_length_958_cov_16.452852	446	526	8	6	80	0.0750000
NODE_7489_length_958_cov_16.452852	499	579	0	30	80	0.3750000
NODE_7489_length_958_cov_16.452852	499	579	2	27	80	0.3375000
NODE_7489_length_958_cov_16.452852	499	579	4	13	80	0.1625000
NODE_7489_length_958_cov_16.452852	499	579	6	10	80	0.1250000
NODE_7490_length_958_cov_16.008149	446	526	0	69	80	0.8625000
NODE_7490_length_958_cov_16.008149	446	526	6	11	80	0.1375000
NODE_7490_length_958_cov_16.008149	499	579	0	16	80	0.2000000
NODE_7490_length_958_cov_16.008149	499	579	6	64	80	0.8000000
NODE_7491_length_958_cov_14.154831	516	596	1	4	80	0.0500000
NODE_7491_length_958_cov_14.154831	516	596	2	50	80	0.6250000
NODE_7491_length_958_cov_14.154831	516	596	3	26	80	0.3250000
NODE_7491_length_958_cov_14.154831	569	649	0	11	80	0.1375000
NODE_7491_length_958_cov_14.154831	569	649	2	69	80	0.8625000
NODE_7492_length_958_cov_12.381839	454	534	0	40	80	0.5000000
NODE_7492_length_958_cov_12.381839	454	534	2	40	80	0.5000000
NODE_7492_length_958_cov_12.381839	507	587	0	2	80	0.0250000
NODE_7492_length_958_cov_12.381839	507	587	2	78	80	0.9750000
NODE_7493_length_958_cov_11.782305	479	559	0	41	80	0.5125000
NODE_7493_length_958_cov_11.782305	479	559	4	39	80	0.4875000
NODE_7493_length_958_cov_11.782305	532	612	0	16	80	0.2000000
NODE_7493_length_958_cov_11.782305	532	612	4	64	80	0.8000000
NODE_7501_length_957_cov_40.837995	746	826	0	80	80	1.0000000
NODE_7501_length_957_cov_40.837995	799	879	0	80	80	1.0000000
NODE_7502_length_957_cov_25.976690	631	711	6	21	80	0.2625000
NODE_7502_length_957_cov_25.976690	631	711	8	13	80	0.1625000
NODE_7502_length_957_cov_25.976690	631	711	10	41	80	0.5125000
NODE_7502_length_957_cov_25.976690	631	711	11	1	80	0.0125000
NODE_7502_length_957_cov_25.976690	631	711	12	4	80	0.0500000
NODE_7502_length_957_cov_25.976690	684	764	0	23	80	0.2875000
NODE_7502_length_957_cov_25.976690	684	764	2	2	80	0.0250000
NODE_7502_length_957_cov_25.976690	684	764	6	21	80	0.2625000
NODE_7502_length_957_cov_25.976690	684	764	8	15	80	0.1875000
NODE_7502_length_957_cov_25.976690	684	764	10	19	80	0.2375000
NODE_7503_length_957_cov_25.855478	57	131	0	2	74	0.0270270
NODE_7503_length_957_cov_25.855478	57	131	4	12	74	0.1621622
NODE_7503_length_957_cov_25.855478	57	131	6	60	74	0.8108108
NODE_7503_length_957_cov_25.855478	414	494	0	57	80	0.7125000
NODE_7503_length_957_cov_25.855478	414	494	4	23	80	0.2875000
NODE_7503_length_957_cov_25.855478	467	547	0	4	80	0.0500000
NODE_7503_length_957_cov_25.855478	467	547	4	76	80	0.9500000
NODE_7504_length_957_cov_24.625874	445	525	9	1	80	0.0125000
NODE_7504_length_957_cov_24.625874	445	525	10	17	80	0.2125000
NODE_7504_length_957_cov_24.625874	445	525	12	37	80	0.4625000
NODE_7504_length_957_cov_24.625874	445	525	13	1	80	0.0125000
NODE_7504_length_957_cov_24.625874	445	525	16	24	80	0.3000000
NODE_7504_length_957_cov_24.625874	498	578	3	15	80	0.1875000
NODE_7504_length_957_cov_24.625874	498	578	6	5	80	0.0625000
NODE_7504_length_957_cov_24.625874	498	578	10	50	80	0.6250000
NODE_7504_length_957_cov_24.625874	498	578	12	10	80	0.1250000
NODE_7505_length_957_cov_19.955711	286	366	0	80	80	1.0000000
NODE_7505_length_957_cov_19.955711	339	419	0	80	80	1.0000000
NODE_7506_length_957_cov_18.861305	414	494	0	7	80	0.0875000
NODE_7506_length_957_cov_18.861305	414	494	4	43	80	0.5375000
NODE_7506_length_957_cov_18.861305	414	494	8	30	80	0.3750000
NODE_7506_length_957_cov_18.861305	467	547	0	17	80	0.2125000
NODE_7506_length_957_cov_18.861305	467	547	4	18	80	0.2250000
NODE_7506_length_957_cov_18.861305	467	547	8	45	80	0.5625000
NODE_7507_length_957_cov_17.356643	361	441	0	69	80	0.8625000
NODE_7507_length_957_cov_17.356643	361	441	2	11	80	0.1375000
NODE_7507_length_957_cov_17.356643	414	494	0	22	80	0.2750000
NODE_7507_length_957_cov_17.356643	414	494	2	58	80	0.7250000
NODE_7508_length_957_cov_13.569930	162	242	0	80	80	1.0000000
NODE_7508_length_957_cov_13.569930	215	299	0	84	84	1.0000000
NODE_7509_length_957_cov_12.334499	314	394	0	63	80	0.7875000
NODE_7509_length_957_cov_12.334499	314	394	6	17	80	0.2125000
NODE_7509_length_957_cov_12.334499	367	447	0	10	80	0.1250000
NODE_7509_length_957_cov_12.334499	367	447	6	70	80	0.8750000
NODE_7510_length_957_cov_12.017483	173	253	0	80	80	1.0000000
NODE_7510_length_957_cov_12.017483	226	306	0	32	80	0.4000000
NODE_7510_length_957_cov_12.017483	226	306	2	48	80	0.6000000
NODE_7511_length_957_cov_10.026807	446	526	0	80	80	1.0000000
NODE_7511_length_957_cov_10.026807	499	579	0	39	80	0.4875000
NODE_7511_length_957_cov_10.026807	499	579	2	41	80	0.5125000
NODE_7529_length_956_cov_48.047841	479	559	0	39	80	0.4875000
NODE_7529_length_956_cov_48.047841	479	559	4	41	80	0.5125000
NODE_7529_length_956_cov_48.047841	532	612	0	2	80	0.0250000
NODE_7529_length_956_cov_48.047841	532	612	4	78	80	0.9750000
NODE_7529_length_956_cov_48.047841	608	688	0	4	80	0.0500000
NODE_7529_length_956_cov_48.047841	608	688	2	27	80	0.3375000
NODE_7529_length_956_cov_48.047841	608	688	4	32	80	0.4000000
NODE_7529_length_956_cov_48.047841	608	688	6	17	80	0.2125000
NODE_7529_length_956_cov_48.047841	661	741	4	17	80	0.2125000
NODE_7529_length_956_cov_48.047841	661	741	6	52	80	0.6500000
NODE_7529_length_956_cov_48.047841	661	741	8	11	80	0.1375000
NODE_7530_length_956_cov_34.539090	298	378	0	13	80	0.1625000
NODE_7530_length_956_cov_34.539090	298	378	2	67	80	0.8375000
NODE_7530_length_956_cov_34.539090	351	431	0	9	80	0.1125000
NODE_7530_length_956_cov_34.539090	351	431	2	71	80	0.8875000
NODE_7530_length_956_cov_34.539090	427	507	0	80	80	1.0000000
NODE_7530_length_956_cov_34.539090	480	560	0	80	80	1.0000000
NODE_7531_length_956_cov_24.355893	398	478	0	80	80	1.0000000
NODE_7531_length_956_cov_24.355893	451	531	0	80	80	1.0000000
NODE_7532_length_956_cov_21.940490	373	453	0	73	80	0.9125000
NODE_7532_length_956_cov_21.940490	373	453	2	7	80	0.0875000
NODE_7532_length_956_cov_21.940490	426	506	0	20	80	0.2500000
NODE_7532_length_956_cov_21.940490	426	506	2	60	80	0.7500000
NODE_7532_length_956_cov_21.940490	502	582	2	32	80	0.4000000
NODE_7532_length_956_cov_21.940490	502	582	6	7	80	0.0875000
NODE_7532_length_956_cov_21.940490	502	582	8	41	80	0.5125000
NODE_7532_length_956_cov_21.940490	555	635	2	6	80	0.0750000
NODE_7532_length_956_cov_21.940490	555	635	6	7	80	0.0875000
NODE_7532_length_956_cov_21.940490	555	635	8	67	80	0.8375000
NODE_7533_length_956_cov_19.435239	274	354	0	80	80	1.0000000
NODE_7533_length_956_cov_19.435239	274	301	0	27	27	1.0000000
NODE_7534_length_956_cov_17.819137	378	458	0	55	80	0.6875000
NODE_7534_length_956_cov_17.819137	378	458	2	25	80	0.3125000
NODE_7534_length_956_cov_17.819137	431	511	0	2	80	0.0250000
NODE_7534_length_956_cov_17.819137	431	511	2	78	80	0.9750000
NODE_7535_length_956_cov_16.098016	551	631	0	80	80	1.0000000
NODE_7535_length_956_cov_16.098016	604	684	0	80	80	1.0000000
NODE_7536_length_956_cov_15.229872	490	570	0	38	80	0.4750000
NODE_7536_length_956_cov_15.229872	490	570	2	36	80	0.4500000
NODE_7536_length_956_cov_15.229872	490	570	4	6	80	0.0750000
NODE_7536_length_956_cov_15.229872	543	623	0	80	80	1.0000000
NODE_7537_length_956_cov_7.533256	439	519	0	80	80	1.0000000
NODE_7537_length_956_cov_7.533256	497	572	0	75	75	1.0000000
NODE_7545_length_955_cov_30.821262	438	518	0	21	80	0.2625000
NODE_7545_length_955_cov_30.821262	438	518	2	59	80	0.7375000
NODE_7545_length_955_cov_30.821262	491	571	0	36	80	0.4500000
NODE_7545_length_955_cov_30.821262	491	571	2	44	80	0.5500000
NODE_7546_length_955_cov_30.574766	380	460	0	9	80	0.1125000
NODE_7546_length_955_cov_30.574766	380	460	2	71	80	0.8875000
NODE_7546_length_955_cov_30.574766	433	513	0	62	80	0.7750000
NODE_7546_length_955_cov_30.574766	433	513	2	18	80	0.2250000
NODE_7546_length_955_cov_30.574766	509	589	0	80	80	1.0000000
NODE_7546_length_955_cov_30.574766	562	642	0	80	80	1.0000000
NODE_7547_length_955_cov_27.734813	373	453	0	12	80	0.1500000
NODE_7547_length_955_cov_27.734813	373	453	6	17	80	0.2125000
NODE_7547_length_955_cov_27.734813	373	453	8	51	80	0.6375000
NODE_7547_length_955_cov_27.734813	426	506	0	6	80	0.0750000
NODE_7547_length_955_cov_27.734813	426	506	6	60	80	0.7500000
NODE_7547_length_955_cov_27.734813	426	506	8	14	80	0.1750000
NODE_7548_length_955_cov_24.475467	439	519	0	80	80	1.0000000
NODE_7548_length_955_cov_24.475467	492	572	0	80	80	1.0000000
NODE_7549_length_955_cov_22.146028	351	431	0	56	80	0.7000000
NODE_7549_length_955_cov_22.146028	351	431	2	24	80	0.3000000
NODE_7549_length_955_cov_22.146028	404	484	0	3	80	0.0375000
NODE_7549_length_955_cov_22.146028	404	484	2	25	80	0.3125000
NODE_7549_length_955_cov_22.146028	404	484	8	52	80	0.6500000
NODE_7550_length_955_cov_16.212617	441	521	0	37	80	0.4625000
NODE_7550_length_955_cov_16.212617	441	521	2	43	80	0.5375000
NODE_7550_length_955_cov_16.212617	494	574	0	80	80	1.0000000
NODE_7551_length_955_cov_13.334112	269	349	0	40	80	0.5000000
NODE_7551_length_955_cov_13.334112	269	349	2	40	80	0.5000000
NODE_7551_length_955_cov_13.334112	322	402	2	41	80	0.5125000
NODE_7551_length_955_cov_13.334112	322	402	6	30	80	0.3750000
NODE_7551_length_955_cov_13.334112	322	402	8	9	80	0.1125000
NODE_7552_length_955_cov_12.544393	363	443	2	13	80	0.1625000
NODE_7552_length_955_cov_12.544393	363	443	8	7	80	0.0875000
NODE_7552_length_955_cov_12.544393	363	443	9	2	80	0.0250000
NODE_7552_length_955_cov_12.544393	363	443	10	58	80	0.7250000
NODE_7552_length_955_cov_12.544393	416	496	0	29	80	0.3625000
NODE_7552_length_955_cov_12.544393	416	496	2	37	80	0.4625000
NODE_7552_length_955_cov_12.544393	416	496	9	2	80	0.0250000
NODE_7552_length_955_cov_12.544393	416	496	10	12	80	0.1500000
NODE_7553_length_955_cov_8.204439	358	438	0	15	80	0.1875000
NODE_7553_length_955_cov_8.204439	358	438	2	65	80	0.8125000
NODE_7553_length_955_cov_8.204439	411	491	0	63	80	0.7875000
NODE_7553_length_955_cov_8.204439	411	491	2	17	80	0.2125000
NODE_7563_length_954_cov_35.691228	381	461	0	80	80	1.0000000
NODE_7563_length_954_cov_35.691228	434	514	0	80	80	1.0000000
NODE_7564_length_954_cov_30.769591	408	488	2	10	80	0.1250000
NODE_7564_length_954_cov_30.769591	408	488	6	38	80	0.4750000
NODE_7564_length_954_cov_30.769591	408	488	8	32	80	0.4000000
NODE_7564_length_954_cov_30.769591	461	541	2	39	80	0.4875000
NODE_7564_length_954_cov_30.769591	461	541	4	24	80	0.3000000
NODE_7564_length_954_cov_30.769591	461	541	6	11	80	0.1375000
NODE_7564_length_954_cov_30.769591	461	541	8	6	80	0.0750000
NODE_7565_length_954_cov_27.247953	418	498	0	37	80	0.4625000
NODE_7565_length_954_cov_27.247953	418	498	2	6	80	0.0750000
NODE_7565_length_954_cov_27.247953	418	498	4	37	80	0.4625000
NODE_7565_length_954_cov_27.247953	471	551	0	4	80	0.0500000
NODE_7565_length_954_cov_27.247953	471	551	2	15	80	0.1875000
NODE_7565_length_954_cov_27.247953	471	551	4	61	80	0.7625000
NODE_7566_length_954_cov_22.796491	270	350	2	80	80	1.0000000
NODE_7566_length_954_cov_22.796491	323	403	0	24	80	0.3000000
NODE_7566_length_954_cov_22.796491	323	403	2	56	80	0.7000000
NODE_7567_length_954_cov_15.645614	337	417	0	9	80	0.1125000
NODE_7567_length_954_cov_15.645614	337	417	2	71	80	0.8875000
NODE_7567_length_954_cov_15.645614	390	470	2	29	80	0.3625000
NODE_7567_length_954_cov_15.645614	390	470	4	51	80	0.6375000
NODE_7568_length_954_cov_13.538012	346	426	0	80	80	1.0000000
NODE_7568_length_954_cov_13.538012	399	479	0	80	80	1.0000000
NODE_7569_length_954_cov_12.162573	155	217	0	29	62	0.4677419
NODE_7569_length_954_cov_12.162573	155	217	2	19	62	0.3064516
NODE_7569_length_954_cov_12.162573	155	217	4	6	62	0.0967742
NODE_7569_length_954_cov_12.162573	155	217	6	2	62	0.0322581
NODE_7569_length_954_cov_12.162573	155	217	8	6	62	0.0967742
NODE_7570_length_954_cov_10.714620	239	319	2	14	80	0.1750000
NODE_7570_length_954_cov_10.714620	239	319	4	41	80	0.5125000
NODE_7570_length_954_cov_10.714620	239	319	6	2	80	0.0250000
NODE_7570_length_954_cov_10.714620	239	319	8	23	80	0.2875000
NODE_7570_length_954_cov_10.714620	292	372	4	25	80	0.3125000
NODE_7570_length_954_cov_10.714620	292	372	6	21	80	0.2625000
NODE_7570_length_954_cov_10.714620	292	372	8	34	80	0.4250000
NODE_7571_length_954_cov_5.670175	431	511	0	80	80	1.0000000
NODE_7571_length_954_cov_5.670175	484	564	0	42	80	0.5250000
NODE_7571_length_954_cov_5.670175	484	564	2	38	80	0.4750000
NODE_7582_length_953_cov_35.789227	425	505	0	80	80	1.0000000
NODE_7582_length_953_cov_35.789227	478	558	0	80	80	1.0000000
NODE_7583_length_953_cov_33.940281	430	510	0	22	80	0.2750000
NODE_7583_length_953_cov_33.940281	430	510	2	32	80	0.4000000
NODE_7583_length_953_cov_33.940281	430	510	4	26	80	0.3250000
NODE_7583_length_953_cov_33.940281	483	563	0	27	80	0.3375000
NODE_7583_length_953_cov_33.940281	483	563	2	16	80	0.2000000
NODE_7583_length_953_cov_33.940281	483	563	4	37	80	0.4625000
NODE_7584_length_953_cov_26.844262	333	413	0	30	80	0.3750000
NODE_7584_length_953_cov_26.844262	333	413	4	50	80	0.6250000
NODE_7584_length_953_cov_26.844262	386	466	2	22	80	0.2750000
NODE_7584_length_953_cov_26.844262	386	466	4	58	80	0.7250000
NODE_7584_length_953_cov_26.844262	462	542	0	8	80	0.1000000
NODE_7584_length_953_cov_26.844262	462	542	2	45	80	0.5625000
NODE_7584_length_953_cov_26.844262	462	542	4	12	80	0.1500000
NODE_7584_length_953_cov_26.844262	462	542	6	15	80	0.1875000
NODE_7584_length_953_cov_26.844262	515	595	0	1	80	0.0125000
NODE_7584_length_953_cov_26.844262	515	595	1	1	80	0.0125000
NODE_7584_length_953_cov_26.844262	515	595	4	36	80	0.4500000
NODE_7584_length_953_cov_26.844262	515	595	6	42	80	0.5250000
NODE_7585_length_953_cov_20.770492	301	381	0	80	80	1.0000000
NODE_7585_length_953_cov_20.770492	354	434	0	80	80	1.0000000
NODE_7586_length_953_cov_17.514052	421	501	0	80	80	1.0000000
NODE_7586_length_953_cov_17.514052	474	554	0	61	80	0.7625000
NODE_7586_length_953_cov_17.514052	474	554	2	19	80	0.2375000
NODE_7586_length_953_cov_17.514052	550	630	2	28	80	0.3500000
NODE_7586_length_953_cov_17.514052	550	630	5	1	80	0.0125000
NODE_7586_length_953_cov_17.514052	550	630	6	2	80	0.0250000
NODE_7586_length_953_cov_17.514052	550	630	8	26	80	0.3250000
NODE_7586_length_953_cov_17.514052	550	630	10	23	80	0.2875000
NODE_7586_length_953_cov_17.514052	603	683	8	52	80	0.6500000
NODE_7586_length_953_cov_17.514052	603	683	10	28	80	0.3500000
NODE_7587_length_953_cov_11.579625	332	412	0	61	80	0.7625000
NODE_7587_length_953_cov_11.579625	332	412	6	19	80	0.2375000
NODE_7587_length_953_cov_11.579625	385	465	0	8	80	0.1000000
NODE_7587_length_953_cov_11.579625	385	465	6	53	80	0.6625000
NODE_7587_length_953_cov_11.579625	385	465	8	15	80	0.1875000
NODE_7587_length_953_cov_11.579625	385	465	10	4	80	0.0500000
NODE_7588_length_953_cov_7.281030	276	356	0	50	80	0.6250000
NODE_7588_length_953_cov_7.281030	276	356	4	13	80	0.1625000
NODE_7588_length_953_cov_7.281030	276	356	6	17	80	0.2125000
NODE_7588_length_953_cov_7.281030	329	409	4	15	80	0.1875000
NODE_7588_length_953_cov_7.281030	329	409	6	65	80	0.8125000
NODE_7599_length_952_cov_44.880422	447	527	0	80	80	1.0000000
NODE_7599_length_952_cov_44.880422	500	580	0	80	80	1.0000000
NODE_7599_length_952_cov_44.880422	871	951	0	80	80	1.0000000
NODE_7600_length_952_cov_42.485346	402	482	0	47	80	0.5875000
NODE_7600_length_952_cov_42.485346	402	482	6	33	80	0.4125000
NODE_7600_length_952_cov_42.485346	455	535	6	47	80	0.5875000
NODE_7600_length_952_cov_42.485346	455	535	8	28	80	0.3500000
NODE_7600_length_952_cov_42.485346	455	535	10	5	80	0.0625000
NODE_7601_length_952_cov_40.065651	422	502	2	1	80	0.0125000
NODE_7601_length_952_cov_40.065651	422	502	8	46	80	0.5750000
NODE_7601_length_952_cov_40.065651	422	502	10	33	80	0.4125000
NODE_7601_length_952_cov_40.065651	475	555	0	39	80	0.4875000
NODE_7601_length_952_cov_40.065651	475	555	2	15	80	0.1875000
NODE_7601_length_952_cov_40.065651	475	555	8	26	80	0.3250000
NODE_7602_length_952_cov_34.813599	308	388	6	8	80	0.1000000
NODE_7602_length_952_cov_34.813599	308	388	12	14	80	0.1750000
NODE_7602_length_952_cov_34.813599	308	388	14	57	80	0.7125000
NODE_7602_length_952_cov_34.813599	308	388	16	1	80	0.0125000
NODE_7602_length_952_cov_34.813599	361	441	2	7	80	0.0875000
NODE_7602_length_952_cov_34.813599	361	441	9	1	80	0.0125000
NODE_7602_length_952_cov_34.813599	361	441	10	24	80	0.3000000
NODE_7602_length_952_cov_34.813599	361	441	12	35	80	0.4375000
NODE_7602_length_952_cov_34.813599	361	441	14	12	80	0.1500000
NODE_7602_length_952_cov_34.813599	361	441	16	1	80	0.0125000
NODE_7603_length_952_cov_28.055100	661	741	0	36	80	0.4500000
NODE_7603_length_952_cov_28.055100	661	741	2	44	80	0.5500000
NODE_7603_length_952_cov_28.055100	714	794	0	27	80	0.3375000
NODE_7603_length_952_cov_28.055100	714	794	2	53	80	0.6625000
NODE_7604_length_952_cov_23.739742	435	515	0	57	80	0.7125000
NODE_7604_length_952_cov_23.739742	435	515	2	23	80	0.2875000
NODE_7604_length_952_cov_23.739742	488	568	0	80	80	1.0000000
NODE_7606_length_952_cov_11.478312	245	324	0	56	79	0.7088608
NODE_7606_length_952_cov_11.478312	245	324	2	23	79	0.2911392
NODE_7606_length_952_cov_11.478312	297	377	0	23	80	0.2875000
NODE_7606_length_952_cov_11.478312	297	377	2	57	80	0.7125000
NODE_7607_length_952_cov_11.284877	272	352	0	80	80	1.0000000
NODE_7607_length_952_cov_11.284877	325	405	0	80	80	1.0000000
NODE_7608_length_952_cov_10.807737	458	538	0	8	80	0.1000000
NODE_7608_length_952_cov_10.807737	458	538	3	1	80	0.0125000
NODE_7608_length_952_cov_10.807737	458	538	4	5	80	0.0625000
NODE_7608_length_952_cov_10.807737	458	538	6	66	80	0.8250000
NODE_7608_length_952_cov_10.807737	511	591	0	36	80	0.4500000
NODE_7608_length_952_cov_10.807737	511	591	4	13	80	0.1625000
NODE_7608_length_952_cov_10.807737	511	591	6	31	80	0.3875000
NODE_7609_length_952_cov_8.770223	375	455	0	80	80	1.0000000
NODE_7609_length_952_cov_8.770223	428	508	0	80	80	1.0000000
NODE_7623_length_951_cov_54.397887	354	434	0	15	80	0.1875000
NODE_7623_length_951_cov_54.397887	354	434	1	18	80	0.2250000
NODE_7623_length_951_cov_54.397887	354	434	3	47	80	0.5875000
NODE_7623_length_951_cov_54.397887	407	487	3	76	80	0.9500000
NODE_7623_length_951_cov_54.397887	407	487	5	4	80	0.0500000
NODE_7623_length_951_cov_54.397887	483	563	3	62	80	0.7750000
NODE_7623_length_951_cov_54.397887	483	563	4	18	80	0.2250000
NODE_7623_length_951_cov_54.397887	544	616	1	47	72	0.6527778
NODE_7623_length_951_cov_54.397887	544	616	3	25	72	0.3472222
NODE_7624_length_951_cov_47.881455	355	435	2	26	80	0.3250000
NODE_7624_length_951_cov_47.881455	355	435	4	32	80	0.4000000
NODE_7624_length_951_cov_47.881455	355	435	6	22	80	0.2750000
NODE_7624_length_951_cov_47.881455	408	488	4	34	80	0.4250000
NODE_7624_length_951_cov_47.881455	408	488	6	43	80	0.5375000
NODE_7624_length_951_cov_47.881455	408	488	8	3	80	0.0375000
NODE_7624_length_951_cov_47.881455	484	564	2	12	80	0.1500000
NODE_7624_length_951_cov_47.881455	484	564	4	33	80	0.4125000
NODE_7624_length_951_cov_47.881455	484	564	8	7	80	0.0875000
NODE_7624_length_951_cov_47.881455	484	564	10	28	80	0.3500000
NODE_7624_length_951_cov_47.881455	537	617	8	17	80	0.2125000
NODE_7624_length_951_cov_47.881455	537	617	10	63	80	0.7875000
NODE_7625_length_951_cov_24.322770	479	559	0	12	80	0.1500000
NODE_7625_length_951_cov_24.322770	479	559	2	68	80	0.8500000
NODE_7625_length_951_cov_24.322770	532	612	0	65	80	0.8125000
NODE_7625_length_951_cov_24.322770	532	612	2	15	80	0.1875000
NODE_7626_length_951_cov_23.001174	470	550	11	4	80	0.0500000
NODE_7626_length_951_cov_23.001174	470	550	13	3	80	0.0375000
NODE_7626_length_951_cov_23.001174	470	550	16	7	80	0.0875000
NODE_7626_length_951_cov_23.001174	470	550	17	3	80	0.0375000
NODE_7626_length_951_cov_23.001174	470	550	18	23	80	0.2875000
NODE_7626_length_951_cov_23.001174	470	550	20	3	80	0.0375000
NODE_7626_length_951_cov_23.001174	470	550	22	37	80	0.4625000
NODE_7626_length_951_cov_23.001174	523	603	4	33	80	0.4125000
NODE_7626_length_951_cov_23.001174	523	603	7	1	80	0.0125000
NODE_7626_length_951_cov_23.001174	523	603	9	5	80	0.0625000
NODE_7626_length_951_cov_23.001174	523	603	11	18	80	0.2250000
NODE_7626_length_951_cov_23.001174	523	603	13	3	80	0.0375000
NODE_7626_length_951_cov_23.001174	523	603	17	3	80	0.0375000
NODE_7626_length_951_cov_23.001174	523	603	20	3	80	0.0375000
NODE_7626_length_951_cov_23.001174	523	603	22	14	80	0.1750000
NODE_7627_length_951_cov_22.059859	562	642	0	80	80	1.0000000
NODE_7627_length_951_cov_22.059859	615	695	0	45	80	0.5625000
NODE_7627_length_951_cov_22.059859	615	695	1	5	80	0.0625000
NODE_7627_length_951_cov_22.059859	615	695	3	25	80	0.3125000
NODE_7627_length_951_cov_22.059859	615	695	5	2	80	0.0250000
NODE_7627_length_951_cov_22.059859	615	695	7	3	80	0.0375000
NODE_7628_length_951_cov_19.413146	456	536	4	25	80	0.3125000
NODE_7628_length_951_cov_19.413146	456	536	6	13	80	0.1625000
NODE_7628_length_951_cov_19.413146	456	536	8	42	80	0.5250000
NODE_7628_length_951_cov_19.413146	509	589	2	7	80	0.0875000
NODE_7628_length_951_cov_19.413146	509	589	4	2	80	0.0250000
NODE_7628_length_951_cov_19.413146	509	589	6	45	80	0.5625000
NODE_7628_length_951_cov_19.413146	509	589	8	26	80	0.3250000
NODE_7628_length_951_cov_19.413146	830	877	0	47	47	1.0000000
NODE_7629_length_951_cov_18.970657	384	464	0	16	80	0.2000000
NODE_7629_length_951_cov_18.970657	384	464	2	64	80	0.8000000
NODE_7629_length_951_cov_18.970657	437	517	0	69	80	0.8625000
NODE_7629_length_951_cov_18.970657	437	517	2	11	80	0.1375000
NODE_7629_length_951_cov_18.970657	513	593	0	22	80	0.2750000
NODE_7629_length_951_cov_18.970657	513	593	2	24	80	0.3000000
NODE_7629_length_951_cov_18.970657	513	593	6	34	80	0.4250000
NODE_7629_length_951_cov_18.970657	566	646	0	8	80	0.1000000
NODE_7629_length_951_cov_18.970657	566	646	4	39	80	0.4875000
NODE_7629_length_951_cov_18.970657	566	646	6	33	80	0.4125000
NODE_7630_length_951_cov_17.164319	409	490	2	58	81	0.7160494
NODE_7630_length_951_cov_17.164319	409	490	4	23	81	0.2839506
NODE_7630_length_951_cov_17.164319	463	543	0	19	80	0.2375000
NODE_7630_length_951_cov_17.164319	463	543	2	53	80	0.6625000
NODE_7630_length_951_cov_17.164319	463	543	4	8	80	0.1000000
NODE_7631_length_951_cov_17.009390	393	473	0	72	80	0.9000000
NODE_7631_length_951_cov_17.009390	393	473	4	8	80	0.1000000
NODE_7631_length_951_cov_17.009390	446	526	0	19	80	0.2375000
NODE_7631_length_951_cov_17.009390	446	526	4	45	80	0.5625000
NODE_7631_length_951_cov_17.009390	446	526	6	16	80	0.2000000
NODE_7632_length_951_cov_15.551643	520	600	2	12	80	0.1500000
NODE_7632_length_951_cov_15.551643	520	600	4	68	80	0.8500000
NODE_7632_length_951_cov_15.551643	573	653	0	50	80	0.6250000
NODE_7632_length_951_cov_15.551643	573	653	2	15	80	0.1875000
NODE_7632_length_951_cov_15.551643	573	653	4	15	80	0.1875000
NODE_7633_length_951_cov_13.562207	364	444	0	80	80	1.0000000
NODE_7633_length_951_cov_13.562207	417	497	0	80	80	1.0000000
NODE_7634_length_951_cov_13.086854	450	530	2	66	80	0.8250000
NODE_7634_length_951_cov_13.086854	450	530	4	8	80	0.1000000
NODE_7634_length_951_cov_13.086854	450	530	6	6	80	0.0750000
NODE_7634_length_951_cov_13.086854	503	583	0	48	80	0.6000000
NODE_7634_length_951_cov_13.086854	503	583	2	32	80	0.4000000
NODE_7635_length_951_cov_6.812207	350	430	2	23	80	0.2875000
NODE_7635_length_951_cov_6.812207	350	430	4	57	80	0.7125000
NODE_7635_length_951_cov_6.812207	403	483	0	48	80	0.6000000
NODE_7635_length_951_cov_6.812207	403	483	2	17	80	0.2125000
NODE_7635_length_951_cov_6.812207	403	483	4	15	80	0.1875000
NODE_7636_length_951_cov_5.076291	80	160	0	80	80	1.0000000
NODE_7636_length_951_cov_5.076291	133	213	0	80	80	1.0000000
NODE_7649_length_950_cov_62.151586	731	794	2	2	63	0.0317460
NODE_7649_length_950_cov_62.151586	731	794	10	1	63	0.0158730
NODE_7649_length_950_cov_62.151586	731	794	12	29	63	0.4603175
NODE_7649_length_950_cov_62.151586	731	794	14	5	63	0.0793651
NODE_7649_length_950_cov_62.151586	731	794	16	14	63	0.2222222
NODE_7649_length_950_cov_62.151586	731	794	18	2	63	0.0317460
NODE_7649_length_950_cov_62.151586	731	794	20	1	63	0.0158730
NODE_7649_length_950_cov_62.151586	731	794	22	7	63	0.1111111
NODE_7649_length_950_cov_62.151586	731	794	24	1	63	0.0158730
NODE_7649_length_950_cov_62.151586	731	794	26	1	63	0.0158730
NODE_7650_length_950_cov_56.088132	354	434	0	12	80	0.1500000
NODE_7650_length_950_cov_56.088132	354	434	2	68	80	0.8500000
NODE_7650_length_950_cov_56.088132	407	487	0	27	80	0.3375000
NODE_7650_length_950_cov_56.088132	407	487	2	15	80	0.1875000
NODE_7650_length_950_cov_56.088132	407	487	4	2	80	0.0250000
NODE_7650_length_950_cov_56.088132	407	487	6	36	80	0.4500000
NODE_7650_length_950_cov_56.088132	483	563	2	7	80	0.0875000
NODE_7650_length_950_cov_56.088132	483	563	4	17	80	0.2125000
NODE_7650_length_950_cov_56.088132	483	563	6	56	80	0.7000000
NODE_7650_length_950_cov_56.088132	536	616	2	40	80	0.5000000
NODE_7650_length_950_cov_56.088132	536	616	4	37	80	0.4625000
NODE_7650_length_950_cov_56.088132	536	616	6	3	80	0.0375000
NODE_7651_length_950_cov_29.780259	501	581	0	80	80	1.0000000
NODE_7651_length_950_cov_29.780259	554	634	0	54	80	0.6750000
NODE_7651_length_950_cov_29.780259	554	634	5	26	80	0.3250000
NODE_7652_length_950_cov_27.278496	388	468	0	80	80	1.0000000
NODE_7652_length_950_cov_27.278496	441	519	0	78	78	1.0000000
NODE_7653_length_950_cov_26.766157	322	402	0	7	80	0.0875000
NODE_7653_length_950_cov_26.766157	322	402	2	29	80	0.3625000
NODE_7653_length_950_cov_26.766157	322	402	4	44	80	0.5500000
NODE_7653_length_950_cov_26.766157	375	455	2	6	80	0.0750000
NODE_7653_length_950_cov_26.766157	375	455	4	74	80	0.9250000
NODE_7653_length_950_cov_26.766157	451	531	0	74	80	0.9250000
NODE_7653_length_950_cov_26.766157	451	531	2	6	80	0.0750000
NODE_7653_length_950_cov_26.766157	504	584	0	80	80	1.0000000
NODE_7654_length_950_cov_19.638073	421	501	0	44	80	0.5500000
NODE_7654_length_950_cov_19.638073	421	501	2	36	80	0.4500000
NODE_7654_length_950_cov_19.638073	474	554	0	25	80	0.3125000
NODE_7654_length_950_cov_19.638073	474	554	2	55	80	0.6875000
NODE_7654_length_950_cov_19.638073	550	630	0	15	80	0.1875000
NODE_7654_length_950_cov_19.638073	550	630	3	1	80	0.0125000
NODE_7654_length_950_cov_19.638073	550	630	4	2	80	0.0250000
NODE_7654_length_950_cov_19.638073	550	630	8	2	80	0.0250000
NODE_7654_length_950_cov_19.638073	550	630	13	15	80	0.1875000
NODE_7654_length_950_cov_19.638073	550	630	14	45	80	0.5625000
NODE_7654_length_950_cov_19.638073	603	683	0	11	80	0.1375000
NODE_7654_length_950_cov_19.638073	603	683	3	5	80	0.0625000
NODE_7654_length_950_cov_19.638073	603	683	9	10	80	0.1250000
NODE_7654_length_950_cov_19.638073	603	683	11	5	80	0.0625000
NODE_7654_length_950_cov_19.638073	603	683	13	26	80	0.3250000
NODE_7654_length_950_cov_19.638073	603	683	14	12	80	0.1500000
NODE_7654_length_950_cov_19.638073	603	683	15	11	80	0.1375000
NODE_7655_length_950_cov_14.686251	376	456	0	80	80	1.0000000
NODE_7655_length_950_cov_14.686251	429	509	0	80	80	1.0000000
NODE_7656_length_950_cov_14.215041	339	419	0	2	80	0.0250000
NODE_7656_length_950_cov_14.215041	339	419	2	78	80	0.9750000
NODE_7656_length_950_cov_14.215041	392	472	0	23	80	0.2875000
NODE_7656_length_950_cov_14.215041	392	472	2	57	80	0.7125000
NODE_7657_length_950_cov_6.397180	370	450	0	15	80	0.1875000
NODE_7657_length_950_cov_6.397180	370	450	2	65	80	0.8125000
NODE_7657_length_950_cov_6.397180	423	504	0	69	81	0.8518519
NODE_7657_length_950_cov_6.397180	423	504	2	12	81	0.1481481
NODE_7659_length_950_cov_4.430082	594	674	0	62	80	0.7750000
NODE_7659_length_950_cov_4.430082	594	674	2	18	80	0.2250000
NODE_7659_length_950_cov_4.430082	647	727	0	9	80	0.1125000
NODE_7659_length_950_cov_4.430082	647	727	2	71	80	0.8875000
NODE_7672_length_949_cov_25.550588	371	451	0	79	80	0.9875000
NODE_7672_length_949_cov_25.550588	371	451	2	1	80	0.0125000
NODE_7672_length_949_cov_25.550588	500	580	2	10	80	0.1250000
NODE_7672_length_949_cov_25.550588	500	580	8	62	80	0.7750000
NODE_7672_length_949_cov_25.550588	500	580	10	8	80	0.1000000
NODE_7672_length_949_cov_25.550588	553	633	0	23	80	0.2875000
NODE_7672_length_949_cov_25.550588	553	633	6	7	80	0.0875000
NODE_7672_length_949_cov_25.550588	553	633	8	50	80	0.6250000
NODE_7673_length_949_cov_20.949412	252	332	0	59	80	0.7375000
NODE_7673_length_949_cov_20.949412	252	332	2	21	80	0.2625000
NODE_7673_length_949_cov_20.949412	305	385	0	6	80	0.0750000
NODE_7673_length_949_cov_20.949412	305	385	2	74	80	0.9250000
NODE_7674_length_949_cov_20.601176	364	444	0	40	80	0.5000000
NODE_7674_length_949_cov_20.601176	364	444	2	2	80	0.0250000
NODE_7674_length_949_cov_20.601176	364	444	4	38	80	0.4750000
NODE_7674_length_949_cov_20.601176	417	497	0	9	80	0.1125000
NODE_7674_length_949_cov_20.601176	417	497	2	1	80	0.0125000
NODE_7674_length_949_cov_20.601176	417	497	4	70	80	0.8750000
NODE_7674_length_949_cov_20.601176	493	573	0	80	80	1.0000000
NODE_7674_length_949_cov_20.601176	546	626	0	80	80	1.0000000
NODE_7675_length_949_cov_20.575294	481	561	2	11	80	0.1375000
NODE_7675_length_949_cov_20.575294	481	561	7	14	80	0.1750000
NODE_7675_length_949_cov_20.575294	481	561	8	51	80	0.6375000
NODE_7675_length_949_cov_20.575294	481	561	9	2	80	0.0250000
NODE_7675_length_949_cov_20.575294	481	561	10	2	80	0.0250000
NODE_7675_length_949_cov_20.575294	534	614	2	41	80	0.5125000
NODE_7675_length_949_cov_20.575294	534	614	7	25	80	0.3125000
NODE_7675_length_949_cov_20.575294	534	614	8	10	80	0.1250000
NODE_7675_length_949_cov_20.575294	534	614	9	2	80	0.0250000
NODE_7675_length_949_cov_20.575294	534	614	10	2	80	0.0250000
NODE_7676_length_949_cov_19.483529	340	420	0	80	80	1.0000000
NODE_7676_length_949_cov_19.483529	393	473	0	80	80	1.0000000
NODE_7676_length_949_cov_19.483529	469	549	0	57	80	0.7125000
NODE_7676_length_949_cov_19.483529	469	549	2	3	80	0.0375000
NODE_7676_length_949_cov_19.483529	469	549	4	20	80	0.2500000
NODE_7676_length_949_cov_19.483529	522	602	0	4	80	0.0500000
NODE_7676_length_949_cov_19.483529	522	602	2	4	80	0.0500000
NODE_7676_length_949_cov_19.483529	522	602	4	72	80	0.9000000
NODE_7677_length_949_cov_19.407059	433	513	0	18	80	0.2250000
NODE_7677_length_949_cov_19.407059	433	513	2	62	80	0.7750000
NODE_7677_length_949_cov_19.407059	486	566	0	71	80	0.8875000
NODE_7677_length_949_cov_19.407059	486	566	2	9	80	0.1125000
NODE_7677_length_949_cov_19.407059	562	642	0	44	80	0.5500000
NODE_7677_length_949_cov_19.407059	562	642	2	36	80	0.4500000
NODE_7677_length_949_cov_19.407059	615	695	0	36	80	0.4500000
NODE_7677_length_949_cov_19.407059	615	695	2	44	80	0.5500000
NODE_7678_length_949_cov_10.903529	561	641	0	80	80	1.0000000
NODE_7678_length_949_cov_10.903529	614	694	0	80	80	1.0000000
NODE_7679_length_949_cov_7.245882	0	71	0	63	71	0.8873239
NODE_7679_length_949_cov_7.245882	0	71	6	8	71	0.1126761
NODE_7679_length_949_cov_7.245882	0	71	0	63	71	0.8873239
NODE_7679_length_949_cov_7.245882	0	71	6	8	71	0.1126761
NODE_7679_length_949_cov_7.245882	44	124	0	19	80	0.2375000
NODE_7679_length_949_cov_7.245882	44	124	6	44	80	0.5500000
NODE_7679_length_949_cov_7.245882	44	124	9	17	80	0.2125000
NODE_7680_length_949_cov_6.998824	494	574	0	80	80	1.0000000
NODE_7680_length_949_cov_6.998824	547	627	0	80	80	1.0000000
NODE_7702_length_948_cov_37.201413	510	590	0	80	80	1.0000000
NODE_7702_length_948_cov_37.201413	563	643	0	80	80	1.0000000
NODE_7703_length_948_cov_20.082450	58	99	0	41	41	1.0000000
NODE_7703_length_948_cov_20.082450	113	193	48	2	80	0.0250000
NODE_7703_length_948_cov_20.082450	113	193	52	4	80	0.0500000
NODE_7703_length_948_cov_20.082450	113	193	62	3	80	0.0375000
NODE_7703_length_948_cov_20.082450	113	193	64	2	80	0.0250000
NODE_7703_length_948_cov_20.082450	113	193	66	3	80	0.0375000
NODE_7703_length_948_cov_20.082450	113	193	68	2	80	0.0250000
NODE_7703_length_948_cov_20.082450	113	193	69	1	80	0.0125000
NODE_7703_length_948_cov_20.082450	113	193	71	2	80	0.0250000
NODE_7703_length_948_cov_20.082450	113	193	73	1	80	0.0125000
NODE_7703_length_948_cov_20.082450	113	193	74	2	80	0.0250000
NODE_7703_length_948_cov_20.082450	113	193	82	2	80	0.0250000
NODE_7703_length_948_cov_20.082450	113	193	86	9	80	0.1125000
NODE_7703_length_948_cov_20.082450	113	193	92	2	80	0.0250000
NODE_7703_length_948_cov_20.082450	113	193	94	7	80	0.0875000
NODE_7703_length_948_cov_20.082450	113	193	96	1	80	0.0125000
NODE_7703_length_948_cov_20.082450	113	193	98	3	80	0.0375000
NODE_7703_length_948_cov_20.082450	113	193	100	7	80	0.0875000
NODE_7703_length_948_cov_20.082450	113	193	102	2	80	0.0250000
NODE_7703_length_948_cov_20.082450	113	193	106	2	80	0.0250000
NODE_7703_length_948_cov_20.082450	113	193	108	2	80	0.0250000
NODE_7703_length_948_cov_20.082450	113	193	111	1	80	0.0125000
NODE_7703_length_948_cov_20.082450	113	193	114	3	80	0.0375000
NODE_7703_length_948_cov_20.082450	113	193	115	4	80	0.0500000
NODE_7703_length_948_cov_20.082450	113	193	116	3	80	0.0375000
NODE_7703_length_948_cov_20.082450	113	193	118	1	80	0.0125000
NODE_7703_length_948_cov_20.082450	113	193	121	2	80	0.0250000
NODE_7703_length_948_cov_20.082450	113	193	122	1	80	0.0125000
NODE_7703_length_948_cov_20.082450	113	193	123	4	80	0.0500000
NODE_7703_length_948_cov_20.082450	113	193	124	1	80	0.0125000
NODE_7703_length_948_cov_20.082450	113	193	125	1	80	0.0125000
NODE_7703_length_948_cov_20.082450	166	246	102	2	80	0.0250000
NODE_7703_length_948_cov_20.082450	166	246	106	2	80	0.0250000
NODE_7703_length_948_cov_20.082450	166	246	108	2	80	0.0250000
NODE_7703_length_948_cov_20.082450	166	246	109	1	80	0.0125000
NODE_7703_length_948_cov_20.082450	166	246	110	1	80	0.0125000
NODE_7703_length_948_cov_20.082450	166	246	111	4	80	0.0500000
NODE_7703_length_948_cov_20.082450	166	246	113	2	80	0.0250000
NODE_7703_length_948_cov_20.082450	166	246	114	3	80	0.0375000
NODE_7703_length_948_cov_20.082450	166	246	115	7	80	0.0875000
NODE_7703_length_948_cov_20.082450	166	246	116	6	80	0.0750000
NODE_7703_length_948_cov_20.082450	166	246	117	4	80	0.0500000
NODE_7703_length_948_cov_20.082450	166	246	118	2	80	0.0250000
NODE_7703_length_948_cov_20.082450	166	246	119	5	80	0.0625000
NODE_7703_length_948_cov_20.082450	166	246	120	7	80	0.0875000
NODE_7703_length_948_cov_20.082450	166	246	121	7	80	0.0875000
NODE_7703_length_948_cov_20.082450	166	246	122	5	80	0.0625000
NODE_7703_length_948_cov_20.082450	166	246	123	8	80	0.1000000
NODE_7703_length_948_cov_20.082450	166	246	124	7	80	0.0875000
NODE_7703_length_948_cov_20.082450	166	246	125	5	80	0.0625000
NODE_7704_length_948_cov_16.785630	308	388	0	15	80	0.1875000
NODE_7704_length_948_cov_16.785630	308	388	2	65	80	0.8125000
NODE_7704_length_948_cov_16.785630	361	441	0	20	80	0.2500000
NODE_7704_length_948_cov_16.785630	361	441	2	60	80	0.7500000
NODE_7704_length_948_cov_16.785630	437	517	0	80	80	1.0000000
NODE_7704_length_948_cov_16.785630	490	570	0	80	80	1.0000000
NODE_7705_length_948_cov_12.740872	400	480	0	24	80	0.3000000
NODE_7705_length_948_cov_12.740872	400	480	2	35	80	0.4375000
NODE_7705_length_948_cov_12.740872	400	480	4	21	80	0.2625000
NODE_7705_length_948_cov_12.740872	453	533	0	77	80	0.9625000
NODE_7705_length_948_cov_12.740872	453	533	2	3	80	0.0375000
NODE_7706_length_948_cov_10.220259	465	545	0	80	80	1.0000000
NODE_7706_length_948_cov_10.220259	518	598	0	80	80	1.0000000
NODE_7707_length_948_cov_8.504122	456	536	4	28	80	0.3500000
NODE_7707_length_948_cov_8.504122	456	536	6	52	80	0.6500000
NODE_7707_length_948_cov_8.504122	509	589	0	11	80	0.1375000
NODE_7707_length_948_cov_8.504122	509	589	2	33	80	0.4125000
NODE_7707_length_948_cov_8.504122	509	589	3	1	80	0.0125000
NODE_7707_length_948_cov_8.504122	509	589	4	14	80	0.1750000
NODE_7707_length_948_cov_8.504122	509	589	6	21	80	0.2625000
NODE_7709_length_948_cov_5.425206	641	721	6	34	80	0.4250000
NODE_7709_length_948_cov_5.425206	641	721	8	46	80	0.5750000
NODE_7709_length_948_cov_5.425206	694	774	0	53	80	0.6625000
NODE_7709_length_948_cov_5.425206	694	774	6	27	80	0.3375000
NODE_7711_length_948_cov_3.586572	696	776	0	80	80	1.0000000
NODE_7715_length_948_cov_2.786808	259	324	0	31	65	0.4769231
NODE_7715_length_948_cov_2.786808	259	324	2	34	65	0.5230770
NODE_7715_length_948_cov_2.786808	297	377	2	80	80	1.0000000
NODE_7721_length_947_cov_91.466981	393	473	0	80	80	1.0000000
NODE_7721_length_947_cov_91.466981	446	526	0	80	80	1.0000000
NODE_7722_length_947_cov_61.139151	402	482	0	80	80	1.0000000
NODE_7722_length_947_cov_61.139151	455	535	0	80	80	1.0000000
NODE_7723_length_947_cov_50.009434	488	568	0	80	80	1.0000000
NODE_7723_length_947_cov_50.009434	541	621	0	80	80	1.0000000
NODE_7724_length_947_cov_36.271226	511	591	4	17	80	0.2125000
NODE_7724_length_947_cov_36.271226	511	591	6	19	80	0.2375000
NODE_7724_length_947_cov_36.271226	511	591	8	44	80	0.5500000
NODE_7724_length_947_cov_36.271226	564	644	0	22	80	0.2750000
NODE_7724_length_947_cov_36.271226	564	644	2	2	80	0.0250000
NODE_7724_length_947_cov_36.271226	564	644	4	4	80	0.0500000
NODE_7724_length_947_cov_36.271226	564	644	6	23	80	0.2875000
NODE_7724_length_947_cov_36.271226	564	644	8	29	80	0.3625000
NODE_7725_length_947_cov_23.384434	425	505	8	80	80	1.0000000
NODE_7725_length_947_cov_23.384434	478	558	0	4	80	0.0500000
NODE_7725_length_947_cov_23.384434	478	558	6	13	80	0.1625000
NODE_7725_length_947_cov_23.384434	478	558	7	8	80	0.1000000
NODE_7725_length_947_cov_23.384434	478	558	8	55	80	0.6875000
NODE_7726_length_947_cov_19.103774	316	396	0	7	80	0.0875000
NODE_7726_length_947_cov_19.103774	316	396	2	73	80	0.9125000
NODE_7726_length_947_cov_19.103774	369	449	0	60	80	0.7500000
NODE_7726_length_947_cov_19.103774	369	449	2	20	80	0.2500000
NODE_7727_length_947_cov_18.853774	516	596	0	80	80	1.0000000
NODE_7727_length_947_cov_18.853774	569	649	0	80	80	1.0000000
NODE_7728_length_947_cov_18.077830	315	395	0	37	80	0.4625000
NODE_7728_length_947_cov_18.077830	315	395	2	14	80	0.1750000
NODE_7728_length_947_cov_18.077830	315	395	6	29	80	0.3625000
NODE_7728_length_947_cov_18.077830	368	448	4	6	80	0.0750000
NODE_7728_length_947_cov_18.077830	368	448	6	74	80	0.9250000
NODE_7729_length_947_cov_17.713443	403	483	0	80	80	1.0000000
NODE_7729_length_947_cov_17.713443	456	536	0	80	80	1.0000000
NODE_7730_length_947_cov_14.492925	358	438	0	6	80	0.0750000
NODE_7730_length_947_cov_14.492925	358	438	2	44	80	0.5500000
NODE_7730_length_947_cov_14.492925	358	438	4	30	80	0.3750000
NODE_7730_length_947_cov_14.492925	411	491	0	10	80	0.1250000
NODE_7730_length_947_cov_14.492925	411	491	2	70	80	0.8750000
NODE_7730_length_947_cov_14.492925	487	567	2	21	80	0.2625000
NODE_7730_length_947_cov_14.492925	487	567	4	4	80	0.0500000
NODE_7730_length_947_cov_14.492925	487	567	6	42	80	0.5250000
NODE_7730_length_947_cov_14.492925	487	567	8	13	80	0.1625000
NODE_7730_length_947_cov_14.492925	540	620	0	23	80	0.2875000
NODE_7730_length_947_cov_14.492925	540	620	4	18	80	0.2250000
NODE_7730_length_947_cov_14.492925	540	620	6	39	80	0.4875000
NODE_7731_length_947_cov_10.573113	550	630	0	80	80	1.0000000
NODE_7731_length_947_cov_10.573113	603	683	0	80	80	1.0000000
NODE_7732_length_947_cov_7.762972	550	630	0	49	80	0.6125000
NODE_7732_length_947_cov_7.762972	550	630	2	31	80	0.3875000
NODE_7732_length_947_cov_7.762972	607	683	2	76	76	1.0000000
NODE_7747_length_946_cov_39.726092	378	458	0	80	80	1.0000000
NODE_7747_length_946_cov_39.726092	431	511	0	80	80	1.0000000
NODE_7747_length_946_cov_39.726092	507	587	0	80	80	1.0000000
NODE_7747_length_946_cov_39.726092	560	640	0	80	80	1.0000000
NODE_7748_length_946_cov_32.728453	404	484	2	48	80	0.6000000
NODE_7748_length_946_cov_32.728453	404	484	4	21	80	0.2625000
NODE_7748_length_946_cov_32.728453	404	484	6	11	80	0.1375000
NODE_7748_length_946_cov_32.728453	457	537	4	74	80	0.9250000
NODE_7748_length_946_cov_32.728453	457	537	6	6	80	0.0750000
NODE_7749_length_946_cov_27.548996	280	360	0	80	80	1.0000000
NODE_7749_length_946_cov_27.548996	333	413	0	80	80	1.0000000
NODE_7750_length_946_cov_24.622196	352	432	0	4	80	0.0500000
NODE_7750_length_946_cov_24.622196	352	432	8	76	80	0.9500000
NODE_7750_length_946_cov_24.622196	405	486	0	1	81	0.0123457
NODE_7750_length_946_cov_24.622196	405	486	7	1	81	0.0123457
NODE_7750_length_946_cov_24.622196	405	486	8	79	81	0.9753087
NODE_7751_length_946_cov_18.082645	492	572	0	80	80	1.0000000
NODE_7751_length_946_cov_18.082645	545	625	0	80	80	1.0000000
NODE_7752_length_946_cov_18.031877	433	513	0	57	80	0.7125000
NODE_7752_length_946_cov_18.031877	433	513	4	23	80	0.2875000
NODE_7752_length_946_cov_18.031877	486	566	0	4	80	0.0500000
NODE_7752_length_946_cov_18.031877	486	566	4	76	80	0.9500000
NODE_7753_length_946_cov_15.188902	472	552	4	61	80	0.7625000
NODE_7753_length_946_cov_15.188902	472	552	5	17	80	0.2125000
NODE_7753_length_946_cov_15.188902	472	552	6	2	80	0.0250000
NODE_7753_length_946_cov_15.188902	525	605	2	47	80	0.5875000
NODE_7753_length_946_cov_15.188902	525	605	4	25	80	0.3125000
NODE_7753_length_946_cov_15.188902	525	605	6	8	80	0.1000000
NODE_7754_length_946_cov_11.201889	408	488	0	80	80	1.0000000
NODE_7754_length_946_cov_11.201889	461	541	0	80	80	1.0000000
NODE_7768_length_945_cov_42.997636	361	441	0	34	80	0.4250000
NODE_7768_length_945_cov_42.997636	361	441	4	46	80	0.5750000
NODE_7768_length_945_cov_42.997636	414	494	4	52	80	0.6500000
NODE_7768_length_945_cov_42.997636	414	494	8	28	80	0.3500000
NODE_7769_length_945_cov_31.223404	357	437	0	6	80	0.0750000
NODE_7769_length_945_cov_31.223404	357	437	2	23	80	0.2875000
NODE_7769_length_945_cov_31.223404	357	437	6	51	80	0.6375000
NODE_7769_length_945_cov_31.223404	410	490	2	13	80	0.1625000
NODE_7769_length_945_cov_31.223404	410	490	4	23	80	0.2875000
NODE_7769_length_945_cov_31.223404	410	490	6	38	80	0.4750000
NODE_7769_length_945_cov_31.223404	410	490	8	6	80	0.0750000
NODE_7770_length_945_cov_26.348700	331	411	18	15	80	0.1875000
NODE_7770_length_945_cov_26.348700	331	411	21	1	80	0.0125000
NODE_7770_length_945_cov_26.348700	331	411	22	33	80	0.4125000
NODE_7770_length_945_cov_26.348700	331	411	24	13	80	0.1625000
NODE_7770_length_945_cov_26.348700	331	411	26	17	80	0.2125000
NODE_7770_length_945_cov_26.348700	331	411	31	1	80	0.0125000
NODE_7770_length_945_cov_26.348700	384	464	22	2	80	0.0250000
NODE_7770_length_945_cov_26.348700	384	464	24	10	80	0.1250000
NODE_7770_length_945_cov_26.348700	384	464	25	7	80	0.0875000
NODE_7770_length_945_cov_26.348700	384	464	26	61	80	0.7625000
NODE_7771_length_945_cov_20.349882	435	515	0	80	80	1.0000000
NODE_7771_length_945_cov_20.349882	488	568	0	80	80	1.0000000
NODE_7772_length_945_cov_14.771868	386	466	0	80	80	1.0000000
NODE_7772_length_945_cov_14.771868	439	519	0	62	80	0.7750000
NODE_7772_length_945_cov_14.771868	439	519	1	6	80	0.0750000
NODE_7772_length_945_cov_14.771868	439	519	10	12	80	0.1500000
NODE_7773_length_945_cov_10.158392	599	679	0	35	80	0.4375000
NODE_7773_length_945_cov_10.158392	599	679	2	45	80	0.5625000
NODE_7773_length_945_cov_10.158392	652	732	0	28	80	0.3500000
NODE_7773_length_945_cov_10.158392	652	732	2	52	80	0.6500000
NODE_7775_length_945_cov_5.403073	357	437	0	43	80	0.5375000
NODE_7775_length_945_cov_5.403073	357	437	2	37	80	0.4625000
NODE_7775_length_945_cov_5.403073	410	490	0	26	80	0.3250000
NODE_7775_length_945_cov_5.403073	410	490	2	54	80	0.6750000
NODE_7785_length_944_cov_42.401183	358	438	0	24	80	0.3000000
NODE_7785_length_944_cov_42.401183	358	438	7	1	80	0.0125000
NODE_7785_length_944_cov_42.401183	358	438	8	8	80	0.1000000
NODE_7785_length_944_cov_42.401183	358	438	12	3	80	0.0375000
NODE_7785_length_944_cov_42.401183	358	438	14	44	80	0.5500000
NODE_7785_length_944_cov_42.401183	411	498	10	13	87	0.1494253
NODE_7785_length_944_cov_42.401183	411	498	12	36	87	0.4137931
NODE_7785_length_944_cov_42.401183	411	498	14	38	87	0.4367816
NODE_7786_length_944_cov_32.712426	377	457	0	1	80	0.0125000
NODE_7786_length_944_cov_32.712426	377	457	2	24	80	0.3000000
NODE_7786_length_944_cov_32.712426	377	457	4	55	80	0.6875000
NODE_7786_length_944_cov_32.712426	430	510	0	54	80	0.6750000
NODE_7786_length_944_cov_32.712426	430	510	2	24	80	0.3000000
NODE_7786_length_944_cov_32.712426	430	510	4	2	80	0.0250000
NODE_7787_length_944_cov_27.839053	417	497	0	17	80	0.2125000
NODE_7787_length_944_cov_27.839053	417	497	4	6	80	0.0750000
NODE_7787_length_944_cov_27.839053	417	497	7	1	80	0.0125000
NODE_7787_length_944_cov_27.839053	417	497	12	10	80	0.1250000
NODE_7787_length_944_cov_27.839053	417	497	13	46	80	0.5750000
NODE_7787_length_944_cov_27.839053	470	550	2	7	80	0.0875000
NODE_7787_length_944_cov_27.839053	470	550	8	10	80	0.1250000
NODE_7787_length_944_cov_27.839053	470	550	11	1	80	0.0125000
NODE_7787_length_944_cov_27.839053	470	550	12	7	80	0.0875000
NODE_7787_length_944_cov_27.839053	470	550	13	55	80	0.6875000
NODE_7788_length_944_cov_24.702959	413	493	0	80	80	1.0000000
NODE_7788_length_944_cov_24.702959	466	546	0	80	80	1.0000000
NODE_7789_length_944_cov_11.951479	347	427	0	80	80	1.0000000
NODE_7789_length_944_cov_11.951479	400	480	0	80	80	1.0000000
NODE_7789_length_944_cov_11.951479	476	556	0	80	80	1.0000000
NODE_7789_length_944_cov_11.951479	529	609	0	80	80	1.0000000
NODE_7790_length_944_cov_6.745562	366	446	0	76	80	0.9500000
NODE_7790_length_944_cov_6.745562	366	446	2	4	80	0.0500000
NODE_7790_length_944_cov_6.745562	419	499	0	23	80	0.2875000
NODE_7790_length_944_cov_6.745562	419	499	2	57	80	0.7125000
NODE_7792_length_944_cov_4.420118	236	316	0	80	80	1.0000000
NODE_7792_length_944_cov_4.420118	289	369	0	80	80	1.0000000
NODE_7800_length_943_cov_40.111374	536	614	0	78	78	1.0000000
NODE_7800_length_943_cov_40.111374	587	667	0	80	80	1.0000000
NODE_7801_length_943_cov_29.446682	338	418	0	30	80	0.3750000
NODE_7801_length_943_cov_29.446682	338	418	2	50	80	0.6250000
NODE_7801_length_943_cov_29.446682	391	471	0	80	80	1.0000000
NODE_7802_length_943_cov_28.289100	393	473	0	19	80	0.2375000
NODE_7802_length_943_cov_28.289100	393	473	2	61	80	0.7625000
NODE_7802_length_943_cov_28.289100	446	526	0	72	80	0.9000000
NODE_7802_length_943_cov_28.289100	446	526	2	8	80	0.1000000
NODE_7803_length_943_cov_27.225118	343	423	0	80	80	1.0000000
NODE_7803_length_943_cov_27.225118	396	476	0	28	80	0.3500000
NODE_7803_length_943_cov_27.225118	396	476	1	52	80	0.6500000
NODE_7804_length_943_cov_26.536730	275	303	0	12	28	0.4285714
NODE_7804_length_943_cov_26.536730	275	303	4	16	28	0.5714286
NODE_7804_length_943_cov_26.536730	299	379	0	7	80	0.0875000
NODE_7804_length_943_cov_26.536730	299	379	5	1	80	0.0125000
NODE_7804_length_943_cov_26.536730	299	379	6	27	80	0.3375000
NODE_7804_length_943_cov_26.536730	299	379	10	18	80	0.2250000
NODE_7804_length_943_cov_26.536730	299	379	12	27	80	0.3375000
NODE_7804_length_943_cov_26.536730	352	432	0	4	80	0.0500000
NODE_7804_length_943_cov_26.536730	352	432	2	22	80	0.2750000
NODE_7804_length_943_cov_26.536730	352	432	6	4	80	0.0500000
NODE_7804_length_943_cov_26.536730	352	432	12	50	80	0.6250000
NODE_7805_length_943_cov_24.992891	374	454	4	32	80	0.4000000
NODE_7805_length_943_cov_24.992891	374	454	6	10	80	0.1250000
NODE_7805_length_943_cov_24.992891	374	454	7	14	80	0.1750000
NODE_7805_length_943_cov_24.992891	374	454	8	24	80	0.3000000
NODE_7805_length_943_cov_24.992891	427	507	4	30	80	0.3750000
NODE_7805_length_943_cov_24.992891	427	507	6	12	80	0.1500000
NODE_7805_length_943_cov_24.992891	427	507	7	3	80	0.0375000
NODE_7805_length_943_cov_24.992891	427	507	8	35	80	0.4375000
NODE_7805_length_943_cov_24.992891	503	583	4	2	80	0.0250000
NODE_7805_length_943_cov_24.992891	503	583	6	60	80	0.7500000
NODE_7805_length_943_cov_24.992891	503	583	7	1	80	0.0125000
NODE_7805_length_943_cov_24.992891	503	583	8	4	80	0.0500000
NODE_7805_length_943_cov_24.992891	503	583	9	3	80	0.0375000
NODE_7805_length_943_cov_24.992891	503	583	11	3	80	0.0375000
NODE_7805_length_943_cov_24.992891	503	583	12	7	80	0.0875000
NODE_7805_length_943_cov_24.992891	556	636	6	9	80	0.1125000
NODE_7805_length_943_cov_24.992891	556	636	7	1	80	0.0125000
NODE_7805_length_943_cov_24.992891	556	636	8	4	80	0.0500000
NODE_7805_length_943_cov_24.992891	556	636	9	3	80	0.0375000
NODE_7805_length_943_cov_24.992891	556	636	11	3	80	0.0375000
NODE_7805_length_943_cov_24.992891	556	636	12	18	80	0.2250000
NODE_7805_length_943_cov_24.992891	556	636	14	25	80	0.3125000
NODE_7805_length_943_cov_24.992891	556	636	16	12	80	0.1500000
NODE_7805_length_943_cov_24.992891	556	636	17	5	80	0.0625000
NODE_7806_length_943_cov_24.758294	403	483	0	19	80	0.2375000
NODE_7806_length_943_cov_24.758294	403	483	2	61	80	0.7625000
NODE_7806_length_943_cov_24.758294	456	536	0	72	80	0.9000000
NODE_7806_length_943_cov_24.758294	456	536	2	8	80	0.1000000
NODE_7807_length_943_cov_22.316351	432	512	0	5	80	0.0625000
NODE_7807_length_943_cov_22.316351	432	512	2	30	80	0.3750000
NODE_7807_length_943_cov_22.316351	432	512	3	11	80	0.1375000
NODE_7807_length_943_cov_22.316351	432	512	4	34	80	0.4250000
NODE_7807_length_943_cov_22.316351	485	565	2	43	80	0.5375000
NODE_7807_length_943_cov_22.316351	485	565	4	37	80	0.4625000
NODE_7808_length_943_cov_22.149289	393	473	2	38	80	0.4750000
NODE_7808_length_943_cov_22.149289	393	473	4	42	80	0.5250000
NODE_7808_length_943_cov_22.149289	446	526	0	9	80	0.1125000
NODE_7808_length_943_cov_22.149289	446	526	2	55	80	0.6875000
NODE_7808_length_943_cov_22.149289	446	526	4	16	80	0.2000000
NODE_7809_length_943_cov_20.055687	412	492	0	17	80	0.2125000
NODE_7809_length_943_cov_20.055687	412	492	2	2	80	0.0250000
NODE_7809_length_943_cov_20.055687	412	492	4	61	80	0.7625000
NODE_7809_length_943_cov_20.055687	465	545	0	70	80	0.8750000
NODE_7809_length_943_cov_20.055687	465	545	2	2	80	0.0250000
NODE_7809_length_943_cov_20.055687	465	545	4	8	80	0.1000000
NODE_7810_length_943_cov_16.022512	338	418	0	80	80	1.0000000
NODE_7810_length_943_cov_16.022512	391	471	0	80	80	1.0000000
NODE_7811_length_943_cov_10.939573	474	554	0	7	80	0.0875000
NODE_7811_length_943_cov_10.939573	474	554	2	12	80	0.1500000
NODE_7811_length_943_cov_10.939573	474	554	4	61	80	0.7625000
NODE_7811_length_943_cov_10.939573	527	607	0	60	80	0.7500000
NODE_7811_length_943_cov_10.939573	527	607	2	12	80	0.1500000
NODE_7811_length_943_cov_10.939573	527	607	4	8	80	0.1000000
NODE_7812_length_943_cov_9.483412	422	502	0	80	80	1.0000000
NODE_7812_length_943_cov_9.483412	475	555	0	80	80	1.0000000
NODE_7830_length_942_cov_58.088968	384	464	8	45	80	0.5625000
NODE_7830_length_942_cov_58.088968	384	464	10	11	80	0.1375000
NODE_7830_length_942_cov_58.088968	384	464	11	1	80	0.0125000
NODE_7830_length_942_cov_58.088968	384	464	12	4	80	0.0500000
NODE_7830_length_942_cov_58.088968	384	464	14	19	80	0.2375000
NODE_7830_length_942_cov_58.088968	437	517	8	67	80	0.8375000
NODE_7830_length_942_cov_58.088968	437	517	14	13	80	0.1625000
NODE_7832_length_942_cov_27.466192	360	440	0	38	80	0.4750000
NODE_7832_length_942_cov_27.466192	360	440	2	33	80	0.4125000
NODE_7832_length_942_cov_27.466192	360	440	4	9	80	0.1125000
NODE_7832_length_942_cov_27.466192	413	493	2	30	80	0.3750000
NODE_7832_length_942_cov_27.466192	413	493	4	50	80	0.6250000
NODE_7833_length_942_cov_26.914591	346	426	2	55	80	0.6875000
NODE_7833_length_942_cov_26.914591	346	426	4	25	80	0.3125000
NODE_7833_length_942_cov_26.914591	399	479	0	36	80	0.4500000
NODE_7833_length_942_cov_26.914591	399	479	2	44	80	0.5500000
NODE_7834_length_942_cov_17.911032	390	470	0	2	80	0.0250000
NODE_7834_length_942_cov_17.911032	390	470	2	35	80	0.4375000
NODE_7834_length_942_cov_17.911032	390	470	4	19	80	0.2375000
NODE_7834_length_942_cov_17.911032	390	470	6	24	80	0.3000000
NODE_7834_length_942_cov_17.911032	443	523	0	2	80	0.0250000
NODE_7834_length_942_cov_17.911032	443	523	2	2	80	0.0250000
NODE_7834_length_942_cov_17.911032	443	523	4	60	80	0.7500000
NODE_7834_length_942_cov_17.911032	443	523	6	16	80	0.2000000
NODE_7835_length_942_cov_14.695136	442	522	2	80	80	1.0000000
NODE_7835_length_942_cov_14.695136	495	575	0	48	80	0.6000000
NODE_7835_length_942_cov_14.695136	495	575	2	32	80	0.4000000
NODE_7836_length_942_cov_14.097272	547	627	0	80	80	1.0000000
NODE_7836_length_942_cov_14.097272	600	680	0	80	80	1.0000000
NODE_7837_length_942_cov_13.174377	322	402	2	31	80	0.3875000
NODE_7837_length_942_cov_13.174377	322	402	4	8	80	0.1000000
NODE_7837_length_942_cov_13.174377	322	402	6	41	80	0.5125000
NODE_7837_length_942_cov_13.174377	375	455	0	50	80	0.6250000
NODE_7837_length_942_cov_13.174377	375	455	2	30	80	0.3750000
NODE_7858_length_941_cov_36.592637	259	339	0	47	80	0.5875000
NODE_7858_length_941_cov_36.592637	259	339	2	33	80	0.4125000
NODE_7858_length_941_cov_36.592637	312	392	2	38	80	0.4750000
NODE_7858_length_941_cov_36.592637	312	392	4	42	80	0.5250000
NODE_7858_length_941_cov_36.592637	388	468	0	20	80	0.2500000
NODE_7858_length_941_cov_36.592637	388	468	2	19	80	0.2375000
NODE_7858_length_941_cov_36.592637	388	468	4	41	80	0.5125000
NODE_7858_length_941_cov_36.592637	441	521	0	73	80	0.9125000
NODE_7858_length_941_cov_36.592637	441	521	2	7	80	0.0875000
NODE_7859_length_941_cov_35.375297	352	432	0	19	80	0.2375000
NODE_7859_length_941_cov_35.375297	352	432	2	61	80	0.7625000
NODE_7859_length_941_cov_35.375297	405	485	0	72	80	0.9000000
NODE_7859_length_941_cov_35.375297	405	485	2	8	80	0.1000000
NODE_7859_length_941_cov_35.375297	481	561	0	80	80	1.0000000
NODE_7859_length_941_cov_35.375297	534	614	0	80	80	1.0000000
NODE_7860_length_941_cov_32.222090	407	487	0	32	80	0.4000000
NODE_7860_length_941_cov_32.222090	407	487	2	33	80	0.4125000
NODE_7860_length_941_cov_32.222090	407	487	4	15	80	0.1875000
NODE_7860_length_941_cov_32.222090	460	540	0	80	80	1.0000000
NODE_7861_length_941_cov_28.442993	391	471	12	10	80	0.1250000
NODE_7861_length_941_cov_28.442993	391	471	18	5	80	0.0625000
NODE_7861_length_941_cov_28.442993	391	471	20	17	80	0.2125000
NODE_7861_length_941_cov_28.442993	391	471	22	19	80	0.2375000
NODE_7861_length_941_cov_28.442993	391	471	24	4	80	0.0500000
NODE_7861_length_941_cov_28.442993	391	471	25	2	80	0.0250000
NODE_7861_length_941_cov_28.442993	391	471	26	23	80	0.2875000
NODE_7861_length_941_cov_28.442993	444	524	6	2	80	0.0250000
NODE_7861_length_941_cov_28.442993	444	524	11	1	80	0.0125000
NODE_7861_length_941_cov_28.442993	444	524	12	1	80	0.0125000
NODE_7861_length_941_cov_28.442993	444	524	14	32	80	0.4000000
NODE_7861_length_941_cov_28.442993	444	524	18	18	80	0.2250000
NODE_7861_length_941_cov_28.442993	444	524	24	1	80	0.0125000
NODE_7861_length_941_cov_28.442993	444	524	25	2	80	0.0250000
NODE_7861_length_941_cov_28.442993	444	524	26	23	80	0.2875000
NODE_7862_length_941_cov_20.788599	341	421	0	80	80	1.0000000
NODE_7862_length_941_cov_20.788599	394	474	0	53	80	0.6625000
NODE_7862_length_941_cov_20.788599	394	474	1	18	80	0.2250000
NODE_7862_length_941_cov_20.788599	394	474	2	9	80	0.1125000
NODE_7863_length_941_cov_18.000000	364	444	3	72	80	0.9000000
NODE_7863_length_941_cov_18.000000	364	444	4	8	80	0.1000000
NODE_7863_length_941_cov_18.000000	417	497	0	43	80	0.5375000
NODE_7863_length_941_cov_18.000000	417	497	2	6	80	0.0750000
NODE_7863_length_941_cov_18.000000	417	497	3	31	80	0.3875000
NODE_7864_length_941_cov_11.020190	325	405	0	80	80	1.0000000
NODE_7864_length_941_cov_11.020190	378	458	0	80	80	1.0000000
NODE_7865_length_941_cov_6.020190	260	287	2	11	27	0.4074074
NODE_7865_length_941_cov_6.020190	260	287	6	16	27	0.5925926
NODE_7865_length_941_cov_6.020190	260	340	2	11	80	0.1375000
NODE_7865_length_941_cov_6.020190	260	340	6	20	80	0.2500000
NODE_7865_length_941_cov_6.020190	260	340	8	49	80	0.6125000
NODE_7867_length_941_cov_3.745843	867	941	2	19	74	0.2567568
NODE_7867_length_941_cov_3.745843	867	941	4	18	74	0.2432432
NODE_7867_length_941_cov_3.745843	867	941	6	37	74	0.5000000
NODE_7877_length_940_cov_43.954816	243	323	0	42	80	0.5250000
NODE_7877_length_940_cov_43.954816	243	323	2	27	80	0.3375000
NODE_7877_length_940_cov_43.954816	243	323	4	3	80	0.0375000
NODE_7877_length_940_cov_43.954816	243	323	6	8	80	0.1000000
NODE_7877_length_940_cov_43.954816	296	376	2	16	80	0.2000000
NODE_7877_length_940_cov_43.954816	296	376	4	3	80	0.0375000
NODE_7877_length_940_cov_43.954816	296	376	6	25	80	0.3125000
NODE_7877_length_940_cov_43.954816	296	376	8	36	80	0.4500000
NODE_7877_length_940_cov_43.954816	372	452	0	8	80	0.1000000
NODE_7877_length_940_cov_43.954816	372	452	2	21	80	0.2625000
NODE_7877_length_940_cov_43.954816	372	452	4	13	80	0.1625000
NODE_7877_length_940_cov_43.954816	372	452	6	35	80	0.4375000
NODE_7877_length_940_cov_43.954816	372	452	8	3	80	0.0375000
NODE_7877_length_940_cov_43.954816	425	505	0	61	80	0.7625000
NODE_7877_length_940_cov_43.954816	425	505	2	19	80	0.2375000
NODE_7878_length_940_cov_27.763377	423	503	0	80	80	1.0000000
NODE_7878_length_940_cov_27.763377	476	556	0	80	80	1.0000000
NODE_7897_length_939_cov_58.982143	363	443	12	12	80	0.1500000
NODE_7897_length_939_cov_58.982143	363	443	14	4	80	0.0500000
NODE_7897_length_939_cov_58.982143	363	443	16	5	80	0.0625000
NODE_7897_length_939_cov_58.982143	363	443	18	6	80	0.0750000
NODE_7897_length_939_cov_58.982143	363	443	24	7	80	0.0875000
NODE_7897_length_939_cov_58.982143	363	443	26	3	80	0.0375000
NODE_7897_length_939_cov_58.982143	363	443	30	2	80	0.0250000
NODE_7897_length_939_cov_58.982143	363	443	32	17	80	0.2125000
NODE_7897_length_939_cov_58.982143	363	443	34	17	80	0.2125000
NODE_7897_length_939_cov_58.982143	363	443	36	7	80	0.0875000
NODE_7897_length_939_cov_58.982143	416	496	14	3	80	0.0375000
NODE_7897_length_939_cov_58.982143	416	496	16	12	80	0.1500000
NODE_7897_length_939_cov_58.982143	416	496	22	12	80	0.1500000
NODE_7897_length_939_cov_58.982143	416	496	24	8	80	0.1000000
NODE_7897_length_939_cov_58.982143	416	496	26	7	80	0.0875000
NODE_7897_length_939_cov_58.982143	416	496	28	1	80	0.0125000
NODE_7897_length_939_cov_58.982143	416	496	29	1	80	0.0125000
NODE_7897_length_939_cov_58.982143	416	496	30	10	80	0.1250000
NODE_7897_length_939_cov_58.982143	416	496	32	2	80	0.0250000
NODE_7897_length_939_cov_58.982143	416	496	34	17	80	0.2125000
NODE_7897_length_939_cov_58.982143	416	496	36	7	80	0.0875000
NODE_7898_length_939_cov_32.469048	327	407	2	26	80	0.3250000
NODE_7898_length_939_cov_32.469048	327	407	4	48	80	0.6000000
NODE_7898_length_939_cov_32.469048	327	407	6	6	80	0.0750000
NODE_7898_length_939_cov_32.469048	380	460	2	38	80	0.4750000
NODE_7898_length_939_cov_32.469048	380	460	4	38	80	0.4750000
NODE_7898_length_939_cov_32.469048	380	460	6	4	80	0.0500000
NODE_7899_length_939_cov_31.895238	265	345	2	50	80	0.6250000
NODE_7899_length_939_cov_31.895238	265	345	6	30	80	0.3750000
NODE_7899_length_939_cov_31.895238	318	398	6	80	80	1.0000000
NODE_7900_length_939_cov_25.354762	439	519	0	29	80	0.3625000
NODE_7900_length_939_cov_25.354762	439	519	2	18	80	0.2250000
NODE_7900_length_939_cov_25.354762	439	519	3	33	80	0.4125000
NODE_7900_length_939_cov_25.354762	492	572	2	20	80	0.2500000
NODE_7900_length_939_cov_25.354762	492	572	3	40	80	0.5000000
NODE_7900_length_939_cov_25.354762	492	572	4	20	80	0.2500000
NODE_7901_length_939_cov_24.892857	370	450	0	80	80	1.0000000
NODE_7901_length_939_cov_24.892857	423	503	0	80	80	1.0000000
NODE_7902_length_939_cov_24.246429	422	502	2	80	80	1.0000000
NODE_7902_length_939_cov_24.246429	475	555	2	80	80	1.0000000
NODE_7902_length_939_cov_24.246429	551	631	0	14	80	0.1750000
NODE_7902_length_939_cov_24.246429	551	631	2	66	80	0.8250000
NODE_7902_length_939_cov_24.246429	604	684	0	67	80	0.8375000
NODE_7902_length_939_cov_24.246429	604	684	2	13	80	0.1625000
NODE_7903_length_939_cov_21.141667	368	448	0	80	80	1.0000000
NODE_7903_length_939_cov_21.141667	421	501	0	80	80	1.0000000
NODE_7904_length_939_cov_16.425000	327	407	2	16	80	0.2000000
NODE_7904_length_939_cov_16.425000	327	407	4	64	80	0.8000000
NODE_7904_length_939_cov_16.425000	380	460	0	2	80	0.0250000
NODE_7904_length_939_cov_16.425000	380	460	2	67	80	0.8375000
NODE_7904_length_939_cov_16.425000	380	460	4	11	80	0.1375000
NODE_7905_length_939_cov_13.828571	469	548	3	39	79	0.4936709
NODE_7905_length_939_cov_13.828571	469	548	4	21	79	0.2658228
NODE_7905_length_939_cov_13.828571	469	548	6	19	79	0.2405063
NODE_7905_length_939_cov_13.828571	522	603	2	39	81	0.4814815
NODE_7905_length_939_cov_13.828571	522	603	4	7	81	0.0864198
NODE_7905_length_939_cov_13.828571	522	603	6	35	81	0.4320988
NODE_7906_length_939_cov_13.521429	402	482	2	70	80	0.8750000
NODE_7906_length_939_cov_13.521429	402	482	4	10	80	0.1250000
NODE_7906_length_939_cov_13.521429	455	535	2	80	80	1.0000000
NODE_7907_length_939_cov_12.955952	398	478	0	80	80	1.0000000
NODE_7907_length_939_cov_12.955952	451	531	0	80	80	1.0000000
NODE_7908_length_939_cov_6.564286	523	545	0	22	22	1.0000000
NODE_7922_length_938_cov_44.458880	362	442	0	76	80	0.9500000
NODE_7922_length_938_cov_44.458880	362	442	9	4	80	0.0500000
NODE_7922_length_938_cov_44.458880	415	495	0	23	80	0.2875000
NODE_7922_length_938_cov_44.458880	415	495	9	23	80	0.2875000
NODE_7922_length_938_cov_44.458880	415	495	11	32	80	0.4000000
NODE_7922_length_938_cov_44.458880	415	495	12	2	80	0.0250000
NODE_7923_length_938_cov_44.435042	748	815	2	24	67	0.3582090
NODE_7923_length_938_cov_44.435042	748	815	4	43	67	0.6417910
NODE_7924_length_938_cov_32.177592	466	546	2	47	80	0.5875000
NODE_7924_length_938_cov_32.177592	466	546	6	33	80	0.4125000
NODE_7924_length_938_cov_32.177592	519	599	1	2	80	0.0250000
NODE_7924_length_938_cov_32.177592	519	599	2	78	80	0.9750000
NODE_7925_length_938_cov_21.139452	474	554	0	2	80	0.0250000
NODE_7925_length_938_cov_21.139452	474	554	2	49	80	0.6125000
NODE_7925_length_938_cov_21.139452	474	554	4	29	80	0.3625000
NODE_7925_length_938_cov_21.139452	527	607	2	50	80	0.6250000
NODE_7925_length_938_cov_21.139452	527	607	4	30	80	0.3750000
NODE_7927_length_938_cov_8.791418	300	380	0	28	80	0.3500000
NODE_7927_length_938_cov_8.791418	300	380	2	52	80	0.6500000
NODE_7927_length_938_cov_8.791418	353	433	0	36	80	0.4500000
NODE_7927_length_938_cov_8.791418	353	433	2	44	80	0.5500000
NODE_7932_length_938_cov_2.693683	59	139	0	4	80	0.0500000
NODE_7932_length_938_cov_2.693683	59	139	2	76	80	0.9500000
NODE_7932_length_938_cov_2.693683	112	192	0	57	80	0.7125000
NODE_7932_length_938_cov_2.693683	112	192	2	23	80	0.2875000
NODE_7946_length_937_cov_31.890215	407	487	2	20	80	0.2500000
NODE_7946_length_937_cov_31.890215	407	487	4	60	80	0.7500000
NODE_7946_length_937_cov_31.890215	460	536	0	36	76	0.4736842
NODE_7946_length_937_cov_31.890215	460	536	2	33	76	0.4342105
NODE_7946_length_937_cov_31.890215	460	536	4	7	76	0.0921053
NODE_7947_length_937_cov_31.198091	425	505	0	51	80	0.6375000
NODE_7947_length_937_cov_31.198091	425	505	2	29	80	0.3625000
NODE_7947_length_937_cov_31.198091	478	558	0	80	80	1.0000000
NODE_7948_length_937_cov_29.742243	296	376	0	80	80	1.0000000
NODE_7948_length_937_cov_29.742243	349	429	0	34	80	0.4250000
NODE_7948_length_937_cov_29.742243	349	429	6	46	80	0.5750000
NODE_7948_length_937_cov_29.742243	425	505	4	17	80	0.2125000
NODE_7948_length_937_cov_29.742243	425	505	6	32	80	0.4000000
NODE_7948_length_937_cov_29.742243	425	505	10	31	80	0.3875000
NODE_7948_length_937_cov_29.742243	478	558	0	1	80	0.0125000
NODE_7948_length_937_cov_29.742243	478	558	4	69	80	0.8625000
NODE_7948_length_937_cov_29.742243	478	558	10	10	80	0.1250000
NODE_7950_length_937_cov_26.153938	487	567	0	80	80	1.0000000
NODE_7950_length_937_cov_26.153938	540	620	0	33	80	0.4125000
NODE_7950_length_937_cov_26.153938	540	620	2	47	80	0.5875000
NODE_7951_length_937_cov_20.898568	515	595	0	67	80	0.8375000
NODE_7951_length_937_cov_20.898568	515	595	2	13	80	0.1625000
NODE_7951_length_937_cov_20.898568	568	648	0	80	80	1.0000000
NODE_7952_length_937_cov_20.502387	181	261	2	12	80	0.1500000
NODE_7952_length_937_cov_20.502387	181	261	4	68	80	0.8500000
NODE_7952_length_937_cov_20.502387	234	314	0	44	80	0.5500000
NODE_7952_length_937_cov_20.502387	234	314	2	21	80	0.2625000
NODE_7952_length_937_cov_20.502387	234	314	4	15	80	0.1875000
NODE_7952_length_937_cov_20.502387	310	390	0	40	80	0.5000000
NODE_7952_length_937_cov_20.502387	310	390	4	40	80	0.5000000
NODE_7952_length_937_cov_20.502387	363	443	0	20	80	0.2500000
NODE_7952_length_937_cov_20.502387	363	443	4	60	80	0.7500000
NODE_7953_length_937_cov_15.219570	526	606	2	13	80	0.1625000
NODE_7953_length_937_cov_15.219570	526	606	4	30	80	0.3750000
NODE_7953_length_937_cov_15.219570	526	606	6	37	80	0.4625000
NODE_7953_length_937_cov_15.219570	579	659	2	8	80	0.1000000
NODE_7953_length_937_cov_15.219570	579	659	4	24	80	0.3000000
NODE_7953_length_937_cov_15.219570	579	659	6	48	80	0.6000000
NODE_7954_length_937_cov_9.633652	521	601	0	80	80	1.0000000
NODE_7954_length_937_cov_9.633652	574	654	0	80	80	1.0000000
NODE_7956_length_937_cov_6.630072	305	385	0	6	80	0.0750000
NODE_7956_length_937_cov_6.630072	305	385	2	27	80	0.3375000
NODE_7956_length_937_cov_6.630072	305	385	4	38	80	0.4750000
NODE_7956_length_937_cov_6.630072	305	385	6	9	80	0.1125000
NODE_7956_length_937_cov_6.630072	358	438	2	7	80	0.0875000
NODE_7956_length_937_cov_6.630072	358	438	4	60	80	0.7500000
NODE_7956_length_937_cov_6.630072	358	438	6	13	80	0.1625000
NODE_7957_length_937_cov_4.649165	470	550	0	49	80	0.6125000
NODE_7957_length_937_cov_4.649165	470	550	2	31	80	0.3875000
NODE_7957_length_937_cov_4.649165	523	603	0	21	80	0.2625000
NODE_7957_length_937_cov_4.649165	523	603	2	59	80	0.7375000
NODE_7969_length_936_cov_57.105137	267	347	0	80	80	1.0000000
NODE_7969_length_936_cov_57.105137	320	400	0	80	80	1.0000000
NODE_7969_length_936_cov_57.105137	396	476	0	80	80	1.0000000
NODE_7969_length_936_cov_57.105137	449	529	0	80	80	1.0000000
NODE_7970_length_936_cov_39.983274	433	513	4	15	80	0.1875000
NODE_7970_length_936_cov_39.983274	433	513	8	8	80	0.1000000
NODE_7970_length_936_cov_39.983274	433	513	12	57	80	0.7125000
NODE_7970_length_936_cov_39.983274	486	566	0	50	80	0.6250000
NODE_7970_length_936_cov_39.983274	486	566	4	18	80	0.2250000
NODE_7970_length_936_cov_39.983274	486	566	8	1	80	0.0125000
NODE_7970_length_936_cov_39.983274	486	566	12	11	80	0.1375000
NODE_7971_length_936_cov_22.486260	534	614	0	35	80	0.4375000
NODE_7971_length_936_cov_22.486260	534	614	2	45	80	0.5625000
NODE_7971_length_936_cov_22.486260	587	667	0	80	80	1.0000000
NODE_7972_length_936_cov_19.639188	409	489	0	80	80	1.0000000
NODE_7972_length_936_cov_19.639188	462	542	0	80	80	1.0000000
NODE_7973_length_936_cov_15.083632	322	402	0	80	80	1.0000000
NODE_7973_length_936_cov_15.083632	375	455	0	42	80	0.5250000
NODE_7973_length_936_cov_15.083632	375	455	10	38	80	0.4750000
NODE_7974_length_936_cov_13.962963	356	424	0	7	68	0.1029412
NODE_7974_length_936_cov_13.962963	356	424	4	16	68	0.2352941
NODE_7974_length_936_cov_13.962963	356	424	6	1	68	0.0147059
NODE_7974_length_936_cov_13.962963	356	424	7	27	68	0.3970588
NODE_7974_length_936_cov_13.962963	356	424	8	17	68	0.2500000
NODE_7975_length_936_cov_12.502987	447	527	0	80	80	1.0000000
NODE_7975_length_936_cov_12.502987	500	580	0	80	80	1.0000000
NODE_7976_length_936_cov_12.279570	340	420	0	80	80	1.0000000
NODE_7976_length_936_cov_12.279570	393	473	0	80	80	1.0000000
NODE_7977_length_936_cov_7.906810	587	667	0	80	80	1.0000000
NODE_7977_length_936_cov_7.906810	640	720	0	80	80	1.0000000
NODE_7978_length_936_cov_6.845878	322	402	0	80	80	1.0000000
NODE_7978_length_936_cov_6.845878	375	455	0	80	80	1.0000000
NODE_7979_length_936_cov_6.434886	556	635	0	64	79	0.8101266
NODE_7979_length_936_cov_6.434886	556	635	2	15	79	0.1898734
NODE_7979_length_936_cov_6.434886	608	688	0	12	80	0.1500000
NODE_7979_length_936_cov_6.434886	608	688	2	68	80	0.8500000
NODE_7993_length_935_cov_38.209330	57	137	80	2	80	0.0250000
NODE_7993_length_935_cov_38.209330	57	137	82	1	80	0.0125000
NODE_7993_length_935_cov_38.209330	57	137	85	1	80	0.0125000
NODE_7993_length_935_cov_38.209330	57	137	91	1	80	0.0125000
NODE_7993_length_935_cov_38.209330	57	137	92	1	80	0.0125000
NODE_7993_length_935_cov_38.209330	57	137	94	2	80	0.0250000
NODE_7993_length_935_cov_38.209330	57	137	96	2	80	0.0250000
NODE_7993_length_935_cov_38.209330	57	137	100	1	80	0.0125000
NODE_7993_length_935_cov_38.209330	57	137	104	2	80	0.0250000
NODE_7993_length_935_cov_38.209330	57	137	106	1	80	0.0125000
NODE_7993_length_935_cov_38.209330	57	137	110	3	80	0.0375000
NODE_7993_length_935_cov_38.209330	57	137	112	1	80	0.0125000
NODE_7993_length_935_cov_38.209330	57	137	114	2	80	0.0250000
NODE_7993_length_935_cov_38.209330	57	137	118	2	80	0.0250000
NODE_7993_length_935_cov_38.209330	57	137	120	2	80	0.0250000
NODE_7993_length_935_cov_38.209330	57	137	122	5	80	0.0625000
NODE_7993_length_935_cov_38.209330	57	137	124	51	80	0.6375000
NODE_7994_length_935_cov_27.306220	439	519	0	9	80	0.1125000
NODE_7994_length_935_cov_27.306220	439	519	2	13	80	0.1625000
NODE_7994_length_935_cov_27.306220	439	519	6	58	80	0.7250000
NODE_7994_length_935_cov_27.306220	492	572	0	9	80	0.1125000
NODE_7994_length_935_cov_27.306220	492	572	2	66	80	0.8250000
NODE_7994_length_935_cov_27.306220	492	572	6	5	80	0.0625000
NODE_7995_length_935_cov_26.562201	321	401	0	71	80	0.8875000
NODE_7995_length_935_cov_26.562201	321	401	4	9	80	0.1125000
NODE_7995_length_935_cov_26.562201	374	454	0	18	80	0.2250000
NODE_7995_length_935_cov_26.562201	374	454	4	36	80	0.4500000
NODE_7995_length_935_cov_26.562201	374	454	6	26	80	0.3250000
NODE_7995_length_935_cov_26.562201	450	530	4	15	80	0.1875000
NODE_7995_length_935_cov_26.562201	450	530	6	14	80	0.1750000
NODE_7995_length_935_cov_26.562201	450	530	8	51	80	0.6375000
NODE_7995_length_935_cov_26.562201	503	583	0	32	80	0.4000000
NODE_7995_length_935_cov_26.562201	503	583	2	18	80	0.2250000
NODE_7995_length_935_cov_26.562201	503	583	4	18	80	0.2250000
NODE_7995_length_935_cov_26.562201	503	583	8	12	80	0.1500000
NODE_7996_length_935_cov_25.098086	356	436	0	77	80	0.9625000
NODE_7996_length_935_cov_25.098086	356	436	2	3	80	0.0375000
NODE_7996_length_935_cov_25.098086	409	489	0	24	80	0.3000000
NODE_7996_length_935_cov_25.098086	409	489	2	56	80	0.7000000
NODE_7997_length_935_cov_24.316986	467	547	6	35	80	0.4375000
NODE_7997_length_935_cov_24.316986	467	547	8	21	80	0.2625000
NODE_7997_length_935_cov_24.316986	467	547	10	8	80	0.1000000
NODE_7997_length_935_cov_24.316986	467	547	12	15	80	0.1875000
NODE_7997_length_935_cov_24.316986	467	547	14	1	80	0.0125000
NODE_7997_length_935_cov_24.316986	520	600	8	30	80	0.3750000
NODE_7997_length_935_cov_24.316986	520	600	10	34	80	0.4250000
NODE_7997_length_935_cov_24.316986	520	600	12	15	80	0.1875000
NODE_7997_length_935_cov_24.316986	520	600	14	1	80	0.0125000
NODE_7998_length_935_cov_19.221292	397	477	0	11	80	0.1375000
NODE_7998_length_935_cov_19.221292	397	477	2	69	80	0.8625000
NODE_7998_length_935_cov_19.221292	450	530	0	35	80	0.4375000
NODE_7998_length_935_cov_19.221292	450	530	2	45	80	0.5625000
NODE_7999_length_935_cov_15.016746	404	484	0	65	80	0.8125000
NODE_7999_length_935_cov_15.016746	404	484	1	2	80	0.0250000
NODE_7999_length_935_cov_15.016746	404	484	2	2	80	0.0250000
NODE_7999_length_935_cov_15.016746	404	484	4	11	80	0.1375000
NODE_7999_length_935_cov_15.016746	457	537	0	12	80	0.1500000
NODE_7999_length_935_cov_15.016746	457	537	1	2	80	0.0250000
NODE_7999_length_935_cov_15.016746	457	537	2	2	80	0.0250000
NODE_7999_length_935_cov_15.016746	457	537	4	64	80	0.8000000
NODE_8000_length_935_cov_13.138756	341	421	0	27	80	0.3375000
NODE_8000_length_935_cov_13.138756	341	421	2	37	80	0.4625000
NODE_8000_length_935_cov_13.138756	341	421	3	1	80	0.0125000
NODE_8000_length_935_cov_13.138756	341	421	4	15	80	0.1875000
NODE_8000_length_935_cov_13.138756	394	474	2	11	80	0.1375000
NODE_8000_length_935_cov_13.138756	394	474	3	1	80	0.0125000
NODE_8000_length_935_cov_13.138756	394	474	4	19	80	0.2375000
NODE_8000_length_935_cov_13.138756	394	474	6	49	80	0.6125000
NODE_8002_length_935_cov_6.485646	512	592	0	26	80	0.3250000
NODE_8002_length_935_cov_6.485646	512	592	2	7	80	0.0875000
NODE_8002_length_935_cov_6.485646	512	592	5	14	80	0.1750000
NODE_8002_length_935_cov_6.485646	512	592	7	33	80	0.4125000
NODE_8002_length_935_cov_6.485646	565	645	5	33	80	0.4125000
NODE_8002_length_935_cov_6.485646	565	645	7	47	80	0.5875000
NODE_8003_length_935_cov_6.467703	250	330	0	80	80	1.0000000
NODE_8003_length_935_cov_6.467703	303	383	0	80	80	1.0000000
NODE_8004_length_935_cov_6.144737	478	558	0	80	80	1.0000000
NODE_8004_length_935_cov_6.144737	531	611	0	80	80	1.0000000
NODE_8005_length_935_cov_3.905502	39	119	12	2	80	0.0250000
NODE_8005_length_935_cov_3.905502	39	119	14	57	80	0.7125000
NODE_8005_length_935_cov_3.905502	39	119	16	21	80	0.2625000
NODE_8005_length_935_cov_3.905502	92	166	2	4	74	0.0540541
NODE_8005_length_935_cov_3.905502	92	166	8	4	74	0.0540541
NODE_8005_length_935_cov_3.905502	92	166	9	6	74	0.0810811
NODE_8005_length_935_cov_3.905502	92	166	12	26	74	0.3513514
NODE_8005_length_935_cov_3.905502	92	166	14	11	74	0.1486486
NODE_8005_length_935_cov_3.905502	92	166	16	23	74	0.3108108
NODE_8028_length_934_cov_22.898204	403	483	0	58	80	0.7250000
NODE_8028_length_934_cov_22.898204	403	483	6	22	80	0.2750000
NODE_8028_length_934_cov_22.898204	456	536	0	10	80	0.1250000
NODE_8028_length_934_cov_22.898204	456	536	6	70	80	0.8750000
NODE_8029_length_934_cov_17.746108	246	326	0	80	80	1.0000000
NODE_8029_length_934_cov_17.746108	299	379	0	80	80	1.0000000
NODE_8030_length_934_cov_16.049102	367	447	0	80	80	1.0000000
NODE_8030_length_934_cov_16.049102	420	500	0	80	80	1.0000000
NODE_8031_length_934_cov_13.738922	379	459	2	80	80	1.0000000
NODE_8031_length_934_cov_13.738922	432	459	2	27	27	1.0000000
NODE_8031_length_934_cov_13.738922	470	512	0	37	42	0.8809524
NODE_8031_length_934_cov_13.738922	470	512	2	5	42	0.1190476
NODE_8032_length_934_cov_9.091018	407	487	5	33	80	0.4125000
NODE_8032_length_934_cov_9.091018	407	487	6	47	80	0.5875000
NODE_8032_length_934_cov_9.091018	460	540	2	37	80	0.4625000
NODE_8032_length_934_cov_9.091018	460	540	5	42	80	0.5250000
NODE_8032_length_934_cov_9.091018	460	540	7	1	80	0.0125000
NODE_8034_length_934_cov_5.349701	583	663	0	80	80	1.0000000
NODE_8050_length_933_cov_36.557554	462	542	0	18	80	0.2250000
NODE_8050_length_933_cov_36.557554	462	542	2	62	80	0.7750000
NODE_8050_length_933_cov_36.557554	515	595	0	15	80	0.1875000
NODE_8050_length_933_cov_36.557554	515	595	2	65	80	0.8125000
NODE_8051_length_933_cov_27.645084	476	556	2	15	80	0.1875000
NODE_8051_length_933_cov_27.645084	476	556	4	65	80	0.8125000
NODE_8051_length_933_cov_27.645084	529	609	0	11	80	0.1375000
NODE_8051_length_933_cov_27.645084	529	609	1	8	80	0.1000000
NODE_8051_length_933_cov_27.645084	529	609	2	11	80	0.1375000
NODE_8051_length_933_cov_27.645084	529	609	4	50	80	0.6250000
NODE_8052_length_933_cov_26.749400	611	691	0	52	80	0.6500000
NODE_8052_length_933_cov_26.749400	611	691	2	28	80	0.3500000
NODE_8052_length_933_cov_26.749400	664	744	0	22	80	0.2750000
NODE_8052_length_933_cov_26.749400	664	744	2	58	80	0.7250000
NODE_8053_length_933_cov_26.308153	430	510	0	80	80	1.0000000
NODE_8053_length_933_cov_26.308153	483	563	0	80	80	1.0000000
NODE_8054_length_933_cov_19.966427	444	530	0	17	86	0.1976744
NODE_8054_length_933_cov_19.966427	444	530	2	69	86	0.8023256
NODE_8054_length_933_cov_19.966427	497	583	0	12	86	0.1395349
NODE_8054_length_933_cov_19.966427	497	583	2	74	86	0.8604651
NODE_8055_length_933_cov_16.870504	284	364	6	80	80	1.0000000
NODE_8055_length_933_cov_16.870504	337	415	0	34	78	0.4358974
NODE_8055_length_933_cov_16.870504	337	415	6	44	78	0.5641026
NODE_8056_length_933_cov_16.699041	366	446	0	31	80	0.3875000
NODE_8056_length_933_cov_16.699041	366	446	2	49	80	0.6125000
NODE_8056_length_933_cov_16.699041	419	499	0	30	80	0.3750000
NODE_8056_length_933_cov_16.699041	419	499	2	50	80	0.6250000
NODE_8057_length_933_cov_11.171463	197	277	0	50	80	0.6250000
NODE_8057_length_933_cov_11.171463	197	277	4	30	80	0.3750000
NODE_8057_length_933_cov_11.171463	250	330	4	80	80	1.0000000
NODE_8073_length_932_cov_26.656663	397	477	0	38	80	0.4750000
NODE_8073_length_932_cov_26.656663	397	477	4	42	80	0.5250000
NODE_8073_length_932_cov_26.656663	450	530	0	80	80	1.0000000
NODE_8074_length_932_cov_16.581032	407	485	12	62	78	0.7948718
NODE_8074_length_932_cov_16.581032	407	485	14	16	78	0.2051282
NODE_8074_length_932_cov_16.581032	460	538	0	12	78	0.1538462
NODE_8074_length_932_cov_16.581032	460	538	2	38	78	0.4871795
NODE_8074_length_932_cov_16.581032	460	538	12	9	78	0.1153846
NODE_8074_length_932_cov_16.581032	460	538	14	19	78	0.2435897
NODE_8075_length_932_cov_13.462185	413	493	0	35	80	0.4375000
NODE_8075_length_932_cov_13.462185	413	493	2	45	80	0.5625000
NODE_8075_length_932_cov_13.462185	466	546	0	80	80	1.0000000
NODE_8076_length_932_cov_13.442977	386	466	4	40	80	0.5000000
NODE_8076_length_932_cov_13.442977	386	466	6	40	80	0.5000000
NODE_8076_length_932_cov_13.442977	439	519	2	11	80	0.1375000
NODE_8076_length_932_cov_13.442977	439	519	6	69	80	0.8625000
NODE_8077_length_932_cov_11.947179	344	424	0	80	80	1.0000000
NODE_8077_length_932_cov_11.947179	397	477	0	80	80	1.0000000
NODE_8079_length_932_cov_10.849940	409	489	0	80	80	1.0000000
NODE_8079_length_932_cov_10.849940	462	542	0	80	80	1.0000000
NODE_8080_length_932_cov_10.174070	342	422	0	13	80	0.1625000
NODE_8080_length_932_cov_10.174070	342	422	2	67	80	0.8375000
NODE_8080_length_932_cov_10.174070	395	475	0	32	80	0.4000000
NODE_8080_length_932_cov_10.174070	395	475	2	48	80	0.6000000
NODE_8082_length_932_cov_9.200480	184	264	0	80	80	1.0000000
NODE_8082_length_932_cov_9.200480	237	317	0	80	80	1.0000000
NODE_8090_length_932_cov_2.689076	598	676	0	78	78	1.0000000
NODE_8090_length_932_cov_2.689076	798	845	0	47	47	1.0000000
NODE_8103_length_931_cov_51.451923	320	400	0	80	80	1.0000000
NODE_8103_length_931_cov_51.451923	373	453	0	80	80	1.0000000
NODE_8104_length_931_cov_46.621394	527	607	4	1	80	0.0125000
NODE_8104_length_931_cov_46.621394	527	607	6	79	80	0.9875000
NODE_8104_length_931_cov_46.621394	580	660	0	43	80	0.5375000
NODE_8104_length_931_cov_46.621394	580	660	2	3	80	0.0375000
NODE_8104_length_931_cov_46.621394	580	660	6	34	80	0.4250000
NODE_8105_length_931_cov_36.334135	347	427	0	57	80	0.7125000
NODE_8105_length_931_cov_36.334135	347	427	4	23	80	0.2875000
NODE_8105_length_931_cov_36.334135	400	480	0	4	80	0.0500000
NODE_8105_length_931_cov_36.334135	400	480	4	30	80	0.3750000
NODE_8105_length_931_cov_36.334135	400	480	6	46	80	0.5750000
NODE_8106_length_931_cov_32.495192	482	562	0	4	80	0.0500000
NODE_8106_length_931_cov_32.495192	482	562	2	14	80	0.1750000
NODE_8106_length_931_cov_32.495192	482	562	6	62	80	0.7750000
NODE_8106_length_931_cov_32.495192	535	617	0	59	82	0.7195122
NODE_8106_length_931_cov_32.495192	535	617	2	14	82	0.1707317
NODE_8106_length_931_cov_32.495192	535	617	6	9	82	0.1097561
NODE_8107_length_931_cov_22.100962	375	455	20	80	80	1.0000000
NODE_8107_length_931_cov_22.100962	428	508	0	10	80	0.1250000
NODE_8107_length_931_cov_22.100962	428	508	6	23	80	0.2875000
NODE_8107_length_931_cov_22.100962	428	508	8	19	80	0.2375000
NODE_8107_length_931_cov_22.100962	428	508	20	28	80	0.3500000
NODE_8108_length_931_cov_21.781250	347	427	0	26	80	0.3250000
NODE_8108_length_931_cov_21.781250	347	427	4	39	80	0.4875000
NODE_8108_length_931_cov_21.781250	347	427	6	15	80	0.1875000
NODE_8108_length_931_cov_21.781250	400	480	2	20	80	0.2500000
NODE_8108_length_931_cov_21.781250	400	480	4	12	80	0.1500000
NODE_8108_length_931_cov_21.781250	400	480	5	25	80	0.3125000
NODE_8108_length_931_cov_21.781250	400	480	6	23	80	0.2875000
NODE_8109_length_931_cov_19.084135	411	491	0	9	80	0.1125000
NODE_8109_length_931_cov_19.084135	411	491	2	71	80	0.8875000
NODE_8109_length_931_cov_19.084135	464	544	0	22	80	0.2750000
NODE_8109_length_931_cov_19.084135	464	544	2	58	80	0.7250000
NODE_8110_length_931_cov_14.879808	444	524	0	5	80	0.0625000
NODE_8110_length_931_cov_14.879808	444	524	2	6	80	0.0750000
NODE_8110_length_931_cov_14.879808	444	524	4	52	80	0.6500000
NODE_8110_length_931_cov_14.879808	444	524	6	17	80	0.2125000
NODE_8110_length_931_cov_14.879808	497	577	2	15	80	0.1875000
NODE_8110_length_931_cov_14.879808	497	577	4	44	80	0.5500000
NODE_8110_length_931_cov_14.879808	497	577	6	21	80	0.2625000
NODE_8111_length_931_cov_13.087740	759	800	10	2	41	0.0487805
NODE_8111_length_931_cov_13.087740	759	800	12	1	41	0.0243902
NODE_8111_length_931_cov_13.087740	759	800	14	1	41	0.0243902
NODE_8111_length_931_cov_13.087740	759	800	18	1	41	0.0243902
NODE_8111_length_931_cov_13.087740	759	800	20	16	41	0.3902439
NODE_8111_length_931_cov_13.087740	759	800	22	14	41	0.3414634
NODE_8111_length_931_cov_13.087740	759	800	24	4	41	0.0975610
NODE_8111_length_931_cov_13.087740	759	800	26	2	41	0.0487805
NODE_8112_length_931_cov_10.534856	399	479	0	24	80	0.3000000
NODE_8112_length_931_cov_10.534856	399	479	4	56	80	0.7000000
NODE_8112_length_931_cov_10.534856	452	532	0	20	80	0.2500000
NODE_8112_length_931_cov_10.534856	452	532	4	60	80	0.7500000
NODE_8113_length_931_cov_9.865385	236	316	0	80	80	1.0000000
NODE_8113_length_931_cov_9.865385	289	369	0	28	80	0.3500000
NODE_8113_length_931_cov_9.865385	289	369	2	52	80	0.6500000
NODE_8115_length_931_cov_6.201923	479	559	5	24	80	0.3000000
NODE_8115_length_931_cov_6.201923	479	559	7	4	80	0.0500000
NODE_8115_length_931_cov_6.201923	479	559	8	6	80	0.0750000
NODE_8115_length_931_cov_6.201923	479	559	9	1	80	0.0125000
NODE_8115_length_931_cov_6.201923	479	559	10	45	80	0.5625000
NODE_8115_length_931_cov_6.201923	532	612	0	33	80	0.4125000
NODE_8115_length_931_cov_6.201923	532	612	3	6	80	0.0750000
NODE_8115_length_931_cov_6.201923	532	612	5	38	80	0.4750000
NODE_8115_length_931_cov_6.201923	532	612	7	3	80	0.0375000
NODE_8124_length_931_cov_1.780048	832	902	0	70	70	1.0000000
NODE_8126_length_931_cov_1.433894	220	284	11	6	64	0.0937500
NODE_8126_length_931_cov_1.433894	220	284	13	12	64	0.1875000
NODE_8126_length_931_cov_1.433894	220	284	15	6	64	0.0937500
NODE_8126_length_931_cov_1.433894	220	284	16	4	64	0.0625000
NODE_8126_length_931_cov_1.433894	220	284	17	7	64	0.1093750
NODE_8126_length_931_cov_1.433894	220	284	18	29	64	0.4531250
NODE_8131_length_930_cov_49.052948	252	332	0	34	80	0.4250000
NODE_8131_length_930_cov_49.052948	252	332	2	46	80	0.5750000
NODE_8131_length_930_cov_49.052948	305	385	0	64	80	0.8000000
NODE_8131_length_930_cov_49.052948	305	385	14	4	80	0.0500000
NODE_8131_length_930_cov_49.052948	305	385	16	12	80	0.1500000
NODE_8131_length_930_cov_49.052948	381	462	14	2	81	0.0246914
NODE_8131_length_930_cov_49.052948	381	462	16	51	81	0.6296296
NODE_8131_length_930_cov_49.052948	381	462	17	9	81	0.1111111
NODE_8131_length_930_cov_49.052948	381	462	18	6	81	0.0740741
NODE_8131_length_930_cov_49.052948	381	462	20	13	81	0.1604938
NODE_8131_length_930_cov_49.052948	435	515	4	10	80	0.1250000
NODE_8131_length_930_cov_49.052948	435	515	6	6	80	0.0750000
NODE_8131_length_930_cov_49.052948	435	515	8	21	80	0.2625000
NODE_8131_length_930_cov_49.052948	435	515	14	2	80	0.0250000
NODE_8131_length_930_cov_49.052948	435	515	16	22	80	0.2750000
NODE_8131_length_930_cov_49.052948	435	515	17	9	80	0.1125000
NODE_8131_length_930_cov_49.052948	435	515	20	10	80	0.1250000
NODE_8132_length_930_cov_31.510229	400	482	10	76	82	0.9268293
NODE_8132_length_930_cov_31.510229	400	482	12	6	82	0.0731707
NODE_8132_length_930_cov_31.510229	453	535	0	48	82	0.5853658
NODE_8132_length_930_cov_31.510229	453	535	10	34	82	0.4146341
NODE_8133_length_930_cov_29.139591	329	409	2	37	80	0.4625000
NODE_8133_length_930_cov_29.139591	329	409	4	43	80	0.5375000
NODE_8133_length_930_cov_29.139591	382	462	2	74	80	0.9250000
NODE_8133_length_930_cov_29.139591	382	462	4	6	80	0.0750000
NODE_8134_length_930_cov_24.787004	518	598	6	80	80	1.0000000
NODE_8134_length_930_cov_24.787004	571	651	2	43	80	0.5375000
NODE_8134_length_930_cov_24.787004	571	651	6	28	80	0.3500000
NODE_8134_length_930_cov_24.787004	571	651	8	9	80	0.1125000
NODE_8135_length_930_cov_24.608905	300	380	2	31	80	0.3875000
NODE_8135_length_930_cov_24.608905	300	380	6	10	80	0.1250000
NODE_8135_length_930_cov_24.608905	300	380	7	3	80	0.0375000
NODE_8135_length_930_cov_24.608905	300	380	8	36	80	0.4500000
NODE_8135_length_930_cov_24.608905	353	433	2	19	80	0.2375000
NODE_8135_length_930_cov_24.608905	353	433	6	24	80	0.3000000
NODE_8135_length_930_cov_24.608905	353	433	8	37	80	0.4625000
NODE_8136_length_930_cov_16.494585	482	562	4	21	80	0.2625000
NODE_8136_length_930_cov_16.494585	482	562	6	29	80	0.3625000
NODE_8136_length_930_cov_16.494585	482	562	8	22	80	0.2750000
NODE_8136_length_930_cov_16.494585	482	562	10	8	80	0.1000000
NODE_8136_length_930_cov_16.494585	535	615	6	54	80	0.6750000
NODE_8136_length_930_cov_16.494585	535	615	8	26	80	0.3250000
NODE_8137_length_930_cov_13.296029	249	329	2	80	80	1.0000000
NODE_8137_length_930_cov_13.296029	302	382	0	33	80	0.4125000
NODE_8137_length_930_cov_13.296029	302	382	2	47	80	0.5875000
NODE_8137_length_930_cov_13.296029	378	458	0	80	80	1.0000000
NODE_8137_length_930_cov_13.296029	431	511	0	80	80	1.0000000
NODE_8138_length_930_cov_11.758123	463	543	0	80	80	1.0000000
NODE_8138_length_930_cov_11.758123	516	596	0	80	80	1.0000000
NODE_8139_length_930_cov_7.576414	531	611	0	29	80	0.3625000
NODE_8139_length_930_cov_7.576414	531	611	2	51	80	0.6375000
NODE_8139_length_930_cov_7.576414	584	664	0	2	80	0.0250000
NODE_8139_length_930_cov_7.576414	584	664	2	78	80	0.9750000
NODE_8156_length_930_cov_0.821901	676	736	0	60	60	1.0000000
NODE_8157_length_929_cov_54.485542	313	393	0	10	80	0.1250000
NODE_8157_length_929_cov_54.485542	313	393	4	8	80	0.1000000
NODE_8157_length_929_cov_54.485542	313	393	10	41	80	0.5125000
NODE_8157_length_929_cov_54.485542	313	393	11	3	80	0.0375000
NODE_8157_length_929_cov_54.485542	313	393	13	8	80	0.1000000
NODE_8157_length_929_cov_54.485542	313	393	14	10	80	0.1250000
NODE_8157_length_929_cov_54.485542	366	446	4	4	80	0.0500000
NODE_8157_length_929_cov_54.485542	366	446	10	60	80	0.7500000
NODE_8157_length_929_cov_54.485542	366	446	13	6	80	0.0750000
NODE_8157_length_929_cov_54.485542	366	446	14	10	80	0.1250000
NODE_8157_length_929_cov_54.485542	442	522	2	16	80	0.2000000
NODE_8157_length_929_cov_54.485542	442	522	3	11	80	0.1375000
NODE_8157_length_929_cov_54.485542	442	522	4	53	80	0.6625000
NODE_8157_length_929_cov_54.485542	495	575	2	55	80	0.6875000
NODE_8157_length_929_cov_54.485542	495	575	3	11	80	0.1375000
NODE_8157_length_929_cov_54.485542	495	575	4	14	80	0.1750000
NODE_8158_length_929_cov_49.865060	429	509	0	80	80	1.0000000
NODE_8158_length_929_cov_49.865060	482	562	0	48	80	0.6000000
NODE_8158_length_929_cov_49.865060	482	562	2	16	80	0.2000000
NODE_8158_length_929_cov_49.865060	482	562	6	16	80	0.2000000
NODE_8159_length_929_cov_34.634940	358	438	4	80	80	1.0000000
NODE_8159_length_929_cov_34.634940	411	491	0	36	80	0.4500000
NODE_8159_length_929_cov_34.634940	411	491	4	44	80	0.5500000
NODE_8161_length_929_cov_20.815663	365	445	4	15	80	0.1875000
NODE_8161_length_929_cov_20.815663	365	445	5	14	80	0.1750000
NODE_8161_length_929_cov_20.815663	365	445	6	51	80	0.6375000
NODE_8161_length_929_cov_20.815663	418	498	2	42	80	0.5250000
NODE_8161_length_929_cov_20.815663	418	498	4	19	80	0.2375000
NODE_8161_length_929_cov_20.815663	418	498	6	19	80	0.2375000
NODE_8162_length_929_cov_17.798795	376	456	0	13	80	0.1625000
NODE_8162_length_929_cov_17.798795	376	456	4	16	80	0.2000000
NODE_8162_length_929_cov_17.798795	376	456	6	50	80	0.6250000
NODE_8162_length_929_cov_17.798795	376	456	8	1	80	0.0125000
NODE_8162_length_929_cov_17.798795	429	509	2	26	80	0.3250000
NODE_8162_length_929_cov_17.798795	429	509	6	29	80	0.3625000
NODE_8162_length_929_cov_17.798795	429	509	8	25	80	0.3125000
NODE_8163_length_929_cov_16.622892	331	408	0	23	77	0.2987013
NODE_8163_length_929_cov_16.622892	331	408	6	54	77	0.7012987
NODE_8163_length_929_cov_16.622892	381	461	0	76	80	0.9500000
NODE_8163_length_929_cov_16.622892	381	461	6	4	80	0.0500000
NODE_8163_length_929_cov_16.622892	457	537	0	80	80	1.0000000
NODE_8163_length_929_cov_16.622892	510	590	0	28	80	0.3500000
NODE_8163_length_929_cov_16.622892	510	590	2	52	80	0.6500000
NODE_8164_length_929_cov_15.242169	302	382	2	9	80	0.1125000
NODE_8164_length_929_cov_15.242169	302	382	4	5	80	0.0625000
NODE_8164_length_929_cov_15.242169	302	382	6	66	80	0.8250000
NODE_8164_length_929_cov_15.242169	355	435	0	11	80	0.1375000
NODE_8164_length_929_cov_15.242169	355	435	2	19	80	0.2375000
NODE_8164_length_929_cov_15.242169	355	435	4	28	80	0.3500000
NODE_8164_length_929_cov_15.242169	355	435	6	22	80	0.2750000
NODE_8164_length_929_cov_15.242169	431	511	4	37	80	0.4625000
NODE_8164_length_929_cov_15.242169	431	511	5	1	80	0.0125000
NODE_8164_length_929_cov_15.242169	431	511	6	37	80	0.4625000
NODE_8164_length_929_cov_15.242169	431	511	8	5	80	0.0625000
NODE_8164_length_929_cov_15.242169	484	564	4	23	80	0.2875000
NODE_8164_length_929_cov_15.242169	484	564	6	45	80	0.5625000
NODE_8164_length_929_cov_15.242169	484	564	8	12	80	0.1500000
NODE_8165_length_929_cov_13.197590	259	339	0	80	80	1.0000000
NODE_8165_length_929_cov_13.197590	312	392	0	64	80	0.8000000
NODE_8165_length_929_cov_13.197590	312	392	2	16	80	0.2000000
NODE_8167_length_929_cov_7.766265	385	465	2	21	80	0.2625000
NODE_8167_length_929_cov_7.766265	385	465	4	59	80	0.7375000
NODE_8167_length_929_cov_7.766265	438	518	0	18	80	0.2250000
NODE_8167_length_929_cov_7.766265	438	518	2	37	80	0.4625000
NODE_8167_length_929_cov_7.766265	438	518	4	25	80	0.3125000
NODE_8168_length_929_cov_5.750602	382	462	0	80	80	1.0000000
NODE_8168_length_929_cov_5.750602	435	515	0	80	80	1.0000000
NODE_8181_length_928_cov_35.226779	273	353	0	80	80	1.0000000
NODE_8181_length_928_cov_35.226779	326	406	0	80	80	1.0000000
NODE_8181_length_928_cov_35.226779	402	482	0	17	80	0.2125000
NODE_8181_length_928_cov_35.226779	402	482	2	45	80	0.5625000
NODE_8181_length_928_cov_35.226779	402	482	4	18	80	0.2250000
NODE_8181_length_928_cov_35.226779	455	535	0	4	80	0.0500000
NODE_8181_length_928_cov_35.226779	455	535	2	43	80	0.5375000
NODE_8181_length_928_cov_35.226779	455	535	4	33	80	0.4125000
NODE_8182_length_928_cov_25.218335	299	379	0	41	80	0.5125000
NODE_8182_length_928_cov_25.218335	299	379	2	39	80	0.4875000
NODE_8182_length_928_cov_25.218335	352	432	0	14	80	0.1750000
NODE_8182_length_928_cov_25.218335	352	432	2	66	80	0.8250000
NODE_8183_length_928_cov_22.815440	342	422	0	80	80	1.0000000
NODE_8183_length_928_cov_22.815440	395	475	0	80	80	1.0000000
NODE_8183_length_928_cov_22.815440	471	551	0	5	80	0.0625000
NODE_8183_length_928_cov_22.815440	471	551	6	17	80	0.2125000
NODE_8183_length_928_cov_22.815440	471	551	8	58	80	0.7250000
NODE_8183_length_928_cov_22.815440	524	604	0	15	80	0.1875000
NODE_8183_length_928_cov_22.815440	524	604	6	22	80	0.2750000
NODE_8183_length_928_cov_22.815440	524	604	8	43	80	0.5375000
NODE_8184_length_928_cov_20.718938	365	445	0	28	80	0.3500000
NODE_8184_length_928_cov_20.718938	365	445	2	19	80	0.2375000
NODE_8184_length_928_cov_20.718938	365	445	4	33	80	0.4125000
NODE_8184_length_928_cov_20.718938	418	498	2	37	80	0.4625000
NODE_8184_length_928_cov_20.718938	418	498	4	43	80	0.5375000
NODE_8185_length_928_cov_19.418577	420	500	2	22	80	0.2750000
NODE_8185_length_928_cov_19.418577	420	500	4	36	80	0.4500000
NODE_8185_length_928_cov_19.418577	420	500	8	22	80	0.2750000
NODE_8185_length_928_cov_19.418577	473	553	4	5	80	0.0625000
NODE_8185_length_928_cov_19.418577	473	553	6	41	80	0.5125000
NODE_8185_length_928_cov_19.418577	473	553	8	34	80	0.4250000
NODE_8185_length_928_cov_19.418577	549	591	6	34	42	0.8095238
NODE_8185_length_928_cov_19.418577	549	591	8	8	42	0.1904762
NODE_8186_length_928_cov_13.354644	323	403	0	52	80	0.6500000
NODE_8186_length_928_cov_13.354644	323	403	4	28	80	0.3500000
NODE_8186_length_928_cov_13.354644	376	456	0	2	80	0.0250000
NODE_8186_length_928_cov_13.354644	376	456	4	78	80	0.9750000
NODE_8187_length_928_cov_13.096502	361	441	0	80	80	1.0000000
NODE_8187_length_928_cov_13.096502	414	494	0	80	80	1.0000000
NODE_8189_length_928_cov_10.399276	447	527	0	80	80	1.0000000
NODE_8189_length_928_cov_10.399276	500	580	0	80	80	1.0000000
NODE_8207_length_927_cov_19.516908	398	478	0	4	80	0.0500000
NODE_8207_length_927_cov_19.516908	398	478	4	1	80	0.0125000
NODE_8207_length_927_cov_19.516908	398	478	6	75	80	0.9375000
NODE_8207_length_927_cov_19.516908	451	531	0	24	80	0.3000000
NODE_8207_length_927_cov_19.516908	451	531	6	56	80	0.7000000
NODE_8208_length_927_cov_11.190821	358	438	6	80	80	1.0000000
NODE_8208_length_927_cov_11.190821	411	491	0	34	80	0.4250000
NODE_8208_length_927_cov_11.190821	411	491	2	12	80	0.1500000
NODE_8208_length_927_cov_11.190821	411	491	4	5	80	0.0625000
NODE_8208_length_927_cov_11.190821	411	491	6	29	80	0.3625000
NODE_8209_length_927_cov_8.123188	239	319	2	8	80	0.1000000
NODE_8209_length_927_cov_8.123188	239	319	4	72	80	0.9000000
NODE_8209_length_927_cov_8.123188	292	372	2	49	80	0.6125000
NODE_8209_length_927_cov_8.123188	292	372	4	31	80	0.3875000
NODE_8210_length_927_cov_4.585749	515	595	0	80	80	1.0000000
NODE_8210_length_927_cov_4.585749	568	648	0	80	80	1.0000000
NODE_8222_length_927_cov_1.250000	626	706	0	80	80	1.0000000
NODE_8222_length_927_cov_1.250000	679	759	0	80	80	1.0000000
NODE_8227_length_926_cov_78.382104	433	513	2	6	80	0.0750000
NODE_8227_length_926_cov_78.382104	433	513	4	3	80	0.0375000
NODE_8227_length_926_cov_78.382104	433	513	6	7	80	0.0875000
NODE_8227_length_926_cov_78.382104	433	513	8	1	80	0.0125000
NODE_8227_length_926_cov_78.382104	433	513	10	63	80	0.7875000
NODE_8227_length_926_cov_78.382104	486	566	0	32	80	0.4000000
NODE_8227_length_926_cov_78.382104	486	566	2	27	80	0.3375000
NODE_8227_length_926_cov_78.382104	486	566	4	3	80	0.0375000
NODE_8227_length_926_cov_78.382104	486	566	6	3	80	0.0375000
NODE_8227_length_926_cov_78.382104	486	566	10	15	80	0.1875000
NODE_8228_length_926_cov_44.385732	383	463	2	80	80	1.0000000
NODE_8228_length_926_cov_44.385732	436	516	0	28	80	0.3500000
NODE_8228_length_926_cov_44.385732	436	516	1	10	80	0.1250000
NODE_8228_length_926_cov_44.385732	436	516	2	42	80	0.5250000
NODE_8229_length_926_cov_43.446191	362	442	6	9	80	0.1125000
NODE_8229_length_926_cov_43.446191	362	442	8	71	80	0.8875000
NODE_8229_length_926_cov_43.446191	415	495	0	45	80	0.5625000
NODE_8229_length_926_cov_43.446191	415	495	6	17	80	0.2125000
NODE_8229_length_926_cov_43.446191	415	495	8	18	80	0.2250000
NODE_8229_length_926_cov_43.446191	491	571	0	64	80	0.8000000
NODE_8229_length_926_cov_43.446191	491	571	2	16	80	0.2000000
NODE_8229_length_926_cov_43.446191	544	624	0	11	80	0.1375000
NODE_8229_length_926_cov_43.446191	544	624	2	69	80	0.8625000
NODE_8230_length_926_cov_40.163241	42	61	2	12	19	0.6315789
NODE_8230_length_926_cov_40.163241	42	61	4	7	19	0.3684210
NODE_8230_length_926_cov_40.163241	279	359	0	4	80	0.0500000
NODE_8230_length_926_cov_40.163241	279	359	12	76	80	0.9500000
NODE_8230_length_926_cov_40.163241	332	412	0	57	80	0.7125000
NODE_8230_length_926_cov_40.163241	332	412	12	23	80	0.2875000
NODE_8230_length_926_cov_40.163241	408	488	0	80	80	1.0000000
NODE_8230_length_926_cov_40.163241	461	541	0	51	80	0.6375000
NODE_8230_length_926_cov_40.163241	461	541	2	29	80	0.3625000
NODE_8231_length_926_cov_29.923821	372	452	0	44	80	0.5500000
NODE_8231_length_926_cov_29.923821	372	452	2	36	80	0.4500000
NODE_8231_length_926_cov_29.923821	425	505	2	27	80	0.3375000
NODE_8231_length_926_cov_29.923821	425	505	5	53	80	0.6625000
NODE_8232_length_926_cov_24.657799	350	430	4	80	80	1.0000000
NODE_8232_length_926_cov_24.657799	403	483	0	50	80	0.6250000
NODE_8232_length_926_cov_24.657799	403	483	3	1	80	0.0125000
NODE_8232_length_926_cov_24.657799	403	483	4	29	80	0.3625000
NODE_8233_length_926_cov_17.438936	360	440	0	9	80	0.1125000
NODE_8233_length_926_cov_17.438936	360	440	2	68	80	0.8500000
NODE_8233_length_926_cov_17.438936	360	440	4	3	80	0.0375000
NODE_8233_length_926_cov_17.438936	413	493	0	8	80	0.1000000
NODE_8233_length_926_cov_17.438936	413	493	2	52	80	0.6500000
NODE_8233_length_926_cov_17.438936	413	493	4	20	80	0.2500000
NODE_8234_length_926_cov_12.413543	418	491	2	41	73	0.5616438
NODE_8234_length_926_cov_12.413543	418	491	4	32	73	0.4383562
NODE_8234_length_926_cov_12.413543	464	544	2	47	80	0.5875000
NODE_8234_length_926_cov_12.413543	464	544	4	33	80	0.4125000
NODE_8235_length_926_cov_5.771463	453	533	0	17	80	0.2125000
NODE_8235_length_926_cov_5.771463	453	533	2	26	80	0.3250000
NODE_8235_length_926_cov_5.771463	453	533	3	1	80	0.0125000
NODE_8235_length_926_cov_5.771463	453	533	4	36	80	0.4500000
NODE_8235_length_926_cov_5.771463	505	586	2	44	81	0.5432099
NODE_8235_length_926_cov_5.771463	505	586	4	37	81	0.4567901
NODE_8236_length_926_cov_5.209190	435	515	0	80	80	1.0000000
NODE_8236_length_926_cov_5.209190	488	568	0	80	80	1.0000000
NODE_8247_length_925_cov_40.767554	514	594	0	80	80	1.0000000
NODE_8247_length_925_cov_40.767554	567	647	0	60	80	0.7500000
NODE_8247_length_925_cov_40.767554	567	647	2	20	80	0.2500000
NODE_8248_length_925_cov_30.226392	262	342	0	80	80	1.0000000
NODE_8248_length_925_cov_30.226392	315	395	0	80	80	1.0000000
NODE_8248_length_925_cov_30.226392	391	471	0	80	80	1.0000000
NODE_8248_length_925_cov_30.226392	444	524	0	80	80	1.0000000
NODE_8249_length_925_cov_22.075061	334	414	0	21	80	0.2625000
NODE_8249_length_925_cov_22.075061	334	414	2	7	80	0.0875000
NODE_8249_length_925_cov_22.075061	334	414	6	52	80	0.6500000
NODE_8249_length_925_cov_22.075061	387	467	0	18	80	0.2250000
NODE_8249_length_925_cov_22.075061	387	467	6	62	80	0.7750000
NODE_8250_length_925_cov_18.164649	410	490	0	13	80	0.1625000
NODE_8250_length_925_cov_18.164649	410	490	2	23	80	0.2875000
NODE_8250_length_925_cov_18.164649	410	490	4	44	80	0.5500000
NODE_8250_length_925_cov_18.164649	464	543	0	33	79	0.4177215
NODE_8250_length_925_cov_18.164649	464	543	2	46	79	0.5822785
NODE_8251_length_925_cov_14.067797	472	548	0	76	76	1.0000000
NODE_8251_length_925_cov_14.067797	525	601	0	54	76	0.7105263
NODE_8251_length_925_cov_14.067797	525	601	2	22	76	0.2894737
NODE_8252_length_925_cov_7.098063	418	498	0	80	80	1.0000000
NODE_8252_length_925_cov_7.098063	471	551	0	80	80	1.0000000
NODE_8266_length_924_cov_61.292121	397	477	2	35	80	0.4375000
NODE_8266_length_924_cov_61.292121	397	477	4	45	80	0.5625000
NODE_8266_length_924_cov_61.292121	450	530	0	25	80	0.3125000
NODE_8266_length_924_cov_61.292121	450	530	2	33	80	0.4125000
NODE_8266_length_924_cov_61.292121	450	530	4	22	80	0.2750000
NODE_8267_length_924_cov_31.522424	375	455	0	19	80	0.2375000
NODE_8267_length_924_cov_31.522424	375	455	12	61	80	0.7625000
NODE_8267_length_924_cov_31.522424	428	508	0	41	80	0.5125000
NODE_8267_length_924_cov_31.522424	428	508	12	39	80	0.4875000
NODE_8268_length_924_cov_30.446061	299	379	0	2	80	0.0250000
NODE_8268_length_924_cov_30.446061	299	379	2	78	80	0.9750000
NODE_8268_length_924_cov_30.446061	352	432	0	55	80	0.6875000
NODE_8268_length_924_cov_30.446061	352	432	2	25	80	0.3125000
NODE_8268_length_924_cov_30.446061	428	508	0	6	80	0.0750000
NODE_8268_length_924_cov_30.446061	428	508	8	74	80	0.9250000
NODE_8268_length_924_cov_30.446061	481	561	0	8	80	0.1000000
NODE_8268_length_924_cov_30.446061	481	561	8	72	80	0.9000000
NODE_8269_length_924_cov_28.877576	542	622	0	26	80	0.3250000
NODE_8269_length_924_cov_28.877576	542	622	3	1	80	0.0125000
NODE_8269_length_924_cov_28.877576	542	622	4	28	80	0.3500000
NODE_8269_length_924_cov_28.877576	542	622	5	3	80	0.0375000
NODE_8269_length_924_cov_28.877576	542	622	6	22	80	0.2750000
NODE_8269_length_924_cov_28.877576	595	675	4	9	80	0.1125000
NODE_8269_length_924_cov_28.877576	595	675	5	3	80	0.0375000
NODE_8269_length_924_cov_28.877576	595	675	6	51	80	0.6375000
NODE_8269_length_924_cov_28.877576	595	675	8	17	80	0.2125000
NODE_8270_length_924_cov_27.261818	506	586	2	37	80	0.4625000
NODE_8270_length_924_cov_27.261818	506	586	4	19	80	0.2375000
NODE_8270_length_924_cov_27.261818	506	586	6	24	80	0.3000000
NODE_8270_length_924_cov_27.261818	559	639	0	3	80	0.0375000
NODE_8270_length_924_cov_27.261818	559	639	4	5	80	0.0625000
NODE_8270_length_924_cov_27.261818	559	639	6	72	80	0.9000000
NODE_8271_length_924_cov_25.946667	371	451	2	45	80	0.5625000
NODE_8271_length_924_cov_25.946667	371	451	4	26	80	0.3250000
NODE_8271_length_924_cov_25.946667	371	451	6	9	80	0.1125000
NODE_8271_length_924_cov_25.946667	424	504	4	71	80	0.8875000
NODE_8271_length_924_cov_25.946667	424	504	6	9	80	0.1125000
NODE_8271_length_924_cov_25.946667	500	580	0	26	80	0.3250000
NODE_8271_length_924_cov_25.946667	500	580	2	12	80	0.1500000
NODE_8271_length_924_cov_25.946667	500	580	4	42	80	0.5250000
NODE_8271_length_924_cov_25.946667	553	633	4	80	80	1.0000000
NODE_8272_length_924_cov_25.113939	305	385	0	43	80	0.5375000
NODE_8272_length_924_cov_25.113939	305	385	2	37	80	0.4625000
NODE_8272_length_924_cov_25.113939	358	438	0	7	80	0.0875000
NODE_8272_length_924_cov_25.113939	358	438	2	68	80	0.8500000
NODE_8272_length_924_cov_25.113939	358	438	6	5	80	0.0625000
NODE_8272_length_924_cov_25.113939	434	514	0	2	80	0.0250000
NODE_8272_length_924_cov_25.113939	434	514	4	48	80	0.6000000
NODE_8272_length_924_cov_25.113939	434	514	6	30	80	0.3750000
NODE_8272_length_924_cov_25.113939	487	567	0	55	80	0.6875000
NODE_8272_length_924_cov_25.113939	487	567	4	25	80	0.3125000
NODE_8273_length_924_cov_16.343030	481	561	2	4	80	0.0500000
NODE_8273_length_924_cov_16.343030	481	561	4	76	80	0.9500000
NODE_8273_length_924_cov_16.343030	534	614	0	5	80	0.0625000
NODE_8273_length_924_cov_16.343030	534	614	1	2	80	0.0250000
NODE_8273_length_924_cov_16.343030	534	614	2	50	80	0.6250000
NODE_8273_length_924_cov_16.343030	534	614	4	23	80	0.2875000
NODE_8274_length_924_cov_14.793939	299	379	0	80	80	1.0000000
NODE_8274_length_924_cov_14.793939	352	432	0	80	80	1.0000000
NODE_8275_length_924_cov_14.209697	485	562	0	7	77	0.0909091
NODE_8275_length_924_cov_14.209697	485	562	2	70	77	0.9090909
NODE_8275_length_924_cov_14.209697	535	615	0	14	80	0.1750000
NODE_8275_length_924_cov_14.209697	535	615	2	66	80	0.8250000
NODE_8276_length_924_cov_13.423030	287	367	0	80	80	1.0000000
NODE_8276_length_924_cov_13.423030	340	420	0	80	80	1.0000000
NODE_8277_length_924_cov_12.008485	237	307	12	19	70	0.2714286
NODE_8277_length_924_cov_12.008485	237	307	17	22	70	0.3142857
NODE_8277_length_924_cov_12.008485	237	307	18	29	70	0.4142857
NODE_8279_length_924_cov_8.619394	560	640	0	30	80	0.3750000
NODE_8279_length_924_cov_8.619394	560	640	2	50	80	0.6250000
NODE_8279_length_924_cov_8.619394	613	693	0	21	80	0.2625000
NODE_8279_length_924_cov_8.619394	613	693	2	59	80	0.7375000
NODE_8280_length_924_cov_4.640000	426	506	0	80	80	1.0000000
NODE_8280_length_924_cov_4.640000	479	559	0	80	80	1.0000000
NODE_8290_length_924_cov_1.467879	352	381	0	29	29	1.0000000
NODE_8296_length_924_cov_0.648485	830	890	2	60	60	1.0000000
NODE_8296_length_924_cov_0.648485	863	924	0	6	61	0.0983607
NODE_8296_length_924_cov_0.648485	863	924	2	55	61	0.9016393
NODE_8297_length_923_cov_43.213592	371	451	0	80	80	1.0000000
NODE_8297_length_923_cov_43.213592	424	504	0	80	80	1.0000000
NODE_8297_length_923_cov_43.213592	500	580	0	79	80	0.9875000
NODE_8297_length_923_cov_43.213592	500	580	2	1	80	0.0125000
NODE_8297_length_923_cov_43.213592	553	633	0	26	80	0.3250000
NODE_8297_length_923_cov_43.213592	553	633	2	54	80	0.6750000
NODE_8298_length_923_cov_34.108010	370	450	0	80	80	1.0000000
NODE_8298_length_923_cov_34.108010	423	503	0	80	80	1.0000000
NODE_8299_length_923_cov_29.163835	392	472	0	11	80	0.1375000
NODE_8299_length_923_cov_29.163835	392	472	4	14	80	0.1750000
NODE_8299_length_923_cov_29.163835	392	472	6	34	80	0.4250000
NODE_8299_length_923_cov_29.163835	392	472	8	21	80	0.2625000
NODE_8299_length_923_cov_29.163835	445	525	2	12	80	0.1500000
NODE_8299_length_923_cov_29.163835	445	525	4	5	80	0.0625000
NODE_8299_length_923_cov_29.163835	445	525	6	6	80	0.0750000
NODE_8299_length_923_cov_29.163835	445	525	8	57	80	0.7125000
NODE_8300_length_923_cov_19.139563	375	455	0	34	80	0.4250000
NODE_8300_length_923_cov_19.139563	375	455	2	46	80	0.5750000
NODE_8300_length_923_cov_19.139563	428	508	0	22	80	0.2750000
NODE_8300_length_923_cov_19.139563	428	508	2	58	80	0.7250000
NODE_8301_length_923_cov_17.433252	512	592	0	80	80	1.0000000
NODE_8301_length_923_cov_17.433252	565	645	0	80	80	1.0000000
NODE_8302_length_923_cov_16.597087	279	359	0	80	80	1.0000000
NODE_8302_length_923_cov_16.597087	332	412	0	80	80	1.0000000
NODE_8303_length_923_cov_15.229369	446	526	0	80	80	1.0000000
NODE_8303_length_923_cov_15.229369	499	579	0	80	80	1.0000000
NODE_8304_length_923_cov_14.007282	304	349	0	45	45	1.0000000
NODE_8304_length_923_cov_14.007282	345	427	0	82	82	1.0000000
NODE_8304_length_923_cov_14.007282	397	480	0	83	83	1.0000000
NODE_8305_length_923_cov_6.500000	308	388	0	69	80	0.8625000
NODE_8305_length_923_cov_6.500000	308	388	2	11	80	0.1375000
NODE_8305_length_923_cov_6.500000	361	441	0	16	80	0.2000000
NODE_8305_length_923_cov_6.500000	361	441	2	64	80	0.8000000
NODE_8307_length_923_cov_6.115291	447	527	0	80	80	1.0000000
NODE_8307_length_923_cov_6.115291	500	580	0	80	80	1.0000000
NODE_8308_length_923_cov_5.351942	363	445	2	12	82	0.1463415
NODE_8308_length_923_cov_5.351942	363	445	3	1	82	0.0121951
NODE_8308_length_923_cov_5.351942	363	445	4	26	82	0.3170732
NODE_8308_length_923_cov_5.351942	363	445	6	43	82	0.5243902
NODE_8308_length_923_cov_5.351942	365	445	2	12	80	0.1500000
NODE_8308_length_923_cov_5.351942	365	445	3	1	80	0.0125000
NODE_8308_length_923_cov_5.351942	365	445	4	24	80	0.3000000
NODE_8308_length_923_cov_5.351942	365	445	6	43	80	0.5375000
NODE_8317_length_923_cov_1.059466	63	143	2	1	80	0.0125000
NODE_8317_length_923_cov_1.059466	63	143	4	29	80	0.3625000
NODE_8317_length_923_cov_1.059466	63	143	8	35	80	0.4375000
NODE_8317_length_923_cov_1.059466	63	143	10	15	80	0.1875000
NODE_8320_length_922_cov_40.331713	243	289	66	1	46	0.0217391
NODE_8320_length_922_cov_40.331713	243	289	68	1	46	0.0217391
NODE_8320_length_922_cov_40.331713	243	289	70	2	46	0.0434783
NODE_8320_length_922_cov_40.331713	243	289	72	2	46	0.0434783
NODE_8320_length_922_cov_40.331713	243	289	73	4	46	0.0869565
NODE_8320_length_922_cov_40.331713	243	289	74	2	46	0.0434783
NODE_8320_length_922_cov_40.331713	243	289	78	3	46	0.0652174
NODE_8320_length_922_cov_40.331713	243	289	81	3	46	0.0652174
NODE_8320_length_922_cov_40.331713	243	289	82	1	46	0.0217391
NODE_8320_length_922_cov_40.331713	243	289	83	2	46	0.0434783
NODE_8320_length_922_cov_40.331713	243	289	90	2	46	0.0434783
NODE_8320_length_922_cov_40.331713	243	289	91	1	46	0.0217391
NODE_8320_length_922_cov_40.331713	243	289	92	1	46	0.0217391
NODE_8320_length_922_cov_40.331713	243	289	102	1	46	0.0217391
NODE_8320_length_922_cov_40.331713	243	289	107	1	46	0.0217391
NODE_8320_length_922_cov_40.331713	243	289	108	3	46	0.0652174
NODE_8320_length_922_cov_40.331713	243	289	111	1	46	0.0217391
NODE_8320_length_922_cov_40.331713	243	289	112	5	46	0.1086956
NODE_8320_length_922_cov_40.331713	243	289	113	1	46	0.0217391
NODE_8320_length_922_cov_40.331713	243	289	114	2	46	0.0434783
NODE_8320_length_922_cov_40.331713	243	289	116	1	46	0.0217391
NODE_8320_length_922_cov_40.331713	243	289	118	2	46	0.0434783
NODE_8320_length_922_cov_40.331713	243	289	120	1	46	0.0217391
NODE_8320_length_922_cov_40.331713	243	289	122	1	46	0.0217391
NODE_8320_length_922_cov_40.331713	243	289	124	2	46	0.0434783
NODE_8320_length_922_cov_40.331713	262	342	66	1	80	0.0125000
NODE_8320_length_922_cov_40.331713	262	342	68	1	80	0.0125000
NODE_8320_length_922_cov_40.331713	262	342	70	2	80	0.0250000
NODE_8320_length_922_cov_40.331713	262	342	72	2	80	0.0250000
NODE_8320_length_922_cov_40.331713	262	342	73	4	80	0.0500000
NODE_8320_length_922_cov_40.331713	262	342	74	2	80	0.0250000
NODE_8320_length_922_cov_40.331713	262	342	75	2	80	0.0250000
NODE_8320_length_922_cov_40.331713	262	342	77	1	80	0.0125000
NODE_8320_length_922_cov_40.331713	262	342	78	3	80	0.0375000
NODE_8320_length_922_cov_40.331713	262	342	79	1	80	0.0125000
NODE_8320_length_922_cov_40.331713	262	342	81	3	80	0.0375000
NODE_8320_length_922_cov_40.331713	262	342	82	1	80	0.0125000
NODE_8320_length_922_cov_40.331713	262	342	83	2	80	0.0250000
NODE_8320_length_922_cov_40.331713	262	342	90	2	80	0.0250000
NODE_8320_length_922_cov_40.331713	262	342	91	1	80	0.0125000
NODE_8320_length_922_cov_40.331713	262	342	92	1	80	0.0125000
NODE_8320_length_922_cov_40.331713	262	342	96	2	80	0.0250000
NODE_8320_length_922_cov_40.331713	262	342	101	1	80	0.0125000
NODE_8320_length_922_cov_40.331713	262	342	102	1	80	0.0125000
NODE_8320_length_922_cov_40.331713	262	342	103	1	80	0.0125000
NODE_8320_length_922_cov_40.331713	262	342	107	1	80	0.0125000
NODE_8320_length_922_cov_40.331713	262	342	114	1	80	0.0125000
NODE_8320_length_922_cov_40.331713	262	342	115	1	80	0.0125000
NODE_8320_length_922_cov_40.331713	262	342	117	1	80	0.0125000
NODE_8320_length_922_cov_40.331713	262	342	118	1	80	0.0125000
NODE_8320_length_922_cov_40.331713	262	342	119	1	80	0.0125000
NODE_8320_length_922_cov_40.331713	262	342	120	2	80	0.0250000
NODE_8320_length_922_cov_40.331713	262	342	121	3	80	0.0375000
NODE_8320_length_922_cov_40.331713	262	342	125	1	80	0.0125000
NODE_8320_length_922_cov_40.331713	262	342	131	1	80	0.0125000
NODE_8320_length_922_cov_40.331713	262	342	153	1	80	0.0125000
NODE_8320_length_922_cov_40.331713	262	342	155	1	80	0.0125000
NODE_8320_length_922_cov_40.331713	262	342	167	1	80	0.0125000
NODE_8320_length_922_cov_40.331713	262	342	170	1	80	0.0125000
NODE_8320_length_922_cov_40.331713	262	342	172	1	80	0.0125000
NODE_8320_length_922_cov_40.331713	262	342	176	2	80	0.0250000
NODE_8320_length_922_cov_40.331713	262	342	178	1	80	0.0125000
NODE_8320_length_922_cov_40.331713	262	342	193	1	80	0.0125000
NODE_8320_length_922_cov_40.331713	262	342	197	1	80	0.0125000
NODE_8320_length_922_cov_40.331713	262	342	202	1	80	0.0125000
NODE_8320_length_922_cov_40.331713	262	342	220	1	80	0.0125000
NODE_8320_length_922_cov_40.331713	262	342	246	1	80	0.0125000
NODE_8320_length_922_cov_40.331713	262	342	254	1	80	0.0125000
NODE_8320_length_922_cov_40.331713	262	342	260	1	80	0.0125000
NODE_8320_length_922_cov_40.331713	262	342	264	2	80	0.0250000
NODE_8320_length_922_cov_40.331713	262	342	266	1	80	0.0125000
NODE_8320_length_922_cov_40.331713	262	342	270	3	80	0.0375000
NODE_8320_length_922_cov_40.331713	262	342	272	2	80	0.0250000
NODE_8320_length_922_cov_40.331713	262	342	277	1	80	0.0125000
NODE_8320_length_922_cov_40.331713	262	342	286	1	80	0.0125000
NODE_8320_length_922_cov_40.331713	262	342	289	1	80	0.0125000
NODE_8320_length_922_cov_40.331713	262	342	296	1	80	0.0125000
NODE_8320_length_922_cov_40.331713	262	342	300	1	80	0.0125000
NODE_8320_length_922_cov_40.331713	262	342	302	1	80	0.0125000
NODE_8320_length_922_cov_40.331713	262	342	308	1	80	0.0125000
NODE_8320_length_922_cov_40.331713	262	342	316	1	80	0.0125000
NODE_8320_length_922_cov_40.331713	262	342	329	1	80	0.0125000
NODE_8320_length_922_cov_40.331713	262	342	339	1	80	0.0125000
NODE_8320_length_922_cov_40.331713	780	860	10	11	80	0.1375000
NODE_8320_length_922_cov_40.331713	780	860	12	1	80	0.0125000
NODE_8320_length_922_cov_40.331713	780	860	16	44	80	0.5500000
NODE_8320_length_922_cov_40.331713	780	860	18	24	80	0.3000000
NODE_8320_length_922_cov_40.331713	833	913	0	18	80	0.2250000
NODE_8320_length_922_cov_40.331713	833	913	2	19	80	0.2375000
NODE_8320_length_922_cov_40.331713	833	913	4	2	80	0.0250000
NODE_8320_length_922_cov_40.331713	833	913	12	12	80	0.1500000
NODE_8320_length_922_cov_40.331713	833	913	16	29	80	0.3625000
NODE_8321_length_922_cov_38.549210	126	177	88	2	51	0.0392157
NODE_8321_length_922_cov_38.549210	126	177	102	1	51	0.0196078
NODE_8321_length_922_cov_38.549210	126	177	108	1	51	0.0196078
NODE_8321_length_922_cov_38.549210	126	177	116	1	51	0.0196078
NODE_8321_length_922_cov_38.549210	126	177	118	1	51	0.0196078
NODE_8321_length_922_cov_38.549210	126	177	119	1	51	0.0196078
NODE_8321_length_922_cov_38.549210	126	177	123	1	51	0.0196078
NODE_8321_length_922_cov_38.549210	126	177	131	1	51	0.0196078
NODE_8321_length_922_cov_38.549210	126	177	135	1	51	0.0196078
NODE_8321_length_922_cov_38.549210	126	177	136	2	51	0.0392157
NODE_8321_length_922_cov_38.549210	126	177	151	1	51	0.0196078
NODE_8321_length_922_cov_38.549210	126	177	156	1	51	0.0196078
NODE_8321_length_922_cov_38.549210	126	177	162	1	51	0.0196078
NODE_8321_length_922_cov_38.549210	126	177	165	3	51	0.0588235
NODE_8321_length_922_cov_38.549210	126	177	171	1	51	0.0196078
NODE_8321_length_922_cov_38.549210	126	177	176	1	51	0.0196078
NODE_8321_length_922_cov_38.549210	126	177	178	2	51	0.0392157
NODE_8321_length_922_cov_38.549210	126	177	183	1	51	0.0196078
NODE_8321_length_922_cov_38.549210	126	177	185	1	51	0.0196078
NODE_8321_length_922_cov_38.549210	126	177	187	1	51	0.0196078
NODE_8321_length_922_cov_38.549210	126	177	193	3	51	0.0588235
NODE_8321_length_922_cov_38.549210	126	177	195	1	51	0.0196078
NODE_8321_length_922_cov_38.549210	126	177	202	1	51	0.0196078
NODE_8321_length_922_cov_38.549210	126	177	204	2	51	0.0392157
NODE_8321_length_922_cov_38.549210	126	177	206	1	51	0.0196078
NODE_8321_length_922_cov_38.549210	126	177	210	1	51	0.0196078
NODE_8321_length_922_cov_38.549210	126	177	216	1	51	0.0196078
NODE_8321_length_922_cov_38.549210	126	177	221	1	51	0.0196078
NODE_8321_length_922_cov_38.549210	126	177	222	1	51	0.0196078
NODE_8321_length_922_cov_38.549210	126	177	224	1	51	0.0196078
NODE_8321_length_922_cov_38.549210	126	177	228	2	51	0.0392157
NODE_8321_length_922_cov_38.549210	126	177	230	3	51	0.0588235
NODE_8321_length_922_cov_38.549210	126	177	231	1	51	0.0196078
NODE_8321_length_922_cov_38.549210	126	177	232	1	51	0.0196078
NODE_8321_length_922_cov_38.549210	126	177	233	1	51	0.0196078
NODE_8321_length_922_cov_38.549210	126	177	236	1	51	0.0196078
NODE_8321_length_922_cov_38.549210	126	177	237	1	51	0.0196078
NODE_8321_length_922_cov_38.549210	126	177	239	1	51	0.0196078
NODE_8321_length_922_cov_38.549210	126	177	250	1	51	0.0196078
NODE_8321_length_922_cov_38.549210	126	177	256	1	51	0.0196078
NODE_8321_length_922_cov_38.549210	308	383	0	75	75	1.0000000
NODE_8321_length_922_cov_38.549210	356	393	0	37	37	1.0000000
NODE_8321_length_922_cov_38.549210	818	898	0	19	80	0.2375000
NODE_8321_length_922_cov_38.549210	818	898	2	13	80	0.1625000
NODE_8321_length_922_cov_38.549210	818	898	4	48	80	0.6000000
NODE_8321_length_922_cov_38.549210	871	908	0	29	37	0.7837838
NODE_8321_length_922_cov_38.549210	871	908	2	8	37	0.2162162
NODE_8322_length_922_cov_35.041312	385	465	7	17	80	0.2125000
NODE_8322_length_922_cov_35.041312	385	465	8	6	80	0.0750000
NODE_8322_length_922_cov_35.041312	385	465	9	21	80	0.2625000
NODE_8322_length_922_cov_35.041312	385	465	10	22	80	0.2750000
NODE_8322_length_922_cov_35.041312	385	465	14	14	80	0.1750000
NODE_8322_length_922_cov_35.041312	438	518	5	12	80	0.1500000
NODE_8322_length_922_cov_35.041312	438	518	6	17	80	0.2125000
NODE_8322_length_922_cov_35.041312	438	518	10	13	80	0.1625000
NODE_8322_length_922_cov_35.041312	438	518	14	38	80	0.4750000
NODE_8323_length_922_cov_30.749696	426	506	9	20	80	0.2500000
NODE_8323_length_922_cov_30.749696	426	506	13	17	80	0.2125000
NODE_8323_length_922_cov_30.749696	426	506	15	43	80	0.5375000
NODE_8323_length_922_cov_30.749696	479	559	4	7	80	0.0875000
NODE_8323_length_922_cov_30.749696	479	559	8	1	80	0.0125000
NODE_8323_length_922_cov_30.749696	479	559	9	3	80	0.0375000
NODE_8323_length_922_cov_30.749696	479	559	11	17	80	0.2125000
NODE_8323_length_922_cov_30.749696	479	559	12	6	80	0.0750000
NODE_8323_length_922_cov_30.749696	479	559	13	31	80	0.3875000
NODE_8323_length_922_cov_30.749696	479	559	14	5	80	0.0625000
NODE_8323_length_922_cov_30.749696	479	559	15	10	80	0.1250000
NODE_8324_length_922_cov_25.558931	291	370	0	7	79	0.0886076
NODE_8324_length_922_cov_25.558931	291	370	2	15	79	0.1898734
NODE_8324_length_922_cov_25.558931	291	370	4	57	79	0.7215190
NODE_8324_length_922_cov_25.558931	344	423	0	60	79	0.7594936
NODE_8324_length_922_cov_25.558931	344	423	2	15	79	0.1898734
NODE_8324_length_922_cov_25.558931	344	423	4	4	79	0.0506329
NODE_8325_length_922_cov_25.527339	391	471	0	14	80	0.1750000
NODE_8325_length_922_cov_25.527339	391	471	2	66	80	0.8250000
NODE_8325_length_922_cov_25.527339	444	524	2	80	80	1.0000000
NODE_8326_length_922_cov_23.630620	224	304	0	33	80	0.4125000
NODE_8326_length_922_cov_23.630620	224	304	2	13	80	0.1625000
NODE_8326_length_922_cov_23.630620	224	304	4	34	80	0.4250000
NODE_8326_length_922_cov_23.630620	277	357	2	6	80	0.0750000
NODE_8326_length_922_cov_23.630620	277	357	4	74	80	0.9250000
NODE_8326_length_922_cov_23.630620	353	433	0	33	80	0.4125000
NODE_8326_length_922_cov_23.630620	353	433	2	35	80	0.4375000
NODE_8326_length_922_cov_23.630620	353	433	4	12	80	0.1500000
NODE_8326_length_922_cov_23.630620	406	486	2	15	80	0.1875000
NODE_8326_length_922_cov_23.630620	406	486	4	65	80	0.8125000
NODE_8327_length_922_cov_22.388821	465	545	0	29	80	0.3625000
NODE_8327_length_922_cov_22.388821	465	545	6	51	80	0.6375000
NODE_8327_length_922_cov_22.388821	518	598	6	59	80	0.7375000
NODE_8327_length_922_cov_22.388821	518	598	8	21	80	0.2625000
NODE_8328_length_922_cov_20.320778	421	501	0	80	80	1.0000000
NODE_8328_length_922_cov_20.320778	474	554	0	80	80	1.0000000
NODE_8329_length_922_cov_17.645200	413	479	2	10	66	0.1515152
NODE_8329_length_922_cov_17.645200	413	479	3	4	66	0.0606061
NODE_8329_length_922_cov_17.645200	413	479	4	52	66	0.7878788
NODE_8330_length_922_cov_12.574727	454	534	0	64	80	0.8000000
NODE_8330_length_922_cov_12.574727	454	534	3	1	80	0.0125000
NODE_8330_length_922_cov_12.574727	454	534	4	15	80	0.1875000
NODE_8330_length_922_cov_12.574727	507	587	0	11	80	0.1375000
NODE_8330_length_922_cov_12.574727	507	587	3	1	80	0.0125000
NODE_8330_length_922_cov_12.574727	507	587	4	68	80	0.8500000
NODE_8331_length_922_cov_11.934386	255	335	0	20	80	0.2500000
NODE_8331_length_922_cov_11.934386	255	335	2	20	80	0.2500000
NODE_8331_length_922_cov_11.934386	255	335	7	1	80	0.0125000
NODE_8331_length_922_cov_11.934386	255	335	8	39	80	0.4875000
NODE_8331_length_922_cov_11.934386	308	388	6	32	80	0.4000000
NODE_8331_length_922_cov_11.934386	308	388	8	48	80	0.6000000
NODE_8332_length_922_cov_11.068044	423	503	2	27	80	0.3375000
NODE_8332_length_922_cov_11.068044	423	503	4	2	80	0.0250000
NODE_8332_length_922_cov_11.068044	423	503	10	51	80	0.6375000
NODE_8332_length_922_cov_11.068044	476	557	6	25	81	0.3086420
NODE_8332_length_922_cov_11.068044	476	557	8	23	81	0.2839506
NODE_8332_length_922_cov_11.068044	476	557	10	33	81	0.4074074
NODE_8333_length_922_cov_7.907655	441	521	0	80	80	1.0000000
NODE_8333_length_922_cov_7.907655	494	574	0	80	80	1.0000000
NODE_8334_length_922_cov_7.737546	463	543	0	66	80	0.8250000
NODE_8334_length_922_cov_7.737546	463	543	2	14	80	0.1750000
NODE_8334_length_922_cov_7.737546	516	596	0	13	80	0.1625000
NODE_8334_length_922_cov_7.737546	516	596	2	59	80	0.7375000
NODE_8334_length_922_cov_7.737546	516	596	4	8	80	0.1000000
NODE_8335_length_922_cov_7.241798	298	378	0	80	80	1.0000000
NODE_8335_length_922_cov_7.241798	351	431	0	80	80	1.0000000
NODE_8347_length_921_cov_21.317518	457	537	0	80	80	1.0000000
NODE_8347_length_921_cov_21.317518	510	590	0	80	80	1.0000000
NODE_8348_length_921_cov_18.462287	519	599	0	54	80	0.6750000
NODE_8348_length_921_cov_18.462287	519	599	6	26	80	0.3250000
NODE_8348_length_921_cov_18.462287	572	652	0	1	80	0.0125000
NODE_8348_length_921_cov_18.462287	572	652	6	79	80	0.9875000
NODE_8349_length_921_cov_15.440389	373	453	0	5	80	0.0625000
NODE_8349_length_921_cov_15.440389	373	453	4	2	80	0.0250000
NODE_8349_length_921_cov_15.440389	373	453	5	13	80	0.1625000
NODE_8349_length_921_cov_15.440389	373	453	7	33	80	0.4125000
NODE_8349_length_921_cov_15.440389	373	453	8	27	80	0.3375000
NODE_8349_length_921_cov_15.440389	426	506	0	1	80	0.0125000
NODE_8349_length_921_cov_15.440389	426	506	6	12	80	0.1500000
NODE_8349_length_921_cov_15.440389	426	506	8	67	80	0.8375000
NODE_8350_length_921_cov_13.216545	465	545	0	46	80	0.5750000
NODE_8350_length_921_cov_13.216545	465	545	2	34	80	0.4250000
NODE_8350_length_921_cov_13.216545	518	598	2	80	80	1.0000000
NODE_8351_length_921_cov_9.283455	399	439	0	40	40	1.0000000
NODE_8351_length_921_cov_9.283455	532	612	6	10	80	0.1250000
NODE_8351_length_921_cov_9.283455	532	612	8	70	80	0.8750000
NODE_8351_length_921_cov_9.283455	585	665	0	41	80	0.5125000
NODE_8351_length_921_cov_9.283455	585	665	3	2	80	0.0250000
NODE_8351_length_921_cov_9.283455	585	665	6	20	80	0.2500000
NODE_8351_length_921_cov_9.283455	585	665	8	17	80	0.2125000
NODE_8352_length_921_cov_8.253041	289	369	0	35	80	0.4375000
NODE_8352_length_921_cov_8.253041	289	369	2	45	80	0.5625000
NODE_8352_length_921_cov_8.253041	342	422	0	2	80	0.0250000
NODE_8352_length_921_cov_8.253041	342	422	2	78	80	0.9750000
NODE_8364_length_920_cov_47.493301	543	623	1	8	80	0.1000000
NODE_8364_length_920_cov_47.493301	543	623	2	62	80	0.7750000
NODE_8364_length_920_cov_47.493301	543	623	3	10	80	0.1250000
NODE_8364_length_920_cov_47.493301	596	676	1	11	80	0.1375000
NODE_8364_length_920_cov_47.493301	596	676	2	59	80	0.7375000
NODE_8364_length_920_cov_47.493301	596	676	3	10	80	0.1250000
NODE_8365_length_920_cov_30.404385	543	623	0	3	80	0.0375000
NODE_8365_length_920_cov_30.404385	543	623	2	33	80	0.4125000
NODE_8365_length_920_cov_30.404385	543	623	3	16	80	0.2000000
NODE_8365_length_920_cov_30.404385	543	623	7	22	80	0.2750000
NODE_8365_length_920_cov_30.404385	543	623	9	6	80	0.0750000
NODE_8365_length_920_cov_30.404385	596	676	7	43	80	0.5375000
NODE_8365_length_920_cov_30.404385	596	676	9	37	80	0.4625000
NODE_8366_length_920_cov_25.360536	413	493	0	7	80	0.0875000
NODE_8366_length_920_cov_25.360536	413	493	2	44	80	0.5500000
NODE_8366_length_920_cov_25.360536	413	493	6	10	80	0.1250000
NODE_8366_length_920_cov_25.360536	413	493	8	19	80	0.2375000
NODE_8366_length_920_cov_25.360536	466	546	4	12	80	0.1500000
NODE_8366_length_920_cov_25.360536	466	546	6	31	80	0.3875000
NODE_8366_length_920_cov_25.360536	466	546	8	37	80	0.4625000
NODE_8366_length_920_cov_25.360536	542	615	0	59	73	0.8082192
NODE_8366_length_920_cov_25.360536	542	615	4	14	73	0.1917808
NODE_8366_length_920_cov_25.360536	588	668	0	80	80	1.0000000
NODE_8367_length_920_cov_24.918392	403	483	0	2	80	0.0250000
NODE_8367_length_920_cov_24.918392	403	483	2	13	80	0.1625000
NODE_8367_length_920_cov_24.918392	403	483	8	65	80	0.8125000
NODE_8367_length_920_cov_24.918392	456	536	0	2	80	0.0250000
NODE_8367_length_920_cov_24.918392	456	536	2	66	80	0.8250000
NODE_8367_length_920_cov_24.918392	456	536	8	12	80	0.1500000
NODE_8368_length_920_cov_18.517661	353	433	0	24	80	0.3000000
NODE_8368_length_920_cov_18.517661	353	433	2	56	80	0.7000000
NODE_8368_length_920_cov_18.517661	406	486	0	38	80	0.4750000
NODE_8368_length_920_cov_18.517661	406	486	2	42	80	0.5250000
NODE_8369_length_920_cov_17.710110	310	390	0	40	80	0.5000000
NODE_8369_length_920_cov_17.710110	310	390	4	40	80	0.5000000
NODE_8369_length_920_cov_17.710110	363	443	0	80	80	1.0000000
NODE_8370_length_920_cov_15.650426	403	458	0	42	55	0.7636364
NODE_8370_length_920_cov_15.650426	403	458	1	1	55	0.0181818
NODE_8370_length_920_cov_15.650426	403	458	2	8	55	0.1454545
NODE_8370_length_920_cov_15.650426	403	458	4	4	55	0.0727273
NODE_8371_length_920_cov_12.588307	454	534	0	38	80	0.4750000
NODE_8371_length_920_cov_12.588307	454	534	4	42	80	0.5250000
NODE_8371_length_920_cov_12.588307	507	586	0	6	79	0.0759494
NODE_8371_length_920_cov_12.588307	507	586	4	73	79	0.9240506
NODE_8372_length_920_cov_10.822168	354	434	0	80	80	1.0000000
NODE_8372_length_920_cov_10.822168	407	487	0	80	80	1.0000000
NODE_8374_length_920_cov_8.297199	453	533	0	63	80	0.7875000
NODE_8374_length_920_cov_8.297199	453	533	2	6	80	0.0750000
NODE_8374_length_920_cov_8.297199	453	533	4	11	80	0.1375000
NODE_8374_length_920_cov_8.297199	506	583	0	28	77	0.3636364
NODE_8374_length_920_cov_8.297199	506	583	2	49	77	0.6363636
NODE_8378_length_920_cov_2.992692	501	581	0	80	80	1.0000000
NODE_8378_length_920_cov_2.992692	554	634	0	30	80	0.3750000
NODE_8378_length_920_cov_2.992692	554	634	2	12	80	0.1500000
NODE_8378_length_920_cov_2.992692	554	634	4	38	80	0.4750000
NODE_8389_length_919_cov_44.813415	338	418	6	1	80	0.0125000
NODE_8389_length_919_cov_44.813415	338	418	8	20	80	0.2500000
NODE_8389_length_919_cov_44.813415	338	418	21	1	80	0.0125000
NODE_8389_length_919_cov_44.813415	338	418	22	58	80	0.7250000
NODE_8389_length_919_cov_44.813415	391	471	2	37	80	0.4625000
NODE_8389_length_919_cov_44.813415	391	471	6	1	80	0.0125000
NODE_8389_length_919_cov_44.813415	391	471	8	36	80	0.4500000
NODE_8389_length_919_cov_44.813415	391	471	21	1	80	0.0125000
NODE_8389_length_919_cov_44.813415	391	471	22	5	80	0.0625000
NODE_8389_length_919_cov_44.813415	467	547	0	72	80	0.9000000
NODE_8389_length_919_cov_44.813415	467	547	2	8	80	0.1000000
NODE_8389_length_919_cov_44.813415	520	600	0	28	80	0.3500000
NODE_8389_length_919_cov_44.813415	520	600	2	52	80	0.6500000
NODE_8390_length_919_cov_37.459756	389	469	0	16	80	0.2000000
NODE_8390_length_919_cov_37.459756	389	469	2	27	80	0.3375000
NODE_8390_length_919_cov_37.459756	389	469	4	3	80	0.0375000
NODE_8390_length_919_cov_37.459756	389	469	6	7	80	0.0875000
NODE_8390_length_919_cov_37.459756	389	469	10	27	80	0.3375000
NODE_8390_length_919_cov_37.459756	442	522	6	1	80	0.0125000
NODE_8390_length_919_cov_37.459756	442	522	8	15	80	0.1875000
NODE_8390_length_919_cov_37.459756	442	522	10	44	80	0.5500000
NODE_8390_length_919_cov_37.459756	442	522	12	20	80	0.2500000
NODE_8390_length_919_cov_37.459756	518	598	0	38	80	0.4750000
NODE_8390_length_919_cov_37.459756	518	598	2	11	80	0.1375000
NODE_8390_length_919_cov_37.459756	518	598	6	28	80	0.3500000
NODE_8390_length_919_cov_37.459756	518	598	8	3	80	0.0375000
NODE_8390_length_919_cov_37.459756	571	651	0	80	80	1.0000000
NODE_8391_length_919_cov_35.002439	474	554	0	37	80	0.4625000
NODE_8391_length_919_cov_35.002439	474	554	1	43	80	0.5375000
NODE_8391_length_919_cov_35.002439	527	607	1	80	80	1.0000000
NODE_8392_length_919_cov_29.935366	246	326	0	80	80	1.0000000
NODE_8392_length_919_cov_29.935366	299	379	0	80	80	1.0000000
NODE_8393_length_919_cov_28.190244	470	550	0	80	80	1.0000000
NODE_8393_length_919_cov_28.190244	523	603	0	80	80	1.0000000
NODE_8394_length_919_cov_27.119512	454	534	0	2	80	0.0250000
NODE_8394_length_919_cov_27.119512	454	534	14	16	80	0.2000000
NODE_8394_length_919_cov_27.119512	454	534	16	1	80	0.0125000
NODE_8394_length_919_cov_27.119512	454	534	18	61	80	0.7625000
NODE_8394_length_919_cov_27.119512	507	587	0	13	80	0.1625000
NODE_8394_length_919_cov_27.119512	507	587	12	1	80	0.0125000
NODE_8394_length_919_cov_27.119512	507	587	13	11	80	0.1375000
NODE_8394_length_919_cov_27.119512	507	587	14	17	80	0.2125000
NODE_8394_length_919_cov_27.119512	507	587	18	38	80	0.4750000
NODE_8395_length_919_cov_21.836585	545	625	0	19	80	0.2375000
NODE_8395_length_919_cov_21.836585	545	625	2	61	80	0.7625000
NODE_8395_length_919_cov_21.836585	598	677	0	71	79	0.8987342
NODE_8395_length_919_cov_21.836585	598	677	2	8	79	0.1012658
NODE_8396_length_919_cov_17.442683	385	465	0	80	80	1.0000000
NODE_8396_length_919_cov_17.442683	438	518	0	80	80	1.0000000
NODE_8397_length_919_cov_16.685366	309	389	2	1	80	0.0125000
NODE_8397_length_919_cov_16.685366	309	389	6	42	80	0.5250000
NODE_8397_length_919_cov_16.685366	309	389	8	37	80	0.4625000
NODE_8397_length_919_cov_16.685366	362	442	0	4	80	0.0500000
NODE_8397_length_919_cov_16.685366	362	442	2	50	80	0.6250000
NODE_8397_length_919_cov_16.685366	362	442	6	15	80	0.1875000
NODE_8397_length_919_cov_16.685366	362	442	8	11	80	0.1375000
NODE_8398_length_919_cov_14.013415	435	515	0	2	80	0.0250000
NODE_8398_length_919_cov_14.013415	435	515	2	1	80	0.0125000
NODE_8398_length_919_cov_14.013415	435	515	3	9	80	0.1125000
NODE_8398_length_919_cov_14.013415	435	515	5	14	80	0.1750000
NODE_8398_length_919_cov_14.013415	435	515	8	54	80	0.6750000
NODE_8398_length_919_cov_14.013415	488	568	8	80	80	1.0000000
NODE_8399_length_919_cov_12.013415	340	420	0	8	80	0.1000000
NODE_8399_length_919_cov_12.013415	340	420	2	33	80	0.4125000
NODE_8399_length_919_cov_12.013415	340	420	6	39	80	0.4875000
NODE_8399_length_919_cov_12.013415	393	473	0	5	80	0.0625000
NODE_8399_length_919_cov_12.013415	393	473	2	23	80	0.2875000
NODE_8399_length_919_cov_12.013415	393	473	4	20	80	0.2500000
NODE_8399_length_919_cov_12.013415	393	473	6	32	80	0.4000000
NODE_8403_length_919_cov_3.529268	424	504	0	72	80	0.9000000
NODE_8403_length_919_cov_3.529268	424	504	4	8	80	0.1000000
NODE_8403_length_919_cov_3.529268	477	557	0	19	80	0.2375000
NODE_8403_length_919_cov_3.529268	477	557	4	52	80	0.6500000
NODE_8403_length_919_cov_3.529268	477	557	6	9	80	0.1125000
NODE_8404_length_919_cov_3.200000	444	524	0	80	80	1.0000000
NODE_8404_length_919_cov_3.200000	497	577	0	76	80	0.9500000
NODE_8404_length_919_cov_3.200000	497	577	2	3	80	0.0375000
NODE_8404_length_919_cov_3.200000	497	577	4	1	80	0.0125000
NODE_8415_length_918_cov_41.115995	387	467	4	48	80	0.6000000
NODE_8415_length_918_cov_41.115995	387	467	8	32	80	0.4000000
NODE_8415_length_918_cov_41.115995	440	520	0	8	80	0.1000000
NODE_8415_length_918_cov_41.115995	440	520	4	25	80	0.3125000
NODE_8415_length_918_cov_41.115995	440	520	6	7	80	0.0875000
NODE_8415_length_918_cov_41.115995	440	520	8	40	80	0.5000000
NODE_8416_length_918_cov_37.405372	427	507	0	2	80	0.0250000
NODE_8416_length_918_cov_37.405372	427	507	4	11	80	0.1375000
NODE_8416_length_918_cov_37.405372	427	507	6	21	80	0.2625000
NODE_8416_length_918_cov_37.405372	427	507	8	10	80	0.1250000
NODE_8416_length_918_cov_37.405372	427	507	10	36	80	0.4500000
NODE_8416_length_918_cov_37.405372	480	560	0	55	80	0.6875000
NODE_8416_length_918_cov_37.405372	480	560	4	11	80	0.1375000
NODE_8416_length_918_cov_37.405372	480	560	6	14	80	0.1750000
NODE_8417_length_918_cov_31.559219	289	369	0	32	80	0.4000000
NODE_8417_length_918_cov_31.559219	289	369	4	48	80	0.6000000
NODE_8417_length_918_cov_31.559219	342	422	0	80	80	1.0000000
NODE_8417_length_918_cov_31.559219	418	498	0	19	80	0.2375000
NODE_8417_length_918_cov_31.559219	418	498	2	42	80	0.5250000
NODE_8417_length_918_cov_31.559219	418	498	4	19	80	0.2375000
NODE_8417_length_918_cov_31.559219	471	551	2	55	80	0.6875000
NODE_8417_length_918_cov_31.559219	471	551	4	25	80	0.3125000
NODE_8418_length_918_cov_25.195360	429	509	0	49	80	0.6125000
NODE_8418_length_918_cov_25.195360	429	509	4	23	80	0.2875000
NODE_8418_length_918_cov_25.195360	429	509	6	8	80	0.1000000
NODE_8418_length_918_cov_25.195360	482	562	2	16	80	0.2000000
NODE_8418_length_918_cov_25.195360	482	562	4	19	80	0.2375000
NODE_8418_length_918_cov_25.195360	482	562	6	45	80	0.5625000
NODE_8420_length_918_cov_10.537241	361	441	0	54	80	0.6750000
NODE_8420_length_918_cov_10.537241	361	441	2	26	80	0.3250000
NODE_8420_length_918_cov_10.537241	414	492	0	1	78	0.0128205
NODE_8420_length_918_cov_10.537241	414	492	2	77	78	0.9871795
NODE_8421_length_918_cov_9.821734	283	363	0	59	80	0.7375000
NODE_8421_length_918_cov_9.821734	283	363	2	21	80	0.2625000
NODE_8421_length_918_cov_9.821734	336	416	0	80	80	1.0000000
NODE_8422_length_918_cov_9.714286	365	445	2	80	80	1.0000000
NODE_8422_length_918_cov_9.714286	418	498	0	25	80	0.3125000
NODE_8422_length_918_cov_9.714286	418	498	2	55	80	0.6875000
NODE_8441_length_917_cov_38.845966	405	476	0	71	71	1.0000000
NODE_8441_length_917_cov_38.845966	458	538	0	80	80	1.0000000
NODE_8442_length_917_cov_37.775061	505	585	0	80	80	1.0000000
NODE_8442_length_917_cov_37.775061	558	638	0	80	80	1.0000000
NODE_8443_length_917_cov_33.195599	335	415	0	80	80	1.0000000
NODE_8443_length_917_cov_33.195599	388	468	0	80	80	1.0000000
NODE_8443_length_917_cov_33.195599	464	544	0	54	80	0.6750000
NODE_8443_length_917_cov_33.195599	464	544	10	26	80	0.3250000
NODE_8443_length_917_cov_33.195599	517	597	0	1	80	0.0125000
NODE_8443_length_917_cov_33.195599	517	597	10	79	80	0.9875000
NODE_8444_length_917_cov_22.871638	463	543	0	22	80	0.2750000
NODE_8444_length_917_cov_22.871638	463	543	2	56	80	0.7000000
NODE_8444_length_917_cov_22.871638	463	543	4	2	80	0.0250000
NODE_8444_length_917_cov_22.871638	516	593	2	31	77	0.4025974
NODE_8444_length_917_cov_22.871638	516	593	4	46	77	0.5974026
NODE_8445_length_917_cov_16.899756	321	401	2	15	80	0.1875000
NODE_8445_length_917_cov_16.899756	321	401	4	65	80	0.8125000
NODE_8445_length_917_cov_16.899756	374	454	2	59	80	0.7375000
NODE_8445_length_917_cov_16.899756	374	454	4	21	80	0.2625000
NODE_8446_length_917_cov_12.283619	397	477	2	80	80	1.0000000
NODE_8446_length_917_cov_12.283619	450	530	0	6	80	0.0750000
NODE_8446_length_917_cov_12.283619	450	530	2	74	80	0.9250000
NODE_8447_length_917_cov_12.172372	380	460	0	27	80	0.3375000
NODE_8447_length_917_cov_12.172372	380	460	2	13	80	0.1625000
NODE_8447_length_917_cov_12.172372	380	460	4	7	80	0.0875000
NODE_8447_length_917_cov_12.172372	380	460	10	5	80	0.0625000
NODE_8447_length_917_cov_12.172372	380	460	22	13	80	0.1625000
NODE_8447_length_917_cov_12.172372	380	460	25	4	80	0.0500000
NODE_8447_length_917_cov_12.172372	380	460	32	1	80	0.0125000
NODE_8447_length_917_cov_12.172372	380	460	33	10	80	0.1250000
NODE_8447_length_917_cov_12.172372	433	513	22	12	80	0.1500000
NODE_8447_length_917_cov_12.172372	433	513	25	4	80	0.0500000
NODE_8447_length_917_cov_12.172372	433	513	30	15	80	0.1875000
NODE_8447_length_917_cov_12.172372	433	513	32	13	80	0.1625000
NODE_8447_length_917_cov_12.172372	433	513	33	36	80	0.4500000
NODE_8447_length_917_cov_12.172372	545	597	10	15	52	0.2884615
NODE_8447_length_917_cov_12.172372	545	597	18	27	52	0.5192308
NODE_8447_length_917_cov_12.172372	545	597	20	10	52	0.1923077
NODE_8448_length_917_cov_8.277506	564	644	2	16	80	0.2000000
NODE_8448_length_917_cov_8.277506	564	644	4	33	80	0.4125000
NODE_8448_length_917_cov_8.277506	564	644	6	31	80	0.3875000
NODE_8448_length_917_cov_8.277506	617	697	0	31	80	0.3875000
NODE_8448_length_917_cov_8.277506	617	697	4	49	80	0.6125000
NODE_8449_length_917_cov_8.145477	155	235	0	80	80	1.0000000
NODE_8449_length_917_cov_8.145477	208	288	0	31	80	0.3875000
NODE_8449_length_917_cov_8.145477	208	288	2	49	80	0.6125000
NODE_8451_length_917_cov_6.073350	366	446	0	80	80	1.0000000
NODE_8451_length_917_cov_6.073350	419	499	0	80	80	1.0000000
NODE_8463_length_916_cov_32.867809	347	427	0	23	80	0.2875000
NODE_8463_length_916_cov_32.867809	347	427	2	57	80	0.7125000
NODE_8463_length_916_cov_32.867809	400	480	0	76	80	0.9500000
NODE_8463_length_916_cov_32.867809	400	480	2	4	80	0.0500000
NODE_8464_length_916_cov_27.673195	450	530	4	31	80	0.3875000
NODE_8464_length_916_cov_27.673195	450	530	8	49	80	0.6125000
NODE_8464_length_916_cov_27.673195	503	583	0	21	80	0.2625000
NODE_8464_length_916_cov_27.673195	503	583	2	16	80	0.2000000
NODE_8464_length_916_cov_27.673195	503	583	4	43	80	0.5375000
NODE_8465_length_916_cov_27.146879	223	303	4	1	80	0.0125000
NODE_8465_length_916_cov_27.146879	223	303	11	1	80	0.0125000
NODE_8465_length_916_cov_27.146879	223	303	12	6	80	0.0750000
NODE_8465_length_916_cov_27.146879	223	303	16	1	80	0.0125000
NODE_8465_length_916_cov_27.146879	223	303	18	19	80	0.2375000
NODE_8465_length_916_cov_27.146879	223	303	20	52	80	0.6500000
NODE_8465_length_916_cov_27.146879	276	356	0	52	80	0.6500000
NODE_8465_length_916_cov_27.146879	276	356	4	2	80	0.0250000
NODE_8465_length_916_cov_27.146879	276	356	11	1	80	0.0125000
NODE_8465_length_916_cov_27.146879	276	356	12	6	80	0.0750000
NODE_8465_length_916_cov_27.146879	276	356	16	1	80	0.0125000
NODE_8465_length_916_cov_27.146879	276	356	18	18	80	0.2250000
NODE_8466_length_916_cov_25.604651	398	478	8	1	80	0.0125000
NODE_8466_length_916_cov_25.604651	398	478	10	14	80	0.1750000
NODE_8466_length_916_cov_25.604651	398	478	13	1	80	0.0125000
NODE_8466_length_916_cov_25.604651	398	478	14	42	80	0.5250000
NODE_8466_length_916_cov_25.604651	398	478	15	1	80	0.0125000
NODE_8466_length_916_cov_25.604651	398	478	18	21	80	0.2625000
NODE_8466_length_916_cov_25.604651	451	531	2	5	80	0.0625000
NODE_8466_length_916_cov_25.604651	451	531	7	1	80	0.0125000
NODE_8466_length_916_cov_25.604651	451	531	10	16	80	0.2000000
NODE_8466_length_916_cov_25.604651	451	531	12	45	80	0.5625000
NODE_8466_length_916_cov_25.604651	451	531	15	1	80	0.0125000
NODE_8466_length_916_cov_25.604651	451	531	18	12	80	0.1500000
NODE_8467_length_916_cov_18.035496	456	536	0	21	80	0.2625000
NODE_8467_length_916_cov_18.035496	456	536	2	59	80	0.7375000
NODE_8467_length_916_cov_18.035496	509	589	0	32	80	0.4000000
NODE_8467_length_916_cov_18.035496	509	589	2	48	80	0.6000000
NODE_8468_length_916_cov_12.651163	500	580	0	6	80	0.0750000
NODE_8468_length_916_cov_12.651163	500	580	2	34	80	0.4250000
NODE_8468_length_916_cov_12.651163	500	580	8	6	80	0.0750000
NODE_8468_length_916_cov_12.651163	500	580	9	1	80	0.0125000
NODE_8468_length_916_cov_12.651163	500	580	10	33	80	0.4125000
NODE_8468_length_916_cov_12.651163	553	633	6	4	80	0.0500000
NODE_8468_length_916_cov_12.651163	553	633	7	7	80	0.0875000
NODE_8468_length_916_cov_12.651163	553	633	8	48	80	0.6000000
NODE_8468_length_916_cov_12.651163	553	633	10	21	80	0.2625000
NODE_8469_length_916_cov_11.337821	530	610	0	76	80	0.9500000
NODE_8469_length_916_cov_11.337821	530	610	2	4	80	0.0500000
NODE_8469_length_916_cov_11.337821	583	663	0	80	80	1.0000000
NODE_8470_length_916_cov_9.640147	293	373	0	12	80	0.1500000
NODE_8470_length_916_cov_9.640147	293	373	2	51	80	0.6375000
NODE_8470_length_916_cov_9.640147	293	373	6	17	80	0.2125000
NODE_8470_length_916_cov_9.640147	346	426	0	10	80	0.1250000
NODE_8470_length_916_cov_9.640147	346	426	6	70	80	0.8750000
NODE_8472_length_916_cov_8.042840	426	506	0	80	80	1.0000000
NODE_8472_length_916_cov_8.042840	479	559	0	80	80	1.0000000
NODE_8473_length_916_cov_7.123623	785	847	14	2	62	0.0322581
NODE_8473_length_916_cov_7.123623	785	847	16	5	62	0.0806452
NODE_8473_length_916_cov_7.123623	785	847	31	1	62	0.0161290
NODE_8473_length_916_cov_7.123623	785	847	33	3	62	0.0483871
NODE_8473_length_916_cov_7.123623	785	847	37	2	62	0.0322581
NODE_8473_length_916_cov_7.123623	785	847	38	3	62	0.0483871
NODE_8473_length_916_cov_7.123623	785	847	44	2	62	0.0322581
NODE_8473_length_916_cov_7.123623	785	847	46	2	62	0.0322581
NODE_8473_length_916_cov_7.123623	785	847	50	4	62	0.0645161
NODE_8473_length_916_cov_7.123623	785	847	52	2	62	0.0322581
NODE_8473_length_916_cov_7.123623	785	847	54	36	62	0.5806451
NODE_8473_length_916_cov_7.123623	820	900	42	4	80	0.0500000
NODE_8473_length_916_cov_7.123623	820	900	46	1	80	0.0125000
NODE_8473_length_916_cov_7.123623	820	900	48	4	80	0.0500000
NODE_8473_length_916_cov_7.123623	820	900	49	1	80	0.0125000
NODE_8473_length_916_cov_7.123623	820	900	50	40	80	0.5000000
NODE_8473_length_916_cov_7.123623	820	900	54	30	80	0.3750000
NODE_8481_length_915_cov_59.289216	398	478	2	23	80	0.2875000
NODE_8481_length_915_cov_59.289216	398	478	4	57	80	0.7125000
NODE_8481_length_915_cov_59.289216	451	531	0	5	80	0.0625000
NODE_8481_length_915_cov_59.289216	451	531	2	19	80	0.2375000
NODE_8481_length_915_cov_59.289216	451	531	4	15	80	0.1875000
NODE_8481_length_915_cov_59.289216	451	531	29	23	80	0.2875000
NODE_8481_length_915_cov_59.289216	451	531	57	1	80	0.0125000
NODE_8481_length_915_cov_59.289216	451	531	58	17	80	0.2125000
NODE_8481_length_915_cov_59.289216	527	607	58	23	80	0.2875000
NODE_8481_length_915_cov_59.289216	527	607	59	5	80	0.0625000
NODE_8481_length_915_cov_59.289216	527	607	61	17	80	0.2125000
NODE_8481_length_915_cov_59.289216	527	607	62	1	80	0.0125000
NODE_8481_length_915_cov_59.289216	527	607	63	3	80	0.0375000
NODE_8481_length_915_cov_59.289216	527	607	64	2	80	0.0250000
NODE_8481_length_915_cov_59.289216	527	607	65	3	80	0.0375000
NODE_8481_length_915_cov_59.289216	527	607	67	1	80	0.0125000
NODE_8481_length_915_cov_59.289216	527	607	68	25	80	0.3125000
NODE_8481_length_915_cov_59.289216	580	660	39	20	80	0.2500000
NODE_8481_length_915_cov_59.289216	580	660	50	1	80	0.0125000
NODE_8481_length_915_cov_59.289216	580	660	51	12	80	0.1500000
NODE_8481_length_915_cov_59.289216	580	660	58	6	80	0.0750000
NODE_8481_length_915_cov_59.289216	580	660	59	20	80	0.2500000
NODE_8481_length_915_cov_59.289216	580	660	60	3	80	0.0375000
NODE_8481_length_915_cov_59.289216	580	660	61	17	80	0.2125000
NODE_8481_length_915_cov_59.289216	580	660	62	1	80	0.0125000
NODE_8482_length_915_cov_45.104167	153	228	4	75	75	1.0000000
NODE_8482_length_915_cov_45.104167	206	286	0	50	80	0.6250000
NODE_8482_length_915_cov_45.104167	206	286	4	30	80	0.3750000
NODE_8482_length_915_cov_45.104167	282	362	0	20	80	0.2500000
NODE_8482_length_915_cov_45.104167	282	362	2	56	80	0.7000000
NODE_8482_length_915_cov_45.104167	282	362	4	4	80	0.0500000
NODE_8482_length_915_cov_45.104167	335	415	2	27	80	0.3375000
NODE_8482_length_915_cov_45.104167	335	415	4	50	80	0.6250000
NODE_8482_length_915_cov_45.104167	335	415	6	3	80	0.0375000
NODE_8483_length_915_cov_37.599265	397	477	0	69	80	0.8625000
NODE_8483_length_915_cov_37.599265	397	477	2	11	80	0.1375000
NODE_8483_length_915_cov_37.599265	450	530	0	16	80	0.2000000
NODE_8483_length_915_cov_37.599265	450	530	2	64	80	0.8000000
NODE_8485_length_915_cov_20.458333	297	377	2	47	80	0.5875000
NODE_8485_length_915_cov_20.458333	297	377	4	33	80	0.4125000
NODE_8485_length_915_cov_20.458333	350	430	2	36	80	0.4500000
NODE_8485_length_915_cov_20.458333	350	430	4	44	80	0.5500000
NODE_8485_length_915_cov_20.458333	426	506	2	25	80	0.3125000
NODE_8485_length_915_cov_20.458333	426	506	10	9	80	0.1125000
NODE_8485_length_915_cov_20.458333	426	506	11	1	80	0.0125000
NODE_8485_length_915_cov_20.458333	426	506	12	45	80	0.5625000
NODE_8485_length_915_cov_20.458333	479	559	10	28	80	0.3500000
NODE_8485_length_915_cov_20.458333	479	559	12	52	80	0.6500000
NODE_8486_length_915_cov_14.397059	175	255	0	71	80	0.8875000
NODE_8486_length_915_cov_14.397059	175	255	2	9	80	0.1125000
NODE_8486_length_915_cov_14.397059	228	308	0	18	80	0.2250000
NODE_8486_length_915_cov_14.397059	228	308	2	62	80	0.7750000
NODE_8487_length_915_cov_8.741422	295	375	0	80	80	1.0000000
NODE_8487_length_915_cov_8.741422	348	428	0	32	80	0.4000000
NODE_8487_length_915_cov_8.741422	348	428	2	48	80	0.6000000
NODE_8488_length_915_cov_7.719363	823	894	14	15	71	0.2112676
NODE_8488_length_915_cov_7.719363	823	894	18	2	71	0.0281690
NODE_8488_length_915_cov_7.719363	823	894	20	54	71	0.7605634
NODE_8488_length_915_cov_7.719363	828	894	14	15	66	0.2272727
NODE_8488_length_915_cov_7.719363	828	894	18	2	66	0.0303030
NODE_8488_length_915_cov_7.719363	828	894	20	49	66	0.7424242
NODE_8488_length_915_cov_7.719363	867	915	0	4	48	0.0833333
NODE_8488_length_915_cov_7.719363	867	915	4	2	48	0.0416667
NODE_8488_length_915_cov_7.719363	867	915	6	1	48	0.0208333
NODE_8488_length_915_cov_7.719363	867	915	12	11	48	0.2291667
NODE_8488_length_915_cov_7.719363	867	915	14	18	48	0.3750000
NODE_8488_length_915_cov_7.719363	867	915	18	2	48	0.0416667
NODE_8488_length_915_cov_7.719363	867	915	20	10	48	0.2083333
NODE_8488_length_915_cov_7.719363	867	915	0	4	48	0.0833333
NODE_8488_length_915_cov_7.719363	867	915	4	2	48	0.0416667
NODE_8488_length_915_cov_7.719363	867	915	6	1	48	0.0208333
NODE_8488_length_915_cov_7.719363	867	915	12	11	48	0.2291667
NODE_8488_length_915_cov_7.719363	867	915	14	18	48	0.3750000
NODE_8488_length_915_cov_7.719363	867	915	18	2	48	0.0416667
NODE_8488_length_915_cov_7.719363	867	915	20	10	48	0.2083333
NODE_8488_length_915_cov_7.719363	867	915	0	4	48	0.0833333
NODE_8488_length_915_cov_7.719363	867	915	4	2	48	0.0416667
NODE_8488_length_915_cov_7.719363	867	915	6	1	48	0.0208333
NODE_8488_length_915_cov_7.719363	867	915	12	11	48	0.2291667
NODE_8488_length_915_cov_7.719363	867	915	14	18	48	0.3750000
NODE_8488_length_915_cov_7.719363	867	915	18	2	48	0.0416667
NODE_8488_length_915_cov_7.719363	867	915	20	10	48	0.2083333
NODE_8489_length_915_cov_7.648284	370	450	0	80	80	1.0000000
NODE_8489_length_915_cov_7.648284	423	503	0	80	80	1.0000000
NODE_8490_length_915_cov_6.848039	434	514	0	25	80	0.3125000
NODE_8490_length_915_cov_6.848039	434	514	2	55	80	0.6875000
NODE_8490_length_915_cov_6.848039	487	567	0	29	80	0.3625000
NODE_8490_length_915_cov_6.848039	487	567	2	51	80	0.6375000
NODE_8497_length_915_cov_2.011029	24	99	0	19	75	0.2533333
NODE_8497_length_915_cov_2.011029	24	99	2	56	75	0.7466667
NODE_8505_length_914_cov_89.814724	0	41	16	3	41	0.0731707
NODE_8505_length_914_cov_89.814724	0	41	18	5	41	0.1219512
NODE_8505_length_914_cov_89.814724	0	41	27	1	41	0.0243902
NODE_8505_length_914_cov_89.814724	0	41	28	1	41	0.0243902
NODE_8505_length_914_cov_89.814724	0	41	37	1	41	0.0243902
NODE_8505_length_914_cov_89.814724	0	41	42	2	41	0.0487805
NODE_8505_length_914_cov_89.814724	0	41	60	1	41	0.0243902
NODE_8505_length_914_cov_89.814724	0	41	82	2	41	0.0487805
NODE_8505_length_914_cov_89.814724	0	41	88	3	41	0.0731707
NODE_8505_length_914_cov_89.814724	0	41	90	2	41	0.0487805
NODE_8505_length_914_cov_89.814724	0	41	93	1	41	0.0243902
NODE_8505_length_914_cov_89.814724	0	41	105	1	41	0.0243902
NODE_8505_length_914_cov_89.814724	0	41	123	1	41	0.0243902
NODE_8505_length_914_cov_89.814724	0	41	135	1	41	0.0243902
NODE_8505_length_914_cov_89.814724	0	41	137	2	41	0.0487805
NODE_8505_length_914_cov_89.814724	0	41	149	2	41	0.0487805
NODE_8505_length_914_cov_89.814724	0	41	150	1	41	0.0243902
NODE_8505_length_914_cov_89.814724	0	41	155	1	41	0.0243902
NODE_8505_length_914_cov_89.814724	0	41	156	2	41	0.0487805
NODE_8505_length_914_cov_89.814724	0	41	161	1	41	0.0243902
NODE_8505_length_914_cov_89.814724	0	41	163	2	41	0.0487805
NODE_8505_length_914_cov_89.814724	0	41	169	1	41	0.0243902
NODE_8505_length_914_cov_89.814724	0	41	172	2	41	0.0487805
NODE_8505_length_914_cov_89.814724	0	41	182	1	41	0.0243902
NODE_8505_length_914_cov_89.814724	0	41	186	1	41	0.0243902
NODE_8505_length_914_cov_89.814724	19	94	90	2	75	0.0266667
NODE_8505_length_914_cov_89.814724	19	94	93	1	75	0.0133333
NODE_8505_length_914_cov_89.814724	19	94	105	1	75	0.0133333
NODE_8505_length_914_cov_89.814724	19	94	123	1	75	0.0133333
NODE_8505_length_914_cov_89.814724	19	94	135	1	75	0.0133333
NODE_8505_length_914_cov_89.814724	19	94	137	2	75	0.0266667
NODE_8505_length_914_cov_89.814724	19	94	149	2	75	0.0266667
NODE_8505_length_914_cov_89.814724	19	94	150	1	75	0.0133333
NODE_8505_length_914_cov_89.814724	19	94	155	1	75	0.0133333
NODE_8505_length_914_cov_89.814724	19	94	156	2	75	0.0266667
NODE_8505_length_914_cov_89.814724	19	94	161	1	75	0.0133333
NODE_8505_length_914_cov_89.814724	19	94	163	2	75	0.0266667
NODE_8505_length_914_cov_89.814724	19	94	169	1	75	0.0133333
NODE_8505_length_914_cov_89.814724	19	94	172	2	75	0.0266667
NODE_8505_length_914_cov_89.814724	19	94	182	1	75	0.0133333
NODE_8505_length_914_cov_89.814724	19	94	186	1	75	0.0133333
NODE_8505_length_914_cov_89.814724	19	94	202	1	75	0.0133333
NODE_8505_length_914_cov_89.814724	19	94	213	1	75	0.0133333
NODE_8505_length_914_cov_89.814724	19	94	217	1	75	0.0133333
NODE_8505_length_914_cov_89.814724	19	94	221	1	75	0.0133333
NODE_8505_length_914_cov_89.814724	19	94	233	1	75	0.0133333
NODE_8505_length_914_cov_89.814724	19	94	236	1	75	0.0133333
NODE_8505_length_914_cov_89.814724	19	94	239	1	75	0.0133333
NODE_8505_length_914_cov_89.814724	19	94	241	1	75	0.0133333
NODE_8505_length_914_cov_89.814724	19	94	245	2	75	0.0266667
NODE_8505_length_914_cov_89.814724	19	94	257	2	75	0.0266667
NODE_8505_length_914_cov_89.814724	19	94	263	2	75	0.0266667
NODE_8505_length_914_cov_89.814724	19	94	267	1	75	0.0133333
NODE_8505_length_914_cov_89.814724	19	94	274	2	75	0.0266667
NODE_8505_length_914_cov_89.814724	19	94	276	1	75	0.0133333
NODE_8505_length_914_cov_89.814724	19	94	280	1	75	0.0133333
NODE_8505_length_914_cov_89.814724	19	94	281	6	75	0.0800000
NODE_8505_length_914_cov_89.814724	19	94	286	1	75	0.0133333
NODE_8505_length_914_cov_89.814724	19	94	288	1	75	0.0133333
NODE_8505_length_914_cov_89.814724	19	94	292	1	75	0.0133333
NODE_8505_length_914_cov_89.814724	19	94	296	1	75	0.0133333
NODE_8505_length_914_cov_89.814724	19	94	300	1	75	0.0133333
NODE_8505_length_914_cov_89.814724	19	94	302	2	75	0.0266667
NODE_8505_length_914_cov_89.814724	19	94	304	1	75	0.0133333
NODE_8505_length_914_cov_89.814724	19	94	310	1	75	0.0133333
NODE_8505_length_914_cov_89.814724	19	94	311	1	75	0.0133333
NODE_8505_length_914_cov_89.814724	19	94	312	2	75	0.0266667
NODE_8505_length_914_cov_89.814724	19	94	315	1	75	0.0133333
NODE_8505_length_914_cov_89.814724	19	94	318	1	75	0.0133333
NODE_8505_length_914_cov_89.814724	19	94	319	1	75	0.0133333
NODE_8505_length_914_cov_89.814724	19	94	320	2	75	0.0266667
NODE_8505_length_914_cov_89.814724	19	94	324	3	75	0.0400000
NODE_8505_length_914_cov_89.814724	19	94	330	2	75	0.0266667
NODE_8505_length_914_cov_89.814724	19	94	331	2	75	0.0266667
NODE_8505_length_914_cov_89.814724	19	94	337	1	75	0.0133333
NODE_8505_length_914_cov_89.814724	19	94	339	1	75	0.0133333
NODE_8505_length_914_cov_89.814724	19	94	341	1	75	0.0133333
NODE_8505_length_914_cov_89.814724	19	94	347	1	75	0.0133333
NODE_8506_length_914_cov_33.755828	400	480	0	80	80	1.0000000
NODE_8506_length_914_cov_33.755828	453	533	0	80	80	1.0000000
NODE_8507_length_914_cov_31.557055	368	448	0	6	80	0.0750000
NODE_8507_length_914_cov_31.557055	368	448	2	74	80	0.9250000
NODE_8507_length_914_cov_31.557055	421	501	0	51	80	0.6375000
NODE_8507_length_914_cov_31.557055	421	501	2	29	80	0.3625000
NODE_8508_length_914_cov_29.087117	331	411	0	10	80	0.1250000
NODE_8508_length_914_cov_29.087117	331	411	6	9	80	0.1125000
NODE_8508_length_914_cov_29.087117	331	411	8	3	80	0.0375000
NODE_8508_length_914_cov_29.087117	331	411	12	58	80	0.7250000
NODE_8508_length_914_cov_29.087117	384	464	0	63	80	0.7875000
NODE_8508_length_914_cov_29.087117	384	464	6	9	80	0.1125000
NODE_8508_length_914_cov_29.087117	384	464	8	3	80	0.0375000
NODE_8508_length_914_cov_29.087117	384	464	12	5	80	0.0625000
NODE_8509_length_914_cov_28.490798	273	353	0	80	80	1.0000000
NODE_8509_length_914_cov_28.490798	326	406	0	80	80	1.0000000
NODE_8509_length_914_cov_28.490798	402	482	0	51	80	0.6375000
NODE_8509_length_914_cov_28.490798	402	482	2	29	80	0.3625000
NODE_8509_length_914_cov_28.490798	455	535	0	35	80	0.4375000
NODE_8509_length_914_cov_28.490798	455	535	2	45	80	0.5625000
NODE_8510_length_914_cov_25.429448	393	473	0	80	80	1.0000000
NODE_8510_length_914_cov_25.429448	446	526	0	31	80	0.3875000
NODE_8510_length_914_cov_25.429448	446	526	1	16	80	0.2000000
NODE_8510_length_914_cov_25.429448	446	526	2	33	80	0.4125000
NODE_8510_length_914_cov_25.429448	522	602	2	80	80	1.0000000
NODE_8510_length_914_cov_25.429448	575	655	0	12	80	0.1500000
NODE_8510_length_914_cov_25.429448	575	655	1	16	80	0.2000000
NODE_8510_length_914_cov_25.429448	575	655	2	52	80	0.6500000
NODE_8511_length_914_cov_19.111656	354	434	0	14	80	0.1750000
NODE_8511_length_914_cov_19.111656	354	434	6	49	80	0.6125000
NODE_8511_length_914_cov_19.111656	354	434	8	17	80	0.2125000
NODE_8511_length_914_cov_19.111656	407	487	2	40	80	0.5000000
NODE_8511_length_914_cov_19.111656	407	487	6	10	80	0.1250000
NODE_8511_length_914_cov_19.111656	407	487	8	30	80	0.3750000
NODE_8512_length_914_cov_13.423313	603	683	0	80	80	1.0000000
NODE_8512_length_914_cov_13.423313	656	736	0	80	80	1.0000000
NODE_8513_length_914_cov_10.947239	341	411	0	9	70	0.1285714
NODE_8513_length_914_cov_10.947239	341	411	2	25	70	0.3571429
NODE_8513_length_914_cov_10.947239	341	411	4	36	70	0.5142857
NODE_8513_length_914_cov_10.947239	384	464	0	6	80	0.0750000
NODE_8513_length_914_cov_10.947239	384	464	2	36	80	0.4500000
NODE_8513_length_914_cov_10.947239	384	464	4	38	80	0.4750000
NODE_8518_length_914_cov_1.931288	833	873	0	4	40	0.1000000
NODE_8518_length_914_cov_1.931288	833	873	2	4	40	0.1000000
NODE_8518_length_914_cov_1.931288	833	873	4	32	40	0.8000000
NODE_8526_length_913_cov_49.665848	31	111	54	1	80	0.0125000
NODE_8526_length_913_cov_49.665848	31	111	56	5	80	0.0625000
NODE_8526_length_913_cov_49.665848	31	111	64	1	80	0.0125000
NODE_8526_length_913_cov_49.665848	31	111	66	3	80	0.0375000
NODE_8526_length_913_cov_49.665848	31	111	68	5	80	0.0625000
NODE_8526_length_913_cov_49.665848	31	111	70	3	80	0.0375000
NODE_8526_length_913_cov_49.665848	31	111	71	6	80	0.0750000
NODE_8526_length_913_cov_49.665848	31	111	73	2	80	0.0250000
NODE_8526_length_913_cov_49.665848	31	111	78	1	80	0.0125000
NODE_8526_length_913_cov_49.665848	31	111	80	12	80	0.1500000
NODE_8526_length_913_cov_49.665848	31	111	82	3	80	0.0375000
NODE_8526_length_913_cov_49.665848	31	111	84	1	80	0.0125000
NODE_8526_length_913_cov_49.665848	31	111	85	1	80	0.0125000
NODE_8526_length_913_cov_49.665848	31	111	88	1	80	0.0125000
NODE_8526_length_913_cov_49.665848	31	111	89	4	80	0.0500000
NODE_8526_length_913_cov_49.665848	31	111	93	2	80	0.0250000
NODE_8526_length_913_cov_49.665848	31	111	97	4	80	0.0500000
NODE_8526_length_913_cov_49.665848	31	111	99	1	80	0.0125000
NODE_8526_length_913_cov_49.665848	31	111	100	1	80	0.0125000
NODE_8526_length_913_cov_49.665848	31	111	104	2	80	0.0250000
NODE_8526_length_913_cov_49.665848	31	111	105	1	80	0.0125000
NODE_8526_length_913_cov_49.665848	31	111	107	3	80	0.0375000
NODE_8526_length_913_cov_49.665848	31	111	109	4	80	0.0500000
NODE_8526_length_913_cov_49.665848	31	111	111	3	80	0.0375000
NODE_8526_length_913_cov_49.665848	31	111	115	5	80	0.0625000
NODE_8526_length_913_cov_49.665848	31	111	117	5	80	0.0625000
NODE_8526_length_913_cov_49.665848	136	155	90	3	19	0.1578947
NODE_8526_length_913_cov_49.665848	136	155	91	1	19	0.0526316
NODE_8526_length_913_cov_49.665848	136	155	92	5	19	0.2631579
NODE_8526_length_913_cov_49.665848	136	155	94	5	19	0.2631579
NODE_8526_length_913_cov_49.665848	136	155	96	5	19	0.2631579
NODE_8527_length_913_cov_47.115479	367	447	0	80	80	1.0000000
NODE_8527_length_913_cov_47.115479	420	500	0	80	80	1.0000000
NODE_8528_length_913_cov_36.541769	502	582	1	24	80	0.3000000
NODE_8528_length_913_cov_36.541769	502	582	2	54	80	0.6750000
NODE_8528_length_913_cov_36.541769	502	582	3	2	80	0.0250000
NODE_8528_length_913_cov_36.541769	555	635	1	13	80	0.1625000
NODE_8528_length_913_cov_36.541769	555	635	2	67	80	0.8375000
NODE_8529_length_913_cov_33.679361	433	513	0	80	80	1.0000000
NODE_8529_length_913_cov_33.679361	486	566	0	80	80	1.0000000
NODE_8530_length_913_cov_29.675676	408	488	0	80	80	1.0000000
NODE_8530_length_913_cov_29.675676	461	541	0	61	80	0.7625000
NODE_8530_length_913_cov_29.675676	461	541	2	19	80	0.2375000
NODE_8531_length_913_cov_24.901720	342	422	0	8	80	0.1000000
NODE_8531_length_913_cov_24.901720	342	422	2	5	80	0.0625000
NODE_8531_length_913_cov_24.901720	342	422	4	67	80	0.8375000
NODE_8531_length_913_cov_24.901720	395	475	2	44	80	0.5500000
NODE_8531_length_913_cov_24.901720	395	475	4	36	80	0.4500000
NODE_8532_length_913_cov_24.625307	396	476	8	23	80	0.2875000
NODE_8532_length_913_cov_24.625307	396	476	12	2	80	0.0250000
NODE_8532_length_913_cov_24.625307	396	476	14	11	80	0.1375000
NODE_8532_length_913_cov_24.625307	396	476	15	1	80	0.0125000
NODE_8532_length_913_cov_24.625307	396	476	16	43	80	0.5375000
NODE_8532_length_913_cov_24.625307	449	529	0	17	80	0.2125000
NODE_8532_length_913_cov_24.625307	449	529	2	14	80	0.1750000
NODE_8532_length_913_cov_24.625307	449	529	5	5	80	0.0625000
NODE_8532_length_913_cov_24.625307	449	529	8	40	80	0.5000000
NODE_8532_length_913_cov_24.625307	449	529	12	2	80	0.0250000
NODE_8532_length_913_cov_24.625307	449	529	14	2	80	0.0250000
NODE_8533_length_913_cov_15.094595	525	589	4	14	64	0.2187500
NODE_8533_length_913_cov_15.094595	525	589	6	50	64	0.7812500
NODE_8533_length_913_cov_15.094595	562	642	0	11	80	0.1375000
NODE_8533_length_913_cov_15.094595	562	642	2	6	80	0.0750000
NODE_8533_length_913_cov_15.094595	562	642	4	46	80	0.5750000
NODE_8533_length_913_cov_15.094595	562	642	6	17	80	0.2125000
NODE_8534_length_913_cov_8.633907	305	385	0	13	80	0.1625000
NODE_8534_length_913_cov_8.633907	305	385	2	7	80	0.0875000
NODE_8534_length_913_cov_8.633907	305	385	4	12	80	0.1500000
NODE_8534_length_913_cov_8.633907	305	385	10	48	80	0.6000000
NODE_8534_length_913_cov_8.633907	358	429	8	27	71	0.3802817
NODE_8534_length_913_cov_8.633907	358	429	10	39	71	0.5492958
NODE_8534_length_913_cov_8.633907	358	429	12	5	71	0.0704225
NODE_8546_length_912_cov_25.110701	419	499	0	80	80	1.0000000
NODE_8546_length_912_cov_25.110701	472	552	0	80	80	1.0000000
NODE_8547_length_912_cov_20.045510	306	386	0	41	80	0.5125000
NODE_8547_length_912_cov_20.045510	306	386	2	39	80	0.4875000
NODE_8547_length_912_cov_20.045510	359	439	0	7	80	0.0875000
NODE_8547_length_912_cov_20.045510	359	439	2	73	80	0.9125000
NODE_8548_length_912_cov_19.635916	326	406	0	69	80	0.8625000
NODE_8548_length_912_cov_19.635916	326	406	2	11	80	0.1375000
NODE_8548_length_912_cov_19.635916	379	459	0	16	80	0.2000000
NODE_8548_length_912_cov_19.635916	379	459	2	39	80	0.4875000
NODE_8548_length_912_cov_19.635916	379	459	4	25	80	0.3125000
NODE_8549_length_912_cov_17.714637	395	475	0	80	80	1.0000000
NODE_8549_length_912_cov_17.714637	448	528	0	80	80	1.0000000
NODE_8550_length_912_cov_15.546125	355	435	0	19	80	0.2375000
NODE_8550_length_912_cov_15.546125	355	435	6	1	80	0.0125000
NODE_8550_length_912_cov_15.546125	355	435	8	32	80	0.4000000
NODE_8550_length_912_cov_15.546125	355	435	10	28	80	0.3500000
NODE_8550_length_912_cov_15.546125	408	488	10	80	80	1.0000000
NODE_8551_length_912_cov_15.077491	255	291	0	36	36	1.0000000
NODE_8551_length_912_cov_15.077491	264	328	0	64	64	1.0000000
NODE_8551_length_912_cov_15.077491	415	495	1	10	80	0.1250000
NODE_8551_length_912_cov_15.077491	415	495	2	70	80	0.8750000
NODE_8551_length_912_cov_15.077491	468	548	1	42	80	0.5250000
NODE_8551_length_912_cov_15.077491	468	548	2	38	80	0.4750000
NODE_8552_length_912_cov_15.023370	361	441	2	62	80	0.7750000
NODE_8552_length_912_cov_15.023370	361	441	4	18	80	0.2250000
NODE_8552_length_912_cov_15.023370	414	494	0	16	80	0.2000000
NODE_8552_length_912_cov_15.023370	414	494	2	63	80	0.7875000
NODE_8552_length_912_cov_15.023370	414	494	4	1	80	0.0125000
NODE_8553_length_912_cov_13.600246	61	141	0	47	80	0.5875000
NODE_8553_length_912_cov_13.600246	61	141	2	33	80	0.4125000
NODE_8553_length_912_cov_13.600246	460	540	0	64	80	0.8000000
NODE_8553_length_912_cov_13.600246	460	540	2	7	80	0.0875000
NODE_8553_length_912_cov_13.600246	460	540	7	9	80	0.1125000
NODE_8553_length_912_cov_13.600246	513	593	0	11	80	0.1375000
NODE_8553_length_912_cov_13.600246	513	593	2	7	80	0.0875000
NODE_8553_length_912_cov_13.600246	513	593	7	45	80	0.5625000
NODE_8553_length_912_cov_13.600246	513	593	8	17	80	0.2125000
NODE_8554_length_912_cov_13.113161	385	465	2	51	80	0.6375000
NODE_8554_length_912_cov_13.113161	385	465	4	29	80	0.3625000
NODE_8554_length_912_cov_13.113161	438	518	2	39	80	0.4875000
NODE_8554_length_912_cov_13.113161	438	518	4	41	80	0.5125000
NODE_8555_length_912_cov_11.110701	353	433	2	80	80	1.0000000
NODE_8555_length_912_cov_11.110701	406	486	0	47	80	0.5875000
NODE_8555_length_912_cov_11.110701	406	486	2	33	80	0.4125000
NODE_8555_length_912_cov_11.110701	827	907	0	6	80	0.0750000
NODE_8555_length_912_cov_11.110701	827	907	2	2	80	0.0250000
NODE_8555_length_912_cov_11.110701	827	907	4	6	80	0.0750000
NODE_8555_length_912_cov_11.110701	827	907	6	66	80	0.8250000
NODE_8555_length_912_cov_11.110701	831	854	6	23	23	1.0000000
NODE_8584_length_911_cov_173.171182	580	660	427	1	80	0.0125000
NODE_8584_length_911_cov_173.171182	580	660	432	1	80	0.0125000
NODE_8584_length_911_cov_173.171182	580	660	433	1	80	0.0125000
NODE_8584_length_911_cov_173.171182	580	660	441	1	80	0.0125000
NODE_8584_length_911_cov_173.171182	580	660	448	1	80	0.0125000
NODE_8584_length_911_cov_173.171182	580	660	457	1	80	0.0125000
NODE_8584_length_911_cov_173.171182	580	660	464	1	80	0.0125000
NODE_8584_length_911_cov_173.171182	580	660	474	1	80	0.0125000
NODE_8584_length_911_cov_173.171182	580	660	487	1	80	0.0125000
NODE_8584_length_911_cov_173.171182	580	660	489	1	80	0.0125000
NODE_8584_length_911_cov_173.171182	580	660	492	1	80	0.0125000
NODE_8584_length_911_cov_173.171182	580	660	495	1	80	0.0125000
NODE_8584_length_911_cov_173.171182	580	660	499	1	80	0.0125000
NODE_8584_length_911_cov_173.171182	580	660	501	1	80	0.0125000
NODE_8584_length_911_cov_173.171182	580	660	506	1	80	0.0125000
NODE_8584_length_911_cov_173.171182	580	660	521	1	80	0.0125000
NODE_8584_length_911_cov_173.171182	580	660	522	1	80	0.0125000
NODE_8584_length_911_cov_173.171182	580	660	523	2	80	0.0250000
NODE_8584_length_911_cov_173.171182	580	660	524	2	80	0.0250000
NODE_8584_length_911_cov_173.171182	580	660	526	2	80	0.0250000
NODE_8584_length_911_cov_173.171182	580	660	527	1	80	0.0125000
NODE_8584_length_911_cov_173.171182	580	660	528	2	80	0.0250000
NODE_8584_length_911_cov_173.171182	580	660	529	1	80	0.0125000
NODE_8584_length_911_cov_173.171182	580	660	533	1	80	0.0125000
NODE_8584_length_911_cov_173.171182	580	660	536	3	80	0.0375000
NODE_8584_length_911_cov_173.171182	580	660	538	1	80	0.0125000
NODE_8584_length_911_cov_173.171182	580	660	542	1	80	0.0125000
NODE_8584_length_911_cov_173.171182	580	660	543	1	80	0.0125000
NODE_8584_length_911_cov_173.171182	580	660	544	2	80	0.0250000
NODE_8584_length_911_cov_173.171182	580	660	546	1	80	0.0125000
NODE_8584_length_911_cov_173.171182	580	660	548	2	80	0.0250000
NODE_8584_length_911_cov_173.171182	580	660	551	1	80	0.0125000
NODE_8584_length_911_cov_173.171182	580	660	552	1	80	0.0125000
NODE_8584_length_911_cov_173.171182	580	660	554	1	80	0.0125000
NODE_8584_length_911_cov_173.171182	580	660	559	2	80	0.0250000
NODE_8584_length_911_cov_173.171182	580	660	569	1	80	0.0125000
NODE_8584_length_911_cov_173.171182	580	660	571	1	80	0.0125000
NODE_8584_length_911_cov_173.171182	580	660	579	1	80	0.0125000
NODE_8584_length_911_cov_173.171182	580	660	581	1	80	0.0125000
NODE_8584_length_911_cov_173.171182	580	660	583	3	80	0.0375000
NODE_8584_length_911_cov_173.171182	580	660	588	1	80	0.0125000
NODE_8584_length_911_cov_173.171182	580	660	589	1	80	0.0125000
NODE_8584_length_911_cov_173.171182	580	660	590	1	80	0.0125000
NODE_8584_length_911_cov_173.171182	580	660	591	1	80	0.0125000
NODE_8584_length_911_cov_173.171182	580	660	597	1	80	0.0125000
NODE_8584_length_911_cov_173.171182	580	660	618	1	80	0.0125000
NODE_8584_length_911_cov_173.171182	580	660	619	1	80	0.0125000
NODE_8584_length_911_cov_173.171182	580	660	622	1	80	0.0125000
NODE_8584_length_911_cov_173.171182	580	660	624	1	80	0.0125000
NODE_8584_length_911_cov_173.171182	580	660	631	2	80	0.0250000
NODE_8584_length_911_cov_173.171182	580	660	632	1	80	0.0125000
NODE_8584_length_911_cov_173.171182	580	660	638	2	80	0.0250000
NODE_8584_length_911_cov_173.171182	580	660	641	1	80	0.0125000
NODE_8584_length_911_cov_173.171182	580	660	642	2	80	0.0250000
NODE_8584_length_911_cov_173.171182	580	660	643	1	80	0.0125000
NODE_8584_length_911_cov_173.171182	580	660	645	2	80	0.0250000
NODE_8584_length_911_cov_173.171182	580	660	646	3	80	0.0375000
NODE_8584_length_911_cov_173.171182	580	660	647	2	80	0.0250000
NODE_8584_length_911_cov_173.171182	580	660	648	2	80	0.0250000
NODE_8584_length_911_cov_173.171182	580	660	650	2	80	0.0250000
NODE_8584_length_911_cov_173.171182	633	713	590	1	80	0.0125000
NODE_8584_length_911_cov_173.171182	633	713	591	1	80	0.0125000
NODE_8584_length_911_cov_173.171182	633	713	597	1	80	0.0125000
NODE_8584_length_911_cov_173.171182	633	713	618	1	80	0.0125000
NODE_8584_length_911_cov_173.171182	633	713	619	1	80	0.0125000
NODE_8584_length_911_cov_173.171182	633	713	622	1	80	0.0125000
NODE_8584_length_911_cov_173.171182	633	713	624	1	80	0.0125000
NODE_8584_length_911_cov_173.171182	633	713	631	2	80	0.0250000
NODE_8584_length_911_cov_173.171182	633	713	632	1	80	0.0125000
NODE_8584_length_911_cov_173.171182	633	713	638	2	80	0.0250000
NODE_8584_length_911_cov_173.171182	633	713	641	1	80	0.0125000
NODE_8584_length_911_cov_173.171182	633	713	642	2	80	0.0250000
NODE_8584_length_911_cov_173.171182	633	713	643	1	80	0.0125000
NODE_8584_length_911_cov_173.171182	633	713	644	1	80	0.0125000
NODE_8584_length_911_cov_173.171182	633	713	645	2	80	0.0250000
NODE_8584_length_911_cov_173.171182	633	713	646	3	80	0.0375000
NODE_8584_length_911_cov_173.171182	633	713	647	3	80	0.0375000
NODE_8584_length_911_cov_173.171182	633	713	648	4	80	0.0500000
NODE_8584_length_911_cov_173.171182	633	713	649	1	80	0.0125000
NODE_8584_length_911_cov_173.171182	633	713	650	5	80	0.0625000
NODE_8584_length_911_cov_173.171182	633	713	652	1	80	0.0125000
NODE_8584_length_911_cov_173.171182	633	713	653	1	80	0.0125000
NODE_8584_length_911_cov_173.171182	633	713	655	2	80	0.0250000
NODE_8584_length_911_cov_173.171182	633	713	656	2	80	0.0250000
NODE_8584_length_911_cov_173.171182	633	713	659	1	80	0.0125000
NODE_8584_length_911_cov_173.171182	633	713	661	1	80	0.0125000
NODE_8584_length_911_cov_173.171182	633	713	666	1	80	0.0125000
NODE_8584_length_911_cov_173.171182	633	713	668	2	80	0.0250000
NODE_8584_length_911_cov_173.171182	633	713	669	2	80	0.0250000
NODE_8584_length_911_cov_173.171182	633	713	673	1	80	0.0125000
NODE_8584_length_911_cov_173.171182	633	713	674	1	80	0.0125000
NODE_8584_length_911_cov_173.171182	633	713	676	1	80	0.0125000
NODE_8584_length_911_cov_173.171182	633	713	677	1	80	0.0125000
NODE_8584_length_911_cov_173.171182	633	713	680	1	80	0.0125000
NODE_8584_length_911_cov_173.171182	633	713	681	1	80	0.0125000
NODE_8584_length_911_cov_173.171182	633	713	684	2	80	0.0250000
NODE_8584_length_911_cov_173.171182	633	713	685	1	80	0.0125000
NODE_8584_length_911_cov_173.171182	633	713	687	1	80	0.0125000
NODE_8584_length_911_cov_173.171182	633	713	689	2	80	0.0250000
NODE_8584_length_911_cov_173.171182	633	713	690	1	80	0.0125000
NODE_8584_length_911_cov_173.171182	633	713	696	1	80	0.0125000
NODE_8584_length_911_cov_173.171182	633	713	697	1	80	0.0125000
NODE_8584_length_911_cov_173.171182	633	713	698	3	80	0.0375000
NODE_8584_length_911_cov_173.171182	633	713	700	1	80	0.0125000
NODE_8584_length_911_cov_173.171182	633	713	707	1	80	0.0125000
NODE_8584_length_911_cov_173.171182	633	713	709	1	80	0.0125000
NODE_8584_length_911_cov_173.171182	633	713	727	1	80	0.0125000
NODE_8584_length_911_cov_173.171182	633	713	739	1	80	0.0125000
NODE_8584_length_911_cov_173.171182	633	713	741	1	80	0.0125000
NODE_8584_length_911_cov_173.171182	633	713	742	1	80	0.0125000
NODE_8584_length_911_cov_173.171182	633	713	757	1	80	0.0125000
NODE_8584_length_911_cov_173.171182	633	713	771	1	80	0.0125000
NODE_8584_length_911_cov_173.171182	633	713	772	1	80	0.0125000
NODE_8584_length_911_cov_173.171182	633	713	788	1	80	0.0125000
NODE_8584_length_911_cov_173.171182	633	713	803	1	80	0.0125000
NODE_8584_length_911_cov_173.171182	633	713	814	1	80	0.0125000
NODE_8584_length_911_cov_173.171182	633	713	836	1	80	0.0125000
NODE_8585_length_911_cov_88.250000	525	605	6	17	80	0.2125000
NODE_8585_length_911_cov_88.250000	525	605	8	63	80	0.7875000
NODE_8585_length_911_cov_88.250000	578	658	0	29	80	0.3625000
NODE_8585_length_911_cov_88.250000	578	658	2	18	80	0.2250000
NODE_8585_length_911_cov_88.250000	578	658	6	23	80	0.2875000
NODE_8585_length_911_cov_88.250000	578	658	8	10	80	0.1250000
NODE_8586_length_911_cov_46.854680	255	335	14	12	80	0.1500000
NODE_8586_length_911_cov_46.854680	255	335	15	25	80	0.3125000
NODE_8586_length_911_cov_46.854680	255	335	16	43	80	0.5375000
NODE_8586_length_911_cov_46.854680	308	388	1	28	80	0.3500000
NODE_8586_length_911_cov_46.854680	308	388	13	5	80	0.0625000
NODE_8586_length_911_cov_46.854680	308	388	14	32	80	0.4000000
NODE_8586_length_911_cov_46.854680	308	388	15	15	80	0.1875000
NODE_8586_length_911_cov_46.854680	384	464	0	70	80	0.8750000
NODE_8586_length_911_cov_46.854680	384	464	1	10	80	0.1250000
NODE_8586_length_911_cov_46.854680	437	517	0	80	80	1.0000000
NODE_8587_length_911_cov_31.362069	301	381	0	34	80	0.4250000
NODE_8587_length_911_cov_31.362069	301	381	2	46	80	0.5750000
NODE_8587_length_911_cov_31.362069	354	434	0	8	80	0.1000000
NODE_8587_length_911_cov_31.362069	354	434	2	72	80	0.9000000
NODE_8588_length_911_cov_19.235222	445	525	2	16	80	0.2000000
NODE_8588_length_911_cov_19.235222	445	525	5	11	80	0.1375000
NODE_8588_length_911_cov_19.235222	445	525	6	12	80	0.1500000
NODE_8588_length_911_cov_19.235222	445	525	8	41	80	0.5125000
NODE_8588_length_911_cov_19.235222	498	578	0	6	80	0.0750000
NODE_8588_length_911_cov_19.235222	498	578	2	63	80	0.7875000
NODE_8588_length_911_cov_19.235222	498	578	8	11	80	0.1375000
NODE_8589_length_911_cov_16.230296	233	313	2	23	80	0.2875000
NODE_8589_length_911_cov_16.230296	233	313	4	57	80	0.7125000
NODE_8589_length_911_cov_16.230296	286	366	0	51	80	0.6375000
NODE_8589_length_911_cov_16.230296	286	366	2	25	80	0.3125000
NODE_8589_length_911_cov_16.230296	286	366	4	4	80	0.0500000
NODE_8590_length_911_cov_14.979064	472	552	0	80	80	1.0000000
NODE_8590_length_911_cov_14.979064	525	605	0	27	80	0.3375000
NODE_8590_length_911_cov_14.979064	525	605	4	53	80	0.6625000
NODE_8591_length_911_cov_12.089901	357	409	10	24	52	0.4615385
NODE_8591_length_911_cov_12.089901	357	409	12	10	52	0.1923077
NODE_8591_length_911_cov_12.089901	357	409	14	8	52	0.1538462
NODE_8591_length_911_cov_12.089901	357	409	16	10	52	0.1923077
NODE_8591_length_911_cov_12.089901	401	462	4	3	61	0.0491803
NODE_8591_length_911_cov_12.089901	401	462	6	24	61	0.3934426
NODE_8591_length_911_cov_12.089901	401	462	10	9	61	0.1475410
NODE_8591_length_911_cov_12.089901	401	462	12	15	61	0.2459016
NODE_8591_length_911_cov_12.089901	401	462	14	10	61	0.1639344
NODE_8606_length_910_cov_27.838471	347	427	0	80	80	1.0000000
NODE_8606_length_910_cov_27.838471	400	480	0	61	80	0.7625000
NODE_8606_length_910_cov_27.838471	400	480	2	19	80	0.2375000
NODE_8607_length_910_cov_25.895191	361	441	0	3	80	0.0375000
NODE_8607_length_910_cov_25.895191	361	441	4	77	80	0.9625000
NODE_8607_length_910_cov_25.895191	414	494	0	21	80	0.2625000
NODE_8607_length_910_cov_25.895191	414	494	4	59	80	0.7375000
NODE_8608_length_910_cov_25.604192	294	374	0	41	80	0.5125000
NODE_8608_length_910_cov_25.604192	294	374	2	3	80	0.0375000
NODE_8608_length_910_cov_25.604192	294	374	4	36	80	0.4500000
NODE_8608_length_910_cov_25.604192	347	427	0	28	80	0.3500000
NODE_8608_length_910_cov_25.604192	347	427	1	6	80	0.0750000
NODE_8608_length_910_cov_25.604192	347	427	2	46	80	0.5750000
NODE_8608_length_910_cov_25.604192	423	503	2	48	80	0.6000000
NODE_8608_length_910_cov_25.604192	423	503	6	26	80	0.3250000
NODE_8608_length_910_cov_25.604192	423	503	10	6	80	0.0750000
NODE_8608_length_910_cov_25.604192	476	556	6	21	80	0.2625000
NODE_8608_length_910_cov_25.604192	476	556	8	17	80	0.2125000
NODE_8608_length_910_cov_25.604192	476	556	9	6	80	0.0750000
NODE_8608_length_910_cov_25.604192	476	556	10	36	80	0.4500000
NODE_8609_length_910_cov_16.066584	656	736	4	12	80	0.1500000
NODE_8609_length_910_cov_16.066584	656	736	6	68	80	0.8500000
NODE_8609_length_910_cov_16.066584	709	789	0	32	80	0.4000000
NODE_8609_length_910_cov_16.066584	709	789	2	7	80	0.0875000
NODE_8609_length_910_cov_16.066584	709	789	6	41	80	0.5125000
NODE_8610_length_910_cov_14.696671	417	497	14	19	80	0.2375000
NODE_8610_length_910_cov_14.696671	417	497	16	4	80	0.0500000
NODE_8610_length_910_cov_14.696671	417	497	17	3	80	0.0375000
NODE_8610_length_910_cov_14.696671	417	497	18	54	80	0.6750000
NODE_8610_length_910_cov_14.696671	470	550	0	15	80	0.1875000
NODE_8610_length_910_cov_14.696671	470	550	2	27	80	0.3375000
NODE_8610_length_910_cov_14.696671	470	550	11	11	80	0.1375000
NODE_8610_length_910_cov_14.696671	470	550	14	19	80	0.2375000
NODE_8610_length_910_cov_14.696671	470	550	16	1	80	0.0125000
NODE_8610_length_910_cov_14.696671	470	550	17	3	80	0.0375000
NODE_8610_length_910_cov_14.696671	470	550	18	4	80	0.0500000
NODE_8612_length_910_cov_7.114673	442	522	3	4	80	0.0500000
NODE_8612_length_910_cov_7.114673	442	522	4	30	80	0.3750000
NODE_8612_length_910_cov_7.114673	442	522	5	14	80	0.1750000
NODE_8612_length_910_cov_7.114673	442	522	7	32	80	0.4000000
NODE_8612_length_910_cov_7.114673	495	575	0	6	80	0.0750000
NODE_8612_length_910_cov_7.114673	495	575	2	24	80	0.3000000
NODE_8612_length_910_cov_7.114673	495	575	4	36	80	0.4500000
NODE_8612_length_910_cov_7.114673	495	575	5	5	80	0.0625000
NODE_8612_length_910_cov_7.114673	495	575	7	9	80	0.1125000
NODE_8614_length_910_cov_2.992602	196	269	8	5	73	0.0684932
NODE_8614_length_910_cov_2.992602	196	269	10	23	73	0.3150685
NODE_8614_length_910_cov_2.992602	196	269	12	20	73	0.2739726
NODE_8614_length_910_cov_2.992602	196	269	14	6	73	0.0821918
NODE_8614_length_910_cov_2.992602	196	269	16	4	73	0.0547945
NODE_8614_length_910_cov_2.992602	196	269	20	9	73	0.1232877
NODE_8614_length_910_cov_2.992602	196	269	22	1	73	0.0136986
NODE_8614_length_910_cov_2.992602	196	269	24	2	73	0.0273973
NODE_8614_length_910_cov_2.992602	196	269	26	1	73	0.0136986
NODE_8614_length_910_cov_2.992602	196	269	34	2	73	0.0273973
NODE_8614_length_910_cov_2.992602	249	329	12	1	80	0.0125000
NODE_8614_length_910_cov_2.992602	249	329	16	4	80	0.0500000
NODE_8614_length_910_cov_2.992602	249	329	20	9	80	0.1125000
NODE_8614_length_910_cov_2.992602	249	329	22	1	80	0.0125000
NODE_8614_length_910_cov_2.992602	249	329	24	2	80	0.0250000
NODE_8614_length_910_cov_2.992602	249	329	26	1	80	0.0125000
NODE_8614_length_910_cov_2.992602	249	329	32	17	80	0.2125000
NODE_8614_length_910_cov_2.992602	249	329	34	9	80	0.1125000
NODE_8614_length_910_cov_2.992602	249	329	36	4	80	0.0500000
NODE_8614_length_910_cov_2.992602	249	329	38	5	80	0.0625000
NODE_8614_length_910_cov_2.992602	249	329	40	4	80	0.0500000
NODE_8614_length_910_cov_2.992602	249	329	42	3	80	0.0375000
NODE_8614_length_910_cov_2.992602	249	329	44	12	80	0.1500000
NODE_8614_length_910_cov_2.992602	249	329	45	8	80	0.1000000
NODE_8614_length_910_cov_2.992602	386	439	28	4	53	0.0754717
NODE_8614_length_910_cov_2.992602	386	439	30	4	53	0.0754717
NODE_8614_length_910_cov_2.992602	386	439	32	5	53	0.0943396
NODE_8614_length_910_cov_2.992602	386	439	34	8	53	0.1509434
NODE_8614_length_910_cov_2.992602	386	439	36	15	53	0.2830189
NODE_8614_length_910_cov_2.992602	386	439	38	15	53	0.2830189
NODE_8614_length_910_cov_2.992602	386	439	40	2	53	0.0377358
NODE_8623_length_909_cov_35.291358	426	506	4	21	80	0.2625000
NODE_8623_length_909_cov_35.291358	426	506	6	4	80	0.0500000
NODE_8623_length_909_cov_35.291358	426	506	8	18	80	0.2250000
NODE_8623_length_909_cov_35.291358	426	506	10	13	80	0.1625000
NODE_8623_length_909_cov_35.291358	426	506	12	24	80	0.3000000
NODE_8623_length_909_cov_35.291358	479	559	6	35	80	0.4375000
NODE_8623_length_909_cov_35.291358	479	559	8	36	80	0.4500000
NODE_8623_length_909_cov_35.291358	479	559	10	9	80	0.1125000
NODE_8624_length_909_cov_27.449383	311	391	0	80	80	1.0000000
NODE_8624_length_909_cov_27.449383	364	444	0	29	80	0.3625000
NODE_8624_length_909_cov_27.449383	364	444	2	14	80	0.1750000
NODE_8624_length_909_cov_27.449383	364	444	4	37	80	0.4625000
NODE_8625_length_909_cov_25.212346	295	375	0	77	80	0.9625000
NODE_8625_length_909_cov_25.212346	295	375	2	3	80	0.0375000
NODE_8625_length_909_cov_25.212346	348	428	0	24	80	0.3000000
NODE_8625_length_909_cov_25.212346	348	428	2	56	80	0.7000000
NODE_8626_length_909_cov_23.604938	403	483	0	19	80	0.2375000
NODE_8626_length_909_cov_23.604938	403	483	2	61	80	0.7625000
NODE_8626_length_909_cov_23.604938	456	536	0	18	80	0.2250000
NODE_8626_length_909_cov_23.604938	456	536	2	62	80	0.7750000
NODE_8627_length_909_cov_19.070370	441	521	2	28	80	0.3500000
NODE_8627_length_909_cov_19.070370	441	521	4	19	80	0.2375000
NODE_8627_length_909_cov_19.070370	441	521	5	4	80	0.0500000
NODE_8627_length_909_cov_19.070370	441	521	6	29	80	0.3625000
NODE_8627_length_909_cov_19.070370	494	574	6	80	80	1.0000000
NODE_8628_length_909_cov_11.533333	332	412	0	49	80	0.6125000
NODE_8628_length_909_cov_11.533333	332	412	2	31	80	0.3875000
NODE_8628_length_909_cov_11.533333	385	465	0	80	80	1.0000000
NODE_8629_length_909_cov_10.229630	497	577	0	80	80	1.0000000
NODE_8629_length_909_cov_10.229630	550	622	0	72	72	1.0000000
NODE_8631_length_909_cov_7.122222	328	408	0	80	80	1.0000000
NODE_8631_length_909_cov_7.122222	381	461	0	80	80	1.0000000
NODE_8632_length_909_cov_4.664198	775	855	4	5	80	0.0625000
NODE_8632_length_909_cov_4.664198	775	855	6	36	80	0.4500000
NODE_8632_length_909_cov_4.664198	775	855	8	39	80	0.4875000
NODE_8632_length_909_cov_4.664198	828	885	0	5	57	0.0877193
NODE_8632_length_909_cov_4.664198	828	885	1	1	57	0.0175439
NODE_8632_length_909_cov_4.664198	828	885	2	18	57	0.3157895
NODE_8632_length_909_cov_4.664198	828	885	4	11	57	0.1929825
NODE_8632_length_909_cov_4.664198	828	885	6	22	57	0.3859649
NODE_8644_length_908_cov_55.546354	409	489	8	28	80	0.3500000
NODE_8644_length_908_cov_55.546354	409	489	11	9	80	0.1125000
NODE_8644_length_908_cov_55.546354	409	489	19	43	80	0.5375000
NODE_8644_length_908_cov_55.546354	462	542	0	1	80	0.0125000
NODE_8644_length_908_cov_55.546354	462	542	11	30	80	0.3750000
NODE_8644_length_908_cov_55.546354	462	542	12	31	80	0.3875000
NODE_8644_length_908_cov_55.546354	462	542	19	18	80	0.2250000
NODE_8645_length_908_cov_18.720643	329	409	0	80	80	1.0000000
NODE_8645_length_908_cov_18.720643	382	462	0	63	80	0.7875000
NODE_8645_length_908_cov_18.720643	382	462	2	17	80	0.2125000
NODE_8646_length_908_cov_14.640297	430	510	4	3	80	0.0375000
NODE_8646_length_908_cov_14.640297	430	510	6	9	80	0.1125000
NODE_8646_length_908_cov_14.640297	430	510	8	1	80	0.0125000
NODE_8646_length_908_cov_14.640297	430	510	10	9	80	0.1125000
NODE_8646_length_908_cov_14.640297	430	510	12	9	80	0.1125000
NODE_8646_length_908_cov_14.640297	430	510	14	49	80	0.6125000
NODE_8646_length_908_cov_14.640297	483	562	0	40	79	0.5063291
NODE_8646_length_908_cov_14.640297	483	562	2	8	79	0.1012658
NODE_8646_length_908_cov_14.640297	483	562	4	7	79	0.0886076
NODE_8646_length_908_cov_14.640297	483	562	6	9	79	0.1139240
NODE_8646_length_908_cov_14.640297	483	562	8	1	79	0.0126582
NODE_8646_length_908_cov_14.640297	483	562	10	9	79	0.1139240
NODE_8646_length_908_cov_14.640297	483	562	12	1	79	0.0126582
NODE_8646_length_908_cov_14.640297	483	562	14	4	79	0.0506329
NODE_8648_length_908_cov_10.789864	370	450	0	12	80	0.1500000
NODE_8648_length_908_cov_10.789864	370	450	2	5	80	0.0625000
NODE_8648_length_908_cov_10.789864	370	450	6	49	80	0.6125000
NODE_8648_length_908_cov_10.789864	370	450	10	14	80	0.1750000
NODE_8648_length_908_cov_10.789864	423	503	4	28	80	0.3500000
NODE_8648_length_908_cov_10.789864	423	503	6	13	80	0.1625000
NODE_8648_length_908_cov_10.789864	423	503	8	7	80	0.0875000
NODE_8648_length_908_cov_10.789864	423	503	10	32	80	0.4000000
NODE_8651_length_908_cov_3.737948	251	331	0	80	80	1.0000000
NODE_8651_length_908_cov_3.737948	304	384	0	80	80	1.0000000
NODE_8664_length_907_cov_22.110149	459	539	0	80	80	1.0000000
NODE_8664_length_907_cov_22.110149	512	592	0	80	80	1.0000000
NODE_8665_length_907_cov_20.943069	410	490	0	80	80	1.0000000
NODE_8665_length_907_cov_20.943069	463	543	0	80	80	1.0000000
NODE_8666_length_907_cov_19.519802	411	488	0	43	77	0.5584416
NODE_8666_length_907_cov_19.519802	411	488	6	34	77	0.4415585
NODE_8666_length_907_cov_19.519802	461	541	6	80	80	1.0000000
NODE_8667_length_907_cov_17.928218	329	405	0	29	76	0.3815790
NODE_8667_length_907_cov_17.928218	329	405	2	37	76	0.4868421
NODE_8667_length_907_cov_17.928218	329	405	4	7	76	0.0921053
NODE_8667_length_907_cov_17.928218	329	405	6	3	76	0.0394737
NODE_8667_length_907_cov_17.928218	382	462	2	13	80	0.1625000
NODE_8667_length_907_cov_17.928218	382	462	4	10	80	0.1250000
NODE_8667_length_907_cov_17.928218	382	462	6	57	80	0.7125000
NODE_8668_length_907_cov_13.060644	293	373	0	14	80	0.1750000
NODE_8668_length_907_cov_13.060644	293	373	2	25	80	0.3125000
NODE_8668_length_907_cov_13.060644	293	373	6	41	80	0.5125000
NODE_8668_length_907_cov_13.060644	346	426	0	8	80	0.1000000
NODE_8668_length_907_cov_13.060644	346	426	2	2	80	0.0250000
NODE_8668_length_907_cov_13.060644	346	426	6	70	80	0.8750000
NODE_8669_length_907_cov_11.155941	401	462	3	9	61	0.1475410
NODE_8669_length_907_cov_11.155941	401	462	6	7	61	0.1147541
NODE_8669_length_907_cov_11.155941	401	462	8	45	61	0.7377049
NODE_8669_length_907_cov_11.155941	607	687	0	68	80	0.8500000
NODE_8669_length_907_cov_11.155941	607	687	4	12	80	0.1500000
NODE_8670_length_907_cov_9.237624	247	327	0	56	80	0.7000000
NODE_8670_length_907_cov_9.237624	247	327	2	24	80	0.3000000
NODE_8670_length_907_cov_9.237624	300	380	0	55	80	0.6875000
NODE_8670_length_907_cov_9.237624	300	380	1	7	80	0.0875000
NODE_8670_length_907_cov_9.237624	300	380	3	18	80	0.2250000
NODE_8671_length_907_cov_8.686881	275	365	0	80	90	0.8888889
NODE_8671_length_907_cov_8.686881	275	365	1	6	90	0.0666667
NODE_8671_length_907_cov_8.686881	275	365	2	4	90	0.0444444
NODE_8671_length_907_cov_8.686881	338	418	0	23	80	0.2875000
NODE_8671_length_907_cov_8.686881	338	418	2	57	80	0.7125000
NODE_8680_length_907_cov_2.949257	503	526	0	23	23	1.0000000
NODE_8686_length_906_cov_32.369269	447	527	0	34	80	0.4250000
NODE_8686_length_906_cov_32.369269	447	527	2	46	80	0.5750000
NODE_8686_length_906_cov_32.369269	500	580	2	80	80	1.0000000
NODE_8687_length_906_cov_23.594796	196	276	8	21	80	0.2625000
NODE_8687_length_906_cov_23.594796	196	276	9	11	80	0.1375000
NODE_8687_length_906_cov_23.594796	196	276	10	3	80	0.0375000
NODE_8687_length_906_cov_23.594796	196	276	12	5	80	0.0625000
NODE_8687_length_906_cov_23.594796	196	276	14	7	80	0.0875000
NODE_8687_length_906_cov_23.594796	196	276	15	2	80	0.0250000
NODE_8687_length_906_cov_23.594796	196	276	16	31	80	0.3875000
NODE_8687_length_906_cov_23.594796	249	329	4	1	80	0.0125000
NODE_8687_length_906_cov_23.594796	249	329	6	6	80	0.0750000
NODE_8687_length_906_cov_23.594796	249	329	8	6	80	0.0750000
NODE_8687_length_906_cov_23.594796	249	329	12	43	80	0.5375000
NODE_8687_length_906_cov_23.594796	249	329	15	2	80	0.0250000
NODE_8687_length_906_cov_23.594796	249	329	16	22	80	0.2750000
NODE_8688_length_906_cov_21.443618	404	484	6	1	80	0.0125000
NODE_8688_length_906_cov_21.443618	404	484	7	1	80	0.0125000
NODE_8688_length_906_cov_21.443618	404	484	8	78	80	0.9750000
NODE_8688_length_906_cov_21.443618	457	537	2	16	80	0.2000000
NODE_8688_length_906_cov_21.443618	457	537	6	34	80	0.4250000
NODE_8688_length_906_cov_21.443618	457	537	8	29	80	0.3625000
NODE_8688_length_906_cov_21.443618	457	537	10	1	80	0.0125000
NODE_8689_length_906_cov_20.596035	593	634	2	41	41	1.0000000
NODE_8690_length_906_cov_20.429988	410	490	0	80	80	1.0000000
NODE_8690_length_906_cov_20.429988	463	543	0	80	80	1.0000000
NODE_8691_length_906_cov_20.395291	523	603	0	4	80	0.0500000
NODE_8691_length_906_cov_20.395291	523	603	10	36	80	0.4500000
NODE_8691_length_906_cov_20.395291	523	603	12	40	80	0.5000000
NODE_8691_length_906_cov_20.395291	576	656	0	14	80	0.1750000
NODE_8691_length_906_cov_20.395291	576	656	2	6	80	0.0750000
NODE_8691_length_906_cov_20.395291	576	656	12	60	80	0.7500000
NODE_8692_length_906_cov_19.297398	255	335	0	80	80	1.0000000
NODE_8692_length_906_cov_19.297398	308	388	0	80	80	1.0000000
NODE_8693_length_906_cov_18.505576	357	437	2	80	80	1.0000000
NODE_8693_length_906_cov_18.505576	410	490	0	29	80	0.3625000
NODE_8693_length_906_cov_18.505576	410	490	2	51	80	0.6375000
NODE_8694_length_906_cov_10.068154	191	271	0	58	80	0.7250000
NODE_8694_length_906_cov_10.068154	191	271	2	2	80	0.0250000
NODE_8694_length_906_cov_10.068154	191	271	4	20	80	0.2500000
NODE_8694_length_906_cov_10.068154	244	324	0	5	80	0.0625000
NODE_8694_length_906_cov_10.068154	244	324	2	4	80	0.0500000
NODE_8694_length_906_cov_10.068154	244	324	4	71	80	0.8875000
NODE_8695_length_906_cov_10.006196	304	384	0	11	80	0.1375000
NODE_8695_length_906_cov_10.006196	304	384	2	69	80	0.8625000
NODE_8695_length_906_cov_10.006196	357	437	0	47	80	0.5875000
NODE_8695_length_906_cov_10.006196	357	437	1	1	80	0.0125000
NODE_8695_length_906_cov_10.006196	357	437	2	32	80	0.4000000
NODE_8696_length_906_cov_8.562577	370	454	0	84	84	1.0000000
NODE_8696_length_906_cov_8.562577	423	507	0	34	84	0.4047619
NODE_8696_length_906_cov_8.562577	423	507	2	50	84	0.5952381
NODE_8716_length_905_cov_39.203474	406	486	0	31	80	0.3875000
NODE_8716_length_905_cov_39.203474	406	486	2	17	80	0.2125000
NODE_8716_length_905_cov_39.203474	406	486	4	32	80	0.4000000
NODE_8716_length_905_cov_39.203474	459	539	2	21	80	0.2625000
NODE_8716_length_905_cov_39.203474	459	539	4	59	80	0.7375000
NODE_8717_length_905_cov_37.053350	411	491	2	40	80	0.5000000
NODE_8717_length_905_cov_37.053350	411	491	4	4	80	0.0500000
NODE_8717_length_905_cov_37.053350	411	491	6	36	80	0.4500000
NODE_8717_length_905_cov_37.053350	464	544	0	50	80	0.6250000
NODE_8717_length_905_cov_37.053350	464	544	2	30	80	0.3750000
NODE_8718_length_905_cov_27.426799	288	368	0	80	80	1.0000000
NODE_8718_length_905_cov_27.426799	341	421	0	80	80	1.0000000
NODE_8719_length_905_cov_26.332506	375	455	0	80	80	1.0000000
NODE_8719_length_905_cov_26.332506	428	508	0	28	80	0.3500000
NODE_8719_length_905_cov_26.332506	428	508	2	52	80	0.6500000
NODE_8720_length_905_cov_20.651365	377	457	0	80	80	1.0000000
NODE_8720_length_905_cov_20.651365	430	510	0	80	80	1.0000000
NODE_8721_length_905_cov_19.718362	365	445	2	65	80	0.8125000
NODE_8721_length_905_cov_19.718362	365	445	4	15	80	0.1875000
NODE_8721_length_905_cov_19.718362	418	498	0	53	80	0.6625000
NODE_8721_length_905_cov_19.718362	418	498	2	27	80	0.3375000
NODE_8722_length_905_cov_13.696030	366	420	11	19	54	0.3518519
NODE_8722_length_905_cov_13.696030	366	420	19	12	54	0.2222222
NODE_8722_length_905_cov_13.696030	366	420	20	17	54	0.3148148
NODE_8722_length_905_cov_13.696030	366	420	21	6	54	0.1111111
NODE_8723_length_905_cov_9.978908	222	302	0	80	80	1.0000000
NODE_8723_length_905_cov_9.978908	275	355	0	80	80	1.0000000
NODE_8725_length_905_cov_7.980149	321	401	0	2	80	0.0250000
NODE_8725_length_905_cov_7.980149	321	401	2	78	80	0.9750000
NODE_8725_length_905_cov_7.980149	374	454	0	15	80	0.1875000
NODE_8725_length_905_cov_7.980149	374	454	2	65	80	0.8125000
NODE_8727_length_905_cov_6.064516	459	539	0	80	80	1.0000000
NODE_8727_length_905_cov_6.064516	512	592	0	80	80	1.0000000
NODE_8742_length_905_cov_1.040943	73	119	26	11	46	0.2391304
NODE_8742_length_905_cov_1.040943	73	119	28	35	46	0.7608696
NODE_8742_length_905_cov_1.040943	126	172	10	7	46	0.1521739
NODE_8742_length_905_cov_1.040943	126	172	12	2	46	0.0434783
NODE_8742_length_905_cov_1.040943	126	172	14	9	46	0.1956522
NODE_8742_length_905_cov_1.040943	126	172	17	1	46	0.0217391
NODE_8742_length_905_cov_1.040943	126	172	22	4	46	0.0869565
NODE_8742_length_905_cov_1.040943	126	172	25	1	46	0.0217391
NODE_8742_length_905_cov_1.040943	126	172	26	22	46	0.4782609
NODE_8743_length_904_cov_29.532919	338	418	2	80	80	1.0000000
NODE_8743_length_904_cov_29.532919	391	471	0	28	80	0.3500000
NODE_8743_length_904_cov_29.532919	391	471	2	52	80	0.6500000
NODE_8743_length_904_cov_29.532919	467	547	0	4	80	0.0500000
NODE_8743_length_904_cov_29.532919	467	547	2	6	80	0.0750000
NODE_8743_length_904_cov_29.532919	467	547	4	70	80	0.8750000
NODE_8743_length_904_cov_29.532919	520	600	0	7	80	0.0875000
NODE_8743_length_904_cov_29.532919	520	600	1	1	80	0.0125000
NODE_8743_length_904_cov_29.532919	520	600	2	39	80	0.4875000
NODE_8743_length_904_cov_29.532919	520	600	4	33	80	0.4125000
NODE_8744_length_904_cov_28.844720	371	451	0	38	80	0.4750000
NODE_8744_length_904_cov_28.844720	371	451	4	42	80	0.5250000
NODE_8744_length_904_cov_28.844720	424	504	4	39	80	0.4875000
NODE_8744_length_904_cov_28.844720	424	504	6	41	80	0.5125000
NODE_8745_length_904_cov_26.977640	488	568	0	30	80	0.3750000
NODE_8745_length_904_cov_26.977640	488	568	2	50	80	0.6250000
NODE_8745_length_904_cov_26.977640	541	621	0	80	80	1.0000000
NODE_8746_length_904_cov_24.529193	464	544	0	25	80	0.3125000
NODE_8746_length_904_cov_24.529193	464	544	2	55	80	0.6875000
NODE_8746_length_904_cov_24.529193	517	597	0	73	80	0.9125000
NODE_8746_length_904_cov_24.529193	517	597	2	7	80	0.0875000
NODE_8747_length_904_cov_24.452174	507	587	0	16	80	0.2000000
NODE_8747_length_904_cov_24.452174	507	587	2	29	80	0.3625000
NODE_8747_length_904_cov_24.452174	507	587	4	7	80	0.0875000
NODE_8747_length_904_cov_24.452174	507	587	6	28	80	0.3500000
NODE_8747_length_904_cov_24.452174	560	640	0	22	80	0.2750000
NODE_8747_length_904_cov_24.452174	560	640	2	58	80	0.7250000
NODE_8748_length_904_cov_19.649689	307	387	0	4	80	0.0500000
NODE_8748_length_904_cov_19.649689	307	387	2	29	80	0.3625000
NODE_8748_length_904_cov_19.649689	307	387	4	47	80	0.5875000
NODE_8748_length_904_cov_19.649689	360	440	0	57	80	0.7125000
NODE_8748_length_904_cov_19.649689	360	440	2	23	80	0.2875000
NODE_8748_length_904_cov_19.649689	595	675	2	14	80	0.1750000
NODE_8748_length_904_cov_19.649689	595	675	4	38	80	0.4750000
NODE_8748_length_904_cov_19.649689	595	675	6	28	80	0.3500000
NODE_8748_length_904_cov_19.649689	648	728	2	24	80	0.3000000
NODE_8748_length_904_cov_19.649689	648	728	4	7	80	0.0875000
NODE_8748_length_904_cov_19.649689	648	728	5	17	80	0.2125000
NODE_8748_length_904_cov_19.649689	648	728	6	32	80	0.4000000
NODE_8750_length_904_cov_16.608696	252	332	0	58	80	0.7250000
NODE_8750_length_904_cov_16.608696	252	332	1	22	80	0.2750000
NODE_8750_length_904_cov_16.608696	305	385	0	80	80	1.0000000
NODE_8750_length_904_cov_16.608696	381	461	0	80	80	1.0000000
NODE_8750_length_904_cov_16.608696	434	514	0	80	80	1.0000000
NODE_8751_length_904_cov_15.811180	431	511	0	50	80	0.6250000
NODE_8751_length_904_cov_15.811180	431	511	2	13	80	0.1625000
NODE_8751_length_904_cov_15.811180	431	511	4	2	80	0.0250000
NODE_8751_length_904_cov_15.811180	431	511	12	12	80	0.1500000
NODE_8751_length_904_cov_15.811180	431	511	14	3	80	0.0375000
NODE_8751_length_904_cov_15.811180	484	564	2	10	80	0.1250000
NODE_8751_length_904_cov_15.811180	484	564	4	2	80	0.0250000
NODE_8751_length_904_cov_15.811180	484	564	12	12	80	0.1500000
NODE_8751_length_904_cov_15.811180	484	564	14	15	80	0.1875000
NODE_8751_length_904_cov_15.811180	484	564	16	41	80	0.5125000
NODE_8752_length_904_cov_9.249689	581	661	0	59	80	0.7375000
NODE_8752_length_904_cov_9.249689	581	661	2	21	80	0.2625000
NODE_8752_length_904_cov_9.249689	634	714	0	16	80	0.2000000
NODE_8752_length_904_cov_9.249689	634	714	2	64	80	0.8000000
NODE_8756_length_904_cov_4.772671	318	398	0	14	80	0.1750000
NODE_8756_length_904_cov_4.772671	318	398	2	66	80	0.8250000
NODE_8756_length_904_cov_4.772671	371	451	0	67	80	0.8375000
NODE_8756_length_904_cov_4.772671	371	451	2	13	80	0.1625000
NODE_8773_length_903_cov_58.723881	386	466	10	1	80	0.0125000
NODE_8773_length_903_cov_58.723881	386	466	12	20	80	0.2500000
NODE_8773_length_903_cov_58.723881	386	466	13	2	80	0.0250000
NODE_8773_length_903_cov_58.723881	386	466	14	1	80	0.0125000
NODE_8773_length_903_cov_58.723881	386	466	17	2	80	0.0250000
NODE_8773_length_903_cov_58.723881	386	466	19	3	80	0.0375000
NODE_8773_length_903_cov_58.723881	386	466	20	8	80	0.1000000
NODE_8773_length_903_cov_58.723881	386	466	26	1	80	0.0125000
NODE_8773_length_903_cov_58.723881	386	466	28	6	80	0.0750000
NODE_8773_length_903_cov_58.723881	386	466	30	9	80	0.1125000
NODE_8773_length_903_cov_58.723881	386	466	32	27	80	0.3375000
NODE_8773_length_903_cov_58.723881	439	519	14	3	80	0.0375000
NODE_8773_length_903_cov_58.723881	439	519	16	4	80	0.0500000
NODE_8773_length_903_cov_58.723881	439	519	18	16	80	0.2000000
NODE_8773_length_903_cov_58.723881	439	519	20	21	80	0.2625000
NODE_8773_length_903_cov_58.723881	439	519	22	1	80	0.0125000
NODE_8773_length_903_cov_58.723881	439	519	26	9	80	0.1125000
NODE_8773_length_903_cov_58.723881	439	519	28	6	80	0.0750000
NODE_8773_length_903_cov_58.723881	439	519	30	9	80	0.1125000
NODE_8773_length_903_cov_58.723881	439	519	32	11	80	0.1375000
NODE_8773_length_903_cov_58.723881	515	595	10	41	80	0.5125000
NODE_8773_length_903_cov_58.723881	515	595	18	10	80	0.1250000
NODE_8773_length_903_cov_58.723881	515	595	20	20	80	0.2500000
NODE_8773_length_903_cov_58.723881	515	595	22	9	80	0.1125000
NODE_8773_length_903_cov_58.723881	568	648	2	7	80	0.0875000
NODE_8773_length_903_cov_58.723881	568	648	6	8	80	0.1000000
NODE_8773_length_903_cov_58.723881	568	648	8	22	80	0.2750000
NODE_8773_length_903_cov_58.723881	568	648	10	43	80	0.5375000
NODE_8774_length_903_cov_41.298507	397	477	0	48	80	0.6000000
NODE_8774_length_903_cov_41.298507	397	477	4	2	80	0.0250000
NODE_8774_length_903_cov_41.298507	397	477	6	30	80	0.3750000
NODE_8774_length_903_cov_41.298507	450	530	0	50	80	0.6250000
NODE_8774_length_903_cov_41.298507	450	530	2	30	80	0.3750000
NODE_8775_length_903_cov_28.691542	394	474	3	25	80	0.3125000
NODE_8775_length_903_cov_28.691542	394	474	4	55	80	0.6875000
NODE_8775_length_903_cov_28.691542	447	527	0	9	80	0.1125000
NODE_8775_length_903_cov_28.691542	447	527	3	1	80	0.0125000
NODE_8775_length_903_cov_28.691542	447	527	4	70	80	0.8750000
NODE_8776_length_903_cov_26.276119	441	521	2	14	80	0.1750000
NODE_8776_length_903_cov_26.276119	441	521	4	46	80	0.5750000
NODE_8776_length_903_cov_26.276119	441	521	6	20	80	0.2500000
NODE_8776_length_903_cov_26.276119	494	574	0	30	80	0.3750000
NODE_8776_length_903_cov_26.276119	494	574	2	37	80	0.4625000
NODE_8776_length_903_cov_26.276119	494	574	4	13	80	0.1625000
NODE_8778_length_903_cov_18.166667	351	431	0	80	80	1.0000000
NODE_8778_length_903_cov_18.166667	404	484	0	80	80	1.0000000
NODE_8779_length_903_cov_15.460199	440	520	0	80	80	1.0000000
NODE_8779_length_903_cov_15.460199	493	573	0	80	80	1.0000000
NODE_8780_length_903_cov_15.084577	352	432	0	13	80	0.1625000
NODE_8780_length_903_cov_15.084577	352	432	4	67	80	0.8375000
NODE_8780_length_903_cov_15.084577	405	485	0	66	80	0.8250000
NODE_8780_length_903_cov_15.084577	405	485	4	14	80	0.1750000
NODE_8781_length_903_cov_15.070896	367	447	0	23	80	0.2875000
NODE_8781_length_903_cov_15.070896	367	447	2	5	80	0.0625000
NODE_8781_length_903_cov_15.070896	367	447	4	52	80	0.6500000
NODE_8781_length_903_cov_15.070896	420	500	0	31	80	0.3875000
NODE_8781_length_903_cov_15.070896	420	500	2	9	80	0.1125000
NODE_8781_length_903_cov_15.070896	420	500	4	40	80	0.5000000
NODE_8782_length_903_cov_14.004975	318	399	2	7	81	0.0864198
NODE_8782_length_903_cov_14.004975	318	399	6	52	81	0.6419753
NODE_8782_length_903_cov_14.004975	318	399	8	22	81	0.2716049
NODE_8782_length_903_cov_14.004975	372	452	2	2	80	0.0250000
NODE_8782_length_903_cov_14.004975	372	452	6	69	80	0.8625000
NODE_8782_length_903_cov_14.004975	372	452	8	9	80	0.1125000
NODE_8783_length_903_cov_10.546020	150	230	0	11	80	0.1375000
NODE_8783_length_903_cov_10.546020	150	230	2	50	80	0.6250000
NODE_8783_length_903_cov_10.546020	150	230	4	19	80	0.2375000
NODE_8783_length_903_cov_10.546020	203	283	0	11	80	0.1375000
NODE_8783_length_903_cov_10.546020	203	283	2	63	80	0.7875000
NODE_8783_length_903_cov_10.546020	203	283	6	6	80	0.0750000
NODE_8784_length_903_cov_9.288557	373	453	0	80	80	1.0000000
NODE_8784_length_903_cov_9.288557	426	506	0	80	80	1.0000000
NODE_8785_length_903_cov_8.052239	439	519	0	80	80	1.0000000
NODE_8785_length_903_cov_8.052239	492	572	0	80	80	1.0000000
NODE_8798_length_902_cov_64.459527	355	435	0	13	80	0.1625000
NODE_8798_length_902_cov_64.459527	355	435	1	5	80	0.0625000
NODE_8798_length_902_cov_64.459527	355	435	2	62	80	0.7750000
NODE_8798_length_902_cov_64.459527	408	488	0	48	80	0.6000000
NODE_8798_length_902_cov_64.459527	408	488	1	10	80	0.1250000
NODE_8798_length_902_cov_64.459527	408	488	2	22	80	0.2750000
NODE_8798_length_902_cov_64.459527	484	564	0	10	80	0.1250000
NODE_8798_length_902_cov_64.459527	484	564	4	70	80	0.8750000
NODE_8798_length_902_cov_64.459527	537	617	0	40	80	0.5000000
NODE_8798_length_902_cov_64.459527	537	617	4	40	80	0.5000000
NODE_8799_length_902_cov_60.823163	395	475	0	25	80	0.3125000
NODE_8799_length_902_cov_60.823163	395	475	2	55	80	0.6875000
NODE_8799_length_902_cov_60.823163	448	528	0	35	80	0.4375000
NODE_8799_length_902_cov_60.823163	448	528	2	45	80	0.5625000
NODE_8800_length_902_cov_44.002491	383	463	6	24	80	0.3000000
NODE_8800_length_902_cov_44.002491	383	463	8	36	80	0.4500000
NODE_8800_length_902_cov_44.002491	383	463	10	20	80	0.2500000
NODE_8800_length_902_cov_44.002491	436	516	2	1	80	0.0125000
NODE_8800_length_902_cov_44.002491	436	516	4	38	80	0.4750000
NODE_8800_length_902_cov_44.002491	436	516	8	7	80	0.0875000
NODE_8800_length_902_cov_44.002491	436	516	10	34	80	0.4250000
NODE_8801_length_902_cov_41.059776	378	458	8	16	80	0.2000000
NODE_8801_length_902_cov_41.059776	378	458	14	1	80	0.0125000
NODE_8801_length_902_cov_41.059776	378	458	15	42	80	0.5250000
NODE_8801_length_902_cov_41.059776	378	458	17	3	80	0.0375000
NODE_8801_length_902_cov_41.059776	378	458	18	18	80	0.2250000
NODE_8801_length_902_cov_41.059776	431	511	2	5	80	0.0625000
NODE_8801_length_902_cov_41.059776	431	511	10	41	80	0.5125000
NODE_8801_length_902_cov_41.059776	431	511	15	6	80	0.0750000
NODE_8801_length_902_cov_41.059776	431	511	17	3	80	0.0375000
NODE_8801_length_902_cov_41.059776	431	511	18	25	80	0.3125000
NODE_8802_length_902_cov_38.952677	372	452	0	16	80	0.2000000
NODE_8802_length_902_cov_38.952677	372	452	2	58	80	0.7250000
NODE_8802_length_902_cov_38.952677	372	452	4	6	80	0.0750000
NODE_8802_length_902_cov_38.952677	425	505	2	34	80	0.4250000
NODE_8802_length_902_cov_38.952677	425	505	4	46	80	0.5750000
NODE_8803_length_902_cov_34.156912	373	453	0	80	80	1.0000000
NODE_8803_length_902_cov_34.156912	426	506	0	80	80	1.0000000
NODE_8804_length_902_cov_23.007472	295	375	0	62	80	0.7750000
NODE_8804_length_902_cov_23.007472	295	375	4	9	80	0.1125000
NODE_8804_length_902_cov_23.007472	295	375	6	9	80	0.1125000
NODE_8804_length_902_cov_23.007472	348	428	0	9	80	0.1125000
NODE_8804_length_902_cov_23.007472	348	428	4	9	80	0.1125000
NODE_8804_length_902_cov_23.007472	348	428	6	62	80	0.7750000
NODE_8805_length_902_cov_19.491905	238	291	0	7	53	0.1320755
NODE_8805_length_902_cov_19.491905	238	291	2	4	53	0.0754717
NODE_8805_length_902_cov_19.491905	238	291	8	23	53	0.4339623
NODE_8805_length_902_cov_19.491905	238	291	10	18	53	0.3396226
NODE_8805_length_902_cov_19.491905	238	291	14	1	53	0.0188679
NODE_8805_length_902_cov_19.491905	264	344	4	3	80	0.0375000
NODE_8805_length_902_cov_19.491905	264	344	6	2	80	0.0250000
NODE_8805_length_902_cov_19.491905	264	344	8	8	80	0.1000000
NODE_8805_length_902_cov_19.491905	264	344	10	18	80	0.2250000
NODE_8805_length_902_cov_19.491905	264	344	12	24	80	0.3000000
NODE_8805_length_902_cov_19.491905	264	344	14	25	80	0.3125000
NODE_8806_length_902_cov_10.794521	214	294	0	12	80	0.1500000
NODE_8806_length_902_cov_10.794521	214	294	2	68	80	0.8500000
NODE_8806_length_902_cov_10.794521	267	347	0	55	80	0.6875000
NODE_8806_length_902_cov_10.794521	267	347	2	25	80	0.3125000
NODE_8807_length_902_cov_9.520548	518	598	0	21	80	0.2625000
NODE_8807_length_902_cov_9.520548	518	598	2	59	80	0.7375000
NODE_8807_length_902_cov_9.520548	571	651	2	30	80	0.3750000
NODE_8807_length_902_cov_9.520548	571	651	4	50	80	0.6250000
NODE_8808_length_902_cov_8.323786	337	417	0	80	80	1.0000000
NODE_8808_length_902_cov_8.323786	390	470	0	80	80	1.0000000
NODE_8811_length_902_cov_7.300125	434	514	0	80	80	1.0000000
NODE_8811_length_902_cov_7.300125	487	567	0	80	80	1.0000000
NODE_8812_length_902_cov_4.185554	505	585	0	80	80	1.0000000
NODE_8812_length_902_cov_4.185554	558	588	0	30	30	1.0000000
NODE_8812_length_902_cov_4.185554	610	662	4	52	52	1.0000000
NODE_8830_length_902_cov_0.963885	82	106	0	24	24	1.0000000
NODE_8832_length_901_cov_36.066085	412	490	0	6	78	0.0769231
NODE_8832_length_901_cov_36.066085	412	490	2	72	78	0.9230769
NODE_8832_length_901_cov_36.066085	463	543	0	15	80	0.1875000
NODE_8832_length_901_cov_36.066085	463	543	2	65	80	0.8125000
NODE_8833_length_901_cov_28.129676	377	457	2	11	80	0.1375000
NODE_8833_length_901_cov_28.129676	377	457	8	18	80	0.2250000
NODE_8833_length_901_cov_28.129676	377	457	10	51	80	0.6375000
NODE_8833_length_901_cov_28.129676	430	510	0	53	80	0.6625000
NODE_8833_length_901_cov_28.129676	430	510	2	11	80	0.1375000
NODE_8833_length_901_cov_28.129676	430	510	10	16	80	0.2000000
NODE_8834_length_901_cov_26.763092	272	352	2	23	80	0.2875000
NODE_8834_length_901_cov_26.763092	272	352	4	57	80	0.7125000
NODE_8834_length_901_cov_26.763092	325	405	0	33	80	0.4125000
NODE_8834_length_901_cov_26.763092	325	405	2	43	80	0.5375000
NODE_8834_length_901_cov_26.763092	325	405	4	4	80	0.0500000
NODE_8834_length_901_cov_26.763092	401	481	0	26	80	0.3250000
NODE_8834_length_901_cov_26.763092	401	481	2	54	80	0.6750000
NODE_8834_length_901_cov_26.763092	454	534	0	29	80	0.3625000
NODE_8834_length_901_cov_26.763092	454	534	2	51	80	0.6375000
NODE_8835_length_901_cov_25.628429	369	449	0	23	80	0.2875000
NODE_8835_length_901_cov_25.628429	369	449	2	18	80	0.2250000
NODE_8835_length_901_cov_25.628429	369	449	4	39	80	0.4875000
NODE_8835_length_901_cov_25.628429	422	502	0	19	80	0.2375000
NODE_8835_length_901_cov_25.628429	422	502	4	61	80	0.7625000
NODE_8836_length_901_cov_17.857855	408	488	2	80	80	1.0000000
NODE_8836_length_901_cov_17.857855	461	541	0	20	80	0.2500000
NODE_8836_length_901_cov_17.857855	461	541	1	14	80	0.1750000
NODE_8836_length_901_cov_17.857855	461	541	2	46	80	0.5750000
NODE_8837_length_901_cov_16.254364	362	442	0	8	80	0.1000000
NODE_8837_length_901_cov_16.254364	362	442	2	72	80	0.9000000
NODE_8837_length_901_cov_16.254364	415	495	0	61	80	0.7625000
NODE_8837_length_901_cov_16.254364	415	495	2	19	80	0.2375000
NODE_8838_length_901_cov_8.346633	321	401	0	57	80	0.7125000
NODE_8838_length_901_cov_8.346633	321	401	2	23	80	0.2875000
NODE_8838_length_901_cov_8.346633	374	454	0	80	80	1.0000000
NODE_8840_length_901_cov_6.044888	363	443	0	43	80	0.5375000
NODE_8840_length_901_cov_6.044888	363	443	2	37	80	0.4625000
NODE_8840_length_901_cov_6.044888	416	496	2	80	80	1.0000000
NODE_8845_length_901_cov_3.814214	194	274	0	80	80	1.0000000
NODE_8845_length_901_cov_3.814214	247	326	0	79	79	1.0000000
NODE_8857_length_900_cov_30.284644	407	487	0	80	80	1.0000000
NODE_8857_length_900_cov_30.284644	460	540	0	80	80	1.0000000
NODE_8858_length_900_cov_29.679151	425	505	0	80	80	1.0000000
NODE_8858_length_900_cov_29.679151	478	558	0	80	80	1.0000000
NODE_8859_length_900_cov_25.963795	321	401	0	9	80	0.1125000
NODE_8859_length_900_cov_25.963795	321	401	2	71	80	0.8875000
NODE_8859_length_900_cov_25.963795	374	454	0	42	80	0.5250000
NODE_8859_length_900_cov_25.963795	374	454	2	38	80	0.4750000
NODE_8860_length_900_cov_17.681648	530	606	0	76	76	1.0000000
NODE_8860_length_900_cov_17.681648	583	659	0	35	76	0.4605263
NODE_8860_length_900_cov_17.681648	583	659	2	41	76	0.5394737
NODE_8861_length_900_cov_16.294632	316	396	0	24	80	0.3000000
NODE_8861_length_900_cov_16.294632	316	396	2	56	80	0.7000000
NODE_8861_length_900_cov_16.294632	369	449	0	63	80	0.7875000
NODE_8861_length_900_cov_16.294632	369	449	2	3	80	0.0375000
NODE_8861_length_900_cov_16.294632	369	449	4	14	80	0.1750000
NODE_8863_length_900_cov_5.962547	0	70	7	2	70	0.0285714
NODE_8863_length_900_cov_5.962547	0	70	9	1	70	0.0142857
NODE_8863_length_900_cov_5.962547	0	70	19	1	70	0.0142857
NODE_8863_length_900_cov_5.962547	0	70	24	1	70	0.0142857
NODE_8863_length_900_cov_5.962547	0	70	28	12	70	0.1714286
NODE_8863_length_900_cov_5.962547	0	70	30	9	70	0.1285714
NODE_8863_length_900_cov_5.962547	0	70	36	7	70	0.1000000
NODE_8863_length_900_cov_5.962547	0	70	38	9	70	0.1285714
NODE_8863_length_900_cov_5.962547	0	70	42	28	70	0.4000000
NODE_8863_length_900_cov_5.962547	43	108	24	1	65	0.0153846
NODE_8863_length_900_cov_5.962547	43	108	26	2	65	0.0307692
NODE_8863_length_900_cov_5.962547	43	108	38	1	65	0.0153846
NODE_8863_length_900_cov_5.962547	43	108	40	1	65	0.0153846
NODE_8863_length_900_cov_5.962547	43	108	42	60	65	0.9230769
NODE_8870_length_900_cov_2.521848	85	165	0	80	80	1.0000000
NODE_8870_length_900_cov_2.521848	138	218	0	47	80	0.5875000
NODE_8870_length_900_cov_2.521848	138	218	1	4	80	0.0500000
NODE_8870_length_900_cov_2.521848	138	218	2	29	80	0.3625000
NODE_8879_length_899_cov_45.853750	380	460	0	19	80	0.2375000
NODE_8879_length_899_cov_45.853750	380	460	3	2	80	0.0250000
NODE_8879_length_899_cov_45.853750	380	460	4	59	80	0.7375000
NODE_8879_length_899_cov_45.853750	433	516	0	75	83	0.9036145
NODE_8879_length_899_cov_45.853750	433	516	3	2	83	0.0240964
NODE_8879_length_899_cov_45.853750	433	516	4	6	83	0.0722892
NODE_8880_length_899_cov_37.758750	381	461	4	55	80	0.6875000
NODE_8880_length_899_cov_37.758750	381	461	6	25	80	0.3125000
NODE_8880_length_899_cov_37.758750	434	514	0	34	80	0.4250000
NODE_8880_length_899_cov_37.758750	434	514	4	46	80	0.5750000
NODE_8881_length_899_cov_27.362500	413	493	2	15	80	0.1875000
NODE_8881_length_899_cov_27.362500	413	493	4	11	80	0.1375000
NODE_8881_length_899_cov_27.362500	413	493	6	5	80	0.0625000
NODE_8881_length_899_cov_27.362500	413	493	8	7	80	0.0875000
NODE_8881_length_899_cov_27.362500	413	493	10	7	80	0.0875000
NODE_8881_length_899_cov_27.362500	413	493	12	2	80	0.0250000
NODE_8881_length_899_cov_27.362500	413	493	14	18	80	0.2250000
NODE_8881_length_899_cov_27.362500	413	493	16	15	80	0.1875000
NODE_8881_length_899_cov_27.362500	466	546	2	11	80	0.1375000
NODE_8881_length_899_cov_27.362500	466	546	4	64	80	0.8000000
NODE_8881_length_899_cov_27.362500	466	546	6	5	80	0.0625000
NODE_8882_length_899_cov_20.563750	379	459	0	10	80	0.1250000
NODE_8882_length_899_cov_20.563750	379	459	2	25	80	0.3125000
NODE_8882_length_899_cov_20.563750	379	459	4	45	80	0.5625000
NODE_8882_length_899_cov_20.563750	432	507	0	38	75	0.5066667
NODE_8882_length_899_cov_20.563750	432	507	2	35	75	0.4666667
NODE_8882_length_899_cov_20.563750	432	507	4	2	75	0.0266667
NODE_8884_length_899_cov_17.130000	319	399	0	80	80	1.0000000
NODE_8884_length_899_cov_17.130000	372	452	0	80	80	1.0000000
NODE_8885_length_899_cov_16.317500	270	350	0	13	80	0.1625000
NODE_8885_length_899_cov_16.317500	270	350	1	1	80	0.0125000
NODE_8885_length_899_cov_16.317500	270	350	5	51	80	0.6375000
NODE_8885_length_899_cov_16.317500	270	350	7	15	80	0.1875000
NODE_8885_length_899_cov_16.317500	323	403	3	15	80	0.1875000
NODE_8885_length_899_cov_16.317500	323	403	5	12	80	0.1500000
NODE_8885_length_899_cov_16.317500	323	403	7	53	80	0.6625000
NODE_8886_length_899_cov_16.190000	284	364	0	80	80	1.0000000
NODE_8886_length_899_cov_16.190000	337	417	0	80	80	1.0000000
NODE_8887_length_899_cov_13.873750	317	397	0	80	80	1.0000000
NODE_8887_length_899_cov_13.873750	370	450	0	80	80	1.0000000
NODE_8888_length_899_cov_12.957500	240	320	0	6	80	0.0750000
NODE_8888_length_899_cov_12.957500	240	320	2	3	80	0.0375000
NODE_8888_length_899_cov_12.957500	240	320	4	5	80	0.0625000
NODE_8888_length_899_cov_12.957500	240	320	8	66	80	0.8250000
NODE_8888_length_899_cov_12.957500	293	373	0	27	80	0.3375000
NODE_8888_length_899_cov_12.957500	293	373	4	3	80	0.0375000
NODE_8888_length_899_cov_12.957500	293	373	6	22	80	0.2750000
NODE_8888_length_899_cov_12.957500	293	373	8	28	80	0.3500000
NODE_8889_length_899_cov_12.516250	387	467	0	80	80	1.0000000
NODE_8889_length_899_cov_12.516250	440	520	0	80	80	1.0000000
NODE_8890_length_899_cov_10.846250	348	428	0	26	80	0.3250000
NODE_8890_length_899_cov_10.846250	348	428	2	54	80	0.6750000
NODE_8890_length_899_cov_10.846250	401	485	0	36	84	0.4285714
NODE_8890_length_899_cov_10.846250	401	485	2	48	84	0.5714286
NODE_8891_length_899_cov_9.185000	347	427	0	80	80	1.0000000
NODE_8891_length_899_cov_9.185000	400	480	0	80	80	1.0000000
NODE_8892_length_899_cov_8.655000	498	578	0	80	80	1.0000000
NODE_8892_length_899_cov_8.655000	551	631	0	80	80	1.0000000
NODE_8893_length_899_cov_3.551250	0	54	1	2	54	0.0370370
NODE_8893_length_899_cov_3.551250	0	54	2	10	54	0.1851852
NODE_8893_length_899_cov_3.551250	0	54	8	9	54	0.1666667
NODE_8893_length_899_cov_3.551250	0	54	10	1	54	0.0185185
NODE_8893_length_899_cov_3.551250	0	54	14	3	54	0.0555556
NODE_8893_length_899_cov_3.551250	0	54	16	4	54	0.0740741
NODE_8893_length_899_cov_3.551250	0	54	18	2	54	0.0370370
NODE_8893_length_899_cov_3.551250	0	54	22	1	54	0.0185185
NODE_8893_length_899_cov_3.551250	0	54	29	1	54	0.0185185
NODE_8893_length_899_cov_3.551250	0	54	31	1	54	0.0185185
NODE_8893_length_899_cov_3.551250	0	54	33	14	54	0.2592593
NODE_8893_length_899_cov_3.551250	0	54	35	1	54	0.0185185
NODE_8893_length_899_cov_3.551250	0	54	37	5	54	0.0925926
NODE_8893_length_899_cov_3.551250	27	107	16	2	80	0.0250000
NODE_8893_length_899_cov_3.551250	27	107	18	2	80	0.0250000
NODE_8893_length_899_cov_3.551250	27	107	22	1	80	0.0125000
NODE_8893_length_899_cov_3.551250	27	107	29	1	80	0.0125000
NODE_8893_length_899_cov_3.551250	27	107	31	1	80	0.0125000
NODE_8893_length_899_cov_3.551250	27	107	33	14	80	0.1750000
NODE_8893_length_899_cov_3.551250	27	107	35	4	80	0.0500000
NODE_8893_length_899_cov_3.551250	27	107	37	6	80	0.0750000
NODE_8893_length_899_cov_3.551250	27	107	39	3	80	0.0375000
NODE_8893_length_899_cov_3.551250	27	107	41	46	80	0.5750000
NODE_8893_length_899_cov_3.551250	103	183	6	11	80	0.1375000
NODE_8893_length_899_cov_3.551250	103	183	8	9	80	0.1125000
NODE_8893_length_899_cov_3.551250	103	183	15	3	80	0.0375000
NODE_8893_length_899_cov_3.551250	103	183	17	6	80	0.0750000
NODE_8893_length_899_cov_3.551250	103	183	19	2	80	0.0250000
NODE_8893_length_899_cov_3.551250	103	183	26	2	80	0.0250000
NODE_8893_length_899_cov_3.551250	103	183	30	7	80	0.0875000
NODE_8893_length_899_cov_3.551250	103	183	31	8	80	0.1000000
NODE_8893_length_899_cov_3.551250	103	183	33	6	80	0.0750000
NODE_8893_length_899_cov_3.551250	103	183	34	7	80	0.0875000
NODE_8893_length_899_cov_3.551250	103	183	35	9	80	0.1125000
NODE_8893_length_899_cov_3.551250	103	183	36	9	80	0.1125000
NODE_8893_length_899_cov_3.551250	103	183	41	1	80	0.0125000
NODE_8893_length_899_cov_3.551250	156	179	6	7	23	0.3043478
NODE_8893_length_899_cov_3.551250	156	179	8	9	23	0.3913043
NODE_8893_length_899_cov_3.551250	156	179	15	3	23	0.1304348
NODE_8893_length_899_cov_3.551250	156	179	17	4	23	0.1739130
NODE_8914_length_898_cov_52.405507	299	379	0	14	80	0.1750000
NODE_8914_length_898_cov_52.405507	299	379	2	15	80	0.1875000
NODE_8914_length_898_cov_52.405507	299	379	4	51	80	0.6375000
NODE_8914_length_898_cov_52.405507	352	432	0	67	80	0.8375000
NODE_8914_length_898_cov_52.405507	352	432	2	13	80	0.1625000
NODE_8914_length_898_cov_52.405507	428	508	0	80	80	1.0000000
NODE_8914_length_898_cov_52.405507	481	561	0	80	80	1.0000000
NODE_8915_length_898_cov_44.973717	363	443	0	1	80	0.0125000
NODE_8915_length_898_cov_44.973717	363	443	2	79	80	0.9875000
NODE_8915_length_898_cov_44.973717	416	496	0	1	80	0.0125000
NODE_8915_length_898_cov_44.973717	416	496	2	79	80	0.9875000
NODE_8916_length_898_cov_38.269086	425	505	0	2	80	0.0250000
NODE_8916_length_898_cov_38.269086	425	505	2	65	80	0.8125000
NODE_8916_length_898_cov_38.269086	425	505	4	13	80	0.1625000
NODE_8916_length_898_cov_38.269086	478	558	0	2	80	0.0250000
NODE_8916_length_898_cov_38.269086	478	558	2	78	80	0.9750000
NODE_8917_length_898_cov_27.006258	465	545	0	4	80	0.0500000
NODE_8917_length_898_cov_27.006258	465	545	2	42	80	0.5250000
NODE_8917_length_898_cov_27.006258	465	545	8	32	80	0.4000000
NODE_8917_length_898_cov_27.006258	465	545	12	2	80	0.0250000
NODE_8917_length_898_cov_27.006258	518	598	8	25	80	0.3125000
NODE_8917_length_898_cov_27.006258	518	598	10	7	80	0.0875000
NODE_8917_length_898_cov_27.006258	518	598	12	48	80	0.6000000
NODE_8918_length_898_cov_25.902378	185	265	4	80	80	1.0000000
NODE_8918_length_898_cov_25.902378	238	318	0	35	80	0.4375000
NODE_8918_length_898_cov_25.902378	238	318	2	10	80	0.1250000
NODE_8918_length_898_cov_25.902378	238	318	4	35	80	0.4375000
NODE_8918_length_898_cov_25.902378	314	394	0	26	80	0.3250000
NODE_8918_length_898_cov_25.902378	314	394	2	41	80	0.5125000
NODE_8918_length_898_cov_25.902378	314	394	4	13	80	0.1625000
NODE_8918_length_898_cov_25.902378	367	447	2	24	80	0.3000000
NODE_8918_length_898_cov_25.902378	367	447	4	56	80	0.7000000
NODE_8919_length_898_cov_25.209011	368	448	2	52	80	0.6500000
NODE_8919_length_898_cov_25.209011	368	448	8	28	80	0.3500000
NODE_8919_length_898_cov_25.209011	421	501	6	42	80	0.5250000
NODE_8919_length_898_cov_25.209011	421	501	8	32	80	0.4000000
NODE_8919_length_898_cov_25.209011	421	501	16	6	80	0.0750000
NODE_8920_length_898_cov_21.923655	325	405	0	42	80	0.5250000
NODE_8920_length_898_cov_21.923655	325	405	2	38	80	0.4750000
NODE_8920_length_898_cov_21.923655	378	458	2	80	80	1.0000000
NODE_8921_length_898_cov_21.065081	306	386	0	7	80	0.0875000
NODE_8921_length_898_cov_21.065081	306	386	2	46	80	0.5750000
NODE_8921_length_898_cov_21.065081	306	386	4	27	80	0.3375000
NODE_8921_length_898_cov_21.065081	359	439	4	43	80	0.5375000
NODE_8921_length_898_cov_21.065081	359	439	6	37	80	0.4625000
NODE_8922_length_898_cov_20.954944	374	454	0	80	80	1.0000000
NODE_8922_length_898_cov_20.954944	427	507	0	80	80	1.0000000
NODE_8923_length_898_cov_17.387985	398	478	0	9	80	0.1125000
NODE_8923_length_898_cov_17.387985	398	478	2	71	80	0.8875000
NODE_8923_length_898_cov_17.387985	451	531	0	43	80	0.5375000
NODE_8923_length_898_cov_17.387985	451	531	2	37	80	0.4625000
NODE_8924_length_898_cov_17.252816	265	345	0	80	80	1.0000000
NODE_8924_length_898_cov_17.252816	318	398	0	80	80	1.0000000
NODE_8926_length_898_cov_13.152691	455	535	0	13	80	0.1625000
NODE_8926_length_898_cov_13.152691	455	535	2	67	80	0.8375000
NODE_8926_length_898_cov_13.152691	508	588	0	7	80	0.0875000
NODE_8926_length_898_cov_13.152691	508	588	2	73	80	0.9125000
NODE_8927_length_898_cov_12.612015	375	455	2	59	80	0.7375000
NODE_8927_length_898_cov_12.612015	375	455	6	21	80	0.2625000
NODE_8927_length_898_cov_12.612015	428	508	0	28	80	0.3500000
NODE_8927_length_898_cov_12.612015	428	508	1	23	80	0.2875000
NODE_8927_length_898_cov_12.612015	428	508	2	29	80	0.3625000
NODE_8928_length_898_cov_12.498123	428	508	0	12	80	0.1500000
NODE_8928_length_898_cov_12.498123	428	508	2	68	80	0.8500000
NODE_8928_length_898_cov_12.498123	481	561	0	23	80	0.2875000
NODE_8928_length_898_cov_12.498123	481	561	2	57	80	0.7125000
NODE_8932_length_898_cov_1.790989	0	56	0	56	56	1.0000000
NODE_8932_length_898_cov_1.790989	29	93	0	62	64	0.9687500
NODE_8932_length_898_cov_1.790989	29	93	6	2	64	0.0312500
NODE_8944_length_897_cov_63.921053	350	430	0	20	80	0.2500000
NODE_8944_length_897_cov_63.921053	350	430	2	45	80	0.5625000
NODE_8944_length_897_cov_63.921053	350	430	4	15	80	0.1875000
NODE_8944_length_897_cov_63.921053	403	483	0	73	80	0.9125000
NODE_8944_length_897_cov_63.921053	403	483	2	7	80	0.0875000
NODE_8945_length_897_cov_58.921053	316	396	26	28	80	0.3500000
NODE_8945_length_897_cov_58.921053	316	396	27	31	80	0.3875000
NODE_8945_length_897_cov_58.921053	316	396	28	21	80	0.2625000
NODE_8945_length_897_cov_58.921053	369	449	2	27	80	0.3375000
NODE_8945_length_897_cov_58.921053	369	449	15	3	80	0.0375000
NODE_8945_length_897_cov_58.921053	369	449	26	1	80	0.0125000
NODE_8945_length_897_cov_58.921053	369	449	27	34	80	0.4250000
NODE_8945_length_897_cov_58.921053	369	449	28	15	80	0.1875000
NODE_8946_length_897_cov_35.946115	324	404	0	9	80	0.1125000
NODE_8946_length_897_cov_35.946115	324	404	2	28	80	0.3500000
NODE_8946_length_897_cov_35.946115	324	404	5	1	80	0.0125000
NODE_8946_length_897_cov_35.946115	324	404	6	42	80	0.5250000
NODE_8946_length_897_cov_35.946115	377	457	0	62	80	0.7750000
NODE_8946_length_897_cov_35.946115	377	457	2	18	80	0.2250000
NODE_8947_length_897_cov_25.548872	238	318	0	13	80	0.1625000
NODE_8947_length_897_cov_25.548872	238	318	2	67	80	0.8375000
NODE_8947_length_897_cov_25.548872	291	371	0	54	80	0.6750000
NODE_8947_length_897_cov_25.548872	291	371	2	26	80	0.3250000
NODE_8948_length_897_cov_24.913534	399	479	0	59	80	0.7375000
NODE_8948_length_897_cov_24.913534	399	479	2	21	80	0.2625000
NODE_8948_length_897_cov_24.913534	452	532	0	6	80	0.0750000
NODE_8948_length_897_cov_24.913534	452	532	2	74	80	0.9250000
NODE_8949_length_897_cov_21.839599	308	388	0	78	80	0.9750000
NODE_8949_length_897_cov_21.839599	308	388	2	2	80	0.0250000
NODE_8949_length_897_cov_21.839599	361	441	0	25	80	0.3125000
NODE_8949_length_897_cov_21.839599	361	441	2	55	80	0.6875000
NODE_8950_length_897_cov_19.355890	489	569	0	26	80	0.3250000
NODE_8950_length_897_cov_19.355890	489	569	8	54	80	0.6750000
NODE_8950_length_897_cov_19.355890	542	622	0	17	80	0.2125000
NODE_8950_length_897_cov_19.355890	542	622	8	63	80	0.7875000
NODE_8951_length_897_cov_16.295739	209	289	0	80	80	1.0000000
NODE_8951_length_897_cov_16.295739	262	342	0	37	80	0.4625000
NODE_8951_length_897_cov_16.295739	262	342	4	43	80	0.5375000
NODE_8952_length_897_cov_14.766917	395	475	0	10	80	0.1250000
NODE_8952_length_897_cov_14.766917	395	475	2	70	80	0.8750000
NODE_8952_length_897_cov_14.766917	448	528	0	58	80	0.7250000
NODE_8952_length_897_cov_14.766917	448	528	2	22	80	0.2750000
NODE_8953_length_897_cov_14.219298	253	333	0	80	80	1.0000000
NODE_8953_length_897_cov_14.219298	306	386	0	80	80	1.0000000
NODE_8954_length_897_cov_11.116541	182	262	0	25	80	0.3125000
NODE_8954_length_897_cov_11.116541	182	262	2	55	80	0.6875000
NODE_8954_length_897_cov_11.116541	235	315	0	1	80	0.0125000
NODE_8954_length_897_cov_11.116541	235	315	2	79	80	0.9875000
NODE_8955_length_897_cov_8.211779	303	383	0	17	80	0.2125000
NODE_8955_length_897_cov_8.211779	303	383	2	63	80	0.7875000
NODE_8955_length_897_cov_8.211779	356	436	0	70	80	0.8750000
NODE_8955_length_897_cov_8.211779	356	436	2	10	80	0.1250000
NODE_8973_length_896_cov_48.249686	397	477	0	80	80	1.0000000
NODE_8973_length_896_cov_48.249686	450	530	0	80	80	1.0000000
NODE_8974_length_896_cov_24.824341	213	293	0	13	80	0.1625000
NODE_8974_length_896_cov_24.824341	213	293	2	67	80	0.8375000
NODE_8974_length_896_cov_24.824341	266	346	0	65	80	0.8125000
NODE_8974_length_896_cov_24.824341	266	346	2	15	80	0.1875000
NODE_8975_length_896_cov_23.130489	333	413	0	4	80	0.0500000
NODE_8975_length_896_cov_23.130489	333	413	2	76	80	0.9500000
NODE_8975_length_896_cov_23.130489	386	466	0	40	80	0.5000000
NODE_8975_length_896_cov_23.130489	386	466	2	40	80	0.5000000
NODE_8975_length_896_cov_23.130489	462	542	0	53	80	0.6625000
NODE_8975_length_896_cov_23.130489	462	542	2	27	80	0.3375000
NODE_8975_length_896_cov_23.130489	515	595	2	80	80	1.0000000
NODE_8976_length_896_cov_20.673777	361	441	6	19	80	0.2375000
NODE_8976_length_896_cov_20.673777	361	441	10	4	80	0.0500000
NODE_8976_length_896_cov_20.673777	361	441	16	14	80	0.1750000
NODE_8976_length_896_cov_20.673777	361	441	18	3	80	0.0375000
NODE_8976_length_896_cov_20.673777	361	441	20	40	80	0.5000000
NODE_8976_length_896_cov_20.673777	414	497	0	33	83	0.3975904
NODE_8976_length_896_cov_20.673777	414	497	14	22	83	0.2650602
NODE_8976_length_896_cov_20.673777	414	497	16	15	83	0.1807229
NODE_8976_length_896_cov_20.673777	414	497	20	13	83	0.1566265
NODE_8977_length_896_cov_18.979925	418	498	0	9	80	0.1125000
NODE_8977_length_896_cov_18.979925	418	498	4	21	80	0.2625000
NODE_8977_length_896_cov_18.979925	418	498	7	2	80	0.0250000
NODE_8977_length_896_cov_18.979925	418	498	8	48	80	0.6000000
NODE_8977_length_896_cov_18.979925	471	551	0	2	80	0.0250000
NODE_8977_length_896_cov_18.979925	471	551	3	1	80	0.0125000
NODE_8977_length_896_cov_18.979925	471	551	4	38	80	0.4750000
NODE_8977_length_896_cov_18.979925	471	551	8	39	80	0.4875000
NODE_8978_length_896_cov_15.875784	340	420	2	36	80	0.4500000
NODE_8978_length_896_cov_15.875784	340	420	6	20	80	0.2500000
NODE_8978_length_896_cov_15.875784	340	420	9	24	80	0.3000000
NODE_8978_length_896_cov_15.875784	393	473	6	3	80	0.0375000
NODE_8978_length_896_cov_15.875784	393	473	9	36	80	0.4500000
NODE_8978_length_896_cov_15.875784	393	473	10	2	80	0.0250000
NODE_8978_length_896_cov_15.875784	393	473	13	9	80	0.1125000
NODE_8978_length_896_cov_15.875784	393	473	14	24	80	0.3000000
NODE_8978_length_896_cov_15.875784	393	473	15	6	80	0.0750000
NODE_8980_length_896_cov_10.646173	337	417	0	80	80	1.0000000
NODE_8980_length_896_cov_10.646173	390	470	0	78	80	0.9750000
NODE_8980_length_896_cov_10.646173	390	470	2	2	80	0.0250000
NODE_8981_length_896_cov_10.351317	327	407	0	33	80	0.4125000
NODE_8981_length_896_cov_10.351317	327	407	4	47	80	0.5875000
NODE_8981_length_896_cov_10.351317	380	460	4	45	80	0.5625000
NODE_8981_length_896_cov_10.351317	380	460	6	35	80	0.4375000
NODE_8982_length_896_cov_9.754078	411	491	0	80	80	1.0000000
NODE_8982_length_896_cov_9.754078	464	544	0	80	80	1.0000000
NODE_8983_length_896_cov_8.069009	340	422	0	70	82	0.8536586
NODE_8983_length_896_cov_8.069009	340	422	3	11	82	0.1341463
NODE_8983_length_896_cov_8.069009	340	422	5	1	82	0.0121951
NODE_8983_length_896_cov_8.069009	395	475	0	80	80	1.0000000
NODE_8986_length_896_cov_4.939774	384	464	0	80	80	1.0000000
NODE_8986_length_896_cov_4.939774	437	517	0	80	80	1.0000000
NODE_9005_length_895_cov_54.949749	378	458	8	6	80	0.0750000
NODE_9005_length_895_cov_54.949749	378	458	12	74	80	0.9250000
NODE_9005_length_895_cov_54.949749	431	511	0	9	80	0.1125000
NODE_9005_length_895_cov_54.949749	431	511	8	50	80	0.6250000
NODE_9005_length_895_cov_54.949749	431	511	12	21	80	0.2625000
NODE_9006_length_895_cov_53.945980	306	386	0	80	80	1.0000000
NODE_9006_length_895_cov_53.945980	359	439	0	80	80	1.0000000
NODE_9007_length_895_cov_48.915829	369	449	0	35	80	0.4375000
NODE_9007_length_895_cov_48.915829	369	449	2	45	80	0.5625000
NODE_9007_length_895_cov_48.915829	422	502	2	80	80	1.0000000
NODE_9007_length_895_cov_48.915829	498	578	2	32	80	0.4000000
NODE_9007_length_895_cov_48.915829	498	578	4	48	80	0.6000000
NODE_9007_length_895_cov_48.915829	551	631	2	36	80	0.4500000
NODE_9007_length_895_cov_48.915829	551	631	4	44	80	0.5500000
NODE_9008_length_895_cov_38.347990	452	532	2	26	80	0.3250000
NODE_9008_length_895_cov_38.347990	452	532	6	5	80	0.0625000
NODE_9008_length_895_cov_38.347990	452	532	12	25	80	0.3125000
NODE_9008_length_895_cov_38.347990	452	532	18	1	80	0.0125000
NODE_9008_length_895_cov_38.347990	452	532	19	11	80	0.1375000
NODE_9008_length_895_cov_38.347990	452	532	23	12	80	0.1500000
NODE_9008_length_895_cov_38.347990	505	585	12	18	80	0.2250000
NODE_9008_length_895_cov_38.347990	505	585	16	3	80	0.0375000
NODE_9008_length_895_cov_38.347990	505	585	18	1	80	0.0125000
NODE_9008_length_895_cov_38.347990	505	585	19	11	80	0.1375000
NODE_9008_length_895_cov_38.347990	505	585	23	44	80	0.5500000
NODE_9008_length_895_cov_38.347990	505	585	24	3	80	0.0375000
NODE_9009_length_895_cov_33.716080	418	499	4	3	81	0.0370370
NODE_9009_length_895_cov_33.716080	418	499	6	37	81	0.4567901
NODE_9009_length_895_cov_33.716080	418	499	8	41	81	0.5061728
NODE_9009_length_895_cov_33.716080	472	552	0	51	80	0.6375000
NODE_9009_length_895_cov_33.716080	472	552	2	1	80	0.0125000
NODE_9009_length_895_cov_33.716080	472	552	4	4	80	0.0500000
NODE_9009_length_895_cov_33.716080	472	552	8	24	80	0.3000000
NODE_9010_length_895_cov_21.630653	392	468	0	4	76	0.0526316
NODE_9010_length_895_cov_21.630653	392	468	2	57	76	0.7500000
NODE_9010_length_895_cov_21.630653	392	468	4	15	76	0.1973684
NODE_9010_length_895_cov_21.630653	441	521	2	12	80	0.1500000
NODE_9010_length_895_cov_21.630653	441	521	4	16	80	0.2000000
NODE_9010_length_895_cov_21.630653	441	521	6	31	80	0.3875000
NODE_9010_length_895_cov_21.630653	441	521	8	21	80	0.2625000
NODE_9011_length_895_cov_19.932161	331	411	2	13	80	0.1625000
NODE_9011_length_895_cov_19.932161	331	411	8	67	80	0.8375000
NODE_9011_length_895_cov_19.932161	384	464	0	47	80	0.5875000
NODE_9011_length_895_cov_19.932161	384	464	2	19	80	0.2375000
NODE_9011_length_895_cov_19.932161	384	464	8	14	80	0.1750000
NODE_9011_length_895_cov_19.932161	460	540	0	49	80	0.6125000
NODE_9011_length_895_cov_19.932161	460	540	4	31	80	0.3875000
NODE_9011_length_895_cov_19.932161	513	593	4	36	80	0.4500000
NODE_9011_length_895_cov_19.932161	513	593	6	30	80	0.3750000
NODE_9011_length_895_cov_19.932161	513	593	8	14	80	0.1750000
NODE_9012_length_895_cov_16.037688	403	479	0	76	76	1.0000000
NODE_9012_length_895_cov_16.037688	452	532	0	80	80	1.0000000
NODE_9013_length_895_cov_13.003769	372	452	0	31	80	0.3875000
NODE_9013_length_895_cov_13.003769	372	452	4	12	80	0.1500000
NODE_9013_length_895_cov_13.003769	372	452	6	37	80	0.4625000
NODE_9013_length_895_cov_13.003769	425	491	6	66	66	1.0000000
NODE_9014_length_895_cov_12.736181	280	360	2	16	80	0.2000000
NODE_9014_length_895_cov_12.736181	280	360	4	64	80	0.8000000
NODE_9014_length_895_cov_12.736181	333	413	0	40	80	0.5000000
NODE_9014_length_895_cov_12.736181	333	413	2	19	80	0.2375000
NODE_9014_length_895_cov_12.736181	333	413	4	21	80	0.2625000
NODE_9015_length_895_cov_11.090452	505	585	0	80	80	1.0000000
NODE_9015_length_895_cov_11.090452	558	638	0	80	80	1.0000000
NODE_9016_length_895_cov_9.266332	468	548	0	64	80	0.8000000
NODE_9016_length_895_cov_9.266332	468	548	2	16	80	0.2000000
NODE_9016_length_895_cov_9.266332	521	601	0	80	80	1.0000000
NODE_9018_length_895_cov_5.659548	472	552	0	80	80	1.0000000
NODE_9018_length_895_cov_5.659548	525	605	0	80	80	1.0000000
NODE_9019_length_895_cov_5.383166	42	123	0	8	81	0.0987654
NODE_9019_length_895_cov_5.383166	42	123	2	73	81	0.9012346
NODE_9030_length_894_cov_60.153459	446	526	0	32	80	0.4000000
NODE_9030_length_894_cov_60.153459	446	526	2	5	80	0.0625000
NODE_9030_length_894_cov_60.153459	446	526	4	7	80	0.0875000
NODE_9030_length_894_cov_60.153459	446	526	8	36	80	0.4500000
NODE_9030_length_894_cov_60.153459	499	579	4	10	80	0.1250000
NODE_9030_length_894_cov_60.153459	499	579	8	70	80	0.8750000
NODE_9031_length_894_cov_49.618868	373	453	4	80	80	1.0000000
NODE_9031_length_894_cov_49.618868	426	506	4	80	80	1.0000000
NODE_9032_length_894_cov_33.228931	459	539	0	40	80	0.5000000
NODE_9032_length_894_cov_33.228931	459	539	2	40	80	0.5000000
NODE_9032_length_894_cov_33.228931	512	592	0	80	80	1.0000000
NODE_9033_length_894_cov_31.933333	411	491	0	80	80	1.0000000
NODE_9033_length_894_cov_31.933333	464	544	0	80	80	1.0000000
NODE_9034_length_894_cov_30.499371	270	350	0	20	80	0.2500000
NODE_9034_length_894_cov_30.499371	270	350	2	60	80	0.7500000
NODE_9034_length_894_cov_30.499371	323	403	2	28	80	0.3500000
NODE_9034_length_894_cov_30.499371	323	403	4	42	80	0.5250000
NODE_9034_length_894_cov_30.499371	323	403	6	10	80	0.1250000
NODE_9034_length_894_cov_30.499371	399	479	0	6	80	0.0750000
NODE_9034_length_894_cov_30.499371	399	479	2	25	80	0.3125000
NODE_9034_length_894_cov_30.499371	399	479	4	49	80	0.6125000
NODE_9034_length_894_cov_30.499371	452	532	0	59	80	0.7375000
NODE_9034_length_894_cov_30.499371	452	532	2	21	80	0.2625000
NODE_9035_length_894_cov_23.046541	79	159	0	80	80	1.0000000
NODE_9035_length_894_cov_23.046541	132	212	0	80	80	1.0000000
NODE_9036_length_894_cov_22.266667	381	461	0	24	80	0.3000000
NODE_9036_length_894_cov_22.266667	381	461	4	22	80	0.2750000
NODE_9036_length_894_cov_22.266667	381	461	6	34	80	0.4250000
NODE_9036_length_894_cov_22.266667	434	514	6	80	80	1.0000000
NODE_9037_length_894_cov_21.997484	332	412	0	80	80	1.0000000
NODE_9037_length_894_cov_21.997484	385	465	0	80	80	1.0000000
NODE_9038_length_894_cov_21.205031	319	399	0	80	80	1.0000000
NODE_9038_length_894_cov_21.205031	372	452	0	80	80	1.0000000
NODE_9038_length_894_cov_21.205031	448	528	0	80	80	1.0000000
NODE_9038_length_894_cov_21.205031	501	581	0	80	80	1.0000000
NODE_9039_length_894_cov_21.132075	422	502	0	80	80	1.0000000
NODE_9039_length_894_cov_21.132075	475	555	0	80	80	1.0000000
NODE_9040_length_894_cov_15.598742	338	418	2	30	80	0.3750000
NODE_9040_length_894_cov_15.598742	338	418	4	50	80	0.6250000
NODE_9040_length_894_cov_15.598742	391	471	2	80	80	1.0000000
NODE_9041_length_894_cov_14.079245	344	424	0	80	80	1.0000000
NODE_9041_length_894_cov_14.079245	397	477	0	80	80	1.0000000
NODE_9042_length_894_cov_13.031447	336	416	2	21	80	0.2625000
NODE_9042_length_894_cov_13.031447	336	416	4	59	80	0.7375000
NODE_9042_length_894_cov_13.031447	389	469	0	23	80	0.2875000
NODE_9042_length_894_cov_13.031447	389	469	2	6	80	0.0750000
NODE_9042_length_894_cov_13.031447	389	469	4	51	80	0.6375000
NODE_9043_length_894_cov_13.031447	353	433	0	80	80	1.0000000
NODE_9043_length_894_cov_13.031447	406	486	0	80	80	1.0000000
NODE_9044_length_894_cov_9.706918	330	410	0	61	80	0.7625000
NODE_9044_length_894_cov_9.706918	330	410	2	19	80	0.2375000
NODE_9045_length_894_cov_6.963522	378	458	0	77	80	0.9625000
NODE_9045_length_894_cov_6.963522	378	458	4	3	80	0.0375000
NODE_9045_length_894_cov_6.963522	431	511	0	24	80	0.3000000
NODE_9045_length_894_cov_6.963522	431	511	4	56	80	0.7000000
NODE_9046_length_894_cov_4.993711	365	445	2	23	80	0.2875000
NODE_9046_length_894_cov_4.993711	365	445	4	27	80	0.3375000
NODE_9046_length_894_cov_4.993711	365	445	6	30	80	0.3750000
NODE_9046_length_894_cov_4.993711	418	498	0	14	80	0.1750000
NODE_9046_length_894_cov_4.993711	418	498	4	25	80	0.3125000
NODE_9046_length_894_cov_4.993711	418	498	6	41	80	0.5125000
NODE_9066_length_893_cov_59.134761	261	341	10	42	80	0.5250000
NODE_9066_length_893_cov_59.134761	261	341	14	1	80	0.0125000
NODE_9066_length_893_cov_59.134761	261	341	21	37	80	0.4625000
NODE_9066_length_893_cov_59.134761	314	394	7	9	80	0.1125000
NODE_9066_length_893_cov_59.134761	314	394	11	21	80	0.2625000
NODE_9066_length_893_cov_59.134761	314	394	16	3	80	0.0375000
NODE_9066_length_893_cov_59.134761	314	394	17	20	80	0.2500000
NODE_9066_length_893_cov_59.134761	314	394	21	27	80	0.3375000
NODE_9067_length_893_cov_58.991184	388	468	0	80	80	1.0000000
NODE_9067_length_893_cov_58.991184	441	521	0	80	80	1.0000000
NODE_9067_length_893_cov_58.991184	517	597	0	80	80	1.0000000
NODE_9067_length_893_cov_58.991184	570	650	0	80	80	1.0000000
NODE_9068_length_893_cov_55.644836	434	514	0	62	80	0.7750000
NODE_9068_length_893_cov_55.644836	434	514	2	18	80	0.2250000
NODE_9068_length_893_cov_55.644836	487	567	0	80	80	1.0000000
NODE_9068_length_893_cov_55.644836	563	643	0	36	80	0.4500000
NODE_9068_length_893_cov_55.644836	563	643	2	25	80	0.3125000
NODE_9068_length_893_cov_55.644836	563	643	4	19	80	0.2375000
NODE_9068_length_893_cov_55.644836	616	696	2	8	80	0.1000000
NODE_9068_length_893_cov_55.644836	616	696	4	26	80	0.3250000
NODE_9068_length_893_cov_55.644836	616	696	6	46	80	0.5750000
NODE_9069_length_893_cov_54.803526	479	559	0	80	80	1.0000000
NODE_9069_length_893_cov_54.803526	532	612	0	80	80	1.0000000
NODE_9070_length_893_cov_38.147355	391	471	0	28	80	0.3500000
NODE_9070_length_893_cov_38.147355	391	471	2	52	80	0.6500000
NODE_9070_length_893_cov_38.147355	444	524	2	69	80	0.8625000
NODE_9070_length_893_cov_38.147355	444	524	4	11	80	0.1375000
NODE_9071_length_893_cov_33.690176	387	467	0	80	80	1.0000000
NODE_9071_length_893_cov_33.690176	440	520	0	80	80	1.0000000
NODE_9072_length_893_cov_32.162469	524	604	2	45	80	0.5625000
NODE_9072_length_893_cov_32.162469	524	604	3	2	80	0.0250000
NODE_9072_length_893_cov_32.162469	524	604	4	33	80	0.4125000
NODE_9072_length_893_cov_32.162469	577	657	2	66	80	0.8250000
NODE_9072_length_893_cov_32.162469	577	657	4	14	80	0.1750000
NODE_9073_length_893_cov_31.916877	344	424	0	35	80	0.4375000
NODE_9073_length_893_cov_31.916877	344	424	8	45	80	0.5625000
NODE_9073_length_893_cov_31.916877	397	477	8	80	80	1.0000000
NODE_9074_length_893_cov_28.693955	437	517	0	11	80	0.1375000
NODE_9074_length_893_cov_28.693955	437	517	4	39	80	0.4875000
NODE_9074_length_893_cov_28.693955	437	517	6	30	80	0.3750000
NODE_9074_length_893_cov_28.693955	490	570	2	34	80	0.4250000
NODE_9074_length_893_cov_28.693955	490	570	6	46	80	0.5750000
NODE_9075_length_893_cov_23.564232	363	443	0	7	80	0.0875000
NODE_9075_length_893_cov_23.564232	363	443	2	73	80	0.9125000
NODE_9075_length_893_cov_23.564232	416	496	0	31	80	0.3875000
NODE_9075_length_893_cov_23.564232	416	496	2	49	80	0.6125000
NODE_9076_length_893_cov_22.633501	272	352	0	17	80	0.2125000
NODE_9076_length_893_cov_22.633501	272	352	2	22	80	0.2750000
NODE_9076_length_893_cov_22.633501	272	352	4	16	80	0.2000000
NODE_9076_length_893_cov_22.633501	272	352	7	1	80	0.0125000
NODE_9076_length_893_cov_22.633501	272	352	8	24	80	0.3000000
NODE_9076_length_893_cov_22.633501	272	352	0	17	80	0.2125000
NODE_9076_length_893_cov_22.633501	272	352	2	22	80	0.2750000
NODE_9076_length_893_cov_22.633501	272	352	4	16	80	0.2000000
NODE_9076_length_893_cov_22.633501	272	352	7	1	80	0.0125000
NODE_9076_length_893_cov_22.633501	272	352	8	24	80	0.3000000
NODE_9076_length_893_cov_22.633501	272	352	0	17	80	0.2125000
NODE_9076_length_893_cov_22.633501	272	352	2	22	80	0.2750000
NODE_9076_length_893_cov_22.633501	272	352	4	16	80	0.2000000
NODE_9076_length_893_cov_22.633501	272	352	7	1	80	0.0125000
NODE_9076_length_893_cov_22.633501	272	352	8	24	80	0.3000000
NODE_9076_length_893_cov_22.633501	325	405	2	9	80	0.1125000
NODE_9076_length_893_cov_22.633501	325	405	4	8	80	0.1000000
NODE_9076_length_893_cov_22.633501	325	405	6	33	80	0.4125000
NODE_9076_length_893_cov_22.633501	325	405	7	1	80	0.0125000
NODE_9076_length_893_cov_22.633501	325	405	8	29	80	0.3625000
NODE_9076_length_893_cov_22.633501	325	405	2	9	80	0.1125000
NODE_9076_length_893_cov_22.633501	325	405	4	8	80	0.1000000
NODE_9076_length_893_cov_22.633501	325	405	6	33	80	0.4125000
NODE_9076_length_893_cov_22.633501	325	405	7	1	80	0.0125000
NODE_9076_length_893_cov_22.633501	325	405	8	29	80	0.3625000
NODE_9076_length_893_cov_22.633501	325	405	2	9	80	0.1125000
NODE_9076_length_893_cov_22.633501	325	405	4	8	80	0.1000000
NODE_9076_length_893_cov_22.633501	325	405	6	33	80	0.4125000
NODE_9076_length_893_cov_22.633501	325	405	7	1	80	0.0125000
NODE_9076_length_893_cov_22.633501	325	405	8	29	80	0.3625000
NODE_9076_length_893_cov_22.633501	401	481	0	26	80	0.3250000
NODE_9076_length_893_cov_22.633501	401	481	2	54	80	0.6750000
NODE_9076_length_893_cov_22.633501	454	534	0	4	80	0.0500000
NODE_9076_length_893_cov_22.633501	454	534	2	76	80	0.9500000
NODE_9077_length_893_cov_22.403023	453	533	13	4	80	0.0500000
NODE_9077_length_893_cov_22.403023	453	533	20	1	80	0.0125000
NODE_9077_length_893_cov_22.403023	453	533	21	13	80	0.1625000
NODE_9077_length_893_cov_22.403023	453	533	22	2	80	0.0250000
NODE_9077_length_893_cov_22.403023	453	533	24	1	80	0.0125000
NODE_9077_length_893_cov_22.403023	453	533	26	42	80	0.5250000
NODE_9077_length_893_cov_22.403023	453	533	27	17	80	0.2125000
NODE_9077_length_893_cov_22.403023	506	586	7	4	80	0.0500000
NODE_9077_length_893_cov_22.403023	506	586	11	10	80	0.1250000
NODE_9077_length_893_cov_22.403023	506	586	16	1	80	0.0125000
NODE_9077_length_893_cov_22.403023	506	586	17	5	80	0.0625000
NODE_9077_length_893_cov_22.403023	506	586	24	1	80	0.0125000
NODE_9077_length_893_cov_22.403023	506	586	25	11	80	0.1375000
NODE_9077_length_893_cov_22.403023	506	586	26	19	80	0.2375000
NODE_9077_length_893_cov_22.403023	506	586	27	29	80	0.3625000
NODE_9078_length_893_cov_19.423174	298	378	0	80	80	1.0000000
NODE_9078_length_893_cov_19.423174	351	431	0	80	80	1.0000000
NODE_9078_length_893_cov_19.423174	427	507	0	54	80	0.6750000
NODE_9078_length_893_cov_19.423174	427	507	8	1	80	0.0125000
NODE_9078_length_893_cov_19.423174	427	507	9	7	80	0.0875000
NODE_9078_length_893_cov_19.423174	427	507	18	18	80	0.2250000
NODE_9078_length_893_cov_19.423174	480	560	0	1	80	0.0125000
NODE_9078_length_893_cov_19.423174	480	560	8	1	80	0.0125000
NODE_9078_length_893_cov_19.423174	480	560	9	7	80	0.0875000
NODE_9078_length_893_cov_19.423174	480	560	18	29	80	0.3625000
NODE_9078_length_893_cov_19.423174	480	560	20	42	80	0.5250000
NODE_9079_length_893_cov_19.389169	360	440	0	45	80	0.5625000
NODE_9079_length_893_cov_19.389169	360	440	2	35	80	0.4375000
NODE_9079_length_893_cov_19.389169	413	493	0	35	80	0.4375000
NODE_9079_length_893_cov_19.389169	413	493	2	45	80	0.5625000
NODE_9079_length_893_cov_19.389169	489	569	0	15	80	0.1875000
NODE_9079_length_893_cov_19.389169	489	569	2	8	80	0.1000000
NODE_9079_length_893_cov_19.389169	489	569	4	5	80	0.0625000
NODE_9079_length_893_cov_19.389169	489	569	7	11	80	0.1375000
NODE_9079_length_893_cov_19.389169	489	569	8	34	80	0.4250000
NODE_9079_length_893_cov_19.389169	489	569	10	7	80	0.0875000
NODE_9079_length_893_cov_19.389169	542	622	4	9	80	0.1125000
NODE_9079_length_893_cov_19.389169	542	622	6	15	80	0.1875000
NODE_9079_length_893_cov_19.389169	542	622	8	49	80	0.6125000
NODE_9079_length_893_cov_19.389169	542	622	10	7	80	0.0875000
NODE_9080_length_893_cov_18.152393	394	474	0	80	80	1.0000000
NODE_9080_length_893_cov_18.152393	447	527	0	80	80	1.0000000
NODE_9081_length_893_cov_15.960957	442	522	0	80	80	1.0000000
NODE_9081_length_893_cov_15.960957	495	575	0	80	80	1.0000000
NODE_9082_length_893_cov_13.119647	473	553	0	39	80	0.4875000
NODE_9082_length_893_cov_13.119647	473	553	2	3	80	0.0375000
NODE_9082_length_893_cov_13.119647	473	553	6	38	80	0.4750000
NODE_9082_length_893_cov_13.119647	526	606	6	80	80	1.0000000
NODE_9084_length_893_cov_5.549118	353	415	6	62	62	1.0000000
NODE_9100_length_893_cov_1.141058	28	108	4	3	80	0.0375000
NODE_9100_length_893_cov_1.141058	28	108	6	14	80	0.1750000
NODE_9100_length_893_cov_1.141058	28	108	8	63	80	0.7875000
NODE_9104_length_892_cov_74.968474	333	413	0	76	80	0.9500000
NODE_9104_length_892_cov_74.968474	333	413	2	4	80	0.0500000
NODE_9104_length_892_cov_74.968474	386	466	0	80	80	1.0000000
NODE_9104_length_892_cov_74.968474	462	542	0	21	80	0.2625000
NODE_9104_length_892_cov_74.968474	462	542	2	43	80	0.5375000
NODE_9104_length_892_cov_74.968474	462	542	4	16	80	0.2000000
NODE_9104_length_892_cov_74.968474	515	595	0	30	80	0.3750000
NODE_9104_length_892_cov_74.968474	515	595	2	17	80	0.2125000
NODE_9104_length_892_cov_74.968474	515	595	4	33	80	0.4125000
NODE_9105_length_892_cov_54.549811	463	550	0	87	87	1.0000000
NODE_9105_length_892_cov_54.549811	523	603	0	80	80	1.0000000
NODE_9105_length_892_cov_54.549811	599	679	0	80	80	1.0000000
NODE_9106_length_892_cov_37.887768	373	453	0	4	80	0.0500000
NODE_9106_length_892_cov_37.887768	373	453	4	4	80	0.0500000
NODE_9106_length_892_cov_37.887768	373	453	6	72	80	0.9000000
NODE_9106_length_892_cov_37.887768	426	506	0	48	80	0.6000000
NODE_9106_length_892_cov_37.887768	426	506	2	9	80	0.1125000
NODE_9106_length_892_cov_37.887768	426	506	4	4	80	0.0500000
NODE_9106_length_892_cov_37.887768	426	506	6	19	80	0.2375000
NODE_9107_length_892_cov_19.732661	361	441	1	10	80	0.1250000
NODE_9107_length_892_cov_19.732661	361	441	3	31	80	0.3875000
NODE_9107_length_892_cov_19.732661	361	441	5	13	80	0.1625000
NODE_9107_length_892_cov_19.732661	361	441	6	26	80	0.3250000
NODE_9107_length_892_cov_19.732661	414	494	0	42	80	0.5250000
NODE_9107_length_892_cov_19.732661	414	494	1	16	80	0.2000000
NODE_9107_length_892_cov_19.732661	414	494	2	5	80	0.0625000
NODE_9107_length_892_cov_19.732661	414	494	3	17	80	0.2125000
NODE_9108_length_892_cov_19.052963	290	370	0	80	80	1.0000000
NODE_9108_length_892_cov_19.052963	343	423	0	80	80	1.0000000
NODE_9108_length_892_cov_19.052963	419	499	0	57	80	0.7125000
NODE_9108_length_892_cov_19.052963	419	499	2	23	80	0.2875000
NODE_9108_length_892_cov_19.052963	472	552	0	4	80	0.0500000
NODE_9108_length_892_cov_19.052963	472	552	2	47	80	0.5875000
NODE_9108_length_892_cov_19.052963	472	552	4	22	80	0.2750000
NODE_9108_length_892_cov_19.052963	472	552	6	7	80	0.0875000
NODE_9109_length_892_cov_17.276166	341	421	0	80	80	1.0000000
NODE_9109_length_892_cov_17.276166	394	474	0	41	80	0.5125000
NODE_9109_length_892_cov_17.276166	394	474	2	39	80	0.4875000
NODE_9110_length_892_cov_16.312736	411	491	0	61	80	0.7625000
NODE_9110_length_892_cov_16.312736	411	491	2	19	80	0.2375000
NODE_9110_length_892_cov_16.312736	464	544	0	8	80	0.1000000
NODE_9110_length_892_cov_16.312736	464	544	2	72	80	0.9000000
NODE_9111_length_892_cov_15.808323	395	475	2	13	80	0.1625000
NODE_9111_length_892_cov_15.808323	395	475	4	28	80	0.3500000
NODE_9111_length_892_cov_15.808323	395	475	6	39	80	0.4875000
NODE_9111_length_892_cov_15.808323	448	528	4	41	80	0.5125000
NODE_9111_length_892_cov_15.808323	448	528	6	39	80	0.4875000
NODE_9112_length_892_cov_14.020177	522	602	0	80	80	1.0000000
NODE_9112_length_892_cov_14.020177	575	655	0	80	80	1.0000000
NODE_9114_length_892_cov_8.798235	400	480	0	21	80	0.2625000
NODE_9114_length_892_cov_8.798235	400	480	2	59	80	0.7375000
NODE_9114_length_892_cov_8.798235	453	533	0	74	80	0.9250000
NODE_9114_length_892_cov_8.798235	453	533	2	6	80	0.0750000
NODE_9115_length_892_cov_8.413619	428	508	0	1	80	0.0125000
NODE_9115_length_892_cov_8.413619	428	508	2	78	80	0.9750000
NODE_9115_length_892_cov_8.413619	428	508	4	1	80	0.0125000
NODE_9115_length_892_cov_8.413619	481	561	2	26	80	0.3250000
NODE_9115_length_892_cov_8.413619	481	561	4	54	80	0.6750000
NODE_9116_length_892_cov_6.694830	374	454	0	80	80	1.0000000
NODE_9116_length_892_cov_6.694830	427	507	0	80	80	1.0000000
NODE_9134_length_891_cov_30.166667	295	375	0	58	80	0.7250000
NODE_9134_length_891_cov_30.166667	295	375	1	22	80	0.2750000
NODE_9134_length_891_cov_30.166667	348	428	0	5	80	0.0625000
NODE_9134_length_891_cov_30.166667	348	428	1	29	80	0.3625000
NODE_9134_length_891_cov_30.166667	348	428	4	46	80	0.5750000
NODE_9135_length_891_cov_26.333333	319	399	0	80	80	1.0000000
NODE_9135_length_891_cov_26.333333	372	452	0	80	80	1.0000000
NODE_9136_length_891_cov_22.228535	336	416	0	32	80	0.4000000
NODE_9136_length_891_cov_22.228535	336	416	2	17	80	0.2125000
NODE_9136_length_891_cov_22.228535	336	416	6	12	80	0.1500000
NODE_9136_length_891_cov_22.228535	336	416	8	10	80	0.1250000
NODE_9136_length_891_cov_22.228535	336	416	10	9	80	0.1125000
NODE_9136_length_891_cov_22.228535	389	469	6	22	80	0.2750000
NODE_9136_length_891_cov_22.228535	389	469	8	32	80	0.4000000
NODE_9136_length_891_cov_22.228535	389	469	10	26	80	0.3250000
NODE_9137_length_891_cov_20.446970	377	457	0	28	80	0.3500000
NODE_9137_length_891_cov_20.446970	377	457	2	6	80	0.0750000
NODE_9137_length_891_cov_20.446970	377	457	4	18	80	0.2250000
NODE_9137_length_891_cov_20.446970	377	457	6	28	80	0.3500000
NODE_9137_length_891_cov_20.446970	430	510	0	5	80	0.0625000
NODE_9137_length_891_cov_20.446970	430	510	2	19	80	0.2375000
NODE_9137_length_891_cov_20.446970	430	510	4	2	80	0.0250000
NODE_9137_length_891_cov_20.446970	430	510	6	54	80	0.6750000
NODE_9138_length_891_cov_20.226010	310	390	0	80	80	1.0000000
NODE_9138_length_891_cov_20.226010	363	443	0	80	80	1.0000000
NODE_9140_length_891_cov_13.207071	392	472	0	13	80	0.1625000
NODE_9140_length_891_cov_13.207071	392	472	2	67	80	0.8375000
NODE_9140_length_891_cov_13.207071	445	525	0	24	80	0.3000000
NODE_9140_length_891_cov_13.207071	445	525	2	56	80	0.7000000
NODE_9141_length_891_cov_11.579545	379	459	6	80	80	1.0000000
NODE_9141_length_891_cov_11.579545	432	512	4	49	80	0.6125000
NODE_9141_length_891_cov_11.579545	432	512	6	31	80	0.3875000
NODE_9142_length_891_cov_11.117424	499	579	0	46	80	0.5750000
NODE_9142_length_891_cov_11.117424	499	579	4	34	80	0.4250000
NODE_9142_length_891_cov_11.117424	552	632	4	80	80	1.0000000
NODE_9153_length_890_cov_29.070796	284	364	0	38	80	0.4750000
NODE_9153_length_890_cov_29.070796	284	364	2	42	80	0.5250000
NODE_9153_length_890_cov_29.070796	337	417	2	80	80	1.0000000
NODE_9153_length_890_cov_29.070796	413	497	0	58	84	0.6904762
NODE_9153_length_890_cov_29.070796	413	497	2	10	84	0.1190476
NODE_9153_length_890_cov_29.070796	413	497	4	16	84	0.1904762
NODE_9153_length_890_cov_29.070796	470	550	0	11	80	0.1375000
NODE_9153_length_890_cov_29.070796	470	550	4	69	80	0.8625000
NODE_9154_length_890_cov_27.295828	550	630	0	80	80	1.0000000
NODE_9154_length_890_cov_27.295828	603	683	0	80	80	1.0000000
NODE_9155_length_890_cov_18.088496	80	135	0	55	55	1.0000000
NODE_9155_length_890_cov_18.088496	276	356	0	18	80	0.2250000
NODE_9155_length_890_cov_18.088496	276	356	2	51	80	0.6375000
NODE_9155_length_890_cov_18.088496	276	356	4	11	80	0.1375000
NODE_9155_length_890_cov_18.088496	329	406	2	40	77	0.5194805
NODE_9155_length_890_cov_18.088496	329	406	4	37	77	0.4805195
NODE_9156_length_890_cov_16.831858	402	482	0	80	80	1.0000000
NODE_9156_length_890_cov_16.831858	455	535	0	80	80	1.0000000
NODE_9157_length_890_cov_11.881163	222	302	0	26	80	0.3250000
NODE_9157_length_890_cov_11.881163	222	302	4	54	80	0.6750000
NODE_9157_length_890_cov_11.881163	275	355	0	6	80	0.0750000
NODE_9157_length_890_cov_11.881163	275	355	4	74	80	0.9250000
NODE_9158_length_890_cov_8.676359	335	415	0	25	80	0.3125000
NODE_9158_length_890_cov_8.676359	335	415	2	55	80	0.6875000
NODE_9158_length_890_cov_8.676359	388	468	0	2	80	0.0250000
NODE_9158_length_890_cov_8.676359	388	468	2	78	80	0.9750000
NODE_9183_length_889_cov_61.520253	334	414	0	67	80	0.8375000
NODE_9183_length_889_cov_61.520253	334	414	2	13	80	0.1625000
NODE_9183_length_889_cov_61.520253	387	467	0	14	80	0.1750000
NODE_9183_length_889_cov_61.520253	387	467	2	66	80	0.8250000
NODE_9183_length_889_cov_61.520253	463	543	0	1	80	0.0125000
NODE_9183_length_889_cov_61.520253	463	543	2	17	80	0.2125000
NODE_9183_length_889_cov_61.520253	463	543	4	20	80	0.2500000
NODE_9183_length_889_cov_61.520253	463	543	6	42	80	0.5250000
NODE_9183_length_889_cov_61.520253	516	596	0	5	80	0.0625000
NODE_9183_length_889_cov_61.520253	516	596	4	24	80	0.3000000
NODE_9183_length_889_cov_61.520253	516	596	6	51	80	0.6375000
NODE_9184_length_889_cov_30.012658	311	391	0	78	80	0.9750000
NODE_9184_length_889_cov_30.012658	311	391	2	2	80	0.0250000
NODE_9184_length_889_cov_30.012658	364	444	0	25	80	0.3125000
NODE_9184_length_889_cov_30.012658	364	444	2	55	80	0.6875000
NODE_9185_length_889_cov_28.217722	413	483	0	30	70	0.4285714
NODE_9185_length_889_cov_28.217722	413	483	4	22	70	0.3142857
NODE_9185_length_889_cov_28.217722	413	483	6	18	70	0.2571429
NODE_9185_length_889_cov_28.217722	466	542	2	18	76	0.2368421
NODE_9185_length_889_cov_28.217722	466	542	6	58	76	0.7631579
NODE_9186_length_889_cov_27.924051	379	449	0	52	70	0.7428572
NODE_9186_length_889_cov_27.924051	379	449	2	18	70	0.2571429
NODE_9186_length_889_cov_27.924051	432	512	2	80	80	1.0000000
NODE_9187_length_889_cov_25.887342	227	285	0	58	58	1.0000000
NODE_9187_length_889_cov_25.887342	258	337	0	79	79	1.0000000
NODE_9188_length_889_cov_22.992405	451	531	0	11	80	0.1375000
NODE_9188_length_889_cov_22.992405	451	531	6	10	80	0.1250000
NODE_9188_length_889_cov_22.992405	451	531	8	59	80	0.7375000
NODE_9188_length_889_cov_22.992405	504	584	0	64	80	0.8000000
NODE_9188_length_889_cov_22.992405	504	584	6	10	80	0.1250000
NODE_9188_length_889_cov_22.992405	504	584	8	6	80	0.0750000
NODE_9189_length_889_cov_20.703797	331	411	2	80	80	1.0000000
NODE_9189_length_889_cov_20.703797	384	464	0	50	80	0.6250000
NODE_9189_length_889_cov_20.703797	384	464	2	30	80	0.3750000
NODE_9190_length_889_cov_20.226582	234	314	0	47	80	0.5875000
NODE_9190_length_889_cov_20.226582	234	314	2	33	80	0.4125000
NODE_9190_length_889_cov_20.226582	287	367	2	80	80	1.0000000
NODE_9191_length_889_cov_15.587342	407	487	5	2	80	0.0250000
NODE_9191_length_889_cov_15.587342	407	487	6	61	80	0.7625000
NODE_9191_length_889_cov_15.587342	407	487	9	3	80	0.0375000
NODE_9191_length_889_cov_15.587342	407	487	11	7	80	0.0875000
NODE_9191_length_889_cov_15.587342	407	487	13	7	80	0.0875000
NODE_9191_length_889_cov_15.587342	460	540	6	10	80	0.1250000
NODE_9191_length_889_cov_15.587342	460	540	9	12	80	0.1500000
NODE_9191_length_889_cov_15.587342	460	540	11	25	80	0.3125000
NODE_9191_length_889_cov_15.587342	460	540	12	14	80	0.1750000
NODE_9191_length_889_cov_15.587342	460	540	13	7	80	0.0875000
NODE_9191_length_889_cov_15.587342	460	540	14	12	80	0.1500000
NODE_9192_length_889_cov_12.669620	313	393	0	5	80	0.0625000
NODE_9192_length_889_cov_12.669620	313	393	4	1	80	0.0125000
NODE_9192_length_889_cov_12.669620	313	393	10	13	80	0.1625000
NODE_9192_length_889_cov_12.669620	313	393	12	30	80	0.3750000
NODE_9192_length_889_cov_12.669620	313	393	14	31	80	0.3875000
NODE_9192_length_889_cov_12.669620	366	446	12	38	80	0.4750000
NODE_9192_length_889_cov_12.669620	366	446	14	42	80	0.5250000
NODE_9193_length_889_cov_12.198734	399	479	10	6	80	0.0750000
NODE_9193_length_889_cov_12.198734	399	479	12	74	80	0.9250000
NODE_9193_length_889_cov_12.198734	452	532	0	27	80	0.3375000
NODE_9193_length_889_cov_12.198734	452	532	8	15	80	0.1875000
NODE_9193_length_889_cov_12.198734	452	532	10	9	80	0.1125000
NODE_9193_length_889_cov_12.198734	452	532	12	29	80	0.3625000
NODE_9197_length_889_cov_3.841772	187	267	0	80	80	1.0000000
NODE_9197_length_889_cov_3.841772	240	320	0	80	80	1.0000000
NODE_9213_length_888_cov_37.102662	490	570	0	80	80	1.0000000
NODE_9213_length_888_cov_37.102662	543	623	0	80	80	1.0000000
NODE_9214_length_888_cov_28.230672	366	446	2	16	80	0.2000000
NODE_9214_length_888_cov_28.230672	366	446	4	4	80	0.0500000
NODE_9214_length_888_cov_28.230672	366	446	6	9	80	0.1125000
NODE_9214_length_888_cov_28.230672	366	446	8	51	80	0.6375000
NODE_9214_length_888_cov_28.230672	419	499	4	23	80	0.2875000
NODE_9214_length_888_cov_28.230672	419	499	8	41	80	0.5125000
NODE_9214_length_888_cov_28.230672	419	499	12	16	80	0.2000000
NODE_9215_length_888_cov_25.243346	391	471	0	9	80	0.1125000
NODE_9215_length_888_cov_25.243346	391	471	2	36	80	0.4500000
NODE_9215_length_888_cov_25.243346	391	471	8	8	80	0.1000000
NODE_9215_length_888_cov_25.243346	391	471	10	27	80	0.3375000
NODE_9215_length_888_cov_25.243346	444	524	8	61	80	0.7625000
NODE_9215_length_888_cov_25.243346	444	524	10	19	80	0.2375000
NODE_9216_length_888_cov_21.045627	236	316	0	69	80	0.8625000
NODE_9216_length_888_cov_21.045627	236	316	2	11	80	0.1375000
NODE_9216_length_888_cov_21.045627	289	367	0	78	78	1.0000000
NODE_9218_length_888_cov_13.447402	515	595	0	26	80	0.3250000
NODE_9218_length_888_cov_13.447402	515	595	2	54	80	0.6750000
NODE_9218_length_888_cov_13.447402	568	648	0	35	80	0.4375000
NODE_9218_length_888_cov_13.447402	568	648	2	45	80	0.5625000
NODE_9219_length_888_cov_12.806084	179	259	0	80	80	1.0000000
NODE_9219_length_888_cov_12.806084	232	312	0	80	80	1.0000000
NODE_9219_length_888_cov_12.806084	308	388	0	58	80	0.7250000
NODE_9219_length_888_cov_12.806084	308	388	2	22	80	0.2750000
NODE_9219_length_888_cov_12.806084	361	441	0	5	80	0.0625000
NODE_9219_length_888_cov_12.806084	361	441	2	75	80	0.9375000
NODE_9220_length_888_cov_12.551331	365	445	0	80	80	1.0000000
NODE_9220_length_888_cov_12.551331	418	498	0	80	80	1.0000000
NODE_9228_length_888_cov_2.041825	42	102	0	60	60	1.0000000
NODE_9237_length_887_cov_32.927665	514	594	0	59	80	0.7375000
NODE_9237_length_887_cov_32.927665	514	594	8	21	80	0.2625000
NODE_9237_length_887_cov_32.927665	567	647	0	6	80	0.0750000
NODE_9237_length_887_cov_32.927665	567	647	8	74	80	0.9250000
NODE_9238_length_887_cov_26.920051	358	438	0	12	80	0.1500000
NODE_9238_length_887_cov_26.920051	358	438	7	1	80	0.0125000
NODE_9238_length_887_cov_26.920051	358	438	8	15	80	0.1875000
NODE_9238_length_887_cov_26.920051	358	438	10	28	80	0.3500000
NODE_9238_length_887_cov_26.920051	358	438	12	24	80	0.3000000
NODE_9238_length_887_cov_26.920051	411	491	2	13	80	0.1625000
NODE_9238_length_887_cov_26.920051	411	491	4	19	80	0.2375000
NODE_9238_length_887_cov_26.920051	411	491	10	3	80	0.0375000
NODE_9238_length_887_cov_26.920051	411	491	12	45	80	0.5625000
NODE_9239_length_887_cov_20.714467	304	384	2	80	80	1.0000000
NODE_9239_length_887_cov_20.714467	357	433	0	45	76	0.5921053
NODE_9239_length_887_cov_20.714467	357	433	2	31	76	0.4078947
NODE_9240_length_887_cov_19.771574	407	487	0	80	80	1.0000000
NODE_9240_length_887_cov_19.771574	460	540	0	80	80	1.0000000
NODE_9241_length_887_cov_14.535533	333	413	0	80	80	1.0000000
NODE_9241_length_887_cov_14.535533	386	466	0	80	80	1.0000000
NODE_9242_length_887_cov_14.114213	345	425	0	80	80	1.0000000
NODE_9242_length_887_cov_14.114213	398	478	0	80	80	1.0000000
NODE_9243_length_887_cov_9.451777	406	486	0	80	80	1.0000000
NODE_9243_length_887_cov_9.451777	459	539	0	80	80	1.0000000
NODE_9245_length_887_cov_6.656091	473	553	0	23	80	0.2875000
NODE_9245_length_887_cov_6.656091	473	553	2	40	80	0.5000000
NODE_9245_length_887_cov_6.656091	473	553	4	17	80	0.2125000
NODE_9245_length_887_cov_6.656091	526	606	2	43	80	0.5375000
NODE_9245_length_887_cov_6.656091	526	606	4	37	80	0.4625000
NODE_9246_length_887_cov_4.719543	420	500	6	80	80	1.0000000
NODE_9246_length_887_cov_4.719543	473	553	0	27	80	0.3375000
NODE_9246_length_887_cov_4.719543	473	553	6	53	80	0.6625000
NODE_9250_length_887_cov_2.583756	385	429	0	44	44	1.0000000
NODE_9250_length_887_cov_2.583756	393	428	0	35	35	1.0000000
NODE_9261_length_887_cov_1.087563	754	829	0	3	75	0.0400000
NODE_9261_length_887_cov_1.087563	754	829	2	26	75	0.3466667
NODE_9261_length_887_cov_1.087563	754	829	4	46	75	0.6133333
NODE_9264_length_886_cov_35.482846	365	445	0	5	80	0.0625000
NODE_9264_length_886_cov_35.482846	365	445	6	75	80	0.9375000
NODE_9264_length_886_cov_35.482846	418	498	0	58	80	0.7250000
NODE_9264_length_886_cov_35.482846	418	498	6	22	80	0.2750000
NODE_9265_length_886_cov_31.939009	438	518	0	13	80	0.1625000
NODE_9265_length_886_cov_31.939009	438	518	5	1	80	0.0125000
NODE_9265_length_886_cov_31.939009	438	518	6	66	80	0.8250000
NODE_9265_length_886_cov_31.939009	491	571	0	10	80	0.1250000
NODE_9265_length_886_cov_31.939009	491	571	6	70	80	0.8750000
NODE_9266_length_886_cov_25.301144	326	406	0	34	80	0.4250000
NODE_9266_length_886_cov_25.301144	326	406	2	5	80	0.0625000
NODE_9266_length_886_cov_25.301144	326	406	4	2	80	0.0250000
NODE_9266_length_886_cov_25.301144	326	406	6	1	80	0.0125000
NODE_9266_length_886_cov_25.301144	326	406	7	38	80	0.4750000
NODE_9266_length_886_cov_25.301144	326	406	0	34	80	0.4250000
NODE_9266_length_886_cov_25.301144	326	406	2	5	80	0.0625000
NODE_9266_length_886_cov_25.301144	326	406	4	2	80	0.0250000
NODE_9266_length_886_cov_25.301144	326	406	6	1	80	0.0125000
NODE_9266_length_886_cov_25.301144	326	406	7	38	80	0.4750000
NODE_9266_length_886_cov_25.301144	379	459	0	22	80	0.2750000
NODE_9266_length_886_cov_25.301144	379	459	2	58	80	0.7250000
NODE_9266_length_886_cov_25.301144	379	459	0	22	80	0.2750000
NODE_9266_length_886_cov_25.301144	379	459	2	58	80	0.7250000
NODE_9267_length_886_cov_14.463787	327	407	0	80	80	1.0000000
NODE_9267_length_886_cov_14.463787	380	460	0	64	80	0.8000000
NODE_9267_length_886_cov_14.463787	380	460	2	16	80	0.2000000
NODE_9286_length_885_cov_35.510178	373	453	0	80	80	1.0000000
NODE_9286_length_885_cov_35.510178	426	506	0	80	80	1.0000000
NODE_9287_length_885_cov_31.857506	368	448	0	80	80	1.0000000
NODE_9287_length_885_cov_31.857506	421	501	0	80	80	1.0000000
NODE_9288_length_885_cov_31.195929	395	475	0	16	80	0.2000000
NODE_9288_length_885_cov_31.195929	395	475	2	64	80	0.8000000
NODE_9288_length_885_cov_31.195929	448	528	0	5	80	0.0625000
NODE_9288_length_885_cov_31.195929	448	528	2	75	80	0.9375000
NODE_9289_length_885_cov_23.735369	356	436	0	80	80	1.0000000
NODE_9289_length_885_cov_23.735369	409	489	0	80	80	1.0000000
NODE_9289_length_885_cov_23.735369	485	565	0	80	80	1.0000000
NODE_9289_length_885_cov_23.735369	538	618	0	80	80	1.0000000
NODE_9290_length_885_cov_22.174300	340	420	0	17	80	0.2125000
NODE_9290_length_885_cov_22.174300	340	420	4	63	80	0.7875000
NODE_9290_length_885_cov_22.174300	393	473	0	47	80	0.5875000
NODE_9290_length_885_cov_22.174300	393	473	4	33	80	0.4125000
NODE_9290_length_885_cov_22.174300	469	549	4	50	80	0.6250000
NODE_9290_length_885_cov_22.174300	469	549	8	30	80	0.3750000
NODE_9290_length_885_cov_22.174300	522	602	0	6	80	0.0750000
NODE_9290_length_885_cov_22.174300	522	602	4	13	80	0.1625000
NODE_9290_length_885_cov_22.174300	522	602	8	61	80	0.7625000
NODE_9291_length_885_cov_17.852417	413	493	0	26	80	0.3250000
NODE_9291_length_885_cov_17.852417	413	493	2	54	80	0.6750000
NODE_9291_length_885_cov_17.852417	466	546	0	79	80	0.9875000
NODE_9291_length_885_cov_17.852417	466	546	2	1	80	0.0125000
NODE_9292_length_885_cov_15.652672	346	426	0	80	80	1.0000000
NODE_9292_length_885_cov_15.652672	399	479	0	73	80	0.9125000
NODE_9292_length_885_cov_15.652672	399	479	6	7	80	0.0875000
NODE_9292_length_885_cov_15.652672	475	555	6	80	80	1.0000000
NODE_9292_length_885_cov_15.652672	528	608	0	23	80	0.2875000
NODE_9292_length_885_cov_15.652672	528	608	2	9	80	0.1125000
NODE_9292_length_885_cov_15.652672	528	608	3	9	80	0.1125000
NODE_9292_length_885_cov_15.652672	528	608	4	1	80	0.0125000
NODE_9292_length_885_cov_15.652672	528	608	6	38	80	0.4750000
NODE_9293_length_885_cov_11.648855	530	610	0	38	80	0.4750000
NODE_9293_length_885_cov_11.648855	530	610	2	42	80	0.5250000
NODE_9293_length_885_cov_11.648855	583	663	0	80	80	1.0000000
NODE_9294_length_885_cov_9.707379	611	691	2	80	80	1.0000000
NODE_9294_length_885_cov_9.707379	664	744	0	45	80	0.5625000
NODE_9294_length_885_cov_9.707379	664	744	2	35	80	0.4375000
NODE_9311_length_884_cov_73.050955	536	616	0	4	80	0.0500000
NODE_9311_length_884_cov_73.050955	536	616	2	25	80	0.3125000
NODE_9311_length_884_cov_73.050955	536	616	4	51	80	0.6375000
NODE_9311_length_884_cov_73.050955	589	669	0	33	80	0.4125000
NODE_9311_length_884_cov_73.050955	589	669	2	37	80	0.4625000
NODE_9311_length_884_cov_73.050955	589	669	4	10	80	0.1250000
NODE_9312_length_884_cov_28.373248	381	461	0	6	80	0.0750000
NODE_9312_length_884_cov_28.373248	381	461	2	74	80	0.9250000
NODE_9312_length_884_cov_28.373248	434	514	0	59	80	0.7375000
NODE_9312_length_884_cov_28.373248	434	514	2	21	80	0.2625000
NODE_9313_length_884_cov_20.649682	463	543	0	48	80	0.6000000
NODE_9313_length_884_cov_20.649682	463	543	2	17	80	0.2125000
NODE_9313_length_884_cov_20.649682	463	543	4	15	80	0.1875000
NODE_9313_length_884_cov_20.649682	516	596	2	27	80	0.3375000
NODE_9313_length_884_cov_20.649682	516	596	4	52	80	0.6500000
NODE_9313_length_884_cov_20.649682	516	596	6	1	80	0.0125000
NODE_9314_length_884_cov_13.391083	225	305	0	80	80	1.0000000
NODE_9314_length_884_cov_13.391083	278	358	0	27	80	0.3375000
NODE_9314_length_884_cov_13.391083	278	358	2	53	80	0.6625000
NODE_9315_length_884_cov_9.192357	278	358	2	32	80	0.4000000
NODE_9315_length_884_cov_9.192357	278	358	3	1	80	0.0125000
NODE_9315_length_884_cov_9.192357	278	358	4	47	80	0.5875000
NODE_9315_length_884_cov_9.192357	331	411	0	5	80	0.0625000
NODE_9315_length_884_cov_9.192357	331	411	2	71	80	0.8875000
NODE_9315_length_884_cov_9.192357	331	411	4	4	80	0.0500000
NODE_9315_length_884_cov_9.192357	407	487	0	20	80	0.2500000
NODE_9315_length_884_cov_9.192357	407	487	2	60	80	0.7500000
NODE_9315_length_884_cov_9.192357	460	540	0	41	80	0.5125000
NODE_9315_length_884_cov_9.192357	460	540	2	39	80	0.4875000
NODE_9335_length_883_cov_46.780612	344	424	0	80	80	1.0000000
NODE_9335_length_883_cov_46.780612	397	477	0	80	80	1.0000000
NODE_9336_length_883_cov_46.304847	387	467	0	39	80	0.4875000
NODE_9336_length_883_cov_46.304847	387	467	4	19	80	0.2375000
NODE_9336_length_883_cov_46.304847	387	467	6	22	80	0.2750000
NODE_9336_length_883_cov_46.304847	440	520	2	19	80	0.2375000
NODE_9336_length_883_cov_46.304847	440	520	4	5	80	0.0625000
NODE_9336_length_883_cov_46.304847	440	520	6	56	80	0.7000000
NODE_9337_length_883_cov_39.579082	410	490	0	57	80	0.7125000
NODE_9337_length_883_cov_39.579082	410	490	6	23	80	0.2875000
NODE_9337_length_883_cov_39.579082	463	543	0	4	80	0.0500000
NODE_9337_length_883_cov_39.579082	463	543	6	76	80	0.9500000
NODE_9338_length_883_cov_28.307398	379	459	10	4	80	0.0500000
NODE_9338_length_883_cov_28.307398	379	459	12	76	80	0.9500000
NODE_9338_length_883_cov_28.307398	432	512	0	18	80	0.2250000
NODE_9338_length_883_cov_28.307398	432	512	2	4	80	0.0500000
NODE_9338_length_883_cov_28.307398	432	512	8	10	80	0.1250000
NODE_9338_length_883_cov_28.307398	432	512	10	11	80	0.1375000
NODE_9338_length_883_cov_28.307398	432	512	11	4	80	0.0500000
NODE_9338_length_883_cov_28.307398	432	512	12	33	80	0.4125000
NODE_9339_length_883_cov_24.927296	429	509	0	80	80	1.0000000
NODE_9339_length_883_cov_24.927296	482	562	0	80	80	1.0000000
NODE_9341_length_883_cov_17.445153	326	406	0	32	80	0.4000000
NODE_9341_length_883_cov_17.445153	326	406	2	41	80	0.5125000
NODE_9341_length_883_cov_17.445153	326	406	6	7	80	0.0875000
NODE_9341_length_883_cov_17.445153	379	459	2	20	80	0.2500000
NODE_9341_length_883_cov_17.445153	379	459	6	49	80	0.6125000
NODE_9341_length_883_cov_17.445153	379	459	8	11	80	0.1375000
NODE_9342_length_883_cov_14.660714	319	395	4	24	76	0.3157895
NODE_9342_length_883_cov_14.660714	319	395	8	7	76	0.0921053
NODE_9342_length_883_cov_14.660714	319	395	10	12	76	0.1578947
NODE_9342_length_883_cov_14.660714	319	395	12	33	76	0.4342105
NODE_9342_length_883_cov_14.660714	740	816	0	76	76	1.0000000
NODE_9343_length_883_cov_11.052296	223	303	0	80	80	1.0000000
NODE_9343_length_883_cov_11.052296	276	356	0	80	80	1.0000000
NODE_9344_length_883_cov_6.873724	0	66	2	1	66	0.0151515
NODE_9344_length_883_cov_6.873724	0	66	4	4	66	0.0606061
NODE_9344_length_883_cov_6.873724	0	66	6	9	66	0.1363636
NODE_9344_length_883_cov_6.873724	0	66	13	10	66	0.1515152
NODE_9344_length_883_cov_6.873724	0	66	15	3	66	0.0454545
NODE_9344_length_883_cov_6.873724	0	66	17	1	66	0.0151515
NODE_9344_length_883_cov_6.873724	0	66	18	8	66	0.1212121
NODE_9344_length_883_cov_6.873724	0	66	20	11	66	0.1666667
NODE_9344_length_883_cov_6.873724	0	66	22	5	66	0.0757576
NODE_9344_length_883_cov_6.873724	0	66	24	14	66	0.2121212
NODE_9345_length_883_cov_3.873724	471	551	0	80	80	1.0000000
NODE_9345_length_883_cov_3.873724	524	604	0	52	80	0.6500000
NODE_9345_length_883_cov_3.873724	524	604	2	28	80	0.3500000
NODE_9346_length_883_cov_3.247449	294	374	0	80	80	1.0000000
NODE_9346_length_883_cov_3.247449	347	427	0	80	80	1.0000000
NODE_9370_length_882_cov_24.241379	438	518	4	32	80	0.4000000
NODE_9370_length_882_cov_24.241379	438	518	6	27	80	0.3375000
NODE_9370_length_882_cov_24.241379	438	518	8	21	80	0.2625000
NODE_9370_length_882_cov_24.241379	491	571	0	27	80	0.3375000
NODE_9370_length_882_cov_24.241379	491	571	2	23	80	0.2875000
NODE_9370_length_882_cov_24.241379	491	571	4	17	80	0.2125000
NODE_9370_length_882_cov_24.241379	491	571	8	13	80	0.1625000
NODE_9371_length_882_cov_23.145594	355	435	2	54	80	0.6750000
NODE_9371_length_882_cov_23.145594	355	435	4	26	80	0.3250000
NODE_9371_length_882_cov_23.145594	408	488	2	60	80	0.7500000
NODE_9371_length_882_cov_23.145594	408	488	4	20	80	0.2500000
NODE_9372_length_882_cov_21.401022	335	415	0	24	80	0.3000000
NODE_9372_length_882_cov_21.401022	335	415	2	41	80	0.5125000
NODE_9372_length_882_cov_21.401022	335	415	4	15	80	0.1875000
NODE_9372_length_882_cov_21.401022	388	468	2	40	80	0.5000000
NODE_9372_length_882_cov_21.401022	388	468	4	40	80	0.5000000
NODE_9373_length_882_cov_19.579821	456	511	0	55	55	1.0000000
NODE_9373_length_882_cov_19.579821	506	586	0	26	80	0.3250000
NODE_9373_length_882_cov_19.579821	506	586	2	7	80	0.0875000
NODE_9373_length_882_cov_19.579821	506	586	6	46	80	0.5750000
NODE_9373_length_882_cov_19.579821	506	586	8	1	80	0.0125000
NODE_9373_length_882_cov_19.579821	559	639	2	18	80	0.2250000
NODE_9373_length_882_cov_19.579821	559	639	6	28	80	0.3500000
NODE_9373_length_882_cov_19.579821	559	639	8	34	80	0.4250000
NODE_9374_length_882_cov_19.342273	298	378	0	80	80	1.0000000
NODE_9374_length_882_cov_19.342273	351	431	0	80	80	1.0000000
NODE_9374_length_882_cov_19.342273	427	508	0	81	81	1.0000000
NODE_9374_length_882_cov_19.342273	481	561	0	32	80	0.4000000
NODE_9374_length_882_cov_19.342273	481	561	2	48	80	0.6000000
NODE_9375_length_882_cov_11.873563	267	347	2	35	80	0.4375000
NODE_9375_length_882_cov_11.873563	267	347	4	23	80	0.2875000
NODE_9375_length_882_cov_11.873563	267	347	6	22	80	0.2750000
NODE_9375_length_882_cov_11.873563	320	400	4	48	80	0.6000000
NODE_9375_length_882_cov_11.873563	320	400	6	32	80	0.4000000
NODE_9376_length_882_cov_8.794381	430	510	0	80	80	1.0000000
NODE_9376_length_882_cov_8.794381	483	563	0	80	80	1.0000000
NODE_9377_length_882_cov_7.537676	527	608	4	75	81	0.9259259
NODE_9377_length_882_cov_7.537676	527	608	5	6	81	0.0740741
NODE_9379_length_882_cov_6.696041	355	435	0	80	80	1.0000000
NODE_9379_length_882_cov_6.696041	408	488	0	80	80	1.0000000
NODE_9380_length_882_cov_4.734355	585	665	0	56	80	0.7000000
NODE_9380_length_882_cov_4.734355	585	665	2	24	80	0.3000000
NODE_9380_length_882_cov_4.734355	638	718	0	3	80	0.0375000
NODE_9380_length_882_cov_4.734355	638	718	2	77	80	0.9625000
NODE_9398_length_881_cov_32.875959	444	524	4	27	80	0.3375000
NODE_9398_length_881_cov_32.875959	444	524	13	2	80	0.0250000
NODE_9398_length_881_cov_32.875959	444	524	18	17	80	0.2125000
NODE_9398_length_881_cov_32.875959	444	524	20	2	80	0.0250000
NODE_9398_length_881_cov_32.875959	444	524	21	1	80	0.0125000
NODE_9398_length_881_cov_32.875959	444	524	22	31	80	0.3875000
NODE_9398_length_881_cov_32.875959	497	577	18	39	80	0.4875000
NODE_9398_length_881_cov_32.875959	497	577	20	33	80	0.4125000
NODE_9398_length_881_cov_32.875959	497	577	22	8	80	0.1000000
NODE_9399_length_881_cov_25.750639	43	117	2	57	74	0.7702703
NODE_9399_length_881_cov_25.750639	43	117	3	17	74	0.2297297
NODE_9399_length_881_cov_25.750639	116	193	3	10	77	0.1298701
NODE_9399_length_881_cov_25.750639	116	193	5	22	77	0.2857143
NODE_9399_length_881_cov_25.750639	116	193	6	13	77	0.1688312
NODE_9399_length_881_cov_25.750639	116	193	7	32	77	0.4155844
NODE_9400_length_881_cov_23.897698	286	365	0	79	79	1.0000000
NODE_9400_length_881_cov_23.897698	338	418	0	80	80	1.0000000
NODE_9401_length_881_cov_20.656010	359	439	0	47	80	0.5875000
NODE_9401_length_881_cov_20.656010	359	439	2	33	80	0.4125000
NODE_9401_length_881_cov_20.656010	412	492	2	80	80	1.0000000
NODE_9402_length_881_cov_20.340153	242	322	0	40	80	0.5000000
NODE_9402_length_881_cov_20.340153	242	322	2	40	80	0.5000000
NODE_9402_length_881_cov_20.340153	295	375	0	25	80	0.3125000
NODE_9402_length_881_cov_20.340153	295	375	2	55	80	0.6875000
NODE_9403_length_881_cov_18.234015	420	500	0	80	80	1.0000000
NODE_9403_length_881_cov_18.234015	473	553	0	80	80	1.0000000
NODE_9404_length_881_cov_17.748082	291	371	0	80	80	1.0000000
NODE_9404_length_881_cov_17.748082	344	424	0	80	80	1.0000000
NODE_9405_length_881_cov_12.884910	332	412	0	80	80	1.0000000
NODE_9405_length_881_cov_12.884910	385	465	0	80	80	1.0000000
NODE_9406_length_881_cov_6.473146	474	553	2	79	79	1.0000000
NODE_9406_length_881_cov_6.473146	514	594	0	30	80	0.3750000
NODE_9406_length_881_cov_6.473146	514	594	2	50	80	0.6250000
NODE_9406_length_881_cov_6.473146	526	565	0	1	39	0.0256410
NODE_9406_length_881_cov_6.473146	526	565	2	38	39	0.9743590
NODE_9406_length_881_cov_6.473146	555	606	0	42	51	0.8235294
NODE_9406_length_881_cov_6.473146	555	606	2	9	51	0.1764706
NODE_9406_length_881_cov_6.473146	567	647	0	80	80	1.0000000
NODE_9407_length_881_cov_5.615090	547	627	0	22	80	0.2750000
NODE_9407_length_881_cov_5.615090	547	627	2	58	80	0.7250000
NODE_9407_length_881_cov_5.615090	600	680	0	11	80	0.1375000
NODE_9407_length_881_cov_5.615090	600	680	2	69	80	0.8625000
NODE_9424_length_880_cov_26.663252	320	400	2	16	80	0.2000000
NODE_9424_length_880_cov_26.663252	320	400	4	63	80	0.7875000
NODE_9424_length_880_cov_26.663252	320	400	5	1	80	0.0125000
NODE_9424_length_880_cov_26.663252	373	453	4	31	80	0.3875000
NODE_9424_length_880_cov_26.663252	373	453	5	4	80	0.0500000
NODE_9424_length_880_cov_26.663252	373	453	6	45	80	0.5625000
NODE_9425_length_880_cov_21.828425	328	408	0	35	80	0.4375000
NODE_9425_length_880_cov_21.828425	328	408	2	45	80	0.5625000
NODE_9425_length_880_cov_21.828425	381	461	0	13	80	0.1625000
NODE_9425_length_880_cov_21.828425	381	461	2	67	80	0.8375000
NODE_9426_length_880_cov_20.245839	427	507	7	3	80	0.0375000
NODE_9426_length_880_cov_20.245839	427	507	12	1	80	0.0125000
NODE_9426_length_880_cov_20.245839	427	507	13	72	80	0.9000000
NODE_9426_length_880_cov_20.245839	427	507	14	4	80	0.0500000
NODE_9426_length_880_cov_20.245839	480	560	0	41	80	0.5125000
NODE_9426_length_880_cov_20.245839	480	560	7	15	80	0.1875000
NODE_9426_length_880_cov_20.245839	480	560	12	1	80	0.0125000
NODE_9426_length_880_cov_20.245839	480	560	13	23	80	0.2875000
NODE_9427_length_880_cov_19.434059	0	69	0	69	69	1.0000000
NODE_9428_length_880_cov_11.843790	363	430	0	67	67	1.0000000
NODE_9429_length_880_cov_11.544174	185	265	0	17	80	0.2125000
NODE_9429_length_880_cov_11.544174	185	265	4	1	80	0.0125000
NODE_9429_length_880_cov_11.544174	185	265	6	20	80	0.2500000
NODE_9429_length_880_cov_11.544174	185	265	8	42	80	0.5250000
NODE_9429_length_880_cov_11.544174	238	318	2	8	80	0.1000000
NODE_9429_length_880_cov_11.544174	238	318	4	15	80	0.1875000
NODE_9429_length_880_cov_11.544174	238	318	8	57	80	0.7125000
NODE_9430_length_880_cov_10.956466	354	434	0	80	80	1.0000000
NODE_9430_length_880_cov_10.956466	407	487	0	80	80	1.0000000
NODE_9431_length_880_cov_10.008963	395	474	0	64	79	0.8101266
NODE_9431_length_880_cov_10.008963	395	474	4	15	79	0.1898734
NODE_9431_length_880_cov_10.008963	448	527	0	11	79	0.1392405
NODE_9431_length_880_cov_10.008963	448	527	4	68	79	0.8607595
NODE_9453_length_879_cov_23.565385	326	406	0	80	80	1.0000000
NODE_9453_length_879_cov_23.565385	379	459	0	80	80	1.0000000
NODE_9453_length_879_cov_23.565385	455	535	0	80	80	1.0000000
NODE_9453_length_879_cov_23.565385	508	586	0	78	78	1.0000000
NODE_9454_length_879_cov_20.758974	355	439	0	23	84	0.2738095
NODE_9454_length_879_cov_20.758974	355	439	2	45	84	0.5357143
NODE_9454_length_879_cov_20.758974	355	439	4	16	84	0.1904762
NODE_9454_length_879_cov_20.758974	412	492	0	76	80	0.9500000
NODE_9454_length_879_cov_20.758974	412	492	2	4	80	0.0500000
NODE_9455_length_879_cov_19.685897	295	375	3	17	80	0.2125000
NODE_9455_length_879_cov_19.685897	295	375	5	50	80	0.6250000
NODE_9455_length_879_cov_19.685897	295	375	6	13	80	0.1625000
NODE_9455_length_879_cov_19.685897	348	428	0	16	80	0.2000000
NODE_9455_length_879_cov_19.685897	348	428	4	12	80	0.1500000
NODE_9455_length_879_cov_19.685897	348	428	5	14	80	0.1750000
NODE_9455_length_879_cov_19.685897	348	428	6	38	80	0.4750000
NODE_9456_length_879_cov_17.738462	413	488	2	75	75	1.0000000
NODE_9456_length_879_cov_17.738462	569	649	2	19	80	0.2375000
NODE_9456_length_879_cov_17.738462	569	649	4	44	80	0.5500000
NODE_9456_length_879_cov_17.738462	569	649	6	17	80	0.2125000
NODE_9456_length_879_cov_17.738462	569	649	2	19	80	0.2375000
NODE_9456_length_879_cov_17.738462	569	649	4	44	80	0.5500000
NODE_9456_length_879_cov_17.738462	569	649	6	17	80	0.2125000
NODE_9456_length_879_cov_17.738462	569	649	2	19	80	0.2375000
NODE_9456_length_879_cov_17.738462	569	649	4	44	80	0.5500000
NODE_9456_length_879_cov_17.738462	569	649	6	17	80	0.2125000
NODE_9456_length_879_cov_17.738462	622	676	2	46	54	0.8518519
NODE_9456_length_879_cov_17.738462	622	676	4	8	54	0.1481481
NODE_9458_length_879_cov_10.756410	335	415	0	42	80	0.5250000
NODE_9458_length_879_cov_10.756410	335	415	4	27	80	0.3375000
NODE_9458_length_879_cov_10.756410	335	415	8	8	80	0.1000000
NODE_9458_length_879_cov_10.756410	335	415	14	3	80	0.0375000
NODE_9458_length_879_cov_10.756410	388	468	4	16	80	0.2000000
NODE_9458_length_879_cov_10.756410	388	468	8	8	80	0.1000000
NODE_9458_length_879_cov_10.756410	388	468	10	9	80	0.1125000
NODE_9458_length_879_cov_10.756410	388	468	14	47	80	0.5875000
NODE_9459_length_879_cov_7.432051	234	314	4	3	80	0.0375000
NODE_9459_length_879_cov_7.432051	234	314	6	3	80	0.0375000
NODE_9459_length_879_cov_7.432051	234	314	8	8	80	0.1000000
NODE_9459_length_879_cov_7.432051	234	314	12	49	80	0.6125000
NODE_9459_length_879_cov_7.432051	234	314	14	17	80	0.2125000
NODE_9459_length_879_cov_7.432051	288	367	0	20	79	0.2531646
NODE_9459_length_879_cov_7.432051	288	367	2	29	79	0.3670886
NODE_9459_length_879_cov_7.432051	288	367	4	7	79	0.0886076
NODE_9459_length_879_cov_7.432051	288	367	6	3	79	0.0379747
NODE_9459_length_879_cov_7.432051	288	367	8	8	79	0.1012658
NODE_9459_length_879_cov_7.432051	288	367	12	12	79	0.1518987
NODE_9473_length_878_cov_230.436457	415	495	2	11	80	0.1375000
NODE_9473_length_878_cov_230.436457	415	495	4	16	80	0.2000000
NODE_9473_length_878_cov_230.436457	415	495	6	6	80	0.0750000
NODE_9473_length_878_cov_230.436457	415	495	8	41	80	0.5125000
NODE_9473_length_878_cov_230.436457	415	495	12	1	80	0.0125000
NODE_9473_length_878_cov_230.436457	415	495	14	1	80	0.0125000
NODE_9473_length_878_cov_230.436457	415	495	16	4	80	0.0500000
NODE_9473_length_878_cov_230.436457	468	548	2	11	80	0.1375000
NODE_9473_length_878_cov_230.436457	468	548	4	10	80	0.1250000
NODE_9473_length_878_cov_230.436457	468	548	12	1	80	0.0125000
NODE_9473_length_878_cov_230.436457	468	548	14	12	80	0.1500000
NODE_9473_length_878_cov_230.436457	468	548	15	8	80	0.1000000
NODE_9473_length_878_cov_230.436457	468	548	16	38	80	0.4750000
NODE_9474_length_878_cov_49.514763	410	490	6	9	80	0.1125000
NODE_9474_length_878_cov_49.514763	410	490	8	52	80	0.6500000
NODE_9474_length_878_cov_49.514763	410	490	10	10	80	0.1250000
NODE_9474_length_878_cov_49.514763	410	490	12	9	80	0.1125000
NODE_9474_length_878_cov_49.514763	463	543	4	41	80	0.5125000
NODE_9474_length_878_cov_49.514763	463	543	6	8	80	0.1000000
NODE_9474_length_878_cov_49.514763	463	543	8	9	80	0.1125000
NODE_9474_length_878_cov_49.514763	463	543	10	10	80	0.1250000
NODE_9474_length_878_cov_49.514763	463	543	12	12	80	0.1500000
NODE_9475_length_878_cov_38.862644	365	445	0	40	80	0.5000000
NODE_9475_length_878_cov_38.862644	365	445	4	40	80	0.5000000
NODE_9475_length_878_cov_38.862644	418	498	4	80	80	1.0000000
NODE_9476_length_878_cov_36.517330	346	426	0	2	80	0.0250000
NODE_9476_length_878_cov_36.517330	346	426	2	78	80	0.9750000
NODE_9476_length_878_cov_36.517330	399	479	0	52	80	0.6500000
NODE_9476_length_878_cov_36.517330	399	479	2	28	80	0.3500000
NODE_9476_length_878_cov_36.517330	475	555	0	37	80	0.4625000
NODE_9476_length_878_cov_36.517330	475	555	2	43	80	0.5375000
NODE_9476_length_878_cov_36.517330	528	608	2	61	80	0.7625000
NODE_9476_length_878_cov_36.517330	528	608	4	19	80	0.2375000
NODE_9477_length_878_cov_34.404365	627	707	8	3	80	0.0375000
NODE_9477_length_878_cov_34.404365	627	707	10	7	80	0.0875000
NODE_9477_length_878_cov_34.404365	627	707	12	2	80	0.0250000
NODE_9477_length_878_cov_34.404365	627	707	14	1	80	0.0125000
NODE_9477_length_878_cov_34.404365	627	707	16	4	80	0.0500000
NODE_9477_length_878_cov_34.404365	627	707	18	12	80	0.1500000
NODE_9477_length_878_cov_34.404365	627	707	20	35	80	0.4375000
NODE_9477_length_878_cov_34.404365	627	707	22	16	80	0.2000000
NODE_9477_length_878_cov_34.404365	627	695	8	3	68	0.0441176
NODE_9477_length_878_cov_34.404365	627	695	10	7	68	0.1029412
NODE_9477_length_878_cov_34.404365	627	695	12	2	68	0.0294118
NODE_9477_length_878_cov_34.404365	627	695	14	1	68	0.0147059
NODE_9477_length_878_cov_34.404365	627	695	18	10	68	0.1470588
NODE_9477_length_878_cov_34.404365	627	695	20	29	68	0.4264706
NODE_9477_length_878_cov_34.404365	627	695	22	16	68	0.2352941
NODE_9477_length_878_cov_34.404365	680	760	12	2	80	0.0250000
NODE_9477_length_878_cov_34.404365	680	760	14	1	80	0.0125000
NODE_9477_length_878_cov_34.404365	680	760	16	4	80	0.0500000
NODE_9477_length_878_cov_34.404365	680	760	18	3	80	0.0375000
NODE_9477_length_878_cov_34.404365	680	760	20	11	80	0.1375000
NODE_9477_length_878_cov_34.404365	680	760	22	21	80	0.2625000
NODE_9477_length_878_cov_34.404365	680	760	28	1	80	0.0125000
NODE_9477_length_878_cov_34.404365	680	760	30	8	80	0.1000000
NODE_9477_length_878_cov_34.404365	680	760	32	8	80	0.1000000
NODE_9477_length_878_cov_34.404365	680	760	34	3	80	0.0375000
NODE_9477_length_878_cov_34.404365	680	760	41	4	80	0.0500000
NODE_9477_length_878_cov_34.404365	680	760	45	2	80	0.0250000
NODE_9477_length_878_cov_34.404365	680	760	51	3	80	0.0375000
NODE_9477_length_878_cov_34.404365	680	760	52	1	80	0.0125000
NODE_9477_length_878_cov_34.404365	680	760	56	4	80	0.0500000
NODE_9477_length_878_cov_34.404365	680	760	58	3	80	0.0375000
NODE_9477_length_878_cov_34.404365	680	760	60	1	80	0.0125000
NODE_9478_length_878_cov_28.761232	467	547	0	62	80	0.7750000
NODE_9478_length_878_cov_28.761232	467	547	4	18	80	0.2250000
NODE_9478_length_878_cov_28.761232	520	600	0	9	80	0.1125000
NODE_9478_length_878_cov_28.761232	520	600	4	71	80	0.8875000
NODE_9479_length_878_cov_24.899872	316	396	0	19	80	0.2375000
NODE_9479_length_878_cov_24.899872	316	396	2	5	80	0.0625000
NODE_9479_length_878_cov_24.899872	316	396	4	56	80	0.7000000
NODE_9479_length_878_cov_24.899872	369	449	0	9	80	0.1125000
NODE_9479_length_878_cov_24.899872	369	449	2	21	80	0.2625000
NODE_9479_length_878_cov_24.899872	369	449	4	50	80	0.6250000
NODE_9479_length_878_cov_24.899872	445	525	0	80	80	1.0000000
NODE_9479_length_878_cov_24.899872	498	578	0	80	80	1.0000000
NODE_9480_length_878_cov_21.446727	377	457	21	8	80	0.1000000
NODE_9480_length_878_cov_21.446727	377	457	27	1	80	0.0125000
NODE_9480_length_878_cov_21.446727	377	457	28	34	80	0.4250000
NODE_9480_length_878_cov_21.446727	377	457	29	7	80	0.0875000
NODE_9480_length_878_cov_21.446727	377	457	30	28	80	0.3500000
NODE_9480_length_878_cov_21.446727	377	457	31	2	80	0.0250000
NODE_9480_length_878_cov_21.446727	430	510	21	10	80	0.1250000
NODE_9480_length_878_cov_21.446727	430	510	22	17	80	0.2125000
NODE_9480_length_878_cov_21.446727	430	510	27	27	80	0.3375000
NODE_9480_length_878_cov_21.446727	430	510	28	17	80	0.2125000
NODE_9480_length_878_cov_21.446727	430	510	29	7	80	0.0875000
NODE_9480_length_878_cov_21.446727	430	510	31	2	80	0.0250000
NODE_9481_length_878_cov_20.553273	424	504	0	27	80	0.3375000
NODE_9481_length_878_cov_20.553273	424	504	2	53	80	0.6625000
NODE_9481_length_878_cov_20.553273	477	557	0	1	80	0.0125000
NODE_9481_length_878_cov_20.553273	477	557	2	79	80	0.9875000
NODE_9482_length_878_cov_14.016688	214	294	0	19	80	0.2375000
NODE_9482_length_878_cov_14.016688	214	294	1	4	80	0.0500000
NODE_9482_length_878_cov_14.016688	214	294	2	15	80	0.1875000
NODE_9482_length_878_cov_14.016688	214	294	4	42	80	0.5250000
NODE_9482_length_878_cov_14.016688	267	347	4	80	80	1.0000000
NODE_9483_length_878_cov_9.252888	423	503	0	19	80	0.2375000
NODE_9483_length_878_cov_9.252888	423	503	2	61	80	0.7625000
NODE_9483_length_878_cov_9.252888	476	556	0	65	80	0.8125000
NODE_9483_length_878_cov_9.252888	476	556	2	15	80	0.1875000
NODE_9484_length_878_cov_8.695764	333	413	0	80	80	1.0000000
NODE_9484_length_878_cov_8.695764	386	466	0	80	80	1.0000000
NODE_9485_length_878_cov_6.686778	65	145	0	80	80	1.0000000
NODE_9485_length_878_cov_6.686778	118	198	0	80	80	1.0000000
NODE_9487_length_878_cov_6.328626	426	506	0	80	80	1.0000000
NODE_9487_length_878_cov_6.328626	479	559	0	80	80	1.0000000
NODE_9488_length_878_cov_5.771502	470	513	4	30	43	0.6976744
NODE_9488_length_878_cov_5.771502	470	513	6	13	43	0.3023256
NODE_9490_length_878_cov_2.672657	499	579	2	6	80	0.0750000
NODE_9490_length_878_cov_2.672657	499	579	4	37	80	0.4625000
NODE_9490_length_878_cov_2.672657	499	579	8	22	80	0.2750000
NODE_9490_length_878_cov_2.672657	499	579	10	3	80	0.0375000
NODE_9490_length_878_cov_2.672657	499	579	12	12	80	0.1500000
NODE_9490_length_878_cov_2.672657	552	631	6	5	79	0.0632911
NODE_9490_length_878_cov_2.672657	552	631	8	12	79	0.1518987
NODE_9490_length_878_cov_2.672657	552	631	10	26	79	0.3291139
NODE_9490_length_878_cov_2.672657	552	631	12	36	79	0.4556962
NODE_9507_length_877_cov_59.021851	324	404	0	55	80	0.6875000
NODE_9507_length_877_cov_59.021851	324	404	6	25	80	0.3125000
NODE_9507_length_877_cov_59.021851	377	457	0	54	80	0.6750000
NODE_9507_length_877_cov_59.021851	377	457	2	26	80	0.3250000
NODE_9508_length_877_cov_54.422879	418	498	0	6	80	0.0750000
NODE_9508_length_877_cov_54.422879	418	498	4	10	80	0.1250000
NODE_9508_length_877_cov_54.422879	418	498	8	64	80	0.8000000
NODE_9508_length_877_cov_54.422879	471	551	0	59	80	0.7375000
NODE_9508_length_877_cov_54.422879	471	551	4	3	80	0.0375000
NODE_9508_length_877_cov_54.422879	471	551	8	18	80	0.2250000
NODE_9509_length_877_cov_47.672237	451	527	0	76	76	1.0000000
NODE_9509_length_877_cov_47.672237	500	580	0	80	80	1.0000000
NODE_9510_length_877_cov_29.884319	349	429	0	67	80	0.8375000
NODE_9510_length_877_cov_29.884319	349	429	2	13	80	0.1625000
NODE_9510_length_877_cov_29.884319	402	482	0	80	80	1.0000000
NODE_9511_length_877_cov_17.681234	423	503	0	80	80	1.0000000
NODE_9511_length_877_cov_17.681234	476	556	0	80	80	1.0000000
NODE_9512_length_877_cov_17.520566	228	308	0	73	80	0.9125000
NODE_9512_length_877_cov_17.520566	228	308	2	7	80	0.0875000
NODE_9512_length_877_cov_17.520566	281	361	0	20	80	0.2500000
NODE_9512_length_877_cov_17.520566	281	361	2	60	80	0.7500000
NODE_9513_length_877_cov_17.374036	362	442	0	32	80	0.4000000
NODE_9513_length_877_cov_17.374036	362	442	2	48	80	0.6000000
NODE_9513_length_877_cov_17.374036	415	495	0	28	80	0.3500000
NODE_9513_length_877_cov_17.374036	415	495	2	52	80	0.6500000
NODE_9515_length_877_cov_9.320051	395	475	0	55	80	0.6875000
NODE_9515_length_877_cov_9.320051	395	475	4	2	80	0.0250000
NODE_9515_length_877_cov_9.320051	395	475	6	23	80	0.2875000
NODE_9515_length_877_cov_9.320051	448	528	0	2	80	0.0250000
NODE_9515_length_877_cov_9.320051	448	528	4	2	80	0.0250000
NODE_9515_length_877_cov_9.320051	448	528	6	76	80	0.9500000
NODE_9517_length_877_cov_6.755784	222	302	0	80	80	1.0000000
NODE_9517_length_877_cov_6.755784	275	354	0	79	79	1.0000000
NODE_9537_length_876_cov_46.021879	389	469	2	9	80	0.1125000
NODE_9537_length_876_cov_46.021879	389	469	12	17	80	0.2125000
NODE_9537_length_876_cov_46.021879	389	469	14	54	80	0.6750000
NODE_9537_length_876_cov_46.021879	442	522	0	23	80	0.2875000
NODE_9537_length_876_cov_46.021879	442	522	2	39	80	0.4875000
NODE_9537_length_876_cov_46.021879	442	522	14	18	80	0.2250000
NODE_9538_length_876_cov_34.441441	379	459	6	1	80	0.0125000
NODE_9538_length_876_cov_34.441441	379	459	8	5	80	0.0625000
NODE_9538_length_876_cov_34.441441	379	459	10	9	80	0.1125000
NODE_9538_length_876_cov_34.441441	379	459	12	19	80	0.2375000
NODE_9538_length_876_cov_34.441441	379	459	14	7	80	0.0875000
NODE_9538_length_876_cov_34.441441	379	459	16	39	80	0.4875000
NODE_9538_length_876_cov_34.441441	432	512	2	14	80	0.1750000
NODE_9538_length_876_cov_34.441441	432	512	4	25	80	0.3125000
NODE_9538_length_876_cov_34.441441	432	512	6	15	80	0.1875000
NODE_9538_length_876_cov_34.441441	432	512	8	5	80	0.0625000
NODE_9538_length_876_cov_34.441441	432	512	12	11	80	0.1375000
NODE_9538_length_876_cov_34.441441	432	512	16	10	80	0.1250000
NODE_9539_length_876_cov_30.742600	344	424	0	48	80	0.6000000
NODE_9539_length_876_cov_30.742600	344	424	2	32	80	0.4000000
NODE_9539_length_876_cov_30.742600	397	477	2	79	80	0.9875000
NODE_9539_length_876_cov_30.742600	397	477	4	1	80	0.0125000
NODE_9540_length_876_cov_28.476190	345	425	0	8	80	0.1000000
NODE_9540_length_876_cov_28.476190	345	425	6	2	80	0.0250000
NODE_9540_length_876_cov_28.476190	345	425	10	70	80	0.8750000
NODE_9540_length_876_cov_28.476190	398	478	0	14	80	0.1750000
NODE_9540_length_876_cov_28.476190	398	478	4	18	80	0.2250000
NODE_9540_length_876_cov_28.476190	398	478	10	48	80	0.6000000
NODE_9541_length_876_cov_22.722008	324	404	0	2	80	0.0250000
NODE_9541_length_876_cov_22.722008	324	404	10	78	80	0.9750000
NODE_9541_length_876_cov_22.722008	377	457	0	9	80	0.1125000
NODE_9541_length_876_cov_22.722008	377	457	3	45	80	0.5625000
NODE_9541_length_876_cov_22.722008	377	457	4	1	80	0.0125000
NODE_9541_length_876_cov_22.722008	377	457	10	25	80	0.3125000
NODE_9542_length_876_cov_17.458172	367	447	2	80	80	1.0000000
NODE_9542_length_876_cov_17.458172	420	500	0	25	80	0.3125000
NODE_9542_length_876_cov_17.458172	420	500	1	2	80	0.0250000
NODE_9542_length_876_cov_17.458172	420	500	2	53	80	0.6625000
NODE_9561_length_875_cov_52.965206	190	270	2	7	80	0.0875000
NODE_9561_length_875_cov_52.965206	190	270	4	9	80	0.1125000
NODE_9561_length_875_cov_52.965206	190	270	5	8	80	0.1000000
NODE_9561_length_875_cov_52.965206	190	270	6	56	80	0.7000000
NODE_9561_length_875_cov_52.965206	243	323	2	60	80	0.7500000
NODE_9561_length_875_cov_52.965206	243	323	4	8	80	0.1000000
NODE_9561_length_875_cov_52.965206	243	323	6	12	80	0.1500000
NODE_9561_length_875_cov_52.965206	319	399	0	11	80	0.1375000
NODE_9561_length_875_cov_52.965206	319	399	1	8	80	0.1000000
NODE_9561_length_875_cov_52.965206	319	399	2	61	80	0.7625000
NODE_9561_length_875_cov_52.965206	372	447	0	38	75	0.5066667
NODE_9561_length_875_cov_52.965206	372	447	2	37	75	0.4933333
NODE_9562_length_875_cov_35.634021	260	340	0	45	80	0.5625000
NODE_9562_length_875_cov_35.634021	260	340	2	35	80	0.4375000
NODE_9562_length_875_cov_35.634021	313	393	2	48	80	0.6000000
NODE_9562_length_875_cov_35.634021	313	393	4	32	80	0.4000000
NODE_9562_length_875_cov_35.634021	389	469	2	19	80	0.2375000
NODE_9562_length_875_cov_35.634021	389	469	4	60	80	0.7500000
NODE_9562_length_875_cov_35.634021	389	469	6	1	80	0.0125000
NODE_9562_length_875_cov_35.634021	442	522	0	45	80	0.5625000
NODE_9562_length_875_cov_35.634021	442	522	2	27	80	0.3375000
NODE_9562_length_875_cov_35.634021	442	522	4	8	80	0.1000000
NODE_9563_length_875_cov_33.771907	363	441	0	78	78	1.0000000
NODE_9563_length_875_cov_33.771907	414	494	0	80	80	1.0000000
NODE_9564_length_875_cov_29.698454	322	402	0	56	80	0.7000000
NODE_9564_length_875_cov_29.698454	322	402	2	24	80	0.3000000
NODE_9564_length_875_cov_29.698454	375	455	0	80	80	1.0000000
NODE_9565_length_875_cov_23.041237	364	444	2	80	80	1.0000000
NODE_9565_length_875_cov_23.041237	417	497	0	24	80	0.3000000
NODE_9565_length_875_cov_23.041237	417	497	2	56	80	0.7000000
NODE_9565_length_875_cov_23.041237	493	573	0	58	80	0.7250000
NODE_9565_length_875_cov_23.041237	493	573	1	3	80	0.0375000
NODE_9565_length_875_cov_23.041237	493	573	2	19	80	0.2375000
NODE_9565_length_875_cov_23.041237	546	626	0	5	80	0.0625000
NODE_9565_length_875_cov_23.041237	546	626	1	3	80	0.0375000
NODE_9565_length_875_cov_23.041237	546	626	2	72	80	0.9000000
NODE_9566_length_875_cov_9.800258	242	322	0	80	80	1.0000000
NODE_9566_length_875_cov_9.800258	295	376	0	81	81	1.0000000
NODE_9567_length_875_cov_8.195876	407	487	0	56	80	0.7000000
NODE_9567_length_875_cov_8.195876	407	487	2	24	80	0.3000000
NODE_9567_length_875_cov_8.195876	460	540	0	80	80	1.0000000
NODE_9585_length_874_cov_48.925161	185	265	0	79	80	0.9875000
NODE_9585_length_874_cov_48.925161	185	265	7	1	80	0.0125000
NODE_9585_length_874_cov_48.925161	238	318	0	26	80	0.3250000
NODE_9585_length_874_cov_48.925161	238	318	7	25	80	0.3125000
NODE_9585_length_874_cov_48.925161	238	318	8	29	80	0.3625000
NODE_9587_length_874_cov_37.354839	199	279	2	80	80	1.0000000
NODE_9587_length_874_cov_37.354839	252	332	0	23	80	0.2875000
NODE_9587_length_874_cov_37.354839	252	332	1	7	80	0.0875000
NODE_9587_length_874_cov_37.354839	252	332	2	50	80	0.6250000
NODE_9588_length_874_cov_35.040000	231	311	0	47	80	0.5875000
NODE_9588_length_874_cov_35.040000	231	311	2	33	80	0.4125000
NODE_9588_length_874_cov_35.040000	284	364	0	18	80	0.2250000
NODE_9588_length_874_cov_35.040000	284	364	2	62	80	0.7750000
NODE_9589_length_874_cov_23.415484	327	407	2	80	80	1.0000000
NODE_9589_length_874_cov_23.415484	380	460	0	25	80	0.3125000
NODE_9589_length_874_cov_23.415484	380	460	2	40	80	0.5000000
NODE_9589_length_874_cov_23.415484	380	460	5	1	80	0.0125000
NODE_9589_length_874_cov_23.415484	380	460	6	14	80	0.1750000
NODE_9589_length_874_cov_23.415484	456	536	6	80	80	1.0000000
NODE_9589_length_874_cov_23.415484	509	589	0	14	80	0.1750000
NODE_9589_length_874_cov_23.415484	509	589	6	66	80	0.8250000
NODE_9590_length_874_cov_21.885161	279	359	0	37	80	0.4625000
NODE_9590_length_874_cov_21.885161	279	359	4	43	80	0.5375000
NODE_9590_length_874_cov_21.885161	332	412	0	14	80	0.1750000
NODE_9590_length_874_cov_21.885161	332	412	4	66	80	0.8250000
NODE_9591_length_874_cov_11.172903	67	147	0	39	80	0.4875000
NODE_9591_length_874_cov_11.172903	67	147	2	41	80	0.5125000
NODE_9591_length_874_cov_11.172903	120	200	0	15	80	0.1875000
NODE_9591_length_874_cov_11.172903	120	200	2	65	80	0.8125000
NODE_9592_length_874_cov_9.645161	424	504	0	80	80	1.0000000
NODE_9592_length_874_cov_9.645161	477	557	0	80	80	1.0000000
NODE_9593_length_874_cov_8.637419	359	439	0	80	80	1.0000000
NODE_9593_length_874_cov_8.637419	412	499	0	87	87	1.0000000
NODE_9596_length_874_cov_4.785806	829	874	0	39	45	0.8666667
NODE_9596_length_874_cov_4.785806	829	874	2	6	45	0.1333333
NODE_9618_length_873_cov_100.625323	50	130	20	2	80	0.0250000
NODE_9618_length_873_cov_100.625323	50	130	22	9	80	0.1125000
NODE_9618_length_873_cov_100.625323	50	130	24	6	80	0.0750000
NODE_9618_length_873_cov_100.625323	50	130	26	16	80	0.2000000
NODE_9618_length_873_cov_100.625323	50	130	28	47	80	0.5875000
NODE_9619_length_873_cov_45.633075	226	306	6	9	80	0.1125000
NODE_9619_length_873_cov_45.633075	226	306	10	13	80	0.1625000
NODE_9619_length_873_cov_45.633075	226	306	12	4	80	0.0500000
NODE_9619_length_873_cov_45.633075	226	306	16	54	80	0.6750000
NODE_9619_length_873_cov_45.633075	279	359	6	3	80	0.0375000
NODE_9619_length_873_cov_45.633075	279	359	10	19	80	0.2375000
NODE_9619_length_873_cov_45.633075	279	359	14	15	80	0.1875000
NODE_9619_length_873_cov_45.633075	279	359	16	43	80	0.5375000
NODE_9619_length_873_cov_45.633075	693	773	0	22	80	0.2750000
NODE_9619_length_873_cov_45.633075	693	773	2	29	80	0.3625000
NODE_9619_length_873_cov_45.633075	693	773	6	29	80	0.3625000
NODE_9619_length_873_cov_45.633075	746	826	0	75	80	0.9375000
NODE_9619_length_873_cov_45.633075	746	826	2	5	80	0.0625000
NODE_9620_length_873_cov_39.224806	190	270	0	47	80	0.5875000
NODE_9620_length_873_cov_39.224806	190	270	2	18	80	0.2250000
NODE_9620_length_873_cov_39.224806	190	270	4	15	80	0.1875000
NODE_9620_length_873_cov_39.224806	243	307	0	64	64	1.0000000
NODE_9620_length_873_cov_39.224806	390	470	0	77	80	0.9625000
NODE_9620_length_873_cov_39.224806	390	470	2	3	80	0.0375000
NODE_9620_length_873_cov_39.224806	443	523	0	24	80	0.3000000
NODE_9620_length_873_cov_39.224806	443	523	2	23	80	0.2875000
NODE_9620_length_873_cov_39.224806	443	523	4	33	80	0.4125000
NODE_9620_length_873_cov_39.224806	504	523	4	19	19	1.0000000
NODE_9620_length_873_cov_39.224806	519	599	2	12	80	0.1500000
NODE_9620_length_873_cov_39.224806	519	599	4	68	80	0.8500000
NODE_9620_length_873_cov_39.224806	572	652	0	18	80	0.2250000
NODE_9620_length_873_cov_39.224806	572	652	2	17	80	0.2125000
NODE_9620_length_873_cov_39.224806	572	652	4	45	80	0.5625000
NODE_9621_length_873_cov_27.992248	372	452	0	80	80	1.0000000
NODE_9621_length_873_cov_27.992248	425	505	0	80	80	1.0000000
NODE_9622_length_873_cov_23.270026	390	470	0	18	80	0.2250000
NODE_9622_length_873_cov_23.270026	390	470	2	21	80	0.2625000
NODE_9622_length_873_cov_23.270026	390	470	3	26	80	0.3250000
NODE_9622_length_873_cov_23.270026	390	470	4	15	80	0.1875000
NODE_9622_length_873_cov_23.270026	443	528	0	76	85	0.8941177
NODE_9622_length_873_cov_23.270026	443	528	2	9	85	0.1058824
NODE_9623_length_873_cov_23.197674	293	373	2	15	80	0.1875000
NODE_9623_length_873_cov_23.197674	293	373	4	65	80	0.8125000
NODE_9623_length_873_cov_23.197674	346	426	0	9	80	0.1125000
NODE_9623_length_873_cov_23.197674	346	426	2	51	80	0.6375000
NODE_9623_length_873_cov_23.197674	346	426	4	20	80	0.2500000
NODE_9624_length_873_cov_20.432817	347	427	2	18	80	0.2250000
NODE_9624_length_873_cov_20.432817	347	427	6	62	80	0.7750000
NODE_9624_length_873_cov_20.432817	400	480	4	28	80	0.3500000
NODE_9624_length_873_cov_20.432817	400	480	5	13	80	0.1625000
NODE_9624_length_873_cov_20.432817	400	480	6	39	80	0.4875000
NODE_9624_length_873_cov_20.432817	476	556	0	41	80	0.5125000
NODE_9624_length_873_cov_20.432817	476	556	3	1	80	0.0125000
NODE_9624_length_873_cov_20.432817	476	556	4	38	80	0.4750000
NODE_9624_length_873_cov_20.432817	529	609	0	80	80	1.0000000
NODE_9625_length_873_cov_19.913437	445	525	0	24	80	0.3000000
NODE_9625_length_873_cov_19.913437	445	525	2	56	80	0.7000000
NODE_9625_length_873_cov_19.913437	498	578	2	33	80	0.4125000
NODE_9625_length_873_cov_19.913437	498	578	4	47	80	0.5875000
NODE_9626_length_873_cov_16.718346	276	356	0	5	80	0.0625000
NODE_9626_length_873_cov_16.718346	276	356	6	75	80	0.9375000
NODE_9626_length_873_cov_16.718346	329	409	0	58	80	0.7250000
NODE_9626_length_873_cov_16.718346	329	409	6	22	80	0.2750000
NODE_9627_length_873_cov_16.422481	423	503	0	25	80	0.3125000
NODE_9627_length_873_cov_16.422481	423	503	8	55	80	0.6875000
NODE_9627_length_873_cov_16.422481	476	556	8	80	80	1.0000000
NODE_9628_length_873_cov_11.198966	410	490	0	80	80	1.0000000
NODE_9628_length_873_cov_11.198966	463	543	0	80	80	1.0000000
NODE_9629_length_873_cov_9.799742	334	414	16	26	80	0.3250000
NODE_9629_length_873_cov_9.799742	334	414	17	10	80	0.1250000
NODE_9629_length_873_cov_9.799742	334	414	18	33	80	0.4125000
NODE_9629_length_873_cov_9.799742	334	414	19	11	80	0.1375000
NODE_9629_length_873_cov_9.799742	387	467	10	15	80	0.1875000
NODE_9629_length_873_cov_9.799742	387	467	16	17	80	0.2125000
NODE_9629_length_873_cov_9.799742	387	467	17	48	80	0.6000000
NODE_9632_length_873_cov_3.828165	490	570	0	25	80	0.3125000
NODE_9632_length_873_cov_3.828165	490	570	2	5	80	0.0625000
NODE_9632_length_873_cov_3.828165	490	570	4	50	80	0.6250000
NODE_9632_length_873_cov_3.828165	543	583	4	40	40	1.0000000
NODE_9632_length_873_cov_3.828165	690	735	0	9	45	0.2000000
NODE_9632_length_873_cov_3.828165	690	735	2	36	45	0.8000000
NODE_9633_length_873_cov_3.443152	716	746	10	5	30	0.1666667
NODE_9633_length_873_cov_3.443152	716	746	12	25	30	0.8333333
NODE_9647_length_873_cov_1.239018	593	658	2	11	65	0.1692308
NODE_9647_length_873_cov_1.239018	593	658	4	4	65	0.0615385
NODE_9647_length_873_cov_1.239018	593	658	6	3	65	0.0461538
NODE_9647_length_873_cov_1.239018	593	658	8	4	65	0.0615385
NODE_9647_length_873_cov_1.239018	593	658	10	2	65	0.0307692
NODE_9647_length_873_cov_1.239018	593	658	12	3	65	0.0461538
NODE_9647_length_873_cov_1.239018	593	658	16	3	65	0.0461538
NODE_9647_length_873_cov_1.239018	593	658	18	14	65	0.2153846
NODE_9647_length_873_cov_1.239018	593	658	20	14	65	0.2153846
NODE_9647_length_873_cov_1.239018	593	658	22	7	65	0.1076923
NODE_9651_length_872_cov_47.732212	432	512	0	17	80	0.2125000
NODE_9651_length_872_cov_47.732212	432	512	4	5	80	0.0625000
NODE_9651_length_872_cov_47.732212	432	512	8	58	80	0.7250000
NODE_9651_length_872_cov_47.732212	484	564	4	48	80	0.6000000
NODE_9651_length_872_cov_47.732212	484	564	8	32	80	0.4000000
NODE_9651_length_872_cov_47.732212	560	640	0	74	80	0.9250000
NODE_9651_length_872_cov_47.732212	560	640	4	6	80	0.0750000
NODE_9651_length_872_cov_47.732212	613	693	0	80	80	1.0000000
NODE_9652_length_872_cov_16.204398	349	429	0	80	80	1.0000000
NODE_9652_length_872_cov_16.204398	402	482	0	80	80	1.0000000
NODE_9652_length_872_cov_16.204398	478	558	0	15	80	0.1875000
NODE_9652_length_872_cov_16.204398	478	558	2	65	80	0.8125000
NODE_9652_length_872_cov_16.204398	531	611	2	80	80	1.0000000
NODE_9653_length_872_cov_12.835705	376	456	0	80	80	1.0000000
NODE_9653_length_872_cov_12.835705	429	509	0	80	80	1.0000000
NODE_9654_length_872_cov_9.657180	356	431	6	26	75	0.3466667
NODE_9654_length_872_cov_9.657180	356	431	12	27	75	0.3600000
NODE_9654_length_872_cov_9.657180	356	431	14	22	75	0.2933333
NODE_9660_length_872_cov_3.531695	425	505	0	80	80	1.0000000
NODE_9660_length_872_cov_3.531695	478	559	0	81	81	1.0000000
NODE_9673_length_871_cov_56.841969	265	345	0	80	80	1.0000000
NODE_9673_length_871_cov_56.841969	318	398	0	80	80	1.0000000
NODE_9673_length_871_cov_56.841969	394	474	0	80	80	1.0000000
NODE_9673_length_871_cov_56.841969	447	527	0	80	80	1.0000000
NODE_9674_length_871_cov_47.528497	461	541	0	32	80	0.4000000
NODE_9674_length_871_cov_47.528497	461	541	2	11	80	0.1375000
NODE_9674_length_871_cov_47.528497	461	541	6	37	80	0.4625000
NODE_9674_length_871_cov_47.528497	514	594	4	28	80	0.3500000
NODE_9674_length_871_cov_47.528497	514	594	6	52	80	0.6500000
NODE_9675_length_871_cov_31.145078	326	406	0	66	80	0.8250000
NODE_9675_length_871_cov_31.145078	326	406	2	14	80	0.1750000
NODE_9675_length_871_cov_31.145078	379	459	0	13	80	0.1625000
NODE_9675_length_871_cov_31.145078	379	459	2	23	80	0.2875000
NODE_9675_length_871_cov_31.145078	379	459	4	44	80	0.5500000
NODE_9676_length_871_cov_27.993523	379	459	0	39	80	0.4875000
NODE_9676_length_871_cov_27.993523	379	459	4	41	80	0.5125000
NODE_9676_length_871_cov_27.993523	432	512	4	80	80	1.0000000
NODE_9677_length_871_cov_25.954663	463	543	0	80	80	1.0000000
NODE_9677_length_871_cov_25.954663	516	596	0	80	80	1.0000000
NODE_9678_length_871_cov_24.069948	492	558	0	4	66	0.0606061
NODE_9678_length_871_cov_24.069948	492	558	4	15	66	0.2272727
NODE_9678_length_871_cov_24.069948	492	558	10	47	66	0.7121212
NODE_9678_length_871_cov_24.069948	558	634	6	20	76	0.2631579
NODE_9678_length_871_cov_24.069948	558	634	10	56	76	0.7368421
NODE_9679_length_871_cov_23.953368	445	522	25	2	77	0.0259740
NODE_9679_length_871_cov_23.953368	445	522	26	4	77	0.0519481
NODE_9679_length_871_cov_23.953368	445	522	27	23	77	0.2987013
NODE_9679_length_871_cov_23.953368	445	522	28	14	77	0.1818182
NODE_9679_length_871_cov_23.953368	445	522	29	10	77	0.1298701
NODE_9679_length_871_cov_23.953368	445	522	34	6	77	0.0779221
NODE_9679_length_871_cov_23.953368	445	522	36	3	77	0.0389610
NODE_9679_length_871_cov_23.953368	445	522	38	4	77	0.0519481
NODE_9679_length_871_cov_23.953368	445	522	41	2	77	0.0259740
NODE_9679_length_871_cov_23.953368	445	522	42	1	77	0.0129870
NODE_9679_length_871_cov_23.953368	445	522	44	8	77	0.1038961
NODE_9680_length_871_cov_19.304404	335	415	0	80	80	1.0000000
NODE_9680_length_871_cov_19.304404	388	468	0	80	80	1.0000000
NODE_9682_length_871_cov_18.108808	370	450	0	48	80	0.6000000
NODE_9682_length_871_cov_18.108808	370	450	2	32	80	0.4000000
NODE_9682_length_871_cov_18.108808	423	503	2	80	80	1.0000000
NODE_9683_length_871_cov_17.034974	362	442	6	17	80	0.2125000
NODE_9683_length_871_cov_17.034974	362	442	8	63	80	0.7875000
NODE_9683_length_871_cov_17.034974	415	495	0	27	80	0.3375000
NODE_9683_length_871_cov_17.034974	415	495	6	43	80	0.5375000
NODE_9683_length_871_cov_17.034974	415	495	8	10	80	0.1250000
NODE_9684_length_871_cov_16.768135	374	454	0	1	80	0.0125000
NODE_9684_length_871_cov_16.768135	374	454	3	1	80	0.0125000
NODE_9684_length_871_cov_16.768135	374	454	4	56	80	0.7000000
NODE_9684_length_871_cov_16.768135	374	454	6	22	80	0.2750000
NODE_9685_length_871_cov_14.196891	267	347	0	19	80	0.2375000
NODE_9685_length_871_cov_14.196891	267	347	2	22	80	0.2750000
NODE_9685_length_871_cov_14.196891	267	347	6	39	80	0.4875000
NODE_9685_length_871_cov_14.196891	320	400	6	56	80	0.7000000
NODE_9685_length_871_cov_14.196891	320	400	8	24	80	0.3000000
NODE_9686_length_871_cov_13.443005	246	326	8	29	80	0.3625000
NODE_9686_length_871_cov_13.443005	246	326	10	51	80	0.6375000
NODE_9686_length_871_cov_13.443005	299	322	10	23	23	1.0000000
NODE_9687_length_871_cov_11.839378	29	109	0	80	80	1.0000000
NODE_9687_length_871_cov_11.839378	82	149	0	67	67	1.0000000
NODE_9687_length_871_cov_11.839378	331	411	0	60	80	0.7500000
NODE_9687_length_871_cov_11.839378	331	411	4	20	80	0.2500000
NODE_9687_length_871_cov_11.839378	384	464	0	7	80	0.0875000
NODE_9687_length_871_cov_11.839378	384	464	4	73	80	0.9125000
NODE_9689_length_871_cov_5.730570	316	373	9	15	57	0.2631579
NODE_9689_length_871_cov_5.730570	316	373	10	15	57	0.2631579
NODE_9689_length_871_cov_5.730570	316	373	11	2	57	0.0350877
NODE_9689_length_871_cov_5.730570	316	373	12	1	57	0.0175439
NODE_9689_length_871_cov_5.730570	316	373	13	15	57	0.2631579
NODE_9689_length_871_cov_5.730570	316	373	14	1	57	0.0175439
NODE_9689_length_871_cov_5.730570	316	373	15	8	57	0.1403509
NODE_9694_length_871_cov_3.544041	428	508	0	80	80	1.0000000
NODE_9694_length_871_cov_3.544041	481	561	0	59	80	0.7375000
NODE_9694_length_871_cov_3.544041	481	561	4	21	80	0.2625000
NODE_9716_length_870_cov_43.400778	542	622	4	51	80	0.6375000
NODE_9716_length_870_cov_43.400778	542	622	6	29	80	0.3625000
NODE_9716_length_870_cov_43.400778	595	675	0	51	80	0.6375000
NODE_9716_length_870_cov_43.400778	595	675	4	29	80	0.3625000
NODE_9719_length_870_cov_28.249027	442	524	2	12	82	0.1463415
NODE_9719_length_870_cov_28.249027	442	524	4	70	82	0.8536586
NODE_9719_length_870_cov_28.249027	497	577	0	44	80	0.5500000
NODE_9719_length_870_cov_28.249027	497	577	2	15	80	0.1875000
NODE_9719_length_870_cov_28.249027	497	577	4	21	80	0.2625000
NODE_9720_length_870_cov_26.992218	240	320	0	8	80	0.1000000
NODE_9720_length_870_cov_26.992218	240	320	2	65	80	0.8125000
NODE_9720_length_870_cov_26.992218	240	320	4	7	80	0.0875000
NODE_9720_length_870_cov_26.992218	293	373	0	45	80	0.5625000
NODE_9720_length_870_cov_26.992218	293	373	2	35	80	0.4375000
NODE_9720_length_870_cov_26.992218	369	449	0	80	80	1.0000000
NODE_9720_length_870_cov_26.992218	422	502	0	80	80	1.0000000
NODE_9721_length_870_cov_25.806744	186	237	0	1	51	0.0196078
NODE_9721_length_870_cov_25.806744	186	237	2	50	51	0.9803922
NODE_9721_length_870_cov_25.806744	391	471	0	44	80	0.5500000
NODE_9721_length_870_cov_25.806744	391	471	2	36	80	0.4500000
NODE_9721_length_870_cov_25.806744	444	524	0	25	80	0.3125000
NODE_9721_length_870_cov_25.806744	444	524	2	55	80	0.6875000
NODE_9722_length_870_cov_18.862516	345	425	4	55	80	0.6875000
NODE_9722_length_870_cov_18.862516	345	425	11	25	80	0.3125000
NODE_9722_length_870_cov_18.862516	398	478	4	2	80	0.0250000
NODE_9722_length_870_cov_18.862516	398	478	8	31	80	0.3875000
NODE_9722_length_870_cov_18.862516	398	478	9	21	80	0.2625000
NODE_9722_length_870_cov_18.862516	398	478	11	26	80	0.3250000
NODE_9723_length_870_cov_15.686122	330	410	0	80	80	1.0000000
NODE_9723_length_870_cov_15.686122	383	463	0	80	80	1.0000000
NODE_9725_length_870_cov_13.334630	479	559	0	26	80	0.3250000
NODE_9725_length_870_cov_13.334630	479	559	2	54	80	0.6750000
NODE_9725_length_870_cov_13.334630	532	612	0	30	80	0.3750000
NODE_9725_length_870_cov_13.334630	532	612	2	50	80	0.6250000
NODE_9726_length_870_cov_9.712062	410	490	0	25	80	0.3125000
NODE_9726_length_870_cov_9.712062	410	490	2	55	80	0.6875000
NODE_9726_length_870_cov_9.712062	463	542	2	79	79	1.0000000
NODE_9728_length_870_cov_7.556420	448	528	0	80	80	1.0000000
NODE_9728_length_870_cov_7.556420	501	581	0	80	80	1.0000000
NODE_9746_length_869_cov_42.784416	395	475	0	80	80	1.0000000
NODE_9746_length_869_cov_42.784416	448	528	0	80	80	1.0000000
NODE_9747_length_869_cov_29.525974	211	291	2	33	80	0.4125000
NODE_9747_length_869_cov_29.525974	211	291	4	47	80	0.5875000
NODE_9747_length_869_cov_29.525974	264	344	0	36	80	0.4500000
NODE_9747_length_869_cov_29.525974	264	344	2	40	80	0.5000000
NODE_9747_length_869_cov_29.525974	264	344	4	4	80	0.0500000
NODE_9748_length_869_cov_16.258442	389	469	0	80	80	1.0000000
NODE_9748_length_869_cov_16.258442	442	522	0	80	80	1.0000000
NODE_9749_length_869_cov_15.940260	321	401	0	9	80	0.1125000
NODE_9749_length_869_cov_15.940260	321	401	2	71	80	0.8875000
NODE_9749_length_869_cov_15.940260	374	454	0	62	80	0.7750000
NODE_9749_length_869_cov_15.940260	374	454	2	18	80	0.2250000
NODE_9750_length_869_cov_9.619481	402	442	183	1	40	0.0250000
NODE_9750_length_869_cov_9.619481	402	442	184	2	40	0.0500000
NODE_9750_length_869_cov_9.619481	402	442	186	1	40	0.0250000
NODE_9750_length_869_cov_9.619481	402	442	187	3	40	0.0750000
NODE_9750_length_869_cov_9.619481	402	442	188	2	40	0.0500000
NODE_9750_length_869_cov_9.619481	402	442	192	1	40	0.0250000
NODE_9750_length_869_cov_9.619481	402	442	193	1	40	0.0250000
NODE_9750_length_869_cov_9.619481	402	442	195	1	40	0.0250000
NODE_9750_length_869_cov_9.619481	402	442	201	1	40	0.0250000
NODE_9750_length_869_cov_9.619481	402	442	209	3	40	0.0750000
NODE_9750_length_869_cov_9.619481	402	442	211	1	40	0.0250000
NODE_9750_length_869_cov_9.619481	402	442	215	1	40	0.0250000
NODE_9750_length_869_cov_9.619481	402	442	217	5	40	0.1250000
NODE_9750_length_869_cov_9.619481	402	442	219	1	40	0.0250000
NODE_9750_length_869_cov_9.619481	402	442	222	1	40	0.0250000
NODE_9750_length_869_cov_9.619481	402	442	224	1	40	0.0250000
NODE_9750_length_869_cov_9.619481	402	442	228	2	40	0.0500000
NODE_9750_length_869_cov_9.619481	402	442	232	1	40	0.0250000
NODE_9750_length_869_cov_9.619481	402	442	234	1	40	0.0250000
NODE_9750_length_869_cov_9.619481	402	442	237	1	40	0.0250000
NODE_9750_length_869_cov_9.619481	402	442	238	1	40	0.0250000
NODE_9750_length_869_cov_9.619481	402	442	241	1	40	0.0250000
NODE_9750_length_869_cov_9.619481	402	442	245	1	40	0.0250000
NODE_9750_length_869_cov_9.619481	402	442	253	1	40	0.0250000
NODE_9750_length_869_cov_9.619481	402	442	255	1	40	0.0250000
NODE_9750_length_869_cov_9.619481	402	442	265	1	40	0.0250000
NODE_9750_length_869_cov_9.619481	402	442	267	1	40	0.0250000
NODE_9750_length_869_cov_9.619481	402	442	275	1	40	0.0250000
NODE_9750_length_869_cov_9.619481	402	442	277	1	40	0.0250000
NODE_9751_length_869_cov_7.123377	392	472	0	80	80	1.0000000
NODE_9751_length_869_cov_7.123377	445	525	0	80	80	1.0000000
NODE_9753_length_869_cov_3.658442	310	378	0	68	68	1.0000000
NODE_9777_length_868_cov_57.465540	355	435	0	71	80	0.8875000
NODE_9777_length_868_cov_57.465540	355	435	3	4	80	0.0500000
NODE_9777_length_868_cov_57.465540	355	435	4	5	80	0.0625000
NODE_9778_length_868_cov_46.509753	0	65	0	28	65	0.4307692
NODE_9778_length_868_cov_46.509753	0	65	2	10	65	0.1538462
NODE_9778_length_868_cov_46.509753	0	65	4	27	65	0.4153846
NODE_9778_length_868_cov_46.509753	0	65	0	28	65	0.4307692
NODE_9778_length_868_cov_46.509753	0	65	2	10	65	0.1538462
NODE_9778_length_868_cov_46.509753	0	65	4	27	65	0.4153846
NODE_9778_length_868_cov_46.509753	0	65	0	28	65	0.4307692
NODE_9778_length_868_cov_46.509753	0	65	2	10	65	0.1538462
NODE_9778_length_868_cov_46.509753	0	65	4	27	65	0.4153846
NODE_9778_length_868_cov_46.509753	0	65	0	28	65	0.4307692
NODE_9778_length_868_cov_46.509753	0	65	2	10	65	0.1538462
NODE_9778_length_868_cov_46.509753	0	65	4	27	65	0.4153846
NODE_9778_length_868_cov_46.509753	61	141	0	4	80	0.0500000
NODE_9778_length_868_cov_46.509753	61	141	2	25	80	0.3125000
NODE_9778_length_868_cov_46.509753	61	141	4	51	80	0.6375000
NODE_9778_length_868_cov_46.509753	61	141	0	4	80	0.0500000
NODE_9778_length_868_cov_46.509753	61	141	2	25	80	0.3125000
NODE_9778_length_868_cov_46.509753	61	141	4	51	80	0.6375000
NODE_9778_length_868_cov_46.509753	114	194	0	57	80	0.7125000
NODE_9778_length_868_cov_46.509753	114	194	2	23	80	0.2875000
NODE_9778_length_868_cov_46.509753	114	194	0	57	80	0.7125000
NODE_9778_length_868_cov_46.509753	114	194	2	23	80	0.2875000
NODE_9779_length_868_cov_26.092328	318	398	0	40	80	0.5000000
NODE_9779_length_868_cov_26.092328	318	398	2	40	80	0.5000000
NODE_9779_length_868_cov_26.092328	371	451	0	80	80	1.0000000
NODE_9781_length_868_cov_22.555267	377	457	0	25	80	0.3125000
NODE_9781_length_868_cov_22.555267	377	457	2	55	80	0.6875000
NODE_9781_length_868_cov_22.555267	430	510	0	16	80	0.2000000
NODE_9781_length_868_cov_22.555267	430	510	2	64	80	0.8000000
NODE_9782_length_868_cov_20.466840	259	339	0	19	80	0.2375000
NODE_9782_length_868_cov_20.466840	259	339	2	61	80	0.7625000
NODE_9782_length_868_cov_20.466840	312	392	0	72	80	0.9000000
NODE_9782_length_868_cov_20.466840	312	392	2	8	80	0.1000000
NODE_9782_length_868_cov_20.466840	388	468	0	80	80	1.0000000
NODE_9782_length_868_cov_20.466840	441	521	0	80	80	1.0000000
NODE_9783_length_868_cov_20.414824	311	391	6	60	80	0.7500000
NODE_9783_length_868_cov_20.414824	311	391	8	20	80	0.2500000
NODE_9783_length_868_cov_20.414824	364	444	2	16	80	0.2000000
NODE_9783_length_868_cov_20.414824	364	444	5	10	80	0.1250000
NODE_9783_length_868_cov_20.414824	364	444	6	7	80	0.0875000
NODE_9783_length_868_cov_20.414824	364	444	8	47	80	0.5875000
NODE_9784_length_868_cov_17.613784	340	420	0	14	80	0.1750000
NODE_9784_length_868_cov_17.613784	340	420	4	66	80	0.8250000
NODE_9784_length_868_cov_17.613784	393	473	0	40	80	0.5000000
NODE_9784_length_868_cov_17.613784	393	473	4	40	80	0.5000000
NODE_9785_length_868_cov_15.768531	353	433	0	80	80	1.0000000
NODE_9785_length_868_cov_15.768531	406	486	0	80	80	1.0000000
NODE_9786_length_868_cov_13.997399	611	691	0	59	80	0.7375000
NODE_9786_length_868_cov_13.997399	611	691	2	7	80	0.0875000
NODE_9786_length_868_cov_13.997399	611	691	6	14	80	0.1750000
NODE_9786_length_868_cov_13.997399	664	744	0	6	80	0.0750000
NODE_9786_length_868_cov_13.997399	664	744	2	7	80	0.0875000
NODE_9786_length_868_cov_13.997399	664	744	6	67	80	0.8375000
NODE_9787_length_868_cov_13.224967	451	531	0	75	80	0.9375000
NODE_9787_length_868_cov_13.224967	451	531	2	5	80	0.0625000
NODE_9787_length_868_cov_13.224967	504	583	0	79	79	1.0000000
NODE_9788_length_868_cov_11.851756	363	422	0	21	59	0.3559322
NODE_9788_length_868_cov_11.851756	363	422	5	2	59	0.0338983
NODE_9788_length_868_cov_11.851756	363	422	6	36	59	0.6101695
NODE_9788_length_868_cov_11.851756	395	475	0	10	80	0.1250000
NODE_9788_length_868_cov_11.851756	395	475	5	1	80	0.0125000
NODE_9788_length_868_cov_11.851756	395	475	6	69	80	0.8625000
NODE_9789_length_868_cov_11.352406	361	441	0	80	80	1.0000000
NODE_9789_length_868_cov_11.352406	414	494	0	80	80	1.0000000
NODE_9790_length_868_cov_11.335501	289	369	0	12	80	0.1500000
NODE_9790_length_868_cov_11.335501	289	369	4	22	80	0.2750000
NODE_9790_length_868_cov_11.335501	289	369	6	46	80	0.5750000
NODE_9790_length_868_cov_11.335501	342	422	0	9	80	0.1125000
NODE_9790_length_868_cov_11.335501	342	422	2	36	80	0.4500000
NODE_9790_length_868_cov_11.335501	342	422	6	35	80	0.4375000
NODE_9791_length_868_cov_8.455137	401	481	2	2	80	0.0250000
NODE_9791_length_868_cov_8.455137	401	481	4	78	80	0.9750000
NODE_9791_length_868_cov_8.455137	454	534	0	24	80	0.3000000
NODE_9791_length_868_cov_8.455137	454	534	1	4	80	0.0500000
NODE_9791_length_868_cov_8.455137	454	534	2	27	80	0.3375000
NODE_9791_length_868_cov_8.455137	454	534	4	25	80	0.3125000
NODE_9816_length_867_cov_27.756510	333	376	2	43	43	1.0000000
NODE_9816_length_867_cov_27.756510	349	429	0	46	80	0.5750000
NODE_9816_length_867_cov_27.756510	349	429	2	34	80	0.4250000
NODE_9816_length_867_cov_27.756510	425	505	0	80	80	1.0000000
NODE_9816_length_867_cov_27.756510	478	542	0	64	64	1.0000000
NODE_9817_length_867_cov_25.354167	280	345	4	65	65	1.0000000
NODE_9817_length_867_cov_25.354167	325	397	0	31	72	0.4305556
NODE_9817_length_867_cov_25.354167	325	397	4	41	72	0.5694444
NODE_9818_length_867_cov_23.968750	369	449	0	80	80	1.0000000
NODE_9818_length_867_cov_23.968750	422	502	0	80	80	1.0000000
NODE_9819_length_867_cov_21.220052	524	604	0	58	80	0.7250000
NODE_9819_length_867_cov_21.220052	524	604	4	4	80	0.0500000
NODE_9819_length_867_cov_21.220052	524	604	6	6	80	0.0750000
NODE_9819_length_867_cov_21.220052	524	604	8	12	80	0.1500000
NODE_9819_length_867_cov_21.220052	577	657	0	5	80	0.0625000
NODE_9819_length_867_cov_21.220052	577	657	4	4	80	0.0500000
NODE_9819_length_867_cov_21.220052	577	657	6	6	80	0.0750000
NODE_9819_length_867_cov_21.220052	577	657	8	12	80	0.1500000
NODE_9819_length_867_cov_21.220052	577	657	10	10	80	0.1250000
NODE_9819_length_867_cov_21.220052	577	657	16	43	80	0.5375000
NODE_9820_length_867_cov_15.042969	287	364	0	10	77	0.1298701
NODE_9820_length_867_cov_15.042969	287	364	2	3	77	0.0389610
NODE_9820_length_867_cov_15.042969	287	364	4	1	77	0.0129870
NODE_9820_length_867_cov_15.042969	287	364	6	9	77	0.1168831
NODE_9820_length_867_cov_15.042969	287	364	8	54	77	0.7012987
NODE_9821_length_867_cov_11.057292	305	373	0	68	68	1.0000000
NODE_9821_length_867_cov_11.057292	346	426	0	80	80	1.0000000
NODE_9821_length_867_cov_11.057292	475	555	0	37	80	0.4625000
NODE_9821_length_867_cov_11.057292	475	555	2	43	80	0.5375000
NODE_9822_length_867_cov_8.127604	347	427	0	80	80	1.0000000
NODE_9822_length_867_cov_8.127604	400	480	0	80	80	1.0000000
NODE_9823_length_867_cov_7.621094	292	372	0	80	80	1.0000000
NODE_9823_length_867_cov_7.621094	345	425	0	80	80	1.0000000
NODE_9826_length_867_cov_5.494792	445	525	0	80	80	1.0000000
NODE_9826_length_867_cov_5.494792	498	578	0	80	80	1.0000000
NODE_9857_length_866_cov_49.224250	269	349	0	67	80	0.8375000
NODE_9857_length_866_cov_49.224250	269	349	2	6	80	0.0750000
NODE_9857_length_866_cov_49.224250	269	349	4	7	80	0.0875000
NODE_9857_length_866_cov_49.224250	322	402	0	14	80	0.1750000
NODE_9857_length_866_cov_49.224250	322	402	2	6	80	0.0750000
NODE_9857_length_866_cov_49.224250	322	402	4	14	80	0.1750000
NODE_9857_length_866_cov_49.224250	322	402	6	31	80	0.3875000
NODE_9857_length_866_cov_49.224250	322	402	8	15	80	0.1875000
NODE_9858_length_866_cov_47.160365	428	508	0	56	80	0.7000000
NODE_9858_length_866_cov_47.160365	428	508	2	24	80	0.3000000
NODE_9858_length_866_cov_47.160365	481	561	0	3	80	0.0375000
NODE_9858_length_866_cov_47.160365	481	561	2	77	80	0.9625000
NODE_9858_length_866_cov_47.160365	557	637	0	59	80	0.7375000
NODE_9858_length_866_cov_47.160365	557	637	2	21	80	0.2625000
NODE_9858_length_866_cov_47.160365	610	690	0	80	80	1.0000000
NODE_9859_length_866_cov_23.398957	281	361	4	14	80	0.1750000
NODE_9859_length_866_cov_23.398957	281	361	12	22	80	0.2750000
NODE_9859_length_866_cov_23.398957	281	361	16	12	80	0.1500000
NODE_9859_length_866_cov_23.398957	281	361	18	32	80	0.4000000
NODE_9859_length_866_cov_23.398957	334	414	8	2	80	0.0250000
NODE_9859_length_866_cov_23.398957	334	414	10	17	80	0.2125000
NODE_9859_length_866_cov_23.398957	334	414	16	9	80	0.1125000
NODE_9859_length_866_cov_23.398957	334	414	17	32	80	0.4000000
NODE_9859_length_866_cov_23.398957	334	414	18	20	80	0.2500000
NODE_9860_length_866_cov_22.186441	455	535	0	45	80	0.5625000
NODE_9860_length_866_cov_22.186441	455	535	2	35	80	0.4375000
NODE_9860_length_866_cov_22.186441	508	588	2	80	80	1.0000000
NODE_9861_length_866_cov_18.362451	451	531	0	80	80	1.0000000
NODE_9861_length_866_cov_18.362451	504	584	0	66	80	0.8250000
NODE_9861_length_866_cov_18.362451	504	584	2	14	80	0.1750000
NODE_9862_length_866_cov_16.830508	372	452	0	16	80	0.2000000
NODE_9862_length_866_cov_16.830508	372	452	1	17	80	0.2125000
NODE_9862_length_866_cov_16.830508	372	452	2	47	80	0.5875000
NODE_9862_length_866_cov_16.830508	425	505	0	69	80	0.8625000
NODE_9862_length_866_cov_16.830508	425	505	1	11	80	0.1375000
NODE_9882_length_865_cov_63.137076	288	368	6	58	80	0.7250000
NODE_9882_length_865_cov_63.137076	288	368	12	22	80	0.2750000
NODE_9882_length_865_cov_63.137076	341	421	6	43	80	0.5375000
NODE_9882_length_865_cov_63.137076	341	421	8	4	80	0.0500000
NODE_9882_length_865_cov_63.137076	341	421	12	33	80	0.4125000
NODE_9883_length_865_cov_19.882507	335	415	0	80	80	1.0000000
NODE_9883_length_865_cov_19.882507	388	468	0	80	80	1.0000000
NODE_9884_length_865_cov_17.784595	306	386	0	80	80	1.0000000
NODE_9884_length_865_cov_17.784595	359	439	0	80	80	1.0000000
NODE_9885_length_865_cov_16.150131	451	531	4	16	80	0.2000000
NODE_9885_length_865_cov_16.150131	451	531	6	41	80	0.5125000
NODE_9885_length_865_cov_16.150131	451	531	10	23	80	0.2875000
NODE_9885_length_865_cov_16.150131	504	584	4	28	80	0.3500000
NODE_9885_length_865_cov_16.150131	504	584	6	22	80	0.2750000
NODE_9885_length_865_cov_16.150131	504	584	10	30	80	0.3750000
NODE_9886_length_865_cov_14.751958	473	553	0	39	80	0.4875000
NODE_9886_length_865_cov_14.751958	473	553	2	41	80	0.5125000
NODE_9886_length_865_cov_14.751958	473	553	0	39	80	0.4875000
NODE_9886_length_865_cov_14.751958	473	553	2	41	80	0.5125000
NODE_9886_length_865_cov_14.751958	526	589	0	63	63	1.0000000
NODE_9886_length_865_cov_14.751958	526	606	0	80	80	1.0000000
NODE_9887_length_865_cov_10.937337	422	502	0	11	80	0.1375000
NODE_9887_length_865_cov_10.937337	422	502	2	69	80	0.8625000
NODE_9887_length_865_cov_10.937337	475	555	0	64	80	0.8000000
NODE_9887_length_865_cov_10.937337	475	555	2	16	80	0.2000000
NODE_9889_length_865_cov_9.167102	389	469	0	50	80	0.6250000
NODE_9889_length_865_cov_9.167102	389	469	2	30	80	0.3750000
NODE_9889_length_865_cov_9.167102	442	522	0	8	80	0.1000000
NODE_9889_length_865_cov_9.167102	442	522	2	72	80	0.9000000
NODE_9912_length_864_cov_13.398693	491	571	4	80	80	1.0000000
NODE_9912_length_864_cov_13.398693	544	624	0	36	80	0.4500000
NODE_9912_length_864_cov_13.398693	544	624	4	44	80	0.5500000
NODE_9913_length_864_cov_8.466667	308	388	0	80	80	1.0000000
NODE_9913_length_864_cov_8.466667	361	441	0	80	80	1.0000000
NODE_9917_length_864_cov_3.947712	651	676	4	1	25	0.0400000
NODE_9917_length_864_cov_3.947712	651	676	8	24	25	0.9600000
NODE_9917_length_864_cov_3.947712	725	805	17	4	80	0.0500000
NODE_9917_length_864_cov_3.947712	725	805	19	1	80	0.0125000
NODE_9917_length_864_cov_3.947712	725	805	21	25	80	0.3125000
NODE_9917_length_864_cov_3.947712	725	805	23	24	80	0.3000000
NODE_9917_length_864_cov_3.947712	725	805	24	14	80	0.1750000
NODE_9917_length_864_cov_3.947712	725	805	26	8	80	0.1000000
NODE_9917_length_864_cov_3.947712	725	805	28	4	80	0.0500000
NODE_9917_length_864_cov_3.947712	778	844	13	4	66	0.0606061
NODE_9917_length_864_cov_3.947712	778	844	15	20	66	0.3030303
NODE_9917_length_864_cov_3.947712	778	844	17	19	66	0.2878788
NODE_9917_length_864_cov_3.947712	778	844	19	1	66	0.0151515
NODE_9917_length_864_cov_3.947712	778	844	21	22	66	0.3333333
NODE_9931_length_863_cov_72.856021	241	321	4	80	80	1.0000000
NODE_9931_length_863_cov_72.856021	294	374	1	22	80	0.2750000
NODE_9931_length_863_cov_72.856021	294	374	4	31	80	0.3875000
NODE_9931_length_863_cov_72.856021	294	374	5	27	80	0.3375000
NODE_9931_length_863_cov_72.856021	370	450	1	26	80	0.3250000
NODE_9931_length_863_cov_72.856021	370	450	3	7	80	0.0875000
NODE_9931_length_863_cov_72.856021	370	450	4	34	80	0.4250000
NODE_9931_length_863_cov_72.856021	370	450	6	1	80	0.0125000
NODE_9931_length_863_cov_72.856021	370	450	7	12	80	0.1500000
NODE_9931_length_863_cov_72.856021	423	503	4	14	80	0.1750000
NODE_9931_length_863_cov_72.856021	423	503	5	2	80	0.0250000
NODE_9931_length_863_cov_72.856021	423	503	6	1	80	0.0125000
NODE_9931_length_863_cov_72.856021	423	503	7	40	80	0.5000000
NODE_9931_length_863_cov_72.856021	423	503	8	17	80	0.2125000
NODE_9931_length_863_cov_72.856021	423	503	9	2	80	0.0250000
NODE_9931_length_863_cov_72.856021	423	503	10	4	80	0.0500000
NODE_9932_length_863_cov_37.130890	363	443	0	80	80	1.0000000
NODE_9932_length_863_cov_37.130890	416	496	0	80	80	1.0000000
NODE_9932_length_863_cov_37.130890	492	572	0	80	80	1.0000000
NODE_9932_length_863_cov_37.130890	545	617	0	68	72	0.9444444
NODE_9932_length_863_cov_37.130890	545	617	4	1	72	0.0138889
NODE_9932_length_863_cov_37.130890	545	617	12	1	72	0.0138889
NODE_9932_length_863_cov_37.130890	545	617	22	1	72	0.0138889
NODE_9932_length_863_cov_37.130890	545	617	46	1	72	0.0138889
NODE_9933_length_863_cov_33.159686	287	367	0	61	80	0.7625000
NODE_9933_length_863_cov_33.159686	287	367	2	7	80	0.0875000
NODE_9933_length_863_cov_33.159686	287	367	4	12	80	0.1500000
NODE_9933_length_863_cov_33.159686	340	420	0	8	80	0.1000000
NODE_9933_length_863_cov_33.159686	340	420	2	7	80	0.0875000
NODE_9933_length_863_cov_33.159686	340	420	4	59	80	0.7375000
NODE_9933_length_863_cov_33.159686	340	420	6	6	80	0.0750000
NODE_9934_length_863_cov_24.714660	370	450	0	20	80	0.2500000
NODE_9934_length_863_cov_24.714660	370	450	2	60	80	0.7500000
NODE_9934_length_863_cov_24.714660	423	503	0	30	80	0.3750000
NODE_9934_length_863_cov_24.714660	423	503	2	50	80	0.6250000
NODE_9935_length_863_cov_21.945026	341	421	0	64	80	0.8000000
NODE_9935_length_863_cov_21.945026	341	421	2	16	80	0.2000000
NODE_9935_length_863_cov_21.945026	394	474	0	80	80	1.0000000
NODE_9936_length_863_cov_19.794503	393	473	0	80	80	1.0000000
NODE_9936_length_863_cov_19.794503	446	526	0	80	80	1.0000000
NODE_9937_length_863_cov_11.778796	303	383	0	10	80	0.1250000
NODE_9937_length_863_cov_11.778796	303	383	2	70	80	0.8750000
NODE_9937_length_863_cov_11.778796	356	436	0	63	80	0.7875000
NODE_9937_length_863_cov_11.778796	356	436	2	17	80	0.2125000
NODE_9938_length_863_cov_10.026178	283	363	0	2	80	0.0250000
NODE_9938_length_863_cov_10.026178	283	363	2	5	80	0.0625000
NODE_9938_length_863_cov_10.026178	283	363	6	41	80	0.5125000
NODE_9938_length_863_cov_10.026178	283	363	8	3	80	0.0375000
NODE_9938_length_863_cov_10.026178	283	363	10	2	80	0.0250000
NODE_9938_length_863_cov_10.026178	283	363	12	27	80	0.3375000
NODE_9938_length_863_cov_10.026178	336	416	10	2	80	0.0250000
NODE_9938_length_863_cov_10.026178	336	416	12	32	80	0.4000000
NODE_9938_length_863_cov_10.026178	336	416	16	8	80	0.1000000
NODE_9938_length_863_cov_10.026178	336	416	17	1	80	0.0125000
NODE_9938_length_863_cov_10.026178	336	416	18	8	80	0.1000000
NODE_9938_length_863_cov_10.026178	336	416	20	29	80	0.3625000
NODE_9957_length_862_cov_46.811271	272	352	0	80	80	1.0000000
NODE_9957_length_862_cov_46.811271	325	405	0	80	80	1.0000000
NODE_9957_length_862_cov_46.811271	401	481	0	80	80	1.0000000
NODE_9957_length_862_cov_46.811271	454	534	0	80	80	1.0000000
NODE_9958_length_862_cov_34.638270	259	339	14	80	80	1.0000000
NODE_9958_length_862_cov_34.638270	312	392	0	23	80	0.2875000
NODE_9958_length_862_cov_34.638270	312	392	4	1	80	0.0125000
NODE_9958_length_862_cov_34.638270	312	392	5	6	80	0.0750000
NODE_9958_length_862_cov_34.638270	312	392	7	19	80	0.2375000
NODE_9958_length_862_cov_34.638270	312	392	12	1	80	0.0125000
NODE_9958_length_862_cov_34.638270	312	392	14	30	80	0.3750000
NODE_9958_length_862_cov_34.638270	388	468	0	42	80	0.5250000
NODE_9958_length_862_cov_34.638270	388	468	2	38	80	0.4750000
NODE_9958_length_862_cov_34.638270	441	521	2	80	80	1.0000000
NODE_9959_length_862_cov_32.068152	468	548	0	27	80	0.3375000
NODE_9959_length_862_cov_32.068152	468	548	2	53	80	0.6625000
NODE_9959_length_862_cov_32.068152	521	601	0	43	80	0.5375000
NODE_9959_length_862_cov_32.068152	521	601	2	37	80	0.4625000
NODE_9960_length_862_cov_23.584535	526	606	0	37	80	0.4625000
NODE_9960_length_862_cov_23.584535	526	606	2	43	80	0.5375000
NODE_9960_length_862_cov_23.584535	579	659	0	80	80	1.0000000
NODE_9961_length_862_cov_19.980341	347	427	0	45	80	0.5625000
NODE_9961_length_862_cov_19.980341	347	427	2	35	80	0.4375000
NODE_9961_length_862_cov_19.980341	400	480	2	62	80	0.7750000
NODE_9961_length_862_cov_19.980341	400	480	6	18	80	0.2250000
NODE_9962_length_862_cov_19.079948	379	459	0	80	80	1.0000000
NODE_9962_length_862_cov_19.079948	432	512	0	80	80	1.0000000
NODE_9963_length_862_cov_18.425950	94	174	0	80	80	1.0000000
NODE_9963_length_862_cov_18.425950	147	201	0	54	54	1.0000000
NODE_9963_length_862_cov_18.425950	392	472	0	40	80	0.5000000
NODE_9963_length_862_cov_18.425950	392	472	2	40	80	0.5000000
NODE_9963_length_862_cov_18.425950	445	525	2	55	80	0.6875000
NODE_9963_length_862_cov_18.425950	445	525	4	25	80	0.3125000
NODE_9964_length_862_cov_11.740498	348	428	0	80	80	1.0000000
NODE_9964_length_862_cov_11.740498	401	481	0	80	80	1.0000000
NODE_9965_length_862_cov_11.685452	292	372	0	80	80	1.0000000
NODE_9965_length_862_cov_11.685452	345	425	0	80	80	1.0000000
NODE_9966_length_862_cov_8.259502	385	465	4	34	80	0.4250000
NODE_9966_length_862_cov_8.259502	385	465	6	27	80	0.3375000
NODE_9966_length_862_cov_8.259502	385	465	8	19	80	0.2375000
NODE_9966_length_862_cov_8.259502	438	518	2	18	80	0.2250000
NODE_9966_length_862_cov_8.259502	438	518	4	22	80	0.2750000
NODE_9966_length_862_cov_8.259502	438	518	6	17	80	0.2125000
NODE_9966_length_862_cov_8.259502	438	518	8	23	80	0.2875000
NODE_9970_length_862_cov_2.895151	388	468	0	37	80	0.4625000
NODE_9970_length_862_cov_2.895151	388	468	2	25	80	0.3125000
NODE_9970_length_862_cov_2.895151	388	468	3	5	80	0.0625000
NODE_9970_length_862_cov_2.895151	388	468	4	13	80	0.1625000
NODE_9970_length_862_cov_2.895151	441	521	0	80	80	1.0000000
NODE_9984_length_861_cov_52.679790	450	530	0	36	80	0.4500000
NODE_9984_length_861_cov_52.679790	450	530	2	27	80	0.3375000
NODE_9984_length_861_cov_52.679790	450	530	5	17	80	0.2125000
NODE_9984_length_861_cov_52.679790	503	583	2	10	80	0.1250000
NODE_9984_length_861_cov_52.679790	503	583	3	6	80	0.0750000
NODE_9984_length_861_cov_52.679790	503	583	5	21	80	0.2625000
NODE_9984_length_861_cov_52.679790	503	583	6	43	80	0.5375000
NODE_9985_length_861_cov_34.868766	470	550	0	5	80	0.0625000
NODE_9985_length_861_cov_34.868766	470	550	6	75	80	0.9375000
NODE_9985_length_861_cov_34.868766	523	603	0	11	80	0.1375000
NODE_9985_length_861_cov_34.868766	523	603	5	1	80	0.0125000
NODE_9985_length_861_cov_34.868766	523	603	6	68	80	0.8500000
NODE_9986_length_861_cov_25.622047	145	225	0	9	80	0.1125000
NODE_9986_length_861_cov_25.622047	145	225	2	71	80	0.8875000
NODE_9986_length_861_cov_25.622047	198	278	0	50	80	0.6250000
NODE_9986_length_861_cov_25.622047	198	278	2	30	80	0.3750000
NODE_9987_length_861_cov_22.052493	401	481	0	14	80	0.1750000
NODE_9987_length_861_cov_22.052493	401	481	2	66	80	0.8250000
NODE_9987_length_861_cov_22.052493	454	534	0	17	80	0.2125000
NODE_9987_length_861_cov_22.052493	454	534	2	63	80	0.7875000
NODE_9988_length_861_cov_19.913386	400	480	0	36	80	0.4500000
NODE_9988_length_861_cov_19.913386	400	480	2	44	80	0.5500000
NODE_9988_length_861_cov_19.913386	453	533	2	65	80	0.8125000
NODE_9988_length_861_cov_19.913386	453	533	4	15	80	0.1875000
NODE_9989_length_861_cov_15.237533	492	572	0	80	80	1.0000000
NODE_9989_length_861_cov_15.237533	545	625	0	80	80	1.0000000
NODE_9990_length_861_cov_12.460630	451	531	0	14	80	0.1750000
NODE_9990_length_861_cov_12.460630	451	531	2	66	80	0.8250000
NODE_9990_length_861_cov_12.460630	504	584	0	52	80	0.6500000
NODE_9990_length_861_cov_12.460630	504	584	2	28	80	0.3500000
NODE_9991_length_861_cov_9.463255	446	526	0	80	80	1.0000000
NODE_9991_length_861_cov_9.463255	499	579	0	80	80	1.0000000
NODE_9992_length_861_cov_9.435696	348	423	0	2	75	0.0266667
NODE_9992_length_861_cov_9.435696	348	423	2	73	75	0.9733334
NODE_9993_length_861_cov_7.009186	51	91	0	40	40	1.0000000
NODE_9993_length_861_cov_7.009186	185	265	0	80	80	1.0000000
NODE_9993_length_861_cov_7.009186	238	318	0	80	80	1.0000000
NODE_10019_length_860_cov_54.315375	245	325	0	80	80	1.0000000
NODE_10019_length_860_cov_54.315375	298	378	0	80	80	1.0000000
NODE_10019_length_860_cov_54.315375	374	454	0	80	80	1.0000000
NODE_10019_length_860_cov_54.315375	427	507	0	80	80	1.0000000
NODE_10020_length_860_cov_29.618922	356	436	2	24	80	0.3000000
NODE_10020_length_860_cov_29.618922	356	436	4	10	80	0.1250000
NODE_10020_length_860_cov_29.618922	356	436	6	46	80	0.5750000
NODE_10020_length_860_cov_29.618922	409	489	0	17	80	0.2125000
NODE_10020_length_860_cov_29.618922	409	489	4	46	80	0.5750000
NODE_10020_length_860_cov_29.618922	409	489	6	17	80	0.2125000
NODE_10021_length_860_cov_15.152431	393	473	6	10	80	0.1250000
NODE_10021_length_860_cov_15.152431	393	473	7	54	80	0.6750000
NODE_10021_length_860_cov_15.152431	393	473	8	16	80	0.2000000
NODE_10021_length_860_cov_15.152431	446	526	2	9	80	0.1125000
NODE_10021_length_860_cov_15.152431	446	526	4	15	80	0.1875000
NODE_10021_length_860_cov_15.152431	446	526	6	8	80	0.1000000
NODE_10021_length_860_cov_15.152431	446	526	7	48	80	0.6000000
NODE_10022_length_860_cov_11.320631	343	423	2	80	80	1.0000000
NODE_10022_length_860_cov_11.320631	396	476	0	31	80	0.3875000
NODE_10022_length_860_cov_11.320631	396	476	2	49	80	0.6125000
NODE_10049_length_859_cov_48.173684	432	512	2	17	80	0.2125000
NODE_10049_length_859_cov_48.173684	432	512	4	1	80	0.0125000
NODE_10049_length_859_cov_48.173684	432	512	8	1	80	0.0125000
NODE_10049_length_859_cov_48.173684	432	512	10	14	80	0.1750000
NODE_10049_length_859_cov_48.173684	432	512	12	47	80	0.5875000
NODE_10049_length_859_cov_48.173684	485	565	0	35	80	0.4375000
NODE_10049_length_859_cov_48.173684	485	565	4	2	80	0.0250000
NODE_10049_length_859_cov_48.173684	485	565	8	13	80	0.1625000
NODE_10049_length_859_cov_48.173684	485	565	10	17	80	0.2125000
NODE_10049_length_859_cov_48.173684	485	565	12	13	80	0.1625000
NODE_10050_length_859_cov_24.957895	402	482	2	9	80	0.1125000
NODE_10050_length_859_cov_24.957895	402	482	6	9	80	0.1125000
NODE_10050_length_859_cov_24.957895	402	482	8	62	80	0.7750000
NODE_10050_length_859_cov_24.957895	455	535	0	50	80	0.6250000
NODE_10050_length_859_cov_24.957895	455	535	2	12	80	0.1500000
NODE_10050_length_859_cov_24.957895	455	535	8	18	80	0.2250000
NODE_10051_length_859_cov_23.431579	251	331	2	3	80	0.0375000
NODE_10051_length_859_cov_23.431579	251	331	4	7	80	0.0875000
NODE_10051_length_859_cov_23.431579	251	331	6	70	80	0.8750000
NODE_10051_length_859_cov_23.431579	304	384	2	39	80	0.4875000
NODE_10051_length_859_cov_23.431579	304	384	4	17	80	0.2125000
NODE_10051_length_859_cov_23.431579	304	384	6	24	80	0.3000000
NODE_10052_length_859_cov_20.523684	341	421	4	38	80	0.4750000
NODE_10052_length_859_cov_20.523684	341	421	9	1	80	0.0125000
NODE_10052_length_859_cov_20.523684	341	421	10	41	80	0.5125000
NODE_10052_length_859_cov_20.523684	394	474	0	5	80	0.0625000
NODE_10052_length_859_cov_20.523684	394	474	6	20	80	0.2500000
NODE_10052_length_859_cov_20.523684	394	474	10	55	80	0.6875000
NODE_10053_length_859_cov_17.996053	316	396	0	28	80	0.3500000
NODE_10053_length_859_cov_17.996053	316	396	2	52	80	0.6500000
NODE_10053_length_859_cov_17.996053	369	449	0	27	80	0.3375000
NODE_10053_length_859_cov_17.996053	369	449	2	53	80	0.6625000
NODE_10054_length_859_cov_16.757895	404	484	0	29	80	0.3625000
NODE_10054_length_859_cov_16.757895	404	484	2	22	80	0.2750000
NODE_10054_length_859_cov_16.757895	404	484	4	29	80	0.3625000
NODE_10054_length_859_cov_16.757895	457	537	2	11	80	0.1375000
NODE_10054_length_859_cov_16.757895	457	537	4	69	80	0.8625000
NODE_10055_length_859_cov_15.852632	346	426	0	4	80	0.0500000
NODE_10055_length_859_cov_15.852632	346	426	6	76	80	0.9500000
NODE_10055_length_859_cov_15.852632	399	479	0	29	80	0.3625000
NODE_10055_length_859_cov_15.852632	399	479	6	51	80	0.6375000
NODE_10056_length_859_cov_11.584211	407	487	0	80	80	1.0000000
NODE_10056_length_859_cov_11.584211	460	540	0	80	80	1.0000000
NODE_10057_length_859_cov_10.296053	368	448	0	69	80	0.8625000
NODE_10057_length_859_cov_10.296053	368	448	2	11	80	0.1375000
NODE_10057_length_859_cov_10.296053	421	501	0	16	80	0.2000000
NODE_10057_length_859_cov_10.296053	421	501	2	64	80	0.8000000
NODE_10066_length_859_cov_2.359211	498	578	2	58	80	0.7250000
NODE_10066_length_859_cov_2.359211	498	578	4	22	80	0.2750000
NODE_10066_length_859_cov_2.359211	551	631	0	6	80	0.0750000
NODE_10066_length_859_cov_2.359211	551	631	1	9	80	0.1125000
NODE_10066_length_859_cov_2.359211	551	631	2	65	80	0.8125000
NODE_10079_length_858_cov_54.677207	277	357	0	78	80	0.9750000
NODE_10079_length_858_cov_54.677207	277	357	2	2	80	0.0250000
NODE_10079_length_858_cov_54.677207	330	410	0	36	80	0.4500000
NODE_10079_length_858_cov_54.677207	330	410	2	44	80	0.5500000
NODE_10080_length_858_cov_40.584980	500	580	0	16	80	0.2000000
NODE_10080_length_858_cov_40.584980	500	580	3	2	80	0.0250000
NODE_10080_length_858_cov_40.584980	500	580	5	28	80	0.3500000
NODE_10080_length_858_cov_40.584980	500	580	6	34	80	0.4250000
NODE_10080_length_858_cov_40.584980	553	633	0	69	80	0.8625000
NODE_10080_length_858_cov_40.584980	553	633	3	2	80	0.0250000
NODE_10080_length_858_cov_40.584980	553	633	5	9	80	0.1125000
NODE_10081_length_858_cov_30.177866	363	443	0	16	80	0.2000000
NODE_10081_length_858_cov_30.177866	363	443	8	53	80	0.6625000
NODE_10081_length_858_cov_30.177866	363	443	9	2	80	0.0250000
NODE_10081_length_858_cov_30.177866	363	443	10	9	80	0.1125000
NODE_10081_length_858_cov_30.177866	416	496	2	8	80	0.1000000
NODE_10081_length_858_cov_30.177866	416	496	8	16	80	0.2000000
NODE_10081_length_858_cov_30.177866	416	496	9	2	80	0.0250000
NODE_10081_length_858_cov_30.177866	416	496	10	54	80	0.6750000
NODE_10081_length_858_cov_30.177866	492	572	2	80	80	1.0000000
NODE_10081_length_858_cov_30.177866	545	625	0	41	80	0.5125000
NODE_10081_length_858_cov_30.177866	545	625	1	2	80	0.0250000
NODE_10081_length_858_cov_30.177866	545	625	2	37	80	0.4625000
NODE_10082_length_858_cov_18.534914	371	451	0	79	80	0.9875000
NODE_10082_length_858_cov_18.534914	371	451	1	1	80	0.0125000
NODE_10082_length_858_cov_18.534914	424	504	0	26	80	0.3250000
NODE_10082_length_858_cov_18.534914	424	504	1	1	80	0.0125000
NODE_10082_length_858_cov_18.534914	424	504	2	53	80	0.6625000
NODE_10083_length_858_cov_15.378129	232	312	0	15	80	0.1875000
NODE_10083_length_858_cov_15.378129	232	312	3	10	80	0.1250000
NODE_10083_length_858_cov_15.378129	232	312	6	22	80	0.2750000
NODE_10083_length_858_cov_15.378129	232	312	8	31	80	0.3875000
NODE_10083_length_858_cov_15.378129	232	312	10	2	80	0.0250000
NODE_10083_length_858_cov_15.378129	285	365	8	25	80	0.3125000
NODE_10083_length_858_cov_15.378129	285	365	10	34	80	0.4250000
NODE_10083_length_858_cov_15.378129	285	365	12	21	80	0.2625000
NODE_10084_length_858_cov_12.310935	335	415	2	50	80	0.6250000
NODE_10084_length_858_cov_12.310935	335	415	4	30	80	0.3750000
NODE_10084_length_858_cov_12.310935	388	468	4	80	80	1.0000000
NODE_10085_length_858_cov_7.835310	396	479	0	38	83	0.4578313
NODE_10085_length_858_cov_7.835310	396	479	4	45	83	0.5421687
NODE_10085_length_858_cov_7.835310	452	532	4	80	80	1.0000000
NODE_10088_length_858_cov_4.953887	474	554	0	80	80	1.0000000
NODE_10088_length_858_cov_4.953887	527	607	0	80	80	1.0000000
NODE_10091_length_858_cov_3.475626	428	502	0	33	74	0.4459459
NODE_10091_length_858_cov_3.475626	428	502	2	15	74	0.2027027
NODE_10091_length_858_cov_3.475626	428	502	4	26	74	0.3513514
NODE_10091_length_858_cov_3.475626	498	578	0	80	80	1.0000000
NODE_10091_length_858_cov_3.475626	551	631	0	80	80	1.0000000
NODE_10108_length_857_cov_33.449868	384	455	0	4	71	0.0563380
NODE_10108_length_857_cov_33.449868	384	455	2	4	71	0.0563380
NODE_10108_length_857_cov_33.449868	384	455	4	8	71	0.1126761
NODE_10108_length_857_cov_33.449868	384	455	6	55	71	0.7746479
NODE_10108_length_857_cov_33.449868	437	518	0	67	81	0.8271605
NODE_10108_length_857_cov_33.449868	437	518	2	4	81	0.0493827
NODE_10108_length_857_cov_33.449868	437	518	6	10	81	0.1234568
NODE_10109_length_857_cov_32.527704	391	471	0	8	80	0.1000000
NODE_10109_length_857_cov_32.527704	391	471	2	60	80	0.7500000
NODE_10109_length_857_cov_32.527704	391	471	4	12	80	0.1500000
NODE_10109_length_857_cov_32.527704	444	524	2	52	80	0.6500000
NODE_10109_length_857_cov_32.527704	444	524	4	28	80	0.3500000
NODE_10110_length_857_cov_27.853562	310	390	0	80	80	1.0000000
NODE_10110_length_857_cov_27.853562	363	443	0	80	80	1.0000000
NODE_10111_length_857_cov_24.654354	282	362	0	80	80	1.0000000
NODE_10111_length_857_cov_24.654354	335	415	0	80	80	1.0000000
NODE_10112_length_857_cov_22.604222	374	456	0	69	82	0.8414634
NODE_10112_length_857_cov_22.604222	374	456	2	13	82	0.1585366
NODE_10112_length_857_cov_22.604222	427	509	0	16	82	0.1951219
NODE_10112_length_857_cov_22.604222	427	509	2	50	82	0.6097561
NODE_10112_length_857_cov_22.604222	427	509	4	16	82	0.1951219
NODE_10113_length_857_cov_17.399736	320	400	0	11	80	0.1375000
NODE_10113_length_857_cov_17.399736	320	400	2	69	80	0.8625000
NODE_10113_length_857_cov_17.399736	373	453	0	64	80	0.8000000
NODE_10113_length_857_cov_17.399736	373	453	2	16	80	0.2000000
NODE_10114_length_857_cov_17.069921	388	468	0	51	80	0.6375000
NODE_10114_length_857_cov_17.069921	388	468	2	29	80	0.3625000
NODE_10114_length_857_cov_17.069921	441	521	0	7	80	0.0875000
NODE_10114_length_857_cov_17.069921	441	521	2	73	80	0.9125000
NODE_10115_length_857_cov_11.816623	433	513	0	80	80	1.0000000
NODE_10115_length_857_cov_11.816623	486	566	0	80	80	1.0000000
NODE_10116_length_857_cov_6.733509	513	593	0	48	80	0.6000000
NODE_10116_length_857_cov_6.733509	513	593	2	32	80	0.4000000
NODE_10117_length_857_cov_6.251979	298	378	0	80	80	1.0000000
NODE_10117_length_857_cov_6.251979	351	431	0	80	80	1.0000000
NODE_10118_length_857_cov_5.827177	323	403	0	60	80	0.7500000
NODE_10118_length_857_cov_5.827177	323	403	2	20	80	0.2500000
NODE_10118_length_857_cov_5.827177	376	456	0	7	80	0.0875000
NODE_10118_length_857_cov_5.827177	376	456	2	73	80	0.9125000
NODE_10120_length_857_cov_4.530343	362	442	0	80	80	1.0000000
NODE_10120_length_857_cov_4.530343	415	495	0	80	80	1.0000000
NODE_10128_length_857_cov_1.464380	179	249	7	4	70	0.0571429
NODE_10128_length_857_cov_1.464380	179	249	8	6	70	0.0857143
NODE_10128_length_857_cov_1.464380	179	249	12	2	70	0.0285714
NODE_10128_length_857_cov_1.464380	179	249	14	7	70	0.1000000
NODE_10128_length_857_cov_1.464380	179	249	16	2	70	0.0285714
NODE_10128_length_857_cov_1.464380	179	249	17	9	70	0.1285714
NODE_10128_length_857_cov_1.464380	179	249	18	40	70	0.5714286
NODE_10128_length_857_cov_1.464380	222	288	12	8	66	0.1212121
NODE_10128_length_857_cov_1.464380	222	288	14	2	66	0.0303030
NODE_10128_length_857_cov_1.464380	222	288	15	2	66	0.0303030
NODE_10128_length_857_cov_1.464380	222	288	16	29	66	0.4393939
NODE_10128_length_857_cov_1.464380	222	288	17	9	66	0.1363636
NODE_10128_length_857_cov_1.464380	222	288	18	16	66	0.2424242
NODE_10138_length_856_cov_39.147952	157	237	0	80	80	1.0000000
NODE_10138_length_856_cov_39.147952	210	290	0	80	80	1.0000000
NODE_10138_length_856_cov_39.147952	286	366	0	34	80	0.4250000
NODE_10138_length_856_cov_39.147952	286	366	2	46	80	0.5750000
NODE_10138_length_856_cov_39.147952	339	419	2	80	80	1.0000000
NODE_10139_length_856_cov_21.937913	353	433	0	42	80	0.5250000
NODE_10139_length_856_cov_21.937913	353	433	6	38	80	0.4750000
NODE_10139_length_856_cov_21.937913	406	486	0	9	80	0.1125000
NODE_10139_length_856_cov_21.937913	406	486	4	4	80	0.0500000
NODE_10139_length_856_cov_21.937913	406	486	6	67	80	0.8375000
NODE_10140_length_856_cov_20.227213	375	459	0	57	84	0.6785714
NODE_10140_length_856_cov_20.227213	375	459	2	27	84	0.3214286
NODE_10140_length_856_cov_20.227213	432	512	2	80	80	1.0000000
NODE_10141_length_856_cov_18.445178	340	420	0	70	80	0.8750000
NODE_10141_length_856_cov_18.445178	340	420	2	10	80	0.1250000
NODE_10141_length_856_cov_18.445178	393	473	0	17	80	0.2125000
NODE_10141_length_856_cov_18.445178	393	473	2	63	80	0.7875000
NODE_10142_length_856_cov_16.564069	462	543	0	30	81	0.3703704
NODE_10142_length_856_cov_16.564069	462	543	2	51	81	0.6296296
NODE_10142_length_856_cov_16.564069	516	596	0	25	80	0.3125000
NODE_10142_length_856_cov_16.564069	516	596	2	55	80	0.6875000
NODE_10142_length_856_cov_16.564069	516	593	0	22	77	0.2857143
NODE_10142_length_856_cov_16.564069	516	593	2	55	77	0.7142857
NODE_10143_length_856_cov_15.803170	403	483	0	9	80	0.1125000
NODE_10143_length_856_cov_15.803170	403	483	2	71	80	0.8875000
NODE_10143_length_856_cov_15.803170	456	536	0	43	80	0.5375000
NODE_10143_length_856_cov_15.803170	456	536	2	37	80	0.4625000
NODE_10144_length_856_cov_12.904888	345	425	0	26	80	0.3250000
NODE_10144_length_856_cov_12.904888	345	425	2	54	80	0.6750000
NODE_10144_length_856_cov_12.904888	398	478	2	80	80	1.0000000
NODE_10145_length_856_cov_9.881110	338	418	0	80	80	1.0000000
NODE_10145_length_856_cov_9.881110	391	471	0	80	80	1.0000000
NODE_10146_length_856_cov_5.875826	405	485	2	80	80	1.0000000
NODE_10146_length_856_cov_5.875826	458	538	2	53	80	0.6625000
NODE_10146_length_856_cov_5.875826	458	538	3	11	80	0.1375000
NODE_10146_length_856_cov_5.875826	458	538	4	16	80	0.2000000
NODE_10149_length_856_cov_4.821664	466	546	0	17	80	0.2125000
NODE_10149_length_856_cov_4.821664	466	546	2	63	80	0.7875000
NODE_10149_length_856_cov_4.821664	519	599	0	70	80	0.8750000
NODE_10149_length_856_cov_4.821664	519	599	2	10	80	0.1250000
NODE_10151_length_856_cov_4.195509	248	328	0	77	80	0.9625000
NODE_10151_length_856_cov_4.195509	248	328	2	3	80	0.0375000
NODE_10151_length_856_cov_4.195509	301	381	0	80	80	1.0000000
NODE_10152_length_856_cov_3.899604	262	339	0	9	77	0.1168831
NODE_10152_length_856_cov_3.899604	262	339	4	68	77	0.8831169
NODE_10152_length_856_cov_3.899604	312	392	0	62	80	0.7750000
NODE_10152_length_856_cov_3.899604	312	392	4	18	80	0.2250000
NODE_10176_length_855_cov_28.312169	541	621	0	80	80	1.0000000
NODE_10176_length_855_cov_28.312169	594	674	0	80	80	1.0000000
NODE_10177_length_855_cov_19.392857	692	772	4	12	80	0.1500000
NODE_10177_length_855_cov_19.392857	692	772	8	18	80	0.2250000
NODE_10177_length_855_cov_19.392857	692	772	10	14	80	0.1750000
NODE_10177_length_855_cov_19.392857	692	772	12	1	80	0.0125000
NODE_10177_length_855_cov_19.392857	692	772	14	35	80	0.4375000
NODE_10177_length_855_cov_19.392857	745	825	0	31	80	0.3875000
NODE_10177_length_855_cov_19.392857	745	825	4	34	80	0.4250000
NODE_10177_length_855_cov_19.392857	745	825	8	15	80	0.1875000
NODE_10178_length_855_cov_13.402116	343	423	2	27	80	0.3375000
NODE_10178_length_855_cov_13.402116	343	423	4	53	80	0.6625000
NODE_10178_length_855_cov_13.402116	396	476	2	37	80	0.4625000
NODE_10178_length_855_cov_13.402116	396	476	4	43	80	0.5375000
NODE_10179_length_855_cov_13.116402	295	375	0	80	80	1.0000000
NODE_10179_length_855_cov_13.116402	348	428	0	80	80	1.0000000
NODE_10180_length_855_cov_11.179894	360	436	0	76	76	1.0000000
NODE_10180_length_855_cov_11.179894	409	489	0	80	80	1.0000000
NODE_10183_length_855_cov_8.593915	339	419	0	3	80	0.0375000
NODE_10183_length_855_cov_8.593915	339	419	4	77	80	0.9625000
NODE_10183_length_855_cov_8.593915	392	472	0	56	80	0.7000000
NODE_10183_length_855_cov_8.593915	392	472	4	24	80	0.3000000
NODE_10206_length_854_cov_64.200000	586	666	2	57	80	0.7125000
NODE_10206_length_854_cov_64.200000	586	666	4	1	80	0.0125000
NODE_10206_length_854_cov_64.200000	586	666	6	22	80	0.2750000
NODE_10206_length_854_cov_64.200000	639	719	2	4	80	0.0500000
NODE_10206_length_854_cov_64.200000	639	719	4	34	80	0.4250000
NODE_10206_length_854_cov_64.200000	639	719	6	22	80	0.2750000
NODE_10206_length_854_cov_64.200000	639	719	8	20	80	0.2500000
NODE_10207_length_854_cov_46.037086	348	428	4	10	80	0.1250000
NODE_10207_length_854_cov_46.037086	348	428	6	70	80	0.8750000
NODE_10207_length_854_cov_46.037086	401	481	4	8	80	0.1000000
NODE_10207_length_854_cov_46.037086	401	481	6	47	80	0.5875000
NODE_10207_length_854_cov_46.037086	401	481	8	16	80	0.2000000
NODE_10207_length_854_cov_46.037086	401	481	10	9	80	0.1125000
NODE_10207_length_854_cov_46.037086	458	481	6	14	23	0.6086956
NODE_10207_length_854_cov_46.037086	458	481	8	9	23	0.3913043
NODE_10208_length_854_cov_45.633113	393	473	0	26	80	0.3250000
NODE_10208_length_854_cov_45.633113	393	473	2	54	80	0.6750000
NODE_10208_length_854_cov_45.633113	446	526	0	5	80	0.0625000
NODE_10208_length_854_cov_45.633113	446	526	2	75	80	0.9375000
NODE_10209_length_854_cov_40.407947	489	569	0	80	80	1.0000000
NODE_10209_length_854_cov_40.407947	542	622	0	80	80	1.0000000
NODE_10210_length_854_cov_29.773510	450	530	0	16	80	0.2000000
NODE_10210_length_854_cov_29.773510	450	530	1	64	80	0.8000000
NODE_10210_length_854_cov_29.773510	503	583	0	69	80	0.8625000
NODE_10210_length_854_cov_29.773510	503	583	1	11	80	0.1375000
NODE_10211_length_854_cov_22.968212	318	398	2	36	80	0.4500000
NODE_10211_length_854_cov_22.968212	318	398	4	44	80	0.5500000
NODE_10211_length_854_cov_22.968212	371	451	0	30	80	0.3750000
NODE_10211_length_854_cov_22.968212	371	451	2	6	80	0.0750000
NODE_10211_length_854_cov_22.968212	371	451	4	44	80	0.5500000
NODE_10212_length_854_cov_18.038411	387	467	10	21	80	0.2625000
NODE_10212_length_854_cov_18.038411	387	467	14	15	80	0.1875000
NODE_10212_length_854_cov_18.038411	387	467	16	44	80	0.5500000
NODE_10212_length_854_cov_18.038411	440	520	0	13	80	0.1625000
NODE_10212_length_854_cov_18.038411	440	520	8	18	80	0.2250000
NODE_10212_length_854_cov_18.038411	440	520	10	43	80	0.5375000
NODE_10212_length_854_cov_18.038411	440	520	16	6	80	0.0750000
NODE_10213_length_854_cov_13.774834	330	410	0	80	80	1.0000000
NODE_10213_length_854_cov_13.774834	383	463	0	80	80	1.0000000
NODE_10214_length_854_cov_11.998675	366	446	0	80	80	1.0000000
NODE_10214_length_854_cov_11.998675	419	499	0	80	80	1.0000000
NODE_10215_length_854_cov_7.600000	298	378	2	5	80	0.0625000
NODE_10215_length_854_cov_7.600000	298	378	5	20	80	0.2500000
NODE_10215_length_854_cov_7.600000	298	378	6	48	80	0.6000000
NODE_10215_length_854_cov_7.600000	298	378	8	7	80	0.0875000
NODE_10215_length_854_cov_7.600000	351	431	0	40	80	0.5000000
NODE_10215_length_854_cov_7.600000	351	431	2	18	80	0.2250000
NODE_10215_length_854_cov_7.600000	351	431	5	20	80	0.2500000
NODE_10215_length_854_cov_7.600000	351	431	6	2	80	0.0250000
NODE_10218_length_854_cov_4.939073	603	633	0	30	30	1.0000000
NODE_10226_length_854_cov_2.354967	613	633	0	20	20	1.0000000
NODE_10239_length_853_cov_61.988064	380	460	0	4	80	0.0500000
NODE_10239_length_853_cov_61.988064	380	460	9	1	80	0.0125000
NODE_10239_length_853_cov_61.988064	380	460	11	6	80	0.0750000
NODE_10239_length_853_cov_61.988064	380	460	12	13	80	0.1625000
NODE_10239_length_853_cov_61.988064	380	460	13	6	80	0.0750000
NODE_10239_length_853_cov_61.988064	380	460	14	50	80	0.6250000
NODE_10239_length_853_cov_61.988064	433	513	13	27	80	0.3375000
NODE_10239_length_853_cov_61.988064	433	513	14	53	80	0.6625000
NODE_10240_length_853_cov_33.683024	384	464	0	37	80	0.4625000
NODE_10240_length_853_cov_33.683024	384	464	4	43	80	0.5375000
NODE_10240_length_853_cov_33.683024	437	517	0	12	80	0.1500000
NODE_10240_length_853_cov_33.683024	437	517	4	68	80	0.8500000
NODE_10241_length_853_cov_31.965517	224	305	0	15	81	0.1851852
NODE_10241_length_853_cov_31.965517	224	305	2	36	81	0.4444444
NODE_10241_length_853_cov_31.965517	224	305	4	30	81	0.3703704
NODE_10241_length_853_cov_31.965517	278	358	0	21	80	0.2625000
NODE_10241_length_853_cov_31.965517	278	358	2	5	80	0.0625000
NODE_10241_length_853_cov_31.965517	278	358	4	54	80	0.6750000
NODE_10241_length_853_cov_31.965517	354	434	0	12	80	0.1500000
NODE_10241_length_853_cov_31.965517	354	434	9	26	80	0.3250000
NODE_10241_length_853_cov_31.965517	354	434	10	42	80	0.5250000
NODE_10241_length_853_cov_31.965517	407	466	0	5	59	0.0847458
NODE_10241_length_853_cov_31.965517	407	466	6	2	59	0.0338983
NODE_10241_length_853_cov_31.965517	407	466	8	1	59	0.0169492
NODE_10241_length_853_cov_31.965517	407	466	9	35	59	0.5932204
NODE_10241_length_853_cov_31.965517	407	466	10	16	59	0.2711864
NODE_10242_length_853_cov_16.551724	247	327	0	6	80	0.0750000
NODE_10242_length_853_cov_16.551724	247	327	2	74	80	0.9250000
NODE_10242_length_853_cov_16.551724	300	380	0	14	80	0.1750000
NODE_10242_length_853_cov_16.551724	300	380	2	66	80	0.8250000
NODE_10242_length_853_cov_16.551724	376	456	0	33	80	0.4125000
NODE_10242_length_853_cov_16.551724	376	456	3	1	80	0.0125000
NODE_10242_length_853_cov_16.551724	376	456	4	46	80	0.5750000
NODE_10242_length_853_cov_16.551724	429	509	4	80	80	1.0000000
NODE_10243_length_853_cov_15.395225	395	475	0	36	80	0.4500000
NODE_10243_length_853_cov_15.395225	395	475	4	44	80	0.5500000
NODE_10243_length_853_cov_15.395225	448	528	0	80	80	1.0000000
NODE_10244_length_853_cov_15.086207	355	434	10	12	79	0.1518987
NODE_10244_length_853_cov_15.086207	355	434	12	9	79	0.1139240
NODE_10244_length_853_cov_15.086207	355	434	14	27	79	0.3417721
NODE_10244_length_853_cov_15.086207	355	434	16	31	79	0.3924051
NODE_10244_length_853_cov_15.086207	408	488	6	2	80	0.0250000
NODE_10244_length_853_cov_15.086207	408	488	8	5	80	0.0625000
NODE_10244_length_853_cov_15.086207	408	488	10	59	80	0.7375000
NODE_10244_length_853_cov_15.086207	408	488	14	14	80	0.1750000
NODE_10245_length_853_cov_14.929708	160	240	2	71	80	0.8875000
NODE_10245_length_853_cov_14.929708	160	240	4	9	80	0.1125000
NODE_10245_length_853_cov_14.929708	213	293	0	37	80	0.4625000
NODE_10245_length_853_cov_14.929708	213	293	2	43	80	0.5375000
NODE_10246_length_853_cov_11.299735	395	475	0	80	80	1.0000000
NODE_10246_length_853_cov_11.299735	448	528	0	80	80	1.0000000
NODE_10247_length_853_cov_9.571618	479	559	0	40	80	0.5000000
NODE_10247_length_853_cov_9.571618	479	559	2	40	80	0.5000000
NODE_10247_length_853_cov_9.571618	532	612	0	80	80	1.0000000
NODE_10248_length_853_cov_7.828912	265	345	0	80	80	1.0000000
NODE_10248_length_853_cov_7.828912	318	398	0	80	80	1.0000000
NODE_10249_length_853_cov_7.623342	255	335	0	4	80	0.0500000
NODE_10249_length_853_cov_7.623342	255	335	6	34	80	0.4250000
NODE_10249_length_853_cov_7.623342	255	335	10	42	80	0.5250000
NODE_10249_length_853_cov_7.623342	308	388	4	32	80	0.4000000
NODE_10249_length_853_cov_7.623342	308	388	10	48	80	0.6000000
NODE_10253_length_853_cov_3.173740	212	292	0	80	80	1.0000000
NODE_10253_length_853_cov_3.173740	265	343	0	78	78	1.0000000
NODE_10258_length_853_cov_1.823607	710	773	0	63	63	1.0000000
NODE_10258_length_853_cov_1.823607	711	773	0	62	62	1.0000000
NODE_10258_length_853_cov_1.823607	711	773	0	62	62	1.0000000
NODE_10258_length_853_cov_1.823607	746	826	0	80	80	1.0000000
NODE_10267_length_852_cov_30.022576	279	359	0	80	80	1.0000000
NODE_10267_length_852_cov_30.022576	332	412	0	80	80	1.0000000
NODE_10268_length_852_cov_19.373174	353	433	0	80	80	1.0000000
NODE_10268_length_852_cov_19.373174	406	486	0	76	80	0.9500000
NODE_10268_length_852_cov_19.373174	406	486	2	4	80	0.0500000
NODE_10269_length_852_cov_18.853918	297	377	0	20	80	0.2500000
NODE_10269_length_852_cov_18.853918	297	377	2	8	80	0.1000000
NODE_10269_length_852_cov_18.853918	297	377	4	52	80	0.6500000
NODE_10269_length_852_cov_18.853918	350	430	0	73	80	0.9125000
NODE_10269_length_852_cov_18.853918	350	430	2	7	80	0.0875000
NODE_10269_length_852_cov_18.853918	426	506	0	16	80	0.2000000
NODE_10269_length_852_cov_18.853918	426	506	2	64	80	0.8000000
NODE_10269_length_852_cov_18.853918	489	559	0	8	70	0.1142857
NODE_10269_length_852_cov_18.853918	489	559	2	62	70	0.8857143
NODE_10270_length_852_cov_17.391766	472	552	0	80	80	1.0000000
NODE_10270_length_852_cov_17.391766	525	605	0	80	80	1.0000000
NODE_10271_length_852_cov_8.818061	513	593	2	80	80	1.0000000
NODE_10271_length_852_cov_8.818061	566	646	0	32	80	0.4000000
NODE_10271_length_852_cov_8.818061	566	646	2	48	80	0.6000000
NODE_10274_length_852_cov_4.403718	493	573	0	80	80	1.0000000
NODE_10274_length_852_cov_4.403718	546	626	0	80	80	1.0000000
NODE_10285_length_851_cov_33.953457	329	409	2	47	80	0.5875000
NODE_10285_length_851_cov_33.953457	329	409	4	33	80	0.4125000
NODE_10285_length_851_cov_33.953457	382	462	0	19	80	0.2375000
NODE_10285_length_851_cov_33.953457	382	462	2	61	80	0.7625000
NODE_10286_length_851_cov_30.488032	395	475	10	17	80	0.2125000
NODE_10286_length_851_cov_30.488032	395	475	12	4	80	0.0500000
NODE_10286_length_851_cov_30.488032	395	475	14	16	80	0.2000000
NODE_10286_length_851_cov_30.488032	395	475	22	43	80	0.5375000
NODE_10286_length_851_cov_30.488032	448	528	8	18	80	0.2250000
NODE_10286_length_851_cov_30.488032	448	528	10	5	80	0.0625000
NODE_10286_length_851_cov_30.488032	448	528	19	1	80	0.0125000
NODE_10286_length_851_cov_30.488032	448	528	20	14	80	0.1750000
NODE_10286_length_851_cov_30.488032	448	528	22	42	80	0.5250000
NODE_10287_length_851_cov_27.481383	353	433	2	18	80	0.2250000
NODE_10287_length_851_cov_27.481383	353	433	4	2	80	0.0250000
NODE_10287_length_851_cov_27.481383	353	433	6	51	80	0.6375000
NODE_10287_length_851_cov_27.481383	353	433	8	9	80	0.1125000
NODE_10287_length_851_cov_27.481383	406	486	2	29	80	0.3625000
NODE_10287_length_851_cov_27.481383	406	486	4	24	80	0.3000000
NODE_10287_length_851_cov_27.481383	406	486	6	18	80	0.2250000
NODE_10287_length_851_cov_27.481383	406	486	8	9	80	0.1125000
NODE_10288_length_851_cov_23.656915	345	425	2	23	80	0.2875000
NODE_10288_length_851_cov_23.656915	345	425	4	57	80	0.7125000
NODE_10288_length_851_cov_23.656915	398	478	2	63	80	0.7875000
NODE_10288_length_851_cov_23.656915	398	478	4	17	80	0.2125000
NODE_10289_length_851_cov_19.769947	298	378	0	80	80	1.0000000
NODE_10289_length_851_cov_19.769947	351	431	0	80	80	1.0000000
NODE_10290_length_851_cov_17.386968	459	539	0	28	80	0.3500000
NODE_10290_length_851_cov_17.386968	459	539	2	52	80	0.6500000
NODE_10290_length_851_cov_17.386968	512	592	2	80	80	1.0000000
NODE_10291_length_851_cov_13.519947	323	403	0	66	80	0.8250000
NODE_10291_length_851_cov_13.519947	323	403	2	14	80	0.1750000
NODE_10291_length_851_cov_13.519947	376	456	0	45	80	0.5625000
NODE_10291_length_851_cov_13.519947	376	456	2	35	80	0.4375000
NODE_10292_length_851_cov_11.771277	403	483	0	80	80	1.0000000
NODE_10292_length_851_cov_11.771277	456	536	0	80	80	1.0000000
NODE_10293_length_851_cov_11.698138	227	307	0	80	80	1.0000000
NODE_10293_length_851_cov_11.698138	280	360	0	79	80	0.9875000
NODE_10293_length_851_cov_11.698138	280	360	2	1	80	0.0125000
NODE_10293_length_851_cov_11.698138	356	436	0	3	80	0.0375000
NODE_10293_length_851_cov_11.698138	356	436	2	38	80	0.4750000
NODE_10293_length_851_cov_11.698138	356	436	4	27	80	0.3375000
NODE_10293_length_851_cov_11.698138	356	436	6	10	80	0.1250000
NODE_10293_length_851_cov_11.698138	356	436	8	2	80	0.0250000
NODE_10293_length_851_cov_11.698138	409	489	4	33	80	0.4125000
NODE_10293_length_851_cov_11.698138	409	489	6	11	80	0.1375000
NODE_10293_length_851_cov_11.698138	409	489	8	36	80	0.4500000
NODE_10294_length_851_cov_11.672872	372	452	2	80	80	1.0000000
NODE_10294_length_851_cov_11.672872	425	505	0	13	80	0.1625000
NODE_10294_length_851_cov_11.672872	425	505	2	67	80	0.8375000
NODE_10295_length_851_cov_10.938830	418	499	0	2	81	0.0246914
NODE_10295_length_851_cov_10.938830	418	499	2	16	81	0.1975309
NODE_10295_length_851_cov_10.938830	418	499	4	63	81	0.7777778
NODE_10296_length_851_cov_10.074468	454	534	0	32	80	0.4000000
NODE_10296_length_851_cov_10.074468	454	534	4	48	80	0.6000000
NODE_10296_length_851_cov_10.074468	507	587	4	80	80	1.0000000
NODE_10297_length_851_cov_7.599734	330	410	0	80	80	1.0000000
NODE_10297_length_851_cov_7.599734	383	463	0	53	80	0.6625000
NODE_10297_length_851_cov_7.599734	383	463	2	27	80	0.3375000
NODE_10298_length_851_cov_5.639628	379	459	0	80	80	1.0000000
NODE_10298_length_851_cov_5.639628	432	512	0	80	80	1.0000000
NODE_10300_length_851_cov_3.880319	729	765	0	36	36	1.0000000
NODE_10300_length_851_cov_3.880319	743	824	0	81	81	1.0000000
NODE_10301_length_851_cov_3.823138	380	460	0	4	80	0.0500000
NODE_10301_length_851_cov_3.823138	380	460	2	76	80	0.9500000
NODE_10301_length_851_cov_3.823138	433	513	0	46	80	0.5750000
NODE_10301_length_851_cov_3.823138	433	513	2	34	80	0.4250000
NODE_10318_length_851_cov_1.130319	33	103	0	70	70	1.0000000
NODE_10326_length_850_cov_36.527297	360	440	12	22	80	0.2750000
NODE_10326_length_850_cov_36.527297	360	440	14	58	80	0.7250000
NODE_10326_length_850_cov_36.527297	413	493	0	52	80	0.6500000
NODE_10326_length_850_cov_36.527297	413	493	11	1	80	0.0125000
NODE_10326_length_850_cov_36.527297	413	493	12	22	80	0.2750000
NODE_10326_length_850_cov_36.527297	413	493	14	5	80	0.0625000
NODE_10327_length_850_cov_31.006658	330	410	0	39	80	0.4875000
NODE_10327_length_850_cov_31.006658	330	410	2	41	80	0.5125000
NODE_10327_length_850_cov_31.006658	383	463	2	33	80	0.4125000
NODE_10327_length_850_cov_31.006658	383	463	4	19	80	0.2375000
NODE_10327_length_850_cov_31.006658	383	463	6	28	80	0.3500000
NODE_10328_length_850_cov_30.460719	251	331	2	33	80	0.4125000
NODE_10328_length_850_cov_30.460719	251	331	10	47	80	0.5875000
NODE_10328_length_850_cov_30.460719	304	384	7	2	80	0.0250000
NODE_10328_length_850_cov_30.460719	304	384	8	31	80	0.3875000
NODE_10328_length_850_cov_30.460719	304	384	10	47	80	0.5875000
NODE_10329_length_850_cov_25.263648	355	435	5	2	80	0.0250000
NODE_10329_length_850_cov_25.263648	355	435	6	6	80	0.0750000
NODE_10329_length_850_cov_25.263648	355	435	7	1	80	0.0125000
NODE_10329_length_850_cov_25.263648	355	435	8	71	80	0.8875000
NODE_10329_length_850_cov_25.263648	408	488	3	26	80	0.3250000
NODE_10329_length_850_cov_25.263648	408	488	5	29	80	0.3625000
NODE_10329_length_850_cov_25.263648	408	488	7	1	80	0.0125000
NODE_10329_length_850_cov_25.263648	408	488	8	24	80	0.3000000
NODE_10330_length_850_cov_21.368842	290	370	0	24	80	0.3000000
NODE_10330_length_850_cov_21.368842	290	370	6	56	80	0.7000000
NODE_10330_length_850_cov_21.368842	343	423	2	20	80	0.2500000
NODE_10330_length_850_cov_21.368842	343	423	6	60	80	0.7500000
NODE_10331_length_850_cov_20.500666	318	398	0	23	80	0.2875000
NODE_10331_length_850_cov_20.500666	318	398	4	57	80	0.7125000
NODE_10331_length_850_cov_20.500666	371	451	0	27	80	0.3375000
NODE_10331_length_850_cov_20.500666	371	451	4	53	80	0.6625000
NODE_10332_length_850_cov_17.268975	398	478	0	80	80	1.0000000
NODE_10332_length_850_cov_17.268975	451	531	0	80	80	1.0000000
NODE_10333_length_850_cov_14.728362	379	459	0	20	80	0.2500000
NODE_10333_length_850_cov_14.728362	379	459	4	60	80	0.7500000
NODE_10333_length_850_cov_14.728362	432	512	0	73	80	0.9125000
NODE_10333_length_850_cov_14.728362	432	512	4	7	80	0.0875000
NODE_10334_length_850_cov_14.230360	313	393	0	80	80	1.0000000
NODE_10334_length_850_cov_14.230360	366	446	0	80	80	1.0000000
NODE_10335_length_850_cov_12.387483	337	417	0	80	80	1.0000000
NODE_10335_length_850_cov_12.387483	390	470	0	80	80	1.0000000
NODE_10335_length_850_cov_12.387483	466	545	0	79	79	1.0000000
NODE_10335_length_850_cov_12.387483	518	598	0	64	80	0.8000000
NODE_10335_length_850_cov_12.387483	518	598	2	16	80	0.2000000
NODE_10336_length_850_cov_11.402130	329	409	0	80	80	1.0000000
NODE_10336_length_850_cov_11.402130	382	462	0	80	80	1.0000000
NODE_10337_length_850_cov_10.326232	330	410	0	20	80	0.2500000
NODE_10337_length_850_cov_10.326232	330	410	2	60	80	0.7500000
NODE_10337_length_850_cov_10.326232	383	463	2	80	80	1.0000000
NODE_10338_length_850_cov_9.675100	464	544	0	80	80	1.0000000
NODE_10338_length_850_cov_9.675100	517	597	0	80	80	1.0000000
NODE_10367_length_849_cov_43.137333	336	416	0	80	80	1.0000000
NODE_10367_length_849_cov_43.137333	389	469	0	80	80	1.0000000
NODE_10368_length_849_cov_36.562667	326	406	0	68	80	0.8500000
NODE_10368_length_849_cov_36.562667	326	406	2	12	80	0.1500000
NODE_10368_length_849_cov_36.562667	379	459	0	26	80	0.3250000
NODE_10368_length_849_cov_36.562667	379	459	2	54	80	0.6750000
NODE_10369_length_849_cov_35.449333	408	488	0	5	80	0.0625000
NODE_10369_length_849_cov_35.449333	408	488	4	5	80	0.0625000
NODE_10369_length_849_cov_35.449333	408	488	8	12	80	0.1500000
NODE_10369_length_849_cov_35.449333	408	488	10	36	80	0.4500000
NODE_10369_length_849_cov_35.449333	408	488	14	22	80	0.2750000
NODE_10369_length_849_cov_35.449333	461	541	8	14	80	0.1750000
NODE_10369_length_849_cov_35.449333	461	541	10	22	80	0.2750000
NODE_10369_length_849_cov_35.449333	461	541	12	6	80	0.0750000
NODE_10369_length_849_cov_35.449333	461	541	14	38	80	0.4750000
NODE_10370_length_849_cov_29.989333	332	412	4	3	80	0.0375000
NODE_10370_length_849_cov_29.989333	332	412	8	15	80	0.1875000
NODE_10370_length_849_cov_29.989333	332	412	10	39	80	0.4875000
NODE_10370_length_849_cov_29.989333	332	412	12	23	80	0.2875000
NODE_10370_length_849_cov_29.989333	385	465	4	7	80	0.0875000
NODE_10370_length_849_cov_29.989333	385	465	6	49	80	0.6125000
NODE_10370_length_849_cov_29.989333	385	465	8	1	80	0.0125000
NODE_10370_length_849_cov_29.989333	385	465	12	23	80	0.2875000
NODE_10371_length_849_cov_17.974667	343	423	0	10	80	0.1250000
NODE_10371_length_849_cov_17.974667	343	423	2	44	80	0.5500000
NODE_10371_length_849_cov_17.974667	343	423	4	26	80	0.3250000
NODE_10371_length_849_cov_17.974667	396	476	0	20	80	0.2500000
NODE_10371_length_849_cov_17.974667	396	476	2	46	80	0.5750000
NODE_10371_length_849_cov_17.974667	396	476	4	14	80	0.1750000
NODE_10372_length_849_cov_17.018667	360	440	0	24	80	0.3000000
NODE_10372_length_849_cov_17.018667	360	440	2	33	80	0.4125000
NODE_10372_length_849_cov_17.018667	360	440	6	23	80	0.2875000
NODE_10372_length_849_cov_17.018667	416	493	2	1	77	0.0129870
NODE_10372_length_849_cov_17.018667	416	493	4	29	77	0.3766234
NODE_10372_length_849_cov_17.018667	416	493	6	47	77	0.6103896
NODE_10373_length_849_cov_15.581333	287	367	0	7	80	0.0875000
NODE_10373_length_849_cov_15.581333	287	367	2	50	80	0.6250000
NODE_10373_length_849_cov_15.581333	287	367	4	23	80	0.2875000
NODE_10373_length_849_cov_15.581333	340	420	2	4	80	0.0500000
NODE_10373_length_849_cov_15.581333	340	420	4	76	80	0.9500000
NODE_10373_length_849_cov_15.581333	416	496	0	33	80	0.4125000
NODE_10373_length_849_cov_15.581333	416	496	2	19	80	0.2375000
NODE_10373_length_849_cov_15.581333	416	496	4	28	80	0.3500000
NODE_10373_length_849_cov_15.581333	469	549	0	80	80	1.0000000
NODE_10374_length_849_cov_9.460000	370	450	0	2	80	0.0250000
NODE_10374_length_849_cov_9.460000	370	450	2	10	80	0.1250000
NODE_10374_length_849_cov_9.460000	370	450	9	1	80	0.0125000
NODE_10374_length_849_cov_9.460000	370	450	10	67	80	0.8375000
NODE_10374_length_849_cov_9.460000	423	503	0	55	80	0.6875000
NODE_10374_length_849_cov_9.460000	423	503	2	10	80	0.1250000
NODE_10374_length_849_cov_9.460000	423	503	9	1	80	0.0125000
NODE_10374_length_849_cov_9.460000	423	503	10	14	80	0.1750000
NODE_10375_length_849_cov_4.893333	427	507	0	25	80	0.3125000
NODE_10375_length_849_cov_4.893333	427	507	2	55	80	0.6875000
NODE_10375_length_849_cov_4.893333	480	560	0	78	80	0.9750000
NODE_10375_length_849_cov_4.893333	480	560	2	2	80	0.0250000
NODE_10376_length_849_cov_4.860000	380	460	0	80	80	1.0000000
NODE_10376_length_849_cov_4.860000	433	513	0	80	80	1.0000000
NODE_10379_length_849_cov_2.761333	254	334	0	13	80	0.1625000
NODE_10379_length_849_cov_2.761333	254	334	2	67	80	0.8375000
NODE_10396_length_848_cov_27.287049	253	333	0	4	80	0.0500000
NODE_10396_length_848_cov_27.287049	253	333	2	42	80	0.5250000
NODE_10396_length_848_cov_27.287049	253	333	4	9	80	0.1125000
NODE_10396_length_848_cov_27.287049	253	333	6	25	80	0.3125000
NODE_10396_length_848_cov_27.287049	306	386	0	57	80	0.7125000
NODE_10396_length_848_cov_27.287049	306	386	2	23	80	0.2875000
NODE_10396_length_848_cov_27.287049	382	458	0	39	76	0.5131579
NODE_10396_length_848_cov_27.287049	382	458	4	37	76	0.4868421
NODE_10396_length_848_cov_27.287049	435	513	4	29	78	0.3717949
NODE_10396_length_848_cov_27.287049	435	513	6	49	78	0.6282051
NODE_10397_length_848_cov_23.511348	248	328	0	80	80	1.0000000
NODE_10397_length_848_cov_23.511348	301	381	0	80	80	1.0000000
NODE_10397_length_848_cov_23.511348	377	457	0	80	80	1.0000000
NODE_10397_length_848_cov_23.511348	430	508	0	78	78	1.0000000
NODE_10398_length_848_cov_21.939920	295	375	0	39	80	0.4875000
NODE_10398_length_848_cov_21.939920	295	375	2	20	80	0.2500000
NODE_10398_length_848_cov_21.939920	295	375	6	21	80	0.2625000
NODE_10398_length_848_cov_21.939920	348	428	2	6	80	0.0750000
NODE_10398_length_848_cov_21.939920	348	428	6	48	80	0.6000000
NODE_10398_length_848_cov_21.939920	348	428	8	26	80	0.3250000
NODE_10399_length_848_cov_21.937250	434	514	0	29	80	0.3625000
NODE_10399_length_848_cov_21.937250	434	514	2	14	80	0.1750000
NODE_10399_length_848_cov_21.937250	434	514	4	37	80	0.4625000
NODE_10399_length_848_cov_21.937250	487	567	0	13	80	0.1625000
NODE_10399_length_848_cov_21.937250	487	567	2	56	80	0.7000000
NODE_10399_length_848_cov_21.937250	487	567	4	11	80	0.1375000
NODE_10400_length_848_cov_19.500668	367	392	0	25	25	1.0000000
NODE_10400_length_848_cov_19.500668	388	468	0	80	80	1.0000000
NODE_10400_length_848_cov_19.500668	441	521	0	80	80	1.0000000
NODE_10400_length_848_cov_19.500668	443	512	0	69	69	1.0000000
NODE_10400_length_848_cov_19.500668	443	472	0	29	29	1.0000000
NODE_10401_length_848_cov_16.566088	323	403	0	80	80	1.0000000
NODE_10401_length_848_cov_16.566088	376	456	0	80	80	1.0000000
NODE_10402_length_848_cov_16.109479	256	336	0	26	80	0.3250000
NODE_10402_length_848_cov_16.109479	256	336	2	9	80	0.1125000
NODE_10402_length_848_cov_16.109479	256	336	4	7	80	0.0875000
NODE_10402_length_848_cov_16.109479	256	336	8	1	80	0.0125000
NODE_10402_length_848_cov_16.109479	256	336	10	37	80	0.4625000
NODE_10402_length_848_cov_16.109479	309	389	0	79	80	0.9875000
NODE_10402_length_848_cov_16.109479	309	389	2	1	80	0.0125000
NODE_10402_length_848_cov_16.109479	385	465	0	80	80	1.0000000
NODE_10402_length_848_cov_16.109479	438	518	0	80	80	1.0000000
NODE_10403_length_848_cov_15.919893	492	568	12	11	76	0.1447368
NODE_10403_length_848_cov_15.919893	492	568	14	7	76	0.0921053
NODE_10403_length_848_cov_15.919893	492	568	16	58	76	0.7631579
NODE_10403_length_848_cov_15.919893	541	621	0	4	80	0.0500000
NODE_10403_length_848_cov_15.919893	541	621	9	2	80	0.0250000
NODE_10403_length_848_cov_15.919893	541	621	10	46	80	0.5750000
NODE_10403_length_848_cov_15.919893	541	621	12	12	80	0.1500000
NODE_10403_length_848_cov_15.919893	541	621	16	16	80	0.2000000
NODE_10404_length_848_cov_13.979973	269	349	0	80	80	1.0000000
NODE_10404_length_848_cov_13.979973	322	402	0	80	80	1.0000000
NODE_10405_length_848_cov_13.073431	343	423	6	8	80	0.1000000
NODE_10405_length_848_cov_13.073431	343	423	8	24	80	0.3000000
NODE_10405_length_848_cov_13.073431	343	423	10	48	80	0.6000000
NODE_10405_length_848_cov_13.073431	396	476	2	38	80	0.4750000
NODE_10405_length_848_cov_13.073431	396	476	4	5	80	0.0625000
NODE_10405_length_848_cov_13.073431	396	476	8	12	80	0.1500000
NODE_10405_length_848_cov_13.073431	396	476	10	25	80	0.3125000
NODE_10406_length_848_cov_8.523364	232	312	0	2	80	0.0250000
NODE_10406_length_848_cov_8.523364	232	312	2	17	80	0.2125000
NODE_10406_length_848_cov_8.523364	232	312	4	61	80	0.7625000
NODE_10406_length_848_cov_8.523364	285	365	0	55	80	0.6875000
NODE_10406_length_848_cov_8.523364	285	365	2	9	80	0.1125000
NODE_10406_length_848_cov_8.523364	285	365	4	16	80	0.2000000
NODE_10406_length_848_cov_8.523364	361	441	0	80	80	1.0000000
NODE_10406_length_848_cov_8.523364	414	494	0	80	80	1.0000000
NODE_10408_length_848_cov_5.903872	251	331	0	19	80	0.2375000
NODE_10408_length_848_cov_5.903872	251	331	2	61	80	0.7625000
NODE_10408_length_848_cov_5.903872	304	383	0	3	79	0.0379747
NODE_10408_length_848_cov_5.903872	304	383	2	76	79	0.9620253
NODE_10409_length_848_cov_5.236315	378	458	0	80	80	1.0000000
NODE_10409_length_848_cov_5.236315	431	507	0	76	76	1.0000000
NODE_10424_length_847_cov_56.417112	576	656	4	8	80	0.1000000
NODE_10424_length_847_cov_56.417112	576	656	12	6	80	0.0750000
NODE_10424_length_847_cov_56.417112	576	656	16	8	80	0.1000000
NODE_10424_length_847_cov_56.417112	576	656	18	42	80	0.5250000
NODE_10424_length_847_cov_56.417112	576	656	19	1	80	0.0125000
NODE_10424_length_847_cov_56.417112	576	656	20	15	80	0.1875000
NODE_10424_length_847_cov_56.417112	629	709	4	61	80	0.7625000
NODE_10424_length_847_cov_56.417112	629	709	12	6	80	0.0750000
NODE_10424_length_847_cov_56.417112	629	709	19	1	80	0.0125000
NODE_10424_length_847_cov_56.417112	629	709	20	12	80	0.1500000
NODE_10425_length_847_cov_27.292781	390	470	0	12	80	0.1500000
NODE_10425_length_847_cov_27.292781	390	470	2	68	80	0.8500000
NODE_10425_length_847_cov_27.292781	443	523	2	37	80	0.4625000
NODE_10425_length_847_cov_27.292781	443	523	4	17	80	0.2125000
NODE_10425_length_847_cov_27.292781	443	523	7	1	80	0.0125000
NODE_10425_length_847_cov_27.292781	443	523	8	25	80	0.3125000
NODE_10426_length_847_cov_24.954545	342	422	6	44	80	0.5500000
NODE_10426_length_847_cov_24.954545	342	422	10	36	80	0.4500000
NODE_10426_length_847_cov_24.954545	395	475	6	4	80	0.0500000
NODE_10426_length_847_cov_24.954545	395	475	10	64	80	0.8000000
NODE_10426_length_847_cov_24.954545	395	475	12	12	80	0.1500000
NODE_10427_length_847_cov_20.310160	341	421	0	80	80	1.0000000
NODE_10427_length_847_cov_20.310160	394	474	0	80	80	1.0000000
NODE_10428_length_847_cov_19.002674	368	448	0	54	80	0.6750000
NODE_10428_length_847_cov_19.002674	368	448	2	26	80	0.3250000
NODE_10428_length_847_cov_19.002674	421	501	0	1	80	0.0125000
NODE_10428_length_847_cov_19.002674	421	501	2	79	80	0.9875000
NODE_10429_length_847_cov_16.879679	218	298	2	42	80	0.5250000
NODE_10429_length_847_cov_16.879679	218	298	5	8	80	0.1000000
NODE_10429_length_847_cov_16.879679	218	298	6	12	80	0.1500000
NODE_10429_length_847_cov_16.879679	218	298	7	18	80	0.2250000
NODE_10429_length_847_cov_16.879679	271	351	0	4	80	0.0500000
NODE_10429_length_847_cov_16.879679	271	351	5	8	80	0.1000000
NODE_10429_length_847_cov_16.879679	271	351	6	61	80	0.7625000
NODE_10429_length_847_cov_16.879679	271	351	7	7	80	0.0875000
NODE_10431_length_847_cov_11.784759	298	378	0	80	80	1.0000000
NODE_10431_length_847_cov_11.784759	351	431	0	80	80	1.0000000
NODE_10431_length_847_cov_11.784759	427	507	0	80	80	1.0000000
NODE_10431_length_847_cov_11.784759	480	560	0	80	80	1.0000000
NODE_10432_length_847_cov_11.604278	407	487	0	7	80	0.0875000
NODE_10432_length_847_cov_11.604278	407	487	2	73	80	0.9125000
NODE_10432_length_847_cov_11.604278	460	540	0	48	80	0.6000000
NODE_10432_length_847_cov_11.604278	460	540	2	32	80	0.4000000
NODE_10433_length_847_cov_10.221925	395	475	0	80	80	1.0000000
NODE_10433_length_847_cov_10.221925	448	528	0	80	80	1.0000000
NODE_10434_length_847_cov_4.602941	97	154	14	9	57	0.1578947
NODE_10434_length_847_cov_4.602941	97	154	16	4	57	0.0701754
NODE_10434_length_847_cov_4.602941	97	154	20	1	57	0.0175439
NODE_10434_length_847_cov_4.602941	97	154	22	3	57	0.0526316
NODE_10434_length_847_cov_4.602941	97	154	24	28	57	0.4912281
NODE_10434_length_847_cov_4.602941	97	154	26	12	57	0.2105263
NODE_10434_length_847_cov_4.602941	127	207	0	9	80	0.1125000
NODE_10434_length_847_cov_4.602941	127	207	2	9	80	0.1125000
NODE_10434_length_847_cov_4.602941	127	207	6	4	80	0.0500000
NODE_10434_length_847_cov_4.602941	127	207	12	4	80	0.0500000
NODE_10434_length_847_cov_4.602941	127	207	14	36	80	0.4500000
NODE_10434_length_847_cov_4.602941	127	207	16	4	80	0.0500000
NODE_10434_length_847_cov_4.602941	127	207	20	1	80	0.0125000
NODE_10434_length_847_cov_4.602941	127	207	22	3	80	0.0375000
NODE_10434_length_847_cov_4.602941	127	207	24	10	80	0.1250000
NODE_10456_length_846_cov_39.476573	336	416	2	80	80	1.0000000
NODE_10456_length_846_cov_39.476573	389	469	0	49	80	0.6125000
NODE_10456_length_846_cov_39.476573	389	469	2	31	80	0.3875000
NODE_10456_length_846_cov_39.476573	465	545	0	12	80	0.1500000
NODE_10456_length_846_cov_39.476573	465	545	6	68	80	0.8500000
NODE_10456_length_846_cov_39.476573	518	598	0	3	80	0.0375000
NODE_10456_length_846_cov_39.476573	518	598	4	11	80	0.1375000
NODE_10456_length_846_cov_39.476573	518	598	5	7	80	0.0875000
NODE_10456_length_846_cov_39.476573	518	598	6	59	80	0.7375000
NODE_10457_length_846_cov_37.297189	312	392	1	8	80	0.1000000
NODE_10457_length_846_cov_37.297189	312	392	2	1	80	0.0125000
NODE_10457_length_846_cov_37.297189	312	392	3	33	80	0.4125000
NODE_10457_length_846_cov_37.297189	312	392	4	38	80	0.4750000
NODE_10457_length_846_cov_37.297189	365	445	2	22	80	0.2750000
NODE_10457_length_846_cov_37.297189	365	445	3	44	80	0.5500000
NODE_10457_length_846_cov_37.297189	365	445	4	14	80	0.1750000
NODE_10458_length_846_cov_32.852744	279	359	0	80	80	1.0000000
NODE_10458_length_846_cov_32.852744	332	412	0	44	80	0.5500000
NODE_10458_length_846_cov_32.852744	332	412	2	36	80	0.4500000
NODE_10459_length_846_cov_31.717537	290	370	0	63	80	0.7875000
NODE_10459_length_846_cov_31.717537	290	370	2	17	80	0.2125000
NODE_10459_length_846_cov_31.717537	343	423	0	10	80	0.1250000
NODE_10459_length_846_cov_31.717537	343	423	2	70	80	0.8750000
NODE_10460_length_846_cov_24.380187	350	430	0	80	80	1.0000000
NODE_10460_length_846_cov_24.380187	403	483	0	80	80	1.0000000
NODE_10461_length_846_cov_16.155288	364	444	4	4	80	0.0500000
NODE_10461_length_846_cov_16.155288	364	444	6	76	80	0.9500000
NODE_10461_length_846_cov_16.155288	417	497	0	25	80	0.3125000
NODE_10461_length_846_cov_16.155288	417	497	2	24	80	0.3000000
NODE_10461_length_846_cov_16.155288	417	497	4	8	80	0.1000000
NODE_10461_length_846_cov_16.155288	417	497	6	23	80	0.2875000
NODE_10462_length_846_cov_15.917001	398	478	0	80	80	1.0000000
NODE_10462_length_846_cov_15.917001	451	531	0	80	80	1.0000000
NODE_10463_length_846_cov_15.275770	355	435	0	80	80	1.0000000
NODE_10463_length_846_cov_15.275770	408	488	0	80	80	1.0000000
NODE_10464_length_846_cov_13.618474	216	296	0	80	80	1.0000000
NODE_10464_length_846_cov_13.618474	269	349	0	48	80	0.6000000
NODE_10464_length_846_cov_13.618474	269	349	2	32	80	0.4000000
NODE_10464_length_846_cov_13.618474	345	425	2	13	80	0.1625000
NODE_10464_length_846_cov_13.618474	345	425	4	41	80	0.5125000
NODE_10464_length_846_cov_13.618474	345	425	8	26	80	0.3250000
NODE_10464_length_846_cov_13.618474	398	478	0	8	80	0.1000000
NODE_10464_length_846_cov_13.618474	398	478	4	12	80	0.1500000
NODE_10464_length_846_cov_13.618474	398	478	6	16	80	0.2000000
NODE_10464_length_846_cov_13.618474	398	478	8	44	80	0.5500000
NODE_10465_length_846_cov_12.878179	425	505	0	23	80	0.2875000
NODE_10465_length_846_cov_12.878179	425	505	2	57	80	0.7125000
NODE_10465_length_846_cov_12.878179	478	558	0	11	80	0.1375000
NODE_10465_length_846_cov_12.878179	478	558	2	69	80	0.8625000
NODE_10467_length_846_cov_7.232932	407	487	0	80	80	1.0000000
NODE_10467_length_846_cov_7.232932	460	540	0	63	80	0.7875000
NODE_10467_length_846_cov_7.232932	460	540	2	17	80	0.2125000
NODE_10468_length_846_cov_6.776439	320	400	0	80	80	1.0000000
NODE_10468_length_846_cov_6.776439	373	453	0	80	80	1.0000000
NODE_10472_length_846_cov_3.025435	190	270	0	80	80	1.0000000
NODE_10472_length_846_cov_3.025435	243	323	0	80	80	1.0000000
NODE_10488_length_845_cov_34.458445	213	293	0	4	80	0.0500000
NODE_10488_length_845_cov_34.458445	213	293	2	76	80	0.9500000
NODE_10488_length_845_cov_34.458445	266	346	0	57	80	0.7125000
NODE_10488_length_845_cov_34.458445	266	346	2	23	80	0.2875000
NODE_10489_length_845_cov_33.025469	309	389	0	32	80	0.4000000
NODE_10489_length_845_cov_33.025469	309	389	2	48	80	0.6000000
NODE_10489_length_845_cov_33.025469	362	442	0	80	80	1.0000000
NODE_10490_length_845_cov_30.331099	288	368	2	25	80	0.3125000
NODE_10490_length_845_cov_30.331099	288	368	4	24	80	0.3000000
NODE_10490_length_845_cov_30.331099	288	368	6	26	80	0.3250000
NODE_10490_length_845_cov_30.331099	288	368	8	5	80	0.0625000
NODE_10490_length_845_cov_30.331099	341	421	4	17	80	0.2125000
NODE_10490_length_845_cov_30.331099	341	421	6	62	80	0.7750000
NODE_10490_length_845_cov_30.331099	341	421	8	1	80	0.0125000
NODE_10491_length_845_cov_22.042895	455	535	14	25	80	0.3125000
NODE_10491_length_845_cov_22.042895	455	535	16	24	80	0.3000000
NODE_10491_length_845_cov_22.042895	455	535	24	1	80	0.0125000
NODE_10491_length_845_cov_22.042895	455	535	26	28	80	0.3500000
NODE_10491_length_845_cov_22.042895	455	535	27	1	80	0.0125000
NODE_10491_length_845_cov_22.042895	455	535	28	1	80	0.0125000
NODE_10491_length_845_cov_22.042895	508	588	0	18	80	0.2250000
NODE_10491_length_845_cov_22.042895	508	588	2	5	80	0.0625000
NODE_10491_length_845_cov_22.042895	508	588	4	16	80	0.2000000
NODE_10491_length_845_cov_22.042895	508	588	12	1	80	0.0125000
NODE_10491_length_845_cov_22.042895	508	588	14	38	80	0.4750000
NODE_10491_length_845_cov_22.042895	508	588	16	2	80	0.0250000
NODE_10492_length_845_cov_20.662198	325	406	4	24	81	0.2962963
NODE_10492_length_845_cov_20.662198	325	406	6	12	81	0.1481481
NODE_10492_length_845_cov_20.662198	325	406	8	41	81	0.5061728
NODE_10492_length_845_cov_20.662198	325	406	10	4	81	0.0493827
NODE_10492_length_845_cov_20.662198	379	459	4	1	80	0.0125000
NODE_10492_length_845_cov_20.662198	379	459	6	12	80	0.1500000
NODE_10492_length_845_cov_20.662198	379	459	8	10	80	0.1250000
NODE_10492_length_845_cov_20.662198	379	459	9	20	80	0.2500000
NODE_10492_length_845_cov_20.662198	379	459	10	37	80	0.4625000
NODE_10493_length_845_cov_17.214477	352	432	6	2	80	0.0250000
NODE_10493_length_845_cov_17.214477	352	432	10	39	80	0.4875000
NODE_10493_length_845_cov_17.214477	352	432	12	7	80	0.0875000
NODE_10493_length_845_cov_17.214477	352	432	16	32	80	0.4000000
NODE_10493_length_845_cov_17.214477	405	485	3	16	80	0.2000000
NODE_10493_length_845_cov_17.214477	405	485	9	2	80	0.0250000
NODE_10493_length_845_cov_17.214477	405	485	11	16	80	0.2000000
NODE_10493_length_845_cov_17.214477	405	485	15	4	80	0.0500000
NODE_10493_length_845_cov_17.214477	405	485	16	42	80	0.5250000
NODE_10494_length_845_cov_15.805630	409	489	0	66	80	0.8250000
NODE_10494_length_845_cov_15.805630	409	489	2	14	80	0.1750000
NODE_10494_length_845_cov_15.805630	462	542	0	17	80	0.2125000
NODE_10494_length_845_cov_15.805630	462	542	2	63	80	0.7875000
NODE_10495_length_845_cov_13.443700	329	409	6	12	80	0.1500000
NODE_10495_length_845_cov_13.443700	329	409	8	31	80	0.3875000
NODE_10495_length_845_cov_13.443700	329	409	9	3	80	0.0375000
NODE_10495_length_845_cov_13.443700	329	409	10	34	80	0.4250000
NODE_10495_length_845_cov_13.443700	382	462	6	7	80	0.0875000
NODE_10495_length_845_cov_13.443700	382	462	10	27	80	0.3375000
NODE_10495_length_845_cov_13.443700	382	462	12	46	80	0.5750000
NODE_10496_length_845_cov_12.301609	334	414	0	18	80	0.2250000
NODE_10496_length_845_cov_12.301609	334	414	2	62	80	0.7750000
NODE_10496_length_845_cov_12.301609	387	467	0	27	80	0.3375000
NODE_10496_length_845_cov_12.301609	387	467	2	53	80	0.6625000
NODE_10497_length_845_cov_11.836461	389	469	0	21	80	0.2625000
NODE_10497_length_845_cov_11.836461	389	469	2	59	80	0.7375000
NODE_10497_length_845_cov_11.836461	442	522	2	80	80	1.0000000
NODE_10499_length_845_cov_8.140751	439	519	0	62	80	0.7750000
NODE_10499_length_845_cov_8.140751	439	519	2	18	80	0.2250000
NODE_10499_length_845_cov_8.140751	492	572	0	80	80	1.0000000
NODE_10516_length_845_cov_1.680965	447	491	0	3	44	0.0681818
NODE_10516_length_845_cov_1.680965	447	491	2	41	44	0.9318182
NODE_10528_length_844_cov_43.778523	313	393	4	12	80	0.1500000
NODE_10528_length_844_cov_43.778523	313	393	8	1	80	0.0125000
NODE_10528_length_844_cov_43.778523	313	393	9	5	80	0.0625000
NODE_10528_length_844_cov_43.778523	313	393	11	5	80	0.0625000
NODE_10528_length_844_cov_43.778523	313	393	17	19	80	0.2375000
NODE_10528_length_844_cov_43.778523	313	393	18	15	80	0.1875000
NODE_10528_length_844_cov_43.778523	313	393	19	23	80	0.2875000
NODE_10528_length_844_cov_43.778523	366	446	7	11	80	0.1375000
NODE_10528_length_844_cov_43.778523	366	446	9	11	80	0.1375000
NODE_10528_length_844_cov_43.778523	366	446	12	3	80	0.0375000
NODE_10528_length_844_cov_43.778523	366	446	14	8	80	0.1000000
NODE_10528_length_844_cov_43.778523	366	446	15	2	80	0.0250000
NODE_10528_length_844_cov_43.778523	366	446	16	8	80	0.1000000
NODE_10528_length_844_cov_43.778523	366	446	17	5	80	0.0625000
NODE_10528_length_844_cov_43.778523	366	446	18	17	80	0.2125000
NODE_10528_length_844_cov_43.778523	366	446	19	7	80	0.0875000
NODE_10528_length_844_cov_43.778523	366	446	20	8	80	0.1000000
NODE_10528_length_844_cov_43.778523	442	522	9	2	80	0.0250000
NODE_10528_length_844_cov_43.778523	442	522	15	17	80	0.2125000
NODE_10528_length_844_cov_43.778523	442	522	16	2	80	0.0250000
NODE_10528_length_844_cov_43.778523	442	522	17	18	80	0.2250000
NODE_10528_length_844_cov_43.778523	442	522	18	27	80	0.3375000
NODE_10528_length_844_cov_43.778523	442	522	21	14	80	0.1750000
NODE_10528_length_844_cov_43.778523	495	575	8	5	80	0.0625000
NODE_10528_length_844_cov_43.778523	495	575	10	6	80	0.0750000
NODE_10528_length_844_cov_43.778523	495	575	12	1	80	0.0125000
NODE_10528_length_844_cov_43.778523	495	575	14	4	80	0.0500000
NODE_10528_length_844_cov_43.778523	495	575	16	1	80	0.0125000
NODE_10528_length_844_cov_43.778523	495	575	18	63	80	0.7875000
NODE_10529_length_844_cov_36.762416	381	461	0	75	80	0.9375000
NODE_10529_length_844_cov_36.762416	381	461	1	1	80	0.0125000
NODE_10529_length_844_cov_36.762416	381	461	2	4	80	0.0500000
NODE_10529_length_844_cov_36.762416	434	514	0	22	80	0.2750000
NODE_10529_length_844_cov_36.762416	434	514	1	1	80	0.0125000
NODE_10529_length_844_cov_36.762416	434	514	2	57	80	0.7125000
NODE_10529_length_844_cov_36.762416	510	590	2	17	80	0.2125000
NODE_10529_length_844_cov_36.762416	510	590	6	36	80	0.4500000
NODE_10529_length_844_cov_36.762416	510	590	8	20	80	0.2500000
NODE_10529_length_844_cov_36.762416	510	590	9	1	80	0.0125000
NODE_10529_length_844_cov_36.762416	510	590	10	6	80	0.0750000
NODE_10529_length_844_cov_36.762416	563	644	2	7	81	0.0864198
NODE_10529_length_844_cov_36.762416	563	644	6	22	81	0.2716049
NODE_10529_length_844_cov_36.762416	563	644	8	45	81	0.5555556
NODE_10529_length_844_cov_36.762416	563	644	9	1	81	0.0123457
NODE_10529_length_844_cov_36.762416	563	644	10	6	81	0.0740741
NODE_10530_length_844_cov_35.765101	424	504	0	80	80	1.0000000
NODE_10530_length_844_cov_35.765101	477	557	0	80	80	1.0000000
NODE_10531_length_844_cov_18.445638	353	420	0	15	67	0.2238806
NODE_10531_length_844_cov_18.445638	353	420	2	52	67	0.7761194
NODE_10531_length_844_cov_18.445638	393	473	0	68	80	0.8500000
NODE_10531_length_844_cov_18.445638	393	473	2	12	80	0.1500000
NODE_10532_length_844_cov_12.616107	363	443	0	15	80	0.1875000
NODE_10532_length_844_cov_12.616107	363	443	4	65	80	0.8125000
NODE_10532_length_844_cov_12.616107	416	496	0	64	80	0.8000000
NODE_10532_length_844_cov_12.616107	416	496	4	16	80	0.2000000
NODE_10533_length_844_cov_12.092617	171	251	0	2	80	0.0250000
NODE_10533_length_844_cov_12.092617	171	251	4	17	80	0.2125000
NODE_10533_length_844_cov_12.092617	171	251	8	40	80	0.5000000
NODE_10533_length_844_cov_12.092617	171	251	12	21	80	0.2625000
NODE_10533_length_844_cov_12.092617	224	304	8	25	80	0.3125000
NODE_10533_length_844_cov_12.092617	224	304	10	29	80	0.3625000
NODE_10533_length_844_cov_12.092617	224	304	12	26	80	0.3250000
NODE_10534_length_844_cov_11.883221	341	421	0	26	80	0.3250000
NODE_10534_length_844_cov_11.883221	341	421	2	54	80	0.6750000
NODE_10534_length_844_cov_11.883221	394	474	0	79	80	0.9875000
NODE_10534_length_844_cov_11.883221	394	474	2	1	80	0.0125000
NODE_10535_length_844_cov_10.571812	390	448	0	19	58	0.3275862
NODE_10535_length_844_cov_10.571812	390	448	2	9	58	0.1551724
NODE_10535_length_844_cov_10.571812	390	448	4	30	58	0.5172414
NODE_10537_length_844_cov_9.357047	370	450	0	80	80	1.0000000
NODE_10537_length_844_cov_9.357047	423	503	0	80	80	1.0000000
NODE_10538_length_844_cov_8.975839	355	435	0	80	80	1.0000000
NODE_10538_length_844_cov_8.975839	408	488	0	80	80	1.0000000
NODE_10539_length_844_cov_7.347651	357	438	0	81	81	1.0000000
NODE_10539_length_844_cov_7.347651	410	491	0	81	81	1.0000000
NODE_10540_length_844_cov_6.975839	444	524	0	80	80	1.0000000
NODE_10540_length_844_cov_6.975839	497	577	0	50	80	0.6250000
NODE_10540_length_844_cov_6.975839	497	577	2	30	80	0.3750000
NODE_10567_length_843_cov_48.258065	203	262	190	1	59	0.0169492
NODE_10567_length_843_cov_48.258065	203	262	192	1	59	0.0169492
NODE_10567_length_843_cov_48.258065	203	262	199	1	59	0.0169492
NODE_10567_length_843_cov_48.258065	203	262	200	1	59	0.0169492
NODE_10567_length_843_cov_48.258065	203	262	201	2	59	0.0338983
NODE_10567_length_843_cov_48.258065	203	262	203	1	59	0.0169492
NODE_10567_length_843_cov_48.258065	203	262	205	1	59	0.0169492
NODE_10567_length_843_cov_48.258065	203	262	206	2	59	0.0338983
NODE_10567_length_843_cov_48.258065	203	262	207	1	59	0.0169492
NODE_10567_length_843_cov_48.258065	203	262	208	1	59	0.0169492
NODE_10567_length_843_cov_48.258065	203	262	209	3	59	0.0508475
NODE_10567_length_843_cov_48.258065	203	262	210	5	59	0.0847458
NODE_10567_length_843_cov_48.258065	203	262	211	12	59	0.2033898
NODE_10567_length_843_cov_48.258065	203	262	212	7	59	0.1186441
NODE_10567_length_843_cov_48.258065	203	262	213	7	59	0.1186441
NODE_10567_length_843_cov_48.258065	203	262	214	4	59	0.0677966
NODE_10567_length_843_cov_48.258065	203	262	215	1	59	0.0169492
NODE_10567_length_843_cov_48.258065	203	262	216	2	59	0.0338983
NODE_10567_length_843_cov_48.258065	203	262	219	1	59	0.0169492
NODE_10567_length_843_cov_48.258065	203	262	224	4	59	0.0677966
NODE_10567_length_843_cov_48.258065	203	262	225	1	59	0.0169492
NODE_10568_length_843_cov_31.279570	351	431	5	2	80	0.0250000
NODE_10568_length_843_cov_31.279570	351	431	7	22	80	0.2750000
NODE_10568_length_843_cov_31.279570	351	431	8	16	80	0.2000000
NODE_10568_length_843_cov_31.279570	351	431	9	24	80	0.3000000
NODE_10568_length_843_cov_31.279570	351	431	12	4	80	0.0500000
NODE_10568_length_843_cov_31.279570	351	431	13	12	80	0.1500000
NODE_10568_length_843_cov_31.279570	404	484	8	69	80	0.8625000
NODE_10568_length_843_cov_31.279570	404	484	12	4	80	0.0500000
NODE_10568_length_843_cov_31.279570	404	484	13	7	80	0.0875000
NODE_10569_length_843_cov_27.060484	423	503	0	9	80	0.1125000
NODE_10569_length_843_cov_27.060484	423	503	2	71	80	0.8875000
NODE_10569_length_843_cov_27.060484	476	556	0	62	80	0.7750000
NODE_10569_length_843_cov_27.060484	476	556	2	18	80	0.2250000
NODE_10570_length_843_cov_22.725806	334	414	0	80	80	1.0000000
NODE_10570_length_843_cov_22.725806	339	396	0	57	57	1.0000000
NODE_10570_length_843_cov_22.725806	356	427	0	71	71	1.0000000
NODE_10570_length_843_cov_22.725806	387	455	0	47	68	0.6911765
NODE_10570_length_843_cov_22.725806	387	455	4	21	68	0.3088235
NODE_10570_length_843_cov_22.725806	401	476	0	33	75	0.4400000
NODE_10570_length_843_cov_22.725806	401	476	4	42	75	0.5600000
NODE_10570_length_843_cov_22.725806	418	486	0	16	68	0.2352941
NODE_10570_length_843_cov_22.725806	418	486	4	52	68	0.7647059
NODE_10570_length_843_cov_22.725806	449	529	0	16	80	0.2000000
NODE_10570_length_843_cov_22.725806	449	529	3	5	80	0.0625000
NODE_10570_length_843_cov_22.725806	449	529	4	59	80	0.7375000
NODE_10571_length_843_cov_22.387097	412	492	0	11	80	0.1375000
NODE_10571_length_843_cov_22.387097	412	492	4	69	80	0.8625000
NODE_10571_length_843_cov_22.387097	465	545	0	2	80	0.0250000
NODE_10571_length_843_cov_22.387097	465	545	4	78	80	0.9750000
NODE_10572_length_843_cov_16.326613	551	631	5	29	80	0.3625000
NODE_10572_length_843_cov_16.326613	551	631	7	28	80	0.3500000
NODE_10572_length_843_cov_16.326613	551	631	10	1	80	0.0125000
NODE_10572_length_843_cov_16.326613	551	631	11	3	80	0.0375000
NODE_10572_length_843_cov_16.326613	551	631	12	19	80	0.2375000
NODE_10572_length_843_cov_16.326613	604	684	4	20	80	0.2500000
NODE_10572_length_843_cov_16.326613	604	684	6	14	80	0.1750000
NODE_10572_length_843_cov_16.326613	604	684	7	4	80	0.0500000
NODE_10572_length_843_cov_16.326613	604	684	8	2	80	0.0250000
NODE_10572_length_843_cov_16.326613	604	684	10	2	80	0.0250000
NODE_10572_length_843_cov_16.326613	604	684	11	3	80	0.0375000
NODE_10572_length_843_cov_16.326613	604	684	12	35	80	0.4375000
NODE_10573_length_843_cov_13.478495	381	461	0	45	80	0.5625000
NODE_10573_length_843_cov_13.478495	381	461	2	35	80	0.4375000
NODE_10573_length_843_cov_13.478495	434	514	2	28	80	0.3500000
NODE_10573_length_843_cov_13.478495	434	514	3	1	80	0.0125000
NODE_10573_length_843_cov_13.478495	434	514	4	15	80	0.1875000
NODE_10573_length_843_cov_13.478495	434	514	8	36	80	0.4500000
NODE_10574_length_843_cov_13.150538	448	528	2	13	80	0.1625000
NODE_10574_length_843_cov_13.150538	448	528	8	67	80	0.8375000
NODE_10574_length_843_cov_13.150538	501	581	0	14	80	0.1750000
NODE_10574_length_843_cov_13.150538	501	581	2	12	80	0.1500000
NODE_10574_length_843_cov_13.150538	501	581	8	54	80	0.6750000
NODE_10575_length_843_cov_12.510753	360	440	0	80	80	1.0000000
NODE_10575_length_843_cov_12.510753	413	493	0	43	80	0.5375000
NODE_10575_length_843_cov_12.510753	413	493	2	37	80	0.4625000
NODE_10576_length_843_cov_11.090054	457	537	0	80	80	1.0000000
NODE_10576_length_843_cov_11.090054	510	590	0	80	80	1.0000000
NODE_10577_length_843_cov_7.672043	472	552	0	49	80	0.6125000
NODE_10577_length_843_cov_7.672043	472	552	2	12	80	0.1500000
NODE_10577_length_843_cov_7.672043	472	552	4	19	80	0.2375000
NODE_10577_length_843_cov_7.672043	525	605	0	80	80	1.0000000
NODE_10601_length_842_cov_39.518170	390	470	0	21	80	0.2625000
NODE_10601_length_842_cov_39.518170	390	470	4	21	80	0.2625000
NODE_10601_length_842_cov_39.518170	390	470	8	5	80	0.0625000
NODE_10601_length_842_cov_39.518170	390	470	12	33	80	0.4125000
NODE_10601_length_842_cov_39.518170	443	523	8	12	80	0.1500000
NODE_10601_length_842_cov_39.518170	443	523	12	68	80	0.8500000
NODE_10602_length_842_cov_21.567968	331	411	0	80	80	1.0000000
NODE_10602_length_842_cov_21.567968	384	464	0	80	80	1.0000000
NODE_10603_length_842_cov_19.761777	228	308	15	42	80	0.5250000
NODE_10603_length_842_cov_19.761777	228	308	16	8	80	0.1000000
NODE_10603_length_842_cov_19.761777	228	308	20	30	80	0.3750000
NODE_10603_length_842_cov_19.761777	281	361	5	2	80	0.0250000
NODE_10603_length_842_cov_19.761777	281	361	14	12	80	0.1500000
NODE_10603_length_842_cov_19.761777	281	361	18	12	80	0.1500000
NODE_10603_length_842_cov_19.761777	281	361	19	9	80	0.1125000
NODE_10603_length_842_cov_19.761777	281	361	20	45	80	0.5625000
NODE_10605_length_842_cov_8.703903	641	722	0	38	81	0.4691358
NODE_10605_length_842_cov_8.703903	641	722	2	9	81	0.1111111
NODE_10605_length_842_cov_8.703903	641	722	4	34	81	0.4197531
NODE_10608_length_842_cov_5.305518	287	367	0	33	80	0.4125000
NODE_10608_length_842_cov_5.305518	287	367	2	47	80	0.5875000
NODE_10608_length_842_cov_5.305518	340	420	0	8	80	0.1000000
NODE_10608_length_842_cov_5.305518	340	420	2	72	80	0.9000000
NODE_10617_length_842_cov_1.751009	35	66	2	31	31	1.0000000
NODE_10622_length_841_cov_23.815364	292	372	0	63	80	0.7875000
NODE_10622_length_841_cov_23.815364	292	372	2	6	80	0.0750000
NODE_10622_length_841_cov_23.815364	292	372	4	11	80	0.1375000
NODE_10622_length_841_cov_23.815364	345	425	0	10	80	0.1250000
NODE_10622_length_841_cov_23.815364	345	425	2	12	80	0.1500000
NODE_10622_length_841_cov_23.815364	345	425	4	58	80	0.7250000
NODE_10623_length_841_cov_18.871968	338	418	0	80	80	1.0000000
NODE_10623_length_841_cov_18.871968	391	471	0	32	80	0.4000000
NODE_10623_length_841_cov_18.871968	391	471	1	27	80	0.3375000
NODE_10623_length_841_cov_18.871968	391	471	2	21	80	0.2625000
NODE_10624_length_841_cov_14.663073	345	425	0	80	80	1.0000000
NODE_10624_length_841_cov_14.663073	398	478	0	57	80	0.7125000
NODE_10624_length_841_cov_14.663073	398	478	1	23	80	0.2875000
NODE_10625_length_841_cov_14.149596	341	421	0	80	80	1.0000000
NODE_10625_length_841_cov_14.149596	394	474	0	80	80	1.0000000
NODE_10626_length_841_cov_12.452830	240	320	0	69	80	0.8625000
NODE_10626_length_841_cov_12.452830	240	320	2	11	80	0.1375000
NODE_10626_length_841_cov_12.452830	293	373	0	16	80	0.2000000
NODE_10626_length_841_cov_12.452830	293	373	2	64	80	0.8000000
NODE_10628_length_841_cov_9.925876	394	474	0	58	80	0.7250000
NODE_10628_length_841_cov_9.925876	394	474	2	22	80	0.2750000
NODE_10628_length_841_cov_9.925876	447	527	0	24	80	0.3000000
NODE_10628_length_841_cov_9.925876	447	527	2	56	80	0.7000000
NODE_10629_length_841_cov_7.407008	317	397	0	80	80	1.0000000
NODE_10629_length_841_cov_7.407008	370	450	0	80	80	1.0000000
NODE_10632_length_841_cov_3.865229	305	356	0	51	51	1.0000000
NODE_10651_length_840_cov_63.726046	461	541	13	17	80	0.2125000
NODE_10651_length_840_cov_63.726046	461	541	14	12	80	0.1500000
NODE_10651_length_840_cov_63.726046	461	541	15	23	80	0.2875000
NODE_10651_length_840_cov_63.726046	461	541	16	7	80	0.0875000
NODE_10651_length_840_cov_63.726046	461	541	18	8	80	0.1000000
NODE_10651_length_840_cov_63.726046	461	541	20	2	80	0.0250000
NODE_10651_length_840_cov_63.726046	461	541	21	11	80	0.1375000
NODE_10651_length_840_cov_63.726046	514	594	8	36	80	0.4500000
NODE_10651_length_840_cov_63.726046	514	594	14	29	80	0.3625000
NODE_10651_length_840_cov_63.726046	514	594	16	7	80	0.0875000
NODE_10651_length_840_cov_63.726046	514	594	18	8	80	0.1000000
NODE_10652_length_840_cov_35.874494	486	566	4	80	80	1.0000000
NODE_10652_length_840_cov_35.874494	539	619	0	18	80	0.2250000
NODE_10652_length_840_cov_35.874494	539	619	4	62	80	0.7750000
NODE_10653_length_840_cov_24.499325	224	304	0	15	80	0.1875000
NODE_10653_length_840_cov_24.499325	224	304	2	3	80	0.0375000
NODE_10653_length_840_cov_24.499325	224	304	6	52	80	0.6500000
NODE_10653_length_840_cov_24.499325	224	304	8	10	80	0.1250000
NODE_10653_length_840_cov_24.499325	277	357	0	68	80	0.8500000
NODE_10653_length_840_cov_24.499325	277	357	2	3	80	0.0375000
NODE_10653_length_840_cov_24.499325	277	357	6	9	80	0.1125000
NODE_10653_length_840_cov_24.499325	353	433	0	9	80	0.1125000
NODE_10653_length_840_cov_24.499325	353	433	2	71	80	0.8875000
NODE_10653_length_840_cov_24.499325	406	486	0	44	80	0.5500000
NODE_10653_length_840_cov_24.499325	406	486	2	36	80	0.4500000
NODE_10654_length_840_cov_23.272605	309	389	2	14	80	0.1750000
NODE_10654_length_840_cov_23.272605	309	389	4	8	80	0.1000000
NODE_10654_length_840_cov_23.272605	309	389	8	14	80	0.1750000
NODE_10654_length_840_cov_23.272605	309	389	14	15	80	0.1875000
NODE_10654_length_840_cov_23.272605	309	389	15	1	80	0.0125000
NODE_10654_length_840_cov_23.272605	309	389	16	28	80	0.3500000
NODE_10654_length_840_cov_23.272605	362	442	0	5	80	0.0625000
NODE_10654_length_840_cov_23.272605	362	442	7	1	80	0.0125000
NODE_10654_length_840_cov_23.272605	362	442	8	16	80	0.2000000
NODE_10654_length_840_cov_23.272605	362	442	10	6	80	0.0750000
NODE_10654_length_840_cov_23.272605	362	442	14	40	80	0.5000000
NODE_10654_length_840_cov_23.272605	362	442	16	12	80	0.1500000
NODE_10655_length_840_cov_22.221323	293	373	1	16	80	0.2000000
NODE_10655_length_840_cov_22.221323	293	373	2	53	80	0.6625000
NODE_10655_length_840_cov_22.221323	293	373	3	11	80	0.1375000
NODE_10655_length_840_cov_22.221323	346	426	0	42	80	0.5250000
NODE_10655_length_840_cov_22.221323	346	426	2	38	80	0.4750000
NODE_10656_length_840_cov_17.026991	348	432	2	51	84	0.6071429
NODE_10656_length_840_cov_17.026991	348	432	4	32	84	0.3809524
NODE_10656_length_840_cov_17.026991	348	432	6	1	84	0.0119048
NODE_10656_length_840_cov_17.026991	405	485	4	80	80	1.0000000
NODE_10657_length_840_cov_16.635628	347	427	0	80	80	1.0000000
NODE_10657_length_840_cov_16.635628	400	480	0	80	80	1.0000000
NODE_10658_length_840_cov_12.133603	336	416	0	80	80	1.0000000
NODE_10658_length_840_cov_12.133603	389	469	0	80	80	1.0000000
NODE_10659_length_840_cov_12.041835	332	412	0	29	80	0.3625000
NODE_10659_length_840_cov_12.041835	332	412	2	43	80	0.5375000
NODE_10659_length_840_cov_12.041835	332	412	4	8	80	0.1000000
NODE_10659_length_840_cov_12.041835	385	465	0	2	80	0.0250000
NODE_10659_length_840_cov_12.041835	385	465	2	32	80	0.4000000
NODE_10659_length_840_cov_12.041835	385	465	4	46	80	0.5750000
NODE_10660_length_840_cov_10.719298	275	354	0	79	79	1.0000000
NODE_10660_length_840_cov_10.719298	327	407	0	80	80	1.0000000
NODE_10663_length_840_cov_5.207827	427	507	0	80	80	1.0000000
NODE_10663_length_840_cov_5.207827	480	560	0	75	80	0.9375000
NODE_10663_length_840_cov_5.207827	480	560	2	5	80	0.0625000
NODE_10683_length_839_cov_274.987838	450	530	89	1	80	0.0125000
NODE_10683_length_839_cov_274.987838	450	530	90	1	80	0.0125000
NODE_10683_length_839_cov_274.987838	450	530	92	2	80	0.0250000
NODE_10683_length_839_cov_274.987838	450	530	94	1	80	0.0125000
NODE_10683_length_839_cov_274.987838	450	530	95	2	80	0.0250000
NODE_10683_length_839_cov_274.987838	450	530	96	5	80	0.0625000
NODE_10683_length_839_cov_274.987838	450	530	97	4	80	0.0500000
NODE_10683_length_839_cov_274.987838	450	530	99	1	80	0.0125000
NODE_10683_length_839_cov_274.987838	450	530	100	1	80	0.0125000
NODE_10683_length_839_cov_274.987838	450	530	102	1	80	0.0125000
NODE_10683_length_839_cov_274.987838	450	530	107	1	80	0.0125000
NODE_10683_length_839_cov_274.987838	450	530	109	3	80	0.0375000
NODE_10683_length_839_cov_274.987838	450	530	111	1	80	0.0125000
NODE_10683_length_839_cov_274.987838	450	530	113	2	80	0.0250000
NODE_10683_length_839_cov_274.987838	450	530	115	1	80	0.0125000
NODE_10683_length_839_cov_274.987838	450	530	129	1	80	0.0125000
NODE_10683_length_839_cov_274.987838	450	530	133	1	80	0.0125000
NODE_10683_length_839_cov_274.987838	450	530	134	2	80	0.0250000
NODE_10683_length_839_cov_274.987838	450	530	137	1	80	0.0125000
NODE_10683_length_839_cov_274.987838	450	530	138	1	80	0.0125000
NODE_10683_length_839_cov_274.987838	450	530	145	1	80	0.0125000
NODE_10683_length_839_cov_274.987838	450	530	146	1	80	0.0125000
NODE_10683_length_839_cov_274.987838	450	530	150	1	80	0.0125000
NODE_10683_length_839_cov_274.987838	450	530	151	1	80	0.0125000
NODE_10683_length_839_cov_274.987838	450	530	152	1	80	0.0125000
NODE_10683_length_839_cov_274.987838	450	530	156	1	80	0.0125000
NODE_10683_length_839_cov_274.987838	450	530	157	2	80	0.0250000
NODE_10683_length_839_cov_274.987838	450	530	158	8	80	0.1000000
NODE_10683_length_839_cov_274.987838	450	530	166	3	80	0.0375000
NODE_10683_length_839_cov_274.987838	450	530	170	1	80	0.0125000
NODE_10683_length_839_cov_274.987838	450	530	172	3	80	0.0375000
NODE_10683_length_839_cov_274.987838	450	530	181	1	80	0.0125000
NODE_10683_length_839_cov_274.987838	450	530	187	6	80	0.0750000
NODE_10683_length_839_cov_274.987838	450	530	188	2	80	0.0250000
NODE_10683_length_839_cov_274.987838	450	530	190	4	80	0.0500000
NODE_10683_length_839_cov_274.987838	450	530	192	3	80	0.0375000
NODE_10683_length_839_cov_274.987838	450	530	193	2	80	0.0250000
NODE_10683_length_839_cov_274.987838	450	530	194	1	80	0.0125000
NODE_10683_length_839_cov_274.987838	450	530	195	2	80	0.0250000
NODE_10683_length_839_cov_274.987838	450	530	196	2	80	0.0250000
NODE_10683_length_839_cov_274.987838	450	530	200	1	80	0.0125000
NODE_10683_length_839_cov_274.987838	503	583	164	4	80	0.0500000
NODE_10683_length_839_cov_274.987838	503	583	166	3	80	0.0375000
NODE_10683_length_839_cov_274.987838	503	583	168	1	80	0.0125000
NODE_10683_length_839_cov_274.987838	503	583	170	1	80	0.0125000
NODE_10683_length_839_cov_274.987838	503	583	172	3	80	0.0375000
NODE_10683_length_839_cov_274.987838	503	583	176	1	80	0.0125000
NODE_10683_length_839_cov_274.987838	503	583	181	1	80	0.0125000
NODE_10683_length_839_cov_274.987838	503	583	183	2	80	0.0250000
NODE_10683_length_839_cov_274.987838	503	583	187	6	80	0.0750000
NODE_10683_length_839_cov_274.987838	503	583	188	2	80	0.0250000
NODE_10683_length_839_cov_274.987838	503	583	189	1	80	0.0125000
NODE_10683_length_839_cov_274.987838	503	583	190	4	80	0.0500000
NODE_10683_length_839_cov_274.987838	503	583	192	4	80	0.0500000
NODE_10683_length_839_cov_274.987838	503	583	193	2	80	0.0250000
NODE_10683_length_839_cov_274.987838	503	583	194	3	80	0.0375000
NODE_10683_length_839_cov_274.987838	503	583	195	2	80	0.0250000
NODE_10683_length_839_cov_274.987838	503	583	196	3	80	0.0375000
NODE_10683_length_839_cov_274.987838	503	583	197	3	80	0.0375000
NODE_10683_length_839_cov_274.987838	503	583	198	2	80	0.0250000
NODE_10683_length_839_cov_274.987838	503	583	199	4	80	0.0500000
NODE_10683_length_839_cov_274.987838	503	583	200	3	80	0.0375000
NODE_10683_length_839_cov_274.987838	503	583	201	1	80	0.0125000
NODE_10683_length_839_cov_274.987838	503	583	202	4	80	0.0500000
NODE_10683_length_839_cov_274.987838	503	583	203	3	80	0.0375000
NODE_10683_length_839_cov_274.987838	503	583	204	3	80	0.0375000
NODE_10683_length_839_cov_274.987838	503	583	206	1	80	0.0125000
NODE_10683_length_839_cov_274.987838	503	583	209	1	80	0.0125000
NODE_10683_length_839_cov_274.987838	503	583	213	4	80	0.0500000
NODE_10683_length_839_cov_274.987838	503	583	214	4	80	0.0500000
NODE_10683_length_839_cov_274.987838	503	583	216	1	80	0.0125000
NODE_10683_length_839_cov_274.987838	503	583	217	1	80	0.0125000
NODE_10683_length_839_cov_274.987838	503	583	219	1	80	0.0125000
NODE_10683_length_839_cov_274.987838	503	583	221	1	80	0.0125000
NODE_10684_length_839_cov_24.500000	303	383	0	80	80	1.0000000
NODE_10684_length_839_cov_24.500000	356	436	0	80	80	1.0000000
NODE_10685_length_839_cov_16.390541	477	557	0	26	80	0.3250000
NODE_10685_length_839_cov_16.390541	477	557	2	54	80	0.6750000
NODE_10685_length_839_cov_16.390541	530	610	0	79	80	0.9875000
NODE_10685_length_839_cov_16.390541	530	610	2	1	80	0.0125000
NODE_10686_length_839_cov_10.006757	383	463	0	47	80	0.5875000
NODE_10686_length_839_cov_10.006757	383	463	2	33	80	0.4125000
NODE_10686_length_839_cov_10.006757	436	516	2	80	80	1.0000000
NODE_10688_length_839_cov_7.612162	308	388	0	80	80	1.0000000
NODE_10688_length_839_cov_7.612162	361	441	0	80	80	1.0000000
NODE_10689_length_839_cov_6.693243	343	423	0	80	80	1.0000000
NODE_10706_length_838_cov_39.263870	383	463	0	1	80	0.0125000
NODE_10706_length_838_cov_39.263870	383	463	4	13	80	0.1625000
NODE_10706_length_838_cov_39.263870	383	463	6	57	80	0.7125000
NODE_10706_length_838_cov_39.263870	383	463	10	9	80	0.1125000
NODE_10706_length_838_cov_39.263870	436	516	0	10	80	0.1250000
NODE_10706_length_838_cov_39.263870	436	516	4	56	80	0.7000000
NODE_10706_length_838_cov_39.263870	436	516	6	5	80	0.0625000
NODE_10706_length_838_cov_39.263870	436	516	10	9	80	0.1125000
NODE_10707_length_838_cov_27.843031	473	553	1	80	80	1.0000000
NODE_10707_length_838_cov_27.843031	526	606	1	69	80	0.8625000
NODE_10707_length_838_cov_27.843031	526	606	2	3	80	0.0375000
NODE_10707_length_838_cov_27.843031	526	606	3	8	80	0.1000000
NODE_10708_length_838_cov_27.238160	432	512	14	80	80	1.0000000
NODE_10708_length_838_cov_27.238160	485	565	0	21	80	0.2625000
NODE_10708_length_838_cov_27.238160	485	565	12	1	80	0.0125000
NODE_10708_length_838_cov_27.238160	485	565	13	31	80	0.3875000
NODE_10708_length_838_cov_27.238160	485	565	14	27	80	0.3375000
NODE_10709_length_838_cov_22.691475	380	460	0	12	80	0.1500000
NODE_10709_length_838_cov_22.691475	380	460	2	68	80	0.8500000
NODE_10709_length_838_cov_22.691475	433	513	0	65	80	0.8125000
NODE_10709_length_838_cov_22.691475	433	513	2	15	80	0.1875000
NODE_10710_length_838_cov_16.169147	312	392	0	80	80	1.0000000
NODE_10710_length_838_cov_16.169147	365	445	0	32	80	0.4000000
NODE_10710_length_838_cov_16.169147	365	445	2	48	80	0.6000000
NODE_10711_length_838_cov_15.753721	328	408	6	12	80	0.1500000
NODE_10711_length_838_cov_15.753721	328	408	10	68	80	0.8500000
NODE_10711_length_838_cov_15.753721	381	461	0	7	80	0.0875000
NODE_10711_length_838_cov_15.753721	381	461	3	3	80	0.0375000
NODE_10711_length_838_cov_15.753721	381	461	6	55	80	0.6875000
NODE_10711_length_838_cov_15.753721	381	461	10	15	80	0.1875000
NODE_10712_length_838_cov_15.514208	294	374	2	80	80	1.0000000
NODE_10712_length_838_cov_15.514208	347	427	0	33	80	0.4125000
NODE_10712_length_838_cov_15.514208	347	427	2	47	80	0.5875000
NODE_10713_length_838_cov_7.733424	350	430	0	80	80	1.0000000
NODE_10713_length_838_cov_7.733424	403	483	0	80	80	1.0000000
NODE_10716_length_838_cov_4.511502	131	213	8	82	82	1.0000000
NODE_10716_length_838_cov_4.511502	184	252	8	68	68	1.0000000
NODE_10722_length_838_cov_2.247632	359	405	0	46	46	1.0000000
NODE_10727_length_838_cov_1.843031	732	752	0	20	20	1.0000000
NODE_10740_length_837_cov_32.691057	401	481	0	16	80	0.2000000
NODE_10740_length_837_cov_32.691057	401	481	2	64	80	0.8000000
NODE_10740_length_837_cov_32.691057	454	534	0	69	80	0.8625000
NODE_10740_length_837_cov_32.691057	454	534	2	11	80	0.1375000
NODE_10741_length_837_cov_30.995935	399	479	2	18	80	0.2250000
NODE_10741_length_837_cov_30.995935	399	479	4	7	80	0.0875000
NODE_10741_length_837_cov_30.995935	399	479	10	19	80	0.2375000
NODE_10741_length_837_cov_30.995935	399	479	12	14	80	0.1750000
NODE_10741_length_837_cov_30.995935	399	479	13	9	80	0.1125000
NODE_10741_length_837_cov_30.995935	399	479	14	10	80	0.1250000
NODE_10741_length_837_cov_30.995935	399	479	16	3	80	0.0375000
NODE_10741_length_837_cov_30.995935	452	532	4	1	80	0.0125000
NODE_10741_length_837_cov_30.995935	452	532	9	1	80	0.0125000
NODE_10741_length_837_cov_30.995935	452	532	10	11	80	0.1375000
NODE_10741_length_837_cov_30.995935	452	532	12	14	80	0.1750000
NODE_10741_length_837_cov_30.995935	452	532	13	9	80	0.1125000
NODE_10741_length_837_cov_30.995935	452	532	14	41	80	0.5125000
NODE_10741_length_837_cov_30.995935	452	532	16	3	80	0.0375000
NODE_10742_length_837_cov_30.883469	278	358	0	80	80	1.0000000
NODE_10742_length_837_cov_30.883469	331	411	0	63	80	0.7875000
NODE_10742_length_837_cov_30.883469	331	411	2	17	80	0.2125000
NODE_10742_length_837_cov_30.883469	407	487	2	71	80	0.8875000
NODE_10742_length_837_cov_30.883469	407	487	4	9	80	0.1125000
NODE_10742_length_837_cov_30.883469	460	540	0	18	80	0.2250000
NODE_10742_length_837_cov_30.883469	460	540	2	62	80	0.7750000
NODE_10743_length_837_cov_14.573171	205	280	0	75	75	1.0000000
NODE_10743_length_837_cov_14.573171	258	337	0	79	79	1.0000000
NODE_10743_length_837_cov_14.573171	333	413	0	80	80	1.0000000
NODE_10743_length_837_cov_14.573171	386	466	0	80	80	1.0000000
NODE_10744_length_837_cov_12.582656	226	306	0	20	80	0.2500000
NODE_10744_length_837_cov_12.582656	226	306	4	60	80	0.7500000
NODE_10744_length_837_cov_12.582656	279	359	0	34	80	0.4250000
NODE_10744_length_837_cov_12.582656	279	359	2	9	80	0.1125000
NODE_10744_length_837_cov_12.582656	279	359	4	37	80	0.4625000
NODE_10745_length_837_cov_6.998645	389	474	0	85	85	1.0000000
NODE_10745_length_837_cov_6.998645	447	527	0	80	80	1.0000000
NODE_10750_length_837_cov_3.119241	373	453	0	80	80	1.0000000
NODE_10750_length_837_cov_3.119241	426	506	0	80	80	1.0000000
NODE_10769_length_836_cov_40.141113	224	304	0	80	80	1.0000000
NODE_10769_length_836_cov_40.141113	277	357	0	80	80	1.0000000
NODE_10769_length_836_cov_40.141113	353	433	0	11	80	0.1375000
NODE_10769_length_836_cov_40.141113	353	433	3	10	80	0.1250000
NODE_10769_length_836_cov_40.141113	353	433	4	59	80	0.7375000
NODE_10769_length_836_cov_40.141113	406	486	4	80	80	1.0000000
NODE_10770_length_836_cov_27.610583	344	424	0	1	80	0.0125000
NODE_10770_length_836_cov_27.610583	344	424	8	79	80	0.9875000
NODE_10770_length_836_cov_27.610583	397	477	0	54	80	0.6750000
NODE_10770_length_836_cov_27.610583	397	477	8	26	80	0.3250000
NODE_10771_length_836_cov_15.719132	295	375	0	80	80	1.0000000
NODE_10771_length_836_cov_15.719132	348	428	0	56	80	0.7000000
NODE_10771_length_836_cov_15.719132	348	428	2	24	80	0.3000000
NODE_10772_length_836_cov_9.309362	295	375	0	76	80	0.9500000
NODE_10772_length_836_cov_9.309362	295	375	2	4	80	0.0500000
NODE_10772_length_836_cov_9.309362	348	428	0	23	80	0.2875000
NODE_10772_length_836_cov_9.309362	348	428	2	48	80	0.6000000
NODE_10772_length_836_cov_9.309362	348	428	4	9	80	0.1125000
NODE_10773_length_836_cov_6.283582	336	416	0	80	80	1.0000000
NODE_10773_length_836_cov_6.283582	389	469	0	80	80	1.0000000
NODE_10774_length_836_cov_4.979647	371	451	0	31	80	0.3875000
NODE_10774_length_836_cov_4.979647	371	451	2	33	80	0.4125000
NODE_10774_length_836_cov_4.979647	371	451	4	16	80	0.2000000
NODE_10774_length_836_cov_4.979647	424	504	0	17	80	0.2125000
NODE_10774_length_836_cov_4.979647	424	504	2	57	80	0.7125000
NODE_10774_length_836_cov_4.979647	424	504	4	6	80	0.0750000
NODE_10787_length_835_cov_61.033967	253	333	0	80	80	1.0000000
NODE_10787_length_835_cov_61.033967	306	386	0	80	80	1.0000000
NODE_10788_length_835_cov_32.380435	390	470	0	14	80	0.1750000
NODE_10788_length_835_cov_32.380435	390	470	2	8	80	0.1000000
NODE_10788_length_835_cov_32.380435	390	470	4	7	80	0.0875000
NODE_10788_length_835_cov_32.380435	390	470	6	51	80	0.6375000
NODE_10788_length_835_cov_32.380435	443	523	0	22	80	0.2750000
NODE_10788_length_835_cov_32.380435	443	523	2	39	80	0.4875000
NODE_10788_length_835_cov_32.380435	443	523	6	19	80	0.2375000
NODE_10789_length_835_cov_20.779891	415	495	2	48	80	0.6000000
NODE_10789_length_835_cov_20.779891	415	495	4	14	80	0.1750000
NODE_10789_length_835_cov_20.779891	415	495	5	2	80	0.0250000
NODE_10789_length_835_cov_20.779891	415	495	6	16	80	0.2000000
NODE_10789_length_835_cov_20.779891	468	548	2	3	80	0.0375000
NODE_10789_length_835_cov_20.779891	468	548	3	30	80	0.3750000
NODE_10789_length_835_cov_20.779891	468	548	4	34	80	0.4250000
NODE_10789_length_835_cov_20.779891	468	548	6	13	80	0.1625000
NODE_10808_length_835_cov_1.694293	18	80	0	1	62	0.0161290
NODE_10808_length_835_cov_1.694293	18	80	2	1	62	0.0161290
NODE_10808_length_835_cov_1.694293	18	80	4	60	62	0.9677419
NODE_10820_length_834_cov_13.689796	213	293	0	67	80	0.8375000
NODE_10820_length_834_cov_13.689796	213	293	2	13	80	0.1625000
NODE_10820_length_834_cov_13.689796	266	346	0	15	80	0.1875000
NODE_10820_length_834_cov_13.689796	266	346	2	65	80	0.8125000
NODE_10822_length_834_cov_12.609524	406	486	0	80	80	1.0000000
NODE_10822_length_834_cov_12.609524	459	539	0	72	80	0.9000000
NODE_10822_length_834_cov_12.609524	459	539	2	8	80	0.1000000
NODE_10823_length_834_cov_11.492517	248	328	0	80	80	1.0000000
NODE_10823_length_834_cov_11.492517	301	381	0	80	80	1.0000000
NODE_10824_length_834_cov_9.957823	212	292	0	50	80	0.6250000
NODE_10824_length_834_cov_9.957823	212	292	2	30	80	0.3750000
NODE_10824_length_834_cov_9.957823	265	345	2	27	80	0.3375000
NODE_10824_length_834_cov_9.957823	265	345	4	5	80	0.0625000
NODE_10824_length_834_cov_9.957823	265	345	6	48	80	0.6000000
NODE_10825_length_834_cov_6.448980	482	546	0	64	64	1.0000000
NODE_10833_length_834_cov_2.658503	589	641	0	52	52	1.0000000
NODE_10846_length_833_cov_57.702997	338	418	0	58	80	0.7250000
NODE_10846_length_833_cov_57.702997	338	418	4	22	80	0.2750000
NODE_10846_length_833_cov_57.702997	391	471	0	5	80	0.0625000
NODE_10846_length_833_cov_57.702997	391	471	4	32	80	0.4000000
NODE_10846_length_833_cov_57.702997	391	471	6	43	80	0.5375000
NODE_10847_length_833_cov_38.153951	364	444	0	21	80	0.2625000
NODE_10847_length_833_cov_38.153951	364	444	2	59	80	0.7375000
NODE_10847_length_833_cov_38.153951	417	497	2	37	80	0.4625000
NODE_10847_length_833_cov_38.153951	417	497	4	17	80	0.2125000
NODE_10847_length_833_cov_38.153951	417	497	6	26	80	0.3250000
NODE_10848_length_833_cov_34.302452	368	448	0	22	80	0.2750000
NODE_10848_length_833_cov_34.302452	368	448	2	36	80	0.4500000
NODE_10848_length_833_cov_34.302452	368	448	4	22	80	0.2750000
NODE_10848_length_833_cov_34.302452	421	501	0	8	80	0.1000000
NODE_10848_length_833_cov_34.302452	421	501	2	40	80	0.5000000
NODE_10848_length_833_cov_34.302452	421	501	4	32	80	0.4000000
NODE_10849_length_833_cov_20.452316	311	392	0	81	81	1.0000000
NODE_10849_length_833_cov_20.452316	365	445	0	80	80	1.0000000
NODE_10850_length_833_cov_16.643052	238	318	0	80	80	1.0000000
NODE_10851_length_833_cov_16.536785	84	164	0	80	80	1.0000000
NODE_10851_length_833_cov_16.536785	137	217	0	80	80	1.0000000
NODE_10865_length_833_cov_3.089918	467	547	0	80	80	1.0000000
NODE_10865_length_833_cov_3.089918	520	600	0	80	80	1.0000000
NODE_10891_length_832_cov_35.728513	460	540	0	80	80	1.0000000
NODE_10891_length_832_cov_35.728513	513	593	0	32	80	0.4000000
NODE_10891_length_832_cov_35.728513	513	593	2	48	80	0.6000000
NODE_10892_length_832_cov_25.450205	292	372	10	42	80	0.5250000
NODE_10892_length_832_cov_25.450205	292	372	14	38	80	0.4750000
NODE_10892_length_832_cov_25.450205	345	425	10	2	80	0.0250000
NODE_10892_length_832_cov_25.450205	345	425	13	1	80	0.0125000
NODE_10892_length_832_cov_25.450205	345	425	14	77	80	0.9625000
NODE_10893_length_832_cov_18.858117	428	508	2	33	80	0.4125000
NODE_10893_length_832_cov_18.858117	428	508	4	39	80	0.4875000
NODE_10893_length_832_cov_18.858117	428	508	6	8	80	0.1000000
NODE_10893_length_832_cov_18.858117	481	561	2	48	80	0.6000000
NODE_10893_length_832_cov_18.858117	481	561	4	30	80	0.3750000
NODE_10893_length_832_cov_18.858117	481	561	6	2	80	0.0250000
NODE_10894_length_832_cov_17.799454	314	394	0	77	80	0.9625000
NODE_10894_length_832_cov_17.799454	314	394	2	3	80	0.0375000
NODE_10894_length_832_cov_17.799454	367	447	0	24	80	0.3000000
NODE_10894_length_832_cov_17.799454	367	447	2	56	80	0.7000000
NODE_10895_length_832_cov_14.811733	353	433	0	42	80	0.5250000
NODE_10895_length_832_cov_14.811733	353	433	2	33	80	0.4125000
NODE_10895_length_832_cov_14.811733	353	433	5	1	80	0.0125000
NODE_10895_length_832_cov_14.811733	353	433	6	4	80	0.0500000
NODE_10896_length_832_cov_14.770805	259	339	0	38	80	0.4750000
NODE_10896_length_832_cov_14.770805	259	339	1	7	80	0.0875000
NODE_10896_length_832_cov_14.770805	259	339	2	35	80	0.4375000
NODE_10896_length_832_cov_14.770805	312	392	2	80	80	1.0000000
NODE_10897_length_832_cov_8.305593	266	346	0	6	80	0.0750000
NODE_10897_length_832_cov_8.305593	266	346	6	46	80	0.5750000
NODE_10897_length_832_cov_8.305593	266	346	8	28	80	0.3500000
NODE_10897_length_832_cov_8.305593	319	399	0	12	80	0.1500000
NODE_10897_length_832_cov_8.305593	319	399	2	29	80	0.3625000
NODE_10897_length_832_cov_8.305593	319	399	8	39	80	0.4875000
NODE_10918_length_831_cov_18.403005	371	451	0	80	80	1.0000000
NODE_10918_length_831_cov_18.403005	424	504	0	80	80	1.0000000
NODE_10919_length_831_cov_16.017760	357	437	0	34	80	0.4250000
NODE_10919_length_831_cov_16.017760	357	437	2	18	80	0.2250000
NODE_10919_length_831_cov_16.017760	357	437	6	28	80	0.3500000
NODE_10919_length_831_cov_16.017760	410	490	6	33	80	0.4125000
NODE_10919_length_831_cov_16.017760	410	490	8	47	80	0.5875000
NODE_10920_length_831_cov_13.740437	405	485	0	42	80	0.5250000
NODE_10920_length_831_cov_13.740437	405	485	2	38	80	0.4750000
NODE_10920_length_831_cov_13.740437	458	538	2	80	80	1.0000000
NODE_10921_length_831_cov_9.595628	281	361	0	80	80	1.0000000
NODE_10921_length_831_cov_9.595628	334	414	0	80	80	1.0000000
NODE_10922_length_831_cov_8.199454	433	482	0	6	49	0.1224490
NODE_10922_length_831_cov_8.199454	433	482	2	43	49	0.8775510
NODE_10923_length_831_cov_7.607923	216	296	0	29	80	0.3625000
NODE_10923_length_831_cov_7.607923	216	296	2	14	80	0.1750000
NODE_10923_length_831_cov_7.607923	216	296	4	37	80	0.4625000
NODE_10923_length_831_cov_7.607923	269	349	2	9	80	0.1125000
NODE_10923_length_831_cov_7.607923	269	349	4	71	80	0.8875000
NODE_10924_length_831_cov_6.454918	334	409	0	49	75	0.6533333
NODE_10924_length_831_cov_6.454918	334	409	2	26	75	0.3466667
NODE_10924_length_831_cov_6.454918	382	462	0	1	80	0.0125000
NODE_10924_length_831_cov_6.454918	382	462	2	79	80	0.9875000
NODE_10960_length_830_cov_40.856361	238	318	0	80	80	1.0000000
NODE_10960_length_830_cov_40.856361	291	371	0	80	80	1.0000000
NODE_10961_length_830_cov_32.170999	302	378	0	7	76	0.0921053
NODE_10961_length_830_cov_32.170999	302	378	2	69	76	0.9078947
NODE_10961_length_830_cov_32.170999	303	383	0	7	80	0.0875000
NODE_10961_length_830_cov_32.170999	303	383	2	73	80	0.9125000
NODE_10961_length_830_cov_32.170999	356	436	0	44	80	0.5500000
NODE_10961_length_830_cov_32.170999	356	436	2	36	80	0.4500000
NODE_10962_length_830_cov_28.041040	393	473	4	80	80	1.0000000
NODE_10962_length_830_cov_28.041040	446	526	0	22	80	0.2750000
NODE_10962_length_830_cov_28.041040	446	526	4	58	80	0.7250000
NODE_10963_length_830_cov_20.280438	360	440	0	17	80	0.2125000
NODE_10963_length_830_cov_20.280438	360	440	2	63	80	0.7875000
NODE_10963_length_830_cov_20.280438	413	492	0	26	79	0.3291139
NODE_10963_length_830_cov_20.280438	413	492	2	10	79	0.1265823
NODE_10963_length_830_cov_20.280438	413	492	6	43	79	0.5443038
NODE_10964_length_830_cov_19.495212	274	354	0	80	80	1.0000000
NODE_10964_length_830_cov_19.495212	327	407	0	80	80	1.0000000
NODE_10965_length_830_cov_18.522572	368	448	2	27	80	0.3375000
NODE_10965_length_830_cov_18.522572	368	448	8	24	80	0.3000000
NODE_10965_length_830_cov_18.522572	368	448	10	29	80	0.3625000
NODE_10965_length_830_cov_18.522572	421	501	2	14	80	0.1750000
NODE_10965_length_830_cov_18.522572	421	501	8	29	80	0.3625000
NODE_10965_length_830_cov_18.522572	421	501	10	37	80	0.4625000
NODE_10966_length_830_cov_13.830369	278	358	10	2	80	0.0250000
NODE_10966_length_830_cov_13.830369	278	358	15	1	80	0.0125000
NODE_10966_length_830_cov_13.830369	278	358	16	77	80	0.9625000
NODE_10966_length_830_cov_13.830369	331	411	0	41	80	0.5125000
NODE_10966_length_830_cov_13.830369	331	411	10	14	80	0.1750000
NODE_10966_length_830_cov_13.830369	331	411	15	1	80	0.0125000
NODE_10966_length_830_cov_13.830369	331	411	16	24	80	0.3000000
NODE_10967_length_830_cov_12.459644	201	281	0	80	80	1.0000000
NODE_10967_length_830_cov_12.459644	254	334	0	80	80	1.0000000
NODE_10968_length_830_cov_8.344733	450	530	0	80	80	1.0000000
NODE_10968_length_830_cov_8.344733	503	583	0	80	80	1.0000000
NODE_10969_length_830_cov_8.227086	634	714	0	16	80	0.2000000
NODE_10969_length_830_cov_8.227086	634	714	2	64	80	0.8000000
NODE_10969_length_830_cov_8.227086	687	767	0	69	80	0.8625000
NODE_10969_length_830_cov_8.227086	687	767	2	11	80	0.1375000
NODE_10995_length_829_cov_74.910959	271	351	0	24	80	0.3000000
NODE_10995_length_829_cov_74.910959	271	351	2	56	80	0.7000000
NODE_10995_length_829_cov_74.910959	324	404	0	31	80	0.3875000
NODE_10995_length_829_cov_74.910959	324	404	2	49	80	0.6125000
NODE_10996_length_829_cov_34.068493	302	382	0	80	80	1.0000000
NODE_10996_length_829_cov_34.068493	355	435	0	80	80	1.0000000
NODE_10997_length_829_cov_24.027397	441	521	8	2	80	0.0250000
NODE_10997_length_829_cov_24.027397	441	521	10	13	80	0.1625000
NODE_10997_length_829_cov_24.027397	441	521	12	65	80	0.8125000
NODE_10997_length_829_cov_24.027397	494	574	4	12	80	0.1500000
NODE_10997_length_829_cov_24.027397	494	574	6	17	80	0.2125000
NODE_10997_length_829_cov_24.027397	494	574	8	15	80	0.1875000
NODE_10997_length_829_cov_24.027397	494	574	12	36	80	0.4500000
NODE_10998_length_829_cov_21.735616	420	500	4	38	80	0.4750000
NODE_10998_length_829_cov_21.735616	420	500	8	42	80	0.5250000
NODE_10998_length_829_cov_21.735616	473	553	4	66	80	0.8250000
NODE_10998_length_829_cov_21.735616	473	553	8	14	80	0.1750000
NODE_10999_length_829_cov_18.446575	407	487	0	80	80	1.0000000
NODE_10999_length_829_cov_18.446575	460	540	0	80	80	1.0000000
NODE_11000_length_829_cov_10.971233	368	448	0	5	80	0.0625000
NODE_11000_length_829_cov_10.971233	368	448	1	1	80	0.0125000
NODE_11000_length_829_cov_10.971233	368	448	2	30	80	0.3750000
NODE_11000_length_829_cov_10.971233	368	448	4	27	80	0.3375000
NODE_11000_length_829_cov_10.971233	368	448	6	17	80	0.2125000
NODE_11000_length_829_cov_10.971233	421	501	4	10	80	0.1250000
NODE_11000_length_829_cov_10.971233	421	501	6	52	80	0.6500000
NODE_11000_length_829_cov_10.971233	421	501	7	13	80	0.1625000
NODE_11000_length_829_cov_10.971233	421	501	10	4	80	0.0500000
NODE_11000_length_829_cov_10.971233	421	501	12	1	80	0.0125000
NODE_11001_length_829_cov_10.035616	387	467	0	80	80	1.0000000
NODE_11001_length_829_cov_10.035616	440	520	0	80	80	1.0000000
NODE_11002_length_829_cov_9.906849	326	406	0	80	80	1.0000000
NODE_11002_length_829_cov_9.906849	379	459	0	79	80	0.9875000
NODE_11002_length_829_cov_9.906849	379	459	2	1	80	0.0125000
NODE_11003_length_829_cov_8.809589	450	530	0	18	80	0.2250000
NODE_11003_length_829_cov_8.809589	450	530	2	62	80	0.7750000
NODE_11003_length_829_cov_8.809589	503	583	0	70	80	0.8750000
NODE_11003_length_829_cov_8.809589	503	583	2	10	80	0.1250000
NODE_11006_length_829_cov_4.310959	473	553	0	80	80	1.0000000
NODE_11006_length_829_cov_4.310959	526	606	0	80	80	1.0000000
NODE_11008_length_829_cov_3.079452	507	587	0	65	80	0.8125000
NODE_11008_length_829_cov_3.079452	507	587	2	15	80	0.1875000
NODE_11008_length_829_cov_3.079452	507	587	0	65	80	0.8125000
NODE_11008_length_829_cov_3.079452	507	587	2	15	80	0.1875000
NODE_11008_length_829_cov_3.079452	560	640	0	12	80	0.1500000
NODE_11008_length_829_cov_3.079452	560	640	2	68	80	0.8500000
NODE_11025_length_828_cov_41.116598	436	516	0	70	80	0.8750000
NODE_11025_length_828_cov_41.116598	436	516	2	10	80	0.1250000
NODE_11025_length_828_cov_41.116598	489	569	0	17	80	0.2125000
NODE_11025_length_828_cov_41.116598	489	569	2	63	80	0.7875000
NODE_11026_length_828_cov_36.459534	372	452	4	32	80	0.4000000
NODE_11026_length_828_cov_36.459534	372	452	8	48	80	0.6000000
NODE_11026_length_828_cov_36.459534	425	505	0	14	80	0.1750000
NODE_11026_length_828_cov_36.459534	425	505	4	11	80	0.1375000
NODE_11026_length_828_cov_36.459534	425	505	8	55	80	0.6875000
NODE_11027_length_828_cov_33.515775	443	523	4	16	80	0.2000000
NODE_11027_length_828_cov_33.515775	443	523	6	21	80	0.2625000
NODE_11027_length_828_cov_33.515775	443	523	8	27	80	0.3375000
NODE_11027_length_828_cov_33.515775	443	523	10	16	80	0.2000000
NODE_11027_length_828_cov_33.515775	496	576	2	21	80	0.2625000
NODE_11027_length_828_cov_33.515775	496	576	4	48	80	0.6000000
NODE_11027_length_828_cov_33.515775	496	576	8	11	80	0.1375000
NODE_11028_length_828_cov_21.123457	380	460	0	80	80	1.0000000
NODE_11028_length_828_cov_21.123457	433	513	0	80	80	1.0000000
NODE_11029_length_828_cov_17.406036	304	392	0	88	88	1.0000000
NODE_11029_length_828_cov_17.406036	369	445	0	76	76	1.0000000
NODE_11030_length_828_cov_14.606310	287	367	0	80	80	1.0000000
NODE_11030_length_828_cov_14.606310	340	420	0	80	80	1.0000000
NODE_11031_length_828_cov_14.493827	326	406	0	48	80	0.6000000
NODE_11031_length_828_cov_14.493827	326	406	4	32	80	0.4000000
NODE_11031_length_828_cov_14.493827	379	459	0	65	80	0.8125000
NODE_11031_length_828_cov_14.493827	379	459	2	15	80	0.1875000
NODE_11031_length_828_cov_14.493827	455	535	2	80	80	1.0000000
NODE_11031_length_828_cov_14.493827	508	588	0	8	80	0.1000000
NODE_11031_length_828_cov_14.493827	508	588	2	72	80	0.9000000
NODE_11032_length_828_cov_10.550069	280	360	2	11	80	0.1375000
NODE_11032_length_828_cov_10.550069	280	360	4	3	80	0.0375000
NODE_11032_length_828_cov_10.550069	280	360	6	66	80	0.8250000
NODE_11032_length_828_cov_10.550069	333	413	0	29	80	0.3625000
NODE_11032_length_828_cov_10.550069	333	413	2	35	80	0.4375000
NODE_11032_length_828_cov_10.550069	333	413	6	16	80	0.2000000
NODE_11033_length_828_cov_9.292181	594	674	0	60	80	0.7500000
NODE_11033_length_828_cov_9.292181	594	674	2	20	80	0.2500000
NODE_11033_length_828_cov_9.292181	647	727	0	80	80	1.0000000
NODE_11034_length_828_cov_8.747599	298	378	0	80	80	1.0000000
NODE_11034_length_828_cov_8.747599	351	431	0	80	80	1.0000000
NODE_11035_length_828_cov_8.098765	199	279	0	21	80	0.2625000
NODE_11035_length_828_cov_8.098765	199	279	2	1	80	0.0125000
NODE_11035_length_828_cov_8.098765	199	279	4	58	80	0.7250000
NODE_11035_length_828_cov_8.098765	252	332	4	80	80	1.0000000
NODE_11037_length_828_cov_7.473251	300	380	0	80	80	1.0000000
NODE_11037_length_828_cov_7.473251	353	433	0	80	80	1.0000000
NODE_11039_length_828_cov_5.481481	543	623	0	64	80	0.8000000
NODE_11039_length_828_cov_5.481481	543	623	2	16	80	0.2000000
NODE_11039_length_828_cov_5.481481	596	676	0	11	80	0.1375000
NODE_11039_length_828_cov_5.481481	596	676	2	69	80	0.8625000
NODE_11041_length_828_cov_5.069959	259	339	5	32	80	0.4000000
NODE_11041_length_828_cov_5.069959	259	339	6	48	80	0.6000000
NODE_11066_length_827_cov_34.567308	269	349	0	26	80	0.3250000
NODE_11066_length_827_cov_34.567308	269	349	4	2	80	0.0250000
NODE_11066_length_827_cov_34.567308	269	349	6	52	80	0.6500000
NODE_11066_length_827_cov_34.567308	322	402	2	10	80	0.1250000
NODE_11066_length_827_cov_34.567308	322	402	6	70	80	0.8750000
NODE_11066_length_827_cov_34.567308	398	478	0	60	80	0.7500000
NODE_11066_length_827_cov_34.567308	398	478	2	20	80	0.2500000
NODE_11066_length_827_cov_34.567308	451	531	0	19	80	0.2375000
NODE_11066_length_827_cov_34.567308	451	531	2	61	80	0.7625000
NODE_11067_length_827_cov_31.538462	320	400	0	66	80	0.8250000
NODE_11067_length_827_cov_31.538462	320	400	4	14	80	0.1750000
NODE_11067_length_827_cov_31.538462	373	453	0	13	80	0.1625000
NODE_11067_length_827_cov_31.538462	373	453	4	67	80	0.8375000
NODE_11068_length_827_cov_19.548077	464	544	0	71	80	0.8875000
NODE_11068_length_827_cov_19.548077	464	544	2	9	80	0.1125000
NODE_11068_length_827_cov_19.548077	517	597	0	80	80	1.0000000
NODE_11069_length_827_cov_17.490385	320	400	0	15	80	0.1875000
NODE_11069_length_827_cov_17.490385	320	400	2	65	80	0.8125000
NODE_11069_length_827_cov_17.490385	373	453	2	33	80	0.4125000
NODE_11069_length_827_cov_17.490385	373	453	4	47	80	0.5875000
NODE_11070_length_827_cov_15.247253	205	285	0	80	80	1.0000000
NODE_11070_length_827_cov_15.247253	258	338	0	80	80	1.0000000
NODE_11071_length_827_cov_14.151099	372	452	0	36	80	0.4500000
NODE_11071_length_827_cov_14.151099	372	452	5	1	80	0.0125000
NODE_11071_length_827_cov_14.151099	372	452	6	43	80	0.5375000
NODE_11071_length_827_cov_14.151099	425	505	6	80	80	1.0000000
NODE_11072_length_827_cov_12.157967	262	342	0	80	80	1.0000000
NODE_11072_length_827_cov_12.157967	315	395	0	30	80	0.3750000
NODE_11072_length_827_cov_12.157967	315	395	2	50	80	0.6250000
NODE_11073_length_827_cov_11.777473	316	396	0	80	80	1.0000000
NODE_11073_length_827_cov_11.777473	369	449	0	80	80	1.0000000
NODE_11074_length_827_cov_11.651099	393	473	0	80	80	1.0000000
NODE_11074_length_827_cov_11.651099	446	526	0	80	80	1.0000000
NODE_11075_length_827_cov_10.711538	286	366	0	20	80	0.2500000
NODE_11075_length_827_cov_10.711538	286	366	4	14	80	0.1750000
NODE_11075_length_827_cov_10.711538	286	366	6	46	80	0.5750000
NODE_11075_length_827_cov_10.711538	339	419	4	25	80	0.3125000
NODE_11075_length_827_cov_10.711538	339	419	6	55	80	0.6875000
NODE_11076_length_827_cov_10.262363	273	353	0	74	80	0.9250000
NODE_11076_length_827_cov_10.262363	273	353	2	6	80	0.0750000
NODE_11076_length_827_cov_10.262363	326	406	0	21	80	0.2625000
NODE_11076_length_827_cov_10.262363	326	406	2	59	80	0.7375000
NODE_11077_length_827_cov_10.221154	256	336	2	3	80	0.0375000
NODE_11077_length_827_cov_10.221154	256	336	4	51	80	0.6375000
NODE_11077_length_827_cov_10.221154	256	336	6	26	80	0.3250000
NODE_11078_length_827_cov_9.576923	359	439	0	80	80	1.0000000
NODE_11078_length_827_cov_9.576923	412	492	0	80	80	1.0000000
NODE_11079_length_827_cov_8.780220	361	441	0	23	80	0.2875000
NODE_11079_length_827_cov_8.780220	361	441	1	1	80	0.0125000
NODE_11079_length_827_cov_8.780220	361	441	4	15	80	0.1875000
NODE_11079_length_827_cov_8.780220	361	441	12	5	80	0.0625000
NODE_11079_length_827_cov_8.780220	361	441	16	16	80	0.2000000
NODE_11079_length_827_cov_8.780220	361	441	17	10	80	0.1250000
NODE_11079_length_827_cov_8.780220	361	441	18	10	80	0.1250000
NODE_11079_length_827_cov_8.780220	414	494	16	16	80	0.2000000
NODE_11079_length_827_cov_8.780220	414	494	17	10	80	0.1250000
NODE_11079_length_827_cov_8.780220	414	494	18	18	80	0.2250000
NODE_11079_length_827_cov_8.780220	414	494	20	2	80	0.0250000
NODE_11079_length_827_cov_8.780220	414	494	22	34	80	0.4250000
NODE_11093_length_827_cov_1.412088	736	784	2	6	48	0.1250000
NODE_11093_length_827_cov_1.412088	736	784	4	42	48	0.8750000
NODE_11106_length_826_cov_34.026135	211	291	4	13	80	0.1625000
NODE_11106_length_826_cov_34.026135	211	291	6	23	80	0.2875000
NODE_11106_length_826_cov_34.026135	211	291	8	33	80	0.4125000
NODE_11106_length_826_cov_34.026135	211	291	10	11	80	0.1375000
NODE_11106_length_826_cov_34.026135	264	344	4	22	80	0.2750000
NODE_11106_length_826_cov_34.026135	264	344	6	46	80	0.5750000
NODE_11106_length_826_cov_34.026135	264	344	8	12	80	0.1500000
NODE_11107_length_826_cov_24.093535	282	362	0	1	80	0.0125000
NODE_11107_length_826_cov_24.093535	282	362	2	79	80	0.9875000
NODE_11107_length_826_cov_24.093535	335	415	0	54	80	0.6750000
NODE_11107_length_826_cov_24.093535	335	415	2	26	80	0.3250000
NODE_11108_length_826_cov_20.943604	207	287	0	80	80	1.0000000
NODE_11108_length_826_cov_20.943604	260	340	0	80	80	1.0000000
NODE_11109_length_826_cov_20.437414	413	493	0	23	80	0.2875000
NODE_11109_length_826_cov_20.437414	413	493	6	57	80	0.7125000
NODE_11109_length_826_cov_20.437414	466	546	2	30	80	0.3750000
NODE_11109_length_826_cov_20.437414	466	546	6	34	80	0.4250000
NODE_11109_length_826_cov_20.437414	466	546	8	16	80	0.2000000
NODE_11110_length_826_cov_20.200825	432	512	0	80	80	1.0000000
NODE_11110_length_826_cov_20.200825	485	565	0	58	80	0.7250000
NODE_11110_length_826_cov_20.200825	485	565	2	22	80	0.2750000
NODE_11111_length_826_cov_18.489684	345	425	0	17	80	0.2125000
NODE_11111_length_826_cov_18.489684	345	425	2	63	80	0.7875000
NODE_11111_length_826_cov_18.489684	398	478	0	70	80	0.8750000
NODE_11111_length_826_cov_18.489684	398	478	2	10	80	0.1250000
NODE_11112_length_826_cov_17.998624	336	416	0	51	80	0.6375000
NODE_11112_length_826_cov_17.998624	336	416	2	29	80	0.3625000
NODE_11112_length_826_cov_17.998624	389	469	0	80	80	1.0000000
NODE_11113_length_826_cov_17.038514	358	438	0	80	80	1.0000000
NODE_11113_length_826_cov_17.038514	411	491	0	80	80	1.0000000
NODE_11114_length_826_cov_16.777166	514	603	0	89	89	1.0000000
NODE_11115_length_826_cov_16.177442	361	441	0	80	80	1.0000000
NODE_11115_length_826_cov_16.177442	414	494	0	80	80	1.0000000
NODE_11116_length_826_cov_15.134801	346	426	0	19	80	0.2375000
NODE_11116_length_826_cov_15.134801	346	426	2	23	80	0.2875000
NODE_11116_length_826_cov_15.134801	346	426	6	38	80	0.4750000
NODE_11116_length_826_cov_15.134801	399	479	4	41	80	0.5125000
NODE_11116_length_826_cov_15.134801	399	479	6	39	80	0.4875000
NODE_11117_length_826_cov_9.943604	320	400	0	31	80	0.3875000
NODE_11117_length_826_cov_9.943604	320	400	2	49	80	0.6125000
NODE_11117_length_826_cov_9.943604	373	453	0	11	80	0.1375000
NODE_11117_length_826_cov_9.943604	373	453	2	69	80	0.8625000
NODE_11120_length_826_cov_4.852820	501	579	0	78	78	1.0000000
NODE_11120_length_826_cov_4.852820	552	632	0	80	80	1.0000000
NODE_11161_length_825_cov_61.804408	382	462	0	43	80	0.5375000
NODE_11161_length_825_cov_61.804408	382	462	2	37	80	0.4625000
NODE_11161_length_825_cov_61.804408	435	514	0	27	79	0.3417721
NODE_11161_length_825_cov_61.804408	435	514	2	52	79	0.6582279
NODE_11162_length_825_cov_43.825069	488	568	0	22	80	0.2750000
NODE_11162_length_825_cov_43.825069	488	568	6	58	80	0.7250000
NODE_11162_length_825_cov_43.825069	541	621	0	75	80	0.9375000
NODE_11162_length_825_cov_43.825069	541	621	6	5	80	0.0625000
NODE_11162_length_825_cov_43.825069	617	697	0	6	80	0.0750000
NODE_11162_length_825_cov_43.825069	617	697	5	1	80	0.0125000
NODE_11162_length_825_cov_43.825069	617	697	6	26	80	0.3250000
NODE_11162_length_825_cov_43.825069	617	697	12	24	80	0.3000000
NODE_11162_length_825_cov_43.825069	617	697	14	23	80	0.2875000
NODE_11162_length_825_cov_43.825069	670	750	10	20	80	0.2500000
NODE_11162_length_825_cov_43.825069	670	750	12	4	80	0.0500000
NODE_11162_length_825_cov_43.825069	670	750	14	47	80	0.5875000
NODE_11162_length_825_cov_43.825069	670	750	15	4	80	0.0500000
NODE_11162_length_825_cov_43.825069	670	750	16	5	80	0.0625000
NODE_11163_length_825_cov_43.389807	496	576	2	12	80	0.1500000
NODE_11163_length_825_cov_43.389807	496	576	8	9	80	0.1125000
NODE_11163_length_825_cov_43.389807	496	576	10	36	80	0.4500000
NODE_11163_length_825_cov_43.389807	496	576	12	23	80	0.2875000
NODE_11163_length_825_cov_43.389807	549	629	8	8	80	0.1000000
NODE_11163_length_825_cov_43.389807	549	629	10	42	80	0.5250000
NODE_11163_length_825_cov_43.389807	549	629	12	30	80	0.3750000
NODE_11164_length_825_cov_39.603306	386	466	0	17	80	0.2125000
NODE_11164_length_825_cov_39.603306	386	466	2	63	80	0.7875000
NODE_11164_length_825_cov_39.603306	439	519	0	13	80	0.1625000
NODE_11164_length_825_cov_39.603306	439	519	2	67	80	0.8375000
NODE_11165_length_825_cov_32.205234	354	434	0	80	80	1.0000000
NODE_11165_length_825_cov_32.205234	407	487	0	80	80	1.0000000
NODE_11166_length_825_cov_29.411846	503	583	0	21	80	0.2625000
NODE_11166_length_825_cov_29.411846	503	583	2	59	80	0.7375000
NODE_11166_length_825_cov_29.411846	556	636	0	54	80	0.6750000
NODE_11166_length_825_cov_29.411846	556	636	2	26	80	0.3250000
NODE_11167_length_825_cov_22.428375	312	392	0	36	80	0.4500000
NODE_11167_length_825_cov_22.428375	312	392	8	44	80	0.5500000
NODE_11167_length_825_cov_22.428375	365	445	2	4	80	0.0500000
NODE_11167_length_825_cov_22.428375	365	445	8	31	80	0.3875000
NODE_11167_length_825_cov_22.428375	365	445	9	1	80	0.0125000
NODE_11167_length_825_cov_22.428375	365	445	10	44	80	0.5500000
NODE_11167_length_825_cov_22.428375	441	521	2	53	80	0.6625000
NODE_11167_length_825_cov_22.428375	441	521	6	27	80	0.3375000
NODE_11167_length_825_cov_22.428375	494	574	4	38	80	0.4750000
NODE_11167_length_825_cov_22.428375	494	574	6	42	80	0.5250000
NODE_11168_length_825_cov_19.964187	249	329	0	80	80	1.0000000
NODE_11168_length_825_cov_19.964187	302	382	0	80	80	1.0000000
NODE_11169_length_825_cov_13.790634	273	353	0	80	80	1.0000000
NODE_11169_length_825_cov_13.790634	326	406	0	80	80	1.0000000
NODE_11170_length_825_cov_11.834711	331	411	0	31	80	0.3875000
NODE_11170_length_825_cov_11.834711	331	411	6	49	80	0.6125000
NODE_11170_length_825_cov_11.834711	384	464	0	4	80	0.0500000
NODE_11170_length_825_cov_11.834711	384	464	2	28	80	0.3500000
NODE_11170_length_825_cov_11.834711	384	464	6	48	80	0.6000000
NODE_11171_length_825_cov_11.477961	392	472	0	23	80	0.2875000
NODE_11171_length_825_cov_11.477961	392	472	2	20	80	0.2500000
NODE_11171_length_825_cov_11.477961	392	472	4	37	80	0.4625000
NODE_11172_length_825_cov_8.947658	259	339	0	80	80	1.0000000
NODE_11172_length_825_cov_8.947658	312	392	0	80	80	1.0000000
NODE_11173_length_825_cov_7.811295	379	459	0	80	80	1.0000000
NODE_11173_length_825_cov_7.811295	432	512	0	80	80	1.0000000
NODE_11174_length_825_cov_7.104683	464	544	0	7	80	0.0875000
NODE_11174_length_825_cov_7.104683	464	544	2	73	80	0.9125000
NODE_11174_length_825_cov_7.104683	517	597	0	60	80	0.7500000
NODE_11174_length_825_cov_7.104683	517	597	2	20	80	0.2500000
NODE_11176_length_825_cov_6.252066	542	622	0	80	80	1.0000000
NODE_11176_length_825_cov_6.252066	595	675	0	80	80	1.0000000
NODE_11178_length_825_cov_5.230028	264	344	0	80	80	1.0000000
NODE_11178_length_825_cov_5.230028	317	372	0	55	55	1.0000000
NODE_11178_length_825_cov_5.230028	383	463	0	23	80	0.2875000
NODE_11178_length_825_cov_5.230028	383	463	2	57	80	0.7125000
NODE_11178_length_825_cov_5.230028	436	516	2	74	80	0.9250000
NODE_11178_length_825_cov_5.230028	436	516	4	6	80	0.0750000
NODE_11205_length_825_cov_0.765840	0	50	0	50	50	1.0000000
NODE_11207_length_824_cov_27.074483	337	412	0	75	75	1.0000000
NODE_11207_length_824_cov_27.074483	390	470	0	32	80	0.4000000
NODE_11207_length_824_cov_27.074483	390	470	2	48	80	0.6000000
NODE_11208_length_824_cov_23.936552	365	445	0	16	80	0.2000000
NODE_11208_length_824_cov_23.936552	365	445	2	64	80	0.8000000
NODE_11208_length_824_cov_23.936552	418	493	0	49	75	0.6533333
NODE_11208_length_824_cov_23.936552	418	493	2	26	75	0.3466667
NODE_11209_length_824_cov_22.129655	377	457	1	2	80	0.0250000
NODE_11209_length_824_cov_22.129655	377	457	2	78	80	0.9750000
NODE_11209_length_824_cov_22.129655	430	510	0	51	80	0.6375000
NODE_11209_length_824_cov_22.129655	430	510	1	4	80	0.0500000
NODE_11209_length_824_cov_22.129655	430	510	2	25	80	0.3125000
NODE_11210_length_824_cov_17.914483	387	467	0	30	80	0.3750000
NODE_11210_length_824_cov_17.914483	387	467	2	50	80	0.6250000
NODE_11210_length_824_cov_17.914483	440	520	0	74	80	0.9250000
NODE_11210_length_824_cov_17.914483	440	520	2	6	80	0.0750000
NODE_11211_length_824_cov_16.662069	362	442	2	9	80	0.1125000
NODE_11211_length_824_cov_16.662069	362	442	6	71	80	0.8875000
NODE_11211_length_824_cov_16.662069	415	495	1	3	80	0.0375000
NODE_11211_length_824_cov_16.662069	415	495	2	54	80	0.6750000
NODE_11211_length_824_cov_16.662069	415	495	6	23	80	0.2875000
NODE_11212_length_824_cov_16.306207	352	432	0	80	80	1.0000000
NODE_11212_length_824_cov_16.306207	405	485	0	52	80	0.6500000
NODE_11212_length_824_cov_16.306207	405	485	2	28	80	0.3500000
NODE_11213_length_824_cov_15.891034	342	422	0	80	80	1.0000000
NODE_11213_length_824_cov_15.891034	395	475	0	80	80	1.0000000
NODE_11214_length_824_cov_12.485517	280	360	0	46	80	0.5750000
NODE_11214_length_824_cov_12.485517	280	360	2	34	80	0.4250000
NODE_11214_length_824_cov_12.485517	333	413	2	80	80	1.0000000
NODE_11216_length_824_cov_5.924138	269	349	0	15	80	0.1875000
NODE_11216_length_824_cov_5.924138	269	349	2	65	80	0.8125000
NODE_11216_length_824_cov_5.924138	322	402	0	23	80	0.2875000
NODE_11216_length_824_cov_5.924138	322	402	2	57	80	0.7125000
NODE_11222_length_824_cov_3.849655	191	271	0	63	80	0.7875000
NODE_11222_length_824_cov_3.849655	191	271	2	17	80	0.2125000
NODE_11251_length_823_cov_75.169890	207	287	2	58	80	0.7250000
NODE_11251_length_823_cov_75.169890	207	287	12	10	80	0.1250000
NODE_11251_length_823_cov_75.169890	207	287	13	1	80	0.0125000
NODE_11251_length_823_cov_75.169890	207	287	14	11	80	0.1375000
NODE_11251_length_823_cov_75.169890	260	340	2	5	80	0.0625000
NODE_11251_length_823_cov_75.169890	260	340	12	61	80	0.7625000
NODE_11251_length_823_cov_75.169890	260	340	13	1	80	0.0125000
NODE_11251_length_823_cov_75.169890	260	340	14	11	80	0.1375000
NODE_11251_length_823_cov_75.169890	260	340	18	2	80	0.0250000
NODE_11251_length_823_cov_75.169890	336	416	5	7	80	0.0875000
NODE_11251_length_823_cov_75.169890	336	416	6	27	80	0.3375000
NODE_11251_length_823_cov_75.169890	336	416	7	9	80	0.1125000
NODE_11251_length_823_cov_75.169890	336	416	12	2	80	0.0250000
NODE_11251_length_823_cov_75.169890	336	416	18	35	80	0.4375000
NODE_11251_length_823_cov_75.169890	389	469	5	7	80	0.0875000
NODE_11251_length_823_cov_75.169890	389	469	6	11	80	0.1375000
NODE_11251_length_823_cov_75.169890	389	469	7	62	80	0.7750000
NODE_11253_length_823_cov_37.738950	332	412	0	28	80	0.3500000
NODE_11253_length_823_cov_37.738950	332	412	4	52	80	0.6500000
NODE_11253_length_823_cov_37.738950	385	466	0	81	81	1.0000000
NODE_11254_length_823_cov_29.349448	400	480	0	52	80	0.6500000
NODE_11254_length_823_cov_29.349448	400	480	2	28	80	0.3500000
NODE_11254_length_823_cov_29.349448	453	533	2	80	80	1.0000000
NODE_11255_length_823_cov_25.730663	338	418	0	80	80	1.0000000
NODE_11255_length_823_cov_25.730663	391	471	0	80	80	1.0000000
NODE_11256_length_823_cov_24.599448	349	429	0	20	80	0.2500000
NODE_11256_length_823_cov_24.599448	349	429	2	20	80	0.2500000
NODE_11256_length_823_cov_24.599448	349	429	8	15	80	0.1875000
NODE_11256_length_823_cov_24.599448	349	429	10	25	80	0.3125000
NODE_11256_length_823_cov_24.599448	402	482	8	49	80	0.6125000
NODE_11256_length_823_cov_24.599448	402	482	10	31	80	0.3875000
NODE_11257_length_823_cov_22.149171	356	436	0	80	80	1.0000000
NODE_11257_length_823_cov_22.149171	409	489	0	80	80	1.0000000
NODE_11257_length_823_cov_22.149171	485	565	0	80	80	1.0000000
NODE_11257_length_823_cov_22.149171	538	618	0	80	80	1.0000000
NODE_11258_length_823_cov_20.892265	329	409	0	80	80	1.0000000
NODE_11258_length_823_cov_20.892265	382	462	0	80	80	1.0000000
NODE_11259_length_823_cov_19.281768	305	385	0	60	80	0.7500000
NODE_11259_length_823_cov_19.281768	305	385	2	20	80	0.2500000
NODE_11259_length_823_cov_19.281768	358	438	0	7	80	0.0875000
NODE_11259_length_823_cov_19.281768	358	438	2	73	80	0.9125000
NODE_11260_length_823_cov_15.738950	409	489	0	80	80	1.0000000
NODE_11260_length_823_cov_15.738950	462	542	0	80	80	1.0000000
NODE_11261_length_823_cov_10.729282	362	437	0	23	75	0.3066667
NODE_11261_length_823_cov_10.729282	362	437	2	52	75	0.6933333
NODE_11261_length_823_cov_10.729282	410	484	0	12	74	0.1621622
NODE_11261_length_823_cov_10.729282	410	484	2	62	74	0.8378378
NODE_11262_length_823_cov_9.110497	394	474	0	80	80	1.0000000
NODE_11262_length_823_cov_9.110497	447	527	0	80	80	1.0000000
NODE_11265_length_823_cov_5.511050	168	248	7	2	80	0.0250000
NODE_11265_length_823_cov_5.511050	168	248	10	10	80	0.1250000
NODE_11265_length_823_cov_5.511050	168	248	11	13	80	0.1625000
NODE_11265_length_823_cov_5.511050	168	248	13	13	80	0.1625000
NODE_11265_length_823_cov_5.511050	168	248	15	42	80	0.5250000
NODE_11265_length_823_cov_5.511050	434	485	0	51	51	1.0000000
NODE_11292_length_823_cov_0.968232	86	154	0	16	68	0.2352941
NODE_11292_length_823_cov_0.968232	86	154	2	52	68	0.7647059
NODE_11298_length_822_cov_25.423237	377	459	0	3	82	0.0365854
NODE_11298_length_822_cov_25.423237	377	459	2	79	82	0.9634146
NODE_11298_length_822_cov_25.423237	432	512	0	38	80	0.4750000
NODE_11298_length_822_cov_25.423237	432	512	2	42	80	0.5250000
NODE_11299_length_822_cov_16.381743	394	474	6	1	80	0.0125000
NODE_11299_length_822_cov_16.381743	394	474	7	3	80	0.0375000
NODE_11299_length_822_cov_16.381743	394	474	12	76	80	0.9500000
NODE_11299_length_822_cov_16.381743	447	527	0	32	80	0.4000000
NODE_11299_length_822_cov_16.381743	447	527	5	1	80	0.0125000
NODE_11299_length_822_cov_16.381743	447	527	6	17	80	0.2125000
NODE_11299_length_822_cov_16.381743	447	527	12	30	80	0.3750000
NODE_11300_length_822_cov_12.426003	223	296	0	73	73	1.0000000
NODE_11300_length_822_cov_12.426003	278	349	0	71	71	1.0000000
NODE_11301_length_822_cov_10.608575	464	544	0	3	80	0.0375000
NODE_11301_length_822_cov_10.608575	464	544	4	77	80	0.9625000
NODE_11301_length_822_cov_10.608575	517	597	0	56	80	0.7000000
NODE_11301_length_822_cov_10.608575	517	597	4	24	80	0.3000000
NODE_11302_length_822_cov_9.496542	363	443	0	5	80	0.0625000
NODE_11302_length_822_cov_9.496542	363	443	7	1	80	0.0125000
NODE_11302_length_822_cov_9.496542	363	443	8	74	80	0.9250000
NODE_11302_length_822_cov_9.496542	416	496	0	8	80	0.1000000
NODE_11302_length_822_cov_9.496542	416	496	8	72	80	0.9000000
NODE_11333_length_821_cov_39.818560	341	420	0	79	79	1.0000000
NODE_11333_length_821_cov_39.818560	393	473	0	61	80	0.7625000
NODE_11333_length_821_cov_39.818560	393	473	2	19	80	0.2375000
NODE_11334_length_821_cov_27.721607	299	379	0	80	80	1.0000000
NODE_11334_length_821_cov_27.721607	352	432	0	80	80	1.0000000
NODE_11335_length_821_cov_26.252078	386	466	4	8	80	0.1000000
NODE_11335_length_821_cov_26.252078	386	466	12	12	80	0.1500000
NODE_11335_length_821_cov_26.252078	386	466	14	6	80	0.0750000
NODE_11335_length_821_cov_26.252078	386	466	16	26	80	0.3250000
NODE_11335_length_821_cov_26.252078	386	466	18	28	80	0.3500000
NODE_11335_length_821_cov_26.252078	439	519	0	12	80	0.1500000
NODE_11335_length_821_cov_26.252078	439	519	2	29	80	0.3625000
NODE_11335_length_821_cov_26.252078	439	519	4	20	80	0.2500000
NODE_11335_length_821_cov_26.252078	439	519	12	12	80	0.1500000
NODE_11335_length_821_cov_26.252078	439	519	18	7	80	0.0875000
NODE_11336_length_821_cov_19.603878	353	433	0	5	80	0.0625000
NODE_11336_length_821_cov_19.603878	353	433	4	55	80	0.6875000
NODE_11336_length_821_cov_19.603878	353	433	6	20	80	0.2500000
NODE_11336_length_821_cov_19.603878	406	486	2	29	80	0.3625000
NODE_11336_length_821_cov_19.603878	406	486	4	30	80	0.3750000
NODE_11336_length_821_cov_19.603878	406	486	6	21	80	0.2625000
NODE_11337_length_821_cov_15.945983	310	390	4	22	80	0.2750000
NODE_11337_length_821_cov_15.945983	310	390	6	58	80	0.7250000
NODE_11337_length_821_cov_15.945983	363	443	0	34	80	0.4250000
NODE_11337_length_821_cov_15.945983	363	443	2	5	80	0.0625000
NODE_11337_length_821_cov_15.945983	363	443	4	6	80	0.0750000
NODE_11337_length_821_cov_15.945983	363	443	6	35	80	0.4375000
NODE_11339_length_821_cov_8.711911	288	368	0	80	80	1.0000000
NODE_11339_length_821_cov_8.711911	341	421	0	80	80	1.0000000
NODE_11349_length_821_cov_3.026316	310	390	0	80	80	1.0000000
NODE_11349_length_821_cov_3.026316	363	443	0	80	80	1.0000000
NODE_11361_length_820_cov_67.292649	328	408	12	38	80	0.4750000
NODE_11361_length_820_cov_67.292649	328	408	14	9	80	0.1125000
NODE_11361_length_820_cov_67.292649	328	408	22	2	80	0.0250000
NODE_11361_length_820_cov_67.292649	328	408	33	16	80	0.2000000
NODE_11361_length_820_cov_67.292649	328	408	34	4	80	0.0500000
NODE_11361_length_820_cov_67.292649	328	408	35	10	80	0.1250000
NODE_11361_length_820_cov_67.292649	328	408	36	1	80	0.0125000
NODE_11361_length_820_cov_67.292649	381	461	23	5	80	0.0625000
NODE_11361_length_820_cov_67.292649	381	461	29	3	80	0.0375000
NODE_11361_length_820_cov_67.292649	381	461	31	25	80	0.3125000
NODE_11361_length_820_cov_67.292649	381	461	33	16	80	0.2000000
NODE_11361_length_820_cov_67.292649	381	461	35	11	80	0.1375000
NODE_11361_length_820_cov_67.292649	381	461	36	20	80	0.2500000
NODE_11362_length_820_cov_26.915395	308	388	8	7	80	0.0875000
NODE_11362_length_820_cov_26.915395	308	388	10	9	80	0.1125000
NODE_11362_length_820_cov_26.915395	308	388	13	11	80	0.1375000
NODE_11362_length_820_cov_26.915395	308	388	14	1	80	0.0125000
NODE_11362_length_820_cov_26.915395	308	388	15	35	80	0.4375000
NODE_11362_length_820_cov_26.915395	308	388	16	6	80	0.0750000
NODE_11362_length_820_cov_26.915395	308	388	17	10	80	0.1250000
NODE_11362_length_820_cov_26.915395	308	388	19	1	80	0.0125000
NODE_11363_length_820_cov_25.253814	301	381	12	37	80	0.4625000
NODE_11363_length_820_cov_25.253814	301	381	16	43	80	0.5375000
NODE_11363_length_820_cov_25.253814	354	434	0	5	80	0.0625000
NODE_11363_length_820_cov_25.253814	354	434	4	22	80	0.2750000
NODE_11363_length_820_cov_25.253814	354	434	15	5	80	0.0625000
NODE_11363_length_820_cov_25.253814	354	434	16	48	80	0.6000000
NODE_11363_length_820_cov_25.253814	430	510	0	80	80	1.0000000
NODE_11363_length_820_cov_25.253814	483	563	0	80	80	1.0000000
NODE_11364_length_820_cov_16.015257	325	405	0	80	80	1.0000000
NODE_11364_length_820_cov_16.015257	378	458	0	80	80	1.0000000
NODE_11365_length_820_cov_14.703190	371	451	8	4	80	0.0500000
NODE_11365_length_820_cov_14.703190	371	451	12	33	80	0.4125000
NODE_11365_length_820_cov_14.703190	371	451	14	43	80	0.5375000
NODE_11365_length_820_cov_14.703190	424	504	8	24	80	0.3000000
NODE_11365_length_820_cov_14.703190	424	504	10	20	80	0.2500000
NODE_11365_length_820_cov_14.703190	424	504	12	5	80	0.0625000
NODE_11365_length_820_cov_14.703190	424	504	14	31	80	0.3875000
NODE_11366_length_820_cov_14.527046	249	329	4	80	80	1.0000000
NODE_11366_length_820_cov_14.527046	302	382	0	49	80	0.6125000
NODE_11366_length_820_cov_14.527046	302	382	4	31	80	0.3875000
NODE_11367_length_820_cov_14.284327	286	366	0	80	80	1.0000000
NODE_11367_length_820_cov_14.284327	339	419	0	80	80	1.0000000
NODE_11367_length_820_cov_14.284327	619	699	0	46	80	0.5750000
NODE_11367_length_820_cov_14.284327	619	699	2	34	80	0.4250000
NODE_11368_length_820_cov_13.036061	364	444	0	6	80	0.0750000
NODE_11368_length_820_cov_13.036061	364	444	2	74	80	0.9250000
NODE_11368_length_820_cov_13.036061	417	497	0	59	80	0.7375000
NODE_11368_length_820_cov_13.036061	417	497	2	21	80	0.2625000
NODE_11369_length_820_cov_12.830791	313	393	0	80	80	1.0000000
NODE_11369_length_820_cov_12.830791	366	446	0	80	80	1.0000000
NODE_11370_length_820_cov_12.768377	366	443	0	24	77	0.3116883
NODE_11370_length_820_cov_12.768377	366	443	2	21	77	0.2727273
NODE_11370_length_820_cov_12.768377	366	443	4	32	77	0.4155844
NODE_11370_length_820_cov_12.768377	496	525	0	19	29	0.6551724
NODE_11370_length_820_cov_12.768377	496	525	2	10	29	0.3448276
NODE_11371_length_820_cov_12.223301	452	519	2	21	67	0.3134328
NODE_11371_length_820_cov_12.223301	452	519	3	9	67	0.1343284
NODE_11371_length_820_cov_12.223301	452	519	4	37	67	0.5522388
NODE_11371_length_820_cov_12.223301	492	572	2	42	80	0.5250000
NODE_11371_length_820_cov_12.223301	492	572	4	34	80	0.4250000
NODE_11371_length_820_cov_12.223301	492	572	6	4	80	0.0500000
NODE_11396_length_819_cov_43.027778	403	483	0	80	80	1.0000000
NODE_11396_length_819_cov_43.027778	456	536	0	80	80	1.0000000
NODE_11396_length_819_cov_43.027778	532	612	0	70	80	0.8750000
NODE_11396_length_819_cov_43.027778	532	612	6	10	80	0.1250000
NODE_11396_length_819_cov_43.027778	585	665	0	17	80	0.2125000
NODE_11396_length_819_cov_43.027778	585	665	6	63	80	0.7875000
NODE_11397_length_819_cov_42.758333	391	471	0	80	80	1.0000000
NODE_11397_length_819_cov_42.758333	444	524	0	80	80	1.0000000
NODE_11398_length_819_cov_41.341667	86	166	0	80	80	1.0000000
NODE_11398_length_819_cov_41.341667	139	219	0	58	80	0.7250000
NODE_11398_length_819_cov_41.341667	139	219	2	3	80	0.0375000
NODE_11398_length_819_cov_41.341667	139	219	3	18	80	0.2250000
NODE_11398_length_819_cov_41.341667	139	219	4	1	80	0.0125000
NODE_11398_length_819_cov_41.341667	215	295	3	3	80	0.0375000
NODE_11398_length_819_cov_41.341667	215	295	4	18	80	0.2250000
NODE_11398_length_819_cov_41.341667	215	295	6	34	80	0.4250000
NODE_11398_length_819_cov_41.341667	215	295	8	25	80	0.3125000
NODE_11398_length_819_cov_41.341667	268	348	2	19	80	0.2375000
NODE_11398_length_819_cov_41.341667	268	348	4	12	80	0.1500000
NODE_11398_length_819_cov_41.341667	268	348	6	35	80	0.4375000
NODE_11398_length_819_cov_41.341667	268	348	8	14	80	0.1750000
NODE_11399_length_819_cov_23.656944	335	415	6	37	80	0.4625000
NODE_11399_length_819_cov_23.656944	335	415	8	7	80	0.0875000
NODE_11399_length_819_cov_23.656944	335	415	11	4	80	0.0500000
NODE_11399_length_819_cov_23.656944	335	415	12	32	80	0.4000000
NODE_11399_length_819_cov_23.656944	388	468	2	17	80	0.2125000
NODE_11399_length_819_cov_23.656944	388	468	5	2	80	0.0250000
NODE_11399_length_819_cov_23.656944	388	468	6	37	80	0.4625000
NODE_11399_length_819_cov_23.656944	388	468	8	6	80	0.0750000
NODE_11399_length_819_cov_23.656944	388	468	12	18	80	0.2250000
NODE_11400_length_819_cov_20.633333	475	555	0	80	80	1.0000000
NODE_11400_length_819_cov_20.633333	528	608	0	80	80	1.0000000
NODE_11401_length_819_cov_18.941667	307	387	0	36	80	0.4500000
NODE_11401_length_819_cov_18.941667	307	387	2	44	80	0.5500000
NODE_11401_length_819_cov_18.941667	360	440	0	80	80	1.0000000
NODE_11401_length_819_cov_18.941667	436	516	0	71	80	0.8875000
NODE_11401_length_819_cov_18.941667	436	516	2	9	80	0.1125000
NODE_11401_length_819_cov_18.941667	489	569	0	18	80	0.2250000
NODE_11401_length_819_cov_18.941667	489	569	2	28	80	0.3500000
NODE_11401_length_819_cov_18.941667	489	569	4	5	80	0.0625000
NODE_11401_length_819_cov_18.941667	489	569	6	13	80	0.1625000
NODE_11401_length_819_cov_18.941667	489	569	8	16	80	0.2000000
NODE_11402_length_819_cov_12.225000	431	511	0	80	80	1.0000000
NODE_11402_length_819_cov_12.225000	484	564	0	80	80	1.0000000
NODE_11403_length_819_cov_11.562500	273	353	0	12	80	0.1500000
NODE_11403_length_819_cov_11.562500	273	353	2	68	80	0.8500000
NODE_11403_length_819_cov_11.562500	326	406	0	11	80	0.1375000
NODE_11403_length_819_cov_11.562500	326	406	1	1	80	0.0125000
NODE_11403_length_819_cov_11.562500	326	406	2	68	80	0.8500000
NODE_11404_length_819_cov_8.905556	477	557	0	80	80	1.0000000
NODE_11404_length_819_cov_8.905556	530	610	0	80	80	1.0000000
NODE_11405_length_819_cov_5.675000	232	312	0	80	80	1.0000000
NODE_11405_length_819_cov_5.675000	285	365	0	80	80	1.0000000
NODE_11431_length_818_cov_21.979138	342	422	0	80	80	1.0000000
NODE_11431_length_818_cov_21.979138	395	475	0	28	80	0.3500000
NODE_11431_length_818_cov_21.979138	395	475	2	52	80	0.6500000
NODE_11432_length_818_cov_15.326843	334	414	2	57	80	0.7125000
NODE_11432_length_818_cov_15.326843	334	414	4	23	80	0.2875000
NODE_11432_length_818_cov_15.326843	387	467	2	79	80	0.9875000
NODE_11432_length_818_cov_15.326843	387	467	4	1	80	0.0125000
NODE_11433_length_818_cov_14.880389	392	472	0	11	80	0.1375000
NODE_11433_length_818_cov_14.880389	392	472	2	69	80	0.8625000
NODE_11433_length_818_cov_14.880389	445	525	0	64	80	0.8000000
NODE_11433_length_818_cov_14.880389	445	525	2	16	80	0.2000000
NODE_11434_length_818_cov_12.369958	390	470	0	80	80	1.0000000
NODE_11434_length_818_cov_12.369958	443	523	0	80	80	1.0000000
NODE_11436_length_818_cov_8.421419	370	450	0	80	80	1.0000000
NODE_11436_length_818_cov_8.421419	423	503	0	80	80	1.0000000
NODE_11437_length_818_cov_6.439499	706	741	0	33	35	0.9428571
NODE_11437_length_818_cov_6.439499	706	741	2	2	35	0.0571429
NODE_11439_length_818_cov_4.098748	320	390	0	70	70	1.0000000
NODE_11439_length_818_cov_4.098748	416	472	0	56	56	1.0000000
NODE_11457_length_817_cov_7.238162	494	574	0	9	80	0.1125000
NODE_11457_length_817_cov_7.238162	494	574	2	7	80	0.0875000
NODE_11457_length_817_cov_7.238162	494	574	4	64	80	0.8000000
NODE_11457_length_817_cov_7.238162	547	627	0	33	80	0.4125000
NODE_11457_length_817_cov_7.238162	547	627	2	9	80	0.1125000
NODE_11457_length_817_cov_7.238162	547	627	4	38	80	0.4750000
NODE_11458_length_817_cov_5.789694	400	480	0	31	80	0.3875000
NODE_11458_length_817_cov_5.789694	400	480	2	49	80	0.6125000
NODE_11458_length_817_cov_5.789694	476	555	0	1	79	0.0126582
NODE_11458_length_817_cov_5.789694	476	555	2	78	79	0.9873418
NODE_11458_length_817_cov_5.789694	528	608	0	54	80	0.6750000
NODE_11458_length_817_cov_5.789694	528	608	2	26	80	0.3250000
NODE_11462_length_817_cov_4.357939	433	513	0	43	80	0.5375000
NODE_11462_length_817_cov_4.357939	433	513	2	37	80	0.4625000
NODE_11462_length_817_cov_4.357939	486	566	0	12	80	0.1500000
NODE_11462_length_817_cov_4.357939	486	566	2	68	80	0.8500000
NODE_11486_length_817_cov_0.692201	626	696	8	4	70	0.0571429
NODE_11486_length_817_cov_0.692201	626	696	10	1	70	0.0142857
NODE_11486_length_817_cov_0.692201	626	696	12	1	70	0.0142857
NODE_11486_length_817_cov_0.692201	626	696	13	3	70	0.0428571
NODE_11486_length_817_cov_0.692201	626	696	14	2	70	0.0285714
NODE_11486_length_817_cov_0.692201	626	696	16	7	70	0.1000000
NODE_11486_length_817_cov_0.692201	626	696	17	2	70	0.0285714
NODE_11486_length_817_cov_0.692201	626	696	20	5	70	0.0714286
NODE_11486_length_817_cov_0.692201	626	696	22	18	70	0.2571429
NODE_11486_length_817_cov_0.692201	626	696	24	20	70	0.2857143
NODE_11486_length_817_cov_0.692201	626	696	26	7	70	0.1000000
NODE_11488_length_816_cov_69.800558	395	475	2	78	80	0.9750000
NODE_11488_length_816_cov_69.800558	395	475	4	2	80	0.0250000
NODE_11488_length_816_cov_69.800558	448	520	0	19	72	0.2638889
NODE_11488_length_816_cov_69.800558	448	520	2	53	72	0.7361111
NODE_11489_length_816_cov_19.044630	77	154	0	77	77	1.0000000
NODE_11489_length_816_cov_19.044630	130	212	0	82	82	1.0000000
NODE_11490_length_816_cov_16.418410	381	461	0	72	80	0.9000000
NODE_11490_length_816_cov_16.418410	381	461	2	8	80	0.1000000
NODE_11490_length_816_cov_16.418410	434	514	0	19	80	0.2375000
NODE_11490_length_816_cov_16.418410	434	514	2	61	80	0.7625000
NODE_11491_length_816_cov_15.945607	319	399	0	21	80	0.2625000
NODE_11491_length_816_cov_15.945607	319	399	1	1	80	0.0125000
NODE_11491_length_816_cov_15.945607	319	399	2	58	80	0.7250000
NODE_11491_length_816_cov_15.945607	372	452	0	7	80	0.0875000
NODE_11491_length_816_cov_15.945607	372	452	2	73	80	0.9125000
NODE_11492_length_816_cov_12.797768	358	438	0	80	80	1.0000000
NODE_11492_length_816_cov_12.797768	411	491	0	80	80	1.0000000
NODE_11493_length_816_cov_12.086471	242	322	2	22	80	0.2750000
NODE_11493_length_816_cov_12.086471	242	322	4	44	80	0.5500000
NODE_11493_length_816_cov_12.086471	242	322	6	14	80	0.1750000
NODE_11493_length_816_cov_12.086471	295	375	2	28	80	0.3500000
NODE_11493_length_816_cov_12.086471	295	375	4	43	80	0.5375000
NODE_11493_length_816_cov_12.086471	295	375	6	9	80	0.1125000
NODE_11495_length_816_cov_3.873082	412	492	0	12	80	0.1500000
NODE_11495_length_816_cov_3.873082	412	492	2	17	80	0.2125000
NODE_11495_length_816_cov_3.873082	412	492	4	51	80	0.6375000
NODE_11495_length_816_cov_3.873082	465	545	4	80	80	1.0000000
NODE_11516_length_815_cov_48.090782	334	414	0	80	80	1.0000000
NODE_11516_length_815_cov_48.090782	387	467	0	80	80	1.0000000
NODE_11517_length_815_cov_27.748603	290	370	0	56	80	0.7000000
NODE_11517_length_815_cov_27.748603	290	370	2	17	80	0.2125000
NODE_11517_length_815_cov_27.748603	290	370	4	7	80	0.0875000
NODE_11517_length_815_cov_27.748603	343	423	0	3	80	0.0375000
NODE_11517_length_815_cov_27.748603	343	423	2	17	80	0.2125000
NODE_11517_length_815_cov_27.748603	343	423	4	17	80	0.2125000
NODE_11517_length_815_cov_27.748603	343	423	8	43	80	0.5375000
NODE_11518_length_815_cov_23.748603	429	509	2	28	80	0.3500000
NODE_11518_length_815_cov_23.748603	429	509	4	15	80	0.1875000
NODE_11518_length_815_cov_23.748603	429	509	6	37	80	0.4625000
NODE_11518_length_815_cov_23.748603	482	562	2	5	80	0.0625000
NODE_11518_length_815_cov_23.748603	482	562	4	49	80	0.6125000
NODE_11518_length_815_cov_23.748603	482	562	6	26	80	0.3250000
NODE_11519_length_815_cov_14.870112	318	398	0	38	80	0.4750000
NODE_11519_length_815_cov_14.870112	318	398	2	9	80	0.1125000
NODE_11519_length_815_cov_14.870112	318	398	4	9	80	0.1125000
NODE_11519_length_815_cov_14.870112	318	398	6	24	80	0.3000000
NODE_11519_length_815_cov_14.870112	371	451	4	7	80	0.0875000
NODE_11519_length_815_cov_14.870112	371	451	6	73	80	0.9125000
NODE_11520_length_815_cov_13.317039	338	418	0	21	80	0.2625000
NODE_11520_length_815_cov_13.317039	338	418	2	50	80	0.6250000
NODE_11520_length_815_cov_13.317039	338	418	4	9	80	0.1125000
NODE_11520_length_815_cov_13.317039	391	471	2	57	80	0.7125000
NODE_11520_length_815_cov_13.317039	391	471	4	23	80	0.2875000
NODE_11521_length_815_cov_12.270950	315	395	0	80	80	1.0000000
NODE_11521_length_815_cov_12.270950	368	448	0	80	80	1.0000000
NODE_11522_length_815_cov_9.304469	150	230	1	16	80	0.2000000
NODE_11522_length_815_cov_9.304469	150	230	4	5	80	0.0625000
NODE_11522_length_815_cov_9.304469	150	230	5	59	80	0.7375000
NODE_11522_length_815_cov_9.304469	203	283	1	69	80	0.8625000
NODE_11522_length_815_cov_9.304469	203	283	5	11	80	0.1375000
NODE_11524_length_815_cov_8.117318	437	517	0	2	80	0.0250000
NODE_11524_length_815_cov_8.117318	437	517	2	78	80	0.9750000
NODE_11524_length_815_cov_8.117318	490	570	0	55	80	0.6875000
NODE_11524_length_815_cov_8.117318	490	570	2	25	80	0.3125000
NODE_11530_length_815_cov_3.963687	275	355	0	80	80	1.0000000
NODE_11530_length_815_cov_3.963687	328	408	0	80	80	1.0000000
NODE_11532_length_815_cov_2.976257	441	508	0	67	67	1.0000000
NODE_11554_length_814_cov_55.545455	304	384	17	39	80	0.4875000
NODE_11554_length_814_cov_55.545455	304	384	18	41	80	0.5125000
NODE_11554_length_814_cov_55.545455	357	437	0	51	80	0.6375000
NODE_11554_length_814_cov_55.545455	357	437	17	29	80	0.3625000
NODE_11554_length_814_cov_55.545455	517	559	0	42	42	1.0000000
NODE_11554_length_814_cov_55.545455	724	804	2	5	80	0.0625000
NODE_11554_length_814_cov_55.545455	724	804	4	8	80	0.1000000
NODE_11554_length_814_cov_55.545455	724	804	8	1	80	0.0125000
NODE_11554_length_814_cov_55.545455	724	804	10	4	80	0.0500000
NODE_11554_length_814_cov_55.545455	724	804	12	2	80	0.0250000
NODE_11554_length_814_cov_55.545455	724	804	16	1	80	0.0125000
NODE_11554_length_814_cov_55.545455	724	804	22	1	80	0.0125000
NODE_11554_length_814_cov_55.545455	724	804	24	1	80	0.0125000
NODE_11554_length_814_cov_55.545455	724	804	26	1	80	0.0125000
NODE_11554_length_814_cov_55.545455	724	804	28	12	80	0.1500000
NODE_11554_length_814_cov_55.545455	724	804	30	4	80	0.0500000
NODE_11554_length_814_cov_55.545455	724	804	32	12	80	0.1500000
NODE_11554_length_814_cov_55.545455	724	804	34	4	80	0.0500000
NODE_11554_length_814_cov_55.545455	724	804	36	24	80	0.3000000
NODE_11555_length_814_cov_32.216783	317	397	0	34	80	0.4250000
NODE_11555_length_814_cov_32.216783	317	397	2	46	80	0.5750000
NODE_11555_length_814_cov_32.216783	370	450	0	21	80	0.2625000
NODE_11555_length_814_cov_32.216783	370	450	2	59	80	0.7375000
NODE_11556_length_814_cov_19.507692	174	254	2	10	80	0.1250000
NODE_11556_length_814_cov_19.507692	174	254	4	70	80	0.8750000
NODE_11556_length_814_cov_19.507692	227	307	0	25	80	0.3125000
NODE_11556_length_814_cov_19.507692	227	307	2	23	80	0.2875000
NODE_11556_length_814_cov_19.507692	227	307	4	32	80	0.4000000
NODE_11556_length_814_cov_19.507692	303	383	2	80	80	1.0000000
NODE_11556_length_814_cov_19.507692	356	436	0	39	80	0.4875000
NODE_11556_length_814_cov_19.507692	356	436	2	41	80	0.5125000
NODE_11557_length_814_cov_18.579021	433	513	0	51	80	0.6375000
NODE_11557_length_814_cov_18.579021	433	513	2	25	80	0.3125000
NODE_11557_length_814_cov_18.579021	433	513	4	4	80	0.0500000
NODE_11557_length_814_cov_18.579021	486	566	2	30	80	0.3750000
NODE_11557_length_814_cov_18.579021	486	566	4	50	80	0.6250000
NODE_11558_length_814_cov_17.183217	339	419	0	80	80	1.0000000
NODE_11558_length_814_cov_17.183217	392	472	0	71	80	0.8875000
NODE_11558_length_814_cov_17.183217	392	472	2	9	80	0.1125000
NODE_11559_length_814_cov_15.306294	238	318	1	11	80	0.1375000
NODE_11559_length_814_cov_15.306294	238	318	2	30	80	0.3750000
NODE_11559_length_814_cov_15.306294	238	318	4	39	80	0.4875000
NODE_11559_length_814_cov_15.306294	291	371	4	74	80	0.9250000
NODE_11559_length_814_cov_15.306294	291	371	6	6	80	0.0750000
NODE_11560_length_814_cov_11.511888	397	477	2	19	80	0.2375000
NODE_11560_length_814_cov_11.511888	397	477	4	11	80	0.1375000
NODE_11560_length_814_cov_11.511888	397	477	6	50	80	0.6250000
NODE_11560_length_814_cov_11.511888	459	530	0	14	71	0.1971831
NODE_11560_length_814_cov_11.511888	459	530	2	57	71	0.8028169
NODE_11561_length_814_cov_10.395804	305	385	0	76	80	0.9500000
NODE_11561_length_814_cov_10.395804	305	385	2	4	80	0.0500000
NODE_11561_length_814_cov_10.395804	358	438	0	35	80	0.4375000
NODE_11561_length_814_cov_10.395804	358	438	2	45	80	0.5625000
NODE_11562_length_814_cov_9.692308	347	427	2	21	80	0.2625000
NODE_11562_length_814_cov_9.692308	347	427	4	27	80	0.3375000
NODE_11562_length_814_cov_9.692308	347	427	6	32	80	0.4000000
NODE_11562_length_814_cov_9.692308	400	480	2	35	80	0.4375000
NODE_11562_length_814_cov_9.692308	400	480	4	19	80	0.2375000
NODE_11562_length_814_cov_9.692308	400	480	6	26	80	0.3250000
NODE_11564_length_814_cov_9.274126	245	325	0	80	80	1.0000000
NODE_11564_length_814_cov_9.274126	298	378	0	80	80	1.0000000
NODE_11565_length_814_cov_8.973427	271	351	0	80	80	1.0000000
NODE_11565_length_814_cov_8.973427	324	404	0	80	80	1.0000000
NODE_11573_length_814_cov_2.145455	273	327	0	54	54	1.0000000
NODE_11573_length_814_cov_2.145455	307	371	0	64	64	1.0000000
NODE_11587_length_813_cov_39.228291	225	305	2	14	80	0.1750000
NODE_11587_length_813_cov_39.228291	225	305	6	21	80	0.2625000
NODE_11587_length_813_cov_39.228291	225	305	8	45	80	0.5625000
NODE_11587_length_813_cov_39.228291	278	358	0	41	80	0.5125000
NODE_11587_length_813_cov_39.228291	278	358	2	26	80	0.3250000
NODE_11587_length_813_cov_39.228291	278	358	8	13	80	0.1625000
NODE_11588_length_813_cov_36.570028	406	486	0	80	80	1.0000000
NODE_11588_length_813_cov_36.570028	459	539	0	80	80	1.0000000
NODE_11589_length_813_cov_26.718487	209	289	0	27	80	0.3375000
NODE_11589_length_813_cov_26.718487	209	289	4	13	80	0.1625000
NODE_11589_length_813_cov_26.718487	209	289	6	40	80	0.5000000
NODE_11589_length_813_cov_26.718487	262	342	4	27	80	0.3375000
NODE_11589_length_813_cov_26.718487	262	342	6	53	80	0.6625000
NODE_11590_length_813_cov_17.537815	335	415	0	5	80	0.0625000
NODE_11590_length_813_cov_17.537815	335	415	2	18	80	0.2250000
NODE_11590_length_813_cov_17.537815	335	415	4	7	80	0.0875000
NODE_11590_length_813_cov_17.537815	335	415	8	3	80	0.0375000
NODE_11590_length_813_cov_17.537815	335	415	11	15	80	0.1875000
NODE_11590_length_813_cov_17.537815	335	415	13	28	80	0.3500000
NODE_11590_length_813_cov_17.537815	335	415	15	4	80	0.0500000
NODE_11590_length_813_cov_17.537815	388	468	10	13	80	0.1625000
NODE_11590_length_813_cov_17.537815	388	468	11	5	80	0.0625000
NODE_11590_length_813_cov_17.537815	388	468	12	6	80	0.0750000
NODE_11590_length_813_cov_17.537815	388	468	13	52	80	0.6500000
NODE_11590_length_813_cov_17.537815	388	468	15	4	80	0.0500000
NODE_11591_length_813_cov_14.243697	279	359	0	80	80	1.0000000
NODE_11591_length_813_cov_14.243697	332	412	0	80	80	1.0000000
NODE_11592_length_813_cov_13.984594	307	387	0	80	80	1.0000000
NODE_11592_length_813_cov_13.984594	360	440	0	80	80	1.0000000
NODE_11593_length_813_cov_13.242297	336	416	0	44	80	0.5500000
NODE_11593_length_813_cov_13.242297	336	416	2	36	80	0.4500000
NODE_11593_length_813_cov_13.242297	389	469	2	46	80	0.5750000
NODE_11593_length_813_cov_13.242297	389	469	5	34	80	0.4250000
NODE_11594_length_813_cov_11.985994	374	454	0	53	80	0.6625000
NODE_11594_length_813_cov_11.985994	374	454	2	27	80	0.3375000
NODE_11594_length_813_cov_11.985994	427	507	2	80	80	1.0000000
NODE_11595_length_813_cov_11.668067	279	359	0	80	80	1.0000000
NODE_11595_length_813_cov_11.668067	332	412	0	80	80	1.0000000
NODE_11596_length_813_cov_8.149860	538	618	0	80	80	1.0000000
NODE_11596_length_813_cov_8.149860	591	671	0	80	80	1.0000000
NODE_11597_length_813_cov_7.098039	234	314	0	52	80	0.6500000
NODE_11597_length_813_cov_7.098039	234	314	2	28	80	0.3500000
NODE_11597_length_813_cov_7.098039	287	367	2	80	80	1.0000000
NODE_11613_length_812_cov_45.183731	435	515	0	36	80	0.4500000
NODE_11613_length_812_cov_45.183731	435	515	4	30	80	0.3750000
NODE_11613_length_812_cov_45.183731	435	515	6	14	80	0.1750000
NODE_11613_length_812_cov_45.183731	488	568	0	80	80	1.0000000
NODE_11614_length_812_cov_23.862553	386	466	0	3	80	0.0375000
NODE_11614_length_812_cov_23.862553	386	466	2	77	80	0.9625000
NODE_11614_length_812_cov_23.862553	439	519	0	54	80	0.6750000
NODE_11614_length_812_cov_23.862553	439	519	2	26	80	0.3250000
NODE_11615_length_812_cov_23.516129	295	375	6	52	80	0.6500000
NODE_11615_length_812_cov_23.516129	295	375	56	13	80	0.1625000
NODE_11615_length_812_cov_23.516129	295	375	57	1	80	0.0125000
NODE_11615_length_812_cov_23.516129	295	375	58	14	80	0.1750000
NODE_11615_length_812_cov_23.516129	348	428	49	17	80	0.2125000
NODE_11615_length_812_cov_23.516129	348	428	51	1	80	0.0125000
NODE_11615_length_812_cov_23.516129	348	428	52	21	80	0.2625000
NODE_11615_length_812_cov_23.516129	348	428	56	27	80	0.3375000
NODE_11615_length_812_cov_23.516129	348	428	58	14	80	0.1750000
NODE_11616_length_812_cov_15.577840	509	589	0	80	80	1.0000000
NODE_11616_length_812_cov_15.577840	562	644	0	82	82	1.0000000
NODE_11617_length_812_cov_13.277700	257	331	0	28	74	0.3783784
NODE_11617_length_812_cov_13.277700	257	331	2	46	74	0.6216216
NODE_11617_length_812_cov_13.277700	304	384	2	32	80	0.4000000
NODE_11617_length_812_cov_13.277700	304	384	4	48	80	0.6000000
NODE_11619_length_812_cov_6.697055	309	389	0	80	80	1.0000000
NODE_11619_length_812_cov_6.697055	362	442	0	80	80	1.0000000
NODE_11642_length_811_cov_65.762640	418	492	32	4	74	0.0540541
NODE_11642_length_811_cov_65.762640	418	492	34	17	74	0.2297297
NODE_11642_length_811_cov_65.762640	418	492	37	7	74	0.0945946
NODE_11642_length_811_cov_65.762640	418	492	38	41	74	0.5540541
NODE_11642_length_811_cov_65.762640	418	492	39	4	74	0.0540541
NODE_11642_length_811_cov_65.762640	418	492	40	1	74	0.0135135
NODE_11642_length_811_cov_65.762640	471	545	4	4	74	0.0540541
NODE_11642_length_811_cov_65.762640	471	545	14	18	74	0.2432432
NODE_11642_length_811_cov_65.762640	471	545	28	25	74	0.3378378
NODE_11642_length_811_cov_65.762640	471	545	34	23	74	0.3108108
NODE_11642_length_811_cov_65.762640	471	545	38	4	74	0.0540541
NODE_11643_length_811_cov_62.933989	457	537	8	27	80	0.3375000
NODE_11643_length_811_cov_62.933989	457	537	12	1	80	0.0125000
NODE_11643_length_811_cov_62.933989	457	537	14	1	80	0.0125000
NODE_11643_length_811_cov_62.933989	457	537	16	29	80	0.3625000
NODE_11643_length_811_cov_62.933989	457	537	19	22	80	0.2750000
NODE_11643_length_811_cov_62.933989	510	590	12	5	80	0.0625000
NODE_11643_length_811_cov_62.933989	510	590	14	14	80	0.1750000
NODE_11643_length_811_cov_62.933989	510	590	16	5	80	0.0625000
NODE_11643_length_811_cov_62.933989	510	590	19	30	80	0.3750000
NODE_11643_length_811_cov_62.933989	510	590	20	26	80	0.3250000
NODE_11644_length_811_cov_26.401685	397	477	0	15	80	0.1875000
NODE_11644_length_811_cov_26.401685	397	477	2	65	80	0.8125000
NODE_11644_length_811_cov_26.401685	450	530	0	37	80	0.4625000
NODE_11644_length_811_cov_26.401685	450	530	2	43	80	0.5375000
NODE_11645_length_811_cov_23.009831	189	269	0	80	80	1.0000000
NODE_11645_length_811_cov_23.009831	242	322	0	80	80	1.0000000
NODE_11646_length_811_cov_20.523876	375	455	0	57	80	0.7125000
NODE_11646_length_811_cov_20.523876	375	455	2	23	80	0.2875000
NODE_11646_length_811_cov_20.523876	428	508	0	80	80	1.0000000
NODE_11647_length_811_cov_17.386236	421	501	0	24	80	0.3000000
NODE_11647_length_811_cov_17.386236	421	501	2	9	80	0.1125000
NODE_11647_length_811_cov_17.386236	421	501	4	47	80	0.5875000
NODE_11647_length_811_cov_17.386236	474	554	0	2	80	0.0250000
NODE_11647_length_811_cov_17.386236	474	554	2	25	80	0.3125000
NODE_11647_length_811_cov_17.386236	474	554	4	53	80	0.6625000
NODE_11648_length_811_cov_15.279494	368	448	0	80	80	1.0000000
NODE_11648_length_811_cov_15.279494	421	502	0	81	81	1.0000000
NODE_11649_length_811_cov_14.543539	222	302	2	24	80	0.3000000
NODE_11649_length_811_cov_14.543539	222	302	6	2	80	0.0250000
NODE_11649_length_811_cov_14.543539	222	302	8	53	80	0.6625000
NODE_11649_length_811_cov_14.543539	222	302	10	1	80	0.0125000
NODE_11649_length_811_cov_14.543539	275	355	6	1	80	0.0125000
NODE_11649_length_811_cov_14.543539	275	355	8	76	80	0.9500000
NODE_11649_length_811_cov_14.543539	275	355	10	3	80	0.0375000
NODE_11650_length_811_cov_12.196629	402	482	0	64	80	0.8000000
NODE_11650_length_811_cov_12.196629	402	482	2	13	80	0.1625000
NODE_11650_length_811_cov_12.196629	402	482	4	3	80	0.0375000
NODE_11650_length_811_cov_12.196629	455	535	0	11	80	0.1375000
NODE_11650_length_811_cov_12.196629	455	535	2	15	80	0.1875000
NODE_11650_length_811_cov_12.196629	455	535	4	54	80	0.6750000
NODE_11651_length_811_cov_12.117978	289	369	0	80	80	1.0000000
NODE_11651_length_811_cov_12.117978	342	422	0	80	80	1.0000000
NODE_11652_length_811_cov_11.886236	330	410	2	14	80	0.1750000
NODE_11652_length_811_cov_11.886236	330	410	4	66	80	0.8250000
NODE_11652_length_811_cov_11.886236	383	463	0	51	80	0.6375000
NODE_11652_length_811_cov_11.886236	383	463	2	4	80	0.0500000
NODE_11652_length_811_cov_11.886236	383	463	4	25	80	0.3125000
NODE_11653_length_811_cov_10.602528	342	422	0	80	80	1.0000000
NODE_11653_length_811_cov_10.602528	395	461	0	66	66	1.0000000
NODE_11653_length_811_cov_10.602528	452	519	0	67	67	1.0000000
NODE_11653_length_811_cov_10.602528	492	572	0	43	80	0.5375000
NODE_11653_length_811_cov_10.602528	492	572	2	37	80	0.4625000
NODE_11654_length_811_cov_7.539326	324	404	0	79	80	0.9875000
NODE_11654_length_811_cov_7.539326	324	404	2	1	80	0.0125000
NODE_11654_length_811_cov_7.539326	377	457	0	80	80	1.0000000
NODE_11655_length_811_cov_6.398876	419	499	0	22	80	0.2750000
NODE_11655_length_811_cov_6.398876	419	499	6	58	80	0.7250000
NODE_11655_length_811_cov_6.398876	472	552	0	75	80	0.9375000
NODE_11655_length_811_cov_6.398876	472	552	6	5	80	0.0625000
NODE_11657_length_811_cov_5.939607	496	527	2	31	31	1.0000000
NODE_11657_length_811_cov_5.939607	528	603	0	10	75	0.1333333
NODE_11657_length_811_cov_5.939607	528	603	1	21	75	0.2800000
NODE_11657_length_811_cov_5.939607	528	603	2	44	75	0.5866666
NODE_11669_length_811_cov_1.501404	645	676	4	31	31	1.0000000
NODE_11684_length_810_cov_42.358650	484	564	0	80	80	1.0000000
NODE_11684_length_810_cov_42.358650	537	617	0	80	80	1.0000000
NODE_11685_length_810_cov_38.604782	370	450	0	80	80	1.0000000
NODE_11685_length_810_cov_38.604782	423	499	0	76	76	1.0000000
NODE_11686_length_810_cov_20.354430	338	418	0	17	80	0.2125000
NODE_11686_length_810_cov_20.354430	338	418	2	63	80	0.7875000
NODE_11686_length_810_cov_20.354430	391	471	0	12	80	0.1500000
NODE_11686_length_810_cov_20.354430	391	471	2	68	80	0.8500000
NODE_11688_length_810_cov_12.367089	144	224	0	5	80	0.0625000
NODE_11688_length_810_cov_12.367089	144	224	6	18	80	0.2250000
NODE_11688_length_810_cov_12.367089	144	224	10	2	80	0.0250000
NODE_11688_length_810_cov_12.367089	144	224	15	19	80	0.2375000
NODE_11688_length_810_cov_12.367089	144	224	16	15	80	0.1875000
NODE_11688_length_810_cov_12.367089	144	224	20	21	80	0.2625000
NODE_11688_length_810_cov_12.367089	197	277	13	18	80	0.2250000
NODE_11688_length_810_cov_12.367089	197	277	14	7	80	0.0875000
NODE_11688_length_810_cov_12.367089	197	277	16	6	80	0.0750000
NODE_11688_length_810_cov_12.367089	197	277	20	49	80	0.6125000
NODE_11689_length_810_cov_8.886076	333	399	2	66	66	1.0000000
NODE_11690_length_810_cov_8.291139	446	526	2	40	80	0.5000000
NODE_11690_length_810_cov_8.291139	446	526	4	40	80	0.5000000
NODE_11690_length_810_cov_8.291139	499	579	2	24	80	0.3000000
NODE_11690_length_810_cov_8.291139	499	579	4	56	80	0.7000000
NODE_11692_length_810_cov_7.213783	335	406	0	19	71	0.2676056
NODE_11692_length_810_cov_7.213783	335	406	2	52	71	0.7323943
NODE_11692_length_810_cov_7.213783	335	416	0	19	81	0.2345679
NODE_11692_length_810_cov_7.213783	335	416	2	62	81	0.7654321
NODE_11692_length_810_cov_7.213783	379	459	2	80	80	1.0000000
NODE_11714_length_809_cov_40.536620	428	500	0	72	72	1.0000000
NODE_11714_length_809_cov_40.536620	473	553	0	28	80	0.3500000
NODE_11714_length_809_cov_40.536620	473	553	1	52	80	0.6500000
NODE_11715_length_809_cov_15.871831	385	465	0	80	80	1.0000000
NODE_11715_length_809_cov_15.871831	402	465	0	63	63	1.0000000
NODE_11715_length_809_cov_15.871831	438	518	0	80	80	1.0000000
NODE_11715_length_809_cov_15.871831	438	518	0	80	80	1.0000000
NODE_11716_length_809_cov_15.019718	286	366	0	53	80	0.6625000
NODE_11716_length_809_cov_15.019718	286	366	8	2	80	0.0250000
NODE_11716_length_809_cov_15.019718	286	366	11	25	80	0.3125000
NODE_11716_length_809_cov_15.019718	339	419	8	2	80	0.0250000
NODE_11716_length_809_cov_15.019718	339	419	11	30	80	0.3750000
NODE_11716_length_809_cov_15.019718	339	419	12	48	80	0.6000000
NODE_11718_length_809_cov_4.483099	244	324	2	4	80	0.0500000
NODE_11718_length_809_cov_4.483099	244	324	4	76	80	0.9500000
NODE_11718_length_809_cov_4.483099	278	324	4	46	46	1.0000000
NODE_11718_length_809_cov_4.483099	298	377	0	15	79	0.1898734
NODE_11718_length_809_cov_4.483099	298	377	2	37	79	0.4683544
NODE_11718_length_809_cov_4.483099	298	377	4	27	79	0.3417721
NODE_11718_length_809_cov_4.483099	308	377	0	15	69	0.2173913
NODE_11718_length_809_cov_4.483099	308	377	2	37	69	0.5362319
NODE_11718_length_809_cov_4.483099	308	377	4	17	69	0.2463768
NODE_11738_length_808_cov_45.023977	325	405	0	48	80	0.6000000
NODE_11738_length_808_cov_45.023977	325	405	2	32	80	0.4000000
NODE_11738_length_808_cov_45.023977	378	458	2	57	80	0.7125000
NODE_11738_length_808_cov_45.023977	378	458	4	23	80	0.2875000
NODE_11739_length_808_cov_24.087447	287	367	0	80	80	1.0000000
NODE_11739_length_808_cov_24.087447	340	420	0	80	80	1.0000000
NODE_11740_length_808_cov_21.867419	324	404	0	80	80	1.0000000
NODE_11740_length_808_cov_21.867419	377	457	0	80	80	1.0000000
NODE_11741_length_808_cov_16.289140	333	413	0	27	80	0.3375000
NODE_11741_length_808_cov_16.289140	333	413	2	53	80	0.6625000
NODE_11741_length_808_cov_16.289140	386	466	0	51	80	0.6375000
NODE_11741_length_808_cov_16.289140	386	466	2	29	80	0.3625000
NODE_11742_length_808_cov_14.489422	307	387	0	10	80	0.1250000
NODE_11742_length_808_cov_14.489422	307	387	4	12	80	0.1500000
NODE_11742_length_808_cov_14.489422	307	387	6	55	80	0.6875000
NODE_11742_length_808_cov_14.489422	307	387	7	3	80	0.0375000
NODE_11742_length_808_cov_14.489422	360	440	2	5	80	0.0625000
NODE_11742_length_808_cov_14.489422	360	440	6	54	80	0.6750000
NODE_11742_length_808_cov_14.489422	360	440	7	18	80	0.2250000
NODE_11742_length_808_cov_14.489422	360	440	8	3	80	0.0375000
NODE_11744_length_808_cov_10.507757	317	397	4	80	80	1.0000000
NODE_11744_length_808_cov_10.507757	370	450	0	49	80	0.6125000
NODE_11744_length_808_cov_10.507757	370	450	3	1	80	0.0125000
NODE_11744_length_808_cov_10.507757	370	450	4	30	80	0.3750000
NODE_11745_length_808_cov_10.066291	483	563	0	80	80	1.0000000
NODE_11745_length_808_cov_10.066291	536	616	0	80	80	1.0000000
NODE_11746_length_808_cov_7.581100	358	438	0	80	80	1.0000000
NODE_11746_length_808_cov_7.581100	411	491	0	80	80	1.0000000
NODE_11756_length_808_cov_3.283498	471	551	0	18	80	0.2250000
NODE_11756_length_808_cov_3.283498	471	551	2	62	80	0.7750000
NODE_11756_length_808_cov_3.283498	524	604	0	71	80	0.8875000
NODE_11756_length_808_cov_3.283498	524	604	2	9	80	0.1125000
NODE_11783_length_807_cov_67.341808	2	25	32	1	23	0.0434783
NODE_11783_length_807_cov_67.341808	2	25	46	1	23	0.0434783
NODE_11783_length_807_cov_67.341808	2	25	54	1	23	0.0434783
NODE_11783_length_807_cov_67.341808	2	25	61	3	23	0.1304348
NODE_11783_length_807_cov_67.341808	2	25	68	1	23	0.0434783
NODE_11783_length_807_cov_67.341808	2	25	80	1	23	0.0434783
NODE_11783_length_807_cov_67.341808	2	25	89	1	23	0.0434783
NODE_11783_length_807_cov_67.341808	2	25	106	1	23	0.0434783
NODE_11783_length_807_cov_67.341808	2	25	110	1	23	0.0434783
NODE_11783_length_807_cov_67.341808	2	25	114	1	23	0.0434783
NODE_11783_length_807_cov_67.341808	2	25	116	1	23	0.0434783
NODE_11783_length_807_cov_67.341808	2	25	122	1	23	0.0434783
NODE_11783_length_807_cov_67.341808	2	25	141	1	23	0.0434783
NODE_11783_length_807_cov_67.341808	2	25	142	2	23	0.0869565
NODE_11783_length_807_cov_67.341808	2	25	146	1	23	0.0434783
NODE_11783_length_807_cov_67.341808	2	25	152	1	23	0.0434783
NODE_11783_length_807_cov_67.341808	2	25	164	1	23	0.0434783
NODE_11783_length_807_cov_67.341808	2	25	168	1	23	0.0434783
NODE_11783_length_807_cov_67.341808	2	25	183	2	23	0.0869565
NODE_11783_length_807_cov_67.341808	339	370	233	1	31	0.0322581
NODE_11783_length_807_cov_67.341808	339	370	244	1	31	0.0322581
NODE_11783_length_807_cov_67.341808	339	370	246	1	31	0.0322581
NODE_11783_length_807_cov_67.341808	339	370	252	1	31	0.0322581
NODE_11783_length_807_cov_67.341808	339	370	254	1	31	0.0322581
NODE_11783_length_807_cov_67.341808	339	370	263	1	31	0.0322581
NODE_11783_length_807_cov_67.341808	339	370	267	1	31	0.0322581
NODE_11783_length_807_cov_67.341808	339	370	269	1	31	0.0322581
NODE_11783_length_807_cov_67.341808	339	370	278	1	31	0.0322581
NODE_11783_length_807_cov_67.341808	339	370	290	2	31	0.0645161
NODE_11783_length_807_cov_67.341808	339	370	295	1	31	0.0322581
NODE_11783_length_807_cov_67.341808	339	370	298	1	31	0.0322581
NODE_11783_length_807_cov_67.341808	339	370	300	1	31	0.0322581
NODE_11783_length_807_cov_67.341808	339	370	304	1	31	0.0322581
NODE_11783_length_807_cov_67.341808	339	370	328	2	31	0.0645161
NODE_11783_length_807_cov_67.341808	339	370	345	3	31	0.0967742
NODE_11783_length_807_cov_67.341808	339	370	357	1	31	0.0322581
NODE_11783_length_807_cov_67.341808	339	370	360	1	31	0.0322581
NODE_11783_length_807_cov_67.341808	339	370	373	3	31	0.0967742
NODE_11783_length_807_cov_67.341808	339	370	375	1	31	0.0322581
NODE_11783_length_807_cov_67.341808	339	370	378	2	31	0.0645161
NODE_11783_length_807_cov_67.341808	339	370	380	2	31	0.0645161
NODE_11783_length_807_cov_67.341808	339	370	382	1	31	0.0322581
NODE_11783_length_807_cov_67.341808	343	423	254	1	80	0.0125000
NODE_11783_length_807_cov_67.341808	343	423	263	1	80	0.0125000
NODE_11783_length_807_cov_67.341808	343	423	267	1	80	0.0125000
NODE_11783_length_807_cov_67.341808	343	423	269	1	80	0.0125000
NODE_11783_length_807_cov_67.341808	343	423	278	1	80	0.0125000
NODE_11783_length_807_cov_67.341808	343	423	290	2	80	0.0250000
NODE_11783_length_807_cov_67.341808	343	423	295	1	80	0.0125000
NODE_11783_length_807_cov_67.341808	343	423	298	1	80	0.0125000
NODE_11783_length_807_cov_67.341808	343	423	300	1	80	0.0125000
NODE_11783_length_807_cov_67.341808	343	423	304	1	80	0.0125000
NODE_11783_length_807_cov_67.341808	343	423	328	2	80	0.0250000
NODE_11783_length_807_cov_67.341808	343	423	345	3	80	0.0375000
NODE_11783_length_807_cov_67.341808	343	423	357	1	80	0.0125000
NODE_11783_length_807_cov_67.341808	343	423	360	1	80	0.0125000
NODE_11783_length_807_cov_67.341808	343	423	373	3	80	0.0375000
NODE_11783_length_807_cov_67.341808	343	423	375	1	80	0.0125000
NODE_11783_length_807_cov_67.341808	343	423	378	2	80	0.0250000
NODE_11783_length_807_cov_67.341808	343	423	380	2	80	0.0250000
NODE_11783_length_807_cov_67.341808	343	423	382	1	80	0.0125000
NODE_11783_length_807_cov_67.341808	343	423	383	2	80	0.0250000
NODE_11783_length_807_cov_67.341808	343	423	386	1	80	0.0125000
NODE_11783_length_807_cov_67.341808	343	423	388	1	80	0.0125000
NODE_11783_length_807_cov_67.341808	343	423	390	1	80	0.0125000
NODE_11783_length_807_cov_67.341808	343	423	391	2	80	0.0250000
NODE_11783_length_807_cov_67.341808	343	423	394	2	80	0.0250000
NODE_11783_length_807_cov_67.341808	343	423	396	1	80	0.0125000
NODE_11783_length_807_cov_67.341808	343	423	398	1	80	0.0125000
NODE_11783_length_807_cov_67.341808	343	423	401	1	80	0.0125000
NODE_11783_length_807_cov_67.341808	343	423	402	1	80	0.0125000
NODE_11783_length_807_cov_67.341808	343	423	417	1	80	0.0125000
NODE_11783_length_807_cov_67.341808	343	423	422	2	80	0.0250000
NODE_11783_length_807_cov_67.341808	343	423	424	1	80	0.0125000
NODE_11783_length_807_cov_67.341808	343	423	425	1	80	0.0125000
NODE_11783_length_807_cov_67.341808	343	423	433	3	80	0.0375000
NODE_11783_length_807_cov_67.341808	343	423	434	1	80	0.0125000
NODE_11783_length_807_cov_67.341808	343	423	440	1	80	0.0125000
NODE_11783_length_807_cov_67.341808	343	423	445	1	80	0.0125000
NODE_11783_length_807_cov_67.341808	343	423	449	2	80	0.0250000
NODE_11783_length_807_cov_67.341808	343	423	451	1	80	0.0125000
NODE_11783_length_807_cov_67.341808	343	423	457	1	80	0.0125000
NODE_11783_length_807_cov_67.341808	343	423	459	1	80	0.0125000
NODE_11783_length_807_cov_67.341808	343	423	463	1	80	0.0125000
NODE_11783_length_807_cov_67.341808	343	423	467	1	80	0.0125000
NODE_11783_length_807_cov_67.341808	343	423	478	3	80	0.0375000
NODE_11783_length_807_cov_67.341808	343	423	482	3	80	0.0375000
NODE_11783_length_807_cov_67.341808	343	423	485	1	80	0.0125000
NODE_11783_length_807_cov_67.341808	343	423	486	2	80	0.0250000
NODE_11783_length_807_cov_67.341808	343	423	490	1	80	0.0125000
NODE_11783_length_807_cov_67.341808	343	423	492	1	80	0.0125000
NODE_11783_length_807_cov_67.341808	343	423	502	1	80	0.0125000
NODE_11783_length_807_cov_67.341808	343	423	507	1	80	0.0125000
NODE_11783_length_807_cov_67.341808	343	423	509	1	80	0.0125000
NODE_11783_length_807_cov_67.341808	343	423	512	2	80	0.0250000
NODE_11783_length_807_cov_67.341808	343	423	513	2	80	0.0250000
NODE_11783_length_807_cov_67.341808	343	423	515	1	80	0.0125000
NODE_11783_length_807_cov_67.341808	343	423	520	2	80	0.0250000
NODE_11783_length_807_cov_67.341808	343	423	529	1	80	0.0125000
NODE_11784_length_807_cov_54.980226	683	749	155	1	66	0.0151515
NODE_11784_length_807_cov_54.980226	683	749	157	1	66	0.0151515
NODE_11784_length_807_cov_54.980226	683	749	161	1	66	0.0151515
NODE_11784_length_807_cov_54.980226	683	749	165	2	66	0.0303030
NODE_11784_length_807_cov_54.980226	683	749	171	2	66	0.0303030
NODE_11784_length_807_cov_54.980226	683	749	173	2	66	0.0303030
NODE_11784_length_807_cov_54.980226	683	749	179	1	66	0.0151515
NODE_11784_length_807_cov_54.980226	683	749	181	1	66	0.0151515
NODE_11784_length_807_cov_54.980226	683	749	183	2	66	0.0303030
NODE_11784_length_807_cov_54.980226	683	749	185	2	66	0.0303030
NODE_11784_length_807_cov_54.980226	683	749	187	1	66	0.0151515
NODE_11784_length_807_cov_54.980226	683	749	189	5	66	0.0757576
NODE_11784_length_807_cov_54.980226	683	749	195	1	66	0.0151515
NODE_11784_length_807_cov_54.980226	683	749	198	2	66	0.0303030
NODE_11784_length_807_cov_54.980226	683	749	202	1	66	0.0151515
NODE_11784_length_807_cov_54.980226	683	749	206	1	66	0.0151515
NODE_11784_length_807_cov_54.980226	683	749	208	1	66	0.0151515
NODE_11784_length_807_cov_54.980226	683	749	211	1	66	0.0151515
NODE_11784_length_807_cov_54.980226	683	749	215	2	66	0.0303030
NODE_11784_length_807_cov_54.980226	683	749	230	1	66	0.0151515
NODE_11784_length_807_cov_54.980226	683	749	234	1	66	0.0151515
NODE_11784_length_807_cov_54.980226	683	749	236	1	66	0.0151515
NODE_11784_length_807_cov_54.980226	683	749	240	1	66	0.0151515
NODE_11784_length_807_cov_54.980226	683	749	242	1	66	0.0151515
NODE_11784_length_807_cov_54.980226	683	749	244	2	66	0.0303030
NODE_11784_length_807_cov_54.980226	683	749	252	1	66	0.0151515
NODE_11784_length_807_cov_54.980226	683	749	254	1	66	0.0151515
NODE_11784_length_807_cov_54.980226	683	749	258	2	66	0.0303030
NODE_11784_length_807_cov_54.980226	683	749	260	1	66	0.0151515
NODE_11784_length_807_cov_54.980226	683	749	262	1	66	0.0151515
NODE_11784_length_807_cov_54.980226	683	749	264	1	66	0.0151515
NODE_11784_length_807_cov_54.980226	683	749	265	2	66	0.0303030
NODE_11784_length_807_cov_54.980226	683	749	267	4	66	0.0606061
NODE_11784_length_807_cov_54.980226	683	749	269	3	66	0.0454545
NODE_11784_length_807_cov_54.980226	683	749	271	8	66	0.1212121
NODE_11784_length_807_cov_54.980226	683	749	273	3	66	0.0454545
NODE_11784_length_807_cov_54.980226	683	749	274	1	66	0.0151515
NODE_11784_length_807_cov_54.980226	683	749	281	1	66	0.0151515
NODE_11784_length_807_cov_54.980226	727	802	37	1	75	0.0133333
NODE_11784_length_807_cov_54.980226	727	802	39	3	75	0.0400000
NODE_11784_length_807_cov_54.980226	727	802	42	1	75	0.0133333
NODE_11784_length_807_cov_54.980226	727	802	43	1	75	0.0133333
NODE_11784_length_807_cov_54.980226	727	802	47	1	75	0.0133333
NODE_11784_length_807_cov_54.980226	727	802	49	1	75	0.0133333
NODE_11784_length_807_cov_54.980226	727	802	55	1	75	0.0133333
NODE_11784_length_807_cov_54.980226	727	802	57	5	75	0.0666667
NODE_11784_length_807_cov_54.980226	727	802	59	1	75	0.0133333
NODE_11784_length_807_cov_54.980226	727	802	61	3	75	0.0400000
NODE_11784_length_807_cov_54.980226	727	802	67	1	75	0.0133333
NODE_11784_length_807_cov_54.980226	727	802	73	1	75	0.0133333
NODE_11784_length_807_cov_54.980226	727	802	85	1	75	0.0133333
NODE_11784_length_807_cov_54.980226	727	802	89	1	75	0.0133333
NODE_11784_length_807_cov_54.980226	727	802	91	1	75	0.0133333
NODE_11784_length_807_cov_54.980226	727	802	95	1	75	0.0133333
NODE_11784_length_807_cov_54.980226	727	802	99	1	75	0.0133333
NODE_11784_length_807_cov_54.980226	727	802	106	1	75	0.0133333
NODE_11784_length_807_cov_54.980226	727	802	107	1	75	0.0133333
NODE_11784_length_807_cov_54.980226	727	802	109	1	75	0.0133333
NODE_11784_length_807_cov_54.980226	727	802	116	4	75	0.0533333
NODE_11784_length_807_cov_54.980226	727	802	120	2	75	0.0266667
NODE_11784_length_807_cov_54.980226	727	802	124	1	75	0.0133333
NODE_11784_length_807_cov_54.980226	727	802	130	3	75	0.0400000
NODE_11784_length_807_cov_54.980226	727	802	134	3	75	0.0400000
NODE_11784_length_807_cov_54.980226	727	802	138	1	75	0.0133333
NODE_11784_length_807_cov_54.980226	727	802	140	4	75	0.0533333
NODE_11784_length_807_cov_54.980226	727	802	142	1	75	0.0133333
NODE_11784_length_807_cov_54.980226	727	802	148	5	75	0.0666667
NODE_11784_length_807_cov_54.980226	727	802	150	1	75	0.0133333
NODE_11784_length_807_cov_54.980226	727	802	155	1	75	0.0133333
NODE_11784_length_807_cov_54.980226	727	802	157	1	75	0.0133333
NODE_11784_length_807_cov_54.980226	727	802	161	1	75	0.0133333
NODE_11784_length_807_cov_54.980226	727	802	165	2	75	0.0266667
NODE_11784_length_807_cov_54.980226	727	802	171	2	75	0.0266667
NODE_11784_length_807_cov_54.980226	727	802	173	2	75	0.0266667
NODE_11784_length_807_cov_54.980226	727	802	179	1	75	0.0133333
NODE_11784_length_807_cov_54.980226	727	802	181	1	75	0.0133333
NODE_11784_length_807_cov_54.980226	727	802	183	2	75	0.0266667
NODE_11784_length_807_cov_54.980226	727	802	185	2	75	0.0266667
NODE_11784_length_807_cov_54.980226	727	802	187	1	75	0.0133333
NODE_11784_length_807_cov_54.980226	727	802	189	5	75	0.0666667
NODE_11784_length_807_cov_54.980226	727	802	195	1	75	0.0133333
NODE_11785_length_807_cov_37.306497	435	515	6	24	80	0.3000000
NODE_11785_length_807_cov_37.306497	435	515	8	56	80	0.7000000
NODE_11785_length_807_cov_37.306497	488	568	3	12	80	0.1500000
NODE_11785_length_807_cov_37.306497	488	568	5	19	80	0.2375000
NODE_11785_length_807_cov_37.306497	488	568	7	22	80	0.2750000
NODE_11785_length_807_cov_37.306497	488	568	8	27	80	0.3375000
NODE_11786_length_807_cov_31.177966	287	367	3	7	80	0.0875000
NODE_11786_length_807_cov_31.177966	287	367	4	45	80	0.5625000
NODE_11786_length_807_cov_31.177966	287	367	6	28	80	0.3500000
NODE_11786_length_807_cov_31.177966	340	420	0	10	80	0.1250000
NODE_11786_length_807_cov_31.177966	340	420	2	31	80	0.3875000
NODE_11786_length_807_cov_31.177966	340	420	5	1	80	0.0125000
NODE_11786_length_807_cov_31.177966	340	420	6	38	80	0.4750000
NODE_11787_length_807_cov_30.638418	250	329	0	79	79	1.0000000
NODE_11787_length_807_cov_30.638418	302	382	0	80	80	1.0000000
NODE_11787_length_807_cov_30.638418	378	458	0	80	80	1.0000000
NODE_11787_length_807_cov_30.638418	431	511	0	80	80	1.0000000
NODE_11788_length_807_cov_29.725989	362	442	0	80	80	1.0000000
NODE_11788_length_807_cov_29.725989	415	495	0	80	80	1.0000000
NODE_11789_length_807_cov_23.200565	441	521	0	80	80	1.0000000
NODE_11789_length_807_cov_23.200565	494	574	0	80	80	1.0000000
NODE_11790_length_807_cov_21.888418	319	386	0	5	67	0.0746269
NODE_11790_length_807_cov_21.888418	319	386	2	62	67	0.9253731
NODE_11790_length_807_cov_21.888418	390	440	0	50	50	1.0000000
NODE_11791_length_807_cov_17.480226	339	419	0	80	80	1.0000000
NODE_11791_length_807_cov_17.480226	392	472	0	80	80	1.0000000
NODE_11792_length_807_cov_14.895480	350	430	0	14	80	0.1750000
NODE_11792_length_807_cov_14.895480	350	430	2	66	80	0.8250000
NODE_11792_length_807_cov_14.895480	403	483	0	34	80	0.4250000
NODE_11792_length_807_cov_14.895480	403	483	2	46	80	0.5750000
NODE_11794_length_807_cov_12.255650	440	520	0	80	80	1.0000000
NODE_11794_length_807_cov_12.255650	493	573	0	80	80	1.0000000
NODE_11795_length_807_cov_11.129944	359	439	0	13	80	0.1625000
NODE_11795_length_807_cov_11.129944	359	439	2	8	80	0.1000000
NODE_11795_length_807_cov_11.129944	359	439	4	59	80	0.7375000
NODE_11795_length_807_cov_11.129944	412	492	0	13	80	0.1625000
NODE_11795_length_807_cov_11.129944	412	492	2	61	80	0.7625000
NODE_11795_length_807_cov_11.129944	412	492	4	6	80	0.0750000
NODE_11801_length_807_cov_3.847458	322	385	0	63	63	1.0000000
NODE_11822_length_806_cov_35.650636	397	477	0	80	80	1.0000000
NODE_11822_length_806_cov_35.650636	450	530	0	80	80	1.0000000
NODE_11822_length_806_cov_35.650636	526	606	0	40	80	0.5000000
NODE_11822_length_806_cov_35.650636	526	606	1	8	80	0.1000000
NODE_11822_length_806_cov_35.650636	526	606	2	6	80	0.0750000
NODE_11822_length_806_cov_35.650636	526	606	4	26	80	0.3250000
NODE_11822_length_806_cov_35.650636	579	667	2	30	88	0.3409091
NODE_11822_length_806_cov_35.650636	579	667	4	58	88	0.6590909
NODE_11823_length_806_cov_29.615276	377	457	2	22	80	0.2750000
NODE_11823_length_806_cov_29.615276	377	457	4	6	80	0.0750000
NODE_11823_length_806_cov_29.615276	377	457	6	52	80	0.6500000
NODE_11823_length_806_cov_29.615276	430	510	0	20	80	0.2500000
NODE_11823_length_806_cov_29.615276	430	510	4	39	80	0.4875000
NODE_11823_length_806_cov_29.615276	430	510	6	21	80	0.2625000
NODE_11824_length_806_cov_23.680339	394	474	0	19	80	0.2375000
NODE_11824_length_806_cov_23.680339	394	474	4	2	80	0.0250000
NODE_11824_length_806_cov_23.680339	394	474	6	59	80	0.7375000
NODE_11824_length_806_cov_23.680339	447	527	2	2	80	0.0250000
NODE_11824_length_806_cov_23.680339	447	527	4	20	80	0.2500000
NODE_11824_length_806_cov_23.680339	447	527	6	58	80	0.7250000
NODE_11825_length_806_cov_19.107496	239	293	0	54	54	1.0000000
NODE_11825_length_806_cov_19.107496	248	293	0	45	45	1.0000000
NODE_11825_length_806_cov_19.107496	266	345	0	79	79	1.0000000
NODE_11825_length_806_cov_19.107496	266	345	0	79	79	1.0000000
NODE_11825_length_806_cov_19.107496	421	501	0	22	80	0.2750000
NODE_11825_length_806_cov_19.107496	421	501	2	5	80	0.0625000
NODE_11825_length_806_cov_19.107496	421	501	4	53	80	0.6625000
NODE_11826_length_806_cov_17.551627	308	388	0	80	80	1.0000000
NODE_11826_length_806_cov_17.551627	361	441	0	80	80	1.0000000
NODE_11827_length_806_cov_15.608204	408	488	2	7	80	0.0875000
NODE_11827_length_806_cov_15.608204	408	488	6	73	80	0.9125000
NODE_11827_length_806_cov_15.608204	461	543	0	7	82	0.0853659
NODE_11827_length_806_cov_15.608204	461	543	2	31	82	0.3780488
NODE_11827_length_806_cov_15.608204	461	543	6	44	82	0.5365854
NODE_11864_length_805_cov_94.121813	398	478	0	80	80	1.0000000
NODE_11864_length_805_cov_94.121813	451	531	0	80	80	1.0000000
NODE_11865_length_805_cov_54.001416	284	364	0	80	80	1.0000000
NODE_11865_length_805_cov_54.001416	337	417	0	80	80	1.0000000
NODE_11865_length_805_cov_54.001416	413	493	0	80	80	1.0000000
NODE_11865_length_805_cov_54.001416	466	546	0	80	80	1.0000000
NODE_11866_length_805_cov_42.325779	377	457	3	54	80	0.6750000
NODE_11866_length_805_cov_42.325779	377	457	4	1	80	0.0125000
NODE_11866_length_805_cov_42.325779	377	457	7	25	80	0.3125000
NODE_11866_length_805_cov_42.325779	430	510	3	2	80	0.0250000
NODE_11866_length_805_cov_42.325779	430	510	4	35	80	0.4375000
NODE_11866_length_805_cov_42.325779	430	510	6	1	80	0.0125000
NODE_11866_length_805_cov_42.325779	430	510	7	42	80	0.5250000
NODE_11867_length_805_cov_36.742210	345	425	0	49	80	0.6125000
NODE_11867_length_805_cov_36.742210	345	425	2	31	80	0.3875000
NODE_11867_length_805_cov_36.742210	398	478	0	80	80	1.0000000
NODE_11868_length_805_cov_25.879603	361	441	0	80	80	1.0000000
NODE_11868_length_805_cov_25.879603	414	494	0	80	80	1.0000000
NODE_11869_length_805_cov_25.048159	306	386	0	80	80	1.0000000
NODE_11869_length_805_cov_25.048159	359	439	0	80	80	1.0000000
NODE_11870_length_805_cov_15.453258	311	391	0	54	80	0.6750000
NODE_11870_length_805_cov_15.453258	311	391	4	26	80	0.3250000
NODE_11870_length_805_cov_15.453258	364	444	0	1	80	0.0125000
NODE_11870_length_805_cov_15.453258	364	444	4	79	80	0.9875000
NODE_11871_length_805_cov_14.930595	264	344	0	64	80	0.8000000
NODE_11871_length_805_cov_14.930595	264	344	2	16	80	0.2000000
NODE_11871_length_805_cov_14.930595	317	397	0	80	80	1.0000000
NODE_11872_length_805_cov_10.888102	259	339	0	80	80	1.0000000
NODE_11872_length_805_cov_10.888102	312	392	0	80	80	1.0000000
NODE_11873_length_805_cov_10.716714	348	428	0	80	80	1.0000000
NODE_11873_length_805_cov_10.716714	401	481	0	80	80	1.0000000
NODE_11876_length_805_cov_7.212465	374	454	2	80	80	1.0000000
NODE_11876_length_805_cov_7.212465	427	507	0	38	80	0.4750000
NODE_11876_length_805_cov_7.212465	427	507	2	42	80	0.5250000
NODE_11877_length_805_cov_5.637394	323	403	0	80	80	1.0000000
NODE_11877_length_805_cov_5.637394	376	456	0	80	80	1.0000000
NODE_11878_length_805_cov_4.001416	304	384	0	27	80	0.3375000
NODE_11878_length_805_cov_4.001416	304	384	2	53	80	0.6625000
NODE_11878_length_805_cov_4.001416	357	437	0	25	80	0.3125000
NODE_11878_length_805_cov_4.001416	357	437	2	55	80	0.6875000
NODE_11903_length_804_cov_26.204255	319	399	0	80	80	1.0000000
NODE_11903_length_804_cov_26.204255	372	452	0	80	80	1.0000000
NODE_11904_length_804_cov_25.978723	242	322	0	80	80	1.0000000
NODE_11904_length_804_cov_25.978723	295	375	0	80	80	1.0000000
NODE_11904_length_804_cov_25.978723	371	451	0	59	80	0.7375000
NODE_11904_length_804_cov_25.978723	371	451	2	21	80	0.2625000
NODE_11904_length_804_cov_25.978723	424	504	0	6	80	0.0750000
NODE_11904_length_804_cov_25.978723	424	504	2	57	80	0.7125000
NODE_11904_length_804_cov_25.978723	424	504	4	17	80	0.2125000
NODE_11905_length_804_cov_25.628369	444	524	0	54	80	0.6750000
NODE_11905_length_804_cov_25.628369	444	524	2	26	80	0.3250000
NODE_11905_length_804_cov_25.628369	497	577	0	18	80	0.2250000
NODE_11905_length_804_cov_25.628369	497	577	2	62	80	0.7750000
NODE_11906_length_804_cov_22.438298	269	349	0	16	80	0.2000000
NODE_11906_length_804_cov_22.438298	269	349	2	14	80	0.1750000
NODE_11906_length_804_cov_22.438298	269	349	4	50	80	0.6250000
NODE_11906_length_804_cov_22.438298	322	402	4	39	80	0.4875000
NODE_11906_length_804_cov_22.438298	322	402	6	41	80	0.5125000
NODE_11907_length_804_cov_17.425532	273	353	0	55	80	0.6875000
NODE_11907_length_804_cov_17.425532	273	353	6	16	80	0.2000000
NODE_11907_length_804_cov_17.425532	273	353	8	9	80	0.1125000
NODE_11907_length_804_cov_17.425532	326	406	0	2	80	0.0250000
NODE_11907_length_804_cov_17.425532	326	406	6	16	80	0.2000000
NODE_11907_length_804_cov_17.425532	326	406	8	35	80	0.4375000
NODE_11907_length_804_cov_17.425532	326	406	12	27	80	0.3375000
NODE_11908_length_804_cov_16.849645	229	309	0	80	80	1.0000000
NODE_11908_length_804_cov_16.849645	282	362	0	80	80	1.0000000
NODE_11909_length_804_cov_16.024113	499	579	0	80	80	1.0000000
NODE_11909_length_804_cov_16.024113	552	632	0	80	80	1.0000000
NODE_11910_length_804_cov_14.567376	375	455	2	19	80	0.2375000
NODE_11910_length_804_cov_14.567376	375	455	4	3	80	0.0375000
NODE_11910_length_804_cov_14.567376	375	455	6	25	80	0.3125000
NODE_11910_length_804_cov_14.567376	375	455	8	33	80	0.4125000
NODE_11910_length_804_cov_14.567376	428	508	2	27	80	0.3375000
NODE_11910_length_804_cov_14.567376	428	508	6	51	80	0.6375000
NODE_11910_length_804_cov_14.567376	428	508	8	2	80	0.0250000
NODE_11911_length_804_cov_14.011348	262	342	0	64	80	0.8000000
NODE_11911_length_804_cov_14.011348	262	342	2	16	80	0.2000000
NODE_11911_length_804_cov_14.011348	315	395	0	80	80	1.0000000
NODE_11912_length_804_cov_13.800000	289	318	0	29	29	1.0000000
NODE_11913_length_804_cov_12.585816	396	476	0	25	80	0.3125000
NODE_11913_length_804_cov_12.585816	396	476	4	55	80	0.6875000
NODE_11913_length_804_cov_12.585816	449	529	0	78	80	0.9750000
NODE_11913_length_804_cov_12.585816	449	529	4	2	80	0.0250000
NODE_11914_length_804_cov_12.375887	190	270	2	4	80	0.0500000
NODE_11914_length_804_cov_12.375887	190	270	6	26	80	0.3250000
NODE_11914_length_804_cov_12.375887	190	270	8	50	80	0.6250000
NODE_11914_length_804_cov_12.375887	243	323	0	20	80	0.2500000
NODE_11914_length_804_cov_12.375887	243	323	4	27	80	0.3375000
NODE_11914_length_804_cov_12.375887	243	323	6	25	80	0.3125000
NODE_11914_length_804_cov_12.375887	243	323	8	8	80	0.1000000
NODE_11915_length_804_cov_10.947518	363	443	0	15	80	0.1875000
NODE_11915_length_804_cov_10.947518	363	443	2	65	80	0.8125000
NODE_11915_length_804_cov_10.947518	416	496	0	28	80	0.3500000
NODE_11915_length_804_cov_10.947518	416	496	2	52	80	0.6500000
NODE_11916_length_804_cov_8.164539	427	507	0	9	80	0.1125000
NODE_11916_length_804_cov_8.164539	427	507	2	71	80	0.8875000
NODE_11916_length_804_cov_8.164539	480	560	0	62	80	0.7750000
NODE_11916_length_804_cov_8.164539	480	560	2	18	80	0.2250000
NODE_11917_length_804_cov_7.462411	345	425	0	80	80	1.0000000
NODE_11917_length_804_cov_7.462411	398	478	0	80	80	1.0000000
NODE_11919_length_804_cov_3.663830	736	799	0	63	63	1.0000000
NODE_11933_length_804_cov_1.303546	480	560	4	12	80	0.1500000
NODE_11933_length_804_cov_1.303546	480	560	6	7	80	0.0875000
NODE_11933_length_804_cov_1.303546	480	560	8	61	80	0.7625000
NODE_11933_length_804_cov_1.303546	533	613	0	8	80	0.1000000
NODE_11933_length_804_cov_1.303546	533	613	2	13	80	0.1625000
NODE_11933_length_804_cov_1.303546	533	613	4	8	80	0.1000000
NODE_11933_length_804_cov_1.303546	533	613	6	9	80	0.1125000
NODE_11933_length_804_cov_1.303546	533	613	8	42	80	0.5250000
NODE_11942_length_803_cov_40.930398	374	454	0	80	80	1.0000000
NODE_11942_length_803_cov_40.930398	427	507	0	80	80	1.0000000
NODE_11944_length_803_cov_28.346591	242	322	0	80	80	1.0000000
NODE_11944_length_803_cov_28.346591	295	375	0	40	80	0.5000000
NODE_11944_length_803_cov_28.346591	295	375	2	40	80	0.5000000
NODE_11945_length_803_cov_23.420455	288	368	0	80	80	1.0000000
NODE_11945_length_803_cov_23.420455	341	421	0	80	80	1.0000000
NODE_11946_length_803_cov_20.977273	316	396	0	80	80	1.0000000
NODE_11946_length_803_cov_20.977273	369	449	0	80	80	1.0000000
NODE_11947_length_803_cov_18.458807	307	387	4	14	80	0.1750000
NODE_11947_length_803_cov_18.458807	307	387	6	26	80	0.3250000
NODE_11947_length_803_cov_18.458807	307	387	8	40	80	0.5000000
NODE_11947_length_803_cov_18.458807	360	440	0	6	80	0.0750000
NODE_11947_length_803_cov_18.458807	360	440	4	57	80	0.7125000
NODE_11947_length_803_cov_18.458807	360	440	6	17	80	0.2125000
NODE_11948_length_803_cov_14.411932	386	466	0	80	80	1.0000000
NODE_11948_length_803_cov_14.411932	439	519	0	80	80	1.0000000
NODE_11949_length_803_cov_10.157670	319	399	2	80	80	1.0000000
NODE_11949_length_803_cov_10.157670	372	452	1	31	80	0.3875000
NODE_11949_length_803_cov_10.157670	372	452	2	41	80	0.5125000
NODE_11949_length_803_cov_10.157670	372	452	3	8	80	0.1000000
NODE_11950_length_803_cov_8.977273	362	442	0	80	80	1.0000000
NODE_11950_length_803_cov_8.977273	415	485	0	70	70	1.0000000
NODE_11951_length_803_cov_7.735795	195	275	0	80	80	1.0000000
NODE_11951_length_803_cov_7.735795	248	328	0	80	80	1.0000000
NODE_11955_length_803_cov_4.613636	266	346	2	21	80	0.2625000
NODE_11955_length_803_cov_4.613636	266	346	3	6	80	0.0750000
NODE_11955_length_803_cov_4.613636	266	346	4	53	80	0.6625000
NODE_11955_length_803_cov_4.613636	319	399	0	34	80	0.4250000
NODE_11955_length_803_cov_4.613636	319	399	2	40	80	0.5000000
NODE_11955_length_803_cov_4.613636	319	399	3	6	80	0.0750000
NODE_11957_length_803_cov_4.220170	72	152	0	11	80	0.1375000
NODE_11957_length_803_cov_4.220170	72	152	2	14	80	0.1750000
NODE_11957_length_803_cov_4.220170	72	152	4	31	80	0.3875000
NODE_11957_length_803_cov_4.220170	72	152	6	24	80	0.3000000
NODE_11957_length_803_cov_4.220170	130	207	2	13	77	0.1688312
NODE_11957_length_803_cov_4.220170	130	207	4	32	77	0.4155844
NODE_11957_length_803_cov_4.220170	130	207	6	32	77	0.4155844
NODE_11985_length_802_cov_42.294452	289	369	0	80	80	1.0000000
NODE_11985_length_802_cov_42.294452	342	422	0	80	80	1.0000000
NODE_11986_length_802_cov_31.896159	246	326	6	14	80	0.1750000
NODE_11986_length_802_cov_31.896159	246	326	8	22	80	0.2750000
NODE_11986_length_802_cov_31.896159	246	326	12	44	80	0.5500000
NODE_11986_length_802_cov_31.896159	299	379	0	15	80	0.1875000
NODE_11986_length_802_cov_31.896159	299	379	4	5	80	0.0625000
NODE_11986_length_802_cov_31.896159	299	379	10	2	80	0.0250000
NODE_11986_length_802_cov_31.896159	299	379	12	58	80	0.7250000
NODE_11987_length_802_cov_30.786629	419	499	0	80	80	1.0000000
NODE_11987_length_802_cov_30.786629	472	552	0	80	80	1.0000000
NODE_11988_length_802_cov_19.540541	368	448	8	30	80	0.3750000
NODE_11988_length_802_cov_19.540541	368	448	10	50	80	0.6250000
NODE_11988_length_802_cov_19.540541	421	501	8	9	80	0.1125000
NODE_11988_length_802_cov_19.540541	421	501	10	71	80	0.8875000
NODE_11989_length_802_cov_17.689900	268	348	0	69	80	0.8625000
NODE_11989_length_802_cov_17.689900	268	348	8	11	80	0.1375000
NODE_11989_length_802_cov_17.689900	321	401	0	16	80	0.2000000
NODE_11989_length_802_cov_17.689900	321	401	8	64	80	0.8000000
NODE_11990_length_802_cov_16.432432	364	444	2	80	80	1.0000000
NODE_11990_length_802_cov_16.432432	417	497	0	1	80	0.0125000
NODE_11990_length_802_cov_16.432432	417	497	1	2	80	0.0250000
NODE_11990_length_802_cov_16.432432	417	497	2	77	80	0.9625000
NODE_11991_length_802_cov_15.409673	317	397	0	42	80	0.5250000
NODE_11991_length_802_cov_15.409673	317	397	4	38	80	0.4750000
NODE_11991_length_802_cov_15.409673	370	450	3	10	80	0.1250000
NODE_11991_length_802_cov_15.409673	370	450	4	61	80	0.7625000
NODE_11991_length_802_cov_15.409673	370	450	7	9	80	0.1125000
NODE_11992_length_802_cov_12.507824	340	420	0	2	80	0.0250000
NODE_11992_length_802_cov_12.507824	340	420	2	30	80	0.3750000
NODE_11992_length_802_cov_12.507824	340	420	4	48	80	0.6000000
NODE_11992_length_802_cov_12.507824	393	473	0	15	80	0.1875000
NODE_11992_length_802_cov_12.507824	393	473	2	32	80	0.4000000
NODE_11992_length_802_cov_12.507824	393	473	4	33	80	0.4125000
NODE_11993_length_802_cov_9.310100	374	454	0	80	80	1.0000000
NODE_11993_length_802_cov_9.310100	427	507	0	80	80	1.0000000
NODE_11994_length_802_cov_8.421053	272	351	2	70	79	0.8860760
NODE_11994_length_802_cov_8.421053	272	351	4	9	79	0.1139240
NODE_11994_length_802_cov_8.421053	324	404	0	21	80	0.2625000
NODE_11994_length_802_cov_8.421053	324	404	2	59	80	0.7375000
NODE_11997_length_802_cov_5.576102	294	374	0	43	80	0.5375000
NODE_11997_length_802_cov_5.576102	294	374	4	37	80	0.4625000
NODE_11997_length_802_cov_5.576102	347	427	0	1	80	0.0125000
NODE_11997_length_802_cov_5.576102	347	427	4	79	80	0.9875000
NODE_12025_length_801_cov_35.199430	334	414	0	25	80	0.3125000
NODE_12025_length_801_cov_35.199430	334	414	2	25	80	0.3125000
NODE_12025_length_801_cov_35.199430	334	414	10	30	80	0.3750000
NODE_12025_length_801_cov_35.199430	387	467	8	3	80	0.0375000
NODE_12025_length_801_cov_35.199430	387	467	10	77	80	0.9625000
NODE_12026_length_801_cov_20.096866	347	427	4	18	80	0.2250000
NODE_12026_length_801_cov_20.096866	347	427	6	11	80	0.1375000
NODE_12026_length_801_cov_20.096866	347	427	8	44	80	0.5500000
NODE_12026_length_801_cov_20.096866	347	427	10	7	80	0.0875000
NODE_12026_length_801_cov_20.096866	400	480	0	11	80	0.1375000
NODE_12026_length_801_cov_20.096866	400	480	4	60	80	0.7500000
NODE_12026_length_801_cov_20.096866	400	480	8	4	80	0.0500000
NODE_12026_length_801_cov_20.096866	400	480	10	5	80	0.0625000
NODE_12027_length_801_cov_18.643875	355	435	2	61	80	0.7625000
NODE_12027_length_801_cov_18.643875	355	435	4	19	80	0.2375000
NODE_12027_length_801_cov_18.643875	408	488	0	8	80	0.1000000
NODE_12027_length_801_cov_18.643875	408	488	2	60	80	0.7500000
NODE_12027_length_801_cov_18.643875	408	488	4	12	80	0.1500000
NODE_12028_length_801_cov_16.099715	427	507	0	5	80	0.0625000
NODE_12028_length_801_cov_16.099715	427	507	2	75	80	0.9375000
NODE_12028_length_801_cov_16.099715	480	560	0	13	80	0.1625000
NODE_12028_length_801_cov_16.099715	480	560	2	59	80	0.7375000
NODE_12028_length_801_cov_16.099715	480	560	4	8	80	0.1000000
NODE_12029_length_801_cov_12.307692	332	412	0	80	80	1.0000000
NODE_12029_length_801_cov_12.307692	385	465	0	80	80	1.0000000
NODE_12030_length_801_cov_11.464387	293	373	2	80	80	1.0000000
NODE_12030_length_801_cov_11.464387	346	426	0	12	80	0.1500000
NODE_12030_length_801_cov_11.464387	346	426	1	24	80	0.3000000
NODE_12030_length_801_cov_11.464387	346	426	2	44	80	0.5500000
NODE_12031_length_801_cov_8.562678	309	389	0	80	80	1.0000000
NODE_12031_length_801_cov_8.562678	362	442	0	80	80	1.0000000
NODE_12032_length_801_cov_3.927350	339	419	0	80	80	1.0000000
NODE_12032_length_801_cov_3.927350	392	472	0	80	80	1.0000000
NODE_12053_length_800_cov_72.029957	245	325	2	74	80	0.9250000
NODE_12053_length_800_cov_72.029957	245	325	4	6	80	0.0750000
NODE_12053_length_800_cov_72.029957	298	378	0	4	80	0.0500000
NODE_12053_length_800_cov_72.029957	298	378	2	71	80	0.8875000
NODE_12053_length_800_cov_72.029957	298	378	4	5	80	0.0625000
NODE_12054_length_800_cov_22.631954	297	377	0	41	80	0.5125000
NODE_12054_length_800_cov_22.631954	297	377	2	39	80	0.4875000
NODE_12054_length_800_cov_22.631954	350	430	2	47	80	0.5875000
NODE_12054_length_800_cov_22.631954	350	430	4	33	80	0.4125000
NODE_12055_length_800_cov_9.457917	409	489	4	48	80	0.6000000
NODE_12055_length_800_cov_9.457917	409	489	6	32	80	0.4000000
NODE_12055_length_800_cov_9.457917	462	542	0	31	80	0.3875000
NODE_12055_length_800_cov_9.457917	462	542	2	9	80	0.1125000
NODE_12055_length_800_cov_9.457917	462	542	4	40	80	0.5000000
NODE_12084_length_799_cov_101.640000	101	132	68	1	31	0.0322581
NODE_12084_length_799_cov_101.640000	101	132	71	2	31	0.0645161
NODE_12084_length_799_cov_101.640000	101	132	81	2	31	0.0645161
NODE_12084_length_799_cov_101.640000	101	132	85	3	31	0.0967742
NODE_12084_length_799_cov_101.640000	101	132	87	1	31	0.0322581
NODE_12084_length_799_cov_101.640000	101	132	89	1	31	0.0322581
NODE_12084_length_799_cov_101.640000	101	132	94	2	31	0.0645161
NODE_12084_length_799_cov_101.640000	101	132	97	1	31	0.0322581
NODE_12084_length_799_cov_101.640000	101	132	101	1	31	0.0322581
NODE_12084_length_799_cov_101.640000	101	132	106	1	31	0.0322581
NODE_12084_length_799_cov_101.640000	101	132	108	1	31	0.0322581
NODE_12084_length_799_cov_101.640000	101	132	122	1	31	0.0322581
NODE_12084_length_799_cov_101.640000	101	132	126	2	31	0.0645161
NODE_12084_length_799_cov_101.640000	101	132	130	1	31	0.0322581
NODE_12084_length_799_cov_101.640000	101	132	134	1	31	0.0322581
NODE_12084_length_799_cov_101.640000	101	132	139	2	31	0.0645161
NODE_12084_length_799_cov_101.640000	101	132	145	1	31	0.0322581
NODE_12084_length_799_cov_101.640000	101	132	155	1	31	0.0322581
NODE_12084_length_799_cov_101.640000	101	132	157	1	31	0.0322581
NODE_12084_length_799_cov_101.640000	101	132	163	2	31	0.0645161
NODE_12084_length_799_cov_101.640000	101	132	168	1	31	0.0322581
NODE_12084_length_799_cov_101.640000	101	132	173	1	31	0.0322581
NODE_12084_length_799_cov_101.640000	101	132	176	1	31	0.0322581
NODE_12085_length_799_cov_33.630000	367	447	0	7	80	0.0875000
NODE_12085_length_799_cov_33.630000	367	447	4	73	80	0.9125000
NODE_12085_length_799_cov_33.630000	420	500	0	43	80	0.5375000
NODE_12085_length_799_cov_33.630000	420	500	4	37	80	0.4625000
NODE_12086_length_799_cov_15.717143	408	488	4	80	80	1.0000000
NODE_12086_length_799_cov_15.717143	461	541	2	26	80	0.3250000
NODE_12086_length_799_cov_15.717143	461	541	4	54	80	0.6750000
NODE_12087_length_799_cov_15.175714	293	373	0	6	80	0.0750000
NODE_12087_length_799_cov_15.175714	293	373	2	2	80	0.0250000
NODE_12087_length_799_cov_15.175714	293	373	4	72	80	0.9000000
NODE_12087_length_799_cov_15.175714	346	426	0	59	80	0.7375000
NODE_12087_length_799_cov_15.175714	346	426	2	2	80	0.0250000
NODE_12087_length_799_cov_15.175714	346	426	4	19	80	0.2375000
NODE_12088_length_799_cov_8.444286	408	488	0	16	80	0.2000000
NODE_12088_length_799_cov_8.444286	408	488	2	64	80	0.8000000
NODE_12088_length_799_cov_8.444286	461	541	0	45	80	0.5625000
NODE_12088_length_799_cov_8.444286	461	541	2	35	80	0.4375000
NODE_12120_length_798_cov_42.629471	148	228	0	46	80	0.5750000
NODE_12120_length_798_cov_42.629471	148	228	2	34	80	0.4250000
NODE_12120_length_798_cov_42.629471	201	281	0	34	80	0.4250000
NODE_12120_length_798_cov_42.629471	201	281	2	46	80	0.5750000
NODE_12121_length_798_cov_23.658083	368	448	0	67	80	0.8375000
NODE_12121_length_798_cov_23.658083	368	448	4	6	80	0.0750000
NODE_12121_length_798_cov_23.658083	368	448	6	7	80	0.0875000
NODE_12121_length_798_cov_23.658083	421	501	0	14	80	0.1750000
NODE_12121_length_798_cov_23.658083	421	501	4	6	80	0.0750000
NODE_12121_length_798_cov_23.658083	421	501	6	60	80	0.7500000
NODE_12122_length_798_cov_15.037196	341	421	0	80	80	1.0000000
NODE_12122_length_798_cov_15.037196	394	474	0	80	80	1.0000000
NODE_12123_length_798_cov_6.816881	404	483	0	10	79	0.1265823
NODE_12123_length_798_cov_6.816881	404	483	2	69	79	0.8734177
NODE_12123_length_798_cov_6.816881	457	536	0	35	79	0.4430380
NODE_12123_length_798_cov_6.816881	457	536	2	44	79	0.5569620
NODE_12129_length_798_cov_2.796853	246	326	0	80	80	1.0000000
NODE_12129_length_798_cov_2.796853	299	379	0	80	80	1.0000000
NODE_12151_length_797_cov_24.340974	207	287	0	13	80	0.1625000
NODE_12151_length_797_cov_24.340974	207	287	2	67	80	0.8375000
NODE_12151_length_797_cov_24.340974	260	340	0	9	80	0.1125000
NODE_12151_length_797_cov_24.340974	260	340	2	44	80	0.5500000
NODE_12151_length_797_cov_24.340974	260	340	4	27	80	0.3375000
NODE_12152_length_797_cov_21.071633	372	452	0	20	80	0.2500000
NODE_12152_length_797_cov_21.071633	372	452	2	1	80	0.0125000
NODE_12152_length_797_cov_21.071633	372	452	4	3	80	0.0375000
NODE_12152_length_797_cov_21.071633	372	452	6	14	80	0.1750000
NODE_12152_length_797_cov_21.071633	372	452	8	28	80	0.3500000
NODE_12152_length_797_cov_21.071633	372	452	10	14	80	0.1750000
NODE_12152_length_797_cov_21.071633	425	505	6	9	80	0.1125000
NODE_12152_length_797_cov_21.071633	425	505	8	14	80	0.1750000
NODE_12152_length_797_cov_21.071633	425	505	9	10	80	0.1250000
NODE_12152_length_797_cov_21.071633	425	505	10	47	80	0.5875000
NODE_12153_length_797_cov_18.286533	346	426	0	80	80	1.0000000
NODE_12153_length_797_cov_18.286533	399	479	0	80	80	1.0000000
NODE_12154_length_797_cov_16.628940	322	402	4	49	80	0.6125000
NODE_12154_length_797_cov_16.628940	322	402	6	31	80	0.3875000
NODE_12154_length_797_cov_16.628940	375	455	0	37	80	0.4625000
NODE_12154_length_797_cov_16.628940	375	455	2	1	80	0.0125000
NODE_12154_length_797_cov_16.628940	375	455	4	41	80	0.5125000
NODE_12154_length_797_cov_16.628940	375	455	6	1	80	0.0125000
NODE_12155_length_797_cov_15.266476	299	379	0	25	80	0.3125000
NODE_12155_length_797_cov_15.266476	299	379	2	7	80	0.0875000
NODE_12155_length_797_cov_15.266476	299	379	4	48	80	0.6000000
NODE_12155_length_797_cov_15.266476	352	432	2	4	80	0.0500000
NODE_12155_length_797_cov_15.266476	352	432	4	76	80	0.9500000
NODE_12156_length_797_cov_15.035817	263	343	0	4	80	0.0500000
NODE_12156_length_797_cov_15.035817	263	343	4	60	80	0.7500000
NODE_12156_length_797_cov_15.035817	263	343	8	16	80	0.2000000
NODE_12156_length_797_cov_15.035817	316	396	4	11	80	0.1375000
NODE_12156_length_797_cov_15.035817	316	396	8	69	80	0.8625000
NODE_12157_length_797_cov_12.934097	403	484	0	30	81	0.3703704
NODE_12157_length_797_cov_12.934097	403	484	2	51	81	0.6296296
NODE_12157_length_797_cov_12.934097	457	537	0	80	80	1.0000000
NODE_12158_length_797_cov_11.140401	201	281	0	26	80	0.3250000
NODE_12158_length_797_cov_11.140401	201	281	2	54	80	0.6750000
NODE_12158_length_797_cov_11.140401	254	334	0	79	80	0.9875000
NODE_12158_length_797_cov_11.140401	254	334	2	1	80	0.0125000
NODE_12159_length_797_cov_8.681948	284	364	0	42	80	0.5250000
NODE_12159_length_797_cov_8.681948	284	364	3	5	80	0.0625000
NODE_12159_length_797_cov_8.681948	284	364	6	17	80	0.2125000
NODE_12159_length_797_cov_8.681948	284	364	8	4	80	0.0500000
NODE_12159_length_797_cov_8.681948	284	364	10	12	80	0.1500000
NODE_12159_length_797_cov_8.681948	337	417	6	11	80	0.1375000
NODE_12159_length_797_cov_8.681948	337	417	8	4	80	0.0500000
NODE_12159_length_797_cov_8.681948	337	417	10	65	80	0.8125000
NODE_12160_length_797_cov_7.616046	314	397	0	83	83	1.0000000
NODE_12160_length_797_cov_7.616046	370	450	0	80	80	1.0000000
NODE_12161_length_797_cov_7.487106	275	347	0	72	72	1.0000000
NODE_12161_length_797_cov_7.487106	320	400	0	80	80	1.0000000
NODE_12163_length_797_cov_6.068768	357	437	0	67	80	0.8375000
NODE_12163_length_797_cov_6.068768	357	437	2	13	80	0.1625000
NODE_12163_length_797_cov_6.068768	410	490	0	14	80	0.1750000
NODE_12163_length_797_cov_6.068768	410	490	2	23	80	0.2875000
NODE_12163_length_797_cov_6.068768	410	490	4	43	80	0.5375000
NODE_12186_length_796_cov_20.862267	262	342	0	80	80	1.0000000
NODE_12186_length_796_cov_20.862267	315	395	0	80	80	1.0000000
NODE_12187_length_796_cov_18.291248	283	363	0	56	80	0.7000000
NODE_12187_length_796_cov_18.291248	283	363	13	24	80	0.3000000
NODE_12187_length_796_cov_18.291248	336	416	0	3	80	0.0375000
NODE_12187_length_796_cov_18.291248	336	416	13	63	80	0.7875000
NODE_12187_length_796_cov_18.291248	336	416	14	10	80	0.1250000
NODE_12187_length_796_cov_18.291248	336	416	15	4	80	0.0500000
NODE_12189_length_796_cov_7.880918	388	460	0	72	72	1.0000000
NODE_12189_length_796_cov_7.880918	442	513	0	71	71	1.0000000
NODE_12216_length_795_cov_31.729885	298	378	0	1	80	0.0125000
NODE_12216_length_795_cov_31.729885	298	378	4	79	80	0.9875000
NODE_12216_length_795_cov_31.729885	351	431	0	54	80	0.6750000
NODE_12216_length_795_cov_31.729885	351	431	4	26	80	0.3250000
NODE_12217_length_795_cov_26.760057	367	447	0	11	80	0.1375000
NODE_12217_length_795_cov_26.760057	367	447	2	69	80	0.8625000
NODE_12217_length_795_cov_26.760057	420	500	0	34	80	0.4250000
NODE_12217_length_795_cov_26.760057	420	500	2	46	80	0.5750000
NODE_12218_length_795_cov_24.522989	352	432	0	80	80	1.0000000
NODE_12218_length_795_cov_24.522989	405	485	0	80	80	1.0000000
NODE_12219_length_795_cov_22.747126	363	443	0	27	80	0.3375000
NODE_12219_length_795_cov_22.747126	363	443	2	53	80	0.6625000
NODE_12219_length_795_cov_22.747126	416	496	0	28	80	0.3500000
NODE_12219_length_795_cov_22.747126	416	496	2	52	80	0.6500000
NODE_12220_length_795_cov_9.439655	425	505	0	9	80	0.1125000
NODE_12220_length_795_cov_9.439655	425	505	5	2	80	0.0250000
NODE_12220_length_795_cov_9.439655	425	505	6	47	80	0.5875000
NODE_12220_length_795_cov_9.439655	425	505	8	22	80	0.2750000
NODE_12220_length_795_cov_9.439655	478	558	2	29	80	0.3625000
NODE_12220_length_795_cov_9.439655	478	558	6	5	80	0.0625000
NODE_12220_length_795_cov_9.439655	478	558	8	46	80	0.5750000
NODE_12232_length_795_cov_3.359195	349	429	0	35	80	0.4375000
NODE_12232_length_795_cov_3.359195	349	429	2	45	80	0.5625000
NODE_12232_length_795_cov_3.359195	402	482	0	80	80	1.0000000
NODE_12256_length_794_cov_24.680576	326	406	8	10	80	0.1250000
NODE_12256_length_794_cov_24.680576	326	406	10	27	80	0.3375000
NODE_12256_length_794_cov_24.680576	326	406	12	43	80	0.5375000
NODE_12256_length_794_cov_24.680576	379	459	0	10	80	0.1250000
NODE_12256_length_794_cov_24.680576	379	459	2	14	80	0.1750000
NODE_12256_length_794_cov_24.680576	379	459	8	12	80	0.1500000
NODE_12256_length_794_cov_24.680576	379	459	10	7	80	0.0875000
NODE_12256_length_794_cov_24.680576	379	459	12	37	80	0.4625000
NODE_12257_length_794_cov_20.057554	153	233	0	45	80	0.5625000
NODE_12257_length_794_cov_20.057554	153	233	2	7	80	0.0875000
NODE_12257_length_794_cov_20.057554	153	233	6	28	80	0.3500000
NODE_12257_length_794_cov_20.057554	206	286	6	80	80	1.0000000
NODE_12257_length_794_cov_20.057554	282	362	0	29	80	0.3625000
NODE_12257_length_794_cov_20.057554	282	362	4	11	80	0.1375000
NODE_12257_length_794_cov_20.057554	282	362	6	40	80	0.5000000
NODE_12257_length_794_cov_20.057554	335	415	0	80	80	1.0000000
NODE_12258_length_794_cov_16.602878	361	441	0	80	80	1.0000000
NODE_12258_length_794_cov_16.602878	414	494	0	80	80	1.0000000
NODE_12259_length_794_cov_16.362590	337	417	0	80	80	1.0000000
NODE_12259_length_794_cov_16.362590	390	470	0	80	80	1.0000000
NODE_12260_length_794_cov_14.444604	101	160	0	59	59	1.0000000
NODE_12260_length_794_cov_14.444604	409	489	0	80	80	1.0000000
NODE_12260_length_794_cov_14.444604	462	542	0	80	80	1.0000000
NODE_12261_length_794_cov_12.866187	442	522	0	62	80	0.7750000
NODE_12261_length_794_cov_12.866187	442	522	2	18	80	0.2250000
NODE_12261_length_794_cov_12.866187	495	575	0	69	80	0.8625000
NODE_12261_length_794_cov_12.866187	495	575	2	11	80	0.1375000
NODE_12262_length_794_cov_12.287770	235	315	2	22	80	0.2750000
NODE_12262_length_794_cov_12.287770	235	315	4	58	80	0.7250000
NODE_12262_length_794_cov_12.287770	288	368	0	46	80	0.5750000
NODE_12262_length_794_cov_12.287770	288	368	2	25	80	0.3125000
NODE_12262_length_794_cov_12.287770	288	368	4	9	80	0.1125000
NODE_12263_length_794_cov_11.210072	315	395	0	4	80	0.0500000
NODE_12263_length_794_cov_11.210072	315	395	6	56	80	0.7000000
NODE_12263_length_794_cov_11.210072	315	395	8	14	80	0.1750000
NODE_12263_length_794_cov_11.210072	315	395	10	6	80	0.0750000
NODE_12263_length_794_cov_11.210072	368	448	4	5	80	0.0625000
NODE_12263_length_794_cov_11.210072	368	448	6	7	80	0.0875000
NODE_12263_length_794_cov_11.210072	368	448	8	14	80	0.1750000
NODE_12263_length_794_cov_11.210072	368	448	10	54	80	0.6750000
NODE_12264_length_794_cov_10.638849	325	406	0	3	81	0.0370370
NODE_12264_length_794_cov_10.638849	325	406	2	78	81	0.9629630
NODE_12264_length_794_cov_10.638849	379	459	0	56	80	0.7000000
NODE_12264_length_794_cov_10.638849	379	459	2	24	80	0.3000000
NODE_12266_length_794_cov_6.274820	412	492	4	33	80	0.4125000
NODE_12266_length_794_cov_6.274820	412	492	5	7	80	0.0875000
NODE_12266_length_794_cov_6.274820	412	492	6	40	80	0.5000000
NODE_12266_length_794_cov_6.274820	465	545	0	5	80	0.0625000
NODE_12266_length_794_cov_6.274820	465	545	4	75	80	0.9375000
NODE_12271_length_794_cov_3.197122	273	338	0	65	65	1.0000000
NODE_12282_length_794_cov_1.848921	246	326	0	80	80	1.0000000
NODE_12282_length_794_cov_1.848921	299	379	0	80	80	1.0000000
NODE_12295_length_793_cov_29.878963	326	406	8	11	80	0.1375000
NODE_12295_length_793_cov_29.878963	326	406	10	7	80	0.0875000
NODE_12295_length_793_cov_29.878963	326	406	14	21	80	0.2625000
NODE_12295_length_793_cov_29.878963	326	406	16	6	80	0.0750000
NODE_12295_length_793_cov_29.878963	326	406	18	35	80	0.4375000
NODE_12295_length_793_cov_29.878963	379	459	0	21	80	0.2625000
NODE_12295_length_793_cov_29.878963	379	459	2	5	80	0.0625000
NODE_12295_length_793_cov_29.878963	379	459	8	5	80	0.0625000
NODE_12295_length_793_cov_29.878963	379	459	10	29	80	0.3625000
NODE_12295_length_793_cov_29.878963	379	459	14	1	80	0.0125000
NODE_12295_length_793_cov_29.878963	379	459	18	19	80	0.2375000
NODE_12296_length_793_cov_25.981268	310	390	0	80	80	1.0000000
NODE_12296_length_793_cov_25.981268	363	445	0	82	82	1.0000000
NODE_12297_length_793_cov_24.840058	331	411	0	80	80	1.0000000
NODE_12297_length_793_cov_24.840058	384	464	0	80	80	1.0000000
NODE_12298_length_793_cov_21.707493	398	478	2	29	80	0.3625000
NODE_12298_length_793_cov_21.707493	398	478	4	51	80	0.6375000
NODE_12298_length_793_cov_21.707493	451	531	0	50	80	0.6250000
NODE_12298_length_793_cov_21.707493	451	531	2	21	80	0.2625000
NODE_12298_length_793_cov_21.707493	451	531	4	9	80	0.1125000
NODE_12299_length_793_cov_8.358790	257	337	0	80	80	1.0000000
NODE_12299_length_793_cov_8.358790	310	390	0	29	80	0.3625000
NODE_12299_length_793_cov_8.358790	310	390	2	51	80	0.6375000
NODE_12300_length_793_cov_8.236311	477	557	0	80	80	1.0000000
NODE_12300_length_793_cov_8.236311	530	610	0	80	80	1.0000000
NODE_12302_length_793_cov_6.763689	461	541	0	80	80	1.0000000
NODE_12302_length_793_cov_6.763689	514	594	0	80	80	1.0000000
NODE_12307_length_793_cov_4.465418	501	549	0	48	48	1.0000000
NODE_12311_length_793_cov_4.138329	174	254	0	80	80	1.0000000
NODE_12311_length_793_cov_4.138329	227	307	0	80	80	1.0000000
NODE_12338_length_792_cov_40.025974	198	278	0	80	80	1.0000000
NODE_12338_length_792_cov_40.025974	251	331	0	80	80	1.0000000
NODE_12338_length_792_cov_40.025974	327	408	0	81	81	1.0000000
NODE_12338_length_792_cov_40.025974	381	461	0	80	80	1.0000000
NODE_12339_length_792_cov_31.176046	331	411	0	65	80	0.8125000
NODE_12339_length_792_cov_31.176046	331	411	1	15	80	0.1875000
NODE_12339_length_792_cov_31.176046	384	463	0	29	79	0.3670886
NODE_12339_length_792_cov_31.176046	384	463	2	50	79	0.6329114
NODE_12339_length_792_cov_31.176046	459	539	0	39	80	0.4875000
NODE_12339_length_792_cov_31.176046	459	539	2	41	80	0.5125000
NODE_12339_length_792_cov_31.176046	512	546	0	34	34	1.0000000
NODE_12340_length_792_cov_21.347763	303	383	0	80	80	1.0000000
NODE_12340_length_792_cov_21.347763	356	436	0	80	80	1.0000000
NODE_12341_length_792_cov_20.142857	361	441	0	80	80	1.0000000
NODE_12341_length_792_cov_20.142857	414	494	0	65	80	0.8125000
NODE_12341_length_792_cov_20.142857	414	494	2	15	80	0.1875000
NODE_12342_length_792_cov_18.733045	320	400	0	25	80	0.3125000
NODE_12342_length_792_cov_18.733045	320	400	2	55	80	0.6875000
NODE_12342_length_792_cov_18.733045	373	453	0	25	80	0.3125000
NODE_12342_length_792_cov_18.733045	373	453	2	55	80	0.6875000
NODE_12343_length_792_cov_12.024531	369	449	0	80	80	1.0000000
NODE_12343_length_792_cov_12.024531	422	502	0	80	80	1.0000000
NODE_12372_length_791_cov_53.573699	287	359	0	72	72	1.0000000
NODE_12372_length_791_cov_53.573699	332	412	0	80	80	1.0000000
NODE_12373_length_791_cov_40.416185	238	318	0	80	80	1.0000000
NODE_12373_length_791_cov_40.416185	291	371	0	80	80	1.0000000
NODE_12374_length_791_cov_38.791908	309	389	0	5	80	0.0625000
NODE_12374_length_791_cov_38.791908	309	389	2	3	80	0.0375000
NODE_12374_length_791_cov_38.791908	309	389	4	28	80	0.3500000
NODE_12374_length_791_cov_38.791908	309	389	6	44	80	0.5500000
NODE_12374_length_791_cov_38.791908	362	442	0	5	80	0.0625000
NODE_12374_length_791_cov_38.791908	362	442	2	56	80	0.7000000
NODE_12374_length_791_cov_38.791908	362	442	4	19	80	0.2375000
NODE_12375_length_791_cov_23.468208	328	408	0	10	80	0.1250000
NODE_12375_length_791_cov_23.468208	328	408	2	14	80	0.1750000
NODE_12375_length_791_cov_23.468208	328	408	4	56	80	0.7000000
NODE_12375_length_791_cov_23.468208	381	461	0	45	80	0.5625000
NODE_12375_length_791_cov_23.468208	381	461	2	20	80	0.2500000
NODE_12375_length_791_cov_23.468208	381	461	4	15	80	0.1875000
NODE_12376_length_791_cov_20.897399	299	379	0	4	80	0.0500000
NODE_12376_length_791_cov_20.897399	299	379	1	25	80	0.3125000
NODE_12376_length_791_cov_20.897399	299	379	2	10	80	0.1250000
NODE_12376_length_791_cov_20.897399	299	379	4	41	80	0.5125000
NODE_12376_length_791_cov_20.897399	352	432	2	8	80	0.1000000
NODE_12376_length_791_cov_20.897399	352	432	4	72	80	0.9000000
NODE_12377_length_791_cov_13.504335	339	419	0	76	80	0.9500000
NODE_12377_length_791_cov_13.504335	339	419	2	4	80	0.0500000
NODE_12377_length_791_cov_13.504335	392	472	0	80	80	1.0000000
NODE_12379_length_791_cov_12.547688	338	418	2	80	80	1.0000000
NODE_12379_length_791_cov_12.547688	391	471	0	28	80	0.3500000
NODE_12379_length_791_cov_12.547688	391	471	2	52	80	0.6500000
NODE_12380_length_791_cov_11.791908	440	520	2	36	80	0.4500000
NODE_12380_length_791_cov_11.791908	440	520	4	37	80	0.4625000
NODE_12380_length_791_cov_11.791908	440	520	6	7	80	0.0875000
NODE_12380_length_791_cov_11.791908	493	573	2	21	80	0.2625000
NODE_12380_length_791_cov_11.791908	493	573	3	1	80	0.0125000
NODE_12380_length_791_cov_11.791908	493	573	4	36	80	0.4500000
NODE_12380_length_791_cov_11.791908	493	573	6	22	80	0.2750000
NODE_12381_length_791_cov_11.011561	337	417	2	49	80	0.6125000
NODE_12381_length_791_cov_11.011561	337	417	4	31	80	0.3875000
NODE_12381_length_791_cov_11.011561	390	470	0	35	80	0.4375000
NODE_12381_length_791_cov_11.011561	390	470	2	45	80	0.5625000
NODE_12382_length_791_cov_8.757225	325	405	0	80	80	1.0000000
NODE_12382_length_791_cov_8.757225	378	458	0	80	80	1.0000000
NODE_12384_length_791_cov_8.125723	416	496	0	34	80	0.4250000
NODE_12384_length_791_cov_8.125723	416	496	2	46	80	0.5750000
NODE_12384_length_791_cov_8.125723	469	549	0	33	80	0.4125000
NODE_12384_length_791_cov_8.125723	469	549	2	47	80	0.5875000
NODE_12409_length_790_cov_48.021708	526	606	4	10	80	0.1250000
NODE_12409_length_790_cov_48.021708	526	606	6	70	80	0.8750000
NODE_12409_length_790_cov_48.021708	579	659	0	32	80	0.4000000
NODE_12409_length_790_cov_48.021708	579	659	2	7	80	0.0875000
NODE_12409_length_790_cov_48.021708	579	659	4	24	80	0.3000000
NODE_12409_length_790_cov_48.021708	579	659	6	17	80	0.2125000
NODE_12410_length_790_cov_44.151954	343	423	0	80	80	1.0000000
NODE_12410_length_790_cov_44.151954	396	438	0	42	42	1.0000000
NODE_12410_length_790_cov_44.151954	696	776	15	1	80	0.0125000
NODE_12410_length_790_cov_44.151954	696	776	18	1	80	0.0125000
NODE_12410_length_790_cov_44.151954	696	776	20	3	80	0.0375000
NODE_12410_length_790_cov_44.151954	696	776	24	12	80	0.1500000
NODE_12410_length_790_cov_44.151954	696	776	34	1	80	0.0125000
NODE_12410_length_790_cov_44.151954	696	776	38	14	80	0.1750000
NODE_12410_length_790_cov_44.151954	696	776	40	17	80	0.2125000
NODE_12410_length_790_cov_44.151954	696	776	42	7	80	0.0875000
NODE_12410_length_790_cov_44.151954	696	776	44	2	80	0.0250000
NODE_12410_length_790_cov_44.151954	696	776	46	6	80	0.0750000
NODE_12410_length_790_cov_44.151954	696	776	50	16	80	0.2000000
NODE_12411_length_790_cov_27.144718	291	371	0	80	80	1.0000000
NODE_12411_length_790_cov_27.144718	344	424	0	80	80	1.0000000
NODE_12412_length_790_cov_16.973951	232	312	0	80	80	1.0000000
NODE_12412_length_790_cov_16.973951	285	365	0	80	80	1.0000000
NODE_12413_length_790_cov_13.374819	204	284	0	53	80	0.6625000
NODE_12413_length_790_cov_13.374819	204	284	2	27	80	0.3375000
NODE_12413_length_790_cov_13.374819	257	337	0	80	80	1.0000000
NODE_12415_length_790_cov_10.613603	302	382	0	14	80	0.1750000
NODE_12415_length_790_cov_10.613603	302	382	2	66	80	0.8250000
NODE_12415_length_790_cov_10.613603	355	435	0	12	80	0.1500000
NODE_12415_length_790_cov_10.613603	355	435	2	68	80	0.8500000
NODE_12418_length_790_cov_5.493488	271	351	0	80	80	1.0000000
NODE_12418_length_790_cov_5.493488	324	404	0	80	80	1.0000000
NODE_12434_length_790_cov_1.463097	313	376	0	63	63	1.0000000
NODE_12452_length_789_cov_39.123188	226	306	0	80	80	1.0000000
NODE_12452_length_789_cov_39.123188	279	359	0	80	80	1.0000000
NODE_12453_length_789_cov_37.205797	423	503	0	80	80	1.0000000
NODE_12453_length_789_cov_37.205797	476	556	0	80	80	1.0000000
NODE_12454_length_789_cov_31.311594	223	303	0	62	80	0.7750000
NODE_12454_length_789_cov_31.311594	223	303	6	18	80	0.2250000
NODE_12454_length_789_cov_31.311594	276	356	0	9	80	0.1125000
NODE_12454_length_789_cov_31.311594	276	356	6	71	80	0.8875000
NODE_12455_length_789_cov_30.536232	306	386	0	19	80	0.2375000
NODE_12455_length_789_cov_30.536232	306	386	2	43	80	0.5375000
NODE_12455_length_789_cov_30.536232	306	386	4	18	80	0.2250000
NODE_12455_length_789_cov_30.536232	359	439	0	39	80	0.4875000
NODE_12455_length_789_cov_30.536232	359	439	2	23	80	0.2875000
NODE_12455_length_789_cov_30.536232	359	439	4	18	80	0.2250000
NODE_12456_length_789_cov_24.886957	343	423	0	80	80	1.0000000
NODE_12456_length_789_cov_24.886957	396	476	0	80	80	1.0000000
NODE_12457_length_789_cov_23.539130	357	437	0	56	80	0.7000000
NODE_12457_length_789_cov_23.539130	357	437	2	24	80	0.3000000
NODE_12457_length_789_cov_23.539130	410	490	0	3	80	0.0375000
NODE_12457_length_789_cov_23.539130	410	490	2	77	80	0.9625000
NODE_12458_length_789_cov_16.169565	392	472	2	33	80	0.4125000
NODE_12458_length_789_cov_16.169565	392	472	4	47	80	0.5875000
NODE_12458_length_789_cov_16.169565	445	525	0	40	80	0.5000000
NODE_12458_length_789_cov_16.169565	445	525	2	40	80	0.5000000
NODE_12459_length_789_cov_15.175362	242	322	0	80	80	1.0000000
NODE_12459_length_789_cov_15.175362	295	375	0	80	80	1.0000000
NODE_12459_length_789_cov_15.175362	371	451	0	6	80	0.0750000
NODE_12459_length_789_cov_15.175362	371	451	2	31	80	0.3875000
NODE_12459_length_789_cov_15.175362	371	451	4	43	80	0.5375000
NODE_12459_length_789_cov_15.175362	424	504	0	15	80	0.1875000
NODE_12459_length_789_cov_15.175362	424	504	2	22	80	0.2750000
NODE_12459_length_789_cov_15.175362	424	504	4	43	80	0.5375000
NODE_12460_length_789_cov_7.276812	306	386	0	41	80	0.5125000
NODE_12460_length_789_cov_7.276812	306	386	2	39	80	0.4875000
NODE_12460_length_789_cov_7.276812	359	439	0	4	80	0.0500000
NODE_12460_length_789_cov_7.276812	359	439	2	76	80	0.9500000
NODE_12482_length_788_cov_43.091437	335	415	0	42	80	0.5250000
NODE_12482_length_788_cov_43.091437	335	415	4	5	80	0.0625000
NODE_12482_length_788_cov_43.091437	335	415	6	33	80	0.4125000
NODE_12482_length_788_cov_43.091437	388	460	0	9	72	0.1250000
NODE_12482_length_788_cov_43.091437	388	460	2	6	72	0.0833333
NODE_12482_length_788_cov_43.091437	388	460	6	57	72	0.7916667
NODE_12483_length_788_cov_38.914369	345	425	4	80	80	1.0000000
NODE_12483_length_788_cov_38.914369	398	478	0	22	80	0.2750000
NODE_12483_length_788_cov_38.914369	398	478	4	58	80	0.7250000
NODE_12484_length_788_cov_36.148041	320	400	0	3	80	0.0375000
NODE_12484_length_788_cov_36.148041	320	400	2	34	80	0.4250000
NODE_12484_length_788_cov_36.148041	320	400	4	43	80	0.5375000
NODE_12484_length_788_cov_36.148041	373	453	0	13	80	0.1625000
NODE_12484_length_788_cov_36.148041	373	453	2	32	80	0.4000000
NODE_12484_length_788_cov_36.148041	373	453	4	35	80	0.4375000
NODE_12485_length_788_cov_35.460087	346	426	1	13	80	0.1625000
NODE_12485_length_788_cov_35.460087	346	426	3	3	80	0.0375000
NODE_12485_length_788_cov_35.460087	346	426	4	1	80	0.0125000
NODE_12485_length_788_cov_35.460087	346	426	7	4	80	0.0500000
NODE_12485_length_788_cov_35.460087	346	426	8	6	80	0.0750000
NODE_12485_length_788_cov_35.460087	346	426	11	1	80	0.0125000
NODE_12485_length_788_cov_35.460087	346	426	12	6	80	0.0750000
NODE_12485_length_788_cov_35.460087	346	426	16	46	80	0.5750000
NODE_12485_length_788_cov_35.460087	399	479	5	11	80	0.1375000
NODE_12485_length_788_cov_35.460087	399	479	9	2	80	0.0250000
NODE_12485_length_788_cov_35.460087	399	479	10	1	80	0.0125000
NODE_12485_length_788_cov_35.460087	399	479	14	4	80	0.0500000
NODE_12485_length_788_cov_35.460087	399	479	16	62	80	0.7750000
NODE_12486_length_788_cov_30.785196	278	358	2	36	80	0.4500000
NODE_12486_length_788_cov_30.785196	278	358	4	5	80	0.0625000
NODE_12486_length_788_cov_30.785196	278	358	6	39	80	0.4875000
NODE_12486_length_788_cov_30.785196	331	411	4	5	80	0.0625000
NODE_12486_length_788_cov_30.785196	331	411	6	42	80	0.5250000
NODE_12486_length_788_cov_30.785196	331	411	8	18	80	0.2250000
NODE_12486_length_788_cov_30.785196	331	411	10	15	80	0.1875000
NODE_12488_length_788_cov_20.867925	300	380	8	12	80	0.1500000
NODE_12488_length_788_cov_20.867925	300	380	10	68	80	0.8500000
NODE_12488_length_788_cov_20.867925	353	430	0	20	77	0.2597403
NODE_12488_length_788_cov_20.867925	353	430	2	23	77	0.2987013
NODE_12488_length_788_cov_20.867925	353	430	6	7	77	0.0909091
NODE_12488_length_788_cov_20.867925	353	430	10	27	77	0.3506494
NODE_12489_length_788_cov_20.821480	322	402	11	27	80	0.3375000
NODE_12489_length_788_cov_20.821480	322	402	12	41	80	0.5125000
NODE_12489_length_788_cov_20.821480	322	402	14	12	80	0.1500000
NODE_12489_length_788_cov_20.821480	375	455	0	13	80	0.1625000
NODE_12489_length_788_cov_20.821480	375	455	6	23	80	0.2875000
NODE_12489_length_788_cov_20.821480	375	455	11	44	80	0.5500000
NODE_12490_length_788_cov_15.570392	342	422	0	80	80	1.0000000
NODE_12490_length_788_cov_15.570392	395	475	0	80	80	1.0000000
NODE_12491_length_788_cov_12.235123	241	321	0	7	80	0.0875000
NODE_12491_length_788_cov_12.235123	241	321	4	21	80	0.2625000
NODE_12491_length_788_cov_12.235123	241	321	6	33	80	0.4125000
NODE_12491_length_788_cov_12.235123	241	321	8	19	80	0.2375000
NODE_12491_length_788_cov_12.235123	294	374	4	30	80	0.3750000
NODE_12491_length_788_cov_12.235123	294	374	6	8	80	0.1000000
NODE_12491_length_788_cov_12.235123	294	374	8	42	80	0.5250000
NODE_12492_length_788_cov_10.509434	405	480	0	75	75	1.0000000
NODE_12493_length_788_cov_9.737300	310	390	18	57	80	0.7125000
NODE_12493_length_788_cov_9.737300	310	390	20	23	80	0.2875000
NODE_12493_length_788_cov_9.737300	363	443	4	2	80	0.0250000
NODE_12493_length_788_cov_9.737300	363	443	6	2	80	0.0250000
NODE_12493_length_788_cov_9.737300	363	443	13	4	80	0.0500000
NODE_12493_length_788_cov_9.737300	363	443	15	3	80	0.0375000
NODE_12493_length_788_cov_9.737300	363	443	18	4	80	0.0500000
NODE_12493_length_788_cov_9.737300	363	443	20	51	80	0.6375000
NODE_12493_length_788_cov_9.737300	363	443	21	1	80	0.0125000
NODE_12493_length_788_cov_9.737300	363	443	22	13	80	0.1625000
NODE_12494_length_788_cov_8.872279	280	360	2	24	80	0.3000000
NODE_12494_length_788_cov_8.872279	280	360	4	56	80	0.7000000
NODE_12494_length_788_cov_8.872279	333	413	0	22	80	0.2750000
NODE_12494_length_788_cov_8.872279	333	413	2	17	80	0.2125000
NODE_12494_length_788_cov_8.872279	333	413	4	41	80	0.5125000
NODE_12516_length_787_cov_34.683140	274	335	0	61	61	1.0000000
NODE_12516_length_787_cov_34.683140	319	380	0	61	61	1.0000000
NODE_12517_length_787_cov_28.039244	252	329	0	77	77	1.0000000
NODE_12517_length_787_cov_28.039244	302	370	0	68	68	1.0000000
NODE_12518_length_787_cov_25.422965	351	431	2	80	80	1.0000000
NODE_12518_length_787_cov_25.422965	404	484	0	48	80	0.6000000
NODE_12518_length_787_cov_25.422965	404	484	2	32	80	0.4000000
NODE_12519_length_787_cov_24.857558	319	399	0	80	80	1.0000000
NODE_12519_length_787_cov_24.857558	372	452	0	80	80	1.0000000
NODE_12520_length_787_cov_21.357558	291	371	0	80	80	1.0000000
NODE_12520_length_787_cov_21.357558	344	424	0	80	80	1.0000000
NODE_12521_length_787_cov_17.360465	396	476	0	80	80	1.0000000
NODE_12521_length_787_cov_17.360465	449	529	0	80	80	1.0000000
NODE_12522_length_787_cov_14.677326	178	258	0	80	80	1.0000000
NODE_12522_length_787_cov_14.677326	231	311	0	80	80	1.0000000
NODE_12523_length_787_cov_12.959302	331	411	0	13	80	0.1625000
NODE_12523_length_787_cov_12.959302	331	411	2	67	80	0.8375000
NODE_12523_length_787_cov_12.959302	384	464	0	10	80	0.1250000
NODE_12523_length_787_cov_12.959302	384	464	2	70	80	0.8750000
NODE_12524_length_787_cov_12.748547	426	506	0	9	80	0.1125000
NODE_12524_length_787_cov_12.748547	426	506	1	10	80	0.1250000
NODE_12524_length_787_cov_12.748547	426	506	2	61	80	0.7625000
NODE_12524_length_787_cov_12.748547	479	559	0	62	80	0.7750000
NODE_12524_length_787_cov_12.748547	479	559	1	10	80	0.1250000
NODE_12524_length_787_cov_12.748547	479	559	2	8	80	0.1000000
NODE_12525_length_787_cov_12.369186	338	418	0	80	80	1.0000000
NODE_12525_length_787_cov_12.369186	391	471	0	80	80	1.0000000
NODE_12526_length_787_cov_9.213663	376	456	0	80	80	1.0000000
NODE_12527_length_787_cov_8.857558	344	424	0	21	80	0.2625000
NODE_12527_length_787_cov_8.857558	344	424	2	59	80	0.7375000
NODE_12527_length_787_cov_8.857558	397	477	2	38	80	0.4750000
NODE_12527_length_787_cov_8.857558	397	477	4	20	80	0.2500000
NODE_12527_length_787_cov_8.857558	397	477	6	22	80	0.2750000
NODE_12529_length_787_cov_8.186047	508	552	0	44	44	1.0000000
NODE_12541_length_787_cov_2.188953	505	552	0	47	47	1.0000000
NODE_12562_length_786_cov_36.441048	431	511	0	80	80	1.0000000
NODE_12562_length_786_cov_36.441048	484	564	0	80	80	1.0000000
NODE_12563_length_786_cov_23.771470	235	315	4	53	80	0.6625000
NODE_12563_length_786_cov_23.771470	235	315	8	27	80	0.3375000
NODE_12563_length_786_cov_23.771470	288	368	0	11	80	0.1375000
NODE_12563_length_786_cov_23.771470	288	368	4	17	80	0.2125000
NODE_12563_length_786_cov_23.771470	288	368	8	52	80	0.6500000
NODE_12564_length_786_cov_23.333333	361	436	8	52	75	0.6933333
NODE_12564_length_786_cov_23.333333	361	436	9	5	75	0.0666667
NODE_12564_length_786_cov_23.333333	361	436	10	10	75	0.1333333
NODE_12564_length_786_cov_23.333333	361	436	12	1	75	0.0133333
NODE_12564_length_786_cov_23.333333	361	436	14	1	75	0.0133333
NODE_12564_length_786_cov_23.333333	361	436	16	6	75	0.0800000
NODE_12564_length_786_cov_23.333333	362	436	8	51	74	0.6891892
NODE_12564_length_786_cov_23.333333	362	436	9	5	74	0.0675676
NODE_12564_length_786_cov_23.333333	362	436	10	10	74	0.1351351
NODE_12564_length_786_cov_23.333333	362	436	12	1	74	0.0135135
NODE_12564_length_786_cov_23.333333	362	436	14	1	74	0.0135135
NODE_12564_length_786_cov_23.333333	362	436	16	6	74	0.0810811
NODE_12564_length_786_cov_23.333333	375	436	8	38	61	0.6229508
NODE_12564_length_786_cov_23.333333	375	436	9	5	61	0.0819672
NODE_12564_length_786_cov_23.333333	375	436	10	10	61	0.1639344
NODE_12564_length_786_cov_23.333333	375	436	12	1	61	0.0163934
NODE_12564_length_786_cov_23.333333	375	436	14	1	61	0.0163934
NODE_12564_length_786_cov_23.333333	375	436	16	6	61	0.0983607
NODE_12564_length_786_cov_23.333333	414	489	8	6	75	0.0800000
NODE_12564_length_786_cov_23.333333	414	489	10	13	75	0.1733333
NODE_12564_length_786_cov_23.333333	414	489	11	41	75	0.5466667
NODE_12564_length_786_cov_23.333333	414	489	12	1	75	0.0133333
NODE_12564_length_786_cov_23.333333	414	489	13	7	75	0.0933333
NODE_12564_length_786_cov_23.333333	414	489	14	1	75	0.0133333
NODE_12564_length_786_cov_23.333333	414	489	16	6	75	0.0800000
NODE_12564_length_786_cov_23.333333	414	489	8	6	75	0.0800000
NODE_12564_length_786_cov_23.333333	414	489	10	13	75	0.1733333
NODE_12564_length_786_cov_23.333333	414	489	11	41	75	0.5466667
NODE_12564_length_786_cov_23.333333	414	489	12	1	75	0.0133333
NODE_12564_length_786_cov_23.333333	414	489	13	7	75	0.0933333
NODE_12564_length_786_cov_23.333333	414	489	14	1	75	0.0133333
NODE_12564_length_786_cov_23.333333	414	489	16	6	75	0.0800000
NODE_12564_length_786_cov_23.333333	414	489	8	6	75	0.0800000
NODE_12564_length_786_cov_23.333333	414	489	10	13	75	0.1733333
NODE_12564_length_786_cov_23.333333	414	489	11	41	75	0.5466667
NODE_12564_length_786_cov_23.333333	414	489	12	1	75	0.0133333
NODE_12564_length_786_cov_23.333333	414	489	13	7	75	0.0933333
NODE_12564_length_786_cov_23.333333	414	489	14	1	75	0.0133333
NODE_12564_length_786_cov_23.333333	414	489	16	6	75	0.0800000
NODE_12564_length_786_cov_23.333333	490	564	11	2	74	0.0270270
NODE_12564_length_786_cov_23.333333	490	564	12	2	74	0.0270270
NODE_12564_length_786_cov_23.333333	490	564	14	3	74	0.0405405
NODE_12564_length_786_cov_23.333333	490	564	15	40	74	0.5405405
NODE_12564_length_786_cov_23.333333	490	564	17	4	74	0.0540541
NODE_12564_length_786_cov_23.333333	490	564	21	23	74	0.3108108
NODE_12565_length_786_cov_19.279476	310	375	0	27	65	0.4153846
NODE_12565_length_786_cov_19.279476	310	375	2	38	65	0.5846154
NODE_12565_length_786_cov_19.279476	371	441	0	70	70	1.0000000
NODE_12565_length_786_cov_19.279476	371	451	0	80	80	1.0000000
NODE_12565_length_786_cov_19.279476	424	491	0	67	67	1.0000000
NODE_12566_length_786_cov_18.652111	251	331	0	52	80	0.6500000
NODE_12566_length_786_cov_18.652111	251	331	2	28	80	0.3500000
NODE_12566_length_786_cov_18.652111	304	384	2	80	80	1.0000000
NODE_12567_length_786_cov_16.704512	319	399	0	12	80	0.1500000
NODE_12567_length_786_cov_16.704512	319	399	2	1	80	0.0125000
NODE_12567_length_786_cov_16.704512	319	399	3	1	80	0.0125000
NODE_12567_length_786_cov_16.704512	319	399	4	1	80	0.0125000
NODE_12567_length_786_cov_16.704512	319	399	6	65	80	0.8125000
NODE_12567_length_786_cov_16.704512	372	452	0	65	80	0.8125000
NODE_12567_length_786_cov_16.704512	372	452	2	1	80	0.0125000
NODE_12567_length_786_cov_16.704512	372	452	3	1	80	0.0125000
NODE_12567_length_786_cov_16.704512	372	452	4	1	80	0.0125000
NODE_12567_length_786_cov_16.704512	372	452	6	12	80	0.1500000
NODE_12568_length_786_cov_16.254731	378	458	0	38	80	0.4750000
NODE_12568_length_786_cov_16.254731	378	458	1	1	80	0.0125000
NODE_12568_length_786_cov_16.254731	378	458	2	4	80	0.0500000
NODE_12568_length_786_cov_16.254731	378	458	4	17	80	0.2125000
NODE_12568_length_786_cov_16.254731	378	458	6	20	80	0.2500000
NODE_12568_length_786_cov_16.254731	431	511	0	80	80	1.0000000
NODE_12571_length_786_cov_10.053857	381	461	0	40	80	0.5000000
NODE_12571_length_786_cov_10.053857	381	461	2	6	80	0.0750000
NODE_12571_length_786_cov_10.053857	381	461	3	34	80	0.4250000
NODE_12571_length_786_cov_10.053857	434	514	3	29	80	0.3625000
NODE_12571_length_786_cov_10.053857	434	514	4	51	80	0.6375000
NODE_12572_length_786_cov_7.455604	400	473	2	13	73	0.1780822
NODE_12572_length_786_cov_7.455604	400	473	4	60	73	0.8219178
NODE_12572_length_786_cov_7.455604	453	533	0	58	80	0.7250000
NODE_12572_length_786_cov_7.455604	453	533	2	15	80	0.1875000
NODE_12572_length_786_cov_7.455604	453	533	4	7	80	0.0875000
NODE_12573_length_786_cov_7.119360	276	356	0	80	80	1.0000000
NODE_12573_length_786_cov_7.119360	329	409	0	80	80	1.0000000
NODE_12575_length_786_cov_6.771470	382	462	0	71	80	0.8875000
NODE_12575_length_786_cov_6.771470	382	462	2	9	80	0.1125000
NODE_12575_length_786_cov_6.771470	435	515	0	18	80	0.2250000
NODE_12575_length_786_cov_6.771470	435	515	2	62	80	0.7750000
NODE_12603_length_785_cov_83.972303	315	395	0	17	80	0.2125000
NODE_12603_length_785_cov_83.972303	315	395	2	63	80	0.7875000
NODE_12603_length_785_cov_83.972303	368	448	2	80	80	1.0000000
NODE_12604_length_785_cov_33.911079	477	557	0	13	80	0.1625000
NODE_12604_length_785_cov_33.911079	477	557	4	20	80	0.2500000
NODE_12604_length_785_cov_33.911079	477	557	6	47	80	0.5875000
NODE_12604_length_785_cov_33.911079	530	610	4	20	80	0.2500000
NODE_12604_length_785_cov_33.911079	530	610	6	60	80	0.7500000
NODE_12605_length_785_cov_21.174927	265	299	0	28	34	0.8235294
NODE_12605_length_785_cov_21.174927	265	299	2	6	34	0.1764706
NODE_12605_length_785_cov_21.174927	295	375	2	18	80	0.2250000
NODE_12605_length_785_cov_21.174927	295	375	4	2	80	0.0250000
NODE_12605_length_785_cov_21.174927	295	375	6	54	80	0.6750000
NODE_12605_length_785_cov_21.174927	295	375	10	6	80	0.0750000
NODE_12605_length_785_cov_21.174927	348	428	4	2	80	0.0250000
NODE_12605_length_785_cov_21.174927	348	428	6	29	80	0.3625000
NODE_12605_length_785_cov_21.174927	348	428	10	49	80	0.6125000
NODE_12606_length_785_cov_18.612245	291	371	2	80	80	1.0000000
NODE_12606_length_785_cov_18.612245	344	424	0	27	80	0.3375000
NODE_12606_length_785_cov_18.612245	344	424	2	53	80	0.6625000
NODE_12606_length_785_cov_18.612245	684	705	0	21	21	1.0000000
NODE_12607_length_785_cov_9.893586	153	233	0	80	80	1.0000000
NODE_12607_length_785_cov_9.893586	206	286	0	80	80	1.0000000
NODE_12645_length_784_cov_203.604380	5	85	10	1	80	0.0125000
NODE_12645_length_784_cov_203.604380	5	85	16	1	80	0.0125000
NODE_12645_length_784_cov_203.604380	5	85	17	2	80	0.0250000
NODE_12645_length_784_cov_203.604380	5	85	21	1	80	0.0125000
NODE_12645_length_784_cov_203.604380	5	85	23	1	80	0.0125000
NODE_12645_length_784_cov_203.604380	5	85	25	4	80	0.0500000
NODE_12645_length_784_cov_203.604380	5	85	28	1	80	0.0125000
NODE_12645_length_784_cov_203.604380	5	85	33	2	80	0.0250000
NODE_12645_length_784_cov_203.604380	5	85	35	1	80	0.0125000
NODE_12645_length_784_cov_203.604380	5	85	41	2	80	0.0250000
NODE_12645_length_784_cov_203.604380	5	85	45	3	80	0.0375000
NODE_12645_length_784_cov_203.604380	5	85	47	2	80	0.0250000
NODE_12645_length_784_cov_203.604380	5	85	49	2	80	0.0250000
NODE_12645_length_784_cov_203.604380	5	85	51	2	80	0.0250000
NODE_12645_length_784_cov_203.604380	5	85	55	5	80	0.0625000
NODE_12645_length_784_cov_203.604380	5	85	57	2	80	0.0250000
NODE_12645_length_784_cov_203.604380	5	85	59	3	80	0.0375000
NODE_12645_length_784_cov_203.604380	5	85	60	1	80	0.0125000
NODE_12645_length_784_cov_203.604380	5	85	62	5	80	0.0625000
NODE_12645_length_784_cov_203.604380	5	85	64	9	80	0.1125000
NODE_12645_length_784_cov_203.604380	5	85	68	2	80	0.0250000
NODE_12645_length_784_cov_203.604380	5	85	70	3	80	0.0375000
NODE_12645_length_784_cov_203.604380	5	85	71	1	80	0.0125000
NODE_12645_length_784_cov_203.604380	5	85	72	7	80	0.0875000
NODE_12645_length_784_cov_203.604380	5	85	75	5	80	0.0625000
NODE_12645_length_784_cov_203.604380	5	85	77	4	80	0.0500000
NODE_12645_length_784_cov_203.604380	5	85	79	8	80	0.1000000
NODE_12645_length_784_cov_203.604380	58	138	70	2	80	0.0250000
NODE_12645_length_784_cov_203.604380	58	138	71	1	80	0.0125000
NODE_12645_length_784_cov_203.604380	58	138	72	7	80	0.0875000
NODE_12645_length_784_cov_203.604380	58	138	75	5	80	0.0625000
NODE_12645_length_784_cov_203.604380	58	138	77	4	80	0.0500000
NODE_12645_length_784_cov_203.604380	58	138	79	9	80	0.1125000
NODE_12645_length_784_cov_203.604380	58	138	81	1	80	0.0125000
NODE_12645_length_784_cov_203.604380	58	138	83	4	80	0.0500000
NODE_12645_length_784_cov_203.604380	58	138	85	9	80	0.1125000
NODE_12645_length_784_cov_203.604380	58	138	86	2	80	0.0250000
NODE_12645_length_784_cov_203.604380	58	138	87	9	80	0.1125000
NODE_12645_length_784_cov_203.604380	58	138	88	1	80	0.0125000
NODE_12645_length_784_cov_203.604380	58	138	89	6	80	0.0750000
NODE_12645_length_784_cov_203.604380	58	138	90	4	80	0.0500000
NODE_12645_length_784_cov_203.604380	58	138	91	3	80	0.0375000
NODE_12645_length_784_cov_203.604380	58	138	93	4	80	0.0500000
NODE_12645_length_784_cov_203.604380	58	138	95	2	80	0.0250000
NODE_12645_length_784_cov_203.604380	58	138	97	7	80	0.0875000
NODE_12646_length_784_cov_45.210219	49	129	0	80	80	1.0000000
NODE_12646_length_784_cov_45.210219	102	182	0	80	80	1.0000000
NODE_12646_length_784_cov_45.210219	218	298	0	80	80	1.0000000
NODE_12646_length_784_cov_45.210219	271	351	0	80	80	1.0000000
NODE_12646_length_784_cov_45.210219	347	427	0	10	80	0.1250000
NODE_12646_length_784_cov_45.210219	347	427	2	16	80	0.2000000
NODE_12646_length_784_cov_45.210219	347	427	4	54	80	0.6750000
NODE_12646_length_784_cov_45.210219	347	427	0	10	80	0.1250000
NODE_12646_length_784_cov_45.210219	347	427	2	16	80	0.2000000
NODE_12646_length_784_cov_45.210219	347	427	4	54	80	0.6750000
NODE_12646_length_784_cov_45.210219	347	427	0	10	80	0.1250000
NODE_12646_length_784_cov_45.210219	347	427	2	16	80	0.2000000
NODE_12646_length_784_cov_45.210219	347	427	4	54	80	0.6750000
NODE_12646_length_784_cov_45.210219	400	447	4	47	47	1.0000000
NODE_12646_length_784_cov_45.210219	400	480	4	80	80	1.0000000
NODE_12646_length_784_cov_45.210219	400	455	4	55	55	1.0000000
NODE_12647_length_784_cov_33.543066	405	485	0	3	80	0.0375000
NODE_12647_length_784_cov_33.543066	405	485	2	38	80	0.4750000
NODE_12647_length_784_cov_33.543066	405	485	4	39	80	0.4875000
NODE_12647_length_784_cov_33.543066	458	538	0	7	80	0.0875000
NODE_12647_length_784_cov_33.543066	458	538	2	73	80	0.9125000
NODE_12648_length_784_cov_21.762044	318	398	0	80	80	1.0000000
NODE_12648_length_784_cov_21.762044	371	451	0	80	80	1.0000000
NODE_12649_length_784_cov_20.583942	286	366	0	15	80	0.1875000
NODE_12649_length_784_cov_20.583942	286	366	5	6	80	0.0750000
NODE_12649_length_784_cov_20.583942	286	366	8	2	80	0.0250000
NODE_12649_length_784_cov_20.583942	286	366	9	3	80	0.0375000
NODE_12649_length_784_cov_20.583942	286	366	10	54	80	0.6750000
NODE_12649_length_784_cov_20.583942	339	419	0	68	80	0.8500000
NODE_12649_length_784_cov_20.583942	339	419	5	6	80	0.0750000
NODE_12649_length_784_cov_20.583942	339	419	8	2	80	0.0250000
NODE_12649_length_784_cov_20.583942	339	419	9	3	80	0.0375000
NODE_12649_length_784_cov_20.583942	339	419	10	1	80	0.0125000
NODE_12649_length_784_cov_20.583942	415	495	0	80	80	1.0000000
NODE_12649_length_784_cov_20.583942	468	548	0	46	80	0.5750000
NODE_12649_length_784_cov_20.583942	468	548	2	34	80	0.4250000
NODE_12650_length_784_cov_19.448175	217	297	0	80	80	1.0000000
NODE_12650_length_784_cov_19.448175	270	350	0	80	80	1.0000000
NODE_12652_length_784_cov_12.480292	297	377	0	10	80	0.1250000
NODE_12652_length_784_cov_12.480292	297	377	2	14	80	0.1750000
NODE_12652_length_784_cov_12.480292	297	377	4	56	80	0.7000000
NODE_12652_length_784_cov_12.480292	350	430	0	63	80	0.7875000
NODE_12652_length_784_cov_12.480292	350	430	2	2	80	0.0250000
NODE_12652_length_784_cov_12.480292	350	430	4	15	80	0.1875000
NODE_12653_length_784_cov_9.296350	250	330	0	80	80	1.0000000
NODE_12653_length_784_cov_9.296350	303	383	0	80	80	1.0000000
NODE_12653_length_784_cov_9.296350	379	459	0	80	80	1.0000000
NODE_12653_length_784_cov_9.296350	432	512	0	80	80	1.0000000
NODE_12654_length_784_cov_6.316788	274	354	2	67	80	0.8375000
NODE_12654_length_784_cov_6.316788	274	354	4	13	80	0.1625000
NODE_12654_length_784_cov_6.316788	327	407	2	71	80	0.8875000
NODE_12654_length_784_cov_6.316788	327	407	4	9	80	0.1125000
NODE_12688_length_783_cov_41.849415	459	539	0	80	80	1.0000000
NODE_12688_length_783_cov_41.849415	512	592	0	80	80	1.0000000
NODE_12689_length_783_cov_39.881579	230	310	0	80	80	1.0000000
NODE_12689_length_783_cov_39.881579	283	363	0	80	80	1.0000000
NODE_12689_length_783_cov_39.881579	359	439	0	5	80	0.0625000
NODE_12689_length_783_cov_39.881579	359	439	2	75	80	0.9375000
NODE_12689_length_783_cov_39.881579	412	492	2	80	80	1.0000000
NODE_12690_length_783_cov_35.967836	229	309	0	45	80	0.5625000
NODE_12690_length_783_cov_35.967836	229	309	4	35	80	0.4375000
NODE_12690_length_783_cov_35.967836	282	362	4	80	80	1.0000000
NODE_12691_length_783_cov_28.203216	292	372	0	80	80	1.0000000
NODE_12691_length_783_cov_28.203216	345	425	0	80	80	1.0000000
NODE_12692_length_783_cov_16.695906	393	473	0	41	80	0.5125000
NODE_12692_length_783_cov_16.695906	393	473	2	39	80	0.4875000
NODE_12692_length_783_cov_16.695906	446	526	0	7	80	0.0875000
NODE_12692_length_783_cov_16.695906	446	526	2	73	80	0.9125000
NODE_12693_length_783_cov_15.656433	418	498	0	33	80	0.4125000
NODE_12693_length_783_cov_15.656433	418	498	2	26	80	0.3250000
NODE_12693_length_783_cov_15.656433	418	498	4	21	80	0.2625000
NODE_12693_length_783_cov_15.656433	471	551	2	6	80	0.0750000
NODE_12693_length_783_cov_15.656433	471	551	4	53	80	0.6625000
NODE_12693_length_783_cov_15.656433	471	551	6	21	80	0.2625000
NODE_12694_length_783_cov_14.904971	321	401	0	11	80	0.1375000
NODE_12694_length_783_cov_14.904971	321	401	2	66	80	0.8250000
NODE_12694_length_783_cov_14.904971	321	401	3	2	80	0.0250000
NODE_12694_length_783_cov_14.904971	321	401	4	1	80	0.0125000
NODE_12694_length_783_cov_14.904971	374	454	2	68	80	0.8500000
NODE_12694_length_783_cov_14.904971	374	454	3	11	80	0.1375000
NODE_12694_length_783_cov_14.904971	374	454	4	1	80	0.0125000
NODE_12728_length_782_cov_22.461201	347	427	2	4	80	0.0500000
NODE_12728_length_782_cov_22.461201	347	427	4	56	80	0.7000000
NODE_12728_length_782_cov_22.461201	347	427	6	20	80	0.2500000
NODE_12728_length_782_cov_22.461201	400	480	0	9	80	0.1125000
NODE_12728_length_782_cov_22.461201	400	480	2	11	80	0.1375000
NODE_12728_length_782_cov_22.461201	400	480	4	43	80	0.5375000
NODE_12728_length_782_cov_22.461201	400	480	6	17	80	0.2125000
NODE_12729_length_782_cov_19.163982	306	386	0	80	80	1.0000000
NODE_12729_length_782_cov_19.163982	382	462	0	80	80	1.0000000
NODE_12729_length_782_cov_19.163982	435	515	0	80	80	1.0000000
NODE_12730_length_782_cov_19.090776	295	375	0	55	80	0.6875000
NODE_12730_length_782_cov_19.090776	295	375	2	25	80	0.3125000
NODE_12730_length_782_cov_19.090776	348	428	0	2	80	0.0250000
NODE_12730_length_782_cov_19.090776	348	428	2	51	80	0.6375000
NODE_12730_length_782_cov_19.090776	348	428	4	27	80	0.3375000
NODE_12731_length_782_cov_13.509517	323	403	0	80	80	1.0000000
NODE_12731_length_782_cov_13.509517	376	456	0	80	80	1.0000000
NODE_12732_length_782_cov_11.364568	367	447	0	80	80	1.0000000
NODE_12732_length_782_cov_11.364568	420	500	0	80	80	1.0000000
NODE_12735_length_782_cov_7.976574	245	325	0	80	80	1.0000000
NODE_12735_length_782_cov_7.976574	298	378	0	80	80	1.0000000
NODE_12737_length_782_cov_5.500732	384	464	0	80	80	1.0000000
NODE_12737_length_782_cov_5.500732	437	517	0	80	80	1.0000000
NODE_12739_length_782_cov_4.434846	309	389	0	80	80	1.0000000
NODE_12739_length_782_cov_4.434846	362	442	0	80	80	1.0000000
NODE_12740_length_782_cov_3.352855	177	196	4	19	19	1.0000000
NODE_12741_length_782_cov_3.231332	160	240	0	80	80	1.0000000
NODE_12741_length_782_cov_3.231332	213	298	0	85	85	1.0000000
NODE_12765_length_781_cov_34.247801	174	254	0	80	80	1.0000000
NODE_12765_length_781_cov_34.247801	227	307	0	80	80	1.0000000
NODE_12766_length_781_cov_27.530792	490	570	2	8	80	0.1000000
NODE_12766_length_781_cov_27.530792	490	570	6	34	80	0.4250000
NODE_12766_length_781_cov_27.530792	490	570	10	3	80	0.0375000
NODE_12766_length_781_cov_27.530792	490	570	12	35	80	0.4375000
NODE_12766_length_781_cov_27.530792	543	623	2	13	80	0.1625000
NODE_12766_length_781_cov_27.530792	543	623	6	45	80	0.5625000
NODE_12766_length_781_cov_27.530792	543	623	12	22	80	0.2750000
NODE_12766_length_781_cov_27.530792	619	699	0	65	80	0.8125000
NODE_12766_length_781_cov_27.530792	619	699	2	15	80	0.1875000
NODE_12766_length_781_cov_27.530792	672	752	0	80	80	1.0000000
NODE_12767_length_781_cov_22.768328	427	507	0	10	80	0.1250000
NODE_12767_length_781_cov_22.768328	427	507	2	70	80	0.8750000
NODE_12767_length_781_cov_22.768328	480	560	0	8	80	0.1000000
NODE_12767_length_781_cov_22.768328	480	560	2	72	80	0.9000000
NODE_12768_length_781_cov_17.894428	411	491	0	80	80	1.0000000
NODE_12768_length_781_cov_17.894428	464	544	0	80	80	1.0000000
NODE_12769_length_781_cov_14.922287	486	565	0	28	79	0.3544304
NODE_12769_length_781_cov_14.922287	486	565	2	10	79	0.1265823
NODE_12769_length_781_cov_14.922287	486	565	4	41	79	0.5189874
NODE_12769_length_781_cov_14.922287	538	618	4	80	80	1.0000000
NODE_12770_length_781_cov_12.529326	318	398	0	2	80	0.0250000
NODE_12770_length_781_cov_12.529326	318	398	1	55	80	0.6875000
NODE_12770_length_781_cov_12.529326	318	398	2	23	80	0.2875000
NODE_12770_length_781_cov_12.529326	371	451	1	4	80	0.0500000
NODE_12770_length_781_cov_12.529326	371	451	2	76	80	0.9500000
NODE_12771_length_781_cov_10.303519	444	524	3	4	80	0.0500000
NODE_12771_length_781_cov_10.303519	444	524	4	23	80	0.2875000
NODE_12771_length_781_cov_10.303519	444	524	5	10	80	0.1250000
NODE_12771_length_781_cov_10.303519	444	524	6	15	80	0.1875000
NODE_12771_length_781_cov_10.303519	444	524	7	4	80	0.0500000
NODE_12771_length_781_cov_10.303519	444	524	8	24	80	0.3000000
NODE_12772_length_781_cov_9.851906	374	454	0	80	80	1.0000000
NODE_12772_length_781_cov_9.851906	427	507	0	80	80	1.0000000
NODE_12775_length_781_cov_8.557185	113	194	2	81	81	1.0000000
NODE_12775_length_781_cov_8.557185	166	239	0	20	73	0.2739726
NODE_12775_length_781_cov_8.557185	166	239	2	53	73	0.7260274
NODE_12778_length_781_cov_4.734604	30	110	4	48	80	0.6000000
NODE_12778_length_781_cov_4.734604	30	110	6	32	80	0.4000000
NODE_12778_length_781_cov_4.734604	83	163	0	11	80	0.1375000
NODE_12778_length_781_cov_4.734604	83	163	2	4	80	0.0500000
NODE_12778_length_781_cov_4.734604	83	163	6	65	80	0.8125000
NODE_12780_length_781_cov_4.077713	269	349	0	80	80	1.0000000
NODE_12780_length_781_cov_4.077713	322	402	0	80	80	1.0000000
NODE_12812_length_780_cov_37.693098	165	245	2	43	80	0.5375000
NODE_12812_length_780_cov_37.693098	165	245	4	12	80	0.1500000
NODE_12812_length_780_cov_37.693098	165	245	6	3	80	0.0375000
NODE_12812_length_780_cov_37.693098	165	245	10	18	80	0.2250000
NODE_12812_length_780_cov_37.693098	165	245	12	4	80	0.0500000
NODE_12812_length_780_cov_37.693098	218	298	4	2	80	0.0250000
NODE_12812_length_780_cov_37.693098	218	298	6	3	80	0.0375000
NODE_12812_length_780_cov_37.693098	218	298	10	71	80	0.8875000
NODE_12812_length_780_cov_37.693098	218	298	12	4	80	0.0500000
NODE_12813_length_780_cov_22.132159	407	487	0	12	80	0.1500000
NODE_12813_length_780_cov_22.132159	407	487	4	68	80	0.8500000
NODE_12813_length_780_cov_22.132159	460	540	0	23	80	0.2875000
NODE_12813_length_780_cov_22.132159	460	540	4	57	80	0.7125000
NODE_12814_length_780_cov_21.831131	299	379	2	25	80	0.3125000
NODE_12814_length_780_cov_21.831131	299	379	10	4	80	0.0500000
NODE_12814_length_780_cov_21.831131	299	379	16	3	80	0.0375000
NODE_12814_length_780_cov_21.831131	299	379	20	48	80	0.6000000
NODE_12814_length_780_cov_21.831131	352	432	0	8	80	0.1000000
NODE_12814_length_780_cov_21.831131	352	432	5	7	80	0.0875000
NODE_12814_length_780_cov_21.831131	352	432	13	13	80	0.1625000
NODE_12814_length_780_cov_21.831131	352	432	17	19	80	0.2375000
NODE_12814_length_780_cov_21.831131	352	432	18	3	80	0.0375000
NODE_12814_length_780_cov_21.831131	352	432	19	2	80	0.0250000
NODE_12814_length_780_cov_21.831131	352	432	20	28	80	0.3500000
NODE_12815_length_780_cov_16.722467	165	245	0	80	80	1.0000000
NODE_12815_length_780_cov_16.722467	218	298	0	80	80	1.0000000
NODE_12816_length_780_cov_13.189427	150	254	0	104	104	1.0000000
NODE_12816_length_780_cov_13.189427	227	307	0	48	80	0.6000000
NODE_12816_length_780_cov_13.189427	227	307	2	32	80	0.4000000
NODE_12817_length_780_cov_12.910426	276	356	0	54	80	0.6750000
NODE_12817_length_780_cov_12.910426	276	356	2	8	80	0.1000000
NODE_12817_length_780_cov_12.910426	276	356	8	18	80	0.2250000
NODE_12817_length_780_cov_12.910426	329	409	0	9	80	0.1125000
NODE_12817_length_780_cov_12.910426	329	409	8	71	80	0.8875000
NODE_12818_length_780_cov_8.455213	141	221	0	80	80	1.0000000
NODE_12818_length_780_cov_8.455213	194	274	0	62	80	0.7750000
NODE_12818_length_780_cov_8.455213	194	274	1	18	80	0.2250000
NODE_12848_length_779_cov_51.022059	8	43	2	8	35	0.2285714
NODE_12848_length_779_cov_51.022059	8	43	4	27	35	0.7714286
NODE_12848_length_779_cov_51.022059	53	96	4	43	43	1.0000000
NODE_12848_length_779_cov_51.022059	97	177	0	15	80	0.1875000
NODE_12848_length_779_cov_51.022059	97	177	2	10	80	0.1250000
NODE_12848_length_779_cov_51.022059	97	177	4	14	80	0.1750000
NODE_12848_length_779_cov_51.022059	97	177	6	41	80	0.5125000
NODE_12848_length_779_cov_51.022059	150	230	6	45	80	0.5625000
NODE_12848_length_779_cov_51.022059	150	230	8	35	80	0.4375000
NODE_12849_length_779_cov_23.682353	362	442	0	35	80	0.4375000
NODE_12849_length_779_cov_23.682353	362	442	2	45	80	0.5625000
NODE_12849_length_779_cov_23.682353	415	495	2	45	80	0.5625000
NODE_12849_length_779_cov_23.682353	415	495	4	35	80	0.4375000
NODE_12850_length_779_cov_15.994118	320	400	2	7	80	0.0875000
NODE_12850_length_779_cov_15.994118	320	400	6	1	80	0.0125000
NODE_12850_length_779_cov_15.994118	320	400	8	72	80	0.9000000
NODE_12850_length_779_cov_15.994118	373	453	4	29	80	0.3625000
NODE_12850_length_779_cov_15.994118	373	453	6	19	80	0.2375000
NODE_12850_length_779_cov_15.994118	373	453	8	32	80	0.4000000
NODE_12851_length_779_cov_14.386765	258	320	2	20	62	0.3225806
NODE_12851_length_779_cov_14.386765	258	320	7	1	62	0.0161290
NODE_12851_length_779_cov_14.386765	258	320	8	3	62	0.0483871
NODE_12851_length_779_cov_14.386765	258	320	17	4	62	0.0645161
NODE_12851_length_779_cov_14.386765	258	320	18	30	62	0.4838710
NODE_12851_length_779_cov_14.386765	258	320	19	4	62	0.0645161
NODE_12851_length_779_cov_14.386765	293	368	17	3	75	0.0400000
NODE_12851_length_779_cov_14.386765	293	368	18	44	75	0.5866666
NODE_12851_length_779_cov_14.386765	293	368	19	4	75	0.0533333
NODE_12851_length_779_cov_14.386765	293	368	22	24	75	0.3200000
NODE_12851_length_779_cov_14.386765	369	443	8	8	74	0.1081081
NODE_12851_length_779_cov_14.386765	369	443	12	22	74	0.2972973
NODE_12851_length_779_cov_14.386765	369	443	14	34	74	0.4594595
NODE_12851_length_779_cov_14.386765	369	443	16	3	74	0.0405405
NODE_12851_length_779_cov_14.386765	369	443	18	4	74	0.0540541
NODE_12851_length_779_cov_14.386765	369	443	22	3	74	0.0405405
NODE_12852_length_779_cov_11.861765	180	263	0	83	83	1.0000000
NODE_12852_length_779_cov_11.861765	236	316	0	35	80	0.4375000
NODE_12852_length_779_cov_11.861765	236	316	7	45	80	0.5625000
NODE_12852_length_779_cov_11.861765	312	392	7	24	80	0.3000000
NODE_12852_length_779_cov_11.861765	312	392	9	8	80	0.1000000
NODE_12852_length_779_cov_11.861765	312	392	11	26	80	0.3250000
NODE_12852_length_779_cov_11.861765	312	392	16	1	80	0.0125000
NODE_12852_length_779_cov_11.861765	312	392	17	21	80	0.2625000
NODE_12852_length_779_cov_11.861765	365	445	9	5	80	0.0625000
NODE_12852_length_779_cov_11.861765	365	445	10	25	80	0.3125000
NODE_12852_length_779_cov_11.861765	365	445	14	11	80	0.1375000
NODE_12852_length_779_cov_11.861765	365	445	16	1	80	0.0125000
NODE_12852_length_779_cov_11.861765	365	445	17	30	80	0.3750000
NODE_12852_length_779_cov_11.861765	365	445	19	8	80	0.1000000
NODE_12853_length_779_cov_11.735294	285	365	0	80	80	1.0000000
NODE_12853_length_779_cov_11.735294	338	418	0	80	80	1.0000000
NODE_12854_length_779_cov_7.211765	333	413	0	30	80	0.3750000
NODE_12854_length_779_cov_7.211765	333	413	2	50	80	0.6250000
NODE_12854_length_779_cov_7.211765	386	466	0	80	80	1.0000000
NODE_12857_length_779_cov_5.611765	271	351	0	80	80	1.0000000
NODE_12857_length_779_cov_5.611765	324	404	0	69	80	0.8625000
NODE_12857_length_779_cov_5.611765	324	404	4	11	80	0.1375000
NODE_12859_length_779_cov_4.695588	216	296	4	18	80	0.2250000
NODE_12859_length_779_cov_4.695588	216	296	6	24	80	0.3000000
NODE_12859_length_779_cov_4.695588	216	296	8	38	80	0.4750000
NODE_12859_length_779_cov_4.695588	269	349	0	7	80	0.0875000
NODE_12859_length_779_cov_4.695588	269	349	2	31	80	0.3875000
NODE_12859_length_779_cov_4.695588	269	349	4	12	80	0.1500000
NODE_12859_length_779_cov_4.695588	269	349	6	11	80	0.1375000
NODE_12859_length_779_cov_4.695588	269	349	8	19	80	0.2375000
NODE_12863_length_779_cov_2.329412	615	672	6	32	57	0.5614035
NODE_12863_length_779_cov_2.329412	615	672	8	25	57	0.4385965
NODE_12883_length_778_cov_21.615611	325	405	4	57	80	0.7125000
NODE_12883_length_778_cov_21.615611	325	405	6	15	80	0.1875000
NODE_12883_length_778_cov_21.615611	325	405	7	1	80	0.0125000
NODE_12883_length_778_cov_21.615611	325	405	8	7	80	0.0875000
NODE_12883_length_778_cov_21.615611	378	458	4	60	80	0.7500000
NODE_12883_length_778_cov_21.615611	378	458	6	12	80	0.1500000
NODE_12883_length_778_cov_21.615611	378	458	7	1	80	0.0125000
NODE_12883_length_778_cov_21.615611	378	458	8	7	80	0.0875000
NODE_12884_length_778_cov_19.549337	348	428	0	18	80	0.2250000
NODE_12884_length_778_cov_19.549337	348	428	6	62	80	0.7750000
NODE_12884_length_778_cov_19.549337	401	481	0	71	80	0.8875000
NODE_12884_length_778_cov_19.549337	401	481	6	9	80	0.1125000
NODE_12885_length_778_cov_15.403535	312	392	0	46	80	0.5750000
NODE_12885_length_778_cov_15.403535	312	392	2	34	80	0.4250000
NODE_12885_length_778_cov_15.403535	365	445	0	80	80	1.0000000
NODE_12886_length_778_cov_14.614138	101	181	0	80	80	1.0000000
NODE_12886_length_778_cov_14.614138	154	234	0	80	80	1.0000000
NODE_12887_length_778_cov_13.368189	256	336	0	4	80	0.0500000
NODE_12887_length_778_cov_13.368189	256	336	2	50	80	0.6250000
NODE_12887_length_778_cov_13.368189	256	336	4	26	80	0.3250000
NODE_12887_length_778_cov_13.368189	309	389	0	57	80	0.7125000
NODE_12887_length_778_cov_13.368189	309	389	2	23	80	0.2875000
NODE_12891_length_778_cov_6.307806	349	429	0	15	80	0.1875000
NODE_12891_length_778_cov_6.307806	349	429	2	65	80	0.8125000
NODE_12891_length_778_cov_6.307806	402	482	0	57	80	0.7125000
NODE_12891_length_778_cov_6.307806	402	482	2	23	80	0.2875000
NODE_12893_length_778_cov_5.985272	385	465	8	80	80	1.0000000
NODE_12893_length_778_cov_5.985272	438	518	0	22	80	0.2750000
NODE_12893_length_778_cov_5.985272	438	518	4	2	80	0.0250000
NODE_12893_length_778_cov_5.985272	438	518	6	1	80	0.0125000
NODE_12893_length_778_cov_5.985272	438	518	8	55	80	0.6875000
NODE_12928_length_777_cov_25.504425	323	403	2	17	80	0.2125000
NODE_12928_length_777_cov_25.504425	323	403	4	10	80	0.1250000
NODE_12928_length_777_cov_25.504425	323	403	7	1	80	0.0125000
NODE_12928_length_777_cov_25.504425	323	403	8	52	80	0.6500000
NODE_12928_length_777_cov_25.504425	376	456	0	11	80	0.1375000
NODE_12928_length_777_cov_25.504425	376	456	2	21	80	0.2625000
NODE_12928_length_777_cov_25.504425	376	456	6	17	80	0.2125000
NODE_12928_length_777_cov_25.504425	376	456	8	31	80	0.3875000
NODE_12929_length_777_cov_25.410029	346	426	0	13	80	0.1625000
NODE_12929_length_777_cov_25.410029	346	426	2	7	80	0.0875000
NODE_12929_length_777_cov_25.410029	346	426	4	7	80	0.0875000
NODE_12929_length_777_cov_25.410029	346	426	6	53	80	0.6625000
NODE_12929_length_777_cov_25.410029	399	479	0	29	80	0.3625000
NODE_12929_length_777_cov_25.410029	399	479	4	31	80	0.3875000
NODE_12929_length_777_cov_25.410029	399	479	6	20	80	0.2500000
NODE_12930_length_777_cov_25.333333	97	177	0	10	80	0.1250000
NODE_12930_length_777_cov_25.333333	97	177	4	14	80	0.1750000
NODE_12930_length_777_cov_25.333333	97	177	6	56	80	0.7000000
NODE_12930_length_777_cov_25.333333	150	230	0	31	80	0.3875000
NODE_12930_length_777_cov_25.333333	150	230	4	46	80	0.5750000
NODE_12930_length_777_cov_25.333333	150	230	6	3	80	0.0375000
NODE_12931_length_777_cov_21.600295	408	485	0	40	77	0.5194805
NODE_12931_length_777_cov_21.600295	408	485	2	21	77	0.2727273
NODE_12931_length_777_cov_21.600295	408	485	4	16	77	0.2077922
NODE_12931_length_777_cov_21.600295	458	538	2	11	80	0.1375000
NODE_12931_length_777_cov_21.600295	458	538	4	47	80	0.5875000
NODE_12931_length_777_cov_21.600295	458	538	5	1	80	0.0125000
NODE_12931_length_777_cov_21.600295	458	538	6	21	80	0.2625000
NODE_12932_length_777_cov_19.561947	343	423	4	80	80	1.0000000
NODE_12932_length_777_cov_19.561947	396	476	0	46	80	0.5750000
NODE_12932_length_777_cov_19.561947	396	476	4	34	80	0.4250000
NODE_12933_length_777_cov_16.961652	264	344	22	10	80	0.1250000
NODE_12933_length_777_cov_16.961652	264	344	23	24	80	0.3000000
NODE_12933_length_777_cov_16.961652	264	344	24	46	80	0.5750000
NODE_12933_length_777_cov_16.961652	317	397	1	14	80	0.1750000
NODE_12933_length_777_cov_16.961652	317	397	20	5	80	0.0625000
NODE_12933_length_777_cov_16.961652	317	397	21	7	80	0.0875000
NODE_12933_length_777_cov_16.961652	317	397	23	9	80	0.1125000
NODE_12933_length_777_cov_16.961652	317	397	24	45	80	0.5625000
NODE_12934_length_777_cov_16.081121	299	379	0	22	80	0.2750000
NODE_12934_length_777_cov_16.081121	299	379	4	58	80	0.7250000
NODE_12934_length_777_cov_16.081121	352	432	0	4	80	0.0500000
NODE_12934_length_777_cov_16.081121	352	432	2	4	80	0.0500000
NODE_12934_length_777_cov_16.081121	352	432	4	72	80	0.9000000
NODE_12935_length_777_cov_13.827434	380	460	0	29	80	0.3625000
NODE_12935_length_777_cov_13.827434	380	460	4	6	80	0.0750000
NODE_12935_length_777_cov_13.827434	380	460	6	45	80	0.5625000
NODE_12935_length_777_cov_13.827434	433	513	0	34	80	0.4250000
NODE_12935_length_777_cov_13.827434	433	513	2	5	80	0.0625000
NODE_12935_length_777_cov_13.827434	433	513	6	41	80	0.5125000
NODE_12936_length_777_cov_12.497050	413	493	0	80	80	1.0000000
NODE_12936_length_777_cov_12.497050	466	546	0	80	80	1.0000000
NODE_12937_length_777_cov_10.787611	213	286	0	27	73	0.3698630
NODE_12937_length_777_cov_10.787611	213	286	2	46	73	0.6301370
NODE_12938_length_777_cov_8.530973	362	422	0	6	60	0.1000000
NODE_12938_length_777_cov_8.530973	362	422	4	54	60	0.9000000
NODE_12939_length_777_cov_7.634218	79	159	0	80	80	1.0000000
NODE_12939_length_777_cov_7.634218	132	212	0	80	80	1.0000000
NODE_12940_length_777_cov_6.963127	256	336	0	80	80	1.0000000
NODE_12940_length_777_cov_6.963127	309	389	0	80	80	1.0000000
NODE_12941_length_777_cov_6.417404	565	638	0	73	73	1.0000000
NODE_12942_length_777_cov_5.868732	443	523	6	14	80	0.1750000
NODE_12942_length_777_cov_5.868732	443	523	10	12	80	0.1500000
NODE_12942_length_777_cov_5.868732	443	523	12	21	80	0.2625000
NODE_12942_length_777_cov_5.868732	443	523	16	33	80	0.4125000
NODE_12942_length_777_cov_5.868732	496	576	8	25	80	0.3125000
NODE_12942_length_777_cov_5.868732	496	576	10	37	80	0.4625000
NODE_12942_length_777_cov_5.868732	496	576	16	18	80	0.2250000
NODE_12971_length_776_cov_81.002954	237	317	0	66	80	0.8250000
NODE_12971_length_776_cov_81.002954	237	317	1	1	80	0.0125000
NODE_12971_length_776_cov_81.002954	237	317	4	1	80	0.0125000
NODE_12971_length_776_cov_81.002954	237	317	10	1	80	0.0125000
NODE_12971_length_776_cov_81.002954	237	317	21	1	80	0.0125000
NODE_12971_length_776_cov_81.002954	237	317	24	1	80	0.0125000
NODE_12971_length_776_cov_81.002954	237	317	32	1	80	0.0125000
NODE_12971_length_776_cov_81.002954	237	317	39	1	80	0.0125000
NODE_12971_length_776_cov_81.002954	237	317	45	1	80	0.0125000
NODE_12971_length_776_cov_81.002954	237	317	51	1	80	0.0125000
NODE_12971_length_776_cov_81.002954	237	317	53	1	80	0.0125000
NODE_12971_length_776_cov_81.002954	237	317	56	2	80	0.0250000
NODE_12971_length_776_cov_81.002954	237	317	66	1	80	0.0125000
NODE_12971_length_776_cov_81.002954	237	317	69	1	80	0.0125000
NODE_12971_length_776_cov_81.002954	290	370	0	80	80	1.0000000
NODE_12972_length_776_cov_40.502216	345	425	25	27	80	0.3375000
NODE_12972_length_776_cov_40.502216	345	425	27	18	80	0.2250000
NODE_12972_length_776_cov_40.502216	345	425	29	4	80	0.0500000
NODE_12972_length_776_cov_40.502216	345	425	31	31	80	0.3875000
NODE_12972_length_776_cov_40.502216	398	478	11	16	80	0.2000000
NODE_12972_length_776_cov_40.502216	398	478	18	1	80	0.0125000
NODE_12972_length_776_cov_40.502216	398	478	21	5	80	0.0625000
NODE_12972_length_776_cov_40.502216	398	478	25	58	80	0.7250000
NODE_12973_length_776_cov_34.921713	204	284	0	80	80	1.0000000
NODE_12973_length_776_cov_34.921713	257	337	0	80	80	1.0000000
NODE_12974_length_776_cov_29.998523	177	257	1	31	80	0.3875000
NODE_12974_length_776_cov_29.998523	177	257	2	49	80	0.6125000
NODE_12974_length_776_cov_29.998523	230	310	2	80	80	1.0000000
NODE_12975_length_776_cov_25.683900	417	497	0	39	80	0.4875000
NODE_12975_length_776_cov_25.683900	417	497	2	41	80	0.5125000
NODE_12975_length_776_cov_25.683900	470	550	2	44	80	0.5500000
NODE_12975_length_776_cov_25.683900	470	550	6	35	80	0.4375000
NODE_12975_length_776_cov_25.683900	470	550	8	1	80	0.0125000
NODE_12976_length_776_cov_22.276219	367	447	0	31	80	0.3875000
NODE_12976_length_776_cov_22.276219	367	447	4	7	80	0.0875000
NODE_12976_length_776_cov_22.276219	367	447	6	42	80	0.5250000
NODE_12976_length_776_cov_22.276219	420	500	0	22	80	0.2750000
NODE_12976_length_776_cov_22.276219	420	500	2	4	80	0.0500000
NODE_12976_length_776_cov_22.276219	420	500	6	54	80	0.6750000
NODE_12977_length_776_cov_19.574594	242	322	0	38	80	0.4750000
NODE_12977_length_776_cov_19.574594	242	322	2	27	80	0.3375000
NODE_12977_length_776_cov_19.574594	242	322	4	15	80	0.1875000
NODE_12977_length_776_cov_19.574594	295	375	2	12	80	0.1500000
NODE_12977_length_776_cov_19.574594	295	375	4	16	80	0.2000000
NODE_12977_length_776_cov_19.574594	295	375	6	52	80	0.6500000
NODE_12978_length_776_cov_18.262925	384	464	0	80	80	1.0000000
NODE_12978_length_776_cov_18.262925	437	517	0	80	80	1.0000000
NODE_12979_length_776_cov_16.023634	334	414	0	11	80	0.1375000
NODE_12979_length_776_cov_16.023634	334	414	2	69	80	0.8625000
NODE_12979_length_776_cov_16.023634	387	467	0	64	80	0.8000000
NODE_12979_length_776_cov_16.023634	387	467	2	16	80	0.2000000
NODE_12980_length_776_cov_15.841950	282	362	0	43	80	0.5375000
NODE_12980_length_776_cov_15.841950	282	362	1	1	80	0.0125000
NODE_12980_length_776_cov_15.841950	282	362	2	36	80	0.4500000
NODE_12980_length_776_cov_15.841950	335	415	0	35	80	0.4375000
NODE_12980_length_776_cov_15.841950	335	415	2	45	80	0.5625000
NODE_12981_length_776_cov_14.131462	240	320	0	80	80	1.0000000
NODE_12981_length_776_cov_14.131462	293	373	0	80	80	1.0000000
NODE_12981_length_776_cov_14.131462	369	449	0	37	80	0.4625000
NODE_12981_length_776_cov_14.131462	369	449	2	43	80	0.5375000
NODE_12981_length_776_cov_14.131462	422	502	0	20	80	0.2500000
NODE_12981_length_776_cov_14.131462	422	502	2	60	80	0.7500000
NODE_12983_length_776_cov_13.890694	302	382	0	12	80	0.1500000
NODE_12983_length_776_cov_13.890694	302	382	2	25	80	0.3125000
NODE_12983_length_776_cov_13.890694	302	382	4	43	80	0.5375000
NODE_12983_length_776_cov_13.890694	355	435	0	19	80	0.2375000
NODE_12983_length_776_cov_13.890694	355	435	2	27	80	0.3375000
NODE_12983_length_776_cov_13.890694	355	435	4	34	80	0.4250000
NODE_12984_length_776_cov_12.097489	488	568	4	4	80	0.0500000
NODE_12984_length_776_cov_12.097489	488	568	8	5	80	0.0625000
NODE_12984_length_776_cov_12.097489	488	568	10	16	80	0.2000000
NODE_12984_length_776_cov_12.097489	488	568	12	55	80	0.6875000
NODE_12984_length_776_cov_12.097489	541	621	0	10	80	0.1250000
NODE_12984_length_776_cov_12.097489	541	621	4	47	80	0.5875000
NODE_12984_length_776_cov_12.097489	541	621	8	2	80	0.0250000
NODE_12984_length_776_cov_12.097489	541	621	10	16	80	0.2000000
NODE_12984_length_776_cov_12.097489	541	621	12	5	80	0.0625000
NODE_12985_length_776_cov_11.923191	422	498	0	76	76	1.0000000
NODE_12985_length_776_cov_11.923191	475	551	0	76	76	1.0000000
NODE_12986_length_776_cov_11.163959	312	392	0	10	80	0.1250000
NODE_12986_length_776_cov_11.163959	312	392	2	19	80	0.2375000
NODE_12986_length_776_cov_11.163959	312	392	4	51	80	0.6375000
NODE_12986_length_776_cov_11.163959	365	445	2	17	80	0.2125000
NODE_12986_length_776_cov_11.163959	365	445	4	63	80	0.7875000
NODE_12987_length_776_cov_9.754801	370	450	10	80	80	1.0000000
NODE_12987_length_776_cov_9.754801	423	503	2	36	80	0.4500000
NODE_12987_length_776_cov_9.754801	423	503	10	39	80	0.4875000
NODE_12987_length_776_cov_9.754801	423	503	12	5	80	0.0625000
NODE_12989_length_776_cov_8.271787	332	412	0	80	80	1.0000000
NODE_12989_length_776_cov_8.271787	385	465	0	80	80	1.0000000
NODE_12990_length_776_cov_4.874446	330	410	0	80	80	1.0000000
NODE_12990_length_776_cov_4.874446	383	463	0	80	80	1.0000000
NODE_13022_length_775_cov_33.612426	372	452	4	16	80	0.2000000
NODE_13022_length_775_cov_33.612426	372	452	5	7	80	0.0875000
NODE_13022_length_775_cov_33.612426	372	452	6	3	80	0.0375000
NODE_13022_length_775_cov_33.612426	372	452	8	51	80	0.6375000
NODE_13022_length_775_cov_33.612426	372	452	9	3	80	0.0375000
NODE_13022_length_775_cov_33.612426	425	505	0	23	80	0.2875000
NODE_13022_length_775_cov_33.612426	425	505	4	46	80	0.5750000
NODE_13022_length_775_cov_33.612426	425	505	6	3	80	0.0375000
NODE_13022_length_775_cov_33.612426	425	505	8	8	80	0.1000000
NODE_13023_length_775_cov_25.500000	361	434	0	23	73	0.3150685
NODE_13023_length_775_cov_25.500000	361	434	2	50	73	0.6849315
NODE_13023_length_775_cov_25.500000	413	487	0	51	74	0.6891892
NODE_13023_length_775_cov_25.500000	413	487	2	23	74	0.3108108
NODE_13024_length_775_cov_24.128698	220	300	0	80	80	1.0000000
NODE_13024_length_775_cov_24.128698	273	353	0	80	80	1.0000000
NODE_13026_length_775_cov_16.165680	358	438	0	24	80	0.3000000
NODE_13026_length_775_cov_16.165680	358	438	4	56	80	0.7000000
NODE_13026_length_775_cov_16.165680	411	491	0	2	80	0.0250000
NODE_13026_length_775_cov_16.165680	411	491	4	78	80	0.9750000
NODE_13027_length_775_cov_8.522189	440	520	4	6	80	0.0750000
NODE_13027_length_775_cov_8.522189	440	520	6	22	80	0.2750000
NODE_13027_length_775_cov_8.522189	440	520	8	14	80	0.1750000
NODE_13027_length_775_cov_8.522189	440	520	10	38	80	0.4750000
NODE_13027_length_775_cov_8.522189	493	573	0	23	80	0.2875000
NODE_13027_length_775_cov_8.522189	493	573	2	1	80	0.0125000
NODE_13027_length_775_cov_8.522189	493	573	4	6	80	0.0750000
NODE_13027_length_775_cov_8.522189	493	573	8	13	80	0.1625000
NODE_13027_length_775_cov_8.522189	493	573	10	37	80	0.4625000
NODE_13028_length_775_cov_8.258876	247	327	0	80	80	1.0000000
NODE_13028_length_775_cov_8.258876	300	380	0	80	80	1.0000000
NODE_13031_length_775_cov_3.786982	299	379	6	80	80	1.0000000
NODE_13031_length_775_cov_3.786982	352	432	2	26	80	0.3250000
NODE_13031_length_775_cov_3.786982	352	432	4	14	80	0.1750000
NODE_13031_length_775_cov_3.786982	352	432	6	40	80	0.5000000
NODE_13059_length_774_cov_27.386667	433	514	0	81	81	1.0000000
NODE_13059_length_774_cov_27.386667	487	567	0	80	80	1.0000000
NODE_13060_length_774_cov_19.721481	239	319	0	20	80	0.2500000
NODE_13060_length_774_cov_19.721481	239	319	2	60	80	0.7500000
NODE_13060_length_774_cov_19.721481	292	372	0	14	80	0.1750000
NODE_13060_length_774_cov_19.721481	292	372	2	66	80	0.8250000
NODE_13063_length_774_cov_4.594074	216	294	0	25	78	0.3205128
NODE_13063_length_774_cov_4.594074	216	294	2	10	78	0.1282051
NODE_13063_length_774_cov_4.594074	216	294	4	43	78	0.5512820
NODE_13063_length_774_cov_4.594074	269	347	0	12	78	0.1538462
NODE_13063_length_774_cov_4.594074	269	347	2	18	78	0.2307692
NODE_13063_length_774_cov_4.594074	269	347	4	48	78	0.6153846
NODE_13063_length_774_cov_4.594074	405	485	0	80	80	1.0000000
NODE_13103_length_773_cov_60.566766	249	328	0	9	79	0.1139240
NODE_13103_length_773_cov_60.566766	249	328	2	25	79	0.3164557
NODE_13103_length_773_cov_60.566766	249	328	3	45	79	0.5696203
NODE_13103_length_773_cov_60.566766	304	381	2	14	77	0.1818182
NODE_13103_length_773_cov_60.566766	304	381	3	63	77	0.8181818
NODE_13104_length_773_cov_27.299703	230	310	0	80	80	1.0000000
NODE_13104_length_773_cov_27.299703	283	363	0	80	80	1.0000000
NODE_13105_length_773_cov_24.250742	392	470	6	7	78	0.0897436
NODE_13105_length_773_cov_24.250742	392	470	7	1	78	0.0128205
NODE_13105_length_773_cov_24.250742	392	470	8	70	78	0.8974359
NODE_13105_length_773_cov_24.250742	443	523	0	15	80	0.1875000
NODE_13105_length_773_cov_24.250742	443	523	2	17	80	0.2125000
NODE_13105_length_773_cov_24.250742	443	523	7	1	80	0.0125000
NODE_13105_length_773_cov_24.250742	443	523	8	47	80	0.5875000
NODE_13106_length_773_cov_20.683976	367	447	4	9	80	0.1125000
NODE_13106_length_773_cov_20.683976	367	447	8	37	80	0.4625000
NODE_13106_length_773_cov_20.683976	367	447	10	34	80	0.4250000
NODE_13106_length_773_cov_20.683976	420	500	0	13	80	0.1625000
NODE_13106_length_773_cov_20.683976	420	500	4	14	80	0.1750000
NODE_13106_length_773_cov_20.683976	420	500	6	15	80	0.1875000
NODE_13106_length_773_cov_20.683976	420	500	8	16	80	0.2000000
NODE_13106_length_773_cov_20.683976	420	500	10	22	80	0.2750000
NODE_13107_length_773_cov_18.498516	248	328	6	15	80	0.1875000
NODE_13107_length_773_cov_18.498516	248	328	7	10	80	0.1250000
NODE_13107_length_773_cov_18.498516	248	328	8	38	80	0.4750000
NODE_13107_length_773_cov_18.498516	248	328	10	17	80	0.2125000
NODE_13107_length_773_cov_18.498516	301	381	0	12	80	0.1500000
NODE_13107_length_773_cov_18.498516	301	381	4	36	80	0.4500000
NODE_13107_length_773_cov_18.498516	301	381	6	15	80	0.1875000
NODE_13107_length_773_cov_18.498516	301	381	7	10	80	0.1250000
NODE_13107_length_773_cov_18.498516	301	381	8	7	80	0.0875000
NODE_13108_length_773_cov_14.063798	405	485	0	80	80	1.0000000
NODE_13108_length_773_cov_14.063798	458	538	0	71	80	0.8875000
NODE_13108_length_773_cov_14.063798	458	538	2	1	80	0.0125000
NODE_13108_length_773_cov_14.063798	458	538	3	8	80	0.1000000
NODE_13109_length_773_cov_12.482196	421	501	0	80	80	1.0000000
NODE_13109_length_773_cov_12.482196	474	554	0	80	80	1.0000000
NODE_13114_length_773_cov_9.136499	214	294	4	11	80	0.1375000
NODE_13114_length_773_cov_9.136499	214	294	6	51	80	0.6375000
NODE_13114_length_773_cov_9.136499	214	294	8	18	80	0.2250000
NODE_13114_length_773_cov_9.136499	267	347	4	4	80	0.0500000
NODE_13114_length_773_cov_9.136499	267	347	6	59	80	0.7375000
NODE_13114_length_773_cov_9.136499	267	347	8	8	80	0.1000000
NODE_13114_length_773_cov_9.136499	267	347	10	9	80	0.1125000
NODE_13115_length_773_cov_8.609792	461	541	0	80	80	1.0000000
NODE_13115_length_773_cov_8.609792	514	594	0	80	80	1.0000000
NODE_13116_length_773_cov_7.224036	200	280	0	4	80	0.0500000
NODE_13116_length_773_cov_7.224036	200	280	4	76	80	0.9500000
NODE_13116_length_773_cov_7.224036	253	333	0	12	80	0.1500000
NODE_13116_length_773_cov_7.224036	253	333	4	68	80	0.8500000
NODE_13117_length_773_cov_6.910979	522	615	0	93	93	1.0000000
NODE_13117_length_773_cov_6.910979	588	668	0	80	80	1.0000000
NODE_13147_length_772_cov_28.044577	231	311	0	24	80	0.3000000
NODE_13147_length_772_cov_28.044577	231	311	2	7	80	0.0875000
NODE_13147_length_772_cov_28.044577	231	311	6	49	80	0.6125000
NODE_13147_length_772_cov_28.044577	284	364	2	14	80	0.1750000
NODE_13147_length_772_cov_28.044577	284	364	4	18	80	0.2250000
NODE_13147_length_772_cov_28.044577	284	364	6	42	80	0.5250000
NODE_13147_length_772_cov_28.044577	284	364	8	6	80	0.0750000
NODE_13149_length_772_cov_9.523031	288	368	0	80	80	1.0000000
NODE_13149_length_772_cov_9.523031	341	421	0	80	80	1.0000000
NODE_13150_length_772_cov_8.778603	133	213	0	34	80	0.4250000
NODE_13150_length_772_cov_8.778603	133	213	4	24	80	0.3000000
NODE_13150_length_772_cov_8.778603	133	213	6	22	80	0.2750000
NODE_13150_length_772_cov_8.778603	186	266	4	5	80	0.0625000
NODE_13150_length_772_cov_8.778603	186	266	6	75	80	0.9375000
NODE_13151_length_772_cov_7.921248	351	431	0	80	80	1.0000000
NODE_13151_length_772_cov_7.921248	404	480	0	76	76	1.0000000
NODE_13152_length_772_cov_7.059435	276	356	0	9	80	0.1125000
NODE_13152_length_772_cov_7.059435	276	356	2	71	80	0.8875000
NODE_13152_length_772_cov_7.059435	329	409	2	80	80	1.0000000
NODE_13153_length_772_cov_5.536404	269	299	0	30	30	1.0000000
NODE_13153_length_772_cov_5.536404	272	341	0	69	69	1.0000000
NODE_13156_length_772_cov_4.838039	430	510	2	80	80	1.0000000
NODE_13156_length_772_cov_4.838039	483	563	0	29	80	0.3625000
NODE_13156_length_772_cov_4.838039	483	563	2	51	80	0.6375000
NODE_13162_length_772_cov_3.041605	339	419	0	80	80	1.0000000
NODE_13162_length_772_cov_3.041605	392	472	0	32	80	0.4000000
NODE_13162_length_772_cov_3.041605	392	472	4	48	80	0.6000000
NODE_13195_length_771_cov_36.729167	223	304	0	81	81	1.0000000
NODE_13195_length_771_cov_36.729167	277	357	0	80	80	1.0000000
NODE_13195_length_771_cov_36.729167	353	434	0	81	81	1.0000000
NODE_13195_length_771_cov_36.729167	407	487	0	80	80	1.0000000
NODE_13196_length_771_cov_28.903274	337	417	0	80	80	1.0000000
NODE_13196_length_771_cov_28.903274	390	470	0	80	80	1.0000000
NODE_13197_length_771_cov_28.165179	453	533	0	80	80	1.0000000
NODE_13197_length_771_cov_28.165179	506	586	0	80	80	1.0000000
NODE_13198_length_771_cov_14.336310	259	339	0	80	80	1.0000000
NODE_13198_length_771_cov_14.336310	312	392	0	80	80	1.0000000
NODE_13199_length_771_cov_13.592262	428	508	0	80	80	1.0000000
NODE_13199_length_771_cov_13.592262	481	561	0	75	80	0.9375000
NODE_13199_length_771_cov_13.592262	481	561	2	5	80	0.0625000
NODE_13200_length_771_cov_12.226190	407	487	0	22	80	0.2750000
NODE_13200_length_771_cov_12.226190	407	487	2	58	80	0.7250000
NODE_13200_length_771_cov_12.226190	460	540	0	75	80	0.9375000
NODE_13200_length_771_cov_12.226190	460	540	2	5	80	0.0625000
NODE_13201_length_771_cov_11.188988	348	428	0	80	80	1.0000000
NODE_13201_length_771_cov_11.188988	401	481	0	80	80	1.0000000
NODE_13202_length_771_cov_10.525298	171	251	0	12	80	0.1500000
NODE_13202_length_771_cov_10.525298	171	251	2	68	80	0.8500000
NODE_13202_length_771_cov_10.525298	224	304	0	36	80	0.4500000
NODE_13202_length_771_cov_10.525298	224	304	2	44	80	0.5500000
NODE_13207_length_771_cov_3.357143	238	318	0	70	80	0.8750000
NODE_13207_length_771_cov_3.357143	238	318	2	10	80	0.1250000
NODE_13207_length_771_cov_3.357143	291	371	0	17	80	0.2125000
NODE_13207_length_771_cov_3.357143	291	371	2	63	80	0.7875000
NODE_13209_length_771_cov_3.129464	476	518	0	42	42	1.0000000
NODE_13238_length_770_cov_45.312966	212	292	0	9	80	0.1125000
NODE_13238_length_770_cov_45.312966	212	292	6	71	80	0.8875000
NODE_13238_length_770_cov_45.312966	265	345	0	16	80	0.2000000
NODE_13238_length_770_cov_45.312966	265	345	6	64	80	0.8000000
NODE_13239_length_770_cov_23.153502	348	428	0	47	80	0.5875000
NODE_13239_length_770_cov_23.153502	348	428	2	33	80	0.4125000
NODE_13239_length_770_cov_23.153502	401	481	2	63	80	0.7875000
NODE_13239_length_770_cov_23.153502	401	481	4	17	80	0.2125000
NODE_13240_length_770_cov_22.463487	340	420	0	80	80	1.0000000
NODE_13240_length_770_cov_22.463487	393	473	0	80	80	1.0000000
NODE_13241_length_770_cov_18.594635	335	416	0	81	81	1.0000000
NODE_13241_length_770_cov_18.594635	389	469	0	80	80	1.0000000
NODE_13242_length_770_cov_18.092399	292	372	5	44	80	0.5500000
NODE_13242_length_770_cov_18.092399	292	372	6	36	80	0.4500000
NODE_13242_length_770_cov_18.092399	345	425	0	11	80	0.1375000
NODE_13242_length_770_cov_18.092399	345	425	5	69	80	0.8625000
NODE_13243_length_770_cov_7.064083	294	374	0	80	80	1.0000000
NODE_13243_length_770_cov_7.064083	347	426	0	79	79	1.0000000
NODE_13246_length_770_cov_5.184799	341	421	0	80	80	1.0000000
NODE_13246_length_770_cov_5.184799	394	474	0	80	80	1.0000000
NODE_13250_length_770_cov_4.120715	325	405	0	13	80	0.1625000
NODE_13250_length_770_cov_4.120715	325	405	2	1	80	0.0125000
NODE_13250_length_770_cov_4.120715	325	405	4	66	80	0.8250000
NODE_13250_length_770_cov_4.120715	378	458	0	66	80	0.8250000
NODE_13250_length_770_cov_4.120715	378	458	2	1	80	0.0125000
NODE_13250_length_770_cov_4.120715	378	458	4	13	80	0.1625000
NODE_13272_length_769_cov_11.008955	355	435	6	80	80	1.0000000
NODE_13272_length_769_cov_11.008955	408	488	0	33	80	0.4125000
NODE_13272_length_769_cov_11.008955	408	488	2	8	80	0.1000000
NODE_13272_length_769_cov_11.008955	408	488	4	3	80	0.0375000
NODE_13272_length_769_cov_11.008955	408	488	6	36	80	0.4500000
NODE_13274_length_769_cov_9.077612	263	343	0	80	80	1.0000000
NODE_13274_length_769_cov_9.077612	316	396	0	80	80	1.0000000
NODE_13275_length_769_cov_7.034328	289	367	0	78	78	1.0000000
NODE_13275_length_769_cov_7.034328	340	420	0	80	80	1.0000000
NODE_13307_length_769_cov_1.262687	620	668	2	48	48	1.0000000
NODE_13316_length_768_cov_19.195815	266	346	0	80	80	1.0000000
NODE_13316_length_768_cov_19.195815	319	399	0	80	80	1.0000000
NODE_13316_length_768_cov_19.195815	395	475	0	32	80	0.4000000
NODE_13316_length_768_cov_19.195815	395	475	2	48	80	0.6000000
NODE_13316_length_768_cov_19.195815	448	528	0	34	80	0.4250000
NODE_13316_length_768_cov_19.195815	448	528	2	46	80	0.5750000
NODE_13317_length_768_cov_16.420030	246	326	0	68	80	0.8500000
NODE_13317_length_768_cov_16.420030	246	326	2	12	80	0.1500000
NODE_13317_length_768_cov_16.420030	299	379	0	80	80	1.0000000
NODE_13318_length_768_cov_14.508221	309	389	0	80	80	1.0000000
NODE_13318_length_768_cov_14.508221	362	442	0	80	80	1.0000000
NODE_13319_length_768_cov_11.635277	309	389	0	80	80	1.0000000
NODE_13319_length_768_cov_11.635277	362	442	0	80	80	1.0000000
NODE_13321_length_768_cov_9.064275	392	472	5	75	80	0.9375000
NODE_13321_length_768_cov_9.064275	392	472	6	5	80	0.0625000
NODE_13321_length_768_cov_9.064275	445	525	4	35	80	0.4375000
NODE_13321_length_768_cov_9.064275	445	525	5	22	80	0.2750000
NODE_13321_length_768_cov_9.064275	445	525	6	23	80	0.2875000
NODE_13324_length_768_cov_3.605381	512	592	0	80	80	1.0000000
NODE_13324_length_768_cov_3.605381	565	645	0	80	80	1.0000000
NODE_13354_length_767_cov_38.161677	28	108	6	1	80	0.0125000
NODE_13354_length_767_cov_38.161677	28	108	8	2	80	0.0250000
NODE_13354_length_767_cov_38.161677	28	108	14	3	80	0.0375000
NODE_13354_length_767_cov_38.161677	28	108	16	74	80	0.9250000
NODE_13354_length_767_cov_38.161677	254	334	0	67	80	0.8375000
NODE_13354_length_767_cov_38.161677	254	334	2	13	80	0.1625000
NODE_13354_length_767_cov_38.161677	307	387	0	14	80	0.1750000
NODE_13354_length_767_cov_38.161677	307	387	2	66	80	0.8250000
NODE_13355_length_767_cov_24.107784	279	359	0	80	80	1.0000000
NODE_13355_length_767_cov_24.107784	332	412	0	80	80	1.0000000
NODE_13356_length_767_cov_22.823353	286	366	0	26	80	0.3250000
NODE_13356_length_767_cov_22.823353	286	366	4	49	80	0.6125000
NODE_13356_length_767_cov_22.823353	286	366	6	5	80	0.0625000
NODE_13356_length_767_cov_22.823353	339	419	4	22	80	0.2750000
NODE_13356_length_767_cov_22.823353	339	419	6	24	80	0.3000000
NODE_13356_length_767_cov_22.823353	339	419	10	34	80	0.4250000
NODE_13357_length_767_cov_20.898204	312	392	0	80	80	1.0000000
NODE_13357_length_767_cov_20.898204	365	445	0	80	80	1.0000000
NODE_13358_length_767_cov_20.058383	357	439	0	82	82	1.0000000
NODE_13358_length_767_cov_20.058383	410	490	0	80	80	1.0000000
NODE_13359_length_767_cov_20.020958	191	271	2	80	80	1.0000000
NODE_13359_length_767_cov_20.020958	244	324	0	4	80	0.0500000
NODE_13359_length_767_cov_20.020958	244	324	2	76	80	0.9500000
NODE_13360_length_767_cov_18.687126	270	350	0	80	80	1.0000000
NODE_13360_length_767_cov_18.687126	323	403	0	80	80	1.0000000
NODE_13362_length_767_cov_13.323353	45	125	0	59	80	0.7375000
NODE_13362_length_767_cov_13.323353	45	125	2	8	80	0.1000000
NODE_13362_length_767_cov_13.323353	45	125	4	13	80	0.1625000
NODE_13362_length_767_cov_13.323353	98	178	0	6	80	0.0750000
NODE_13362_length_767_cov_13.323353	98	178	2	11	80	0.1375000
NODE_13362_length_767_cov_13.323353	98	178	4	63	80	0.7875000
NODE_13366_length_767_cov_8.787425	377	447	0	19	70	0.2714286
NODE_13366_length_767_cov_8.787425	377	447	2	51	70	0.7285714
NODE_13366_length_767_cov_8.787425	420	500	0	33	80	0.4125000
NODE_13366_length_767_cov_8.787425	420	500	2	47	80	0.5875000
NODE_13367_length_767_cov_7.206587	306	386	0	38	80	0.4750000
NODE_13367_length_767_cov_7.206587	306	386	2	42	80	0.5250000
NODE_13367_length_767_cov_7.206587	359	440	0	41	81	0.5061728
NODE_13367_length_767_cov_7.206587	359	440	2	40	81	0.4938272
NODE_13403_length_766_cov_59.388306	322	402	6	27	80	0.3375000
NODE_13403_length_766_cov_59.388306	322	402	9	14	80	0.1750000
NODE_13403_length_766_cov_59.388306	322	402	10	39	80	0.4875000
NODE_13403_length_766_cov_59.388306	375	455	0	26	80	0.3250000
NODE_13403_length_766_cov_59.388306	375	455	2	24	80	0.3000000
NODE_13403_length_766_cov_59.388306	375	455	6	30	80	0.3750000
NODE_13403_length_766_cov_59.388306	451	531	0	80	80	1.0000000
NODE_13403_length_766_cov_59.388306	504	584	0	80	80	1.0000000
NODE_13404_length_766_cov_23.361319	308	388	0	24	80	0.3000000
NODE_13404_length_766_cov_23.361319	308	388	2	56	80	0.7000000
NODE_13404_length_766_cov_23.361319	361	441	0	33	80	0.4125000
NODE_13404_length_766_cov_23.361319	361	441	2	47	80	0.5875000
NODE_13405_length_766_cov_22.751124	229	309	0	21	80	0.2625000
NODE_13405_length_766_cov_22.751124	229	309	2	59	80	0.7375000
NODE_13405_length_766_cov_22.751124	282	362	0	40	80	0.5000000
NODE_13405_length_766_cov_22.751124	282	362	2	40	80	0.5000000
NODE_13406_length_766_cov_20.011994	285	363	0	72	78	0.9230769
NODE_13406_length_766_cov_20.011994	285	363	2	6	78	0.0769231
NODE_13406_length_766_cov_20.011994	336	416	0	21	80	0.2625000
NODE_13406_length_766_cov_20.011994	336	416	2	14	80	0.1750000
NODE_13406_length_766_cov_20.011994	336	416	4	45	80	0.5625000
NODE_13407_length_766_cov_18.685157	288	368	0	69	80	0.8625000
NODE_13407_length_766_cov_18.685157	288	368	2	11	80	0.1375000
NODE_13407_length_766_cov_18.685157	341	421	0	16	80	0.2000000
NODE_13407_length_766_cov_18.685157	341	421	2	17	80	0.2125000
NODE_13407_length_766_cov_18.685157	341	421	4	47	80	0.5875000
NODE_13408_length_766_cov_13.131934	271	351	9	43	80	0.5375000
NODE_13408_length_766_cov_13.131934	271	351	10	15	80	0.1875000
NODE_13408_length_766_cov_13.131934	271	351	11	22	80	0.2750000
NODE_13408_length_766_cov_13.131934	324	404	0	45	80	0.5625000
NODE_13408_length_766_cov_13.131934	324	404	9	35	80	0.4375000
NODE_13410_length_766_cov_9.479760	274	354	2	80	80	1.0000000
NODE_13410_length_766_cov_9.479760	327	407	0	37	80	0.4625000
NODE_13410_length_766_cov_9.479760	327	407	2	43	80	0.5375000
NODE_13415_length_766_cov_4.500750	333	413	0	80	80	1.0000000
NODE_13415_length_766_cov_4.500750	369	404	0	35	35	1.0000000
NODE_13415_length_766_cov_4.500750	371	413	0	42	42	1.0000000
NODE_13415_length_766_cov_4.500750	397	466	0	57	69	0.8260869
NODE_13415_length_766_cov_4.500750	397	466	2	12	69	0.1739130
NODE_13447_length_765_cov_92.851351	16	96	4	2	80	0.0250000
NODE_13447_length_765_cov_92.851351	16	96	12	12	80	0.1500000
NODE_13447_length_765_cov_92.851351	16	96	14	6	80	0.0750000
NODE_13447_length_765_cov_92.851351	16	96	16	1	80	0.0125000
NODE_13447_length_765_cov_92.851351	16	96	18	4	80	0.0500000
NODE_13447_length_765_cov_92.851351	16	96	20	2	80	0.0250000
NODE_13447_length_765_cov_92.851351	16	96	22	8	80	0.1000000
NODE_13447_length_765_cov_92.851351	16	96	24	4	80	0.0500000
NODE_13447_length_765_cov_92.851351	16	96	30	6	80	0.0750000
NODE_13447_length_765_cov_92.851351	16	96	32	4	80	0.0500000
NODE_13447_length_765_cov_92.851351	16	96	34	2	80	0.0250000
NODE_13447_length_765_cov_92.851351	16	96	36	10	80	0.1250000
NODE_13447_length_765_cov_92.851351	16	96	38	19	80	0.2375000
NODE_13448_length_765_cov_36.345345	504	584	0	80	80	1.0000000
NODE_13448_length_765_cov_36.345345	557	637	0	80	80	1.0000000
NODE_13449_length_765_cov_27.334835	370	450	0	40	80	0.5000000
NODE_13449_length_765_cov_27.334835	370	450	2	40	80	0.5000000
NODE_13449_length_765_cov_27.334835	423	503	0	27	80	0.3375000
NODE_13449_length_765_cov_27.334835	423	503	2	53	80	0.6625000
NODE_13450_length_765_cov_23.355856	251	331	0	9	80	0.1125000
NODE_13450_length_765_cov_23.355856	251	331	2	6	80	0.0750000
NODE_13450_length_765_cov_23.355856	251	331	3	27	80	0.3375000
NODE_13450_length_765_cov_23.355856	251	331	4	38	80	0.4750000
NODE_13450_length_765_cov_23.355856	304	384	0	61	80	0.7625000
NODE_13450_length_765_cov_23.355856	304	384	2	3	80	0.0375000
NODE_13450_length_765_cov_23.355856	304	384	3	16	80	0.2000000
NODE_13450_length_765_cov_23.355856	380	460	0	3	80	0.0375000
NODE_13450_length_765_cov_23.355856	380	460	2	19	80	0.2375000
NODE_13450_length_765_cov_23.355856	380	460	4	7	80	0.0875000
NODE_13450_length_765_cov_23.355856	380	460	6	51	80	0.6375000
NODE_13450_length_765_cov_23.355856	433	506	0	27	73	0.3698630
NODE_13450_length_765_cov_23.355856	433	506	4	26	73	0.3561644
NODE_13450_length_765_cov_23.355856	433	506	6	20	73	0.2739726
NODE_13451_length_765_cov_23.322823	256	336	0	80	80	1.0000000
NODE_13451_length_765_cov_23.322823	309	389	0	80	80	1.0000000
NODE_13452_length_765_cov_21.741742	379	452	0	73	73	1.0000000
NODE_13452_length_765_cov_21.741742	425	505	0	80	80	1.0000000
NODE_13453_length_765_cov_14.253754	450	530	2	22	80	0.2750000
NODE_13453_length_765_cov_14.253754	450	530	4	8	80	0.1000000
NODE_13453_length_765_cov_14.253754	450	530	6	50	80	0.6250000
NODE_13453_length_765_cov_14.253754	503	583	0	14	80	0.1750000
NODE_13453_length_765_cov_14.253754	503	583	4	47	80	0.5875000
NODE_13453_length_765_cov_14.253754	503	583	6	19	80	0.2375000
NODE_13454_length_765_cov_13.627628	313	393	0	80	80	1.0000000
NODE_13454_length_765_cov_13.627628	366	446	0	80	80	1.0000000
NODE_13455_length_765_cov_5.561562	319	349	0	30	30	1.0000000
NODE_13458_length_765_cov_4.367868	433	513	4	8	80	0.1000000
NODE_13458_length_765_cov_4.367868	433	513	7	1	80	0.0125000
NODE_13458_length_765_cov_4.367868	433	513	8	71	80	0.8875000
NODE_13458_length_765_cov_4.367868	486	566	8	80	80	1.0000000
NODE_13483_length_764_cov_30.096241	436	516	0	14	80	0.1750000
NODE_13483_length_764_cov_30.096241	436	516	2	23	80	0.2875000
NODE_13483_length_764_cov_30.096241	436	516	4	43	80	0.5375000
NODE_13483_length_764_cov_30.096241	489	569	0	67	80	0.8375000
NODE_13483_length_764_cov_30.096241	489	569	2	6	80	0.0750000
NODE_13483_length_764_cov_30.096241	489	569	4	7	80	0.0875000
NODE_13484_length_764_cov_29.218045	304	384	0	41	80	0.5125000
NODE_13484_length_764_cov_29.218045	304	384	2	39	80	0.4875000
NODE_13484_length_764_cov_29.218045	357	437	2	46	80	0.5750000
NODE_13484_length_764_cov_29.218045	357	437	4	2	80	0.0250000
NODE_13484_length_764_cov_29.218045	357	437	6	32	80	0.4000000
NODE_13485_length_764_cov_25.951880	421	501	0	80	80	1.0000000
NODE_13485_length_764_cov_25.951880	474	554	0	80	80	1.0000000
NODE_13486_length_764_cov_23.590977	204	284	2	21	80	0.2625000
NODE_13486_length_764_cov_23.590977	204	284	4	28	80	0.3500000
NODE_13486_length_764_cov_23.590977	204	284	8	11	80	0.1375000
NODE_13486_length_764_cov_23.590977	204	284	12	2	80	0.0250000
NODE_13486_length_764_cov_23.590977	204	284	14	18	80	0.2250000
NODE_13486_length_764_cov_23.590977	257	337	8	7	80	0.0875000
NODE_13486_length_764_cov_23.590977	257	337	9	25	80	0.3125000
NODE_13486_length_764_cov_23.590977	257	337	10	8	80	0.1000000
NODE_13486_length_764_cov_23.590977	257	337	12	22	80	0.2750000
NODE_13486_length_764_cov_23.590977	257	337	14	18	80	0.2250000
NODE_13488_length_764_cov_6.804511	281	361	0	80	80	1.0000000
NODE_13488_length_764_cov_6.804511	334	414	0	80	80	1.0000000
NODE_13489_length_764_cov_6.700752	392	458	0	66	66	1.0000000
NODE_13508_length_764_cov_1.171429	475	537	0	62	62	1.0000000
NODE_13520_length_763_cov_28.807229	311	391	0	80	80	1.0000000
NODE_13520_length_763_cov_28.807229	364	444	0	80	80	1.0000000
NODE_13521_length_763_cov_25.299699	598	673	0	24	75	0.3200000
NODE_13521_length_763_cov_25.299699	598	673	2	51	75	0.6800000
NODE_13521_length_763_cov_25.299699	598	678	0	24	80	0.3000000
NODE_13521_length_763_cov_25.299699	598	678	2	56	80	0.7000000
NODE_13521_length_763_cov_25.299699	605	675	0	17	70	0.2428571
NODE_13521_length_763_cov_25.299699	605	675	2	53	70	0.7571428
NODE_13521_length_763_cov_25.299699	607	678	0	15	71	0.2112676
NODE_13521_length_763_cov_25.299699	607	678	2	56	71	0.7887324
NODE_13521_length_763_cov_25.299699	651	731	0	44	80	0.5500000
NODE_13521_length_763_cov_25.299699	651	731	2	36	80	0.4500000
NODE_13521_length_763_cov_25.299699	651	731	0	44	80	0.5500000
NODE_13521_length_763_cov_25.299699	651	731	2	36	80	0.4500000
NODE_13521_length_763_cov_25.299699	651	731	0	44	80	0.5500000
NODE_13521_length_763_cov_25.299699	651	731	2	36	80	0.4500000
NODE_13521_length_763_cov_25.299699	651	731	0	44	80	0.5500000
NODE_13521_length_763_cov_25.299699	651	731	2	36	80	0.4500000
NODE_13522_length_763_cov_12.887048	336	416	0	65	80	0.8125000
NODE_13522_length_763_cov_12.887048	336	416	2	15	80	0.1875000
NODE_13522_length_763_cov_12.887048	389	469	0	12	80	0.1500000
NODE_13522_length_763_cov_12.887048	389	469	2	68	80	0.8500000
NODE_13523_length_763_cov_11.599398	547	627	0	45	80	0.5625000
NODE_13523_length_763_cov_11.599398	547	627	2	35	80	0.4375000
NODE_13523_length_763_cov_11.599398	600	680	0	4	80	0.0500000
NODE_13523_length_763_cov_11.599398	600	680	2	76	80	0.9500000
NODE_13524_length_763_cov_9.378012	297	377	0	80	80	1.0000000
NODE_13524_length_763_cov_9.378012	350	430	0	80	80	1.0000000
NODE_13526_length_763_cov_7.246988	368	448	0	70	80	0.8750000
NODE_13526_length_763_cov_7.246988	368	448	2	10	80	0.1250000
NODE_13526_length_763_cov_7.246988	421	501	0	17	80	0.2125000
NODE_13526_length_763_cov_7.246988	421	501	2	63	80	0.7875000
NODE_13527_length_763_cov_6.414157	371	451	0	80	80	1.0000000
NODE_13527_length_763_cov_6.414157	424	504	0	80	80	1.0000000
NODE_13558_length_762_cov_21.236802	368	448	2	5	80	0.0625000
NODE_13558_length_762_cov_21.236802	368	448	4	51	80	0.6375000
NODE_13558_length_762_cov_21.236802	368	448	6	24	80	0.3000000
NODE_13558_length_762_cov_21.236802	421	501	0	7	80	0.0875000
NODE_13558_length_762_cov_21.236802	421	501	2	10	80	0.1250000
NODE_13558_length_762_cov_21.236802	421	501	4	51	80	0.6375000
NODE_13558_length_762_cov_21.236802	421	501	6	12	80	0.1500000
NODE_13559_length_762_cov_19.984917	327	407	4	29	80	0.3625000
NODE_13559_length_762_cov_19.984917	327	407	6	51	80	0.6375000
NODE_13559_length_762_cov_19.984917	380	460	0	30	80	0.3750000
NODE_13559_length_762_cov_19.984917	380	460	2	8	80	0.1000000
NODE_13559_length_762_cov_19.984917	380	460	4	42	80	0.5250000
NODE_13560_length_762_cov_15.975867	318	398	4	76	80	0.9500000
NODE_13560_length_762_cov_15.975867	318	398	6	4	80	0.0500000
NODE_13560_length_762_cov_15.975867	371	439	4	23	68	0.3382353
NODE_13560_length_762_cov_15.975867	371	439	6	29	68	0.4264706
NODE_13560_length_762_cov_15.975867	371	439	8	16	68	0.2352941
NODE_13561_length_762_cov_12.728507	381	461	3	12	80	0.1500000
NODE_13561_length_762_cov_12.728507	381	461	4	68	80	0.8500000
NODE_13561_length_762_cov_12.728507	434	514	0	38	80	0.4750000
NODE_13561_length_762_cov_12.728507	434	514	3	27	80	0.3375000
NODE_13561_length_762_cov_12.728507	434	514	4	15	80	0.1875000
NODE_13562_length_762_cov_10.078431	277	357	0	11	80	0.1375000
NODE_13562_length_762_cov_10.078431	277	357	2	69	80	0.8625000
NODE_13562_length_762_cov_10.078431	330	410	0	64	80	0.8000000
NODE_13562_length_762_cov_10.078431	330	410	2	16	80	0.2000000
NODE_13563_length_762_cov_9.705882	339	419	0	36	80	0.4500000
NODE_13563_length_762_cov_9.705882	339	419	6	44	80	0.5500000
NODE_13563_length_762_cov_9.705882	392	472	6	80	80	1.0000000
NODE_13564_length_762_cov_7.276018	316	395	0	79	79	1.0000000
NODE_13564_length_762_cov_7.276018	368	448	0	80	80	1.0000000
NODE_13565_length_762_cov_6.168929	222	302	0	8	80	0.1000000
NODE_13565_length_762_cov_6.168929	222	302	2	72	80	0.9000000
NODE_13565_length_762_cov_6.168929	275	355	0	20	80	0.2500000
NODE_13565_length_762_cov_6.168929	275	355	2	60	80	0.7500000
NODE_13613_length_761_cov_44.243202	531	582	2	51	51	1.0000000
NODE_13614_length_761_cov_38.809668	342	422	2	15	80	0.1875000
NODE_13614_length_761_cov_38.809668	342	422	4	55	80	0.6875000
NODE_13614_length_761_cov_38.809668	342	422	6	10	80	0.1250000
NODE_13614_length_761_cov_38.809668	395	475	0	22	80	0.2750000
NODE_13614_length_761_cov_38.809668	395	475	2	46	80	0.5750000
NODE_13614_length_761_cov_38.809668	395	475	4	12	80	0.1500000
NODE_13615_length_761_cov_38.694864	314	394	0	47	80	0.5875000
NODE_13615_length_761_cov_38.694864	314	394	2	1	80	0.0125000
NODE_13615_length_761_cov_38.694864	314	394	6	14	80	0.1750000
NODE_13615_length_761_cov_38.694864	314	394	8	18	80	0.2250000
NODE_13615_length_761_cov_38.694864	367	447	2	3	80	0.0375000
NODE_13615_length_761_cov_38.694864	367	447	6	24	80	0.3000000
NODE_13615_length_761_cov_38.694864	367	447	8	53	80	0.6625000
NODE_13616_length_761_cov_32.382175	432	512	0	5	80	0.0625000
NODE_13616_length_761_cov_32.382175	432	512	14	75	80	0.9375000
NODE_13616_length_761_cov_32.382175	485	565	0	26	80	0.3250000
NODE_13616_length_761_cov_32.382175	485	565	4	3	80	0.0375000
NODE_13616_length_761_cov_32.382175	485	565	13	1	80	0.0125000
NODE_13616_length_761_cov_32.382175	485	565	14	50	80	0.6250000
NODE_13617_length_761_cov_31.444109	323	403	0	80	80	1.0000000
NODE_13617_length_761_cov_31.444109	376	467	0	29	91	0.3186813
NODE_13617_length_761_cov_31.444109	376	467	2	62	91	0.6813187
NODE_13618_length_761_cov_14.004532	366	446	0	80	80	1.0000000
NODE_13618_length_761_cov_14.004532	419	499	0	80	80	1.0000000
NODE_13619_length_761_cov_13.287009	336	415	0	79	79	1.0000000
NODE_13619_length_761_cov_13.287009	388	468	0	80	80	1.0000000
NODE_13621_length_761_cov_9.654079	274	354	0	80	80	1.0000000
NODE_13621_length_761_cov_9.654079	327	407	0	80	80	1.0000000
NODE_13622_length_761_cov_7.306647	308	388	0	7	80	0.0875000
NODE_13622_length_761_cov_7.306647	308	388	2	73	80	0.9125000
NODE_13622_length_761_cov_7.306647	361	441	0	60	80	0.7500000
NODE_13622_length_761_cov_7.306647	361	441	2	20	80	0.2500000
NODE_13625_length_761_cov_4.314199	354	434	0	14	80	0.1750000
NODE_13625_length_761_cov_4.314199	354	434	2	66	80	0.8250000
NODE_13625_length_761_cov_4.314199	407	487	0	50	80	0.6250000
NODE_13625_length_761_cov_4.314199	407	487	2	30	80	0.3750000
NODE_13658_length_760_cov_48.290469	215	295	12	65	80	0.8125000
NODE_13658_length_760_cov_48.290469	215	295	14	15	80	0.1875000
NODE_13658_length_760_cov_48.290469	268	348	0	9	80	0.1125000
NODE_13658_length_760_cov_48.290469	268	348	2	13	80	0.1625000
NODE_13658_length_760_cov_48.290469	268	348	4	19	80	0.2375000
NODE_13658_length_760_cov_48.290469	268	348	12	24	80	0.3000000
NODE_13658_length_760_cov_48.290469	268	348	14	15	80	0.1875000
NODE_13658_length_760_cov_48.290469	344	424	0	27	80	0.3375000
NODE_13658_length_760_cov_48.290469	344	424	4	53	80	0.6625000
NODE_13658_length_760_cov_48.290469	397	477	0	25	80	0.3125000
NODE_13658_length_760_cov_48.290469	397	477	4	55	80	0.6875000
NODE_13659_length_760_cov_28.314675	384	464	4	1	80	0.0125000
NODE_13659_length_760_cov_28.314675	384	464	6	3	80	0.0375000
NODE_13659_length_760_cov_28.314675	384	464	16	61	80	0.7625000
NODE_13659_length_760_cov_28.314675	384	464	18	15	80	0.1875000
NODE_13659_length_760_cov_28.314675	437	517	0	2	80	0.0250000
NODE_13659_length_760_cov_28.314675	437	517	2	45	80	0.5625000
NODE_13659_length_760_cov_28.314675	437	517	4	7	80	0.0875000
NODE_13659_length_760_cov_28.314675	437	517	6	3	80	0.0375000
NODE_13659_length_760_cov_28.314675	437	517	16	8	80	0.1000000
NODE_13659_length_760_cov_28.314675	437	517	18	15	80	0.1875000
NODE_13660_length_760_cov_27.981846	432	512	2	3	80	0.0375000
NODE_13660_length_760_cov_27.981846	432	512	4	16	80	0.2000000
NODE_13660_length_760_cov_27.981846	432	512	7	30	80	0.3750000
NODE_13660_length_760_cov_27.981846	432	512	8	11	80	0.1375000
NODE_13660_length_760_cov_27.981846	432	512	9	20	80	0.2500000
NODE_13660_length_760_cov_27.981846	485	565	2	26	80	0.3250000
NODE_13660_length_760_cov_27.981846	485	565	6	6	80	0.0750000
NODE_13660_length_760_cov_27.981846	485	565	7	7	80	0.0875000
NODE_13660_length_760_cov_27.981846	485	565	8	7	80	0.0875000
NODE_13660_length_760_cov_27.981846	485	565	9	34	80	0.4250000
NODE_13661_length_760_cov_17.500756	372	452	0	80	80	1.0000000
NODE_13661_length_760_cov_17.500756	425	505	0	80	80	1.0000000
NODE_13662_length_760_cov_17.420575	183	263	0	80	80	1.0000000
NODE_13662_length_760_cov_17.420575	236	316	0	80	80	1.0000000
NODE_13663_length_760_cov_13.444781	357	437	2	80	80	1.0000000
NODE_13663_length_760_cov_13.444781	410	490	2	78	80	0.9750000
NODE_13663_length_760_cov_13.444781	410	490	4	2	80	0.0250000
NODE_13664_length_760_cov_13.196672	282	362	0	80	80	1.0000000
NODE_13664_length_760_cov_13.196672	335	415	0	29	80	0.3625000
NODE_13664_length_760_cov_13.196672	335	415	2	51	80	0.6375000
NODE_13665_length_760_cov_12.692890	295	375	0	80	80	1.0000000
NODE_13665_length_760_cov_12.692890	348	428	0	80	80	1.0000000
NODE_13671_length_760_cov_4.282905	388	468	0	42	80	0.5250000
NODE_13671_length_760_cov_4.282905	388	468	2	38	80	0.4750000
NODE_13671_length_760_cov_4.282905	441	521	2	53	80	0.6625000
NODE_13671_length_760_cov_4.282905	441	521	4	27	80	0.3375000
NODE_13671_length_760_cov_4.282905	517	597	0	3	80	0.0375000
NODE_13671_length_760_cov_4.282905	517	597	2	65	80	0.8125000
NODE_13671_length_760_cov_4.282905	517	597	4	12	80	0.1500000
NODE_13683_length_760_cov_1.990923	490	570	0	46	80	0.5750000
NODE_13683_length_760_cov_1.990923	490	570	2	34	80	0.4250000
NODE_13683_length_760_cov_1.990923	543	623	0	68	80	0.8500000
NODE_13683_length_760_cov_1.990923	543	623	1	4	80	0.0500000
NODE_13683_length_760_cov_1.990923	543	623	2	8	80	0.1000000
NODE_13709_length_759_cov_24.757576	376	456	2	32	80	0.4000000
NODE_13709_length_759_cov_24.757576	376	456	4	48	80	0.6000000
NODE_13709_length_759_cov_24.757576	429	509	0	53	80	0.6625000
NODE_13709_length_759_cov_24.757576	429	509	2	15	80	0.1875000
NODE_13709_length_759_cov_24.757576	429	509	4	12	80	0.1500000
NODE_13710_length_759_cov_14.356061	210	290	0	80	80	1.0000000
NODE_13710_length_759_cov_14.356061	263	343	0	80	80	1.0000000
NODE_13711_length_759_cov_10.956061	328	408	0	71	80	0.8875000
NODE_13711_length_759_cov_10.956061	328	408	2	9	80	0.1125000
NODE_13711_length_759_cov_10.956061	381	461	0	80	80	1.0000000
NODE_13712_length_759_cov_10.639394	330	410	4	53	80	0.6625000
NODE_13712_length_759_cov_10.639394	330	410	6	21	80	0.2625000
NODE_13712_length_759_cov_10.639394	330	410	8	6	80	0.0750000
NODE_13712_length_759_cov_10.639394	383	463	2	10	80	0.1250000
NODE_13712_length_759_cov_10.639394	383	463	4	45	80	0.5625000
NODE_13712_length_759_cov_10.639394	383	463	6	19	80	0.2375000
NODE_13712_length_759_cov_10.639394	383	463	8	6	80	0.0750000
NODE_13713_length_759_cov_9.192424	209	290	36	2	81	0.0246914
NODE_13713_length_759_cov_9.192424	209	290	38	2	81	0.0246914
NODE_13713_length_759_cov_9.192424	209	290	44	2	81	0.0246914
NODE_13713_length_759_cov_9.192424	209	290	46	2	81	0.0246914
NODE_13713_length_759_cov_9.192424	209	290	49	1	81	0.0123457
NODE_13713_length_759_cov_9.192424	209	290	51	1	81	0.0123457
NODE_13713_length_759_cov_9.192424	209	290	53	3	81	0.0370370
NODE_13713_length_759_cov_9.192424	209	290	54	3	81	0.0370370
NODE_13713_length_759_cov_9.192424	209	290	56	1	81	0.0123457
NODE_13713_length_759_cov_9.192424	209	290	58	1	81	0.0123457
NODE_13713_length_759_cov_9.192424	209	290	59	3	81	0.0370370
NODE_13713_length_759_cov_9.192424	209	290	61	1	81	0.0123457
NODE_13713_length_759_cov_9.192424	209	290	63	3	81	0.0370370
NODE_13713_length_759_cov_9.192424	209	290	65	1	81	0.0123457
NODE_13713_length_759_cov_9.192424	209	290	69	6	81	0.0740741
NODE_13713_length_759_cov_9.192424	209	290	70	10	81	0.1234568
NODE_13713_length_759_cov_9.192424	209	290	72	6	81	0.0740741
NODE_13713_length_759_cov_9.192424	209	290	74	1	81	0.0123457
NODE_13713_length_759_cov_9.192424	209	290	75	1	81	0.0123457
NODE_13713_length_759_cov_9.192424	209	290	76	13	81	0.1604938
NODE_13713_length_759_cov_9.192424	209	290	77	2	81	0.0246914
NODE_13713_length_759_cov_9.192424	209	290	78	12	81	0.1481481
NODE_13713_length_759_cov_9.192424	209	290	80	4	81	0.0493827
NODE_13713_length_759_cov_9.192424	262	310	24	2	48	0.0416667
NODE_13713_length_759_cov_9.192424	262	310	25	1	48	0.0208333
NODE_13713_length_759_cov_9.192424	262	310	27	1	48	0.0208333
NODE_13713_length_759_cov_9.192424	262	310	28	3	48	0.0625000
NODE_13713_length_759_cov_9.192424	262	310	29	2	48	0.0416667
NODE_13713_length_759_cov_9.192424	262	310	30	8	48	0.1666667
NODE_13713_length_759_cov_9.192424	262	310	35	1	48	0.0208333
NODE_13713_length_759_cov_9.192424	262	310	36	4	48	0.0833333
NODE_13713_length_759_cov_9.192424	262	310	38	2	48	0.0416667
NODE_13713_length_759_cov_9.192424	262	310	44	2	48	0.0416667
NODE_13713_length_759_cov_9.192424	262	310	46	2	48	0.0416667
NODE_13713_length_759_cov_9.192424	262	310	49	1	48	0.0208333
NODE_13713_length_759_cov_9.192424	262	310	51	1	48	0.0208333
NODE_13713_length_759_cov_9.192424	262	310	53	3	48	0.0625000
NODE_13713_length_759_cov_9.192424	262	310	54	3	48	0.0625000
NODE_13713_length_759_cov_9.192424	262	310	56	1	48	0.0208333
NODE_13713_length_759_cov_9.192424	262	310	58	1	48	0.0208333
NODE_13713_length_759_cov_9.192424	262	310	59	3	48	0.0625000
NODE_13713_length_759_cov_9.192424	262	310	61	1	48	0.0208333
NODE_13713_length_759_cov_9.192424	262	310	63	3	48	0.0625000
NODE_13713_length_759_cov_9.192424	262	310	65	1	48	0.0208333
NODE_13713_length_759_cov_9.192424	262	310	69	2	48	0.0416667
NODE_13714_length_759_cov_8.771212	292	372	2	6	80	0.0750000
NODE_13714_length_759_cov_8.771212	292	372	3	10	80	0.1250000
NODE_13714_length_759_cov_8.771212	292	372	4	42	80	0.5250000
NODE_13714_length_759_cov_8.771212	292	372	6	10	80	0.1250000
NODE_13714_length_759_cov_8.771212	292	372	8	12	80	0.1500000
NODE_13714_length_759_cov_8.771212	345	425	4	5	80	0.0625000
NODE_13714_length_759_cov_8.771212	345	425	6	30	80	0.3750000
NODE_13714_length_759_cov_8.771212	345	425	8	45	80	0.5625000
NODE_13715_length_759_cov_8.650000	324	404	0	25	80	0.3125000
NODE_13715_length_759_cov_8.650000	324	404	2	17	80	0.2125000
NODE_13715_length_759_cov_8.650000	324	404	4	38	80	0.4750000
NODE_13715_length_759_cov_8.650000	377	457	0	3	80	0.0375000
NODE_13715_length_759_cov_8.650000	377	457	4	77	80	0.9625000
NODE_13716_length_759_cov_8.268182	604	684	0	80	80	1.0000000
NODE_13716_length_759_cov_8.268182	657	737	0	80	80	1.0000000
NODE_13717_length_759_cov_6.833333	381	461	0	80	80	1.0000000
NODE_13717_length_759_cov_6.833333	434	515	0	81	81	1.0000000
NODE_13718_length_759_cov_6.407576	319	399	0	80	80	1.0000000
NODE_13718_length_759_cov_6.407576	372	452	0	80	80	1.0000000
NODE_13725_length_759_cov_3.400000	355	435	0	77	80	0.9625000
NODE_13725_length_759_cov_3.400000	355	435	2	3	80	0.0375000
NODE_13725_length_759_cov_3.400000	408	488	0	24	80	0.3000000
NODE_13725_length_759_cov_3.400000	408	488	2	56	80	0.7000000
NODE_13726_length_759_cov_3.346970	240	322	1	41	82	0.5000000
NODE_13726_length_759_cov_3.346970	240	322	2	41	82	0.5000000
NODE_13760_length_758_cov_38.414264	215	295	0	80	80	1.0000000
NODE_13760_length_758_cov_38.414264	268	348	0	80	80	1.0000000
NODE_13760_length_758_cov_38.414264	344	424	0	80	80	1.0000000
NODE_13760_length_758_cov_38.414264	397	477	0	80	80	1.0000000
NODE_13761_length_758_cov_36.722307	331	411	0	80	80	1.0000000
NODE_13761_length_758_cov_36.722307	384	464	0	80	80	1.0000000
NODE_13762_length_758_cov_29.910470	235	315	2	40	80	0.5000000
NODE_13762_length_758_cov_29.910470	235	315	4	40	80	0.5000000
NODE_13762_length_758_cov_29.910470	288	368	0	43	80	0.5375000
NODE_13762_length_758_cov_29.910470	288	368	2	30	80	0.3750000
NODE_13762_length_758_cov_29.910470	288	368	4	7	80	0.0875000
NODE_13763_length_758_cov_16.226100	386	466	0	72	80	0.9000000
NODE_13763_length_758_cov_16.226100	386	466	2	8	80	0.1000000
NODE_13763_length_758_cov_16.226100	439	519	0	19	80	0.2375000
NODE_13763_length_758_cov_16.226100	439	519	2	61	80	0.7625000
NODE_13764_length_758_cov_16.097117	311	391	2	80	80	1.0000000
NODE_13764_length_758_cov_16.097117	364	444	0	21	80	0.2625000
NODE_13764_length_758_cov_16.097117	364	444	2	59	80	0.7375000
NODE_13765_length_758_cov_15.525038	260	340	4	80	80	1.0000000
NODE_13765_length_758_cov_15.525038	313	393	2	21	80	0.2625000
NODE_13765_length_758_cov_15.525038	313	393	4	32	80	0.4000000
NODE_13765_length_758_cov_15.525038	313	393	6	27	80	0.3375000
NODE_13768_length_758_cov_9.153263	224	299	0	12	75	0.1600000
NODE_13768_length_758_cov_9.153263	224	299	2	63	75	0.8400000
NODE_13771_length_758_cov_4.241275	508	588	7	3	80	0.0375000
NODE_13771_length_758_cov_4.241275	508	588	8	6	80	0.0750000
NODE_13771_length_758_cov_4.241275	508	588	11	11	80	0.1375000
NODE_13771_length_758_cov_4.241275	508	588	15	35	80	0.4375000
NODE_13771_length_758_cov_4.241275	508	588	17	25	80	0.3125000
NODE_13772_length_758_cov_3.902883	346	426	0	35	80	0.4375000
NODE_13772_length_758_cov_3.902883	346	426	4	8	80	0.1000000
NODE_13772_length_758_cov_3.902883	346	426	6	37	80	0.4625000
NODE_13772_length_758_cov_3.902883	399	479	4	15	80	0.1875000
NODE_13772_length_758_cov_3.902883	399	479	6	65	80	0.8125000
NODE_13794_length_757_cov_49.057751	155	235	0	57	80	0.7125000
NODE_13794_length_757_cov_49.057751	155	235	2	23	80	0.2875000
NODE_13794_length_757_cov_49.057751	208	288	0	4	80	0.0500000
NODE_13794_length_757_cov_49.057751	208	288	2	76	80	0.9500000
NODE_13795_length_757_cov_29.954407	181	262	0	81	81	1.0000000
NODE_13795_length_757_cov_29.954407	235	315	0	80	80	1.0000000
NODE_13795_length_757_cov_29.954407	311	391	0	80	80	1.0000000
NODE_13795_length_757_cov_29.954407	364	444	0	80	80	1.0000000
NODE_13796_length_757_cov_25.565350	352	432	0	13	80	0.1625000
NODE_13796_length_757_cov_25.565350	352	432	2	67	80	0.8375000
NODE_13796_length_757_cov_25.565350	405	483	0	31	78	0.3974359
NODE_13796_length_757_cov_25.565350	405	483	2	47	78	0.6025641
NODE_13797_length_757_cov_18.338906	264	344	2	80	80	1.0000000
NODE_13797_length_757_cov_18.338906	317	397	0	43	80	0.5375000
NODE_13797_length_757_cov_18.338906	317	397	2	37	80	0.4625000
NODE_13798_length_757_cov_15.879939	58	138	0	80	80	1.0000000
NODE_13798_length_757_cov_15.879939	111	191	0	80	80	1.0000000
NODE_13800_length_757_cov_15.291793	314	394	0	3	80	0.0375000
NODE_13800_length_757_cov_15.291793	314	394	2	20	80	0.2500000
NODE_13800_length_757_cov_15.291793	314	394	4	57	80	0.7125000
NODE_13800_length_757_cov_15.291793	367	447	2	20	80	0.2500000
NODE_13800_length_757_cov_15.291793	367	447	4	60	80	0.7500000
NODE_13807_length_757_cov_3.182371	423	503	0	80	80	1.0000000
NODE_13807_length_757_cov_3.182371	476	556	0	80	80	1.0000000
NODE_13832_length_756_cov_26.441400	287	367	0	13	80	0.1625000
NODE_13832_length_756_cov_26.441400	287	367	2	27	80	0.3375000
NODE_13832_length_756_cov_26.441400	287	367	4	40	80	0.5000000
NODE_13832_length_756_cov_26.441400	340	420	2	23	80	0.2875000
NODE_13832_length_756_cov_26.441400	340	420	4	57	80	0.7125000
NODE_13834_length_756_cov_13.097412	154	234	0	80	80	1.0000000
NODE_13834_length_756_cov_13.097412	207	287	0	80	80	1.0000000
NODE_13835_length_756_cov_12.732116	377	457	14	80	80	1.0000000
NODE_13836_length_756_cov_9.254186	241	321	0	40	80	0.5000000
NODE_13836_length_756_cov_9.254186	241	321	2	40	80	0.5000000
NODE_13836_length_756_cov_9.254186	294	374	0	21	80	0.2625000
NODE_13836_length_756_cov_9.254186	294	374	2	59	80	0.7375000
NODE_13837_length_756_cov_8.304414	363	409	0	46	46	1.0000000
NODE_13838_length_756_cov_8.105023	271	351	0	4	80	0.0500000
NODE_13838_length_756_cov_8.105023	271	351	2	76	80	0.9500000
NODE_13838_length_756_cov_8.105023	324	404	0	57	80	0.7125000
NODE_13838_length_756_cov_8.105023	324	404	2	23	80	0.2875000
NODE_13840_length_756_cov_6.622527	431	511	0	80	80	1.0000000
NODE_13840_length_756_cov_6.622527	484	565	0	81	81	1.0000000
NODE_13888_length_755_cov_64.705793	303	383	0	80	80	1.0000000
NODE_13888_length_755_cov_64.705793	356	436	0	80	80	1.0000000
NODE_13889_length_755_cov_58.214939	425	505	2	68	80	0.8500000
NODE_13889_length_755_cov_58.214939	425	505	4	12	80	0.1500000
NODE_13889_length_755_cov_58.214939	425	505	2	68	80	0.8500000
NODE_13889_length_755_cov_58.214939	425	505	4	12	80	0.1500000
NODE_13889_length_755_cov_58.214939	478	556	0	28	78	0.3589744
NODE_13889_length_755_cov_58.214939	478	556	2	50	78	0.6410257
NODE_13889_length_755_cov_58.214939	478	556	0	28	78	0.3589744
NODE_13889_length_755_cov_58.214939	478	556	2	50	78	0.6410257
NODE_13890_length_755_cov_25.945122	237	317	2	20	80	0.2500000
NODE_13890_length_755_cov_25.945122	237	317	4	60	80	0.7500000
NODE_13890_length_755_cov_25.945122	290	370	0	21	80	0.2625000
NODE_13890_length_755_cov_25.945122	290	370	1	2	80	0.0250000
NODE_13890_length_755_cov_25.945122	290	370	2	19	80	0.2375000
NODE_13890_length_755_cov_25.945122	290	370	4	38	80	0.4750000
NODE_13891_length_755_cov_24.263720	334	414	0	39	80	0.4875000
NODE_13891_length_755_cov_24.263720	334	414	2	41	80	0.5125000
NODE_13891_length_755_cov_24.263720	387	467	0	14	80	0.1750000
NODE_13891_length_755_cov_24.263720	387	467	2	66	80	0.8250000
NODE_13892_length_755_cov_15.559451	306	386	0	80	80	1.0000000
NODE_13892_length_755_cov_15.559451	359	439	0	80	80	1.0000000
NODE_13894_length_755_cov_10.196646	332	412	0	80	80	1.0000000
NODE_13894_length_755_cov_10.196646	385	465	0	80	80	1.0000000
NODE_13895_length_755_cov_9.772866	210	290	0	17	80	0.2125000
NODE_13895_length_755_cov_9.772866	210	290	1	1	80	0.0125000
NODE_13895_length_755_cov_9.772866	210	290	2	13	80	0.1625000
NODE_13895_length_755_cov_9.772866	210	290	4	49	80	0.6125000
NODE_13895_length_755_cov_9.772866	263	343	0	2	80	0.0250000
NODE_13895_length_755_cov_9.772866	263	343	2	5	80	0.0625000
NODE_13895_length_755_cov_9.772866	263	343	4	73	80	0.9125000
NODE_13936_length_754_cov_87.432061	208	288	0	80	80	1.0000000
NODE_13936_length_754_cov_87.432061	261	341	0	80	80	1.0000000
NODE_13937_length_754_cov_16.549618	156	236	0	43	80	0.5375000
NODE_13937_length_754_cov_16.549618	156	236	2	23	80	0.2875000
NODE_13937_length_754_cov_16.549618	156	236	4	14	80	0.1750000
NODE_13937_length_754_cov_16.549618	209	289	0	2	80	0.0250000
NODE_13937_length_754_cov_16.549618	209	289	2	38	80	0.4750000
NODE_13937_length_754_cov_16.549618	209	289	4	40	80	0.5000000
NODE_13939_length_754_cov_9.068702	316	396	0	80	80	1.0000000
NODE_13939_length_754_cov_9.068702	369	449	0	80	80	1.0000000
NODE_13940_length_754_cov_5.925191	287	367	0	80	80	1.0000000
NODE_13940_length_754_cov_5.925191	340	420	0	80	80	1.0000000
NODE_13974_length_753_cov_10.434251	386	466	0	56	80	0.7000000
NODE_13974_length_753_cov_10.434251	386	466	2	24	80	0.3000000
NODE_13974_length_753_cov_10.434251	439	519	0	5	80	0.0625000
NODE_13974_length_753_cov_10.434251	439	519	2	75	80	0.9375000
NODE_13976_length_753_cov_7.056575	344	424	0	80	80	1.0000000
NODE_13976_length_753_cov_7.056575	397	477	0	80	80	1.0000000
NODE_13977_length_753_cov_4.597859	321	401	0	3	80	0.0375000
NODE_13977_length_753_cov_4.597859	321	401	2	77	80	0.9625000
NODE_13977_length_753_cov_4.597859	374	454	0	37	80	0.4625000
NODE_13977_length_753_cov_4.597859	374	454	2	43	80	0.5375000
NODE_14003_length_752_cov_66.281776	617	697	20	3	80	0.0375000
NODE_14003_length_752_cov_66.281776	617	697	22	3	80	0.0375000
NODE_14003_length_752_cov_66.281776	617	697	26	7	80	0.0875000
NODE_14003_length_752_cov_66.281776	617	697	28	7	80	0.0875000
NODE_14003_length_752_cov_66.281776	617	697	30	4	80	0.0500000
NODE_14003_length_752_cov_66.281776	617	697	34	9	80	0.1125000
NODE_14003_length_752_cov_66.281776	617	697	36	20	80	0.2500000
NODE_14003_length_752_cov_66.281776	617	697	38	20	80	0.2500000
NODE_14003_length_752_cov_66.281776	617	697	40	7	80	0.0875000
NODE_14003_length_752_cov_66.281776	670	751	0	20	81	0.2469136
NODE_14003_length_752_cov_66.281776	670	751	4	12	81	0.1481481
NODE_14003_length_752_cov_66.281776	670	751	10	1	81	0.0123457
NODE_14003_length_752_cov_66.281776	670	751	11	4	81	0.0493827
NODE_14003_length_752_cov_66.281776	670	751	12	12	81	0.1481481
NODE_14003_length_752_cov_66.281776	670	751	14	1	81	0.0123457
NODE_14003_length_752_cov_66.281776	670	751	16	3	81	0.0370370
NODE_14003_length_752_cov_66.281776	670	751	18	1	81	0.0123457
NODE_14003_length_752_cov_66.281776	670	751	20	3	81	0.0370370
NODE_14003_length_752_cov_66.281776	670	751	22	3	81	0.0370370
NODE_14003_length_752_cov_66.281776	670	751	26	7	81	0.0864198
NODE_14003_length_752_cov_66.281776	670	751	28	7	81	0.0864198
NODE_14003_length_752_cov_66.281776	670	751	30	4	81	0.0493827
NODE_14003_length_752_cov_66.281776	670	751	34	3	81	0.0370370
NODE_14004_length_752_cov_60.274119	193	273	0	7	80	0.0875000
NODE_14004_length_752_cov_60.274119	193	273	3	22	80	0.2750000
NODE_14004_length_752_cov_60.274119	193	273	4	51	80	0.6375000
NODE_14004_length_752_cov_60.274119	246	326	0	32	80	0.4000000
NODE_14004_length_752_cov_60.274119	246	326	3	43	80	0.5375000
NODE_14004_length_752_cov_60.274119	246	326	4	5	80	0.0625000
NODE_14005_length_752_cov_19.811639	299	379	0	80	80	1.0000000
NODE_14005_length_752_cov_19.811639	352	432	0	80	80	1.0000000
NODE_14006_length_752_cov_17.661562	118	198	0	26	80	0.3250000
NODE_14006_length_752_cov_17.661562	118	198	1	47	80	0.5875000
NODE_14006_length_752_cov_17.661562	118	198	3	7	80	0.0875000
NODE_14006_length_752_cov_17.661562	171	251	1	20	80	0.2500000
NODE_14006_length_752_cov_17.661562	171	251	3	60	80	0.7500000
NODE_14007_length_752_cov_13.275651	241	321	8	2	80	0.0250000
NODE_14007_length_752_cov_13.275651	241	321	10	7	80	0.0875000
NODE_14007_length_752_cov_13.275651	241	321	14	12	80	0.1500000
NODE_14007_length_752_cov_13.275651	241	321	16	4	80	0.0500000
NODE_14007_length_752_cov_13.275651	241	321	18	3	80	0.0375000
NODE_14007_length_752_cov_13.275651	241	321	20	31	80	0.3875000
NODE_14007_length_752_cov_13.275651	241	321	22	20	80	0.2500000
NODE_14007_length_752_cov_13.275651	241	321	24	1	80	0.0125000
NODE_14007_length_752_cov_13.275651	294	374	14	5	80	0.0625000
NODE_14007_length_752_cov_13.275651	294	374	16	14	80	0.1750000
NODE_14007_length_752_cov_13.275651	294	374	20	44	80	0.5500000
NODE_14007_length_752_cov_13.275651	294	374	22	16	80	0.2000000
NODE_14007_length_752_cov_13.275651	294	374	24	1	80	0.0125000
NODE_14008_length_752_cov_10.928025	313	393	0	47	80	0.5875000
NODE_14008_length_752_cov_10.928025	313	393	4	33	80	0.4125000
NODE_14011_length_752_cov_9.558959	249	329	0	42	80	0.5250000
NODE_14011_length_752_cov_9.558959	249	329	17	38	80	0.4750000
NODE_14011_length_752_cov_9.558959	302	382	14	12	80	0.1500000
NODE_14011_length_752_cov_9.558959	302	382	15	13	80	0.1625000
NODE_14011_length_752_cov_9.558959	302	382	16	3	80	0.0375000
NODE_14011_length_752_cov_9.558959	302	382	17	52	80	0.6500000
NODE_14014_length_752_cov_8.281776	237	317	0	37	80	0.4625000
NODE_14014_length_752_cov_8.281776	237	317	2	43	80	0.5375000
NODE_14014_length_752_cov_8.281776	290	370	0	80	80	1.0000000
NODE_14015_length_752_cov_8.082695	352	432	0	80	80	1.0000000
NODE_14015_length_752_cov_8.082695	405	485	0	80	80	1.0000000
NODE_14044_length_751_cov_20.730061	238	318	0	30	80	0.3750000
NODE_14044_length_751_cov_20.730061	238	318	4	28	80	0.3500000
NODE_14044_length_751_cov_20.730061	238	318	6	22	80	0.2750000
NODE_14044_length_751_cov_20.730061	291	371	4	5	80	0.0625000
NODE_14044_length_751_cov_20.730061	291	371	6	75	80	0.9375000
NODE_14045_length_751_cov_18.478528	328	409	2	81	81	1.0000000
NODE_14045_length_751_cov_18.478528	382	462	0	28	80	0.3500000
NODE_14045_length_751_cov_18.478528	382	462	2	52	80	0.6500000
NODE_14046_length_751_cov_13.016871	172	252	0	80	80	1.0000000
NODE_14046_length_751_cov_13.016871	225	305	0	80	80	1.0000000
NODE_14047_length_751_cov_12.363497	397	477	0	80	80	1.0000000
NODE_14047_length_751_cov_12.363497	450	530	0	80	80	1.0000000
NODE_14085_length_750_cov_46.371736	396	476	0	21	80	0.2625000
NODE_14085_length_750_cov_46.371736	396	476	4	59	80	0.7375000
NODE_14085_length_750_cov_46.371736	449	529	0	60	80	0.7500000
NODE_14085_length_750_cov_46.371736	449	529	4	20	80	0.2500000
NODE_14086_length_750_cov_24.428571	524	604	49	1	80	0.0125000
NODE_14086_length_750_cov_24.428571	524	604	53	2	80	0.0250000
NODE_14086_length_750_cov_24.428571	524	604	67	1	80	0.0125000
NODE_14086_length_750_cov_24.428571	524	604	69	1	80	0.0125000
NODE_14086_length_750_cov_24.428571	524	604	73	1	80	0.0125000
NODE_14086_length_750_cov_24.428571	524	604	86	3	80	0.0375000
NODE_14086_length_750_cov_24.428571	524	604	88	1	80	0.0125000
NODE_14086_length_750_cov_24.428571	524	604	90	10	80	0.1250000
NODE_14086_length_750_cov_24.428571	524	604	95	2	80	0.0250000
NODE_14086_length_750_cov_24.428571	524	604	99	7	80	0.0875000
NODE_14086_length_750_cov_24.428571	524	604	101	6	80	0.0750000
NODE_14086_length_750_cov_24.428571	524	604	103	4	80	0.0500000
NODE_14086_length_750_cov_24.428571	524	604	104	1	80	0.0125000
NODE_14086_length_750_cov_24.428571	524	604	106	11	80	0.1375000
NODE_14086_length_750_cov_24.428571	524	604	107	5	80	0.0625000
NODE_14086_length_750_cov_24.428571	524	604	108	8	80	0.1000000
NODE_14086_length_750_cov_24.428571	524	604	110	7	80	0.0875000
NODE_14086_length_750_cov_24.428571	524	604	111	9	80	0.1125000
NODE_14086_length_750_cov_24.428571	683	746	0	63	63	1.0000000
NODE_14087_length_750_cov_24.311828	325	405	4	26	80	0.3250000
NODE_14087_length_750_cov_24.311828	325	405	6	18	80	0.2250000
NODE_14087_length_750_cov_24.311828	325	405	8	36	80	0.4500000
NODE_14087_length_750_cov_24.311828	378	458	0	38	80	0.4750000
NODE_14087_length_750_cov_24.311828	378	458	4	34	80	0.4250000
NODE_14087_length_750_cov_24.311828	378	458	6	8	80	0.1000000
NODE_14089_length_750_cov_8.529954	336	416	0	34	80	0.4250000
NODE_14089_length_750_cov_8.529954	336	416	6	21	80	0.2625000
NODE_14089_length_750_cov_8.529954	336	416	8	25	80	0.3125000
NODE_14089_length_750_cov_8.529954	395	469	0	74	74	1.0000000
NODE_14137_length_749_cov_18.986154	221	301	0	80	80	1.0000000
NODE_14137_length_749_cov_18.986154	274	354	0	80	80	1.0000000
NODE_14138_length_749_cov_18.836923	273	355	0	82	82	1.0000000
NODE_14138_length_749_cov_18.836923	328	408	0	80	80	1.0000000
NODE_14138_length_749_cov_18.836923	404	484	0	53	80	0.6625000
NODE_14138_length_749_cov_18.836923	404	484	4	27	80	0.3375000
NODE_14138_length_749_cov_18.836923	457	535	4	78	78	1.0000000
NODE_14139_length_749_cov_16.160000	232	253	0	21	21	1.0000000
NODE_14139_length_749_cov_16.160000	232	306	0	74	74	1.0000000
NODE_14140_length_749_cov_16.115385	307	387	2	24	80	0.3000000
NODE_14140_length_749_cov_16.115385	307	387	4	3	80	0.0375000
NODE_14140_length_749_cov_16.115385	307	387	7	1	80	0.0125000
NODE_14140_length_749_cov_16.115385	307	387	8	10	80	0.1250000
NODE_14140_length_749_cov_16.115385	307	387	9	25	80	0.3125000
NODE_14140_length_749_cov_16.115385	307	387	11	17	80	0.2125000
NODE_14140_length_749_cov_16.115385	360	440	0	14	80	0.1750000
NODE_14140_length_749_cov_16.115385	360	440	2	63	80	0.7875000
NODE_14140_length_749_cov_16.115385	360	440	4	3	80	0.0375000
NODE_14141_length_749_cov_11.210769	340	420	0	80	80	1.0000000
NODE_14141_length_749_cov_11.210769	393	473	0	80	80	1.0000000
NODE_14142_length_749_cov_8.424615	372	452	0	80	80	1.0000000
NODE_14142_length_749_cov_8.424615	425	505	0	80	80	1.0000000
NODE_14145_length_749_cov_4.521538	550	630	0	80	80	1.0000000
NODE_14145_length_749_cov_4.521538	603	683	0	80	80	1.0000000
NODE_14185_length_748_cov_55.348228	393	473	0	27	80	0.3375000
NODE_14185_length_748_cov_55.348228	393	473	5	26	80	0.3250000
NODE_14185_length_748_cov_55.348228	393	473	6	27	80	0.3375000
NODE_14185_length_748_cov_55.348228	446	526	0	32	80	0.4000000
NODE_14185_length_748_cov_55.348228	446	526	4	48	80	0.6000000
NODE_14186_length_748_cov_51.838213	369	449	0	62	80	0.7750000
NODE_14186_length_748_cov_51.838213	369	449	2	18	80	0.2250000
NODE_14186_length_748_cov_51.838213	422	502	0	9	80	0.1125000
NODE_14186_length_748_cov_51.838213	422	502	2	61	80	0.7625000
NODE_14186_length_748_cov_51.838213	422	502	4	10	80	0.1250000
NODE_14187_length_748_cov_46.952234	293	373	0	11	80	0.1375000
NODE_14187_length_748_cov_46.952234	293	373	2	10	80	0.1250000
NODE_14187_length_748_cov_46.952234	293	373	4	59	80	0.7375000
NODE_14187_length_748_cov_46.952234	346	426	0	35	80	0.4375000
NODE_14187_length_748_cov_46.952234	346	426	2	13	80	0.1625000
NODE_14187_length_748_cov_46.952234	346	426	4	32	80	0.4000000
NODE_14188_length_748_cov_45.001541	272	352	0	80	80	1.0000000
NODE_14188_length_748_cov_45.001541	325	405	0	80	80	1.0000000
NODE_14189_length_748_cov_34.355932	488	568	2	46	80	0.5750000
NODE_14189_length_748_cov_34.355932	488	568	6	23	80	0.2875000
NODE_14189_length_748_cov_34.355932	488	568	9	11	80	0.1375000
NODE_14189_length_748_cov_34.355932	541	621	6	16	80	0.2000000
NODE_14189_length_748_cov_34.355932	541	621	9	17	80	0.2125000
NODE_14189_length_748_cov_34.355932	541	621	10	47	80	0.5875000
NODE_14190_length_748_cov_25.972265	297	377	6	16	80	0.2000000
NODE_14190_length_748_cov_25.972265	297	377	10	42	80	0.5250000
NODE_14190_length_748_cov_25.972265	297	377	12	11	80	0.1375000
NODE_14190_length_748_cov_25.972265	297	377	14	11	80	0.1375000
NODE_14190_length_748_cov_25.972265	350	430	4	36	80	0.4500000
NODE_14190_length_748_cov_25.972265	350	430	6	33	80	0.4125000
NODE_14190_length_748_cov_25.972265	350	430	14	11	80	0.1375000
NODE_14191_length_748_cov_21.050847	362	442	0	80	80	1.0000000
NODE_14191_length_748_cov_21.050847	415	495	0	80	80	1.0000000
NODE_14192_length_748_cov_20.682589	353	433	0	80	80	1.0000000
NODE_14192_length_748_cov_20.682589	406	486	0	34	80	0.4250000
NODE_14192_length_748_cov_20.682589	406	486	2	46	80	0.5750000
NODE_14193_length_748_cov_19.081664	261	341	0	63	80	0.7875000
NODE_14193_length_748_cov_19.081664	261	341	2	17	80	0.2125000
NODE_14193_length_748_cov_19.081664	314	394	0	10	80	0.1250000
NODE_14193_length_748_cov_19.081664	314	394	2	70	80	0.8750000
NODE_14193_length_748_cov_19.081664	390	470	2	33	80	0.4125000
NODE_14193_length_748_cov_19.081664	390	470	4	16	80	0.2000000
NODE_14193_length_748_cov_19.081664	390	470	6	31	80	0.3875000
NODE_14193_length_748_cov_19.081664	443	522	4	23	79	0.2911392
NODE_14193_length_748_cov_19.081664	443	522	6	56	79	0.7088608
NODE_14194_length_748_cov_16.579353	81	161	0	16	80	0.2000000
NODE_14194_length_748_cov_16.579353	81	161	2	64	80	0.8000000
NODE_14194_length_748_cov_16.579353	134	214	0	25	80	0.3125000
NODE_14194_length_748_cov_16.579353	134	214	2	55	80	0.6875000
NODE_14194_length_748_cov_16.579353	210	290	0	80	80	1.0000000
NODE_14194_length_748_cov_16.579353	263	343	0	80	80	1.0000000
NODE_14196_length_748_cov_11.983051	375	455	2	22	80	0.2750000
NODE_14196_length_748_cov_11.983051	375	455	4	58	80	0.7250000
NODE_14196_length_748_cov_11.983051	428	508	0	41	80	0.5125000
NODE_14196_length_748_cov_11.983051	428	508	2	34	80	0.4250000
NODE_14196_length_748_cov_11.983051	428	508	4	5	80	0.0625000
NODE_14197_length_748_cov_11.474576	257	337	0	17	80	0.2125000
NODE_14197_length_748_cov_11.474576	257	337	8	63	80	0.7875000
NODE_14197_length_748_cov_11.474576	310	390	0	19	80	0.2375000
NODE_14197_length_748_cov_11.474576	310	390	8	61	80	0.7625000
NODE_14200_length_748_cov_7.979969	223	303	2	59	80	0.7375000
NODE_14200_length_748_cov_7.979969	223	303	4	21	80	0.2625000
NODE_14200_length_748_cov_7.979969	276	356	0	26	80	0.3250000
NODE_14200_length_748_cov_7.979969	276	356	2	54	80	0.6750000
NODE_14240_length_747_cov_24.279321	205	285	0	80	80	1.0000000
NODE_14240_length_747_cov_24.279321	258	338	0	80	80	1.0000000
NODE_14241_length_747_cov_15.438272	352	432	0	80	80	1.0000000
NODE_14241_length_747_cov_15.438272	405	485	0	80	80	1.0000000
NODE_14244_length_747_cov_7.979938	237	317	0	63	80	0.7875000
NODE_14244_length_747_cov_7.979938	237	317	2	17	80	0.2125000
NODE_14244_length_747_cov_7.979938	290	370	0	10	80	0.1250000
NODE_14244_length_747_cov_7.979938	290	370	2	70	80	0.8750000
NODE_14248_length_747_cov_4.918210	157	237	0	80	80	1.0000000
NODE_14248_length_747_cov_4.918210	210	290	0	80	80	1.0000000
NODE_14277_length_746_cov_44.041731	153	233	4	35	80	0.4375000
NODE_14277_length_746_cov_44.041731	153	233	5	1	80	0.0125000
NODE_14277_length_746_cov_44.041731	153	233	6	18	80	0.2250000
NODE_14277_length_746_cov_44.041731	153	233	8	26	80	0.3250000
NODE_14277_length_746_cov_44.041731	206	286	0	20	80	0.2500000
NODE_14277_length_746_cov_44.041731	206	286	2	17	80	0.2125000
NODE_14277_length_746_cov_44.041731	206	286	4	40	80	0.5000000
NODE_14277_length_746_cov_44.041731	206	286	5	1	80	0.0125000
NODE_14277_length_746_cov_44.041731	206	286	8	2	80	0.0250000
NODE_14278_length_746_cov_24.435858	334	414	2	28	80	0.3500000
NODE_14278_length_746_cov_24.435858	334	414	6	52	80	0.6500000
NODE_14278_length_746_cov_24.435858	387	467	0	19	80	0.2375000
NODE_14278_length_746_cov_24.435858	387	467	4	7	80	0.0875000
NODE_14278_length_746_cov_24.435858	387	467	6	54	80	0.6750000
NODE_14279_length_746_cov_20.225657	114	194	2	39	80	0.4875000
NODE_14279_length_746_cov_20.225657	114	194	6	41	80	0.5125000
NODE_14279_length_746_cov_20.225657	167	247	0	1	80	0.0125000
NODE_14279_length_746_cov_20.225657	167	247	4	33	80	0.4125000
NODE_14279_length_746_cov_20.225657	167	247	5	1	80	0.0125000
NODE_14279_length_746_cov_20.225657	167	247	6	45	80	0.5625000
NODE_14280_length_746_cov_17.919629	330	410	2	80	80	1.0000000
NODE_14280_length_746_cov_17.919629	383	463	0	12	80	0.1500000
NODE_14280_length_746_cov_17.919629	383	463	2	68	80	0.8500000
NODE_14281_length_746_cov_17.523957	292	372	0	80	80	1.0000000
NODE_14281_length_746_cov_17.523957	345	425	0	80	80	1.0000000
NODE_14282_length_746_cov_17.214838	306	386	0	80	80	1.0000000
NODE_14282_length_746_cov_17.214838	359	439	0	80	80	1.0000000
NODE_14283_length_746_cov_16.765070	344	424	0	80	80	1.0000000
NODE_14283_length_746_cov_16.765070	397	477	0	80	80	1.0000000
NODE_14284_length_746_cov_13.153014	126	206	0	80	80	1.0000000
NODE_14284_length_746_cov_13.153014	179	259	0	80	80	1.0000000
NODE_14284_length_746_cov_13.153014	244	263	0	19	19	1.0000000
NODE_14285_length_746_cov_12.316847	364	442	2	78	78	1.0000000
NODE_14286_length_746_cov_11.301391	349	429	0	80	80	1.0000000
NODE_14286_length_746_cov_11.301391	402	482	0	80	80	1.0000000
NODE_14302_length_746_cov_2.639876	331	411	4	25	80	0.3125000
NODE_14302_length_746_cov_2.639876	331	411	6	55	80	0.6875000
NODE_14307_length_746_cov_1.879444	435	502	0	67	67	1.0000000
NODE_14310_length_746_cov_1.727975	65	121	0	56	56	1.0000000
NODE_14310_length_746_cov_1.727975	494	540	0	46	46	1.0000000
NODE_14329_length_745_cov_40.360681	257	337	0	80	80	1.0000000
NODE_14329_length_745_cov_40.360681	310	390	0	80	80	1.0000000
NODE_14330_length_745_cov_30.817337	339	419	0	80	80	1.0000000
NODE_14330_length_745_cov_30.817337	392	459	0	67	67	1.0000000
NODE_14335_length_745_cov_8.620743	225	275	0	50	50	1.0000000
NODE_14335_length_745_cov_8.620743	248	328	0	80	80	1.0000000
NODE_14343_length_745_cov_3.922601	249	280	40	2	31	0.0645161
NODE_14343_length_745_cov_3.922601	249	280	42	1	31	0.0322581
NODE_14343_length_745_cov_3.922601	249	280	44	12	31	0.3870968
NODE_14343_length_745_cov_3.922601	249	280	46	16	31	0.5161290
NODE_14343_length_745_cov_3.922601	253	333	38	13	80	0.1625000
NODE_14343_length_745_cov_3.922601	253	333	40	2	80	0.0250000
NODE_14343_length_745_cov_3.922601	253	333	42	27	80	0.3375000
NODE_14343_length_745_cov_3.922601	253	333	44	22	80	0.2750000
NODE_14343_length_745_cov_3.922601	253	333	46	16	80	0.2000000
NODE_14381_length_744_cov_44.953488	553	633	0	20	80	0.2500000
NODE_14381_length_744_cov_44.953488	553	633	2	60	80	0.7500000
NODE_14381_length_744_cov_44.953488	553	633	0	20	80	0.2500000
NODE_14381_length_744_cov_44.953488	553	633	2	60	80	0.7500000
NODE_14381_length_744_cov_44.953488	553	633	0	20	80	0.2500000
NODE_14381_length_744_cov_44.953488	553	633	2	60	80	0.7500000
NODE_14381_length_744_cov_44.953488	553	633	0	20	80	0.2500000
NODE_14381_length_744_cov_44.953488	553	633	2	60	80	0.7500000
NODE_14382_length_744_cov_35.333333	163	243	2	20	80	0.2500000
NODE_14382_length_744_cov_35.333333	163	243	4	15	80	0.1875000
NODE_14382_length_744_cov_35.333333	163	243	6	45	80	0.5625000
NODE_14382_length_744_cov_35.333333	216	296	2	23	80	0.2875000
NODE_14382_length_744_cov_35.333333	216	296	4	37	80	0.4625000
NODE_14382_length_744_cov_35.333333	216	296	6	20	80	0.2500000
NODE_14382_length_744_cov_35.333333	292	372	2	67	80	0.8375000
NODE_14382_length_744_cov_35.333333	292	372	4	13	80	0.1625000
NODE_14382_length_744_cov_35.333333	345	425	2	16	80	0.2000000
NODE_14382_length_744_cov_35.333333	345	425	4	22	80	0.2750000
NODE_14382_length_744_cov_35.333333	345	425	8	42	80	0.5250000
NODE_14383_length_744_cov_34.503876	294	374	1	6	80	0.0750000
NODE_14383_length_744_cov_34.503876	294	374	2	28	80	0.3500000
NODE_14383_length_744_cov_34.503876	294	374	4	28	80	0.3500000
NODE_14383_length_744_cov_34.503876	294	374	5	18	80	0.2250000
NODE_14383_length_744_cov_34.503876	347	427	0	18	80	0.2250000
NODE_14383_length_744_cov_34.503876	347	427	4	62	80	0.7750000
NODE_14384_length_744_cov_32.282171	333	403	0	70	70	1.0000000
NODE_14384_length_744_cov_32.282171	440	520	2	80	80	1.0000000
NODE_14384_length_744_cov_32.282171	493	573	0	33	80	0.4125000
NODE_14384_length_744_cov_32.282171	493	573	2	47	80	0.5875000
NODE_14390_length_744_cov_4.537984	260	340	0	80	80	1.0000000
NODE_14390_length_744_cov_4.537984	313	393	0	80	80	1.0000000
NODE_14396_length_744_cov_2.784496	335	387	4	45	52	0.8653846
NODE_14396_length_744_cov_2.784496	335	387	6	7	52	0.1346154
NODE_14396_length_744_cov_2.784496	360	437	2	30	77	0.3896104
NODE_14396_length_744_cov_2.784496	360	437	4	39	77	0.5064935
NODE_14396_length_744_cov_2.784496	360	437	6	8	77	0.1038961
NODE_14427_length_743_cov_26.369565	354	434	0	23	80	0.2875000
NODE_14427_length_743_cov_26.369565	354	434	2	29	80	0.3625000
NODE_14427_length_743_cov_26.369565	354	434	4	12	80	0.1500000
NODE_14427_length_743_cov_26.369565	354	434	6	16	80	0.2000000
NODE_14427_length_743_cov_26.369565	407	487	0	76	80	0.9500000
NODE_14427_length_743_cov_26.369565	407	487	2	4	80	0.0500000
NODE_14428_length_743_cov_21.759317	138	218	0	35	80	0.4375000
NODE_14428_length_743_cov_21.759317	138	218	15	4	80	0.0500000
NODE_14428_length_743_cov_21.759317	138	218	17	16	80	0.2000000
NODE_14428_length_743_cov_21.759317	138	218	19	1	80	0.0125000
NODE_14428_length_743_cov_21.759317	138	218	21	24	80	0.3000000
NODE_14428_length_743_cov_21.759317	191	271	17	2	80	0.0250000
NODE_14428_length_743_cov_21.759317	191	271	19	1	80	0.0125000
NODE_14428_length_743_cov_21.759317	191	271	20	3	80	0.0375000
NODE_14428_length_743_cov_21.759317	191	271	21	29	80	0.3625000
NODE_14428_length_743_cov_21.759317	191	271	22	45	80	0.5625000
NODE_14429_length_743_cov_18.173913	213	293	2	80	80	1.0000000
NODE_14429_length_743_cov_18.173913	266	346	0	7	80	0.0875000
NODE_14429_length_743_cov_18.173913	266	346	2	73	80	0.9125000
NODE_14431_length_743_cov_17.066770	400	480	0	4	80	0.0500000
NODE_14431_length_743_cov_17.066770	400	480	2	76	80	0.9500000
NODE_14431_length_743_cov_17.066770	453	532	0	56	79	0.7088608
NODE_14431_length_743_cov_17.066770	453	532	2	23	79	0.2911392
NODE_14432_length_743_cov_16.354037	350	430	6	1	80	0.0125000
NODE_14432_length_743_cov_16.354037	350	430	9	1	80	0.0125000
NODE_14432_length_743_cov_16.354037	350	430	10	36	80	0.4500000
NODE_14432_length_743_cov_16.354037	350	430	12	42	80	0.5250000
NODE_14432_length_743_cov_16.354037	403	483	0	2	80	0.0250000
NODE_14432_length_743_cov_16.354037	403	483	2	41	80	0.5125000
NODE_14432_length_743_cov_16.354037	403	483	4	10	80	0.1250000
NODE_14432_length_743_cov_16.354037	403	483	6	1	80	0.0125000
NODE_14432_length_743_cov_16.354037	403	483	9	1	80	0.0125000
NODE_14432_length_743_cov_16.354037	403	483	10	25	80	0.3125000
NODE_14433_length_743_cov_15.667702	220	300	0	9	80	0.1125000
NODE_14433_length_743_cov_15.667702	220	300	2	8	80	0.1000000
NODE_14433_length_743_cov_15.667702	220	300	4	63	80	0.7875000
NODE_14433_length_743_cov_15.667702	273	353	0	32	80	0.4000000
NODE_14433_length_743_cov_15.667702	273	353	2	4	80	0.0500000
NODE_14433_length_743_cov_15.667702	273	353	4	44	80	0.5500000
NODE_14433_length_743_cov_15.667702	349	429	0	80	80	1.0000000
NODE_14433_length_743_cov_15.667702	402	482	0	80	80	1.0000000
NODE_14434_length_743_cov_14.975155	289	362	0	15	73	0.2054795
NODE_14434_length_743_cov_14.975155	289	362	2	2	73	0.0273973
NODE_14434_length_743_cov_14.975155	289	362	4	56	73	0.7671233
NODE_14435_length_743_cov_14.100932	232	312	0	80	80	1.0000000
NODE_14435_length_743_cov_14.100932	285	365	0	80	80	1.0000000
NODE_14435_length_743_cov_14.100932	361	441	0	80	80	1.0000000
NODE_14435_length_743_cov_14.100932	414	494	0	80	80	1.0000000
NODE_14436_length_743_cov_12.968944	268	348	0	80	80	1.0000000
NODE_14436_length_743_cov_12.968944	321	401	0	27	80	0.3375000
NODE_14436_length_743_cov_12.968944	321	401	2	53	80	0.6625000
NODE_14437_length_743_cov_12.847826	485	565	2	43	80	0.5375000
NODE_14437_length_743_cov_12.847826	485	565	4	37	80	0.4625000
NODE_14437_length_743_cov_12.847826	538	618	0	47	80	0.5875000
NODE_14437_length_743_cov_12.847826	538	618	2	33	80	0.4125000
NODE_14438_length_743_cov_11.871118	403	483	2	18	80	0.2250000
NODE_14438_length_743_cov_11.871118	403	483	4	33	80	0.4125000
NODE_14438_length_743_cov_11.871118	403	483	6	29	80	0.3625000
NODE_14438_length_743_cov_11.871118	456	536	0	24	80	0.3000000
NODE_14438_length_743_cov_11.871118	456	536	2	47	80	0.5875000
NODE_14438_length_743_cov_11.871118	456	536	6	9	80	0.1125000
NODE_14439_length_743_cov_11.760870	337	417	0	4	80	0.0500000
NODE_14439_length_743_cov_11.760870	337	417	2	47	80	0.5875000
NODE_14439_length_743_cov_11.760870	337	417	4	29	80	0.3625000
NODE_14439_length_743_cov_11.760870	390	470	2	62	80	0.7750000
NODE_14439_length_743_cov_11.760870	390	470	4	18	80	0.2250000
NODE_14440_length_743_cov_9.006211	351	431	0	75	80	0.9375000
NODE_14440_length_743_cov_9.006211	351	431	2	5	80	0.0625000
NODE_14440_length_743_cov_9.006211	404	484	0	22	80	0.2750000
NODE_14440_length_743_cov_9.006211	404	484	2	32	80	0.4000000
NODE_14440_length_743_cov_9.006211	404	484	4	26	80	0.3250000
NODE_14441_length_743_cov_8.063665	290	370	0	80	80	1.0000000
NODE_14441_length_743_cov_8.063665	343	423	0	80	80	1.0000000
NODE_14456_length_743_cov_2.029503	260	284	0	24	24	1.0000000
NODE_14456_length_743_cov_2.029503	301	363	0	62	62	1.0000000
NODE_14473_length_743_cov_0.989130	592	670	19	1	78	0.0128205
NODE_14473_length_743_cov_0.989130	592	670	23	1	78	0.0128205
NODE_14473_length_743_cov_0.989130	592	670	31	2	78	0.0256410
NODE_14473_length_743_cov_0.989130	592	670	35	1	78	0.0128205
NODE_14473_length_743_cov_0.989130	592	670	37	1	78	0.0128205
NODE_14473_length_743_cov_0.989130	592	670	39	1	78	0.0128205
NODE_14473_length_743_cov_0.989130	592	670	41	2	78	0.0256410
NODE_14473_length_743_cov_0.989130	592	670	43	4	78	0.0512821
NODE_14473_length_743_cov_0.989130	592	670	44	2	78	0.0256410
NODE_14473_length_743_cov_0.989130	592	670	58	2	78	0.0256410
NODE_14473_length_743_cov_0.989130	592	670	60	1	78	0.0128205
NODE_14473_length_743_cov_0.989130	592	670	64	1	78	0.0128205
NODE_14473_length_743_cov_0.989130	592	670	68	17	78	0.2179487
NODE_14473_length_743_cov_0.989130	592	670	69	6	78	0.0769231
NODE_14473_length_743_cov_0.989130	592	670	70	11	78	0.1410256
NODE_14473_length_743_cov_0.989130	592	670	71	25	78	0.3205128
NODE_14477_length_742_cov_23.664075	271	351	0	80	80	1.0000000
NODE_14477_length_742_cov_23.664075	324	404	0	80	80	1.0000000
NODE_14478_length_742_cov_19.488336	288	368	0	21	80	0.2625000
NODE_14478_length_742_cov_19.488336	288	368	2	59	80	0.7375000
NODE_14478_length_742_cov_19.488336	341	421	0	72	80	0.9000000
NODE_14478_length_742_cov_19.488336	341	421	2	8	80	0.1000000
NODE_14479_length_742_cov_18.528771	319	399	0	80	80	1.0000000
NODE_14479_length_742_cov_18.528771	372	452	0	80	80	1.0000000
NODE_14480_length_742_cov_17.401244	126	206	0	55	80	0.6875000
NODE_14480_length_742_cov_17.401244	126	206	4	12	80	0.1500000
NODE_14480_length_742_cov_17.401244	126	206	7	13	80	0.1625000
NODE_14480_length_742_cov_17.401244	179	259	0	2	80	0.0250000
NODE_14480_length_742_cov_17.401244	179	259	4	12	80	0.1500000
NODE_14480_length_742_cov_17.401244	179	259	7	36	80	0.4500000
NODE_14480_length_742_cov_17.401244	179	259	9	30	80	0.3750000
NODE_14482_length_742_cov_7.679627	274	354	0	74	80	0.9250000
NODE_14482_length_742_cov_7.679627	274	354	2	6	80	0.0750000
NODE_14482_length_742_cov_7.679627	327	407	0	21	80	0.2625000
NODE_14482_length_742_cov_7.679627	327	407	2	59	80	0.7375000
NODE_14521_length_741_cov_12.168224	316	392	2	53	76	0.6973684
NODE_14521_length_741_cov_12.168224	316	392	6	23	76	0.3026316
NODE_14521_length_741_cov_12.168224	598	663	0	65	65	1.0000000
NODE_14522_length_741_cov_8.542056	198	278	0	80	80	1.0000000
NODE_14522_length_741_cov_8.542056	251	331	0	80	80	1.0000000
NODE_14525_length_741_cov_5.989097	457	538	12	28	81	0.3456790
NODE_14525_length_741_cov_5.989097	457	538	14	53	81	0.6543210
NODE_14536_length_741_cov_2.556075	212	289	0	64	77	0.8311688
NODE_14536_length_741_cov_2.556075	212	289	2	11	77	0.1428571
NODE_14536_length_741_cov_2.556075	212	289	4	1	77	0.0129870
NODE_14536_length_741_cov_2.556075	212	289	8	1	77	0.0129870
NODE_14571_length_740_cov_54.372855	192	272	2	38	80	0.4750000
NODE_14571_length_740_cov_54.372855	192	272	4	42	80	0.5250000
NODE_14571_length_740_cov_54.372855	245	325	2	26	80	0.3250000
NODE_14571_length_740_cov_54.372855	245	325	4	54	80	0.6750000
NODE_14571_length_740_cov_54.372855	321	401	0	17	80	0.2125000
NODE_14571_length_740_cov_54.372855	321	401	2	47	80	0.5875000
NODE_14571_length_740_cov_54.372855	321	401	4	16	80	0.2000000
NODE_14571_length_740_cov_54.372855	374	454	0	11	80	0.1375000
NODE_14571_length_740_cov_54.372855	374	454	4	18	80	0.2250000
NODE_14571_length_740_cov_54.372855	374	454	6	51	80	0.6375000
NODE_14572_length_740_cov_51.758190	194	274	0	4	80	0.0500000
NODE_14572_length_740_cov_51.758190	194	274	2	1	80	0.0125000
NODE_14572_length_740_cov_51.758190	194	274	4	14	80	0.1750000
NODE_14572_length_740_cov_51.758190	194	274	9	44	80	0.5500000
NODE_14572_length_740_cov_51.758190	194	274	10	13	80	0.1625000
NODE_14572_length_740_cov_51.758190	194	274	12	4	80	0.0500000
NODE_14572_length_740_cov_51.758190	247	327	7	24	80	0.3000000
NODE_14572_length_740_cov_51.758190	247	327	9	16	80	0.2000000
NODE_14572_length_740_cov_51.758190	247	327	10	34	80	0.4250000
NODE_14572_length_740_cov_51.758190	247	327	12	6	80	0.0750000
NODE_14573_length_740_cov_34.185647	359	439	0	31	80	0.3875000
NODE_14573_length_740_cov_34.185647	359	439	2	49	80	0.6125000
NODE_14573_length_740_cov_34.185647	412	492	0	20	80	0.2500000
NODE_14573_length_740_cov_34.185647	412	492	2	60	80	0.7500000
NODE_14574_length_740_cov_24.794072	286	366	0	14	80	0.1750000
NODE_14574_length_740_cov_24.794072	286	366	8	66	80	0.8250000
NODE_14574_length_740_cov_24.794072	339	419	0	3	80	0.0375000
NODE_14574_length_740_cov_24.794072	339	419	8	77	80	0.9625000
NODE_14575_length_740_cov_20.361934	316	396	0	40	80	0.5000000
NODE_14575_length_740_cov_20.361934	316	396	4	40	80	0.5000000
NODE_14575_length_740_cov_20.361934	369	449	0	1	80	0.0125000
NODE_14575_length_740_cov_20.361934	369	449	4	79	80	0.9875000
NODE_14576_length_740_cov_18.982839	266	348	0	82	82	1.0000000
NODE_14576_length_740_cov_18.982839	321	401	0	80	80	1.0000000
NODE_14577_length_740_cov_16.755070	354	434	4	11	80	0.1375000
NODE_14577_length_740_cov_16.755070	354	434	5	12	80	0.1500000
NODE_14577_length_740_cov_16.755070	354	434	6	14	80	0.1750000
NODE_14577_length_740_cov_16.755070	354	434	8	38	80	0.4750000
NODE_14577_length_740_cov_16.755070	354	434	9	5	80	0.0625000
NODE_14577_length_740_cov_16.755070	407	487	4	6	80	0.0750000
NODE_14577_length_740_cov_16.755070	407	487	6	57	80	0.7125000
NODE_14577_length_740_cov_16.755070	407	487	8	17	80	0.2125000
NODE_14579_length_740_cov_7.585023	206	286	0	80	80	1.0000000
NODE_14579_length_740_cov_7.585023	259	339	0	80	80	1.0000000
NODE_14580_length_740_cov_7.174727	165	245	0	38	80	0.4750000
NODE_14580_length_740_cov_7.174727	165	245	4	23	80	0.2875000
NODE_14580_length_740_cov_7.174727	165	245	6	19	80	0.2375000
NODE_14580_length_740_cov_7.174727	218	298	4	8	80	0.1000000
NODE_14580_length_740_cov_7.174727	218	298	6	72	80	0.9000000
NODE_14614_length_739_cov_52.970312	346	426	3	12	80	0.1500000
NODE_14614_length_739_cov_52.970312	346	426	6	68	80	0.8500000
NODE_14614_length_739_cov_52.970312	399	479	3	52	80	0.6500000
NODE_14614_length_739_cov_52.970312	399	479	6	28	80	0.3500000
NODE_14615_length_739_cov_31.175000	204	284	13	8	80	0.1000000
NODE_14615_length_739_cov_31.175000	204	284	17	1	80	0.0125000
NODE_14615_length_739_cov_31.175000	204	284	18	20	80	0.2500000
NODE_14615_length_739_cov_31.175000	204	284	20	51	80	0.6375000
NODE_14615_length_739_cov_31.175000	257	337	4	13	80	0.1625000
NODE_14615_length_739_cov_31.175000	257	337	10	2	80	0.0250000
NODE_14615_length_739_cov_31.175000	257	337	12	14	80	0.1750000
NODE_14615_length_739_cov_31.175000	257	337	14	17	80	0.2125000
NODE_14615_length_739_cov_31.175000	257	337	17	1	80	0.0125000
NODE_14615_length_739_cov_31.175000	257	337	18	14	80	0.1750000
NODE_14615_length_739_cov_31.175000	257	337	20	19	80	0.2375000
NODE_14616_length_739_cov_25.482813	487	567	0	10	80	0.1250000
NODE_14616_length_739_cov_25.482813	487	567	2	28	80	0.3500000
NODE_14616_length_739_cov_25.482813	487	567	4	42	80	0.5250000
NODE_14616_length_739_cov_25.482813	540	620	0	63	80	0.7875000
NODE_14616_length_739_cov_25.482813	540	620	2	17	80	0.2125000
NODE_14617_length_739_cov_24.871875	191	271	0	10	80	0.1250000
NODE_14617_length_739_cov_24.871875	191	271	1	1	80	0.0125000
NODE_14617_length_739_cov_24.871875	191	271	2	15	80	0.1875000
NODE_14617_length_739_cov_24.871875	191	271	4	54	80	0.6750000
NODE_14617_length_739_cov_24.871875	244	324	2	15	80	0.1875000
NODE_14617_length_739_cov_24.871875	244	324	4	65	80	0.8125000
NODE_14618_length_739_cov_18.360937	146	226	0	52	80	0.6500000
NODE_14618_length_739_cov_18.360937	146	226	2	9	80	0.1125000
NODE_14618_length_739_cov_18.360937	146	226	4	19	80	0.2375000
NODE_14618_length_739_cov_18.360937	199	279	0	6	80	0.0750000
NODE_14618_length_739_cov_18.360937	199	279	2	27	80	0.3375000
NODE_14618_length_739_cov_18.360937	199	279	4	47	80	0.5875000
NODE_14619_length_739_cov_13.195312	273	353	0	35	80	0.4375000
NODE_14619_length_739_cov_13.195312	273	353	4	45	80	0.5625000
NODE_14619_length_739_cov_13.195312	326	406	0	19	80	0.2375000
NODE_14619_length_739_cov_13.195312	326	406	4	61	80	0.7625000
NODE_14620_length_739_cov_10.314063	231	311	0	80	80	1.0000000
NODE_14620_length_739_cov_10.314063	284	364	0	80	80	1.0000000
NODE_14622_length_739_cov_8.523438	468	548	0	7	80	0.0875000
NODE_14622_length_739_cov_8.523438	468	548	2	73	80	0.9125000
NODE_14622_length_739_cov_8.523438	521	600	0	7	79	0.0886076
NODE_14622_length_739_cov_8.523438	521	600	2	72	79	0.9113924
NODE_14623_length_739_cov_7.398438	342	422	2	66	80	0.8250000
NODE_14623_length_739_cov_7.398438	342	422	4	14	80	0.1750000
NODE_14623_length_739_cov_7.398438	395	475	0	52	80	0.6500000
NODE_14623_length_739_cov_7.398438	395	475	2	28	80	0.3500000
NODE_14625_length_739_cov_5.826562	252	332	0	7	80	0.0875000
NODE_14625_length_739_cov_5.826562	252	332	1	40	80	0.5000000
NODE_14625_length_739_cov_5.826562	252	332	3	10	80	0.1250000
NODE_14625_length_739_cov_5.826562	252	332	5	23	80	0.2875000
NODE_14625_length_739_cov_5.826562	305	385	3	12	80	0.1500000
NODE_14625_length_739_cov_5.826562	305	385	5	68	80	0.8500000
NODE_14634_length_739_cov_3.232813	355	435	0	56	80	0.7000000
NODE_14634_length_739_cov_3.232813	355	435	2	24	80	0.3000000
NODE_14634_length_739_cov_3.232813	408	488	0	80	80	1.0000000
NODE_14679_length_738_cov_35.278560	274	318	72	4	44	0.0909091
NODE_14679_length_738_cov_35.278560	274	318	75	1	44	0.0227273
NODE_14679_length_738_cov_35.278560	274	318	76	1	44	0.0227273
NODE_14679_length_738_cov_35.278560	274	318	77	4	44	0.0909091
NODE_14679_length_738_cov_35.278560	274	318	79	1	44	0.0227273
NODE_14679_length_738_cov_35.278560	274	318	82	2	44	0.0454545
NODE_14679_length_738_cov_35.278560	274	318	83	4	44	0.0909091
NODE_14679_length_738_cov_35.278560	274	318	84	1	44	0.0227273
NODE_14679_length_738_cov_35.278560	274	318	85	3	44	0.0681818
NODE_14679_length_738_cov_35.278560	274	318	86	11	44	0.2500000
NODE_14679_length_738_cov_35.278560	274	318	87	7	44	0.1590909
NODE_14679_length_738_cov_35.278560	274	318	88	2	44	0.0454545
NODE_14679_length_738_cov_35.278560	274	318	90	1	44	0.0227273
NODE_14679_length_738_cov_35.278560	274	318	92	1	44	0.0227273
NODE_14679_length_738_cov_35.278560	274	318	94	1	44	0.0227273
NODE_14680_length_738_cov_21.672926	208	288	0	39	80	0.4875000
NODE_14680_length_738_cov_21.672926	208	288	2	41	80	0.5125000
NODE_14680_length_738_cov_21.672926	261	341	0	30	80	0.3750000
NODE_14680_length_738_cov_21.672926	261	341	2	50	80	0.6250000
NODE_14681_length_738_cov_15.665102	302	382	0	80	80	1.0000000
NODE_14681_length_738_cov_15.665102	355	435	0	80	80	1.0000000
NODE_14682_length_738_cov_15.661972	338	418	0	47	80	0.5875000
NODE_14682_length_738_cov_15.661972	338	418	2	33	80	0.4125000
NODE_14682_length_738_cov_15.661972	391	471	0	80	80	1.0000000
NODE_14683_length_738_cov_12.594679	49	129	6	4	80	0.0500000
NODE_14683_length_738_cov_12.594679	49	129	10	76	80	0.9500000
NODE_14683_length_738_cov_12.594679	102	182	4	42	80	0.5250000
NODE_14683_length_738_cov_12.594679	102	182	10	38	80	0.4750000
NODE_14683_length_738_cov_12.594679	178	258	0	64	80	0.8000000
NODE_14683_length_738_cov_12.594679	178	258	4	16	80	0.2000000
NODE_14683_length_738_cov_12.594679	231	311	0	80	80	1.0000000
NODE_14691_length_738_cov_4.056338	254	326	0	72	72	1.0000000
NODE_14691_length_738_cov_4.056338	437	528	0	6	91	0.0659341
NODE_14691_length_738_cov_4.056338	437	528	2	3	91	0.0329670
NODE_14691_length_738_cov_4.056338	437	528	4	44	91	0.4835165
NODE_14691_length_738_cov_4.056338	437	528	6	9	91	0.0989011
NODE_14691_length_738_cov_4.056338	437	528	8	8	91	0.0879121
NODE_14691_length_738_cov_4.056338	437	528	10	13	91	0.1428571
NODE_14691_length_738_cov_4.056338	437	528	12	5	91	0.0549451
NODE_14691_length_738_cov_4.056338	437	528	16	2	91	0.0219780
NODE_14691_length_738_cov_4.056338	437	528	18	1	91	0.0109890
NODE_14724_length_737_cov_22.363636	303	383	7	2	80	0.0250000
NODE_14724_length_737_cov_22.363636	303	383	9	4	80	0.0500000
NODE_14724_length_737_cov_22.363636	303	383	12	2	80	0.0250000
NODE_14724_length_737_cov_22.363636	303	383	15	11	80	0.1375000
NODE_14724_length_737_cov_22.363636	303	383	17	8	80	0.1000000
NODE_14724_length_737_cov_22.363636	303	383	19	53	80	0.6625000
NODE_14724_length_737_cov_22.363636	356	436	0	35	80	0.4375000
NODE_14724_length_737_cov_22.363636	356	436	6	1	80	0.0125000
NODE_14724_length_737_cov_22.363636	356	436	7	19	80	0.2375000
NODE_14724_length_737_cov_22.363636	356	436	9	4	80	0.0500000
NODE_14724_length_737_cov_22.363636	356	436	12	2	80	0.0250000
NODE_14724_length_737_cov_22.363636	356	436	15	3	80	0.0375000
NODE_14724_length_737_cov_22.363636	356	436	17	3	80	0.0375000
NODE_14724_length_737_cov_22.363636	356	436	19	13	80	0.1625000
NODE_14725_length_737_cov_21.318182	208	288	0	23	80	0.2875000
NODE_14725_length_737_cov_21.318182	208	288	2	57	80	0.7125000
NODE_14725_length_737_cov_21.318182	261	341	0	76	80	0.9500000
NODE_14725_length_737_cov_21.318182	261	341	2	4	80	0.0500000
NODE_14726_length_737_cov_17.161442	346	426	0	80	80	1.0000000
NODE_14726_length_737_cov_17.161442	399	479	0	80	80	1.0000000
NODE_14727_length_737_cov_11.835423	211	291	0	80	80	1.0000000
NODE_14727_length_737_cov_11.835423	264	344	0	80	80	1.0000000
NODE_14729_length_737_cov_6.782132	488	548	0	60	60	1.0000000
NODE_14732_length_737_cov_6.089342	241	321	2	1	80	0.0125000
NODE_14732_length_737_cov_6.089342	241	321	6	10	80	0.1250000
NODE_14732_length_737_cov_6.089342	241	321	8	69	80	0.8625000
NODE_14732_length_737_cov_6.089342	294	374	0	50	80	0.6250000
NODE_14732_length_737_cov_6.089342	294	374	2	4	80	0.0500000
NODE_14732_length_737_cov_6.089342	294	374	6	6	80	0.0750000
NODE_14732_length_737_cov_6.089342	294	374	8	20	80	0.2500000
NODE_14747_length_737_cov_2.548589	386	416	0	30	30	1.0000000
NODE_14781_length_736_cov_46.601256	226	306	2	31	80	0.3875000
NODE_14781_length_736_cov_46.601256	226	306	4	39	80	0.4875000
NODE_14781_length_736_cov_46.601256	226	306	8	10	80	0.1250000
NODE_14781_length_736_cov_46.601256	279	359	2	3	80	0.0375000
NODE_14781_length_736_cov_46.601256	279	359	4	14	80	0.1750000
NODE_14781_length_736_cov_46.601256	279	359	6	31	80	0.3875000
NODE_14781_length_736_cov_46.601256	279	359	8	32	80	0.4000000
NODE_14782_length_736_cov_32.442700	215	295	0	36	80	0.4500000
NODE_14782_length_736_cov_32.442700	215	295	2	44	80	0.5500000
NODE_14782_length_736_cov_32.442700	268	350	0	1	82	0.0121951
NODE_14782_length_736_cov_32.442700	268	350	2	81	82	0.9878049
NODE_14783_length_736_cov_26.364207	220	300	0	80	80	1.0000000
NODE_14783_length_736_cov_26.364207	273	353	0	80	80	1.0000000
NODE_14785_length_736_cov_10.317111	313	393	0	80	80	1.0000000
NODE_14785_length_736_cov_10.317111	366	446	0	31	80	0.3875000
NODE_14785_length_736_cov_10.317111	366	446	2	49	80	0.6125000
NODE_14786_length_736_cov_9.188383	292	372	0	45	80	0.5625000
NODE_14786_length_736_cov_9.188383	292	372	2	35	80	0.4375000
NODE_14786_length_736_cov_9.188383	345	425	2	80	80	1.0000000
NODE_14787_length_736_cov_8.149137	315	391	0	37	76	0.4868421
NODE_14787_length_736_cov_8.149137	315	391	2	12	76	0.1578947
NODE_14787_length_736_cov_8.149137	315	391	4	27	76	0.3552631
NODE_14787_length_736_cov_8.149137	365	445	2	10	80	0.1250000
NODE_14787_length_736_cov_8.149137	365	445	4	70	80	0.8750000
NODE_14788_length_736_cov_8.103611	295	375	0	80	80	1.0000000
NODE_14788_length_736_cov_8.103611	348	428	0	80	80	1.0000000
NODE_14789_length_736_cov_7.513344	239	319	2	29	80	0.3625000
NODE_14789_length_736_cov_7.513344	239	319	4	20	80	0.2500000
NODE_14789_length_736_cov_7.513344	239	319	6	31	80	0.3875000
NODE_14789_length_736_cov_7.513344	292	372	2	80	80	1.0000000
NODE_14792_length_736_cov_5.967033	253	333	0	40	80	0.5000000
NODE_14792_length_736_cov_5.967033	253	333	2	40	80	0.5000000
NODE_14792_length_736_cov_5.967033	306	386	0	66	80	0.8250000
NODE_14792_length_736_cov_5.967033	306	386	2	14	80	0.1750000
NODE_14795_length_736_cov_4.908948	258	338	0	6	80	0.0750000
NODE_14795_length_736_cov_4.908948	258	338	2	74	80	0.9250000
NODE_14795_length_736_cov_4.908948	311	391	2	80	80	1.0000000
NODE_14825_length_735_cov_21.099057	265	345	0	80	80	1.0000000
NODE_14825_length_735_cov_21.099057	318	398	0	80	80	1.0000000
NODE_14826_length_735_cov_16.696541	190	270	0	80	80	1.0000000
NODE_14826_length_735_cov_16.696541	243	323	0	80	80	1.0000000
NODE_14826_length_735_cov_16.696541	479	538	8	2	59	0.0338983
NODE_14826_length_735_cov_16.696541	479	538	12	57	59	0.9661017
NODE_14827_length_735_cov_13.143082	231	311	0	80	80	1.0000000
NODE_14827_length_735_cov_13.143082	284	364	0	80	80	1.0000000
NODE_14828_length_735_cov_12.415094	434	514	0	12	80	0.1500000
NODE_14828_length_735_cov_12.415094	434	514	4	32	80	0.4000000
NODE_14828_length_735_cov_12.415094	434	514	6	36	80	0.4500000
NODE_14828_length_735_cov_12.415094	487	567	2	2	80	0.0250000
NODE_14828_length_735_cov_12.415094	487	567	6	78	80	0.9750000
NODE_14836_length_735_cov_5.603774	326	394	0	68	68	1.0000000
NODE_14836_length_735_cov_5.603774	367	409	0	42	42	1.0000000
NODE_14880_length_734_cov_26.787402	209	289	0	19	80	0.2375000
NODE_14880_length_734_cov_26.787402	209	289	1	3	80	0.0375000
NODE_14880_length_734_cov_26.787402	209	289	34	3	80	0.0375000
NODE_14880_length_734_cov_26.787402	209	289	38	1	80	0.0125000
NODE_14880_length_734_cov_26.787402	209	289	42	7	80	0.0875000
NODE_14880_length_734_cov_26.787402	209	289	46	41	80	0.5125000
NODE_14880_length_734_cov_26.787402	209	289	48	6	80	0.0750000
NODE_14880_length_734_cov_26.787402	262	342	44	39	80	0.4875000
NODE_14880_length_734_cov_26.787402	262	342	46	21	80	0.2625000
NODE_14880_length_734_cov_26.787402	262	342	48	20	80	0.2500000
NODE_14881_length_734_cov_23.214173	200	280	0	22	80	0.2750000
NODE_14881_length_734_cov_23.214173	200	280	2	58	80	0.7250000
NODE_14881_length_734_cov_23.214173	253	333	0	63	80	0.7875000
NODE_14881_length_734_cov_23.214173	253	333	2	17	80	0.2125000
NODE_14883_length_734_cov_21.645669	245	325	0	80	80	1.0000000
NODE_14883_length_734_cov_21.645669	298	378	0	80	80	1.0000000
NODE_14884_length_734_cov_14.393701	249	329	0	80	80	1.0000000
NODE_14884_length_734_cov_14.393701	302	382	0	80	80	1.0000000
NODE_14885_length_734_cov_11.324409	133	196	0	63	63	1.0000000
NODE_14885_length_734_cov_11.324409	169	229	0	60	60	1.0000000
NODE_14886_length_734_cov_10.872441	302	331	0	29	29	1.0000000
NODE_14890_length_734_cov_6.352756	371	451	2	19	80	0.2375000
NODE_14890_length_734_cov_6.352756	371	451	6	61	80	0.7625000
NODE_14890_length_734_cov_6.352756	424	504	0	32	80	0.4000000
NODE_14890_length_734_cov_6.352756	424	504	4	15	80	0.1875000
NODE_14890_length_734_cov_6.352756	424	504	6	33	80	0.4125000
NODE_14896_length_734_cov_2.705512	231	302	2	71	71	1.0000000
NODE_14934_length_733_cov_35.041009	268	348	0	32	80	0.4000000
NODE_14934_length_733_cov_35.041009	268	348	5	1	80	0.0125000
NODE_14934_length_733_cov_35.041009	268	348	6	8	80	0.1000000
NODE_14934_length_733_cov_35.041009	268	348	8	39	80	0.4875000
NODE_14934_length_733_cov_35.041009	321	402	0	81	81	1.0000000
NODE_14935_length_733_cov_29.810726	28	108	2	80	80	1.0000000
NODE_14935_length_733_cov_29.810726	81	161	0	23	80	0.2875000
NODE_14935_length_733_cov_29.810726	81	161	2	57	80	0.7125000
NODE_14935_length_733_cov_29.810726	157	237	0	80	80	1.0000000
NODE_14935_length_733_cov_29.810726	210	290	0	80	80	1.0000000
NODE_14936_length_733_cov_13.738170	333	413	0	55	80	0.6875000
NODE_14936_length_733_cov_13.738170	333	413	2	25	80	0.3125000
NODE_14936_length_733_cov_13.738170	386	466	0	80	80	1.0000000
NODE_14937_length_733_cov_11.471609	314	389	0	75	75	1.0000000
NODE_14938_length_733_cov_11.321767	245	325	0	60	80	0.7500000
NODE_14938_length_733_cov_11.321767	245	325	2	18	80	0.2250000
NODE_14938_length_733_cov_11.321767	245	325	4	2	80	0.0250000
NODE_14938_length_733_cov_11.321767	298	378	0	7	80	0.0875000
NODE_14938_length_733_cov_11.321767	298	378	2	18	80	0.2250000
NODE_14938_length_733_cov_11.321767	298	378	4	22	80	0.2750000
NODE_14938_length_733_cov_11.321767	298	378	8	33	80	0.4125000
NODE_14940_length_733_cov_8.481073	318	395	0	77	77	1.0000000
NODE_14940_length_733_cov_8.481073	371	451	0	80	80	1.0000000
NODE_14944_length_733_cov_5.485804	659	715	42	13	56	0.2321429
NODE_14944_length_733_cov_5.485804	659	715	44	6	56	0.1071429
NODE_14944_length_733_cov_5.485804	659	715	46	1	56	0.0178571
NODE_14944_length_733_cov_5.485804	659	715	48	1	56	0.0178571
NODE_14944_length_733_cov_5.485804	659	715	50	1	56	0.0178571
NODE_14944_length_733_cov_5.485804	659	715	51	4	56	0.0714286
NODE_14944_length_733_cov_5.485804	659	715	53	12	56	0.2142857
NODE_14944_length_733_cov_5.485804	659	715	54	1	56	0.0178571
NODE_14944_length_733_cov_5.485804	659	715	55	3	56	0.0535714
NODE_14944_length_733_cov_5.485804	659	715	56	3	56	0.0535714
NODE_14944_length_733_cov_5.485804	659	715	58	1	56	0.0178571
NODE_14944_length_733_cov_5.485804	659	715	59	3	56	0.0535714
NODE_14944_length_733_cov_5.485804	659	715	60	2	56	0.0357143
NODE_14944_length_733_cov_5.485804	659	715	61	5	56	0.0892857
NODE_14944_length_733_cov_5.485804	696	733	20	2	37	0.0540541
NODE_14944_length_733_cov_5.485804	696	733	28	1	37	0.0270270
NODE_14944_length_733_cov_5.485804	696	733	30	1	37	0.0270270
NODE_14944_length_733_cov_5.485804	696	733	32	3	37	0.0810811
NODE_14944_length_733_cov_5.485804	696	733	36	3	37	0.0810811
NODE_14944_length_733_cov_5.485804	696	733	38	2	37	0.0540541
NODE_14944_length_733_cov_5.485804	696	733	40	4	37	0.1081081
NODE_14944_length_733_cov_5.485804	696	733	42	15	37	0.4054054
NODE_14944_length_733_cov_5.485804	696	733	44	6	37	0.1621622
NODE_14957_length_733_cov_2.272871	312	392	0	38	80	0.4750000
NODE_14957_length_733_cov_2.272871	312	392	2	42	80	0.5250000
NODE_14957_length_733_cov_2.272871	365	445	0	45	80	0.5625000
NODE_14957_length_733_cov_2.272871	365	445	2	35	80	0.4375000
NODE_14975_length_732_cov_19.519747	229	309	2	1	80	0.0125000
NODE_14975_length_732_cov_19.519747	229	309	4	51	80	0.6375000
NODE_14975_length_732_cov_19.519747	229	309	6	28	80	0.3500000
NODE_14975_length_732_cov_19.519747	282	362	0	12	80	0.1500000
NODE_14975_length_732_cov_19.519747	282	362	2	42	80	0.5250000
NODE_14975_length_732_cov_19.519747	282	362	4	26	80	0.3250000
NODE_14976_length_732_cov_10.846761	247	327	4	18	80	0.2250000
NODE_14976_length_732_cov_10.846761	247	327	6	27	80	0.3375000
NODE_14976_length_732_cov_10.846761	247	327	8	35	80	0.4375000
NODE_14976_length_732_cov_10.846761	300	380	0	9	80	0.1125000
NODE_14976_length_732_cov_10.846761	300	380	2	25	80	0.3125000
NODE_14976_length_732_cov_10.846761	300	380	4	6	80	0.0750000
NODE_14976_length_732_cov_10.846761	300	380	8	40	80	0.5000000
NODE_14977_length_732_cov_9.807267	276	356	0	80	80	1.0000000
NODE_14977_length_732_cov_9.807267	329	409	0	80	80	1.0000000
NODE_14978_length_732_cov_8.053712	415	495	0	6	80	0.0750000
NODE_14978_length_732_cov_8.053712	415	495	2	74	80	0.9250000
NODE_14978_length_732_cov_8.053712	468	548	0	57	80	0.7125000
NODE_14978_length_732_cov_8.053712	468	548	2	23	80	0.2875000
NODE_14980_length_732_cov_5.194313	319	399	0	80	80	1.0000000
NODE_14980_length_732_cov_5.194313	372	452	0	80	80	1.0000000
NODE_14981_length_732_cov_4.998420	293	373	0	80	80	1.0000000
NODE_14981_length_732_cov_4.998420	346	426	0	80	80	1.0000000
NODE_14983_length_732_cov_4.758294	483	524	2	2	41	0.0487805
NODE_14983_length_732_cov_4.758294	483	524	4	39	41	0.9512195
NODE_15021_length_731_cov_36.123418	464	544	0	7	80	0.0875000
NODE_15021_length_731_cov_36.123418	464	544	4	73	80	0.9125000
NODE_15021_length_731_cov_36.123418	517	597	0	44	80	0.5500000
NODE_15021_length_731_cov_36.123418	517	597	4	36	80	0.4500000
NODE_15022_length_731_cov_27.721519	294	374	4	50	80	0.6250000
NODE_15022_length_731_cov_27.721519	294	374	6	13	80	0.1625000
NODE_15022_length_731_cov_27.721519	294	374	8	13	80	0.1625000
NODE_15022_length_731_cov_27.721519	294	374	10	4	80	0.0500000
NODE_15022_length_731_cov_27.721519	347	427	6	13	80	0.1625000
NODE_15022_length_731_cov_27.721519	347	427	8	58	80	0.7250000
NODE_15022_length_731_cov_27.721519	347	427	10	9	80	0.1125000
NODE_15023_length_731_cov_19.655063	394	474	0	20	80	0.2500000
NODE_15023_length_731_cov_19.655063	394	474	8	60	80	0.7500000
NODE_15023_length_731_cov_19.655063	447	527	0	25	80	0.3125000
NODE_15023_length_731_cov_19.655063	447	527	8	55	80	0.6875000
NODE_15024_length_731_cov_16.346519	429	509	0	80	80	1.0000000
NODE_15024_length_731_cov_16.346519	482	562	0	80	80	1.0000000
NODE_15025_length_731_cov_13.892405	321	401	0	40	80	0.5000000
NODE_15025_length_731_cov_13.892405	321	401	2	40	80	0.5000000
NODE_15025_length_731_cov_13.892405	374	454	2	80	80	1.0000000
NODE_15027_length_731_cov_8.800633	218	298	0	66	80	0.8250000
NODE_15027_length_731_cov_8.800633	218	298	2	14	80	0.1750000
NODE_15027_length_731_cov_8.800633	271	352	0	13	81	0.1604938
NODE_15027_length_731_cov_8.800633	271	352	2	27	81	0.3333333
NODE_15027_length_731_cov_8.800633	271	352	4	41	81	0.5061728
NODE_15028_length_731_cov_7.658228	335	406	0	71	71	1.0000000
NODE_15028_length_731_cov_7.658228	387	468	0	81	81	1.0000000
NODE_15031_length_731_cov_5.471519	261	341	0	60	80	0.7500000
NODE_15031_length_731_cov_5.471519	261	341	2	20	80	0.2500000
NODE_15031_length_731_cov_5.471519	314	394	0	7	80	0.0875000
NODE_15031_length_731_cov_5.471519	314	394	2	73	80	0.9125000
NODE_15034_length_731_cov_4.083861	361	441	2	11	80	0.1375000
NODE_15034_length_731_cov_4.083861	361	441	4	69	80	0.8625000
NODE_15034_length_731_cov_4.083861	458	482	0	18	24	0.7500000
NODE_15034_length_731_cov_4.083861	458	482	2	6	24	0.2500000
NODE_15050_length_731_cov_2.226266	466	548	0	82	82	1.0000000
NODE_15077_length_730_cov_51.556260	349	429	8	37	80	0.4625000
NODE_15077_length_730_cov_51.556260	349	429	10	28	80	0.3500000
NODE_15077_length_730_cov_51.556260	349	429	12	15	80	0.1875000
NODE_15077_length_730_cov_51.556260	402	482	0	5	80	0.0625000
NODE_15077_length_730_cov_51.556260	402	482	3	2	80	0.0250000
NODE_15077_length_730_cov_51.556260	402	482	4	4	80	0.0500000
NODE_15077_length_730_cov_51.556260	402	482	7	1	80	0.0125000
NODE_15077_length_730_cov_51.556260	402	482	8	1	80	0.0125000
NODE_15077_length_730_cov_51.556260	402	482	10	20	80	0.2500000
NODE_15077_length_730_cov_51.556260	402	482	12	47	80	0.5875000
NODE_15078_length_730_cov_39.862124	370	450	0	8	80	0.1000000
NODE_15078_length_730_cov_39.862124	370	450	2	72	80	0.9000000
NODE_15078_length_730_cov_39.862124	423	503	0	61	80	0.7625000
NODE_15078_length_730_cov_39.862124	423	503	2	19	80	0.2375000
NODE_15079_length_730_cov_15.801902	261	341	10	55	80	0.6875000
NODE_15079_length_730_cov_15.801902	261	341	12	11	80	0.1375000
NODE_15079_length_730_cov_15.801902	261	341	14	14	80	0.1750000
NODE_15079_length_730_cov_15.801902	314	394	4	1	80	0.0125000
NODE_15079_length_730_cov_15.801902	314	394	6	41	80	0.5125000
NODE_15079_length_730_cov_15.801902	314	394	10	31	80	0.3875000
NODE_15079_length_730_cov_15.801902	314	394	12	7	80	0.0875000
NODE_15080_length_730_cov_11.746434	242	322	10	80	80	1.0000000
NODE_15080_length_730_cov_11.746434	295	375	2	15	80	0.1875000
NODE_15080_length_730_cov_11.746434	295	375	10	47	80	0.5875000
NODE_15080_length_730_cov_11.746434	295	375	12	18	80	0.2250000
NODE_15081_length_730_cov_9.209192	358	438	0	6	80	0.0750000
NODE_15081_length_730_cov_9.209192	358	438	2	74	80	0.9250000
NODE_15081_length_730_cov_9.209192	411	483	0	5	72	0.0694444
NODE_15081_length_730_cov_9.209192	411	483	2	67	72	0.9305556
NODE_15131_length_729_cov_44.188889	418	498	0	18	80	0.2250000
NODE_15131_length_729_cov_44.188889	418	498	2	26	80	0.3250000
NODE_15131_length_729_cov_44.188889	418	498	3	1	80	0.0125000
NODE_15131_length_729_cov_44.188889	418	498	4	35	80	0.4375000
NODE_15131_length_729_cov_44.188889	471	551	0	71	80	0.8875000
NODE_15131_length_729_cov_44.188889	471	551	2	9	80	0.1125000
NODE_15132_length_729_cov_40.390476	330	410	0	80	80	1.0000000
NODE_15132_length_729_cov_40.390476	383	463	0	80	80	1.0000000
NODE_15133_length_729_cov_35.973016	231	311	0	80	80	1.0000000
NODE_15133_length_729_cov_35.973016	284	363	0	79	79	1.0000000
NODE_15134_length_729_cov_18.357143	170	250	0	6	80	0.0750000
NODE_15134_length_729_cov_18.357143	170	250	8	72	80	0.9000000
NODE_15134_length_729_cov_18.357143	170	250	10	2	80	0.0250000
NODE_15134_length_729_cov_18.357143	223	303	8	25	80	0.3125000
NODE_15134_length_729_cov_18.357143	223	303	10	4	80	0.0500000
NODE_15134_length_729_cov_18.357143	223	303	12	51	80	0.6375000
NODE_15135_length_729_cov_17.928571	194	274	0	80	80	1.0000000
NODE_15135_length_729_cov_17.928571	247	327	0	80	80	1.0000000
NODE_15136_length_729_cov_17.373016	369	449	0	80	80	1.0000000
NODE_15136_length_729_cov_17.373016	422	502	0	80	80	1.0000000
NODE_15137_length_729_cov_12.452381	347	427	0	51	80	0.6375000
NODE_15137_length_729_cov_12.452381	347	427	2	29	80	0.3625000
NODE_15137_length_729_cov_12.452381	400	480	0	12	80	0.1500000
NODE_15137_length_729_cov_12.452381	400	480	2	68	80	0.8500000
NODE_15138_length_729_cov_10.388889	296	376	0	80	80	1.0000000
NODE_15138_length_729_cov_10.388889	349	429	0	80	80	1.0000000
NODE_15185_length_728_cov_23.503975	338	418	0	80	80	1.0000000
NODE_15185_length_728_cov_23.503975	391	471	0	80	80	1.0000000
NODE_15186_length_728_cov_22.496025	310	390	1	26	80	0.3250000
NODE_15186_length_728_cov_22.496025	310	390	3	44	80	0.5500000
NODE_15186_length_728_cov_22.496025	310	390	4	10	80	0.1250000
NODE_15186_length_728_cov_22.496025	363	443	2	48	80	0.6000000
NODE_15186_length_728_cov_22.496025	363	443	3	17	80	0.2125000
NODE_15186_length_728_cov_22.496025	363	443	4	15	80	0.1875000
NODE_15187_length_728_cov_16.596184	257	337	0	80	80	1.0000000
NODE_15187_length_728_cov_16.596184	310	387	0	39	77	0.5064935
NODE_15187_length_728_cov_16.596184	310	387	2	35	77	0.4545455
NODE_15187_length_728_cov_16.596184	310	387	4	3	77	0.0389610
NODE_15188_length_728_cov_16.114467	192	272	0	17	80	0.2125000
NODE_15188_length_728_cov_16.114467	192	272	2	63	80	0.7875000
NODE_15188_length_728_cov_16.114467	245	325	2	80	80	1.0000000
NODE_15189_length_728_cov_15.128776	298	377	0	79	79	1.0000000
NODE_15189_length_728_cov_15.128776	350	430	0	80	80	1.0000000
NODE_15190_length_728_cov_10.613672	269	349	0	80	80	1.0000000
NODE_15190_length_728_cov_10.613672	322	402	0	80	80	1.0000000
NODE_15191_length_728_cov_7.613672	408	488	0	80	80	1.0000000
NODE_15191_length_728_cov_7.613672	461	541	0	80	80	1.0000000
NODE_15196_length_728_cov_3.405405	335	415	0	80	80	1.0000000
NODE_15244_length_727_cov_34.883758	57	137	4	45	80	0.5625000
NODE_15244_length_727_cov_34.883758	57	137	8	11	80	0.1375000
NODE_15244_length_727_cov_34.883758	57	137	10	4	80	0.0500000
NODE_15244_length_727_cov_34.883758	57	137	12	12	80	0.1500000
NODE_15244_length_727_cov_34.883758	57	137	14	8	80	0.1000000
NODE_15244_length_727_cov_34.883758	57	137	4	45	80	0.5625000
NODE_15244_length_727_cov_34.883758	57	137	8	11	80	0.1375000
NODE_15244_length_727_cov_34.883758	57	137	10	4	80	0.0500000
NODE_15244_length_727_cov_34.883758	57	137	12	12	80	0.1500000
NODE_15244_length_727_cov_34.883758	57	137	14	8	80	0.1000000
NODE_15244_length_727_cov_34.883758	57	137	4	45	80	0.5625000
NODE_15244_length_727_cov_34.883758	57	137	8	11	80	0.1375000
NODE_15244_length_727_cov_34.883758	57	137	10	4	80	0.0500000
NODE_15244_length_727_cov_34.883758	57	137	12	12	80	0.1500000
NODE_15244_length_727_cov_34.883758	57	137	14	8	80	0.1000000
NODE_15244_length_727_cov_34.883758	110	190	8	7	80	0.0875000
NODE_15244_length_727_cov_34.883758	110	190	10	19	80	0.2375000
NODE_15244_length_727_cov_34.883758	110	190	12	46	80	0.5750000
NODE_15244_length_727_cov_34.883758	110	190	14	8	80	0.1000000
NODE_15244_length_727_cov_34.883758	110	190	8	7	80	0.0875000
NODE_15244_length_727_cov_34.883758	110	190	10	19	80	0.2375000
NODE_15244_length_727_cov_34.883758	110	190	12	46	80	0.5750000
NODE_15244_length_727_cov_34.883758	110	190	14	8	80	0.1000000
NODE_15245_length_727_cov_32.025478	275	355	4	80	80	1.0000000
NODE_15245_length_727_cov_32.025478	328	408	0	51	80	0.6375000
NODE_15245_length_727_cov_32.025478	328	408	4	29	80	0.3625000
NODE_15246_length_727_cov_28.523885	307	381	0	74	74	1.0000000
NODE_15246_length_727_cov_28.523885	360	381	0	21	21	1.0000000
NODE_15246_length_727_cov_28.523885	378	415	0	37	37	1.0000000
NODE_15247_length_727_cov_25.826433	325	405	0	80	80	1.0000000
NODE_15247_length_727_cov_25.826433	378	458	0	80	80	1.0000000
NODE_15248_length_727_cov_22.253185	150	230	6	39	80	0.4875000
NODE_15248_length_727_cov_22.253185	150	230	8	7	80	0.0875000
NODE_15248_length_727_cov_22.253185	150	230	10	19	80	0.2375000
NODE_15248_length_727_cov_22.253185	150	230	12	2	80	0.0250000
NODE_15248_length_727_cov_22.253185	150	230	14	13	80	0.1625000
NODE_15248_length_727_cov_22.253185	203	283	6	23	80	0.2875000
NODE_15248_length_727_cov_22.253185	203	283	8	11	80	0.1375000
NODE_15248_length_727_cov_22.253185	203	283	10	12	80	0.1500000
NODE_15248_length_727_cov_22.253185	203	283	12	2	80	0.0250000
NODE_15248_length_727_cov_22.253185	203	283	13	1	80	0.0125000
NODE_15248_length_727_cov_22.253185	203	283	14	31	80	0.3875000
NODE_15249_length_727_cov_18.972930	263	343	6	31	80	0.3875000
NODE_15249_length_727_cov_18.972930	263	343	8	28	80	0.3500000
NODE_15249_length_727_cov_18.972930	263	343	9	3	80	0.0375000
NODE_15249_length_727_cov_18.972930	263	343	10	18	80	0.2250000
NODE_15249_length_727_cov_18.972930	316	396	2	17	80	0.2125000
NODE_15249_length_727_cov_18.972930	316	396	8	7	80	0.0875000
NODE_15249_length_727_cov_18.972930	316	396	9	3	80	0.0375000
NODE_15249_length_727_cov_18.972930	316	396	10	53	80	0.6625000
NODE_15250_length_727_cov_15.531847	269	349	2	14	80	0.1750000
NODE_15250_length_727_cov_15.531847	269	349	6	47	80	0.5875000
NODE_15250_length_727_cov_15.531847	269	349	8	19	80	0.2375000
NODE_15250_length_727_cov_15.531847	322	402	6	80	80	1.0000000
NODE_15252_length_727_cov_10.178344	280	360	0	34	80	0.4250000
NODE_15252_length_727_cov_10.178344	280	360	6	26	80	0.3250000
NODE_15252_length_727_cov_10.178344	280	360	8	20	80	0.2500000
NODE_15252_length_727_cov_10.178344	333	413	2	4	80	0.0500000
NODE_15252_length_727_cov_10.178344	333	413	4	3	80	0.0375000
NODE_15252_length_727_cov_10.178344	333	413	6	7	80	0.0875000
NODE_15252_length_727_cov_10.178344	333	413	8	62	80	0.7750000
NODE_15252_length_727_cov_10.178344	333	413	10	4	80	0.0500000
NODE_15258_length_727_cov_4.955414	360	440	0	80	80	1.0000000
NODE_15258_length_727_cov_4.955414	413	493	0	80	80	1.0000000
NODE_15287_length_726_cov_52.923445	415	495	0	22	80	0.2750000
NODE_15287_length_726_cov_52.923445	415	495	2	58	80	0.7250000
NODE_15287_length_726_cov_52.923445	468	548	2	67	80	0.8375000
NODE_15287_length_726_cov_52.923445	468	548	4	13	80	0.1625000
NODE_15288_length_726_cov_35.896332	108	188	0	27	80	0.3375000
NODE_15288_length_726_cov_35.896332	108	188	2	52	80	0.6500000
NODE_15288_length_726_cov_35.896332	108	188	4	1	80	0.0125000
NODE_15288_length_726_cov_35.896332	161	241	2	62	80	0.7750000
NODE_15288_length_726_cov_35.896332	161	241	4	18	80	0.2250000
NODE_15288_length_726_cov_35.896332	237	317	2	78	80	0.9750000
NODE_15288_length_726_cov_35.896332	237	317	4	2	80	0.0250000
NODE_15288_length_726_cov_35.896332	290	370	0	43	80	0.5375000
NODE_15288_length_726_cov_35.896332	290	370	2	37	80	0.4625000
NODE_15291_length_726_cov_8.534290	355	435	0	80	80	1.0000000
NODE_15291_length_726_cov_8.534290	408	488	0	80	80	1.0000000
NODE_15330_length_725_cov_40.856230	203	283	0	80	80	1.0000000
NODE_15330_length_725_cov_40.856230	256	336	0	80	80	1.0000000
NODE_15330_length_725_cov_40.856230	332	412	0	13	80	0.1625000
NODE_15330_length_725_cov_40.856230	332	412	2	14	80	0.1750000
NODE_15330_length_725_cov_40.856230	332	412	6	15	80	0.1875000
NODE_15330_length_725_cov_40.856230	332	412	8	32	80	0.4000000
NODE_15330_length_725_cov_40.856230	332	412	12	6	80	0.0750000
NODE_15330_length_725_cov_40.856230	385	465	6	14	80	0.1750000
NODE_15330_length_725_cov_40.856230	385	465	8	21	80	0.2625000
NODE_15330_length_725_cov_40.856230	385	465	10	29	80	0.3625000
NODE_15330_length_725_cov_40.856230	385	465	12	16	80	0.2000000
NODE_15331_length_725_cov_25.036741	366	446	0	19	80	0.2375000
NODE_15331_length_725_cov_25.036741	366	446	4	61	80	0.7625000
NODE_15331_length_725_cov_25.036741	419	499	4	76	80	0.9500000
NODE_15331_length_725_cov_25.036741	419	499	6	4	80	0.0500000
NODE_15332_length_725_cov_23.009585	455	536	0	81	81	1.0000000
NODE_15333_length_725_cov_20.474441	112	192	0	33	80	0.4125000
NODE_15333_length_725_cov_20.474441	112	192	6	8	80	0.1000000
NODE_15333_length_725_cov_20.474441	112	192	8	12	80	0.1500000
NODE_15333_length_725_cov_20.474441	112	192	10	12	80	0.1500000
NODE_15333_length_725_cov_20.474441	112	192	12	15	80	0.1875000
NODE_15333_length_725_cov_20.474441	165	245	9	1	80	0.0125000
NODE_15333_length_725_cov_20.474441	165	245	10	48	80	0.6000000
NODE_15333_length_725_cov_20.474441	165	245	12	31	80	0.3875000
NODE_15334_length_725_cov_15.455272	106	186	0	80	80	1.0000000
NODE_15334_length_725_cov_15.455272	159	239	0	80	80	1.0000000
NODE_15334_length_725_cov_15.455272	235	315	0	12	80	0.1500000
NODE_15334_length_725_cov_15.455272	235	315	2	32	80	0.4000000
NODE_15334_length_725_cov_15.455272	235	315	4	36	80	0.4500000
NODE_15334_length_725_cov_15.455272	288	368	0	15	80	0.1875000
NODE_15334_length_725_cov_15.455272	288	368	2	25	80	0.3125000
NODE_15334_length_725_cov_15.455272	288	368	4	40	80	0.5000000
NODE_15335_length_725_cov_10.426518	289	369	0	76	80	0.9500000
NODE_15335_length_725_cov_10.426518	289	369	2	4	80	0.0500000
NODE_15335_length_725_cov_10.426518	342	422	0	23	80	0.2875000
NODE_15335_length_725_cov_10.426518	342	422	2	17	80	0.2125000
NODE_15335_length_725_cov_10.426518	342	422	6	40	80	0.5000000
NODE_15337_length_725_cov_7.781150	189	269	0	80	80	1.0000000
NODE_15337_length_725_cov_7.781150	242	322	0	80	80	1.0000000
NODE_15388_length_724_cov_28.132800	354	434	2	26	80	0.3250000
NODE_15388_length_724_cov_28.132800	354	434	6	5	80	0.0625000
NODE_15388_length_724_cov_28.132800	354	434	10	49	80	0.6125000
NODE_15388_length_724_cov_28.132800	407	473	4	18	66	0.2727273
NODE_15388_length_724_cov_28.132800	407	473	6	17	66	0.2575758
NODE_15388_length_724_cov_28.132800	407	473	10	31	66	0.4696970
NODE_15389_length_724_cov_24.710400	376	461	0	85	85	1.0000000
NODE_15389_length_724_cov_24.710400	434	514	0	80	80	1.0000000
NODE_15390_length_724_cov_13.960000	152	232	0	80	80	1.0000000
NODE_15390_length_724_cov_13.960000	205	248	0	43	43	1.0000000
NODE_15390_length_724_cov_13.960000	237	286	0	49	49	1.0000000
NODE_15390_length_724_cov_13.960000	259	302	0	43	43	1.0000000
NODE_15390_length_724_cov_13.960000	288	340	0	28	52	0.5384616
NODE_15390_length_724_cov_13.960000	288	340	2	24	52	0.4615385
NODE_15390_length_724_cov_13.960000	313	393	0	3	80	0.0375000
NODE_15390_length_724_cov_13.960000	313	393	2	77	80	0.9625000
NODE_15391_length_724_cov_13.065600	215	295	0	61	80	0.7625000
NODE_15391_length_724_cov_13.065600	215	295	4	19	80	0.2375000
NODE_15391_length_724_cov_13.065600	268	347	0	8	79	0.1012658
NODE_15391_length_724_cov_13.065600	268	347	4	71	79	0.8987342
NODE_15393_length_724_cov_10.358400	257	337	0	76	80	0.9500000
NODE_15393_length_724_cov_10.358400	257	337	4	4	80	0.0500000
NODE_15393_length_724_cov_10.358400	310	385	0	30	75	0.4000000
NODE_15393_length_724_cov_10.358400	310	385	4	45	75	0.6000000
NODE_15396_length_724_cov_6.451200	151	231	0	38	80	0.4750000
NODE_15396_length_724_cov_6.451200	151	231	2	42	80	0.5250000
NODE_15396_length_724_cov_6.451200	202	282	2	80	80	1.0000000
NODE_15397_length_724_cov_5.921600	165	213	0	6	48	0.1250000
NODE_15397_length_724_cov_5.921600	165	213	1	29	48	0.6041667
NODE_15397_length_724_cov_5.921600	165	213	2	13	48	0.2708333
NODE_15399_length_724_cov_5.028800	416	469	0	10	53	0.1886792
NODE_15399_length_724_cov_5.028800	416	469	2	43	53	0.8113208
NODE_15399_length_724_cov_5.028800	488	526	0	23	38	0.6052632
NODE_15399_length_724_cov_5.028800	488	526	2	15	38	0.3947369
NODE_15403_length_724_cov_3.315200	166	246	0	80	80	1.0000000
NODE_15403_length_724_cov_3.315200	219	299	0	80	80	1.0000000
NODE_15442_length_723_cov_81.453526	205	285	0	55	80	0.6875000
NODE_15442_length_723_cov_81.453526	205	285	8	25	80	0.3125000
NODE_15442_length_723_cov_81.453526	258	338	0	2	80	0.0250000
NODE_15442_length_723_cov_81.453526	258	338	5	20	80	0.2500000
NODE_15442_length_723_cov_81.453526	258	338	6	8	80	0.1000000
NODE_15442_length_723_cov_81.453526	258	338	7	8	80	0.1000000
NODE_15442_length_723_cov_81.453526	258	338	8	42	80	0.5250000
NODE_15443_length_723_cov_33.075321	254	329	0	12	75	0.1600000
NODE_15443_length_723_cov_33.075321	254	329	4	63	75	0.8400000
NODE_15443_length_723_cov_33.075321	307	387	4	26	80	0.3250000
NODE_15443_length_723_cov_33.075321	307	387	5	16	80	0.2000000
NODE_15443_length_723_cov_33.075321	307	387	6	38	80	0.4750000
NODE_15444_length_723_cov_25.410256	291	371	0	6	80	0.0750000
NODE_15444_length_723_cov_25.410256	291	371	2	22	80	0.2750000
NODE_15444_length_723_cov_25.410256	291	371	4	52	80	0.6500000
NODE_15444_length_723_cov_25.410256	344	424	2	65	80	0.8125000
NODE_15444_length_723_cov_25.410256	344	424	4	15	80	0.1875000
NODE_15445_length_723_cov_18.097756	233	313	0	35	80	0.4375000
NODE_15445_length_723_cov_18.097756	233	313	2	4	80	0.0500000
NODE_15445_length_723_cov_18.097756	233	313	4	41	80	0.5125000
NODE_15445_length_723_cov_18.097756	286	351	2	3	65	0.0461538
NODE_15445_length_723_cov_18.097756	286	351	4	62	65	0.9538462
NODE_15446_length_723_cov_14.113782	311	391	0	80	80	1.0000000
NODE_15446_length_723_cov_14.113782	364	444	0	80	80	1.0000000
NODE_15447_length_723_cov_11.634615	299	379	0	80	80	1.0000000
NODE_15447_length_723_cov_11.634615	352	432	0	80	80	1.0000000
NODE_15448_length_723_cov_8.342949	357	437	0	34	80	0.4250000
NODE_15448_length_723_cov_8.342949	357	437	2	46	80	0.5750000
NODE_15448_length_723_cov_8.342949	410	490	0	74	80	0.9250000
NODE_15448_length_723_cov_8.342949	410	490	2	6	80	0.0750000
NODE_15455_length_723_cov_2.711538	379	422	0	43	43	1.0000000
NODE_15459_length_723_cov_2.573718	383	413	2	11	30	0.3666667
NODE_15459_length_723_cov_2.573718	383	413	4	19	30	0.6333333
NODE_15495_length_722_cov_19.182986	180	260	0	69	80	0.8625000
NODE_15495_length_722_cov_19.182986	180	260	2	11	80	0.1375000
NODE_15495_length_722_cov_19.182986	233	313	0	20	80	0.2500000
NODE_15495_length_722_cov_19.182986	233	313	2	60	80	0.7500000
NODE_15496_length_722_cov_13.582665	192	272	0	80	80	1.0000000
NODE_15496_length_722_cov_13.582665	245	326	0	66	81	0.8148148
NODE_15496_length_722_cov_13.582665	245	326	2	15	81	0.1851852
NODE_15497_length_722_cov_9.202247	347	427	0	1	80	0.0125000
NODE_15497_length_722_cov_9.202247	347	427	2	79	80	0.9875000
NODE_15497_length_722_cov_9.202247	400	480	0	54	80	0.6750000
NODE_15497_length_722_cov_9.202247	400	480	2	26	80	0.3250000
NODE_15500_length_722_cov_6.707865	343	423	0	80	80	1.0000000
NODE_15500_length_722_cov_6.707865	396	476	0	80	80	1.0000000
NODE_15504_length_722_cov_4.985554	332	393	0	61	61	1.0000000
NODE_15508_length_722_cov_3.977528	217	297	0	4	80	0.0500000
NODE_15508_length_722_cov_3.977528	217	297	2	37	80	0.4625000
NODE_15508_length_722_cov_3.977528	217	297	4	39	80	0.4875000
NODE_15508_length_722_cov_3.977528	270	350	0	57	80	0.7125000
NODE_15508_length_722_cov_3.977528	270	350	2	23	80	0.2875000
NODE_15553_length_721_cov_105.927653	425	505	0	80	80	1.0000000
NODE_15553_length_721_cov_105.927653	478	558	0	80	80	1.0000000
NODE_15554_length_721_cov_49.660772	304	384	0	80	80	1.0000000
NODE_15554_length_721_cov_49.660772	357	437	0	80	80	1.0000000
NODE_15555_length_721_cov_46.991961	341	421	0	10	80	0.1250000
NODE_15555_length_721_cov_46.991961	341	421	2	18	80	0.2250000
NODE_15555_length_721_cov_46.991961	341	421	23	1	80	0.0125000
NODE_15555_length_721_cov_46.991961	341	421	24	24	80	0.3000000
NODE_15555_length_721_cov_46.991961	341	421	25	3	80	0.0375000
NODE_15555_length_721_cov_46.991961	341	421	26	24	80	0.3000000
NODE_15555_length_721_cov_46.991961	394	474	2	13	80	0.1625000
NODE_15555_length_721_cov_46.991961	394	474	24	32	80	0.4000000
NODE_15555_length_721_cov_46.991961	394	474	25	3	80	0.0375000
NODE_15555_length_721_cov_46.991961	394	474	26	32	80	0.4000000
NODE_15556_length_721_cov_38.864952	208	288	0	80	80	1.0000000
NODE_15556_length_721_cov_38.864952	269	341	0	72	72	1.0000000
NODE_15556_length_721_cov_38.864952	337	417	0	80	80	1.0000000
NODE_15556_length_721_cov_38.864952	390	467	0	77	77	1.0000000
NODE_15557_length_721_cov_29.016077	192	272	2	80	80	1.0000000
NODE_15557_length_721_cov_29.016077	251	325	0	39	74	0.5270270
NODE_15557_length_721_cov_29.016077	251	325	2	35	74	0.4729730
NODE_15558_length_721_cov_26.196141	398	478	0	32	80	0.4000000
NODE_15558_length_721_cov_26.196141	398	478	2	48	80	0.6000000
NODE_15558_length_721_cov_26.196141	451	531	2	63	80	0.7875000
NODE_15558_length_721_cov_26.196141	451	531	4	17	80	0.2125000
NODE_15560_length_721_cov_20.054662	178	258	2	8	80	0.1000000
NODE_15560_length_721_cov_20.054662	178	258	7	2	80	0.0250000
NODE_15560_length_721_cov_20.054662	178	258	8	67	80	0.8375000
NODE_15560_length_721_cov_20.054662	178	258	9	3	80	0.0375000
NODE_15560_length_721_cov_20.054662	231	311	0	18	80	0.2250000
NODE_15560_length_721_cov_20.054662	231	311	8	62	80	0.7750000
NODE_15561_length_721_cov_13.670418	263	343	0	3	80	0.0375000
NODE_15561_length_721_cov_13.670418	263	343	2	27	80	0.3375000
NODE_15561_length_721_cov_13.670418	263	343	4	50	80	0.6250000
NODE_15561_length_721_cov_13.670418	316	396	0	55	80	0.6875000
NODE_15561_length_721_cov_13.670418	316	396	2	1	80	0.0125000
NODE_15561_length_721_cov_13.670418	316	396	4	24	80	0.3000000
NODE_15562_length_721_cov_13.652733	268	350	0	11	82	0.1341463
NODE_15562_length_721_cov_13.652733	268	350	2	71	82	0.8658537
NODE_15562_length_721_cov_13.652733	321	403	0	64	82	0.7804878
NODE_15562_length_721_cov_13.652733	321	403	2	18	82	0.2195122
NODE_15563_length_721_cov_13.120579	312	392	0	24	80	0.3000000
NODE_15563_length_721_cov_13.120579	312	392	2	26	80	0.3250000
NODE_15563_length_721_cov_13.120579	312	392	6	4	80	0.0500000
NODE_15563_length_721_cov_13.120579	312	392	8	26	80	0.3250000
NODE_15563_length_721_cov_13.120579	365	445	6	1	80	0.0125000
NODE_15563_length_721_cov_13.120579	365	445	8	29	80	0.3625000
NODE_15563_length_721_cov_13.120579	365	445	12	50	80	0.6250000
NODE_15572_length_721_cov_4.491961	210	280	0	2	70	0.0285714
NODE_15572_length_721_cov_4.491961	210	280	2	68	70	0.9714286
NODE_15572_length_721_cov_4.491961	253	333	0	27	80	0.3375000
NODE_15572_length_721_cov_4.491961	253	333	2	53	80	0.6625000
NODE_15572_length_721_cov_4.491961	470	521	0	51	51	1.0000000
NODE_15608_length_720_cov_17.449275	267	347	0	43	80	0.5375000
NODE_15608_length_720_cov_17.449275	267	347	2	16	80	0.2000000
NODE_15608_length_720_cov_17.449275	267	347	4	21	80	0.2625000
NODE_15608_length_720_cov_17.449275	320	400	2	6	80	0.0750000
NODE_15608_length_720_cov_17.449275	320	400	4	56	80	0.7000000
NODE_15608_length_720_cov_17.449275	320	400	6	18	80	0.2250000
NODE_15609_length_720_cov_14.814815	261	341	0	14	80	0.1750000
NODE_15609_length_720_cov_14.814815	261	341	2	5	80	0.0625000
NODE_15609_length_720_cov_14.814815	261	341	6	61	80	0.7625000
NODE_15609_length_720_cov_14.814815	314	394	0	17	80	0.2125000
NODE_15609_length_720_cov_14.814815	314	394	2	27	80	0.3375000
NODE_15609_length_720_cov_14.814815	314	394	6	36	80	0.4500000
NODE_15610_length_720_cov_14.107890	290	370	0	80	80	1.0000000
NODE_15610_length_720_cov_14.107890	343	423	0	80	80	1.0000000
NODE_15612_length_720_cov_12.924316	314	394	0	13	80	0.1625000
NODE_15612_length_720_cov_12.924316	314	394	2	31	80	0.3875000
NODE_15612_length_720_cov_12.924316	314	394	6	5	80	0.0625000
NODE_15612_length_720_cov_12.924316	314	394	8	31	80	0.3875000
NODE_15612_length_720_cov_12.924316	367	447	2	4	80	0.0500000
NODE_15612_length_720_cov_12.924316	367	447	6	5	80	0.0625000
NODE_15612_length_720_cov_12.924316	367	447	8	71	80	0.8875000
NODE_15614_length_720_cov_10.389694	435	515	6	80	80	1.0000000
NODE_15614_length_720_cov_10.389694	488	568	0	14	80	0.1750000
NODE_15614_length_720_cov_10.389694	488	568	2	34	80	0.4250000
NODE_15614_length_720_cov_10.389694	488	568	6	32	80	0.4000000
NODE_15620_length_720_cov_5.278583	309	389	2	38	80	0.4750000
NODE_15620_length_720_cov_5.278583	309	389	4	42	80	0.5250000
NODE_15620_length_720_cov_5.278583	362	442	0	10	80	0.1250000
NODE_15620_length_720_cov_5.278583	362	442	2	35	80	0.4375000
NODE_15620_length_720_cov_5.278583	362	442	4	35	80	0.4375000
NODE_15624_length_720_cov_3.792271	157	235	0	78	78	1.0000000
NODE_15624_length_720_cov_3.792271	215	265	0	50	50	1.0000000
NODE_15658_length_719_cov_30.256452	279	359	0	80	80	1.0000000
NODE_15658_length_719_cov_30.256452	332	412	0	80	80	1.0000000
NODE_15659_length_719_cov_29.093548	310	390	0	76	80	0.9500000
NODE_15659_length_719_cov_29.093548	310	390	2	4	80	0.0500000
NODE_15659_length_719_cov_29.093548	363	443	0	23	80	0.2875000
NODE_15659_length_719_cov_29.093548	363	443	2	57	80	0.7125000
NODE_15660_length_719_cov_10.988710	195	275	0	80	80	1.0000000
NODE_15660_length_719_cov_10.988710	248	328	0	80	80	1.0000000
NODE_15661_length_719_cov_10.837097	259	339	0	57	80	0.7125000
NODE_15661_length_719_cov_10.837097	259	339	2	23	80	0.2875000
NODE_15661_length_719_cov_10.837097	312	392	0	6	80	0.0750000
NODE_15661_length_719_cov_10.837097	312	392	2	74	80	0.9250000
NODE_15662_length_719_cov_7.622581	288	368	1	23	80	0.2875000
NODE_15662_length_719_cov_7.622581	288	368	2	38	80	0.4750000
NODE_15662_length_719_cov_7.622581	288	368	6	19	80	0.2375000
NODE_15662_length_719_cov_7.622581	341	421	2	8	80	0.1000000
NODE_15662_length_719_cov_7.622581	341	421	6	72	80	0.9000000
NODE_15663_length_719_cov_7.570968	351	431	0	38	80	0.4750000
NODE_15663_length_719_cov_7.570968	351	431	2	42	80	0.5250000
NODE_15663_length_719_cov_7.570968	404	484	0	80	80	1.0000000
NODE_15672_length_719_cov_4.264516	251	281	2	4	30	0.1333333
NODE_15672_length_719_cov_4.264516	251	281	4	26	30	0.8666667
NODE_15684_length_719_cov_1.629032	88	163	2	53	75	0.7066666
NODE_15684_length_719_cov_1.629032	88	163	6	8	75	0.1066667
NODE_15684_length_719_cov_1.629032	88	163	8	7	75	0.0933333
NODE_15684_length_719_cov_1.629032	88	163	10	7	75	0.0933333
NODE_15706_length_718_cov_35.382876	296	376	0	80	80	1.0000000
NODE_15706_length_718_cov_35.382876	296	376	0	80	80	1.0000000
NODE_15706_length_718_cov_35.382876	349	429	0	80	80	1.0000000
NODE_15706_length_718_cov_35.382876	349	429	0	80	80	1.0000000
NODE_15707_length_718_cov_24.211632	313	393	0	80	80	1.0000000
NODE_15707_length_718_cov_24.211632	366	446	0	80	80	1.0000000
NODE_15708_length_718_cov_18.300485	217	297	0	35	80	0.4375000
NODE_15708_length_718_cov_18.300485	217	297	2	1	80	0.0125000
NODE_15708_length_718_cov_18.300485	217	297	4	44	80	0.5500000
NODE_15708_length_718_cov_18.300485	270	350	0	5	80	0.0625000
NODE_15708_length_718_cov_18.300485	270	350	2	47	80	0.5875000
NODE_15708_length_718_cov_18.300485	270	350	4	28	80	0.3500000
NODE_15709_length_718_cov_14.757674	383	463	0	80	80	1.0000000
NODE_15709_length_718_cov_14.757674	436	516	0	27	80	0.3375000
NODE_15709_length_718_cov_14.757674	436	516	2	53	80	0.6625000
NODE_15710_length_718_cov_14.355412	254	334	0	35	80	0.4375000
NODE_15710_length_718_cov_14.355412	254	334	4	45	80	0.5625000
NODE_15710_length_718_cov_14.355412	307	387	0	3	80	0.0375000
NODE_15710_length_718_cov_14.355412	307	387	4	77	80	0.9625000
NODE_15715_length_718_cov_4.804523	263	343	0	80	80	1.0000000
NODE_15715_length_718_cov_4.804523	316	396	0	80	80	1.0000000
NODE_15750_length_717_cov_28.377023	335	415	4	11	80	0.1375000
NODE_15750_length_717_cov_28.377023	335	415	6	69	80	0.8625000
NODE_15750_length_717_cov_28.377023	388	468	0	49	80	0.6125000
NODE_15750_length_717_cov_28.377023	388	468	4	15	80	0.1875000
NODE_15750_length_717_cov_28.377023	388	468	6	16	80	0.2000000
NODE_15751_length_717_cov_23.275081	162	242	0	80	80	1.0000000
NODE_15751_length_717_cov_23.275081	215	295	0	80	80	1.0000000
NODE_15752_length_717_cov_18.564725	319	399	0	52	80	0.6500000
NODE_15752_length_717_cov_18.564725	319	399	2	28	80	0.3500000
NODE_15752_length_717_cov_18.564725	372	452	2	52	80	0.6500000
NODE_15752_length_717_cov_18.564725	372	452	4	28	80	0.3500000
NODE_15753_length_717_cov_18.389968	358	438	0	46	80	0.5750000
NODE_15753_length_717_cov_18.389968	358	438	2	34	80	0.4250000
NODE_15753_length_717_cov_18.389968	411	491	0	30	80	0.3750000
NODE_15753_length_717_cov_18.389968	411	491	2	50	80	0.6250000
NODE_15754_length_717_cov_17.932039	241	321	6	15	80	0.1875000
NODE_15754_length_717_cov_17.932039	241	321	10	11	80	0.1375000
NODE_15754_length_717_cov_17.932039	241	321	12	25	80	0.3125000
NODE_15754_length_717_cov_17.932039	241	321	14	29	80	0.3625000
NODE_15754_length_717_cov_17.932039	294	374	2	5	80	0.0625000
NODE_15754_length_717_cov_17.932039	294	374	4	8	80	0.1000000
NODE_15754_length_717_cov_17.932039	294	374	6	28	80	0.3500000
NODE_15754_length_717_cov_17.932039	294	374	7	1	80	0.0125000
NODE_15754_length_717_cov_17.932039	294	374	8	26	80	0.3250000
NODE_15754_length_717_cov_17.932039	294	374	14	12	80	0.1500000
NODE_15755_length_717_cov_14.637540	298	378	0	3	80	0.0375000
NODE_15755_length_717_cov_14.637540	298	378	2	77	80	0.9625000
NODE_15755_length_717_cov_14.637540	351	431	0	42	80	0.5250000
NODE_15755_length_717_cov_14.637540	351	431	2	38	80	0.4750000
NODE_15756_length_717_cov_12.279935	113	196	0	83	83	1.0000000
NODE_15756_length_717_cov_12.279935	169	249	0	80	80	1.0000000
NODE_15757_length_717_cov_10.711974	353	431	0	2	78	0.0256410
NODE_15757_length_717_cov_10.711974	353	431	2	27	78	0.3461539
NODE_15757_length_717_cov_10.711974	353	431	7	37	78	0.4743590
NODE_15757_length_717_cov_10.711974	353	431	9	7	78	0.0897436
NODE_15757_length_717_cov_10.711974	353	431	10	5	78	0.0641026
NODE_15758_length_717_cov_9.399676	331	411	0	80	80	1.0000000
NODE_15758_length_717_cov_9.399676	384	464	0	80	80	1.0000000
NODE_15762_length_717_cov_5.341424	475	555	0	80	80	1.0000000
NODE_15762_length_717_cov_5.341424	528	608	0	80	80	1.0000000
NODE_15770_length_717_cov_3.187702	285	322	0	37	37	1.0000000
NODE_15805_length_716_cov_16.800648	430	510	0	80	80	1.0000000
NODE_15805_length_716_cov_16.800648	483	563	0	80	80	1.0000000
NODE_15806_length_716_cov_12.565640	356	436	0	80	80	1.0000000
NODE_15806_length_716_cov_12.565640	409	489	0	80	80	1.0000000
NODE_15807_length_716_cov_9.277147	385	465	0	69	80	0.8625000
NODE_15807_length_716_cov_9.277147	385	465	2	11	80	0.1375000
NODE_15807_length_716_cov_9.277147	438	518	0	16	80	0.2000000
NODE_15807_length_716_cov_9.277147	438	518	2	64	80	0.8000000
NODE_15808_length_716_cov_9.257699	302	382	0	4	80	0.0500000
NODE_15808_length_716_cov_9.257699	302	382	2	76	80	0.9500000
NODE_15808_length_716_cov_9.257699	355	435	0	57	80	0.7125000
NODE_15808_length_716_cov_9.257699	355	435	2	23	80	0.2875000
NODE_15809_length_716_cov_6.761750	263	343	0	80	80	1.0000000
NODE_15809_length_716_cov_6.761750	316	396	0	80	80	1.0000000
NODE_15812_length_716_cov_4.909238	236	316	0	80	80	1.0000000
NODE_15812_length_716_cov_4.909238	289	369	0	80	80	1.0000000
NODE_15824_length_716_cov_2.068071	453	481	0	28	28	1.0000000
NODE_15853_length_715_cov_38.795455	260	340	0	80	80	1.0000000
NODE_15853_length_715_cov_38.795455	313	393	0	80	80	1.0000000
NODE_15854_length_715_cov_30.344156	316	396	0	42	80	0.5250000
NODE_15854_length_715_cov_30.344156	316	396	2	38	80	0.4750000
NODE_15854_length_715_cov_30.344156	369	449	0	33	80	0.4125000
NODE_15854_length_715_cov_30.344156	369	449	2	47	80	0.5875000
NODE_15857_length_715_cov_11.209416	484	564	0	80	80	1.0000000
NODE_15857_length_715_cov_11.209416	537	617	0	80	80	1.0000000
NODE_15858_length_715_cov_10.894481	189	242	0	3	53	0.0566038
NODE_15858_length_715_cov_10.894481	189	242	2	50	53	0.9433962
NODE_15859_length_715_cov_10.628247	502	582	0	80	80	1.0000000
NODE_15859_length_715_cov_10.628247	555	635	0	80	80	1.0000000
NODE_15860_length_715_cov_8.647727	138	218	0	53	80	0.6625000
NODE_15860_length_715_cov_8.647727	138	218	2	27	80	0.3375000
NODE_15860_length_715_cov_8.647727	191	271	0	7	80	0.0875000
NODE_15860_length_715_cov_8.647727	191	271	2	73	80	0.9125000
NODE_15861_length_715_cov_8.412338	364	444	0	52	80	0.6500000
NODE_15861_length_715_cov_8.412338	364	444	2	9	80	0.1125000
NODE_15861_length_715_cov_8.412338	364	444	4	19	80	0.2375000
NODE_15861_length_715_cov_8.412338	417	497	2	11	80	0.1375000
NODE_15861_length_715_cov_8.412338	417	497	4	69	80	0.8625000
NODE_15864_length_715_cov_5.373377	318	398	0	80	80	1.0000000
NODE_15864_length_715_cov_5.373377	371	451	0	80	80	1.0000000
NODE_15898_length_715_cov_1.271104	331	397	0	13	66	0.1969697
NODE_15898_length_715_cov_1.271104	331	397	2	53	66	0.8030303
NODE_15910_length_714_cov_18.621138	297	377	2	4	80	0.0500000
NODE_15910_length_714_cov_18.621138	297	377	4	20	80	0.2500000
NODE_15910_length_714_cov_18.621138	297	377	6	49	80	0.6125000
NODE_15910_length_714_cov_18.621138	297	377	8	7	80	0.0875000
NODE_15910_length_714_cov_18.621138	350	430	0	21	80	0.2625000
NODE_15910_length_714_cov_18.621138	350	430	2	36	80	0.4500000
NODE_15910_length_714_cov_18.621138	350	430	4	19	80	0.2375000
NODE_15910_length_714_cov_18.621138	350	430	6	4	80	0.0500000
NODE_15911_length_714_cov_15.468293	268	348	2	25	80	0.3125000
NODE_15911_length_714_cov_15.468293	268	348	4	55	80	0.6875000
NODE_15911_length_714_cov_15.468293	321	401	0	26	80	0.3250000
NODE_15911_length_714_cov_15.468293	321	401	1	1	80	0.0125000
NODE_15911_length_714_cov_15.468293	321	401	2	51	80	0.6375000
NODE_15911_length_714_cov_15.468293	321	401	4	2	80	0.0250000
NODE_15913_length_714_cov_10.530081	218	298	4	80	80	1.0000000
NODE_15913_length_714_cov_10.530081	271	351	0	47	80	0.5875000
NODE_15913_length_714_cov_10.530081	271	351	2	1	80	0.0125000
NODE_15913_length_714_cov_10.530081	271	351	4	32	80	0.4000000
NODE_15913_length_714_cov_10.530081	354	434	0	80	80	1.0000000
NODE_15913_length_714_cov_10.530081	407	487	0	80	80	1.0000000
NODE_15914_length_714_cov_8.365854	285	365	0	80	80	1.0000000
NODE_15914_length_714_cov_8.365854	338	418	0	80	80	1.0000000
NODE_15919_length_714_cov_6.993496	263	343	11	12	80	0.1500000
NODE_15919_length_714_cov_6.993496	263	343	13	9	80	0.1125000
NODE_15919_length_714_cov_6.993496	263	343	14	31	80	0.3875000
NODE_15919_length_714_cov_6.993496	263	343	15	5	80	0.0625000
NODE_15919_length_714_cov_6.993496	263	343	16	23	80	0.2875000
NODE_15919_length_714_cov_6.993496	316	384	0	10	68	0.1470588
NODE_15919_length_714_cov_6.993496	316	384	2	12	68	0.1764706
NODE_15919_length_714_cov_6.993496	316	384	9	6	68	0.0882353
NODE_15919_length_714_cov_6.993496	316	384	11	25	68	0.3676471
NODE_15919_length_714_cov_6.993496	316	384	13	9	68	0.1323529
NODE_15919_length_714_cov_6.993496	316	384	15	5	68	0.0735294
NODE_15919_length_714_cov_6.993496	316	384	16	1	68	0.0147059
NODE_15921_length_714_cov_4.224390	218	288	0	70	70	1.0000000
NODE_15921_length_714_cov_4.224390	271	351	0	80	80	1.0000000
NODE_15969_length_713_cov_19.304560	271	351	0	8	80	0.1000000
NODE_15969_length_713_cov_19.304560	271	351	2	64	80	0.8000000
NODE_15969_length_713_cov_19.304560	271	351	4	8	80	0.1000000
NODE_15969_length_713_cov_19.304560	324	404	0	61	80	0.7625000
NODE_15969_length_713_cov_19.304560	324	404	2	19	80	0.2375000
NODE_15970_length_713_cov_16.926710	262	342	0	35	80	0.4375000
NODE_15970_length_713_cov_16.926710	262	342	2	45	80	0.5625000
NODE_15970_length_713_cov_16.926710	315	395	0	10	80	0.1250000
NODE_15970_length_713_cov_16.926710	315	395	2	70	80	0.8750000
NODE_15973_length_713_cov_7.159609	351	431	0	80	80	1.0000000
NODE_15973_length_713_cov_7.159609	404	484	0	62	80	0.7750000
NODE_15973_length_713_cov_7.159609	404	484	2	18	80	0.2250000
NODE_15974_length_713_cov_6.723127	379	427	16	8	48	0.1666667
NODE_15974_length_713_cov_6.723127	379	427	18	11	48	0.2291667
NODE_15974_length_713_cov_6.723127	379	427	20	29	48	0.6041667
NODE_15975_length_713_cov_4.954397	90	171	0	81	81	1.0000000
NODE_15975_length_713_cov_4.954397	144	224	0	80	80	1.0000000
NODE_15980_length_713_cov_4.302932	402	482	0	80	80	1.0000000
NODE_15980_length_713_cov_4.302932	455	535	0	80	80	1.0000000
NODE_16004_length_713_cov_1.939739	15	75	0	60	60	1.0000000
NODE_16010_length_713_cov_1.605863	81	161	0	32	80	0.4000000
NODE_16010_length_713_cov_1.605863	81	161	2	48	80	0.6000000
NODE_16010_length_713_cov_1.605863	134	214	0	11	80	0.1375000
NODE_16010_length_713_cov_1.605863	134	214	2	69	80	0.8625000
NODE_16052_length_712_cov_32.931485	289	369	0	80	80	1.0000000
NODE_16052_length_712_cov_32.931485	342	422	0	80	80	1.0000000
NODE_16053_length_712_cov_31.752039	185	251	0	66	66	1.0000000
NODE_16053_length_712_cov_31.752039	228	307	0	79	79	1.0000000
NODE_16054_length_712_cov_22.567700	228	308	0	80	80	1.0000000
NODE_16054_length_712_cov_22.567700	281	361	0	29	80	0.3625000
NODE_16054_length_712_cov_22.567700	281	361	4	51	80	0.6375000
NODE_16055_length_712_cov_19.306688	238	318	2	42	80	0.5250000
NODE_16055_length_712_cov_19.306688	238	318	4	14	80	0.1750000
NODE_16055_length_712_cov_19.306688	238	318	6	24	80	0.3000000
NODE_16055_length_712_cov_19.306688	291	371	1	16	80	0.2000000
NODE_16055_length_712_cov_19.306688	291	371	4	44	80	0.5500000
NODE_16055_length_712_cov_19.306688	291	371	5	7	80	0.0875000
NODE_16055_length_712_cov_19.306688	291	371	6	13	80	0.1625000
NODE_16056_length_712_cov_14.929853	332	412	0	1	80	0.0125000
NODE_16056_length_712_cov_14.929853	332	412	9	3	80	0.0375000
NODE_16056_length_712_cov_14.929853	332	412	10	76	80	0.9500000
NODE_16056_length_712_cov_14.929853	385	465	0	54	80	0.6750000
NODE_16056_length_712_cov_14.929853	385	465	9	3	80	0.0375000
NODE_16056_length_712_cov_14.929853	385	465	10	23	80	0.2875000
NODE_16057_length_712_cov_14.228385	250	330	0	80	80	1.0000000
NODE_16057_length_712_cov_14.228385	303	383	0	80	80	1.0000000
NODE_16059_length_712_cov_9.221860	326	406	0	22	80	0.2750000
NODE_16059_length_712_cov_9.221860	326	406	2	58	80	0.7250000
NODE_16059_length_712_cov_9.221860	379	463	0	79	84	0.9404762
NODE_16059_length_712_cov_9.221860	379	463	2	5	84	0.0595238
NODE_16060_length_712_cov_8.368679	331	411	0	80	80	1.0000000
NODE_16060_length_712_cov_8.368679	384	464	0	80	80	1.0000000
NODE_16079_length_712_cov_2.350734	466	510	0	44	44	1.0000000
NODE_16118_length_711_cov_36.459150	146	223	2	77	77	1.0000000
NODE_16118_length_711_cov_36.459150	199	280	0	42	81	0.5185185
NODE_16118_length_711_cov_36.459150	199	280	2	39	81	0.4814815
NODE_16119_length_711_cov_26.702614	460	540	6	9	80	0.1125000
NODE_16119_length_711_cov_26.702614	460	540	8	71	80	0.8875000
NODE_16119_length_711_cov_26.702614	513	593	0	34	80	0.4250000
NODE_16119_length_711_cov_26.702614	513	593	6	26	80	0.3250000
NODE_16119_length_711_cov_26.702614	513	593	8	20	80	0.2500000
NODE_16120_length_711_cov_19.632353	329	409	0	36	80	0.4500000
NODE_16120_length_711_cov_19.632353	329	409	2	44	80	0.5500000
NODE_16120_length_711_cov_19.632353	382	462	0	30	80	0.3750000
NODE_16120_length_711_cov_19.632353	382	462	2	50	80	0.6250000
NODE_16121_length_711_cov_19.267974	283	363	4	3	80	0.0375000
NODE_16121_length_711_cov_19.267974	283	363	6	77	80	0.9625000
NODE_16121_length_711_cov_19.267974	336	416	0	15	80	0.1875000
NODE_16121_length_711_cov_19.267974	336	416	4	41	80	0.5125000
NODE_16121_length_711_cov_19.267974	336	416	6	24	80	0.3000000
NODE_16122_length_711_cov_12.813725	255	334	0	79	79	1.0000000
NODE_16123_length_711_cov_12.147059	314	394	0	73	80	0.9125000
NODE_16123_length_711_cov_12.147059	314	394	2	7	80	0.0875000
NODE_16123_length_711_cov_12.147059	367	447	0	20	80	0.2500000
NODE_16123_length_711_cov_12.147059	367	447	2	60	80	0.7500000
NODE_16124_length_711_cov_10.009804	336	415	0	18	79	0.2278481
NODE_16124_length_711_cov_10.009804	336	415	2	1	79	0.0126582
NODE_16124_length_711_cov_10.009804	336	415	6	3	79	0.0379747
NODE_16124_length_711_cov_10.009804	336	415	8	57	79	0.7215190
NODE_16127_length_711_cov_5.619281	276	356	0	80	80	1.0000000
NODE_16127_length_711_cov_5.619281	329	409	0	80	80	1.0000000
NODE_16130_length_711_cov_4.040850	165	245	0	7	80	0.0875000
NODE_16130_length_711_cov_4.040850	165	245	4	73	80	0.9125000
NODE_16130_length_711_cov_4.040850	218	298	2	24	80	0.3000000
NODE_16130_length_711_cov_4.040850	218	298	4	45	80	0.5625000
NODE_16130_length_711_cov_4.040850	218	298	6	11	80	0.1375000
NODE_16167_length_710_cov_73.721768	626	706	0	54	80	0.6750000
NODE_16167_length_710_cov_73.721768	626	706	2	26	80	0.3250000
NODE_16168_length_710_cov_21.772504	292	372	2	31	80	0.3875000
NODE_16168_length_710_cov_21.772504	292	372	4	49	80	0.6125000
NODE_16168_length_710_cov_21.772504	345	425	2	62	80	0.7750000
NODE_16168_length_710_cov_21.772504	345	425	4	18	80	0.2250000
NODE_16169_length_710_cov_21.597381	18	54	0	36	36	1.0000000
NODE_16170_length_710_cov_13.155483	306	386	2	9	80	0.1125000
NODE_16170_length_710_cov_13.155483	306	386	4	24	80	0.3000000
NODE_16170_length_710_cov_13.155483	306	386	6	47	80	0.5875000
NODE_16170_length_710_cov_13.155483	359	439	0	42	80	0.5250000
NODE_16170_length_710_cov_13.155483	359	439	2	20	80	0.2500000
NODE_16170_length_710_cov_13.155483	359	439	4	18	80	0.2250000
NODE_16173_length_710_cov_8.031097	316	396	0	19	80	0.2375000
NODE_16173_length_710_cov_8.031097	316	396	2	5	80	0.0625000
NODE_16173_length_710_cov_8.031097	316	396	6	10	80	0.1250000
NODE_16173_length_710_cov_8.031097	316	396	8	46	80	0.5750000
NODE_16173_length_710_cov_8.031097	369	449	0	2	80	0.0250000
NODE_16173_length_710_cov_8.031097	369	449	4	10	80	0.1250000
NODE_16173_length_710_cov_8.031097	369	449	6	12	80	0.1500000
NODE_16173_length_710_cov_8.031097	369	449	8	56	80	0.7000000
NODE_16175_length_710_cov_6.664484	264	344	2	74	80	0.9250000
NODE_16175_length_710_cov_6.664484	264	344	4	6	80	0.0750000
NODE_16178_length_710_cov_5.590835	352	421	0	45	69	0.6521739
NODE_16178_length_710_cov_5.590835	352	421	2	24	69	0.3478261
NODE_16178_length_710_cov_5.590835	394	474	0	3	80	0.0375000
NODE_16178_length_710_cov_5.590835	394	474	2	77	80	0.9625000
NODE_16180_length_710_cov_5.356792	248	328	4	74	80	0.9250000
NODE_16180_length_710_cov_5.356792	248	328	6	2	80	0.0250000
NODE_16180_length_710_cov_5.356792	248	328	8	4	80	0.0500000
NODE_16180_length_710_cov_5.356792	301	381	4	42	80	0.5250000
NODE_16180_length_710_cov_5.356792	301	381	6	37	80	0.4625000
NODE_16180_length_710_cov_5.356792	301	381	10	1	80	0.0125000
NODE_16233_length_709_cov_12.227869	347	427	0	15	80	0.1875000
NODE_16233_length_709_cov_12.227869	347	427	2	21	80	0.2625000
NODE_16233_length_709_cov_12.227869	347	427	3	14	80	0.1750000
NODE_16233_length_709_cov_12.227869	347	427	4	30	80	0.3750000
NODE_16233_length_709_cov_12.227869	400	480	2	54	80	0.6750000
NODE_16233_length_709_cov_12.227869	400	480	4	26	80	0.3250000
NODE_16234_length_709_cov_10.531148	279	359	4	9	80	0.1125000
NODE_16234_length_709_cov_10.531148	279	359	8	30	80	0.3750000
NODE_16234_length_709_cov_10.531148	279	359	10	5	80	0.0625000
NODE_16234_length_709_cov_10.531148	279	359	14	36	80	0.4500000
NODE_16234_length_709_cov_10.531148	332	412	0	11	80	0.1375000
NODE_16234_length_709_cov_10.531148	332	412	5	4	80	0.0500000
NODE_16234_length_709_cov_10.531148	332	412	6	26	80	0.3250000
NODE_16234_length_709_cov_10.531148	332	412	10	17	80	0.2125000
NODE_16234_length_709_cov_10.531148	332	412	14	22	80	0.2750000
NODE_16238_length_709_cov_7.181967	225	305	0	3	80	0.0375000
NODE_16238_length_709_cov_7.181967	225	305	2	77	80	0.9625000
NODE_16238_length_709_cov_7.181967	279	312	2	33	33	1.0000000
NODE_16241_length_709_cov_5.888525	239	319	0	43	80	0.5375000
NODE_16241_length_709_cov_5.888525	239	319	2	37	80	0.4625000
NODE_16241_length_709_cov_5.888525	292	372	0	80	80	1.0000000
NODE_16294_length_708_cov_42.435140	307	387	0	80	80	1.0000000
NODE_16294_length_708_cov_42.435140	360	440	0	80	80	1.0000000
NODE_16296_length_708_cov_33.412151	235	315	0	36	80	0.4500000
NODE_16296_length_708_cov_33.412151	235	315	2	44	80	0.5500000
NODE_16296_length_708_cov_33.412151	288	368	0	24	80	0.3000000
NODE_16296_length_708_cov_33.412151	288	368	2	56	80	0.7000000
NODE_16297_length_708_cov_23.034483	316	396	2	12	80	0.1500000
NODE_16297_length_708_cov_23.034483	316	396	4	68	80	0.8500000
NODE_16297_length_708_cov_23.034483	369	449	0	37	80	0.4625000
NODE_16297_length_708_cov_23.034483	369	449	2	13	80	0.1625000
NODE_16297_length_708_cov_23.034483	369	449	4	30	80	0.3750000
NODE_16298_length_708_cov_20.449918	254	334	0	80	80	1.0000000
NODE_16298_length_708_cov_20.449918	307	387	0	46	80	0.5750000
NODE_16298_length_708_cov_20.449918	307	387	2	34	80	0.4250000
NODE_16299_length_708_cov_19.998358	238	318	0	41	80	0.5125000
NODE_16299_length_708_cov_19.998358	238	318	2	17	80	0.2125000
NODE_16299_length_708_cov_19.998358	238	318	3	21	80	0.2625000
NODE_16299_length_708_cov_19.998358	238	318	4	1	80	0.0125000
NODE_16299_length_708_cov_19.998358	291	371	2	5	80	0.0625000
NODE_16299_length_708_cov_19.998358	291	371	3	21	80	0.2625000
NODE_16299_length_708_cov_19.998358	291	371	4	54	80	0.6750000
NODE_16300_length_708_cov_19.021346	366	446	0	41	80	0.5125000
NODE_16300_length_708_cov_19.021346	366	446	2	5	80	0.0625000
NODE_16300_length_708_cov_19.021346	366	446	4	5	80	0.0625000
NODE_16300_length_708_cov_19.021346	366	446	8	29	80	0.3625000
NODE_16300_length_708_cov_19.021346	419	499	0	80	80	1.0000000
NODE_16302_length_708_cov_12.228243	181	263	2	23	82	0.2804878
NODE_16302_length_708_cov_12.228243	181	263	4	59	82	0.7195122
NODE_16302_length_708_cov_12.228243	188	268	2	16	80	0.2000000
NODE_16302_length_708_cov_12.228243	188	268	4	64	80	0.8000000
NODE_16302_length_708_cov_12.228243	236	316	2	47	80	0.5875000
NODE_16302_length_708_cov_12.228243	236	316	4	33	80	0.4125000
NODE_16302_length_708_cov_12.228243	312	392	0	71	80	0.8875000
NODE_16302_length_708_cov_12.228243	312	392	2	9	80	0.1125000
NODE_16302_length_708_cov_12.228243	312	392	0	71	80	0.8875000
NODE_16302_length_708_cov_12.228243	312	392	2	9	80	0.1125000
NODE_16302_length_708_cov_12.228243	365	445	0	80	80	1.0000000
NODE_16303_length_708_cov_11.338259	255	335	0	8	80	0.1000000
NODE_16303_length_708_cov_11.338259	255	335	2	72	80	0.9000000
NODE_16303_length_708_cov_11.338259	308	388	0	19	80	0.2375000
NODE_16303_length_708_cov_11.338259	308	388	2	61	80	0.7625000
NODE_16305_length_708_cov_9.676519	219	299	0	80	80	1.0000000
NODE_16305_length_708_cov_9.676519	272	352	0	32	80	0.4000000
NODE_16305_length_708_cov_9.676519	272	352	2	48	80	0.6000000
NODE_16306_length_708_cov_8.638752	324	399	0	75	75	1.0000000
NODE_16330_length_708_cov_2.699507	358	398	0	40	40	1.0000000
NODE_16370_length_707_cov_30.067434	325	405	0	30	80	0.3750000
NODE_16370_length_707_cov_30.067434	325	405	2	14	80	0.1750000
NODE_16370_length_707_cov_30.067434	325	405	4	36	80	0.4500000
NODE_16370_length_707_cov_30.067434	378	458	0	4	80	0.0500000
NODE_16370_length_707_cov_30.067434	378	458	2	12	80	0.1500000
NODE_16370_length_707_cov_30.067434	378	458	4	64	80	0.8000000
NODE_16371_length_707_cov_26.555921	241	321	0	80	80	1.0000000
NODE_16371_length_707_cov_26.555921	294	374	0	50	80	0.6250000
NODE_16371_length_707_cov_26.555921	294	374	4	30	80	0.3750000
NODE_16372_length_707_cov_23.972039	322	402	0	80	80	1.0000000
NODE_16372_length_707_cov_23.972039	375	455	0	80	80	1.0000000
NODE_16373_length_707_cov_20.348684	157	237	0	80	80	1.0000000
NODE_16373_length_707_cov_20.348684	210	281	0	71	71	1.0000000
NODE_16374_length_707_cov_18.970395	253	333	1	1	80	0.0125000
NODE_16374_length_707_cov_18.970395	253	333	2	79	80	0.9875000
NODE_16374_length_707_cov_18.970395	306	386	2	66	80	0.8250000
NODE_16374_length_707_cov_18.970395	306	386	3	14	80	0.1750000
NODE_16375_length_707_cov_14.324013	302	382	0	80	80	1.0000000
NODE_16375_length_707_cov_14.324013	355	435	0	64	80	0.8000000
NODE_16375_length_707_cov_14.324013	355	435	2	16	80	0.2000000
NODE_16378_length_707_cov_5.062500	313	393	0	80	80	1.0000000
NODE_16441_length_706_cov_34.116969	272	352	2	11	80	0.1375000
NODE_16441_length_706_cov_34.116969	272	352	4	44	80	0.5500000
NODE_16441_length_706_cov_34.116969	272	352	6	16	80	0.2000000
NODE_16441_length_706_cov_34.116969	272	352	8	9	80	0.1125000
NODE_16441_length_706_cov_34.116969	325	405	2	2	80	0.0250000
NODE_16441_length_706_cov_34.116969	325	405	6	50	80	0.6250000
NODE_16441_length_706_cov_34.116969	325	405	8	28	80	0.3500000
NODE_16442_length_706_cov_27.220758	229	309	0	37	80	0.4625000
NODE_16442_length_706_cov_27.220758	229	309	4	43	80	0.5375000
NODE_16442_length_706_cov_27.220758	282	362	0	27	80	0.3375000
NODE_16442_length_706_cov_27.220758	282	362	4	53	80	0.6625000
NODE_16443_length_706_cov_20.380560	264	344	4	6	80	0.0750000
NODE_16443_length_706_cov_20.380560	264	344	6	74	80	0.9250000
NODE_16443_length_706_cov_20.380560	317	397	2	21	80	0.2625000
NODE_16443_length_706_cov_20.380560	317	397	4	11	80	0.1375000
NODE_16443_length_706_cov_20.380560	317	397	6	27	80	0.3375000
NODE_16443_length_706_cov_20.380560	317	397	8	21	80	0.2625000
NODE_16444_length_706_cov_19.525535	289	369	0	80	80	1.0000000
NODE_16444_length_706_cov_19.525535	342	422	0	80	80	1.0000000
NODE_16454_length_706_cov_3.344316	465	545	0	80	80	1.0000000
NODE_16454_length_706_cov_3.344316	518	598	0	80	80	1.0000000
NODE_16494_length_705_cov_19.211221	118	198	0	10	80	0.1250000
NODE_16494_length_705_cov_19.211221	118	198	2	3	80	0.0375000
NODE_16494_length_705_cov_19.211221	118	198	4	4	80	0.0500000
NODE_16494_length_705_cov_19.211221	118	198	10	28	80	0.3500000
NODE_16494_length_705_cov_19.211221	118	198	12	35	80	0.4375000
NODE_16494_length_705_cov_19.211221	171	250	8	1	79	0.0126582
NODE_16494_length_705_cov_19.211221	171	250	10	40	79	0.5063291
NODE_16494_length_705_cov_19.211221	171	250	12	38	79	0.4810127
NODE_16495_length_705_cov_16.338284	291	339	2	45	48	0.9375000
NODE_16495_length_705_cov_16.338284	291	339	6	3	48	0.0625000
NODE_16495_length_705_cov_16.338284	336	406	2	2	70	0.0285714
NODE_16495_length_705_cov_16.338284	336	406	4	46	70	0.6571429
NODE_16495_length_705_cov_16.338284	336	406	6	22	70	0.3142857
NODE_16496_length_705_cov_14.354785	209	289	0	80	80	1.0000000
NODE_16496_length_705_cov_14.354785	262	342	0	80	80	1.0000000
NODE_16497_length_705_cov_12.231023	293	373	0	80	80	1.0000000
NODE_16497_length_705_cov_12.231023	346	426	0	32	80	0.4000000
NODE_16497_length_705_cov_12.231023	346	426	2	48	80	0.6000000
NODE_16498_length_705_cov_11.836634	390	470	0	15	80	0.1875000
NODE_16498_length_705_cov_11.836634	390	470	2	1	80	0.0125000
NODE_16498_length_705_cov_11.836634	390	470	6	64	80	0.8000000
NODE_16498_length_705_cov_11.836634	443	523	0	13	80	0.1625000
NODE_16498_length_705_cov_11.836634	443	523	4	3	80	0.0375000
NODE_16498_length_705_cov_11.836634	443	523	6	64	80	0.8000000
NODE_16499_length_705_cov_10.049505	382	479	0	97	97	1.0000000
NODE_16499_length_705_cov_10.049505	452	532	0	80	80	1.0000000
NODE_16507_length_705_cov_4.275578	358	438	0	80	80	1.0000000
NODE_16507_length_705_cov_4.275578	411	491	0	80	80	1.0000000
NODE_16509_length_705_cov_4.018152	306	364	4	58	58	1.0000000
NODE_16509_length_705_cov_4.018152	337	410	0	26	73	0.3561644
NODE_16509_length_705_cov_4.018152	337	410	2	11	73	0.1506849
NODE_16509_length_705_cov_4.018152	337	410	4	36	73	0.4931507
NODE_16511_length_705_cov_3.620462	253	315	13	5	62	0.0806452
NODE_16511_length_705_cov_3.620462	253	315	14	13	62	0.2096774
NODE_16511_length_705_cov_3.620462	253	315	15	16	62	0.2580645
NODE_16511_length_705_cov_3.620462	253	315	16	5	62	0.0806452
NODE_16511_length_705_cov_3.620462	253	315	18	23	62	0.3709677
NODE_16511_length_705_cov_3.620462	308	368	10	4	60	0.0666667
NODE_16511_length_705_cov_3.620462	308	368	12	4	60	0.0666667
NODE_16511_length_705_cov_3.620462	308	368	13	1	60	0.0166667
NODE_16511_length_705_cov_3.620462	308	368	14	18	60	0.3000000
NODE_16511_length_705_cov_3.620462	308	368	15	1	60	0.0166667
NODE_16511_length_705_cov_3.620462	308	368	16	21	60	0.3500000
NODE_16511_length_705_cov_3.620462	308	368	18	3	60	0.0500000
NODE_16511_length_705_cov_3.620462	308	368	21	1	60	0.0166667
NODE_16511_length_705_cov_3.620462	308	368	22	7	60	0.1166667
NODE_16527_length_705_cov_1.607261	462	531	0	69	69	1.0000000
NODE_16549_length_705_cov_0.529703	33	97	8	64	64	1.0000000
NODE_16549_length_705_cov_0.529703	86	150	0	28	64	0.4375000
NODE_16549_length_705_cov_0.529703	86	150	2	1	64	0.0156250
NODE_16549_length_705_cov_0.529703	86	150	4	3	64	0.0468750
NODE_16549_length_705_cov_0.529703	86	150	6	16	64	0.2500000
NODE_16549_length_705_cov_0.529703	86	150	8	16	64	0.2500000
NODE_16550_length_704_cov_18.256198	295	375	0	80	80	1.0000000
NODE_16550_length_704_cov_18.256198	348	428	0	80	80	1.0000000
NODE_16552_length_704_cov_16.662810	264	344	0	15	80	0.1875000
NODE_16552_length_704_cov_16.662810	264	344	2	48	80	0.6000000
NODE_16552_length_704_cov_16.662810	264	344	4	17	80	0.2125000
NODE_16552_length_704_cov_16.662810	317	397	2	16	80	0.2000000
NODE_16552_length_704_cov_16.662810	317	397	4	64	80	0.8000000
NODE_16553_length_704_cov_12.641322	294	374	0	19	80	0.2375000
NODE_16553_length_704_cov_12.641322	294	374	2	61	80	0.7625000
NODE_16553_length_704_cov_12.641322	347	427	0	16	80	0.2000000
NODE_16553_length_704_cov_12.641322	347	427	2	64	80	0.8000000
NODE_16557_length_704_cov_5.603306	440	498	2	58	58	1.0000000
NODE_16564_length_704_cov_3.535537	303	383	2	80	80	1.0000000
NODE_16564_length_704_cov_3.535537	369	436	2	67	67	1.0000000
NODE_16578_length_704_cov_1.963636	345	425	2	29	80	0.3625000
NODE_16578_length_704_cov_1.963636	345	425	4	51	80	0.6375000
NODE_16578_length_704_cov_1.963636	398	478	2	7	80	0.0875000
NODE_16578_length_704_cov_1.963636	398	478	4	73	80	0.9125000
NODE_16598_length_703_cov_44.102649	514	594	0	80	80	1.0000000
NODE_16598_length_703_cov_44.102649	567	647	0	80	80	1.0000000
NODE_16599_length_703_cov_33.067881	521	594	78	3	73	0.0410959
NODE_16599_length_703_cov_33.067881	521	594	80	3	73	0.0410959
NODE_16599_length_703_cov_33.067881	521	594	81	2	73	0.0273973
NODE_16599_length_703_cov_33.067881	521	594	82	7	73	0.0958904
NODE_16599_length_703_cov_33.067881	521	594	84	10	73	0.1369863
NODE_16599_length_703_cov_33.067881	521	594	86	5	73	0.0684932
NODE_16599_length_703_cov_33.067881	521	594	87	1	73	0.0136986
NODE_16599_length_703_cov_33.067881	521	594	89	2	73	0.0273973
NODE_16599_length_703_cov_33.067881	521	594	91	4	73	0.0547945
NODE_16599_length_703_cov_33.067881	521	594	92	1	73	0.0136986
NODE_16599_length_703_cov_33.067881	521	594	93	7	73	0.0958904
NODE_16599_length_703_cov_33.067881	521	594	95	16	73	0.2191781
NODE_16599_length_703_cov_33.067881	521	594	97	4	73	0.0547945
NODE_16599_length_703_cov_33.067881	521	594	98	1	73	0.0136986
NODE_16599_length_703_cov_33.067881	521	594	99	4	73	0.0547945
NODE_16599_length_703_cov_33.067881	521	594	104	1	73	0.0136986
NODE_16599_length_703_cov_33.067881	521	594	105	2	73	0.0273973
NODE_16599_length_703_cov_33.067881	561	602	78	3	41	0.0731707
NODE_16599_length_703_cov_33.067881	561	602	80	3	41	0.0731707
NODE_16599_length_703_cov_33.067881	561	602	81	2	41	0.0487805
NODE_16599_length_703_cov_33.067881	561	602	82	7	41	0.1707317
NODE_16599_length_703_cov_33.067881	561	602	84	11	41	0.2682927
NODE_16599_length_703_cov_33.067881	561	602	86	5	41	0.1219512
NODE_16599_length_703_cov_33.067881	561	602	87	1	41	0.0243902
NODE_16599_length_703_cov_33.067881	561	602	89	1	41	0.0243902
NODE_16599_length_703_cov_33.067881	561	602	90	1	41	0.0243902
NODE_16599_length_703_cov_33.067881	561	602	92	3	41	0.0731707
NODE_16599_length_703_cov_33.067881	561	602	93	1	41	0.0243902
NODE_16599_length_703_cov_33.067881	561	602	94	3	41	0.0731707
NODE_16600_length_703_cov_30.266556	312	392	0	44	80	0.5500000
NODE_16600_length_703_cov_30.266556	312	392	4	36	80	0.4500000
NODE_16600_length_703_cov_30.266556	365	445	0	80	80	1.0000000
NODE_16601_length_703_cov_17.006623	449	529	0	80	80	1.0000000
NODE_16601_length_703_cov_17.006623	502	582	0	80	80	1.0000000
NODE_16602_length_703_cov_14.801325	383	463	2	45	80	0.5625000
NODE_16602_length_703_cov_14.801325	383	463	4	35	80	0.4375000
NODE_16602_length_703_cov_14.801325	436	516	0	26	80	0.3250000
NODE_16602_length_703_cov_14.801325	436	516	2	49	80	0.6125000
NODE_16602_length_703_cov_14.801325	436	516	4	5	80	0.0625000
NODE_16603_length_703_cov_11.766556	308	388	1	5	80	0.0625000
NODE_16603_length_703_cov_11.766556	308	388	2	13	80	0.1625000
NODE_16603_length_703_cov_11.766556	308	388	3	12	80	0.1500000
NODE_16603_length_703_cov_11.766556	308	388	5	16	80	0.2000000
NODE_16603_length_703_cov_11.766556	308	388	7	13	80	0.1625000
NODE_16603_length_703_cov_11.766556	308	388	8	19	80	0.2375000
NODE_16603_length_703_cov_11.766556	308	388	10	2	80	0.0250000
NODE_16603_length_703_cov_11.766556	361	441	1	3	80	0.0375000
NODE_16603_length_703_cov_11.766556	361	441	2	66	80	0.8250000
NODE_16603_length_703_cov_11.766556	361	441	3	11	80	0.1375000
NODE_16604_length_703_cov_10.405629	213	293	9	4	80	0.0500000
NODE_16604_length_703_cov_10.405629	213	293	12	1	80	0.0125000
NODE_16604_length_703_cov_10.405629	213	293	15	5	80	0.0625000
NODE_16604_length_703_cov_10.405629	213	293	19	2	80	0.0250000
NODE_16604_length_703_cov_10.405629	213	293	23	2	80	0.0250000
NODE_16604_length_703_cov_10.405629	213	293	24	14	80	0.1750000
NODE_16604_length_703_cov_10.405629	213	293	26	25	80	0.3125000
NODE_16604_length_703_cov_10.405629	213	293	30	9	80	0.1125000
NODE_16604_length_703_cov_10.405629	213	293	32	18	80	0.2250000
NODE_16604_length_703_cov_10.405629	266	301	2	6	35	0.1714286
NODE_16604_length_703_cov_10.405629	266	301	8	2	35	0.0571429
NODE_16604_length_703_cov_10.405629	266	301	9	4	35	0.1142857
NODE_16604_length_703_cov_10.405629	266	301	12	1	35	0.0285714
NODE_16604_length_703_cov_10.405629	266	301	15	5	35	0.1428571
NODE_16604_length_703_cov_10.405629	266	301	19	2	35	0.0571429
NODE_16604_length_703_cov_10.405629	266	301	23	2	35	0.0571429
NODE_16604_length_703_cov_10.405629	266	301	24	13	35	0.3714286
NODE_16605_length_703_cov_6.966887	381	440	0	59	59	1.0000000
NODE_16616_length_703_cov_3.491722	256	309	0	11	53	0.2075472
NODE_16616_length_703_cov_3.491722	256	309	2	23	53	0.4339623
NODE_16616_length_703_cov_3.491722	256	309	7	19	53	0.3584906
NODE_16616_length_703_cov_3.491722	257	337	0	39	80	0.4875000
NODE_16616_length_703_cov_3.491722	257	337	2	23	80	0.2875000
NODE_16616_length_703_cov_3.491722	257	337	7	18	80	0.2250000
NODE_16616_length_703_cov_3.491722	305	362	0	57	57	1.0000000
NODE_16624_length_703_cov_2.687086	216	296	7	36	80	0.4500000
NODE_16624_length_703_cov_2.687086	216	296	8	44	80	0.5500000
NODE_16624_length_703_cov_2.687086	269	349	0	8	80	0.1000000
NODE_16624_length_703_cov_2.687086	269	349	4	12	80	0.1500000
NODE_16624_length_703_cov_2.687086	269	349	7	60	80	0.7500000
NODE_16663_length_702_cov_49.784411	221	299	0	31	78	0.3974359
NODE_16663_length_702_cov_49.784411	221	299	1	47	78	0.6025641
NODE_16663_length_702_cov_49.784411	277	352	0	75	75	1.0000000
NODE_16664_length_702_cov_26.570481	201	281	0	33	80	0.4125000
NODE_16664_length_702_cov_26.570481	201	281	2	47	80	0.5875000
NODE_16664_length_702_cov_26.570481	254	334	2	80	80	1.0000000
NODE_16665_length_702_cov_23.971808	139	219	0	54	80	0.6750000
NODE_16665_length_702_cov_23.971808	139	219	2	26	80	0.3250000
NODE_16665_length_702_cov_23.971808	192	272	0	80	80	1.0000000
NODE_16665_length_702_cov_23.971808	268	348	0	80	80	1.0000000
NODE_16665_length_702_cov_23.971808	321	401	0	80	80	1.0000000
NODE_16666_length_702_cov_23.827529	448	528	0	80	80	1.0000000
NODE_16666_length_702_cov_23.827529	501	581	0	80	80	1.0000000
NODE_16667_length_702_cov_14.661692	424	504	0	17	80	0.2125000
NODE_16667_length_702_cov_14.661692	424	504	3	17	80	0.2125000
NODE_16667_length_702_cov_14.661692	424	504	5	46	80	0.5750000
NODE_16667_length_702_cov_14.661692	477	557	2	30	80	0.3750000
NODE_16667_length_702_cov_14.661692	477	557	5	50	80	0.6250000
NODE_16668_length_702_cov_13.908789	259	304	9	10	45	0.2222222
NODE_16668_length_702_cov_13.908789	259	304	14	1	45	0.0222222
NODE_16668_length_702_cov_13.908789	259	304	15	17	45	0.3777778
NODE_16668_length_702_cov_13.908789	259	304	19	2	45	0.0444444
NODE_16668_length_702_cov_13.908789	259	304	21	15	45	0.3333333
NODE_16668_length_702_cov_13.908789	277	357	6	6	80	0.0750000
NODE_16668_length_702_cov_13.908789	277	357	8	4	80	0.0500000
NODE_16668_length_702_cov_13.908789	277	357	10	2	80	0.0250000
NODE_16668_length_702_cov_13.908789	277	357	15	10	80	0.1250000
NODE_16668_length_702_cov_13.908789	277	357	16	11	80	0.1375000
NODE_16668_length_702_cov_13.908789	277	357	18	1	80	0.0125000
NODE_16668_length_702_cov_13.908789	277	357	19	2	80	0.0250000
NODE_16668_length_702_cov_13.908789	277	357	20	9	80	0.1125000
NODE_16668_length_702_cov_13.908789	277	357	21	35	80	0.4375000
NODE_16668_length_702_cov_13.908789	289	357	6	6	68	0.0882353
NODE_16668_length_702_cov_13.908789	289	357	8	4	68	0.0588235
NODE_16668_length_702_cov_13.908789	289	357	10	2	68	0.0294118
NODE_16668_length_702_cov_13.908789	289	357	16	11	68	0.1617647
NODE_16668_length_702_cov_13.908789	289	357	18	1	68	0.0147059
NODE_16668_length_702_cov_13.908789	289	357	20	9	68	0.1323529
NODE_16668_length_702_cov_13.908789	289	357	21	35	68	0.5147059
NODE_16669_length_702_cov_8.502488	337	417	0	80	80	1.0000000
NODE_16669_length_702_cov_8.502488	390	470	0	80	80	1.0000000
NODE_16671_length_702_cov_6.470978	209	289	0	16	80	0.2000000
NODE_16671_length_702_cov_6.470978	209	289	4	64	80	0.8000000
NODE_16671_length_702_cov_6.470978	262	342	0	69	80	0.8625000
NODE_16671_length_702_cov_6.470978	262	342	4	11	80	0.1375000
NODE_16729_length_701_cov_38.715947	178	258	2	80	80	1.0000000
NODE_16729_length_701_cov_38.715947	231	311	0	35	80	0.4375000
NODE_16729_length_701_cov_38.715947	231	311	2	45	80	0.5625000
NODE_16729_length_701_cov_38.715947	307	387	0	80	80	1.0000000
NODE_16729_length_701_cov_38.715947	360	440	0	80	80	1.0000000
NODE_16730_length_701_cov_28.059801	432	513	4	81	81	1.0000000
NODE_16730_length_701_cov_28.059801	486	566	0	46	80	0.5750000
NODE_16730_length_701_cov_28.059801	486	566	4	34	80	0.4250000
NODE_16731_length_701_cov_18.387043	258	338	0	80	80	1.0000000
NODE_16731_length_701_cov_18.387043	311	391	0	80	80	1.0000000
NODE_16732_length_701_cov_17.122924	295	367	6	3	72	0.0416667
NODE_16732_length_701_cov_17.122924	295	367	10	64	72	0.8888889
NODE_16732_length_701_cov_17.122924	295	367	12	5	72	0.0694444
NODE_16733_length_701_cov_16.114618	242	322	0	70	80	0.8750000
NODE_16733_length_701_cov_16.114618	242	322	4	10	80	0.1250000
NODE_16733_length_701_cov_16.114618	295	375	0	17	80	0.2125000
NODE_16733_length_701_cov_16.114618	295	375	4	63	80	0.7875000
NODE_16734_length_701_cov_15.588040	399	479	0	17	80	0.2125000
NODE_16734_length_701_cov_15.588040	399	479	2	63	80	0.7875000
NODE_16734_length_701_cov_15.588040	452	532	0	13	80	0.1625000
NODE_16734_length_701_cov_15.588040	452	532	2	67	80	0.8375000
NODE_16736_length_701_cov_11.420266	229	309	0	48	80	0.6000000
NODE_16736_length_701_cov_11.420266	229	309	2	32	80	0.4000000
NODE_16736_length_701_cov_11.420266	282	362	0	80	80	1.0000000
NODE_16737_length_701_cov_10.411960	202	283	0	31	81	0.3827161
NODE_16737_length_701_cov_10.411960	202	283	2	50	81	0.6172839
NODE_16737_length_701_cov_10.411960	256	336	0	10	80	0.1250000
NODE_16737_length_701_cov_10.411960	256	336	2	70	80	0.8750000
NODE_16738_length_701_cov_9.107973	400	480	0	21	80	0.2625000
NODE_16738_length_701_cov_9.107973	400	480	2	59	80	0.7375000
NODE_16738_length_701_cov_9.107973	453	533	0	11	80	0.1375000
NODE_16738_length_701_cov_9.107973	453	533	2	69	80	0.8625000
NODE_16739_length_701_cov_8.877076	283	363	1	80	80	1.0000000
NODE_16739_length_701_cov_8.877076	336	416	1	80	80	1.0000000
NODE_16740_length_701_cov_8.543189	341	421	0	80	80	1.0000000
NODE_16740_length_701_cov_8.543189	394	474	0	80	80	1.0000000
NODE_16742_length_701_cov_6.317276	273	353	0	23	80	0.2875000
NODE_16742_length_701_cov_6.317276	273	353	1	1	80	0.0125000
NODE_16742_length_701_cov_6.317276	273	353	2	56	80	0.7000000
NODE_16742_length_701_cov_6.317276	326	382	0	52	56	0.9285714
NODE_16742_length_701_cov_6.317276	326	382	1	1	56	0.0178571
NODE_16742_length_701_cov_6.317276	326	382	2	3	56	0.0535714
NODE_16747_length_701_cov_5.081395	318	374	0	12	56	0.2142857
NODE_16747_length_701_cov_5.081395	318	374	2	44	56	0.7857143
NODE_16752_length_701_cov_3.320598	207	287	0	80	80	1.0000000
NODE_16752_length_701_cov_3.320598	260	340	0	80	80	1.0000000
NODE_16794_length_700_cov_22.241265	326	406	20	6	80	0.0750000
NODE_16794_length_700_cov_22.241265	326	406	22	4	80	0.0500000
NODE_16794_length_700_cov_22.241265	326	406	23	4	80	0.0500000
NODE_16794_length_700_cov_22.241265	326	406	24	1	80	0.0125000
NODE_16794_length_700_cov_22.241265	326	406	28	4	80	0.0500000
NODE_16794_length_700_cov_22.241265	326	406	30	4	80	0.0500000
NODE_16794_length_700_cov_22.241265	326	406	32	9	80	0.1125000
NODE_16794_length_700_cov_22.241265	326	406	34	13	80	0.1625000
NODE_16794_length_700_cov_22.241265	326	406	35	2	80	0.0250000
NODE_16794_length_700_cov_22.241265	326	406	36	7	80	0.0875000
NODE_16794_length_700_cov_22.241265	326	406	37	10	80	0.1250000
NODE_16794_length_700_cov_22.241265	326	406	38	11	80	0.1375000
NODE_16794_length_700_cov_22.241265	326	406	39	5	80	0.0625000
NODE_16796_length_700_cov_11.730449	294	374	0	80	80	1.0000000
NODE_16796_length_700_cov_11.730449	347	427	0	80	80	1.0000000
NODE_16800_length_700_cov_7.291181	317	397	0	48	80	0.6000000
NODE_16800_length_700_cov_7.291181	317	397	2	11	80	0.1375000
NODE_16800_length_700_cov_7.291181	317	397	4	21	80	0.2625000
NODE_16800_length_700_cov_7.291181	370	450	2	6	80	0.0750000
NODE_16800_length_700_cov_7.291181	370	450	4	43	80	0.5375000
NODE_16800_length_700_cov_7.291181	370	450	6	31	80	0.3875000
NODE_16801_length_700_cov_6.557404	353	404	0	51	51	1.0000000
NODE_16802_length_700_cov_5.475874	301	381	0	80	80	1.0000000
NODE_16802_length_700_cov_5.475874	354	434	0	80	80	1.0000000
NODE_16803_length_700_cov_3.960067	158	234	4	76	76	1.0000000
NODE_16803_length_700_cov_3.960067	209	291	1	14	82	0.1707317
NODE_16803_length_700_cov_3.960067	209	291	2	29	82	0.3536585
NODE_16803_length_700_cov_3.960067	209	291	4	39	82	0.4756097
NODE_16822_length_700_cov_1.517471	324	404	0	80	80	1.0000000
NODE_16822_length_700_cov_1.517471	377	457	0	80	80	1.0000000
NODE_16844_length_699_cov_18.446667	185	265	2	80	80	1.0000000
NODE_16844_length_699_cov_18.446667	238	318	0	24	80	0.3000000
NODE_16844_length_699_cov_18.446667	238	318	2	56	80	0.7000000
NODE_16845_length_699_cov_18.383333	258	338	0	80	80	1.0000000
NODE_16845_length_699_cov_18.383333	311	391	0	80	80	1.0000000
NODE_16846_length_699_cov_18.103333	218	298	0	46	80	0.5750000
NODE_16846_length_699_cov_18.103333	218	298	2	34	80	0.4250000
NODE_16846_length_699_cov_18.103333	271	351	2	80	80	1.0000000
NODE_16847_length_699_cov_15.636667	279	359	2	53	80	0.6625000
NODE_16847_length_699_cov_15.636667	279	359	4	19	80	0.2375000
NODE_16847_length_699_cov_15.636667	279	359	6	8	80	0.1000000
NODE_16847_length_699_cov_15.636667	332	412	4	63	80	0.7875000
NODE_16847_length_699_cov_15.636667	332	412	6	17	80	0.2125000
NODE_16848_length_699_cov_15.113333	313	393	0	2	80	0.0250000
NODE_16848_length_699_cov_15.113333	313	393	4	38	80	0.4750000
NODE_16848_length_699_cov_15.113333	313	393	8	40	80	0.5000000
NODE_16848_length_699_cov_15.113333	366	446	0	8	80	0.1000000
NODE_16848_length_699_cov_15.113333	366	446	4	72	80	0.9000000
NODE_16849_length_699_cov_10.070000	233	313	0	80	80	1.0000000
NODE_16849_length_699_cov_10.070000	286	366	0	80	80	1.0000000
NODE_16849_length_699_cov_10.070000	362	442	0	80	80	1.0000000
NODE_16849_length_699_cov_10.070000	415	495	0	80	80	1.0000000
NODE_16850_length_699_cov_8.083333	347	427	2	11	80	0.1375000
NODE_16850_length_699_cov_8.083333	347	427	4	69	80	0.8625000
NODE_16850_length_699_cov_8.083333	400	480	0	37	80	0.4625000
NODE_16850_length_699_cov_8.083333	400	480	2	27	80	0.3375000
NODE_16850_length_699_cov_8.083333	400	480	4	16	80	0.2000000
NODE_16851_length_699_cov_7.758333	307	387	0	80	80	1.0000000
NODE_16851_length_699_cov_7.758333	360	440	0	69	80	0.8625000
NODE_16851_length_699_cov_7.758333	360	440	2	11	80	0.1375000
NODE_16852_length_699_cov_7.713333	252	332	4	7	80	0.0875000
NODE_16852_length_699_cov_7.713333	252	332	9	1	80	0.0125000
NODE_16852_length_699_cov_7.713333	252	332	10	53	80	0.6625000
NODE_16852_length_699_cov_7.713333	252	332	12	19	80	0.2375000
NODE_16852_length_699_cov_7.713333	305	385	2	6	80	0.0750000
NODE_16852_length_699_cov_7.713333	305	385	8	15	80	0.1875000
NODE_16852_length_699_cov_7.713333	305	385	10	25	80	0.3125000
NODE_16852_length_699_cov_7.713333	305	385	12	34	80	0.4250000
NODE_16853_length_699_cov_7.186667	271	332	0	47	61	0.7704918
NODE_16853_length_699_cov_7.186667	271	332	2	14	61	0.2295082
NODE_16853_length_699_cov_7.186667	348	428	4	10	80	0.1250000
NODE_16853_length_699_cov_7.186667	348	428	6	3	80	0.0375000
NODE_16853_length_699_cov_7.186667	348	428	8	23	80	0.2875000
NODE_16853_length_699_cov_7.186667	348	428	12	44	80	0.5500000
NODE_16857_length_699_cov_5.815000	243	316	2	19	73	0.2602740
NODE_16857_length_699_cov_5.815000	243	316	4	50	73	0.6849315
NODE_16857_length_699_cov_5.815000	243	316	6	4	73	0.0547945
NODE_16857_length_699_cov_5.815000	293	374	2	29	81	0.3580247
NODE_16857_length_699_cov_5.815000	293	374	4	31	81	0.3827161
NODE_16857_length_699_cov_5.815000	293	374	6	21	81	0.2592593
NODE_16858_length_699_cov_5.520000	302	382	0	80	80	1.0000000
NODE_16858_length_699_cov_5.520000	355	435	0	80	80	1.0000000
NODE_16860_length_699_cov_4.051667	289	369	0	33	80	0.4125000
NODE_16860_length_699_cov_4.051667	289	369	4	6	80	0.0750000
NODE_16860_length_699_cov_4.051667	289	369	7	10	80	0.1250000
NODE_16860_length_699_cov_4.051667	289	369	15	28	80	0.3500000
NODE_16860_length_699_cov_4.051667	289	369	17	3	80	0.0375000
NODE_16860_length_699_cov_4.051667	342	422	15	24	80	0.3000000
NODE_16860_length_699_cov_4.051667	342	422	17	29	80	0.3625000
NODE_16860_length_699_cov_4.051667	342	422	18	27	80	0.3375000
NODE_16868_length_699_cov_2.498333	204	284	0	80	80	1.0000000
NODE_16868_length_699_cov_2.498333	257	337	0	80	80	1.0000000
NODE_16908_length_698_cov_47.350584	321	401	2	33	80	0.4125000
NODE_16908_length_698_cov_47.350584	321	401	4	20	80	0.2500000
NODE_16908_length_698_cov_47.350584	321	401	6	27	80	0.3375000
NODE_16908_length_698_cov_47.350584	374	454	0	26	80	0.3250000
NODE_16908_length_698_cov_47.350584	374	454	4	47	80	0.5875000
NODE_16908_length_698_cov_47.350584	374	454	6	7	80	0.0875000
NODE_16909_length_698_cov_42.848080	255	335	0	80	80	1.0000000
NODE_16909_length_698_cov_42.848080	308	388	0	80	80	1.0000000
NODE_16910_length_698_cov_36.697830	366	446	6	8	80	0.1000000
NODE_16910_length_698_cov_36.697830	366	446	7	1	80	0.0125000
NODE_16910_length_698_cov_36.697830	366	446	8	12	80	0.1500000
NODE_16910_length_698_cov_36.697830	366	446	10	9	80	0.1125000
NODE_16910_length_698_cov_36.697830	366	446	11	32	80	0.4000000
NODE_16910_length_698_cov_36.697830	366	446	12	18	80	0.2250000
NODE_16910_length_698_cov_36.697830	419	484	5	6	65	0.0923077
NODE_16910_length_698_cov_36.697830	419	484	6	4	65	0.0615385
NODE_16910_length_698_cov_36.697830	419	484	7	1	65	0.0153846
NODE_16910_length_698_cov_36.697830	419	484	8	7	65	0.1076923
NODE_16910_length_698_cov_36.697830	419	484	10	41	65	0.6307693
NODE_16910_length_698_cov_36.697830	419	484	11	6	65	0.0923077
NODE_16911_length_698_cov_23.874791	222	302	0	30	80	0.3750000
NODE_16911_length_698_cov_23.874791	222	302	2	2	80	0.0250000
NODE_16911_length_698_cov_23.874791	222	302	4	2	80	0.0250000
NODE_16911_length_698_cov_23.874791	222	302	10	46	80	0.5750000
NODE_16911_length_698_cov_23.874791	275	355	4	3	80	0.0375000
NODE_16911_length_698_cov_23.874791	275	355	6	14	80	0.1750000
NODE_16911_length_698_cov_23.874791	275	355	8	2	80	0.0250000
NODE_16911_length_698_cov_23.874791	275	355	10	61	80	0.7625000
NODE_16912_length_698_cov_7.133556	360	440	0	80	80	1.0000000
NODE_16912_length_698_cov_7.133556	413	493	0	63	80	0.7875000
NODE_16912_length_698_cov_7.133556	413	493	2	17	80	0.2125000
NODE_16913_length_698_cov_6.520868	267	347	0	80	80	1.0000000
NODE_16913_length_698_cov_6.520868	320	400	0	80	80	1.0000000
NODE_16917_length_698_cov_4.762938	329	359	16	16	30	0.5333334
NODE_16917_length_698_cov_4.762938	329	359	18	4	30	0.1333333
NODE_16917_length_698_cov_4.762938	329	359	20	10	30	0.3333333
NODE_16926_length_698_cov_2.577629	309	389	2	80	80	1.0000000
NODE_16926_length_698_cov_2.577629	362	442	0	45	80	0.5625000
NODE_16926_length_698_cov_2.577629	362	442	2	35	80	0.4375000
NODE_16962_length_697_cov_16.013378	305	385	0	80	80	1.0000000
NODE_16962_length_697_cov_16.013378	358	438	0	45	80	0.5625000
NODE_16962_length_697_cov_16.013378	358	438	2	35	80	0.4375000
NODE_16963_length_697_cov_14.411371	440	520	0	6	80	0.0750000
NODE_16963_length_697_cov_14.411371	440	520	2	74	80	0.9250000
NODE_16963_length_697_cov_14.411371	493	573	0	59	80	0.7375000
NODE_16963_length_697_cov_14.411371	493	573	2	21	80	0.2625000
NODE_16964_length_697_cov_14.282609	257	354	0	97	97	1.0000000
NODE_16964_length_697_cov_14.282609	327	385	0	58	58	1.0000000
NODE_16965_length_697_cov_9.969900	360	440	0	80	80	1.0000000
NODE_16965_length_697_cov_9.969900	413	493	0	80	80	1.0000000
NODE_16968_length_697_cov_6.117057	236	316	0	69	80	0.8625000
NODE_16968_length_697_cov_6.117057	236	316	3	11	80	0.1375000
NODE_16968_length_697_cov_6.117057	289	369	0	16	80	0.2000000
NODE_16968_length_697_cov_6.117057	289	369	3	50	80	0.6250000
NODE_16968_length_697_cov_6.117057	289	369	5	14	80	0.1750000
NODE_17025_length_696_cov_28.360134	319	399	0	4	80	0.0500000
NODE_17025_length_696_cov_28.360134	319	399	2	76	80	0.9500000
NODE_17025_length_696_cov_28.360134	372	452	0	57	80	0.7125000
NODE_17025_length_696_cov_28.360134	372	452	2	23	80	0.2875000
NODE_17026_length_696_cov_18.708543	367	447	0	80	80	1.0000000
NODE_17026_length_696_cov_18.708543	420	500	0	80	80	1.0000000
NODE_17027_length_696_cov_18.170854	390	470	0	39	80	0.4875000
NODE_17027_length_696_cov_18.170854	390	470	2	41	80	0.5125000
NODE_17027_length_696_cov_18.170854	443	523	0	12	80	0.1500000
NODE_17027_length_696_cov_18.170854	443	523	2	68	80	0.8500000
NODE_17028_length_696_cov_13.738693	266	346	0	2	80	0.0250000
NODE_17028_length_696_cov_13.738693	266	346	2	78	80	0.9750000
NODE_17028_length_696_cov_13.738693	319	399	0	55	80	0.6875000
NODE_17028_length_696_cov_13.738693	319	399	2	25	80	0.3125000
NODE_17030_length_696_cov_10.693467	239	266	0	27	27	1.0000000
NODE_17031_length_696_cov_9.949749	248	328	0	80	80	1.0000000
NODE_17031_length_696_cov_9.949749	301	381	0	35	80	0.4375000
NODE_17031_length_696_cov_9.949749	301	381	2	45	80	0.5625000
NODE_17032_length_696_cov_8.658291	247	327	0	80	80	1.0000000
NODE_17032_length_696_cov_8.658291	300	380	0	80	80	1.0000000
NODE_17032_length_696_cov_8.658291	376	456	0	80	80	1.0000000
NODE_17032_length_696_cov_8.658291	429	509	0	80	80	1.0000000
NODE_17068_length_696_cov_1.675042	498	543	0	10	45	0.2222222
NODE_17068_length_696_cov_1.675042	498	543	2	35	45	0.7777778
NODE_17100_length_695_cov_24.112416	388	468	0	31	80	0.3875000
NODE_17100_length_695_cov_24.112416	388	468	4	21	80	0.2625000
NODE_17100_length_695_cov_24.112416	388	468	6	28	80	0.3500000
NODE_17100_length_695_cov_24.112416	441	521	0	80	80	1.0000000
NODE_17101_length_695_cov_12.152685	349	429	0	80	80	1.0000000
NODE_17101_length_695_cov_12.152685	402	482	0	80	80	1.0000000
NODE_17103_length_695_cov_8.466443	345	425	0	80	80	1.0000000
NODE_17103_length_695_cov_8.466443	398	478	0	80	80	1.0000000
NODE_17106_length_695_cov_5.661074	283	363	2	80	80	1.0000000
NODE_17106_length_695_cov_5.661074	346	416	0	31	70	0.4428571
NODE_17106_length_695_cov_5.661074	346	416	1	13	70	0.1857143
NODE_17106_length_695_cov_5.661074	346	416	2	26	70	0.3714286
NODE_17124_length_695_cov_2.050336	36	112	0	76	76	1.0000000
NODE_17161_length_694_cov_46.675630	30	110	0	80	80	1.0000000
NODE_17161_length_694_cov_46.675630	83	163	0	80	80	1.0000000
NODE_17161_length_694_cov_46.675630	159	239	0	80	80	1.0000000
NODE_17161_length_694_cov_46.675630	212	292	0	80	80	1.0000000
NODE_17162_length_694_cov_12.850420	326	406	0	80	80	1.0000000
NODE_17162_length_694_cov_12.850420	379	459	0	80	80	1.0000000
NODE_17163_length_694_cov_7.236975	318	396	0	78	78	1.0000000
NODE_17163_length_694_cov_7.236975	371	450	0	79	79	1.0000000
NODE_17166_length_694_cov_5.554622	404	484	0	80	80	1.0000000
NODE_17166_length_694_cov_5.554622	457	537	0	80	80	1.0000000
NODE_17168_length_694_cov_5.373109	152	232	0	13	80	0.1625000
NODE_17168_length_694_cov_5.373109	152	232	2	67	80	0.8375000
NODE_17168_length_694_cov_5.373109	205	285	0	32	80	0.4000000
NODE_17168_length_694_cov_5.373109	205	285	2	48	80	0.6000000
NODE_17227_length_693_cov_26.616162	435	515	0	80	80	1.0000000
NODE_17227_length_693_cov_26.616162	488	568	0	80	80	1.0000000
NODE_17228_length_693_cov_23.552189	193	273	0	80	80	1.0000000
NODE_17228_length_693_cov_23.552189	246	326	0	32	80	0.4000000
NODE_17228_length_693_cov_23.552189	246	326	6	48	80	0.6000000
NODE_17229_length_693_cov_22.848485	231	311	0	52	80	0.6500000
NODE_17229_length_693_cov_22.848485	231	311	1	1	80	0.0125000
NODE_17229_length_693_cov_22.848485	231	311	2	27	80	0.3375000
NODE_17229_length_693_cov_22.848485	284	364	0	11	80	0.1375000
NODE_17229_length_693_cov_22.848485	284	364	2	69	80	0.8625000
NODE_17230_length_693_cov_13.616162	219	299	0	66	80	0.8250000
NODE_17230_length_693_cov_13.616162	219	299	2	8	80	0.1000000
NODE_17230_length_693_cov_13.616162	219	299	4	6	80	0.0750000
NODE_17230_length_693_cov_13.616162	272	352	0	13	80	0.1625000
NODE_17230_length_693_cov_13.616162	272	352	2	8	80	0.1000000
NODE_17230_length_693_cov_13.616162	272	352	4	10	80	0.1250000
NODE_17230_length_693_cov_13.616162	272	352	6	49	80	0.6125000
NODE_17231_length_693_cov_12.382155	305	385	2	12	80	0.1500000
NODE_17231_length_693_cov_12.382155	305	385	4	2	80	0.0250000
NODE_17231_length_693_cov_12.382155	305	385	6	66	80	0.8250000
NODE_17231_length_693_cov_12.382155	358	424	0	7	66	0.1060606
NODE_17231_length_693_cov_12.382155	358	424	2	4	66	0.0606061
NODE_17231_length_693_cov_12.382155	358	424	4	1	66	0.0151515
NODE_17231_length_693_cov_12.382155	358	424	6	54	66	0.8181818
NODE_17232_length_693_cov_10.053872	279	359	0	8	80	0.1000000
NODE_17232_length_693_cov_10.053872	279	359	1	12	80	0.1500000
NODE_17232_length_693_cov_10.053872	279	359	2	60	80	0.7500000
NODE_17232_length_693_cov_10.053872	332	412	0	61	80	0.7625000
NODE_17232_length_693_cov_10.053872	332	412	1	12	80	0.1500000
NODE_17232_length_693_cov_10.053872	332	412	2	7	80	0.0875000
NODE_17233_length_693_cov_9.659933	247	327	2	14	80	0.1750000
NODE_17233_length_693_cov_9.659933	247	327	4	3	80	0.0375000
NODE_17233_length_693_cov_9.659933	247	327	5	16	80	0.2000000
NODE_17233_length_693_cov_9.659933	247	327	6	31	80	0.3875000
NODE_17233_length_693_cov_9.659933	247	327	8	16	80	0.2000000
NODE_17233_length_693_cov_9.659933	300	380	4	3	80	0.0375000
NODE_17233_length_693_cov_9.659933	300	380	6	77	80	0.9625000
NODE_17235_length_693_cov_8.077441	343	423	0	80	80	1.0000000
NODE_17235_length_693_cov_8.077441	396	476	0	80	80	1.0000000
NODE_17243_length_693_cov_3.680135	250	321	2	71	71	1.0000000
NODE_17280_length_692_cov_33.416526	462	542	2	7	80	0.0875000
NODE_17280_length_692_cov_33.416526	462	542	3	36	80	0.4500000
NODE_17280_length_692_cov_33.416526	462	542	4	8	80	0.1000000
NODE_17280_length_692_cov_33.416526	462	542	5	29	80	0.3625000
NODE_17280_length_692_cov_33.416526	515	595	3	19	80	0.2375000
NODE_17280_length_692_cov_33.416526	515	595	4	60	80	0.7500000
NODE_17280_length_692_cov_33.416526	515	595	6	1	80	0.0125000
NODE_17281_length_692_cov_17.559865	291	371	4	29	80	0.3625000
NODE_17281_length_692_cov_17.559865	291	371	6	25	80	0.3125000
NODE_17281_length_692_cov_17.559865	291	371	7	26	80	0.3250000
NODE_17282_length_692_cov_15.070826	304	375	0	20	71	0.2816902
NODE_17282_length_692_cov_15.070826	304	375	2	23	71	0.3239437
NODE_17282_length_692_cov_15.070826	304	375	4	28	71	0.3943662
NODE_17283_length_692_cov_13.279933	308	388	0	11	80	0.1375000
NODE_17283_length_692_cov_13.279933	308	388	2	3	80	0.0375000
NODE_17283_length_692_cov_13.279933	308	388	4	9	80	0.1125000
NODE_17283_length_692_cov_13.279933	308	388	8	1	80	0.0125000
NODE_17283_length_692_cov_13.279933	308	388	10	56	80	0.7000000
NODE_17283_length_692_cov_13.279933	361	441	0	31	80	0.3875000
NODE_17283_length_692_cov_13.279933	361	441	2	5	80	0.0625000
NODE_17283_length_692_cov_13.279933	361	441	4	2	80	0.0250000
NODE_17283_length_692_cov_13.279933	361	441	6	5	80	0.0625000
NODE_17283_length_692_cov_13.279933	361	441	8	2	80	0.0250000
NODE_17283_length_692_cov_13.279933	361	441	10	35	80	0.4375000
NODE_17285_length_692_cov_10.750422	317	397	0	2	80	0.0250000
NODE_17285_length_692_cov_10.750422	317	397	4	78	80	0.9750000
NODE_17287_length_692_cov_7.497470	175	255	0	20	80	0.2500000
NODE_17287_length_692_cov_7.497470	175	255	2	60	80	0.7500000
NODE_17287_length_692_cov_7.497470	228	312	2	84	84	1.0000000
NODE_17289_length_692_cov_7.370995	235	315	2	7	80	0.0875000
NODE_17289_length_692_cov_7.370995	235	315	4	3	80	0.0375000
NODE_17289_length_692_cov_7.370995	235	315	6	70	80	0.8750000
NODE_17289_length_692_cov_7.370995	288	369	2	9	81	0.1111111
NODE_17289_length_692_cov_7.370995	288	369	4	22	81	0.2716049
NODE_17289_length_692_cov_7.370995	288	369	6	50	81	0.6172839
NODE_17328_length_692_cov_1.514334	404	484	2	6	80	0.0750000
NODE_17328_length_692_cov_1.514334	404	484	3	17	80	0.2125000
NODE_17328_length_692_cov_1.514334	404	484	5	5	80	0.0625000
NODE_17328_length_692_cov_1.514334	404	484	7	18	80	0.2250000
NODE_17328_length_692_cov_1.514334	404	484	9	13	80	0.1625000
NODE_17328_length_692_cov_1.514334	404	484	10	18	80	0.2250000
NODE_17328_length_692_cov_1.514334	404	484	11	3	80	0.0375000
NODE_17350_length_691_cov_115.233108	276	356	4	11	80	0.1375000
NODE_17350_length_691_cov_115.233108	276	356	6	21	80	0.2625000
NODE_17350_length_691_cov_115.233108	276	356	8	12	80	0.1500000
NODE_17350_length_691_cov_115.233108	276	356	13	19	80	0.2375000
NODE_17350_length_691_cov_115.233108	276	356	21	4	80	0.0500000
NODE_17350_length_691_cov_115.233108	276	356	25	3	80	0.0375000
NODE_17350_length_691_cov_115.233108	276	356	26	10	80	0.1250000
NODE_17350_length_691_cov_115.233108	329	409	13	10	80	0.1250000
NODE_17350_length_691_cov_115.233108	329	409	20	22	80	0.2750000
NODE_17350_length_691_cov_115.233108	329	409	21	4	80	0.0500000
NODE_17350_length_691_cov_115.233108	329	409	24	9	80	0.1125000
NODE_17350_length_691_cov_115.233108	329	409	25	3	80	0.0375000
NODE_17350_length_691_cov_115.233108	329	409	26	13	80	0.1625000
NODE_17350_length_691_cov_115.233108	329	409	28	19	80	0.2375000
NODE_17350_length_691_cov_115.233108	405	485	20	9	80	0.1125000
NODE_17350_length_691_cov_115.233108	405	485	21	2	80	0.0250000
NODE_17350_length_691_cov_115.233108	405	485	25	4	80	0.0500000
NODE_17350_length_691_cov_115.233108	405	485	31	2	80	0.0250000
NODE_17350_length_691_cov_115.233108	405	485	39	1	80	0.0125000
NODE_17350_length_691_cov_115.233108	405	485	41	3	80	0.0375000
NODE_17350_length_691_cov_115.233108	405	485	45	3	80	0.0375000
NODE_17350_length_691_cov_115.233108	405	485	47	4	80	0.0500000
NODE_17350_length_691_cov_115.233108	405	485	52	1	80	0.0125000
NODE_17350_length_691_cov_115.233108	405	485	53	2	80	0.0250000
NODE_17350_length_691_cov_115.233108	405	485	55	1	80	0.0125000
NODE_17350_length_691_cov_115.233108	405	485	57	6	80	0.0750000
NODE_17350_length_691_cov_115.233108	405	485	60	7	80	0.0875000
NODE_17350_length_691_cov_115.233108	405	485	61	5	80	0.0625000
NODE_17350_length_691_cov_115.233108	405	485	62	2	80	0.0250000
NODE_17350_length_691_cov_115.233108	405	485	64	2	80	0.0250000
NODE_17350_length_691_cov_115.233108	405	485	67	1	80	0.0125000
NODE_17350_length_691_cov_115.233108	405	485	72	1	80	0.0125000
NODE_17350_length_691_cov_115.233108	405	485	77	1	80	0.0125000
NODE_17350_length_691_cov_115.233108	405	485	79	1	80	0.0125000
NODE_17350_length_691_cov_115.233108	405	485	81	1	80	0.0125000
NODE_17350_length_691_cov_115.233108	405	485	90	1	80	0.0125000
NODE_17350_length_691_cov_115.233108	405	485	94	2	80	0.0250000
NODE_17350_length_691_cov_115.233108	405	485	96	1	80	0.0125000
NODE_17350_length_691_cov_115.233108	405	485	98	1	80	0.0125000
NODE_17350_length_691_cov_115.233108	405	485	110	1	80	0.0125000
NODE_17350_length_691_cov_115.233108	405	485	111	3	80	0.0375000
NODE_17350_length_691_cov_115.233108	405	485	123	1	80	0.0125000
NODE_17350_length_691_cov_115.233108	405	485	125	5	80	0.0625000
NODE_17350_length_691_cov_115.233108	405	485	129	1	80	0.0125000
NODE_17350_length_691_cov_115.233108	405	485	133	3	80	0.0375000
NODE_17350_length_691_cov_115.233108	405	485	134	1	80	0.0125000
NODE_17350_length_691_cov_115.233108	405	485	135	1	80	0.0125000
NODE_17350_length_691_cov_115.233108	458	538	60	1	80	0.0125000
NODE_17350_length_691_cov_115.233108	458	538	62	1	80	0.0125000
NODE_17350_length_691_cov_115.233108	458	538	72	1	80	0.0125000
NODE_17350_length_691_cov_115.233108	458	538	77	1	80	0.0125000
NODE_17350_length_691_cov_115.233108	458	538	79	1	80	0.0125000
NODE_17350_length_691_cov_115.233108	458	538	81	1	80	0.0125000
NODE_17350_length_691_cov_115.233108	458	538	90	1	80	0.0125000
NODE_17350_length_691_cov_115.233108	458	538	94	2	80	0.0250000
NODE_17350_length_691_cov_115.233108	458	538	96	1	80	0.0125000
NODE_17350_length_691_cov_115.233108	458	538	98	1	80	0.0125000
NODE_17350_length_691_cov_115.233108	458	538	110	1	80	0.0125000
NODE_17350_length_691_cov_115.233108	458	538	111	3	80	0.0375000
NODE_17350_length_691_cov_115.233108	458	538	123	1	80	0.0125000
NODE_17350_length_691_cov_115.233108	458	538	125	5	80	0.0625000
NODE_17350_length_691_cov_115.233108	458	538	129	1	80	0.0125000
NODE_17350_length_691_cov_115.233108	458	538	131	6	80	0.0750000
NODE_17350_length_691_cov_115.233108	458	538	133	3	80	0.0375000
NODE_17350_length_691_cov_115.233108	458	538	134	7	80	0.0875000
NODE_17350_length_691_cov_115.233108	458	538	135	13	80	0.1625000
NODE_17350_length_691_cov_115.233108	458	538	137	2	80	0.0250000
NODE_17350_length_691_cov_115.233108	458	538	139	10	80	0.1250000
NODE_17350_length_691_cov_115.233108	458	538	140	1	80	0.0125000
NODE_17350_length_691_cov_115.233108	458	538	141	4	80	0.0500000
NODE_17350_length_691_cov_115.233108	458	538	142	3	80	0.0375000
NODE_17350_length_691_cov_115.233108	458	538	144	3	80	0.0375000
NODE_17350_length_691_cov_115.233108	458	538	145	6	80	0.0750000
NODE_17351_length_691_cov_26.076014	188	268	10	52	80	0.6500000
NODE_17351_length_691_cov_26.076014	188	268	14	28	80	0.3500000
NODE_17351_length_691_cov_26.076014	241	321	4	1	80	0.0125000
NODE_17351_length_691_cov_26.076014	241	321	14	79	80	0.9875000
NODE_17352_length_691_cov_21.991554	288	368	0	80	80	1.0000000
NODE_17352_length_691_cov_21.991554	341	419	0	78	78	1.0000000
NODE_17353_length_691_cov_14.908784	226	306	0	6	80	0.0750000
NODE_17353_length_691_cov_14.908784	226	306	2	74	80	0.9250000
NODE_17353_length_691_cov_14.908784	279	359	0	44	80	0.5500000
NODE_17353_length_691_cov_14.908784	279	359	2	36	80	0.4500000
NODE_17358_length_691_cov_5.670608	325	402	0	77	77	1.0000000
NODE_17358_length_691_cov_5.670608	375	455	0	80	80	1.0000000
NODE_17361_length_691_cov_4.866554	103	183	0	25	80	0.3125000
NODE_17361_length_691_cov_4.866554	103	183	2	3	80	0.0375000
NODE_17361_length_691_cov_4.866554	103	183	4	52	80	0.6500000
NODE_17361_length_691_cov_4.866554	156	236	0	22	80	0.2750000
NODE_17361_length_691_cov_4.866554	156	236	2	12	80	0.1500000
NODE_17361_length_691_cov_4.866554	156	236	4	46	80	0.5750000
NODE_17367_length_691_cov_3.388514	304	384	0	73	80	0.9125000
NODE_17367_length_691_cov_3.388514	304	384	2	7	80	0.0875000
NODE_17367_length_691_cov_3.388514	357	437	0	20	80	0.2500000
NODE_17367_length_691_cov_3.388514	357	437	2	60	80	0.7500000
NODE_17415_length_690_cov_39.538071	563	612	4	49	49	1.0000000
NODE_17415_length_690_cov_39.538071	598	678	0	17	80	0.2125000
NODE_17415_length_690_cov_39.538071	598	678	4	63	80	0.7875000
NODE_17415_length_690_cov_39.538071	651	690	0	29	39	0.7435898
NODE_17415_length_690_cov_39.538071	651	690	4	10	39	0.2564103
NODE_17417_length_690_cov_30.336717	319	394	0	1	75	0.0133333
NODE_17417_length_690_cov_30.336717	319	394	2	74	75	0.9866667
NODE_17417_length_690_cov_30.336717	372	453	0	51	81	0.6296296
NODE_17417_length_690_cov_30.336717	372	453	2	30	81	0.3703704
NODE_17417_length_690_cov_30.336717	449	529	0	80	80	1.0000000
NODE_17417_length_690_cov_30.336717	502	582	0	80	80	1.0000000
NODE_17418_length_690_cov_26.888325	270	350	4	3	80	0.0375000
NODE_17418_length_690_cov_26.888325	270	350	8	67	80	0.8375000
NODE_17418_length_690_cov_26.888325	270	350	10	10	80	0.1250000
NODE_17418_length_690_cov_26.888325	323	403	0	26	80	0.3250000
NODE_17418_length_690_cov_26.888325	323	403	2	14	80	0.1750000
NODE_17418_length_690_cov_26.888325	323	403	4	16	80	0.2000000
NODE_17418_length_690_cov_26.888325	323	403	8	24	80	0.3000000
NODE_17419_length_690_cov_23.360406	131	211	6	41	80	0.5125000
NODE_17419_length_690_cov_23.360406	131	211	8	5	80	0.0625000
NODE_17419_length_690_cov_23.360406	131	211	10	15	80	0.1875000
NODE_17419_length_690_cov_23.360406	131	211	12	19	80	0.2375000
NODE_17419_length_690_cov_23.360406	188	264	4	7	76	0.0921053
NODE_17419_length_690_cov_23.360406	188	264	6	44	76	0.5789474
NODE_17419_length_690_cov_23.360406	188	264	8	7	76	0.0921053
NODE_17419_length_690_cov_23.360406	188	264	12	18	76	0.2368421
NODE_17420_length_690_cov_18.737733	316	396	0	71	80	0.8875000
NODE_17420_length_690_cov_18.737733	316	396	2	1	80	0.0125000
NODE_17420_length_690_cov_18.737733	316	396	4	8	80	0.1000000
NODE_17420_length_690_cov_18.737733	369	449	0	18	80	0.2250000
NODE_17420_length_690_cov_18.737733	369	449	2	1	80	0.0125000
NODE_17420_length_690_cov_18.737733	369	449	4	61	80	0.7625000
NODE_17421_length_690_cov_16.593909	364	444	0	80	80	1.0000000
NODE_17421_length_690_cov_16.593909	417	497	0	80	80	1.0000000
NODE_17422_length_690_cov_12.896785	320	400	0	80	80	1.0000000
NODE_17422_length_690_cov_12.896785	373	453	0	59	80	0.7375000
NODE_17422_length_690_cov_12.896785	373	453	2	21	80	0.2625000
NODE_17423_length_690_cov_10.818951	349	429	2	80	80	1.0000000
NODE_17424_length_690_cov_7.015228	273	353	0	80	80	1.0000000
NODE_17424_length_690_cov_7.015228	326	406	0	80	80	1.0000000
NODE_17429_length_690_cov_4.793570	316	365	65	1	49	0.0204082
NODE_17429_length_690_cov_4.793570	316	365	68	1	49	0.0204082
NODE_17429_length_690_cov_4.793570	316	365	70	2	49	0.0408163
NODE_17429_length_690_cov_4.793570	316	365	71	2	49	0.0408163
NODE_17429_length_690_cov_4.793570	316	365	72	3	49	0.0612245
NODE_17429_length_690_cov_4.793570	316	365	73	2	49	0.0408163
NODE_17429_length_690_cov_4.793570	316	365	74	2	49	0.0408163
NODE_17429_length_690_cov_4.793570	316	365	75	1	49	0.0204082
NODE_17429_length_690_cov_4.793570	316	365	76	2	49	0.0408163
NODE_17429_length_690_cov_4.793570	316	365	78	2	49	0.0408163
NODE_17429_length_690_cov_4.793570	316	365	83	1	49	0.0204082
NODE_17429_length_690_cov_4.793570	316	365	86	1	49	0.0204082
NODE_17429_length_690_cov_4.793570	316	365	88	7	49	0.1428571
NODE_17429_length_690_cov_4.793570	316	365	90	2	49	0.0408163
NODE_17429_length_690_cov_4.793570	316	365	92	4	49	0.0816327
NODE_17429_length_690_cov_4.793570	316	365	94	1	49	0.0204082
NODE_17429_length_690_cov_4.793570	316	365	98	2	49	0.0408163
NODE_17429_length_690_cov_4.793570	316	365	99	1	49	0.0204082
NODE_17429_length_690_cov_4.793570	316	365	101	1	49	0.0204082
NODE_17429_length_690_cov_4.793570	316	365	102	2	49	0.0408163
NODE_17429_length_690_cov_4.793570	316	365	103	3	49	0.0612245
NODE_17429_length_690_cov_4.793570	316	365	104	6	49	0.1224490
NODE_17430_length_690_cov_4.717428	316	396	0	36	80	0.4500000
NODE_17430_length_690_cov_4.717428	316	396	4	44	80	0.5500000
NODE_17430_length_690_cov_4.717428	369	449	0	80	80	1.0000000
NODE_17484_length_689_cov_45.984746	244	322	0	56	78	0.7179487
NODE_17484_length_689_cov_45.984746	244	322	2	22	78	0.2820513
NODE_17484_length_689_cov_45.984746	297	377	0	80	80	1.0000000
NODE_17485_length_689_cov_35.705085	436	516	0	80	80	1.0000000
NODE_17485_length_689_cov_35.705085	489	569	0	80	80	1.0000000
NODE_17486_length_689_cov_25.372881	211	291	0	31	80	0.3875000
NODE_17486_length_689_cov_25.372881	211	291	2	49	80	0.6125000
NODE_17486_length_689_cov_25.372881	264	344	2	48	80	0.6000000
NODE_17486_length_689_cov_25.372881	264	344	4	32	80	0.4000000
NODE_17487_length_689_cov_20.138983	319	399	0	7	80	0.0875000
NODE_17487_length_689_cov_20.138983	319	399	2	73	80	0.9125000
NODE_17487_length_689_cov_20.138983	372	452	0	43	80	0.5375000
NODE_17487_length_689_cov_20.138983	372	452	2	37	80	0.4625000
NODE_17488_length_689_cov_14.377966	351	431	0	45	80	0.5625000
NODE_17488_length_689_cov_14.377966	351	431	4	35	80	0.4375000
NODE_17488_length_689_cov_14.377966	404	484	4	80	80	1.0000000
NODE_17489_length_689_cov_9.477966	201	281	0	44	80	0.5500000
NODE_17489_length_689_cov_9.477966	201	281	2	10	80	0.1250000
NODE_17489_length_689_cov_9.477966	201	281	4	26	80	0.3250000
NODE_17489_length_689_cov_9.477966	254	334	0	80	80	1.0000000
NODE_17491_length_689_cov_7.367797	122	207	10	1	85	0.0117647
NODE_17491_length_689_cov_7.367797	122	207	12	22	85	0.2588235
NODE_17491_length_689_cov_7.367797	122	207	14	10	85	0.1176471
NODE_17491_length_689_cov_7.367797	122	207	16	4	85	0.0470588
NODE_17491_length_689_cov_7.367797	122	207	18	7	85	0.0823529
NODE_17491_length_689_cov_7.367797	122	207	22	41	85	0.4823529
NODE_17492_length_689_cov_6.649153	242	322	0	80	80	1.0000000
NODE_17492_length_689_cov_6.649153	295	375	0	80	80	1.0000000
NODE_17504_length_689_cov_2.788136	128	208	3	2	80	0.0250000
NODE_17504_length_689_cov_2.788136	128	208	4	26	80	0.3250000
NODE_17504_length_689_cov_2.788136	128	208	6	25	80	0.3125000
NODE_17504_length_689_cov_2.788136	128	208	8	27	80	0.3375000
NODE_17504_length_689_cov_2.788136	181	261	2	1	80	0.0125000
NODE_17504_length_689_cov_2.788136	181	261	4	30	80	0.3750000
NODE_17504_length_689_cov_2.788136	181	261	6	20	80	0.2500000
NODE_17504_length_689_cov_2.788136	181	261	8	29	80	0.3625000
NODE_17548_length_688_cov_52.256367	198	278	0	24	80	0.3000000
NODE_17548_length_688_cov_52.256367	198	278	2	28	80	0.3500000
NODE_17548_length_688_cov_52.256367	198	278	4	28	80	0.3500000
NODE_17548_length_688_cov_52.256367	251	331	0	9	80	0.1125000
NODE_17548_length_688_cov_52.256367	251	331	2	17	80	0.2125000
NODE_17548_length_688_cov_52.256367	251	331	4	54	80	0.6750000
NODE_17549_length_688_cov_37.563667	373	453	0	26	80	0.3250000
NODE_17549_length_688_cov_37.563667	373	453	2	54	80	0.6750000
NODE_17549_length_688_cov_37.563667	426	506	0	47	80	0.5875000
NODE_17549_length_688_cov_37.563667	426	506	2	33	80	0.4125000
NODE_17549_length_688_cov_37.563667	514	594	0	3	80	0.0375000
NODE_17549_length_688_cov_37.563667	514	594	2	33	80	0.4125000
NODE_17549_length_688_cov_37.563667	514	594	4	3	80	0.0375000
NODE_17549_length_688_cov_37.563667	514	594	6	41	80	0.5125000
NODE_17549_length_688_cov_37.563667	514	594	0	3	80	0.0375000
NODE_17549_length_688_cov_37.563667	514	594	2	33	80	0.4125000
NODE_17549_length_688_cov_37.563667	514	594	4	3	80	0.0375000
NODE_17549_length_688_cov_37.563667	514	594	6	41	80	0.5125000
NODE_17549_length_688_cov_37.563667	514	584	0	3	70	0.0428571
NODE_17549_length_688_cov_37.563667	514	584	2	33	70	0.4714286
NODE_17549_length_688_cov_37.563667	514	584	4	3	70	0.0428571
NODE_17549_length_688_cov_37.563667	514	584	6	31	70	0.4428571
NODE_17549_length_688_cov_37.563667	567	647	0	1	80	0.0125000
NODE_17549_length_688_cov_37.563667	567	647	2	2	80	0.0250000
NODE_17549_length_688_cov_37.563667	567	647	4	35	80	0.4375000
NODE_17549_length_688_cov_37.563667	567	647	6	42	80	0.5250000
NODE_17549_length_688_cov_37.563667	567	646	2	2	79	0.0253165
NODE_17549_length_688_cov_37.563667	567	646	4	35	79	0.4430380
NODE_17549_length_688_cov_37.563667	567	646	6	42	79	0.5316456
NODE_17550_length_688_cov_33.898132	373	453	0	58	80	0.7250000
NODE_17550_length_688_cov_33.898132	373	453	2	22	80	0.2750000
NODE_17550_length_688_cov_33.898132	426	506	0	80	80	1.0000000
NODE_17551_length_688_cov_26.769100	457	537	0	80	80	1.0000000
NODE_17551_length_688_cov_26.769100	510	590	0	80	80	1.0000000
NODE_17552_length_688_cov_22.517827	332	412	0	80	80	1.0000000
NODE_17552_length_688_cov_22.517827	385	465	0	80	80	1.0000000
NODE_17553_length_688_cov_16.796265	225	305	0	80	80	1.0000000
NODE_17553_length_688_cov_16.796265	278	358	0	80	80	1.0000000
NODE_17555_length_688_cov_13.758913	378	458	6	61	80	0.7625000
NODE_17555_length_688_cov_13.758913	378	458	8	19	80	0.2375000
NODE_17555_length_688_cov_13.758913	431	511	0	34	80	0.4250000
NODE_17555_length_688_cov_13.758913	431	511	2	15	80	0.1875000
NODE_17555_length_688_cov_13.758913	431	511	6	31	80	0.3875000
NODE_17556_length_688_cov_12.511036	330	410	0	80	80	1.0000000
NODE_17556_length_688_cov_12.511036	383	463	0	80	80	1.0000000
NODE_17561_length_688_cov_5.446520	366	414	2	27	48	0.5625000
NODE_17561_length_688_cov_5.446520	366	414	4	21	48	0.4375000
NODE_17567_length_688_cov_3.692699	265	345	0	80	80	1.0000000
NODE_17567_length_688_cov_3.692699	322	380	0	38	58	0.6551724
NODE_17567_length_688_cov_3.692699	322	380	2	20	58	0.3448276
NODE_17621_length_687_cov_50.214286	430	510	0	76	80	0.9500000
NODE_17621_length_687_cov_50.214286	430	510	2	4	80	0.0500000
NODE_17621_length_687_cov_50.214286	483	563	0	80	80	1.0000000
NODE_17622_length_687_cov_32.564626	204	284	0	12	80	0.1500000
NODE_17622_length_687_cov_32.564626	204	284	2	68	80	0.8500000
NODE_17622_length_687_cov_32.564626	257	337	0	29	80	0.3625000
NODE_17622_length_687_cov_32.564626	257	337	2	51	80	0.6375000
NODE_17623_length_687_cov_22.365646	231	311	0	49	80	0.6125000
NODE_17623_length_687_cov_22.365646	231	311	2	31	80	0.3875000
NODE_17623_length_687_cov_22.365646	284	364	2	80	80	1.0000000
NODE_17626_length_687_cov_11.943878	233	313	0	80	80	1.0000000
NODE_17626_length_687_cov_11.943878	286	366	0	80	80	1.0000000
NODE_17627_length_687_cov_7.865646	311	391	0	80	80	1.0000000
NODE_17627_length_687_cov_7.865646	364	444	0	69	80	0.8625000
NODE_17627_length_687_cov_7.865646	364	444	2	11	80	0.1375000
NODE_17628_length_687_cov_7.353741	286	366	0	80	80	1.0000000
NODE_17628_length_687_cov_7.353741	339	419	0	80	80	1.0000000
NODE_17631_length_687_cov_5.903061	369	449	0	78	80	0.9750000
NODE_17631_length_687_cov_5.903061	369	449	2	2	80	0.0250000
NODE_17631_length_687_cov_5.903061	422	502	0	80	80	1.0000000
NODE_17695_length_686_cov_34.642249	355	440	0	1	85	0.0117647
NODE_17695_length_686_cov_34.642249	355	440	2	12	85	0.1411765
NODE_17695_length_686_cov_34.642249	355	440	4	4	85	0.0470588
NODE_17695_length_686_cov_34.642249	355	440	6	68	85	0.8000000
NODE_17695_length_686_cov_34.642249	413	493	0	54	80	0.6750000
NODE_17695_length_686_cov_34.642249	413	493	2	12	80	0.1500000
NODE_17695_length_686_cov_34.642249	413	493	6	14	80	0.1750000
NODE_17697_length_686_cov_26.357751	413	493	2	66	80	0.8250000
NODE_17697_length_686_cov_26.357751	413	493	4	14	80	0.1750000
NODE_17697_length_686_cov_26.357751	466	546	0	14	80	0.1750000
NODE_17697_length_686_cov_26.357751	466	546	2	53	80	0.6625000
NODE_17697_length_686_cov_26.357751	466	546	4	13	80	0.1625000
NODE_17698_length_686_cov_16.715503	400	480	0	80	80	1.0000000
NODE_17698_length_686_cov_16.715503	453	533	0	80	80	1.0000000
NODE_17757_length_685_cov_8.769625	178	258	0	8	80	0.1000000
NODE_17757_length_685_cov_8.769625	178	258	3	38	80	0.4750000
NODE_17757_length_685_cov_8.769625	178	258	4	34	80	0.4250000
NODE_17757_length_685_cov_8.769625	222	250	3	12	28	0.4285714
NODE_17757_length_685_cov_8.769625	222	250	4	16	28	0.5714286
NODE_17757_length_685_cov_8.769625	231	311	0	61	80	0.7625000
NODE_17757_length_685_cov_8.769625	231	311	3	12	80	0.1500000
NODE_17757_length_685_cov_8.769625	231	311	4	7	80	0.0875000
NODE_17764_length_685_cov_4.447099	249	329	2	80	80	1.0000000
NODE_17764_length_685_cov_4.447099	302	382	0	21	80	0.2625000
NODE_17764_length_685_cov_4.447099	302	382	2	59	80	0.7375000
NODE_17768_length_685_cov_3.556314	338	418	0	80	80	1.0000000
NODE_17768_length_685_cov_3.556314	391	471	0	36	80	0.4500000
NODE_17768_length_685_cov_3.556314	391	471	2	44	80	0.5500000
NODE_17821_length_684_cov_7.521368	189	269	0	28	80	0.3500000
NODE_17821_length_684_cov_7.521368	189	269	2	52	80	0.6500000
NODE_17821_length_684_cov_7.521368	242	322	2	80	80	1.0000000
NODE_17832_length_684_cov_3.639316	306	386	1	2	80	0.0250000
NODE_17832_length_684_cov_3.639316	306	386	2	78	80	0.9750000
NODE_17832_length_684_cov_3.639316	359	439	0	53	80	0.6625000
NODE_17832_length_684_cov_3.639316	359	439	1	2	80	0.0250000
NODE_17832_length_684_cov_3.639316	359	439	2	25	80	0.3125000
NODE_17866_length_683_cov_27.493151	346	426	0	34	80	0.4250000
NODE_17866_length_683_cov_27.493151	346	426	2	46	80	0.5750000
NODE_17866_length_683_cov_27.493151	399	479	0	80	80	1.0000000
NODE_17867_length_683_cov_12.880137	242	321	2	13	79	0.1645570
NODE_17867_length_683_cov_12.880137	242	321	4	13	79	0.1645570
NODE_17867_length_683_cov_12.880137	242	321	8	12	79	0.1518987
NODE_17867_length_683_cov_12.880137	242	321	10	1	79	0.0126582
NODE_17867_length_683_cov_12.880137	242	321	12	40	79	0.5063291
NODE_17868_length_683_cov_11.772260	218	274	0	56	56	1.0000000
NODE_17868_length_683_cov_11.772260	247	333	0	86	86	1.0000000
NODE_17869_length_683_cov_9.936644	435	515	2	8	80	0.1000000
NODE_17869_length_683_cov_9.936644	435	515	4	47	80	0.5875000
NODE_17869_length_683_cov_9.936644	435	515	6	25	80	0.3125000
NODE_17869_length_683_cov_9.936644	488	568	0	11	80	0.1375000
NODE_17869_length_683_cov_9.936644	488	568	2	8	80	0.1000000
NODE_17869_length_683_cov_9.936644	488	568	4	43	80	0.5375000
NODE_17869_length_683_cov_9.936644	488	568	6	18	80	0.2250000
NODE_17871_length_683_cov_9.017123	296	364	0	68	68	1.0000000
NODE_17871_length_683_cov_9.017123	337	417	0	74	80	0.9250000
NODE_17871_length_683_cov_9.017123	337	417	2	6	80	0.0750000
NODE_17873_length_683_cov_6.797945	359	415	0	47	56	0.8392857
NODE_17873_length_683_cov_6.797945	359	415	2	9	56	0.1607143
NODE_17884_length_683_cov_3.176370	113	186	0	73	73	1.0000000
NODE_17947_length_682_cov_33.516295	423	503	0	80	80	1.0000000
NODE_17947_length_682_cov_33.516295	476	556	0	80	80	1.0000000
NODE_17948_length_682_cov_27.022298	479	559	0	59	80	0.7375000
NODE_17948_length_682_cov_27.022298	479	559	2	5	80	0.0625000
NODE_17948_length_682_cov_27.022298	479	559	4	4	80	0.0500000
NODE_17948_length_682_cov_27.022298	479	559	8	3	80	0.0375000
NODE_17948_length_682_cov_27.022298	479	559	10	1	80	0.0125000
NODE_17948_length_682_cov_27.022298	479	559	14	2	80	0.0250000
NODE_17948_length_682_cov_27.022298	479	559	16	5	80	0.0625000
NODE_17948_length_682_cov_27.022298	479	559	17	1	80	0.0125000
NODE_17948_length_682_cov_27.022298	532	612	0	6	80	0.0750000
NODE_17948_length_682_cov_27.022298	532	612	2	5	80	0.0625000
NODE_17948_length_682_cov_27.022298	532	612	4	4	80	0.0500000
NODE_17948_length_682_cov_27.022298	532	612	8	3	80	0.0375000
NODE_17948_length_682_cov_27.022298	532	612	10	1	80	0.0125000
NODE_17948_length_682_cov_27.022298	532	612	14	2	80	0.0250000
NODE_17948_length_682_cov_27.022298	532	612	16	5	80	0.0625000
NODE_17948_length_682_cov_27.022298	532	612	17	1	80	0.0125000
NODE_17948_length_682_cov_27.022298	532	612	20	16	80	0.2000000
NODE_17948_length_682_cov_27.022298	532	612	22	37	80	0.4625000
NODE_17949_length_682_cov_19.612350	434	514	0	4	80	0.0500000
NODE_17949_length_682_cov_19.612350	434	514	6	76	80	0.9500000
NODE_17949_length_682_cov_19.612350	487	567	0	57	80	0.7125000
NODE_17949_length_682_cov_19.612350	487	567	6	23	80	0.2875000
NODE_17950_length_682_cov_16.620926	261	341	0	80	80	1.0000000
NODE_17950_length_682_cov_16.620926	314	394	0	80	80	1.0000000
NODE_17951_length_682_cov_13.735849	251	331	0	80	80	1.0000000
NODE_17951_length_682_cov_13.735849	304	384	0	80	80	1.0000000
NODE_17952_length_682_cov_12.835334	228	308	0	80	80	1.0000000
NODE_17952_length_682_cov_12.835334	281	361	0	80	80	1.0000000
NODE_17956_length_682_cov_7.504288	224	304	0	80	80	1.0000000
NODE_17956_length_682_cov_7.504288	277	357	0	80	80	1.0000000
NODE_17960_length_682_cov_5.102916	314	351	0	37	37	1.0000000
NODE_17963_length_682_cov_4.579760	152	232	0	35	80	0.4375000
NODE_17963_length_682_cov_4.579760	152	232	2	45	80	0.5625000
NODE_17963_length_682_cov_4.579760	205	285	0	23	80	0.2875000
NODE_17963_length_682_cov_4.579760	205	285	2	57	80	0.7125000
NODE_17967_length_682_cov_4.006861	317	397	0	80	80	1.0000000
NODE_17967_length_682_cov_4.006861	370	450	0	80	80	1.0000000
NODE_17968_length_682_cov_3.859348	160	240	0	80	80	1.0000000
NODE_17968_length_682_cov_3.859348	213	293	0	80	80	1.0000000
NODE_18010_length_681_cov_51.810997	181	261	0	21	80	0.2625000
NODE_18010_length_681_cov_51.810997	181	261	2	16	80	0.2000000
NODE_18010_length_681_cov_51.810997	181	261	4	43	80	0.5375000
NODE_18010_length_681_cov_51.810997	234	316	2	40	82	0.4878049
NODE_18010_length_681_cov_51.810997	234	316	4	42	82	0.5121951
NODE_18011_length_681_cov_32.128866	347	427	0	60	80	0.7500000
NODE_18011_length_681_cov_32.128866	347	427	2	5	80	0.0625000
NODE_18011_length_681_cov_32.128866	347	427	4	15	80	0.1875000
NODE_18011_length_681_cov_32.128866	400	475	0	75	75	1.0000000
NODE_18012_length_681_cov_19.079038	282	362	0	17	80	0.2125000
NODE_18012_length_681_cov_19.079038	282	362	2	47	80	0.5875000
NODE_18012_length_681_cov_19.079038	282	362	4	14	80	0.1750000
NODE_18012_length_681_cov_19.079038	282	362	6	2	80	0.0250000
NODE_18012_length_681_cov_19.079038	335	415	2	14	80	0.1750000
NODE_18012_length_681_cov_19.079038	335	415	4	16	80	0.2000000
NODE_18012_length_681_cov_19.079038	335	415	6	50	80	0.6250000
NODE_18013_length_681_cov_17.053265	294	374	0	80	80	1.0000000
NODE_18013_length_681_cov_17.053265	347	427	0	30	80	0.3750000
NODE_18013_length_681_cov_17.053265	347	427	2	50	80	0.6250000
NODE_18014_length_681_cov_11.183849	306	386	0	80	80	1.0000000
NODE_18014_length_681_cov_11.183849	359	439	0	80	80	1.0000000
NODE_18015_length_681_cov_8.065292	236	316	0	80	80	1.0000000
NODE_18015_length_681_cov_8.065292	289	369	0	80	80	1.0000000
NODE_18017_length_681_cov_6.888316	344	424	0	80	80	1.0000000
NODE_18017_length_681_cov_6.888316	397	477	0	80	80	1.0000000
NODE_18080_length_680_cov_35.695353	348	428	0	20	80	0.2500000
NODE_18080_length_680_cov_35.695353	348	428	2	60	80	0.7500000
NODE_18080_length_680_cov_35.695353	401	481	0	5	80	0.0625000
NODE_18080_length_680_cov_35.695353	401	481	2	75	80	0.9375000
NODE_18081_length_680_cov_17.500861	296	376	0	80	80	1.0000000
NODE_18081_length_680_cov_17.500861	349	429	0	80	80	1.0000000
NODE_18082_length_680_cov_16.685026	260	340	0	65	80	0.8125000
NODE_18082_length_680_cov_16.685026	260	340	6	15	80	0.1875000
NODE_18082_length_680_cov_16.685026	313	393	0	12	80	0.1500000
NODE_18082_length_680_cov_16.685026	313	393	6	66	80	0.8250000
NODE_18082_length_680_cov_16.685026	313	393	8	2	80	0.0250000
NODE_18083_length_680_cov_15.345955	332	412	0	80	80	1.0000000
NODE_18083_length_680_cov_15.345955	385	465	0	80	80	1.0000000
NODE_18089_length_680_cov_3.858864	458	538	0	80	80	1.0000000
NODE_18107_length_680_cov_1.879518	236	256	4	20	20	1.0000000
NODE_18146_length_679_cov_52.046552	367	447	2	80	80	1.0000000
NODE_18146_length_679_cov_52.046552	420	500	0	40	80	0.5000000
NODE_18146_length_679_cov_52.046552	420	500	2	40	80	0.5000000
NODE_18147_length_679_cov_40.353448	179	259	2	80	80	1.0000000
NODE_18147_length_679_cov_40.353448	232	312	0	25	80	0.3125000
NODE_18147_length_679_cov_40.353448	232	312	2	55	80	0.6875000
NODE_18148_length_679_cov_38.144828	364	428	0	17	64	0.2656250
NODE_18148_length_679_cov_38.144828	364	428	2	47	64	0.7343750
NODE_18148_length_679_cov_38.144828	401	481	0	70	80	0.8750000
NODE_18148_length_679_cov_38.144828	401	481	2	10	80	0.1250000
NODE_18149_length_679_cov_17.134483	277	357	0	80	80	1.0000000
NODE_18149_length_679_cov_17.134483	330	410	0	80	80	1.0000000
NODE_18150_length_679_cov_15.046552	310	375	0	65	65	1.0000000
NODE_18151_length_679_cov_12.586207	247	327	0	37	80	0.4625000
NODE_18151_length_679_cov_12.586207	247	327	2	43	80	0.5375000
NODE_18151_length_679_cov_12.586207	303	381	0	27	78	0.3461539
NODE_18151_length_679_cov_12.586207	303	381	2	51	78	0.6538461
NODE_18152_length_679_cov_12.282759	337	417	0	80	80	1.0000000
NODE_18152_length_679_cov_12.282759	390	470	0	44	80	0.5500000
NODE_18152_length_679_cov_12.282759	390	470	2	36	80	0.4500000
NODE_18153_length_679_cov_11.532759	205	285	0	80	80	1.0000000
NODE_18153_length_679_cov_11.532759	258	338	0	80	80	1.0000000
NODE_18155_length_679_cov_8.043103	269	341	0	72	72	1.0000000
NODE_18155_length_679_cov_8.043103	314	394	0	80	80	1.0000000
NODE_18156_length_679_cov_7.267241	191	271	4	4	80	0.0500000
NODE_18156_length_679_cov_7.267241	191	271	5	22	80	0.2750000
NODE_18156_length_679_cov_7.267241	191	271	7	54	80	0.6750000
NODE_18156_length_679_cov_7.267241	244	324	2	33	80	0.4125000
NODE_18156_length_679_cov_7.267241	244	324	5	5	80	0.0625000
NODE_18156_length_679_cov_7.267241	244	324	7	42	80	0.5250000
NODE_18162_length_679_cov_5.391379	279	331	2	9	52	0.1730769
NODE_18162_length_679_cov_5.391379	279	331	6	8	52	0.1538462
NODE_18162_length_679_cov_5.391379	279	331	10	8	52	0.1538462
NODE_18162_length_679_cov_5.391379	279	331	12	11	52	0.2115385
NODE_18162_length_679_cov_5.391379	279	331	14	16	52	0.3076923
NODE_18164_length_679_cov_3.813793	10	69	2	9	59	0.1525424
NODE_18164_length_679_cov_3.813793	10	69	6	3	59	0.0508475
NODE_18164_length_679_cov_3.813793	10	69	8	3	59	0.0508475
NODE_18164_length_679_cov_3.813793	10	69	10	44	59	0.7457627
NODE_18164_length_679_cov_3.813793	48	122	6	15	74	0.2027027
NODE_18164_length_679_cov_3.813793	48	122	8	14	74	0.1891892
NODE_18164_length_679_cov_3.813793	48	122	10	45	74	0.6081081
NODE_18217_length_678_cov_38.910190	252	332	0	80	80	1.0000000
NODE_18217_length_678_cov_38.910190	305	385	0	28	80	0.3500000
NODE_18217_length_678_cov_38.910190	305	385	2	52	80	0.6500000
NODE_18217_length_678_cov_38.910190	381	461	0	1	80	0.0125000
NODE_18217_length_678_cov_38.910190	381	461	2	79	80	0.9875000
NODE_18217_length_678_cov_38.910190	434	514	0	54	80	0.6750000
NODE_18217_length_678_cov_38.910190	434	514	2	26	80	0.3250000
NODE_18218_length_678_cov_20.663212	243	323	0	80	80	1.0000000
NODE_18218_length_678_cov_20.663212	296	376	0	80	80	1.0000000
NODE_18219_length_678_cov_12.081174	243	323	0	80	80	1.0000000
NODE_18219_length_678_cov_12.081174	296	376	0	80	80	1.0000000
NODE_18224_length_678_cov_6.559585	195	264	0	69	69	1.0000000
NODE_18224_length_678_cov_6.559585	237	317	0	80	80	1.0000000
NODE_18228_length_678_cov_4.462867	133	213	0	44	80	0.5500000
NODE_18228_length_678_cov_4.462867	133	213	2	36	80	0.4500000
NODE_18228_length_678_cov_4.462867	186	266	0	20	80	0.2500000
NODE_18228_length_678_cov_4.462867	186	266	2	60	80	0.7500000
NODE_18239_length_678_cov_2.716753	351	431	0	49	80	0.6125000
NODE_18239_length_678_cov_2.716753	351	431	2	31	80	0.3875000
NODE_18239_length_678_cov_2.716753	404	484	2	80	80	1.0000000
NODE_18289_length_677_cov_22.235294	274	354	0	80	80	1.0000000
NODE_18289_length_677_cov_22.235294	327	407	0	80	80	1.0000000
NODE_18290_length_677_cov_16.410035	124	206	0	82	82	1.0000000
NODE_18290_length_677_cov_16.410035	177	261	0	84	84	1.0000000
NODE_18291_length_677_cov_11.031142	393	473	0	47	80	0.5875000
NODE_18291_length_677_cov_11.031142	393	473	1	2	80	0.0250000
NODE_18291_length_677_cov_11.031142	393	473	3	24	80	0.3000000
NODE_18291_length_677_cov_11.031142	393	473	4	7	80	0.0875000
NODE_18291_length_677_cov_11.031142	446	526	0	80	80	1.0000000
NODE_18292_length_677_cov_10.129758	258	338	2	80	80	1.0000000
NODE_18292_length_677_cov_10.129758	311	391	0	50	80	0.6250000
NODE_18292_length_677_cov_10.129758	311	391	2	30	80	0.3750000
NODE_18295_length_677_cov_6.660900	217	297	30	5	80	0.0625000
NODE_18295_length_677_cov_6.660900	217	297	32	1	80	0.0125000
NODE_18295_length_677_cov_6.660900	217	297	34	2	80	0.0250000
NODE_18295_length_677_cov_6.660900	217	297	36	1	80	0.0125000
NODE_18295_length_677_cov_6.660900	217	297	38	9	80	0.1125000
NODE_18295_length_677_cov_6.660900	217	297	40	4	80	0.0500000
NODE_18295_length_677_cov_6.660900	217	297	42	2	80	0.0250000
NODE_18295_length_677_cov_6.660900	217	297	44	3	80	0.0375000
NODE_18295_length_677_cov_6.660900	217	297	46	5	80	0.0625000
NODE_18295_length_677_cov_6.660900	217	297	48	25	80	0.3125000
NODE_18295_length_677_cov_6.660900	217	297	50	23	80	0.2875000
NODE_18297_length_677_cov_5.228374	366	446	2	80	80	1.0000000
NODE_18312_length_677_cov_2.306228	230	278	0	48	48	1.0000000
NODE_18329_length_677_cov_1.709343	369	449	0	80	80	1.0000000
NODE_18329_length_677_cov_1.709343	422	502	0	40	80	0.5000000
NODE_18329_length_677_cov_1.709343	422	502	2	40	80	0.5000000
NODE_18368_length_676_cov_66.473137	286	366	3	19	80	0.2375000
NODE_18368_length_676_cov_66.473137	286	366	4	61	80	0.7625000
NODE_18368_length_676_cov_66.473137	339	419	0	11	80	0.1375000
NODE_18368_length_676_cov_66.473137	339	419	2	3	80	0.0375000
NODE_18368_length_676_cov_66.473137	339	419	3	26	80	0.3250000
NODE_18368_length_676_cov_66.473137	339	419	4	9	80	0.1125000
NODE_18368_length_676_cov_66.473137	339	419	8	2	80	0.0250000
NODE_18368_length_676_cov_66.473137	339	419	14	1	80	0.0125000
NODE_18368_length_676_cov_66.473137	339	419	16	1	80	0.0125000
NODE_18368_length_676_cov_66.473137	339	419	22	1	80	0.0125000
NODE_18368_length_676_cov_66.473137	339	419	23	4	80	0.0500000
NODE_18368_length_676_cov_66.473137	339	419	27	22	80	0.2750000
NODE_18368_length_676_cov_66.473137	383	419	0	2	36	0.0555556
NODE_18368_length_676_cov_66.473137	383	419	2	2	36	0.0555556
NODE_18368_length_676_cov_66.473137	383	419	4	1	36	0.0277778
NODE_18368_length_676_cov_66.473137	383	419	8	2	36	0.0555556
NODE_18368_length_676_cov_66.473137	383	419	14	1	36	0.0277778
NODE_18368_length_676_cov_66.473137	383	419	16	1	36	0.0277778
NODE_18368_length_676_cov_66.473137	383	419	22	1	36	0.0277778
NODE_18368_length_676_cov_66.473137	383	419	23	4	36	0.1111111
NODE_18368_length_676_cov_66.473137	383	419	27	22	36	0.6111111
NODE_18368_length_676_cov_66.473137	383	419	0	2	36	0.0555556
NODE_18368_length_676_cov_66.473137	383	419	2	2	36	0.0555556
NODE_18368_length_676_cov_66.473137	383	419	4	1	36	0.0277778
NODE_18368_length_676_cov_66.473137	383	419	8	2	36	0.0555556
NODE_18368_length_676_cov_66.473137	383	419	14	1	36	0.0277778
NODE_18368_length_676_cov_66.473137	383	419	16	1	36	0.0277778
NODE_18368_length_676_cov_66.473137	383	419	22	1	36	0.0277778
NODE_18368_length_676_cov_66.473137	383	419	23	4	36	0.1111111
NODE_18368_length_676_cov_66.473137	383	419	27	22	36	0.6111111
NODE_18368_length_676_cov_66.473137	398	419	27	21	21	1.0000000
NODE_18369_length_676_cov_14.429809	259	330	14	7	71	0.0985916
NODE_18369_length_676_cov_14.429809	259	330	15	6	71	0.0845070
NODE_18369_length_676_cov_14.429809	259	330	16	13	71	0.1830986
NODE_18369_length_676_cov_14.429809	259	330	17	3	71	0.0422535
NODE_18369_length_676_cov_14.429809	259	330	20	1	71	0.0140845
NODE_18369_length_676_cov_14.429809	259	330	22	2	71	0.0281690
NODE_18369_length_676_cov_14.429809	259	330	23	1	71	0.0140845
NODE_18369_length_676_cov_14.429809	259	330	24	19	71	0.2676056
NODE_18369_length_676_cov_14.429809	259	330	26	1	71	0.0140845
NODE_18369_length_676_cov_14.429809	259	330	27	5	71	0.0704225
NODE_18369_length_676_cov_14.429809	259	330	28	13	71	0.1830986
NODE_18370_length_676_cov_13.882149	292	372	0	80	80	1.0000000
NODE_18370_length_676_cov_13.882149	345	425	0	80	80	1.0000000
NODE_18374_length_676_cov_7.225303	363	443	0	80	80	1.0000000
NODE_18374_length_676_cov_7.225303	416	496	0	80	80	1.0000000
NODE_18375_length_676_cov_6.740035	373	433	0	60	60	1.0000000
NODE_18375_length_676_cov_6.740035	406	486	0	80	80	1.0000000
NODE_18378_length_676_cov_4.658579	167	240	2	2	73	0.0273973
NODE_18378_length_676_cov_4.658579	167	240	4	46	73	0.6301370
NODE_18378_length_676_cov_4.658579	167	240	6	25	73	0.3424658
NODE_18397_length_676_cov_2.292894	146	226	0	62	80	0.7750000
NODE_18397_length_676_cov_2.292894	146	226	4	14	80	0.1750000
NODE_18397_length_676_cov_2.292894	146	226	6	4	80	0.0500000
NODE_18401_length_676_cov_2.157712	175	226	0	51	51	1.0000000
NODE_18417_length_676_cov_1.547660	133	164	2	31	31	1.0000000
NODE_18447_length_675_cov_27.574653	190	270	0	80	80	1.0000000
NODE_18447_length_675_cov_27.574653	243	323	0	30	80	0.3750000
NODE_18447_length_675_cov_27.574653	243	323	2	50	80	0.6250000
NODE_18448_length_675_cov_11.895833	336	416	0	45	80	0.5625000
NODE_18448_length_675_cov_11.895833	336	416	2	35	80	0.4375000
NODE_18448_length_675_cov_11.895833	389	469	0	13	80	0.1625000
NODE_18448_length_675_cov_11.895833	389	469	2	67	80	0.8375000
NODE_18449_length_675_cov_8.157986	414	494	0	30	80	0.3750000
NODE_18449_length_675_cov_8.157986	414	494	2	50	80	0.6250000
NODE_18449_length_675_cov_8.157986	467	547	0	25	80	0.3125000
NODE_18449_length_675_cov_8.157986	467	547	2	55	80	0.6875000
NODE_18450_length_675_cov_8.026042	320	400	0	19	80	0.2375000
NODE_18450_length_675_cov_8.026042	320	400	2	61	80	0.7625000
NODE_18450_length_675_cov_8.026042	373	453	0	16	80	0.2000000
NODE_18450_length_675_cov_8.026042	373	453	2	64	80	0.8000000
NODE_18451_length_675_cov_7.277778	317	397	0	80	80	1.0000000
NODE_18455_length_675_cov_5.666667	142	222	0	80	80	1.0000000
NODE_18455_length_675_cov_5.666667	195	275	0	80	80	1.0000000
NODE_18464_length_675_cov_2.751736	67	122	0	1	55	0.0181818
NODE_18464_length_675_cov_2.751736	67	122	2	1	55	0.0181818
NODE_18464_length_675_cov_2.751736	67	122	4	53	55	0.9636363
NODE_18467_length_675_cov_2.623264	251	289	0	38	38	1.0000000
NODE_18467_length_675_cov_2.623264	279	343	0	64	64	1.0000000
NODE_18467_length_675_cov_2.623264	432	494	2	62	62	1.0000000
NODE_18515_length_674_cov_38.401739	225	305	2	48	80	0.6000000
NODE_18515_length_674_cov_38.401739	225	305	6	3	80	0.0375000
NODE_18515_length_674_cov_38.401739	225	305	9	15	80	0.1875000
NODE_18515_length_674_cov_38.401739	225	305	10	14	80	0.1750000
NODE_18515_length_674_cov_38.401739	278	358	0	5	80	0.0625000
NODE_18515_length_674_cov_38.401739	278	358	4	6	80	0.0750000
NODE_18515_length_674_cov_38.401739	278	358	8	42	80	0.5250000
NODE_18515_length_674_cov_38.401739	278	358	9	15	80	0.1875000
NODE_18515_length_674_cov_38.401739	278	358	10	12	80	0.1500000
NODE_18516_length_674_cov_30.215652	519	599	35	1	80	0.0125000
NODE_18516_length_674_cov_30.215652	519	599	36	1	80	0.0125000
NODE_18516_length_674_cov_30.215652	519	599	40	1	80	0.0125000
NODE_18516_length_674_cov_30.215652	519	599	42	3	80	0.0375000
NODE_18516_length_674_cov_30.215652	519	599	44	2	80	0.0250000
NODE_18516_length_674_cov_30.215652	519	599	46	5	80	0.0625000
NODE_18516_length_674_cov_30.215652	519	599	48	5	80	0.0625000
NODE_18516_length_674_cov_30.215652	519	599	50	1	80	0.0125000
NODE_18516_length_674_cov_30.215652	519	599	52	3	80	0.0375000
NODE_18516_length_674_cov_30.215652	519	599	54	8	80	0.1000000
NODE_18516_length_674_cov_30.215652	519	599	56	35	80	0.4375000
NODE_18516_length_674_cov_30.215652	519	599	58	15	80	0.1875000
NODE_18516_length_674_cov_30.215652	572	602	44	3	30	0.1000000
NODE_18516_length_674_cov_30.215652	572	602	46	1	30	0.0333333
NODE_18516_length_674_cov_30.215652	572	602	52	3	30	0.1000000
NODE_18516_length_674_cov_30.215652	572	602	54	8	30	0.2666667
NODE_18516_length_674_cov_30.215652	572	602	56	13	30	0.4333333
NODE_18516_length_674_cov_30.215652	572	602	58	2	30	0.0666667
NODE_18517_length_674_cov_19.636522	283	363	0	47	80	0.5875000
NODE_18517_length_674_cov_19.636522	283	363	4	33	80	0.4125000
NODE_18517_length_674_cov_19.636522	336	416	4	80	80	1.0000000
NODE_18518_length_674_cov_19.436522	81	161	0	38	80	0.4750000
NODE_18518_length_674_cov_19.436522	81	161	2	42	80	0.5250000
NODE_18518_length_674_cov_19.436522	134	214	0	80	80	1.0000000
NODE_18519_length_674_cov_16.819130	185	265	0	80	80	1.0000000
NODE_18519_length_674_cov_16.819130	238	318	0	80	80	1.0000000
NODE_18520_length_674_cov_14.733913	169	249	4	50	80	0.6250000
NODE_18520_length_674_cov_14.733913	169	249	6	30	80	0.3750000
NODE_18520_length_674_cov_14.733913	222	302	2	6	80	0.0750000
NODE_18520_length_674_cov_14.733913	222	302	6	74	80	0.9250000
NODE_18524_length_674_cov_7.086957	357	437	4	80	80	1.0000000
NODE_18524_length_674_cov_7.086957	410	490	0	32	80	0.4000000
NODE_18524_length_674_cov_7.086957	410	490	4	48	80	0.6000000
NODE_18528_length_674_cov_4.808696	262	342	0	80	80	1.0000000
NODE_18528_length_674_cov_4.808696	315	395	0	80	80	1.0000000
NODE_18592_length_673_cov_47.109756	405	485	0	38	80	0.4750000
NODE_18592_length_673_cov_47.109756	405	485	2	42	80	0.5250000
NODE_18592_length_673_cov_47.109756	458	538	2	80	80	1.0000000
NODE_18593_length_673_cov_20.548780	214	294	0	47	80	0.5875000
NODE_18593_length_673_cov_20.548780	214	294	2	33	80	0.4125000
NODE_18593_length_673_cov_20.548780	267	347	0	80	80	1.0000000
NODE_18596_length_673_cov_8.306620	337	426	0	56	89	0.6292135
NODE_18596_length_673_cov_8.306620	337	426	2	33	89	0.3707865
NODE_18607_length_673_cov_3.041812	196	276	0	7	80	0.0875000
NODE_18607_length_673_cov_3.041812	196	276	2	73	80	0.9125000
NODE_18607_length_673_cov_3.041812	249	329	0	50	80	0.6250000
NODE_18607_length_673_cov_3.041812	249	329	2	30	80	0.3750000
NODE_18660_length_672_cov_15.380454	282	362	0	80	80	1.0000000
NODE_18660_length_672_cov_15.380454	335	415	0	80	80	1.0000000
NODE_18661_length_672_cov_9.902269	328	408	0	6	80	0.0750000
NODE_18661_length_672_cov_9.902269	328	408	4	74	80	0.9250000
NODE_18661_length_672_cov_9.902269	381	461	0	59	80	0.7375000
NODE_18661_length_672_cov_9.902269	381	461	4	21	80	0.2625000
NODE_18662_length_672_cov_9.462478	309	389	2	15	80	0.1875000
NODE_18662_length_672_cov_9.462478	309	389	6	55	80	0.6875000
NODE_18662_length_672_cov_9.462478	309	389	8	10	80	0.1250000
NODE_18662_length_672_cov_9.462478	362	442	0	9	80	0.1125000
NODE_18662_length_672_cov_9.462478	362	442	2	3	80	0.0375000
NODE_18662_length_672_cov_9.462478	362	442	6	62	80	0.7750000
NODE_18662_length_672_cov_9.462478	362	442	8	6	80	0.0750000
NODE_18666_length_672_cov_6.516579	354	434	2	69	80	0.8625000
NODE_18666_length_672_cov_6.516579	354	434	4	9	80	0.1125000
NODE_18666_length_672_cov_6.516579	354	434	6	2	80	0.0250000
NODE_18666_length_672_cov_6.516579	407	487	2	25	80	0.3125000
NODE_18666_length_672_cov_6.516579	407	487	4	11	80	0.1375000
NODE_18666_length_672_cov_6.516579	407	487	6	44	80	0.5500000
NODE_18668_length_672_cov_6.108202	135	215	0	80	80	1.0000000
NODE_18668_length_672_cov_6.108202	188	268	0	39	80	0.4875000
NODE_18668_length_672_cov_6.108202	188	268	2	41	80	0.5125000
NODE_18670_length_672_cov_4.949389	115	152	0	37	37	1.0000000
NODE_18670_length_672_cov_4.949389	125	205	0	80	80	1.0000000
NODE_18670_length_672_cov_4.949389	278	326	0	48	48	1.0000000
NODE_18672_length_672_cov_4.753927	378	450	0	6	72	0.0833333
NODE_18672_length_672_cov_4.753927	378	450	2	43	72	0.5972222
NODE_18672_length_672_cov_4.753927	378	450	4	23	72	0.3194444
NODE_18704_length_672_cov_1.713787	340	401	0	61	61	1.0000000
NODE_18742_length_671_cov_28.874126	306	387	4	39	81	0.4814815
NODE_18742_length_671_cov_28.874126	306	387	6	11	81	0.1358025
NODE_18742_length_671_cov_28.874126	306	387	7	2	81	0.0246914
NODE_18742_length_671_cov_28.874126	306	387	8	29	81	0.3580247
NODE_18742_length_671_cov_28.874126	360	440	0	7	80	0.0875000
NODE_18742_length_671_cov_28.874126	360	440	4	20	80	0.2500000
NODE_18742_length_671_cov_28.874126	360	440	6	36	80	0.4500000
NODE_18742_length_671_cov_28.874126	360	440	8	17	80	0.2125000
NODE_18744_length_671_cov_18.526224	294	333	0	37	39	0.9487180
NODE_18744_length_671_cov_18.526224	294	333	4	2	39	0.0512821
NODE_18744_length_671_cov_18.526224	331	404	0	22	73	0.3013699
NODE_18744_length_671_cov_18.526224	331	404	2	1	73	0.0136986
NODE_18744_length_671_cov_18.526224	331	404	4	50	73	0.6849315
NODE_18744_length_671_cov_18.526224	331	351	4	20	20	1.0000000
NODE_18745_length_671_cov_16.094406	417	497	0	80	80	1.0000000
NODE_18745_length_671_cov_16.094406	470	550	0	80	80	1.0000000
NODE_18746_length_671_cov_11.756993	337	417	6	14	80	0.1750000
NODE_18746_length_671_cov_11.756993	337	417	8	24	80	0.3000000
NODE_18746_length_671_cov_11.756993	337	417	10	42	80	0.5250000
NODE_18746_length_671_cov_11.756993	390	470	0	39	80	0.4875000
NODE_18746_length_671_cov_11.756993	390	470	6	19	80	0.2375000
NODE_18746_length_671_cov_11.756993	390	470	8	1	80	0.0125000
NODE_18746_length_671_cov_11.756993	390	470	10	21	80	0.2625000
NODE_18747_length_671_cov_9.237762	305	382	0	77	77	1.0000000
NODE_18748_length_671_cov_8.491259	298	379	0	81	81	1.0000000
NODE_18748_length_671_cov_8.491259	352	430	0	78	78	1.0000000
NODE_18749_length_671_cov_8.241259	97	128	4	31	31	1.0000000
NODE_18752_length_671_cov_7.201049	368	448	0	80	80	1.0000000
NODE_18752_length_671_cov_7.201049	421	501	0	80	80	1.0000000
NODE_18753_length_671_cov_5.680070	370	450	0	80	80	1.0000000
NODE_18753_length_671_cov_5.680070	423	503	0	80	80	1.0000000
NODE_18754_length_671_cov_4.769231	362	414	0	52	52	1.0000000
NODE_18760_length_671_cov_3.804196	360	440	14	11	80	0.1375000
NODE_18760_length_671_cov_3.804196	360	440	18	2	80	0.0250000
NODE_18760_length_671_cov_3.804196	360	440	22	13	80	0.1625000
NODE_18760_length_671_cov_3.804196	360	440	28	7	80	0.0875000
NODE_18760_length_671_cov_3.804196	360	440	29	7	80	0.0875000
NODE_18760_length_671_cov_3.804196	360	440	30	40	80	0.5000000
NODE_18812_length_670_cov_21.017513	443	523	0	80	80	1.0000000
NODE_18812_length_670_cov_21.017513	496	576	0	80	80	1.0000000
NODE_18813_length_670_cov_20.346760	372	452	0	17	80	0.2125000
NODE_18813_length_670_cov_20.346760	372	452	4	56	80	0.7000000
NODE_18813_length_670_cov_20.346760	372	452	8	7	80	0.0875000
NODE_18813_length_670_cov_20.346760	425	505	4	36	80	0.4500000
NODE_18813_length_670_cov_20.346760	425	505	8	44	80	0.5500000
NODE_18814_length_670_cov_15.728546	157	237	2	57	80	0.7125000
NODE_18814_length_670_cov_15.728546	157	237	4	23	80	0.2875000
NODE_18814_length_670_cov_15.728546	210	290	0	26	80	0.3250000
NODE_18814_length_670_cov_15.728546	210	290	2	54	80	0.6750000
NODE_18814_length_670_cov_15.728546	286	366	0	80	80	1.0000000
NODE_18814_length_670_cov_15.728546	339	419	0	80	80	1.0000000
NODE_18818_length_670_cov_6.499124	390	470	0	80	80	1.0000000
NODE_18834_length_670_cov_3.099825	159	217	0	58	58	1.0000000
NODE_18838_length_670_cov_2.700525	252	332	2	33	80	0.4125000
NODE_18838_length_670_cov_2.700525	252	332	4	47	80	0.5875000
NODE_18838_length_670_cov_2.700525	305	385	0	2	80	0.0250000
NODE_18838_length_670_cov_2.700525	305	385	2	46	80	0.5750000
NODE_18838_length_670_cov_2.700525	305	385	4	32	80	0.4000000
NODE_18883_length_669_cov_13.307018	432	512	0	21	80	0.2625000
NODE_18883_length_669_cov_13.307018	432	512	2	59	80	0.7375000
NODE_18883_length_669_cov_13.307018	485	565	2	80	80	1.0000000
NODE_18886_length_669_cov_6.921053	245	325	0	79	80	0.9875000
NODE_18886_length_669_cov_6.921053	245	325	2	1	80	0.0125000
NODE_18886_length_669_cov_6.921053	298	370	0	26	72	0.3611111
NODE_18886_length_669_cov_6.921053	298	370	2	46	72	0.6388889
NODE_18901_length_669_cov_3.633333	277	347	0	70	70	1.0000000
NODE_18909_length_669_cov_2.361404	434	490	0	56	56	1.0000000
NODE_18958_length_668_cov_23.131810	275	355	0	24	80	0.3000000
NODE_18958_length_668_cov_23.131810	275	355	2	56	80	0.7000000
NODE_18958_length_668_cov_23.131810	328	408	0	77	80	0.9625000
NODE_18958_length_668_cov_23.131810	328	408	2	3	80	0.0375000
NODE_18959_length_668_cov_14.978910	324	404	0	20	80	0.2500000
NODE_18959_length_668_cov_14.978910	324	404	2	60	80	0.7500000
NODE_18959_length_668_cov_14.978910	377	457	0	73	80	0.9125000
NODE_18959_length_668_cov_14.978910	377	457	2	7	80	0.0875000
NODE_18962_length_668_cov_11.184534	187	267	8	80	80	1.0000000
NODE_18962_length_668_cov_11.184534	240	320	0	48	80	0.6000000
NODE_18962_length_668_cov_11.184534	240	320	8	32	80	0.4000000
NODE_18963_length_668_cov_10.548330	211	291	0	57	80	0.7125000
NODE_18963_length_668_cov_10.548330	211	291	4	22	80	0.2750000
NODE_18963_length_668_cov_10.548330	211	291	5	1	80	0.0125000
NODE_18963_length_668_cov_10.548330	264	344	0	4	80	0.0500000
NODE_18963_length_668_cov_10.548330	264	344	4	22	80	0.2750000
NODE_18963_length_668_cov_10.548330	264	344	5	13	80	0.1625000
NODE_18963_length_668_cov_10.548330	264	344	7	3	80	0.0375000
NODE_18963_length_668_cov_10.548330	264	344	9	38	80	0.4750000
NODE_18964_length_668_cov_10.370826	226	308	0	47	82	0.5731707
NODE_18964_length_668_cov_10.370826	226	308	6	35	82	0.4268293
NODE_18964_length_668_cov_10.370826	279	361	6	82	82	1.0000000
NODE_18965_length_668_cov_10.223199	238	318	0	80	80	1.0000000
NODE_18965_length_668_cov_10.223199	291	371	0	80	80	1.0000000
NODE_18967_length_668_cov_9.340949	310	390	0	80	80	1.0000000
NODE_18967_length_668_cov_9.340949	363	443	0	80	80	1.0000000
NODE_18975_length_668_cov_4.077329	304	384	2	36	80	0.4500000
NODE_18975_length_668_cov_4.077329	304	384	4	23	80	0.2875000
NODE_18975_length_668_cov_4.077329	304	384	5	12	80	0.1500000
NODE_18975_length_668_cov_4.077329	304	384	6	9	80	0.1125000
NODE_18975_length_668_cov_4.077329	338	367	2	6	29	0.2068966
NODE_18975_length_668_cov_4.077329	338	367	4	2	29	0.0689655
NODE_18975_length_668_cov_4.077329	338	367	5	12	29	0.4137931
NODE_18975_length_668_cov_4.077329	338	367	6	9	29	0.3103448
NODE_18975_length_668_cov_4.077329	358	427	4	62	69	0.8985507
NODE_18975_length_668_cov_4.077329	358	427	5	7	69	0.1014493
NODE_19032_length_667_cov_33.848592	168	248	0	20	80	0.2500000
NODE_19032_length_667_cov_33.848592	168	248	2	24	80	0.3000000
NODE_19032_length_667_cov_33.848592	168	248	4	10	80	0.1250000
NODE_19032_length_667_cov_33.848592	168	248	5	26	80	0.3250000
NODE_19032_length_667_cov_33.848592	221	301	0	20	80	0.2500000
NODE_19032_length_667_cov_33.848592	221	301	2	48	80	0.6000000
NODE_19032_length_667_cov_33.848592	221	301	4	12	80	0.1500000
NODE_19033_length_667_cov_21.218310	270	350	0	44	80	0.5500000
NODE_19033_length_667_cov_21.218310	270	350	2	36	80	0.4500000
NODE_19033_length_667_cov_21.218310	323	403	0	13	80	0.1625000
NODE_19033_length_667_cov_21.218310	323	403	2	67	80	0.8375000
NODE_19034_length_667_cov_19.204225	258	338	0	80	80	1.0000000
NODE_19034_length_667_cov_19.204225	311	391	0	80	80	1.0000000
NODE_19036_length_667_cov_8.264085	299	379	0	80	80	1.0000000
NODE_19036_length_667_cov_8.264085	352	432	0	80	80	1.0000000
NODE_19037_length_667_cov_8.248239	76	156	0	46	80	0.5750000
NODE_19037_length_667_cov_8.248239	76	156	2	34	80	0.4250000
NODE_19037_length_667_cov_8.248239	129	209	2	80	80	1.0000000
NODE_19038_length_667_cov_8.207746	257	323	0	34	66	0.5151515
NODE_19038_length_667_cov_8.207746	257	323	2	32	66	0.4848485
NODE_19038_length_667_cov_8.207746	296	376	0	25	80	0.3125000
NODE_19038_length_667_cov_8.207746	296	376	2	55	80	0.6875000
NODE_19039_length_667_cov_7.232394	357	437	0	80	80	1.0000000
NODE_19039_length_667_cov_7.232394	410	490	0	80	80	1.0000000
NODE_19042_length_667_cov_4.941901	199	279	2	53	80	0.6625000
NODE_19042_length_667_cov_4.941901	199	279	4	27	80	0.3375000
NODE_19042_length_667_cov_4.941901	252	332	0	8	80	0.1000000
NODE_19042_length_667_cov_4.941901	252	332	2	72	80	0.9000000
NODE_19053_length_667_cov_3.404930	501	536	0	35	35	1.0000000
NODE_19053_length_667_cov_3.404930	503	533	0	30	30	1.0000000
NODE_19100_length_666_cov_24.811287	179	254	8	3	75	0.0400000
NODE_19100_length_666_cov_24.811287	179	254	10	8	75	0.1066667
NODE_19100_length_666_cov_24.811287	179	254	12	24	75	0.3200000
NODE_19100_length_666_cov_24.811287	179	254	14	40	75	0.5333334
NODE_19100_length_666_cov_24.811287	182	254	8	3	72	0.0416667
NODE_19100_length_666_cov_24.811287	182	254	10	8	72	0.1111111
NODE_19100_length_666_cov_24.811287	182	254	12	21	72	0.2916667
NODE_19100_length_666_cov_24.811287	182	254	14	40	72	0.5555556
NODE_19100_length_666_cov_24.811287	227	307	2	1	80	0.0125000
NODE_19100_length_666_cov_24.811287	227	307	3	15	80	0.1875000
NODE_19100_length_666_cov_24.811287	227	307	5	19	80	0.2375000
NODE_19100_length_666_cov_24.811287	227	307	6	1	80	0.0125000
NODE_19100_length_666_cov_24.811287	227	307	8	10	80	0.1250000
NODE_19100_length_666_cov_24.811287	227	307	10	8	80	0.1000000
NODE_19100_length_666_cov_24.811287	227	307	12	25	80	0.3125000
NODE_19100_length_666_cov_24.811287	227	307	14	1	80	0.0125000
NODE_19100_length_666_cov_24.811287	227	307	2	1	80	0.0125000
NODE_19100_length_666_cov_24.811287	227	307	3	15	80	0.1875000
NODE_19100_length_666_cov_24.811287	227	307	5	19	80	0.2375000
NODE_19100_length_666_cov_24.811287	227	307	6	1	80	0.0125000
NODE_19100_length_666_cov_24.811287	227	307	8	10	80	0.1250000
NODE_19100_length_666_cov_24.811287	227	307	10	8	80	0.1000000
NODE_19100_length_666_cov_24.811287	227	307	12	25	80	0.3125000
NODE_19100_length_666_cov_24.811287	227	307	14	1	80	0.0125000
NODE_19100_length_666_cov_24.811287	303	383	12	14	80	0.1750000
NODE_19100_length_666_cov_24.811287	303	383	16	8	80	0.1000000
NODE_19100_length_666_cov_24.811287	303	383	20	14	80	0.1750000
NODE_19100_length_666_cov_24.811287	303	383	35	1	80	0.0125000
NODE_19100_length_666_cov_24.811287	303	383	36	5	80	0.0625000
NODE_19100_length_666_cov_24.811287	303	383	39	2	80	0.0250000
NODE_19100_length_666_cov_24.811287	303	383	48	1	80	0.0125000
NODE_19100_length_666_cov_24.811287	303	383	49	1	80	0.0125000
NODE_19100_length_666_cov_24.811287	303	383	53	1	80	0.0125000
NODE_19100_length_666_cov_24.811287	303	383	58	1	80	0.0125000
NODE_19100_length_666_cov_24.811287	303	383	64	1	80	0.0125000
NODE_19100_length_666_cov_24.811287	303	383	66	2	80	0.0250000
NODE_19100_length_666_cov_24.811287	303	383	68	1	80	0.0125000
NODE_19100_length_666_cov_24.811287	303	383	73	2	80	0.0250000
NODE_19100_length_666_cov_24.811287	303	383	74	13	80	0.1625000
NODE_19100_length_666_cov_24.811287	303	383	75	5	80	0.0625000
NODE_19100_length_666_cov_24.811287	303	383	76	8	80	0.1000000
NODE_19100_length_666_cov_24.811287	356	436	47	8	80	0.1000000
NODE_19100_length_666_cov_24.811287	356	436	53	2	80	0.0250000
NODE_19100_length_666_cov_24.811287	356	436	63	3	80	0.0375000
NODE_19100_length_666_cov_24.811287	356	436	64	8	80	0.1000000
NODE_19100_length_666_cov_24.811287	356	436	73	2	80	0.0250000
NODE_19100_length_666_cov_24.811287	356	436	74	44	80	0.5500000
NODE_19100_length_666_cov_24.811287	356	436	75	5	80	0.0625000
NODE_19100_length_666_cov_24.811287	356	436	76	8	80	0.1000000
NODE_19102_length_666_cov_20.114638	172	252	0	80	80	1.0000000
NODE_19102_length_666_cov_20.114638	225	305	0	80	80	1.0000000
NODE_19103_length_666_cov_16.813051	220	286	0	40	66	0.6060606
NODE_19103_length_666_cov_16.813051	220	286	2	26	66	0.3939394
NODE_19103_length_666_cov_16.813051	259	344	0	46	85	0.5411765
NODE_19103_length_666_cov_16.813051	259	344	2	39	85	0.4588235
NODE_19104_length_666_cov_15.384480	306	386	2	13	80	0.1625000
NODE_19104_length_666_cov_15.384480	306	386	4	28	80	0.3500000
NODE_19104_length_666_cov_15.384480	306	386	6	39	80	0.4875000
NODE_19104_length_666_cov_15.384480	359	439	4	32	80	0.4000000
NODE_19104_length_666_cov_15.384480	359	439	6	48	80	0.6000000
NODE_19105_length_666_cov_14.195767	485	565	6	80	80	1.0000000
NODE_19105_length_666_cov_14.195767	538	618	0	40	80	0.5000000
NODE_19105_length_666_cov_14.195767	538	618	6	40	80	0.5000000
NODE_19108_length_666_cov_7.770723	226	306	0	41	80	0.5125000
NODE_19108_length_666_cov_7.770723	226	306	4	39	80	0.4875000
NODE_19108_length_666_cov_7.770723	279	359	4	80	80	1.0000000
NODE_19163_length_665_cov_28.786219	391	471	2	64	80	0.8000000
NODE_19163_length_665_cov_28.786219	391	471	4	16	80	0.2000000
NODE_19163_length_665_cov_28.786219	444	524	0	2	80	0.0250000
NODE_19163_length_665_cov_28.786219	444	524	2	76	80	0.9500000
NODE_19163_length_665_cov_28.786219	444	524	4	2	80	0.0250000
NODE_19164_length_665_cov_21.740283	311	391	2	5	80	0.0625000
NODE_19164_length_665_cov_21.740283	311	391	4	75	80	0.9375000
NODE_19164_length_665_cov_21.740283	364	444	0	36	80	0.4500000
NODE_19164_length_665_cov_21.740283	364	444	2	22	80	0.2750000
NODE_19164_length_665_cov_21.740283	364	444	4	22	80	0.2750000
NODE_19165_length_665_cov_15.904594	390	470	0	46	80	0.5750000
NODE_19165_length_665_cov_15.904594	390	470	2	34	80	0.4250000
NODE_19165_length_665_cov_15.904594	443	523	0	80	80	1.0000000
NODE_19224_length_664_cov_27.208850	259	339	0	35	80	0.4375000
NODE_19224_length_664_cov_27.208850	259	339	8	12	80	0.1500000
NODE_19224_length_664_cov_27.208850	259	339	16	1	80	0.0125000
NODE_19224_length_664_cov_27.208850	259	339	20	32	80	0.4000000
NODE_19224_length_664_cov_27.208850	345	404	20	5	59	0.0847458
NODE_19224_length_664_cov_27.208850	345	404	21	54	59	0.9152542
NODE_19225_length_664_cov_16.116814	241	321	2	7	80	0.0875000
NODE_19225_length_664_cov_16.116814	241	321	4	73	80	0.9125000
NODE_19225_length_664_cov_16.116814	294	374	2	53	80	0.6625000
NODE_19225_length_664_cov_16.116814	294	374	4	27	80	0.3375000
NODE_19227_length_664_cov_14.185841	332	412	0	80	80	1.0000000
NODE_19227_length_664_cov_14.185841	385	465	0	80	80	1.0000000
NODE_19228_length_664_cov_12.256637	325	405	0	5	80	0.0625000
NODE_19228_length_664_cov_12.256637	325	405	2	75	80	0.9375000
NODE_19228_length_664_cov_12.256637	378	454	0	31	76	0.4078947
NODE_19228_length_664_cov_12.256637	378	454	2	45	76	0.5921053
NODE_19229_length_664_cov_8.378761	252	332	0	80	80	1.0000000
NODE_19229_length_664_cov_8.378761	305	385	0	80	80	1.0000000
NODE_19229_length_664_cov_8.378761	381	461	0	80	80	1.0000000
NODE_19229_length_664_cov_8.378761	434	514	0	30	80	0.3750000
NODE_19229_length_664_cov_8.378761	434	514	2	50	80	0.6250000
NODE_19254_length_664_cov_1.922124	393	434	2	41	41	1.0000000
NODE_19298_length_663_cov_26.601064	398	478	0	80	80	1.0000000
NODE_19298_length_663_cov_26.601064	451	531	0	80	80	1.0000000
NODE_19299_length_663_cov_16.948582	368	448	0	80	80	1.0000000
NODE_19299_length_663_cov_16.948582	421	501	0	80	80	1.0000000
NODE_19300_length_663_cov_16.225177	118	198	0	76	80	0.9500000
NODE_19300_length_663_cov_16.225177	118	198	2	4	80	0.0500000
NODE_19300_length_663_cov_16.225177	171	251	0	23	80	0.2875000
NODE_19300_length_663_cov_16.225177	171	251	2	57	80	0.7125000
NODE_19302_length_663_cov_13.748227	277	357	0	80	80	1.0000000
NODE_19302_length_663_cov_13.748227	330	410	0	80	80	1.0000000
NODE_19303_length_663_cov_10.377660	300	380	0	1	80	0.0125000
NODE_19303_length_663_cov_10.377660	300	380	2	19	80	0.2375000
NODE_19303_length_663_cov_10.377660	300	380	6	60	80	0.7500000
NODE_19304_length_663_cov_9.549645	199	279	0	80	80	1.0000000
NODE_19304_length_663_cov_9.549645	252	332	0	80	80	1.0000000
NODE_19305_length_663_cov_7.397163	151	231	0	80	80	1.0000000
NODE_19305_length_663_cov_7.397163	204	284	0	80	80	1.0000000
NODE_19307_length_663_cov_5.081560	317	397	0	80	80	1.0000000
NODE_19368_length_662_cov_29.218472	233	313	0	80	80	1.0000000
NODE_19368_length_662_cov_29.218472	286	366	0	67	80	0.8375000
NODE_19368_length_662_cov_29.218472	286	366	2	13	80	0.1625000
NODE_19369_length_662_cov_18.717584	193	273	0	80	80	1.0000000
NODE_19369_length_662_cov_18.717584	246	326	0	80	80	1.0000000
NODE_19370_length_662_cov_16.358792	258	338	4	40	80	0.5000000
NODE_19370_length_662_cov_16.358792	258	338	6	40	80	0.5000000
NODE_19370_length_662_cov_16.358792	311	391	2	51	80	0.6375000
NODE_19370_length_662_cov_16.358792	311	391	6	29	80	0.3625000
NODE_19371_length_662_cov_12.845471	259	339	0	80	80	1.0000000
NODE_19371_length_662_cov_12.845471	312	392	0	38	80	0.4750000
NODE_19371_length_662_cov_12.845471	312	392	2	42	80	0.5250000
NODE_19372_length_662_cov_12.476021	299	379	0	80	80	1.0000000
NODE_19372_length_662_cov_12.476021	352	432	0	80	80	1.0000000
NODE_19373_length_662_cov_10.252220	239	319	0	80	80	1.0000000
NODE_19373_length_662_cov_10.252220	292	372	0	80	80	1.0000000
NODE_19376_length_662_cov_6.335702	267	347	2	63	80	0.7875000
NODE_19376_length_662_cov_6.335702	267	347	4	10	80	0.1250000
NODE_19376_length_662_cov_6.335702	267	347	6	7	80	0.0875000
NODE_19376_length_662_cov_6.335702	320	400	0	47	80	0.5875000
NODE_19376_length_662_cov_6.335702	320	400	2	33	80	0.4125000
NODE_19378_length_662_cov_5.738899	295	331	0	36	36	1.0000000
NODE_19378_length_662_cov_5.738899	301	322	0	21	21	1.0000000
NODE_19402_length_662_cov_1.905861	150	230	0	43	80	0.5375000
NODE_19402_length_662_cov_1.905861	150	230	2	37	80	0.4625000
NODE_19402_length_662_cov_1.905861	203	277	0	74	74	1.0000000
NODE_19441_length_661_cov_55.176157	236	316	4	28	80	0.3500000
NODE_19441_length_661_cov_55.176157	236	316	18	2	80	0.0250000
NODE_19441_length_661_cov_55.176157	236	316	19	4	80	0.0500000
NODE_19441_length_661_cov_55.176157	236	316	21	1	80	0.0125000
NODE_19441_length_661_cov_55.176157	236	316	23	1	80	0.0125000
NODE_19441_length_661_cov_55.176157	236	316	24	44	80	0.5500000
NODE_19441_length_661_cov_55.176157	289	369	0	2	80	0.0250000
NODE_19441_length_661_cov_55.176157	289	369	16	1	80	0.0125000
NODE_19441_length_661_cov_55.176157	289	369	17	18	80	0.2250000
NODE_19441_length_661_cov_55.176157	289	369	18	34	80	0.4250000
NODE_19441_length_661_cov_55.176157	289	369	19	4	80	0.0500000
NODE_19441_length_661_cov_55.176157	289	369	21	1	80	0.0125000
NODE_19441_length_661_cov_55.176157	289	369	24	20	80	0.2500000
NODE_19442_length_661_cov_38.501779	231	311	0	44	80	0.5500000
NODE_19442_length_661_cov_38.501779	231	311	2	36	80	0.4500000
NODE_19442_length_661_cov_38.501779	284	364	0	80	80	1.0000000
NODE_19442_length_661_cov_38.501779	360	440	0	59	80	0.7375000
NODE_19442_length_661_cov_38.501779	360	440	2	3	80	0.0375000
NODE_19442_length_661_cov_38.501779	360	440	8	18	80	0.2250000
NODE_19442_length_661_cov_38.501779	413	493	0	6	80	0.0750000
NODE_19442_length_661_cov_38.501779	413	493	2	3	80	0.0375000
NODE_19442_length_661_cov_38.501779	413	493	8	57	80	0.7125000
NODE_19442_length_661_cov_38.501779	413	493	10	14	80	0.1750000
NODE_19443_length_661_cov_31.460854	128	208	0	80	80	1.0000000
NODE_19443_length_661_cov_31.460854	181	261	0	80	80	1.0000000
NODE_19444_length_661_cov_18.960854	216	296	0	80	80	1.0000000
NODE_19444_length_661_cov_18.960854	269	349	0	80	80	1.0000000
NODE_19445_length_661_cov_16.035587	201	281	0	80	80	1.0000000
NODE_19445_length_661_cov_16.035587	254	334	0	63	80	0.7875000
NODE_19445_length_661_cov_16.035587	254	334	2	17	80	0.2125000
NODE_19447_length_661_cov_13.005338	281	343	0	62	62	1.0000000
NODE_19447_length_661_cov_13.005338	353	433	0	80	80	1.0000000
NODE_19447_length_661_cov_13.005338	406	486	0	80	80	1.0000000
NODE_19452_length_661_cov_5.670819	374	454	4	80	80	1.0000000
NODE_19452_length_661_cov_5.670819	427	507	4	32	80	0.4000000
NODE_19452_length_661_cov_5.670819	427	507	5	1	80	0.0125000
NODE_19452_length_661_cov_5.670819	427	507	6	47	80	0.5875000
NODE_19457_length_661_cov_4.601423	319	395	0	1	76	0.0131579
NODE_19457_length_661_cov_4.601423	319	395	2	1	76	0.0131579
NODE_19457_length_661_cov_4.601423	319	395	4	19	76	0.2500000
NODE_19457_length_661_cov_4.601423	319	395	14	55	76	0.7236842
NODE_19459_length_661_cov_3.532028	282	362	0	59	80	0.7375000
NODE_19459_length_661_cov_3.532028	282	362	1	9	80	0.1125000
NODE_19459_length_661_cov_3.532028	282	362	2	5	80	0.0625000
NODE_19459_length_661_cov_3.532028	282	362	4	7	80	0.0875000
NODE_19459_length_661_cov_3.532028	335	415	0	6	80	0.0750000
NODE_19459_length_661_cov_3.532028	335	415	1	9	80	0.1125000
NODE_19459_length_661_cov_3.532028	335	415	2	5	80	0.0625000
NODE_19459_length_661_cov_3.532028	335	415	4	60	80	0.7500000
NODE_19515_length_660_cov_20.741533	343	423	2	4	80	0.0500000
NODE_19515_length_660_cov_20.741533	343	423	4	25	80	0.3125000
NODE_19515_length_660_cov_20.741533	343	423	6	51	80	0.6375000
NODE_19515_length_660_cov_20.741533	396	476	0	24	80	0.3000000
NODE_19515_length_660_cov_20.741533	396	476	2	5	80	0.0625000
NODE_19515_length_660_cov_20.741533	396	476	4	9	80	0.1125000
NODE_19515_length_660_cov_20.741533	396	476	6	42	80	0.5250000
NODE_19516_length_660_cov_15.089127	148	228	0	17	80	0.2125000
NODE_19516_length_660_cov_15.089127	148	228	2	37	80	0.4625000
NODE_19516_length_660_cov_15.089127	148	228	4	14	80	0.1750000
NODE_19516_length_660_cov_15.089127	148	228	6	12	80	0.1500000
NODE_19516_length_660_cov_15.089127	201	281	2	17	80	0.2125000
NODE_19516_length_660_cov_15.089127	201	281	4	1	80	0.0125000
NODE_19516_length_660_cov_15.089127	201	281	5	14	80	0.1750000
NODE_19516_length_660_cov_15.089127	201	281	6	48	80	0.6000000
NODE_19518_length_660_cov_13.301248	276	356	0	80	80	1.0000000
NODE_19518_length_660_cov_13.301248	329	409	0	80	80	1.0000000
NODE_19519_length_660_cov_12.393939	234	314	0	73	80	0.9125000
NODE_19519_length_660_cov_12.393939	234	314	2	7	80	0.0875000
NODE_19519_length_660_cov_12.393939	287	367	0	80	80	1.0000000
NODE_19521_length_660_cov_11.495544	399	479	0	80	80	1.0000000
NODE_19521_length_660_cov_11.495544	452	532	0	80	80	1.0000000
NODE_19522_length_660_cov_10.522282	177	257	0	80	80	1.0000000
NODE_19522_length_660_cov_10.522282	230	311	0	81	81	1.0000000
NODE_19524_length_660_cov_8.887701	254	325	0	50	71	0.7042254
NODE_19524_length_660_cov_8.887701	254	325	2	21	71	0.2957746
NODE_19527_length_660_cov_7.278075	225	305	0	21	80	0.2625000
NODE_19527_length_660_cov_7.278075	225	305	1	59	80	0.7375000
NODE_19527_length_660_cov_7.278075	278	358	0	42	80	0.5250000
NODE_19527_length_660_cov_7.278075	278	358	1	38	80	0.4750000
NODE_19529_length_660_cov_6.577540	350	430	0	80	80	1.0000000
NODE_19529_length_660_cov_6.577540	403	483	0	80	80	1.0000000
NODE_19549_length_660_cov_2.354724	421	470	0	49	49	1.0000000
NODE_19594_length_659_cov_43.587500	2	82	0	80	80	1.0000000
NODE_19594_length_659_cov_43.587500	55	135	0	80	80	1.0000000
NODE_19594_length_659_cov_43.587500	131	211	0	13	80	0.1625000
NODE_19594_length_659_cov_43.587500	131	211	2	10	80	0.1250000
NODE_19594_length_659_cov_43.587500	131	211	4	57	80	0.7125000
NODE_19594_length_659_cov_43.587500	184	264	0	38	80	0.4750000
NODE_19594_length_659_cov_43.587500	184	264	2	6	80	0.0750000
NODE_19594_length_659_cov_43.587500	184	264	4	36	80	0.4500000
NODE_19595_length_659_cov_23.330357	236	316	0	22	80	0.2750000
NODE_19595_length_659_cov_23.330357	236	316	2	58	80	0.7250000
NODE_19595_length_659_cov_23.330357	289	369	0	21	80	0.2625000
NODE_19595_length_659_cov_23.330357	289	369	2	59	80	0.7375000
NODE_19596_length_659_cov_12.775000	255	335	2	32	80	0.4000000
NODE_19596_length_659_cov_12.775000	255	335	11	1	80	0.0125000
NODE_19596_length_659_cov_12.775000	255	335	12	20	80	0.2500000
NODE_19596_length_659_cov_12.775000	255	335	14	27	80	0.3375000
NODE_19596_length_659_cov_12.775000	308	388	12	19	80	0.2375000
NODE_19596_length_659_cov_12.775000	308	388	14	61	80	0.7625000
NODE_19598_length_659_cov_9.683929	220	298	0	38	78	0.4871795
NODE_19598_length_659_cov_9.683929	220	298	4	26	78	0.3333333
NODE_19598_length_659_cov_9.683929	220	298	8	14	78	0.1794872
NODE_19598_length_659_cov_9.683929	271	351	4	13	80	0.1625000
NODE_19598_length_659_cov_9.683929	271	351	8	64	80	0.8000000
NODE_19598_length_659_cov_9.683929	271	351	10	3	80	0.0375000
NODE_19613_length_659_cov_3.658929	305	385	0	46	80	0.5750000
NODE_19613_length_659_cov_3.658929	305	385	2	34	80	0.4250000
NODE_19613_length_659_cov_3.658929	358	438	0	5	80	0.0625000
NODE_19613_length_659_cov_3.658929	358	438	2	75	80	0.9375000
NODE_19678_length_658_cov_38.479428	289	369	2	19	80	0.2375000
NODE_19678_length_658_cov_38.479428	289	369	4	46	80	0.5750000
NODE_19678_length_658_cov_38.479428	289	369	6	15	80	0.1875000
NODE_19678_length_658_cov_38.479428	342	422	4	44	80	0.5500000
NODE_19678_length_658_cov_38.479428	342	422	6	32	80	0.4000000
NODE_19678_length_658_cov_38.479428	342	422	7	1	80	0.0125000
NODE_19678_length_658_cov_38.479428	342	422	8	3	80	0.0375000
NODE_19679_length_658_cov_35.409660	242	322	0	80	80	1.0000000
NODE_19679_length_658_cov_35.409660	295	375	0	80	80	1.0000000
NODE_19680_length_658_cov_20.322004	191	271	0	8	80	0.1000000
NODE_19680_length_658_cov_20.322004	191	271	2	4	80	0.0500000
NODE_19680_length_658_cov_20.322004	191	271	4	49	80	0.6125000
NODE_19680_length_658_cov_20.322004	191	271	6	19	80	0.2375000
NODE_19680_length_658_cov_20.322004	244	321	0	58	77	0.7532467
NODE_19680_length_658_cov_20.322004	244	321	2	4	77	0.0519481
NODE_19680_length_658_cov_20.322004	244	321	4	15	77	0.1948052
NODE_19680_length_658_cov_20.322004	317	397	0	22	80	0.2750000
NODE_19680_length_658_cov_20.322004	317	397	1	1	80	0.0125000
NODE_19680_length_658_cov_20.322004	317	397	2	40	80	0.5000000
NODE_19680_length_658_cov_20.322004	317	397	4	17	80	0.2125000
NODE_19680_length_658_cov_20.322004	370	449	2	10	79	0.1265823
NODE_19680_length_658_cov_20.322004	370	449	4	69	79	0.8734177
NODE_19681_length_658_cov_11.352415	324	404	0	80	80	1.0000000
NODE_19681_length_658_cov_11.352415	377	457	0	80	80	1.0000000
NODE_19685_length_658_cov_8.241503	227	307	0	26	80	0.3250000
NODE_19685_length_658_cov_8.241503	227	307	2	54	80	0.6750000
NODE_19685_length_658_cov_8.241503	280	360	0	52	80	0.6500000
NODE_19685_length_658_cov_8.241503	280	360	2	28	80	0.3500000
NODE_19689_length_658_cov_5.477639	450	530	0	80	80	1.0000000
NODE_19705_length_658_cov_2.277281	286	366	2	39	80	0.4875000
NODE_19705_length_658_cov_2.277281	286	366	3	1	80	0.0125000
NODE_19705_length_658_cov_2.277281	286	366	4	25	80	0.3125000
NODE_19705_length_658_cov_2.277281	286	366	6	15	80	0.1875000
NODE_19705_length_658_cov_2.277281	339	419	2	2	80	0.0250000
NODE_19705_length_658_cov_2.277281	339	419	3	1	80	0.0125000
NODE_19705_length_658_cov_2.277281	339	419	4	62	80	0.7750000
NODE_19705_length_658_cov_2.277281	339	419	6	15	80	0.1875000
NODE_19750_length_657_cov_71.087814	306	372	0	12	66	0.1818182
NODE_19750_length_657_cov_71.087814	306	372	2	52	66	0.7878788
NODE_19750_length_657_cov_71.087814	306	372	4	2	66	0.0303030
NODE_19750_length_657_cov_71.087814	382	462	4	11	80	0.1375000
NODE_19750_length_657_cov_71.087814	382	462	6	1	80	0.0125000
NODE_19750_length_657_cov_71.087814	382	462	8	2	80	0.0250000
NODE_19750_length_657_cov_71.087814	382	462	11	1	80	0.0125000
NODE_19750_length_657_cov_71.087814	382	462	12	2	80	0.0250000
NODE_19750_length_657_cov_71.087814	382	462	16	4	80	0.0500000
NODE_19750_length_657_cov_71.087814	382	462	18	15	80	0.1875000
NODE_19750_length_657_cov_71.087814	382	462	20	1	80	0.0125000
NODE_19750_length_657_cov_71.087814	382	462	22	43	80	0.5375000
NODE_19750_length_657_cov_71.087814	382	462	4	11	80	0.1375000
NODE_19750_length_657_cov_71.087814	382	462	6	1	80	0.0125000
NODE_19750_length_657_cov_71.087814	382	462	8	2	80	0.0250000
NODE_19750_length_657_cov_71.087814	382	462	11	1	80	0.0125000
NODE_19750_length_657_cov_71.087814	382	462	12	2	80	0.0250000
NODE_19750_length_657_cov_71.087814	382	462	16	4	80	0.0500000
NODE_19750_length_657_cov_71.087814	382	462	18	15	80	0.1875000
NODE_19750_length_657_cov_71.087814	382	462	20	1	80	0.0125000
NODE_19750_length_657_cov_71.087814	382	462	22	43	80	0.5375000
NODE_19750_length_657_cov_71.087814	435	515	0	27	80	0.3375000
NODE_19750_length_657_cov_71.087814	435	515	2	4	80	0.0500000
NODE_19750_length_657_cov_71.087814	435	515	4	2	80	0.0250000
NODE_19750_length_657_cov_71.087814	435	515	6	12	80	0.1500000
NODE_19750_length_657_cov_71.087814	435	515	12	1	80	0.0125000
NODE_19750_length_657_cov_71.087814	435	515	16	4	80	0.0500000
NODE_19750_length_657_cov_71.087814	435	515	18	18	80	0.2250000
NODE_19750_length_657_cov_71.087814	435	515	22	12	80	0.1500000
NODE_19750_length_657_cov_71.087814	440	515	0	27	75	0.3600000
NODE_19750_length_657_cov_71.087814	440	515	2	4	75	0.0533333
NODE_19750_length_657_cov_71.087814	440	515	4	2	75	0.0266667
NODE_19750_length_657_cov_71.087814	440	515	6	12	75	0.1600000
NODE_19750_length_657_cov_71.087814	440	515	12	1	75	0.0133333
NODE_19750_length_657_cov_71.087814	440	515	16	4	75	0.0533333
NODE_19750_length_657_cov_71.087814	440	515	18	18	75	0.2400000
NODE_19750_length_657_cov_71.087814	440	515	22	7	75	0.0933333
NODE_19751_length_657_cov_67.408602	98	178	0	80	80	1.0000000
NODE_19751_length_657_cov_67.408602	151	231	0	74	80	0.9250000
NODE_19751_length_657_cov_67.408602	151	231	2	6	80	0.0750000
NODE_19752_length_657_cov_15.568100	265	345	0	80	80	1.0000000
NODE_19752_length_657_cov_15.568100	341	421	0	80	80	1.0000000
NODE_19759_length_657_cov_5.161290	185	256	0	71	71	1.0000000
NODE_19759_length_657_cov_5.161290	229	309	0	80	80	1.0000000
NODE_19824_length_656_cov_37.023339	470	550	0	50	80	0.6250000
NODE_19824_length_656_cov_37.023339	470	550	2	30	80	0.3750000
NODE_19824_length_656_cov_37.023339	523	603	0	11	80	0.1375000
NODE_19824_length_656_cov_37.023339	523	603	2	69	80	0.8625000
NODE_19825_length_656_cov_22.804309	173	253	0	80	80	1.0000000
NODE_19825_length_656_cov_22.804309	226	306	0	28	80	0.3500000
NODE_19825_length_656_cov_22.804309	226	306	2	1	80	0.0125000
NODE_19825_length_656_cov_22.804309	226	306	4	51	80	0.6375000
NODE_19826_length_656_cov_19.280072	345	425	0	80	80	1.0000000
NODE_19826_length_656_cov_19.280072	398	478	0	80	80	1.0000000
NODE_19827_length_656_cov_18.267504	272	352	0	63	80	0.7875000
NODE_19827_length_656_cov_18.267504	272	352	2	17	80	0.2125000
NODE_19827_length_656_cov_18.267504	325	405	0	19	80	0.2375000
NODE_19827_length_656_cov_18.267504	325	405	2	61	80	0.7625000
NODE_19828_length_656_cov_15.928187	223	303	0	80	80	1.0000000
NODE_19829_length_656_cov_15.091562	297	377	0	16	80	0.2000000
NODE_19829_length_656_cov_15.091562	297	377	2	34	80	0.4250000
NODE_19829_length_656_cov_15.091562	297	377	4	30	80	0.3750000
NODE_19829_length_656_cov_15.091562	350	430	0	69	80	0.8625000
NODE_19829_length_656_cov_15.091562	350	430	2	11	80	0.1375000
NODE_19830_length_656_cov_12.773788	269	349	0	6	80	0.0750000
NODE_19830_length_656_cov_12.773788	269	349	2	74	80	0.9250000
NODE_19830_length_656_cov_12.773788	322	399	2	77	77	1.0000000
NODE_19831_length_656_cov_12.493716	212	292	2	11	80	0.1375000
NODE_19831_length_656_cov_12.493716	212	292	4	69	80	0.8625000
NODE_19831_length_656_cov_12.493716	265	345	0	32	80	0.4000000
NODE_19831_length_656_cov_12.493716	265	345	2	15	80	0.1875000
NODE_19831_length_656_cov_12.493716	265	345	4	33	80	0.4125000
NODE_19832_length_656_cov_10.946140	197	277	0	80	80	1.0000000
NODE_19832_length_656_cov_10.946140	250	330	0	80	80	1.0000000
NODE_19833_length_656_cov_9.412926	295	375	0	9	80	0.1125000
NODE_19833_length_656_cov_9.412926	295	375	2	71	80	0.8875000
NODE_19833_length_656_cov_9.412926	348	428	0	47	80	0.5875000
NODE_19833_length_656_cov_9.412926	348	428	2	33	80	0.4125000
NODE_19904_length_655_cov_31.019784	212	292	6	80	80	1.0000000
NODE_19904_length_655_cov_31.019784	265	345	0	24	80	0.3000000
NODE_19904_length_655_cov_31.019784	265	345	6	56	80	0.7000000
NODE_19907_length_655_cov_8.672662	216	296	0	69	80	0.8625000
NODE_19907_length_655_cov_8.672662	216	296	2	11	80	0.1375000
NODE_19907_length_655_cov_8.672662	269	349	0	16	80	0.2000000
NODE_19907_length_655_cov_8.672662	269	349	2	64	80	0.8000000
NODE_19908_length_655_cov_8.250000	204	234	0	30	30	1.0000000
NODE_19909_length_655_cov_7.910072	366	446	0	6	80	0.0750000
NODE_19909_length_655_cov_7.910072	366	446	2	74	80	0.9250000
NODE_19909_length_655_cov_7.910072	419	499	0	49	80	0.6125000
NODE_19909_length_655_cov_7.910072	419	499	2	31	80	0.3875000
NODE_19916_length_655_cov_5.478417	178	255	0	77	77	1.0000000
NODE_19916_length_655_cov_5.478417	178	221	0	43	43	1.0000000
NODE_19919_length_655_cov_5.174460	347	428	0	46	81	0.5679013
NODE_19919_length_655_cov_5.174460	347	428	4	35	81	0.4320988
NODE_19919_length_655_cov_5.174460	401	481	0	80	80	1.0000000
NODE_19979_length_654_cov_17.086486	323	403	0	80	80	1.0000000
NODE_19979_length_654_cov_17.086486	376	456	0	80	80	1.0000000
NODE_19980_length_654_cov_16.194595	318	398	0	80	80	1.0000000
NODE_19980_length_654_cov_16.194595	371	451	0	80	80	1.0000000
NODE_19983_length_654_cov_5.556757	341	412	0	71	71	1.0000000
NODE_19990_length_654_cov_3.236036	105	181	0	76	76	1.0000000
NODE_19990_length_654_cov_3.236036	158	236	0	78	78	1.0000000
NODE_19998_length_654_cov_2.549550	279	366	0	39	87	0.4482759
NODE_19998_length_654_cov_2.549550	279	366	2	48	87	0.5517241
NODE_20013_length_654_cov_1.790991	480	560	4	2	80	0.0250000
NODE_20013_length_654_cov_1.790991	480	560	7	1	80	0.0125000
NODE_20013_length_654_cov_1.790991	480	560	8	47	80	0.5875000
NODE_20013_length_654_cov_1.790991	480	560	10	30	80	0.3750000
NODE_20044_length_653_cov_70.296029	277	357	0	10	80	0.1250000
NODE_20044_length_653_cov_70.296029	277	357	2	6	80	0.0750000
NODE_20044_length_653_cov_70.296029	277	357	4	12	80	0.1500000
NODE_20044_length_653_cov_70.296029	277	357	6	21	80	0.2625000
NODE_20044_length_653_cov_70.296029	277	357	8	5	80	0.0625000
NODE_20044_length_653_cov_70.296029	277	357	10	26	80	0.3250000
NODE_20044_length_653_cov_70.296029	330	410	4	12	80	0.1500000
NODE_20044_length_653_cov_70.296029	330	410	6	5	80	0.0625000
NODE_20044_length_653_cov_70.296029	330	410	8	36	80	0.4500000
NODE_20044_length_653_cov_70.296029	330	410	10	27	80	0.3375000
NODE_20045_length_653_cov_28.072202	302	382	0	80	80	1.0000000
NODE_20045_length_653_cov_28.072202	355	435	0	80	80	1.0000000
NODE_20046_length_653_cov_18.382671	214	294	0	32	80	0.4000000
NODE_20046_length_653_cov_18.382671	214	294	2	4	80	0.0500000
NODE_20046_length_653_cov_18.382671	214	294	4	25	80	0.3125000
NODE_20046_length_653_cov_18.382671	214	294	8	19	80	0.2375000
NODE_20046_length_653_cov_18.382671	267	347	4	8	80	0.1000000
NODE_20046_length_653_cov_18.382671	267	347	8	72	80	0.9000000
NODE_20047_length_653_cov_8.821300	292	372	0	80	80	1.0000000
NODE_20047_length_653_cov_8.821300	345	425	0	80	80	1.0000000
NODE_20048_length_653_cov_8.660650	200	280	0	15	80	0.1875000
NODE_20048_length_653_cov_8.660650	200	280	2	31	80	0.3875000
NODE_20048_length_653_cov_8.660650	200	280	4	6	80	0.0750000
NODE_20048_length_653_cov_8.660650	200	280	6	8	80	0.1000000
NODE_20048_length_653_cov_8.660650	200	280	8	20	80	0.2500000
NODE_20048_length_653_cov_8.660650	253	333	6	7	80	0.0875000
NODE_20048_length_653_cov_8.660650	253	333	8	21	80	0.2625000
NODE_20048_length_653_cov_8.660650	253	333	10	52	80	0.6500000
NODE_20052_length_653_cov_5.777978	308	383	12	5	75	0.0666667
NODE_20052_length_653_cov_5.777978	308	383	14	19	75	0.2533333
NODE_20052_length_653_cov_5.777978	308	383	16	2	75	0.0266667
NODE_20052_length_653_cov_5.777978	308	383	34	2	75	0.0266667
NODE_20052_length_653_cov_5.777978	308	383	54	47	75	0.6266667
NODE_20052_length_653_cov_5.777978	361	435	40	19	74	0.2567568
NODE_20052_length_653_cov_5.777978	361	435	42	14	74	0.1891892
NODE_20052_length_653_cov_5.777978	361	435	44	3	74	0.0405405
NODE_20052_length_653_cov_5.777978	361	435	50	1	74	0.0135135
NODE_20052_length_653_cov_5.777978	361	435	54	37	74	0.5000000
NODE_20054_length_653_cov_5.193141	304	356	0	46	52	0.8846154
NODE_20054_length_653_cov_5.193141	304	356	2	6	52	0.1153846
NODE_20058_length_653_cov_4.823105	178	251	0	13	73	0.1780822
NODE_20058_length_653_cov_4.823105	178	251	4	30	73	0.4109589
NODE_20058_length_653_cov_4.823105	178	251	7	1	73	0.0136986
NODE_20058_length_653_cov_4.823105	178	251	8	29	73	0.3972603
NODE_20058_length_653_cov_4.823105	178	256	0	13	78	0.1666667
NODE_20058_length_653_cov_4.823105	178	256	4	30	78	0.3846154
NODE_20058_length_653_cov_4.823105	178	256	7	1	78	0.0128205
NODE_20058_length_653_cov_4.823105	178	256	8	34	78	0.4358974
NODE_20058_length_653_cov_4.823105	229	309	4	7	80	0.0875000
NODE_20058_length_653_cov_4.823105	229	309	6	21	80	0.2625000
NODE_20058_length_653_cov_4.823105	229	309	8	52	80	0.6500000
NODE_20058_length_653_cov_4.823105	229	309	4	7	80	0.0875000
NODE_20058_length_653_cov_4.823105	229	309	6	21	80	0.2625000
NODE_20058_length_653_cov_4.823105	229	309	8	52	80	0.6500000
NODE_20058_length_653_cov_4.823105	239	309	4	7	70	0.1000000
NODE_20058_length_653_cov_4.823105	239	309	6	21	70	0.3000000
NODE_20058_length_653_cov_4.823105	239	309	8	42	70	0.6000000
NODE_20127_length_652_cov_215.211573	185	248	2	12	63	0.1904762
NODE_20127_length_652_cov_215.211573	185	248	4	1	63	0.0158730
NODE_20127_length_652_cov_215.211573	185	248	6	26	63	0.4126984
NODE_20127_length_652_cov_215.211573	185	248	10	14	63	0.2222222
NODE_20127_length_652_cov_215.211573	185	248	12	3	63	0.0476190
NODE_20127_length_652_cov_215.211573	185	248	14	7	63	0.1111111
NODE_20127_length_652_cov_215.211573	221	301	6	3	80	0.0375000
NODE_20127_length_652_cov_215.211573	221	301	10	14	80	0.1750000
NODE_20127_length_652_cov_215.211573	221	301	12	3	80	0.0375000
NODE_20127_length_652_cov_215.211573	221	301	14	10	80	0.1250000
NODE_20127_length_652_cov_215.211573	221	301	16	12	80	0.1500000
NODE_20127_length_652_cov_215.211573	221	301	18	9	80	0.1125000
NODE_20127_length_652_cov_215.211573	221	301	19	5	80	0.0625000
NODE_20127_length_652_cov_215.211573	221	301	20	1	80	0.0125000
NODE_20127_length_652_cov_215.211573	221	301	22	16	80	0.2000000
NODE_20127_length_652_cov_215.211573	221	301	23	2	80	0.0250000
NODE_20127_length_652_cov_215.211573	221	301	25	3	80	0.0375000
NODE_20127_length_652_cov_215.211573	221	301	27	2	80	0.0250000
NODE_20128_length_652_cov_21.267631	299	379	0	80	80	1.0000000
NODE_20128_length_652_cov_21.267631	352	432	0	80	80	1.0000000
NODE_20138_length_652_cov_4.622061	266	315	0	49	49	1.0000000
NODE_20138_length_652_cov_4.622061	288	368	0	80	80	1.0000000
NODE_20210_length_651_cov_49.981884	425	505	4	3	80	0.0375000
NODE_20210_length_651_cov_49.981884	425	505	8	5	80	0.0625000
NODE_20210_length_651_cov_49.981884	425	505	12	11	80	0.1375000
NODE_20210_length_651_cov_49.981884	425	505	16	4	80	0.0500000
NODE_20210_length_651_cov_49.981884	425	505	18	1	80	0.0125000
NODE_20210_length_651_cov_49.981884	425	505	26	4	80	0.0500000
NODE_20210_length_651_cov_49.981884	425	505	28	16	80	0.2000000
NODE_20210_length_651_cov_49.981884	425	505	30	5	80	0.0625000
NODE_20210_length_651_cov_49.981884	425	505	31	15	80	0.1875000
NODE_20210_length_651_cov_49.981884	425	505	32	12	80	0.1500000
NODE_20210_length_651_cov_49.981884	425	505	33	4	80	0.0500000
NODE_20210_length_651_cov_49.981884	425	505	4	3	80	0.0375000
NODE_20210_length_651_cov_49.981884	425	505	8	5	80	0.0625000
NODE_20210_length_651_cov_49.981884	425	505	12	11	80	0.1375000
NODE_20210_length_651_cov_49.981884	425	505	16	4	80	0.0500000
NODE_20210_length_651_cov_49.981884	425	505	18	1	80	0.0125000
NODE_20210_length_651_cov_49.981884	425	505	26	4	80	0.0500000
NODE_20210_length_651_cov_49.981884	425	505	28	16	80	0.2000000
NODE_20210_length_651_cov_49.981884	425	505	30	5	80	0.0625000
NODE_20210_length_651_cov_49.981884	425	505	31	15	80	0.1875000
NODE_20210_length_651_cov_49.981884	425	505	32	12	80	0.1500000
NODE_20210_length_651_cov_49.981884	425	505	33	4	80	0.0500000
NODE_20210_length_651_cov_49.981884	425	505	4	3	80	0.0375000
NODE_20210_length_651_cov_49.981884	425	505	8	5	80	0.0625000
NODE_20210_length_651_cov_49.981884	425	505	12	11	80	0.1375000
NODE_20210_length_651_cov_49.981884	425	505	16	4	80	0.0500000
NODE_20210_length_651_cov_49.981884	425	505	18	1	80	0.0125000
NODE_20210_length_651_cov_49.981884	425	505	26	4	80	0.0500000
NODE_20210_length_651_cov_49.981884	425	505	28	16	80	0.2000000
NODE_20210_length_651_cov_49.981884	425	505	30	5	80	0.0625000
NODE_20210_length_651_cov_49.981884	425	505	31	15	80	0.1875000
NODE_20210_length_651_cov_49.981884	425	505	32	12	80	0.1500000
NODE_20210_length_651_cov_49.981884	425	505	33	4	80	0.0500000
NODE_20210_length_651_cov_49.981884	425	505	4	3	80	0.0375000
NODE_20210_length_651_cov_49.981884	425	505	8	5	80	0.0625000
NODE_20210_length_651_cov_49.981884	425	505	12	11	80	0.1375000
NODE_20210_length_651_cov_49.981884	425	505	16	4	80	0.0500000
NODE_20210_length_651_cov_49.981884	425	505	18	1	80	0.0125000
NODE_20210_length_651_cov_49.981884	425	505	26	4	80	0.0500000
NODE_20210_length_651_cov_49.981884	425	505	28	16	80	0.2000000
NODE_20210_length_651_cov_49.981884	425	505	30	5	80	0.0625000
NODE_20210_length_651_cov_49.981884	425	505	31	15	80	0.1875000
NODE_20210_length_651_cov_49.981884	425	505	32	12	80	0.1500000
NODE_20210_length_651_cov_49.981884	425	505	33	4	80	0.0500000
NODE_20210_length_651_cov_49.981884	478	540	0	4	62	0.0645161
NODE_20210_length_651_cov_49.981884	478	540	2	12	62	0.1935484
NODE_20210_length_651_cov_49.981884	478	540	4	22	62	0.3548387
NODE_20210_length_651_cov_49.981884	478	540	8	5	62	0.0806452
NODE_20210_length_651_cov_49.981884	478	540	12	11	62	0.1774193
NODE_20210_length_651_cov_49.981884	478	540	16	4	62	0.0645161
NODE_20210_length_651_cov_49.981884	478	540	18	1	62	0.0161290
NODE_20210_length_651_cov_49.981884	478	540	26	3	62	0.0483871
NODE_20210_length_651_cov_49.981884	478	540	0	4	62	0.0645161
NODE_20210_length_651_cov_49.981884	478	540	2	12	62	0.1935484
NODE_20210_length_651_cov_49.981884	478	540	4	22	62	0.3548387
NODE_20210_length_651_cov_49.981884	478	540	8	5	62	0.0806452
NODE_20210_length_651_cov_49.981884	478	540	12	11	62	0.1774193
NODE_20210_length_651_cov_49.981884	478	540	16	4	62	0.0645161
NODE_20210_length_651_cov_49.981884	478	540	18	1	62	0.0161290
NODE_20210_length_651_cov_49.981884	478	540	26	3	62	0.0483871
NODE_20210_length_651_cov_49.981884	478	540	0	4	62	0.0645161
NODE_20210_length_651_cov_49.981884	478	540	2	12	62	0.1935484
NODE_20210_length_651_cov_49.981884	478	540	4	22	62	0.3548387
NODE_20210_length_651_cov_49.981884	478	540	8	5	62	0.0806452
NODE_20210_length_651_cov_49.981884	478	540	12	11	62	0.1774193
NODE_20210_length_651_cov_49.981884	478	540	16	4	62	0.0645161
NODE_20210_length_651_cov_49.981884	478	540	18	1	62	0.0161290
NODE_20210_length_651_cov_49.981884	478	540	26	3	62	0.0483871
NODE_20210_length_651_cov_49.981884	478	542	0	6	64	0.0937500
NODE_20210_length_651_cov_49.981884	478	542	2	12	64	0.1875000
NODE_20210_length_651_cov_49.981884	478	542	4	22	64	0.3437500
NODE_20210_length_651_cov_49.981884	478	542	8	5	64	0.0781250
NODE_20210_length_651_cov_49.981884	478	542	12	11	64	0.1718750
NODE_20210_length_651_cov_49.981884	478	542	16	4	64	0.0625000
NODE_20210_length_651_cov_49.981884	478	542	18	1	64	0.0156250
NODE_20210_length_651_cov_49.981884	478	542	26	3	64	0.0468750
NODE_20211_length_651_cov_36.121377	422	502	0	3	80	0.0375000
NODE_20211_length_651_cov_36.121377	422	502	2	11	80	0.1375000
NODE_20211_length_651_cov_36.121377	422	502	4	66	80	0.8250000
NODE_20211_length_651_cov_36.121377	475	555	0	56	80	0.7000000
NODE_20211_length_651_cov_36.121377	475	555	2	11	80	0.1375000
NODE_20211_length_651_cov_36.121377	475	555	4	13	80	0.1625000
NODE_20212_length_651_cov_20.045290	252	332	0	8	80	0.1000000
NODE_20212_length_651_cov_20.045290	252	332	4	12	80	0.1500000
NODE_20212_length_651_cov_20.045290	252	332	11	1	80	0.0125000
NODE_20212_length_651_cov_20.045290	252	332	12	4	80	0.0500000
NODE_20212_length_651_cov_20.045290	252	332	16	55	80	0.6875000
NODE_20212_length_651_cov_20.045290	305	385	0	17	80	0.2125000
NODE_20212_length_651_cov_20.045290	305	385	4	5	80	0.0625000
NODE_20212_length_651_cov_20.045290	305	385	12	4	80	0.0500000
NODE_20212_length_651_cov_20.045290	305	385	16	54	80	0.6750000
NODE_20213_length_651_cov_12.704710	264	344	0	80	80	1.0000000
NODE_20213_length_651_cov_12.704710	317	397	0	80	80	1.0000000
NODE_20214_length_651_cov_11.632246	205	285	0	80	80	1.0000000
NODE_20214_length_651_cov_11.632246	258	338	0	80	80	1.0000000
NODE_20215_length_651_cov_10.074275	369	449	0	56	80	0.7000000
NODE_20215_length_651_cov_10.074275	369	449	3	24	80	0.3000000
NODE_20215_length_651_cov_10.074275	422	502	0	80	80	1.0000000
NODE_20216_length_651_cov_9.699275	199	279	1	40	80	0.5000000
NODE_20216_length_651_cov_9.699275	199	279	2	2	80	0.0250000
NODE_20216_length_651_cov_9.699275	199	279	4	27	80	0.3375000
NODE_20216_length_651_cov_9.699275	199	279	6	11	80	0.1375000
NODE_20216_length_651_cov_9.699275	252	332	4	16	80	0.2000000
NODE_20216_length_651_cov_9.699275	252	332	6	64	80	0.8000000
NODE_20219_length_651_cov_8.309783	217	296	0	55	79	0.6962025
NODE_20219_length_651_cov_8.309783	217	296	2	24	79	0.3037975
NODE_20219_length_651_cov_8.309783	269	349	0	3	80	0.0375000
NODE_20219_length_651_cov_8.309783	269	349	2	77	80	0.9625000
NODE_20220_length_651_cov_5.621377	148	228	0	80	80	1.0000000
NODE_20220_length_651_cov_5.621377	201	281	0	80	80	1.0000000
NODE_20221_length_651_cov_5.610507	342	422	0	80	80	1.0000000
NODE_20221_length_651_cov_5.610507	395	475	0	80	80	1.0000000
NODE_20225_length_651_cov_4.246377	299	359	0	14	60	0.2333333
NODE_20225_length_651_cov_4.246377	299	359	2	14	60	0.2333333
NODE_20225_length_651_cov_4.246377	299	359	4	18	60	0.3000000
NODE_20225_length_651_cov_4.246377	299	359	6	14	60	0.2333333
NODE_20238_length_651_cov_2.744565	340	421	0	81	81	1.0000000
NODE_20252_length_651_cov_2.016304	280	311	0	31	31	1.0000000
NODE_20292_length_650_cov_22.644283	233	313	2	39	80	0.4875000
NODE_20292_length_650_cov_22.644283	233	313	6	36	80	0.4500000
NODE_20292_length_650_cov_22.644283	233	313	8	5	80	0.0625000
NODE_20292_length_650_cov_22.644283	286	366	2	69	80	0.8625000
NODE_20292_length_650_cov_22.644283	286	366	4	11	80	0.1375000
NODE_20293_length_650_cov_22.156080	269	349	0	22	80	0.2750000
NODE_20293_length_650_cov_22.156080	269	349	2	58	80	0.7250000
NODE_20293_length_650_cov_22.156080	322	402	0	75	80	0.9375000
NODE_20293_length_650_cov_22.156080	322	402	2	5	80	0.0625000
NODE_20294_length_650_cov_20.012704	186	266	0	21	80	0.2625000
NODE_20294_length_650_cov_20.012704	186	266	2	1	80	0.0125000
NODE_20294_length_650_cov_20.012704	186	266	3	6	80	0.0750000
NODE_20294_length_650_cov_20.012704	186	266	4	52	80	0.6500000
NODE_20294_length_650_cov_20.012704	239	319	0	22	80	0.2750000
NODE_20294_length_650_cov_20.012704	239	319	2	53	80	0.6625000
NODE_20294_length_650_cov_20.012704	239	319	3	5	80	0.0625000
NODE_20295_length_650_cov_17.626134	52	132	0	49	80	0.6125000
NODE_20295_length_650_cov_17.626134	52	132	2	31	80	0.3875000
NODE_20295_length_650_cov_17.626134	105	185	2	80	80	1.0000000
NODE_20297_length_650_cov_10.687840	289	369	0	27	80	0.3375000
NODE_20297_length_650_cov_10.687840	289	369	2	53	80	0.6625000
NODE_20297_length_650_cov_10.687840	342	422	0	18	80	0.2250000
NODE_20297_length_650_cov_10.687840	342	422	2	62	80	0.7750000
NODE_20301_length_650_cov_6.519056	312	365	3	1	53	0.0188679
NODE_20301_length_650_cov_6.519056	312	365	7	1	53	0.0188679
NODE_20301_length_650_cov_6.519056	312	365	10	2	53	0.0377358
NODE_20301_length_650_cov_6.519056	312	365	11	6	53	0.1132075
NODE_20301_length_650_cov_6.519056	312	365	12	3	53	0.0566038
NODE_20301_length_650_cov_6.519056	312	365	14	3	53	0.0566038
NODE_20301_length_650_cov_6.519056	312	365	16	5	53	0.0943396
NODE_20301_length_650_cov_6.519056	312	365	18	2	53	0.0377358
NODE_20301_length_650_cov_6.519056	312	365	20	14	53	0.2641509
NODE_20301_length_650_cov_6.519056	312	365	22	8	53	0.1509434
NODE_20301_length_650_cov_6.519056	312	365	24	8	53	0.1509434
NODE_20301_length_650_cov_6.519056	338	417	20	11	79	0.1392405
NODE_20301_length_650_cov_6.519056	338	417	21	7	79	0.0886076
NODE_20301_length_650_cov_6.519056	338	417	22	12	79	0.1518987
NODE_20301_length_650_cov_6.519056	338	417	23	41	79	0.5189874
NODE_20301_length_650_cov_6.519056	338	417	24	8	79	0.1012658
NODE_20302_length_650_cov_6.159710	243	323	0	72	80	0.9000000
NODE_20302_length_650_cov_6.159710	243	323	2	8	80	0.1000000
NODE_20302_length_650_cov_6.159710	296	376	0	80	80	1.0000000
NODE_20318_length_650_cov_2.488203	213	266	0	53	53	1.0000000
NODE_20370_length_649_cov_20.780000	111	140	0	22	29	0.7586207
NODE_20370_length_649_cov_20.780000	111	140	2	7	29	0.2413793
NODE_20370_length_649_cov_20.780000	111	191	0	22	80	0.2750000
NODE_20370_length_649_cov_20.780000	111	191	2	27	80	0.3375000
NODE_20370_length_649_cov_20.780000	111	191	4	7	80	0.0875000
NODE_20370_length_649_cov_20.780000	111	191	10	13	80	0.1625000
NODE_20370_length_649_cov_20.780000	111	191	14	11	80	0.1375000
NODE_20370_length_649_cov_20.780000	138	161	2	22	23	0.9565217
NODE_20370_length_649_cov_20.780000	138	161	4	1	23	0.0434783
NODE_20370_length_649_cov_20.780000	138	214	2	22	76	0.2894737
NODE_20370_length_649_cov_20.780000	138	214	4	7	76	0.0921053
NODE_20370_length_649_cov_20.780000	138	214	10	13	76	0.1710526
NODE_20370_length_649_cov_20.780000	138	214	12	21	76	0.2763158
NODE_20370_length_649_cov_20.780000	138	214	14	13	76	0.1710526
NODE_20370_length_649_cov_20.780000	164	244	4	3	80	0.0375000
NODE_20370_length_649_cov_20.780000	164	244	10	13	80	0.1625000
NODE_20370_length_649_cov_20.780000	164	244	12	51	80	0.6375000
NODE_20370_length_649_cov_20.780000	164	244	14	13	80	0.1625000
NODE_20371_length_649_cov_17.938182	162	242	0	54	80	0.6750000
NODE_20371_length_649_cov_17.938182	162	242	2	26	80	0.3250000
NODE_20371_length_649_cov_17.938182	215	295	0	1	80	0.0125000
NODE_20371_length_649_cov_17.938182	215	295	2	79	80	0.9875000
NODE_20372_length_649_cov_16.761818	395	475	0	25	80	0.3125000
NODE_20372_length_649_cov_16.761818	395	475	2	55	80	0.6875000
NODE_20372_length_649_cov_16.761818	448	528	0	64	80	0.8000000
NODE_20372_length_649_cov_16.761818	448	528	2	16	80	0.2000000
NODE_20373_length_649_cov_15.632727	226	306	0	80	80	1.0000000
NODE_20373_length_649_cov_15.632727	279	359	0	80	80	1.0000000
NODE_20374_length_649_cov_15.516364	329	409	0	25	80	0.3125000
NODE_20374_length_649_cov_15.516364	329	409	2	9	80	0.1125000
NODE_20374_length_649_cov_15.516364	329	409	14	12	80	0.1500000
NODE_20374_length_649_cov_15.516364	329	409	16	34	80	0.4250000
NODE_20374_length_649_cov_15.516364	382	462	14	11	80	0.1375000
NODE_20374_length_649_cov_15.516364	382	462	16	69	80	0.8625000
NODE_20375_length_649_cov_10.374545	453	533	0	80	80	1.0000000
NODE_20375_length_649_cov_10.374545	506	586	0	80	80	1.0000000
NODE_20382_length_649_cov_4.403636	213	293	0	80	80	1.0000000
NODE_20382_length_649_cov_4.403636	266	346	0	80	80	1.0000000
NODE_20454_length_648_cov_34.287796	343	423	0	80	80	1.0000000
NODE_20454_length_648_cov_34.287796	396	476	0	80	80	1.0000000
NODE_20454_length_648_cov_34.287796	472	552	0	80	80	1.0000000
NODE_20454_length_648_cov_34.287796	525	605	0	80	80	1.0000000
NODE_20455_length_648_cov_19.433515	259	339	0	22	80	0.2750000
NODE_20455_length_648_cov_19.433515	259	339	4	58	80	0.7250000
NODE_20455_length_648_cov_19.433515	312	392	0	22	80	0.2750000
NODE_20455_length_648_cov_19.433515	312	392	4	58	80	0.7250000
NODE_20457_length_648_cov_8.391621	206	286	0	80	80	1.0000000
NODE_20457_length_648_cov_8.391621	259	339	0	75	80	0.9375000
NODE_20457_length_648_cov_8.391621	259	339	2	5	80	0.0625000
NODE_20459_length_648_cov_6.573770	293	373	0	80	80	1.0000000
NODE_20459_length_648_cov_6.573770	346	426	0	80	80	1.0000000
NODE_20460_length_648_cov_6.431694	285	328	0	43	43	1.0000000
NODE_20463_length_648_cov_6.085610	257	337	0	80	80	1.0000000
NODE_20463_length_648_cov_6.085610	310	390	0	39	80	0.4875000
NODE_20463_length_648_cov_6.085610	310	390	2	41	80	0.5125000
NODE_20483_length_648_cov_2.333333	19	86	0	65	67	0.9701493
NODE_20483_length_648_cov_2.333333	19	86	2	1	67	0.0149254
NODE_20483_length_648_cov_2.333333	19	86	8	1	67	0.0149254
NODE_20531_length_647_cov_18.489051	295	375	2	17	80	0.2125000
NODE_20531_length_647_cov_18.489051	295	375	4	63	80	0.7875000
NODE_20531_length_647_cov_18.489051	348	428	0	46	80	0.5750000
NODE_20531_length_647_cov_18.489051	348	428	2	11	80	0.1375000
NODE_20531_length_647_cov_18.489051	348	428	4	23	80	0.2875000
NODE_20532_length_647_cov_14.677007	286	366	0	12	80	0.1500000
NODE_20532_length_647_cov_14.677007	286	366	2	8	80	0.1000000
NODE_20532_length_647_cov_14.677007	286	366	4	60	80	0.7500000
NODE_20532_length_647_cov_14.677007	339	419	0	34	80	0.4250000
NODE_20532_length_647_cov_14.677007	339	419	2	5	80	0.0625000
NODE_20532_length_647_cov_14.677007	339	419	4	41	80	0.5125000
NODE_20533_length_647_cov_10.895985	231	311	0	80	80	1.0000000
NODE_20533_length_647_cov_10.895985	284	364	0	80	80	1.0000000
NODE_20534_length_647_cov_9.116788	372	452	2	13	80	0.1625000
NODE_20534_length_647_cov_9.116788	372	452	4	67	80	0.8375000
NODE_20534_length_647_cov_9.116788	425	505	0	52	80	0.6500000
NODE_20534_length_647_cov_9.116788	425	505	2	14	80	0.1750000
NODE_20534_length_647_cov_9.116788	425	505	4	14	80	0.1750000
NODE_20536_length_647_cov_6.410584	150	221	0	9	71	0.1267606
NODE_20536_length_647_cov_6.410584	150	221	2	62	71	0.8732395
NODE_20536_length_647_cov_6.410584	194	274	0	62	80	0.7750000
NODE_20536_length_647_cov_6.410584	194	274	2	18	80	0.2250000
NODE_20539_length_647_cov_5.567518	239	319	0	5	80	0.0625000
NODE_20539_length_647_cov_5.567518	239	319	2	14	80	0.1750000
NODE_20539_length_647_cov_5.567518	239	319	4	23	80	0.2875000
NODE_20539_length_647_cov_5.567518	239	319	10	18	80	0.2250000
NODE_20539_length_647_cov_5.567518	239	319	11	20	80	0.2500000
NODE_20539_length_647_cov_5.567518	292	355	10	7	63	0.1111111
NODE_20539_length_647_cov_5.567518	292	355	11	28	63	0.4444444
NODE_20539_length_647_cov_5.567518	292	355	12	2	63	0.0317460
NODE_20539_length_647_cov_5.567518	292	355	13	4	63	0.0634921
NODE_20539_length_647_cov_5.567518	292	355	14	19	63	0.3015873
NODE_20539_length_647_cov_5.567518	292	355	15	1	63	0.0158730
NODE_20539_length_647_cov_5.567518	292	355	16	2	63	0.0317460
NODE_20539_length_647_cov_5.567518	348	416	8	1	68	0.0147059
NODE_20539_length_647_cov_5.567518	348	416	11	4	68	0.0588235
NODE_20539_length_647_cov_5.567518	348	416	12	1	68	0.0147059
NODE_20539_length_647_cov_5.567518	348	416	14	59	68	0.8676471
NODE_20539_length_647_cov_5.567518	348	416	15	1	68	0.0147059
NODE_20539_length_647_cov_5.567518	348	416	16	2	68	0.0294118
NODE_20539_length_647_cov_5.567518	401	469	14	68	68	1.0000000
NODE_20544_length_647_cov_3.775547	356	399	0	33	43	0.7674419
NODE_20544_length_647_cov_3.775547	356	399	2	10	43	0.2325581
NODE_20550_length_647_cov_2.678832	239	319	0	80	80	1.0000000
NODE_20550_length_647_cov_2.678832	292	372	0	80	80	1.0000000
NODE_20561_length_647_cov_1.937956	254	304	2	50	50	1.0000000
NODE_20607_length_646_cov_56.226691	267	347	0	14	80	0.1750000
NODE_20607_length_646_cov_56.226691	267	347	2	66	80	0.8250000
NODE_20607_length_646_cov_56.226691	320	400	0	25	80	0.3125000
NODE_20607_length_646_cov_56.226691	320	400	2	55	80	0.6875000
NODE_20608_length_646_cov_23.747715	76	153	0	37	77	0.4805195
NODE_20608_length_646_cov_23.747715	76	153	4	40	77	0.5194805
NODE_20608_length_646_cov_23.747715	129	209	0	80	80	1.0000000
NODE_20609_length_646_cov_22.740402	326	406	0	80	80	1.0000000
NODE_20609_length_646_cov_22.740402	379	459	0	80	80	1.0000000
NODE_20610_length_646_cov_15.160878	363	443	0	80	80	1.0000000
NODE_20610_length_646_cov_15.160878	416	496	0	80	80	1.0000000
NODE_20611_length_646_cov_9.429616	309	389	0	80	80	1.0000000
NODE_20611_length_646_cov_9.429616	362	442	0	80	80	1.0000000
NODE_20612_length_646_cov_9.246801	149	221	0	40	72	0.5555556
NODE_20612_length_646_cov_9.246801	149	221	2	32	72	0.4444444
NODE_20613_length_646_cov_7.539305	227	307	0	80	80	1.0000000
NODE_20613_length_646_cov_7.539305	280	360	0	80	80	1.0000000
NODE_20614_length_646_cov_6.756856	236	316	0	30	80	0.3750000
NODE_20614_length_646_cov_6.756856	236	316	5	1	80	0.0125000
NODE_20614_length_646_cov_6.756856	236	316	6	49	80	0.6125000
NODE_20614_length_646_cov_6.756856	289	369	0	21	80	0.2625000
NODE_20614_length_646_cov_6.756856	289	369	6	59	80	0.7375000
NODE_20615_length_646_cov_6.480804	373	437	0	15	64	0.2343750
NODE_20615_length_646_cov_6.480804	373	437	2	49	64	0.7656250
NODE_20615_length_646_cov_6.480804	410	490	0	38	80	0.4750000
NODE_20615_length_646_cov_6.480804	410	490	2	42	80	0.5250000
NODE_20616_length_646_cov_6.396709	194	274	0	80	80	1.0000000
NODE_20616_length_646_cov_6.396709	254	327	0	73	73	1.0000000
NODE_20619_length_646_cov_4.652651	265	345	0	13	80	0.1625000
NODE_20619_length_646_cov_4.652651	265	345	1	1	80	0.0125000
NODE_20619_length_646_cov_4.652651	265	345	2	8	80	0.1000000
NODE_20619_length_646_cov_4.652651	265	345	4	8	80	0.1000000
NODE_20619_length_646_cov_4.652651	265	345	6	50	80	0.6250000
NODE_20623_length_646_cov_4.122486	401	452	2	51	51	1.0000000
NODE_20688_length_645_cov_95.882784	179	259	0	15	80	0.1875000
NODE_20688_length_645_cov_95.882784	179	259	4	65	80	0.8125000
NODE_20688_length_645_cov_95.882784	232	312	0	20	80	0.2500000
NODE_20688_length_645_cov_95.882784	232	312	4	60	80	0.7500000
NODE_20689_length_645_cov_12.985348	343	423	0	80	80	1.0000000
NODE_20689_length_645_cov_12.985348	396	476	0	80	80	1.0000000
NODE_20691_length_645_cov_9.228938	254	334	0	64	80	0.8000000
NODE_20691_length_645_cov_9.228938	254	334	2	16	80	0.2000000
NODE_20691_length_645_cov_9.228938	307	387	0	11	80	0.1375000
NODE_20691_length_645_cov_9.228938	307	387	2	69	80	0.8625000
NODE_20692_length_645_cov_9.172161	293	373	2	63	80	0.7875000
NODE_20692_length_645_cov_9.172161	293	373	4	17	80	0.2125000
NODE_20692_length_645_cov_9.172161	346	426	0	8	80	0.1000000
NODE_20692_length_645_cov_9.172161	346	426	2	72	80	0.9000000
NODE_20697_length_645_cov_5.609890	461	541	0	80	80	1.0000000
NODE_20697_length_645_cov_5.609890	514	594	0	80	80	1.0000000
NODE_20698_length_645_cov_4.743590	237	317	0	80	80	1.0000000
NODE_20698_length_645_cov_4.743590	290	370	0	80	80	1.0000000
NODE_20716_length_645_cov_2.177656	373	416	0	43	43	1.0000000
NODE_20762_length_644_cov_59.286239	323	401	142	3	78	0.0384615
NODE_20762_length_644_cov_59.286239	323	401	145	1	78	0.0128205
NODE_20762_length_644_cov_59.286239	323	401	149	2	78	0.0256410
NODE_20762_length_644_cov_59.286239	323	401	155	1	78	0.0128205
NODE_20762_length_644_cov_59.286239	323	401	159	1	78	0.0128205
NODE_20762_length_644_cov_59.286239	323	401	161	2	78	0.0256410
NODE_20762_length_644_cov_59.286239	323	401	165	1	78	0.0128205
NODE_20762_length_644_cov_59.286239	323	401	172	3	78	0.0384615
NODE_20762_length_644_cov_59.286239	323	401	174	3	78	0.0384615
NODE_20762_length_644_cov_59.286239	323	401	176	1	78	0.0128205
NODE_20762_length_644_cov_59.286239	323	401	178	1	78	0.0128205
NODE_20762_length_644_cov_59.286239	323	401	179	1	78	0.0128205
NODE_20762_length_644_cov_59.286239	323	401	180	2	78	0.0256410
NODE_20762_length_644_cov_59.286239	323	401	184	1	78	0.0128205
NODE_20762_length_644_cov_59.286239	323	401	188	2	78	0.0256410
NODE_20762_length_644_cov_59.286239	323	401	193	1	78	0.0128205
NODE_20762_length_644_cov_59.286239	323	401	197	1	78	0.0128205
NODE_20762_length_644_cov_59.286239	323	401	201	1	78	0.0128205
NODE_20762_length_644_cov_59.286239	323	401	203	1	78	0.0128205
NODE_20762_length_644_cov_59.286239	323	401	208	1	78	0.0128205
NODE_20762_length_644_cov_59.286239	323	401	212	1	78	0.0128205
NODE_20762_length_644_cov_59.286239	323	401	218	1	78	0.0128205
NODE_20762_length_644_cov_59.286239	323	401	220	1	78	0.0128205
NODE_20762_length_644_cov_59.286239	323	401	221	1	78	0.0128205
NODE_20762_length_644_cov_59.286239	323	401	223	1	78	0.0128205
NODE_20762_length_644_cov_59.286239	323	401	227	1	78	0.0128205
NODE_20762_length_644_cov_59.286239	323	401	239	1	78	0.0128205
NODE_20762_length_644_cov_59.286239	323	401	244	1	78	0.0128205
NODE_20762_length_644_cov_59.286239	323	401	246	2	78	0.0256410
NODE_20762_length_644_cov_59.286239	323	401	251	1	78	0.0128205
NODE_20762_length_644_cov_59.286239	323	401	254	2	78	0.0256410
NODE_20762_length_644_cov_59.286239	323	401	256	2	78	0.0256410
NODE_20762_length_644_cov_59.286239	323	401	264	1	78	0.0128205
NODE_20762_length_644_cov_59.286239	323	401	270	1	78	0.0128205
NODE_20762_length_644_cov_59.286239	323	401	281	1	78	0.0128205
NODE_20762_length_644_cov_59.286239	323	401	287	2	78	0.0256410
NODE_20762_length_644_cov_59.286239	323	401	301	1	78	0.0128205
NODE_20762_length_644_cov_59.286239	323	401	304	2	78	0.0256410
NODE_20762_length_644_cov_59.286239	323	401	308	2	78	0.0256410
NODE_20762_length_644_cov_59.286239	323	401	315	2	78	0.0256410
NODE_20762_length_644_cov_59.286239	323	401	320	1	78	0.0128205
NODE_20762_length_644_cov_59.286239	323	401	326	1	78	0.0128205
NODE_20762_length_644_cov_59.286239	323	401	330	2	78	0.0256410
NODE_20762_length_644_cov_59.286239	323	401	333	1	78	0.0128205
NODE_20762_length_644_cov_59.286239	323	401	337	1	78	0.0128205
NODE_20762_length_644_cov_59.286239	323	401	338	1	78	0.0128205
NODE_20762_length_644_cov_59.286239	323	401	342	2	78	0.0256410
NODE_20762_length_644_cov_59.286239	323	401	345	1	78	0.0128205
NODE_20762_length_644_cov_59.286239	323	401	346	2	78	0.0256410
NODE_20762_length_644_cov_59.286239	323	401	348	1	78	0.0128205
NODE_20762_length_644_cov_59.286239	323	401	352	1	78	0.0128205
NODE_20762_length_644_cov_59.286239	323	401	361	3	78	0.0384615
NODE_20762_length_644_cov_59.286239	323	401	363	1	78	0.0128205
NODE_20762_length_644_cov_59.286239	323	401	364	1	78	0.0128205
NODE_20762_length_644_cov_59.286239	323	401	365	2	78	0.0256410
NODE_20763_length_644_cov_27.577982	63	143	0	18	80	0.2250000
NODE_20763_length_644_cov_27.577982	63	143	2	4	80	0.0500000
NODE_20763_length_644_cov_27.577982	63	143	8	1	80	0.0125000
NODE_20763_length_644_cov_27.577982	63	143	9	16	80	0.2000000
NODE_20763_length_644_cov_27.577982	63	143	10	34	80	0.4250000
NODE_20763_length_644_cov_27.577982	63	143	12	7	80	0.0875000
NODE_20763_length_644_cov_27.577982	116	196	10	73	80	0.9125000
NODE_20763_length_644_cov_27.577982	116	196	12	7	80	0.0875000
NODE_20765_length_644_cov_10.073394	284	364	0	80	80	1.0000000
NODE_20765_length_644_cov_10.073394	337	417	0	80	80	1.0000000
NODE_20845_length_643_cov_27.562500	201	281	0	80	80	1.0000000
NODE_20845_length_643_cov_27.562500	254	334	0	28	80	0.3500000
NODE_20845_length_643_cov_27.562500	254	334	2	46	80	0.5750000
NODE_20845_length_643_cov_27.562500	254	334	4	6	80	0.0750000
NODE_20845_length_643_cov_27.562500	330	410	0	4	80	0.0500000
NODE_20845_length_643_cov_27.562500	330	410	2	39	80	0.4875000
NODE_20845_length_643_cov_27.562500	330	410	4	37	80	0.4625000
NODE_20845_length_643_cov_27.562500	383	463	0	57	80	0.7125000
NODE_20845_length_643_cov_27.562500	383	463	2	23	80	0.2875000
NODE_20846_length_643_cov_12.895221	203	283	6	80	80	1.0000000
NODE_20846_length_643_cov_12.895221	256	336	0	42	80	0.5250000
NODE_20846_length_643_cov_12.895221	256	336	6	38	80	0.4750000
NODE_20847_length_643_cov_10.501838	280	360	0	3	80	0.0375000
NODE_20847_length_643_cov_10.501838	280	360	2	77	80	0.9625000
NODE_20847_length_643_cov_10.501838	333	413	0	56	80	0.7000000
NODE_20847_length_643_cov_10.501838	333	413	2	24	80	0.3000000
NODE_20848_length_643_cov_9.136029	307	385	10	23	78	0.2948718
NODE_20848_length_643_cov_9.136029	307	385	12	9	78	0.1153846
NODE_20848_length_643_cov_9.136029	307	385	14	17	78	0.2179487
NODE_20848_length_643_cov_9.136029	307	385	16	9	78	0.1153846
NODE_20848_length_643_cov_9.136029	307	385	18	20	78	0.2564103
NODE_20848_length_643_cov_9.136029	358	438	8	13	80	0.1625000
NODE_20848_length_643_cov_9.136029	358	438	14	57	80	0.7125000
NODE_20848_length_643_cov_9.136029	358	438	16	9	80	0.1125000
NODE_20848_length_643_cov_9.136029	358	438	18	1	80	0.0125000
NODE_20849_length_643_cov_8.264706	202	282	6	8	80	0.1000000
NODE_20849_length_643_cov_8.264706	202	282	8	44	80	0.5500000
NODE_20849_length_643_cov_8.264706	202	282	10	28	80	0.3500000
NODE_20849_length_643_cov_8.264706	255	335	2	7	80	0.0875000
NODE_20849_length_643_cov_8.264706	255	335	4	17	80	0.2125000
NODE_20849_length_643_cov_8.264706	255	335	7	10	80	0.1250000
NODE_20849_length_643_cov_8.264706	255	335	10	46	80	0.5750000
NODE_20851_length_643_cov_7.137868	173	253	0	19	80	0.2375000
NODE_20851_length_643_cov_7.137868	173	253	2	37	80	0.4625000
NODE_20851_length_643_cov_7.137868	173	253	4	24	80	0.3000000
NODE_20851_length_643_cov_7.137868	226	306	0	25	80	0.3125000
NODE_20851_length_643_cov_7.137868	226	306	2	18	80	0.2250000
NODE_20851_length_643_cov_7.137868	226	306	4	37	80	0.4625000
NODE_20855_length_643_cov_5.851103	255	335	12	3	80	0.0375000
NODE_20855_length_643_cov_5.851103	255	335	13	33	80	0.4125000
NODE_20855_length_643_cov_5.851103	255	335	15	7	80	0.0875000
NODE_20855_length_643_cov_5.851103	255	335	17	15	80	0.1875000
NODE_20855_length_643_cov_5.851103	255	335	18	12	80	0.1500000
NODE_20855_length_643_cov_5.851103	255	335	19	10	80	0.1250000
NODE_20855_length_643_cov_5.851103	308	388	2	37	80	0.4625000
NODE_20855_length_643_cov_5.851103	308	388	12	19	80	0.2375000
NODE_20855_length_643_cov_5.851103	308	388	13	24	80	0.3000000
NODE_20869_length_643_cov_3.121324	283	348	0	33	65	0.5076923
NODE_20869_length_643_cov_3.121324	283	348	2	32	65	0.4923077
NODE_20872_length_643_cov_2.806985	387	451	0	64	64	1.0000000
NODE_20942_length_642_cov_36.309392	156	236	0	80	80	1.0000000
NODE_20942_length_642_cov_36.309392	209	289	0	80	80	1.0000000
NODE_20943_length_642_cov_27.046041	154	234	0	59	80	0.7375000
NODE_20943_length_642_cov_27.046041	154	234	2	21	80	0.2625000
NODE_20943_length_642_cov_27.046041	207	287	0	6	80	0.0750000
NODE_20943_length_642_cov_27.046041	207	287	2	74	80	0.9250000
NODE_20944_length_642_cov_26.290976	209	289	0	55	80	0.6875000
NODE_20944_length_642_cov_26.290976	209	289	2	25	80	0.3125000
NODE_20944_length_642_cov_26.290976	262	342	0	3	80	0.0375000
NODE_20944_length_642_cov_26.290976	262	342	2	77	80	0.9625000
NODE_20945_length_642_cov_11.651934	309	389	0	80	80	1.0000000
NODE_20945_length_642_cov_11.651934	362	442	0	80	80	1.0000000
NODE_20947_length_642_cov_6.692449	453	533	0	20	80	0.2500000
NODE_20947_length_642_cov_6.692449	453	533	2	60	80	0.7500000
NODE_20947_length_642_cov_6.692449	506	586	2	80	80	1.0000000
NODE_20951_length_642_cov_5.933702	260	340	0	23	80	0.2875000
NODE_20951_length_642_cov_5.933702	260	340	2	57	80	0.7125000
NODE_20951_length_642_cov_5.933702	313	391	0	74	78	0.9487180
NODE_20951_length_642_cov_5.933702	313	391	2	4	78	0.0512821
NODE_20967_length_642_cov_2.823204	115	158	6	9	43	0.2093023
NODE_20967_length_642_cov_2.823204	115	158	8	7	43	0.1627907
NODE_20967_length_642_cov_2.823204	115	158	10	6	43	0.1395349
NODE_20967_length_642_cov_2.823204	115	158	12	17	43	0.3953488
NODE_20967_length_642_cov_2.823204	115	158	14	4	43	0.0930233
NODE_20967_length_642_cov_2.823204	245	300	20	16	55	0.2909091
NODE_20967_length_642_cov_2.823204	245	300	22	9	55	0.1636364
NODE_20967_length_642_cov_2.823204	245	300	26	1	55	0.0181818
NODE_20967_length_642_cov_2.823204	245	300	27	1	55	0.0181818
NODE_20967_length_642_cov_2.823204	245	300	28	19	55	0.3454545
NODE_20967_length_642_cov_2.823204	245	300	30	4	55	0.0727273
NODE_20967_length_642_cov_2.823204	245	300	32	5	55	0.0909091
NODE_20967_length_642_cov_2.823204	329	410	8	2	81	0.0246914
NODE_20967_length_642_cov_2.823204	329	410	10	7	81	0.0864198
NODE_20967_length_642_cov_2.823204	329	410	12	52	81	0.6419753
NODE_20967_length_642_cov_2.823204	329	410	14	16	81	0.1975309
NODE_20967_length_642_cov_2.823204	329	410	16	4	81	0.0493827
NODE_20991_length_642_cov_1.357274	0	75	0	75	75	1.0000000
NODE_21018_length_641_cov_38.675277	284	345	4	10	61	0.1639344
NODE_21018_length_641_cov_38.675277	284	345	6	14	61	0.2295082
NODE_21018_length_641_cov_38.675277	284	345	8	1	61	0.0163934
NODE_21018_length_641_cov_38.675277	284	345	12	5	61	0.0819672
NODE_21018_length_641_cov_38.675277	284	345	14	18	61	0.2950820
NODE_21018_length_641_cov_38.675277	284	345	16	3	61	0.0491803
NODE_21018_length_641_cov_38.675277	284	345	18	5	61	0.0819672
NODE_21018_length_641_cov_38.675277	284	345	20	5	61	0.0819672
NODE_21018_length_641_cov_38.675277	318	369	14	14	51	0.2745098
NODE_21018_length_641_cov_38.675277	318	369	16	3	51	0.0588235
NODE_21018_length_641_cov_38.675277	318	369	18	5	51	0.0980392
NODE_21018_length_641_cov_38.675277	318	369	20	29	51	0.5686275
NODE_21019_length_641_cov_15.271218	260	340	0	80	80	1.0000000
NODE_21019_length_641_cov_15.271218	313	393	0	80	80	1.0000000
NODE_21021_length_641_cov_12.584871	363	443	0	80	80	1.0000000
NODE_21021_length_641_cov_12.584871	416	496	0	80	80	1.0000000
NODE_21022_length_641_cov_11.125461	38	118	0	80	80	1.0000000
NODE_21022_length_641_cov_11.125461	91	171	0	80	80	1.0000000
NODE_21025_length_641_cov_7.719557	84	138	0	6	54	0.1111111
NODE_21025_length_641_cov_7.719557	84	138	2	4	54	0.0740741
NODE_21025_length_641_cov_7.719557	84	138	6	9	54	0.1666667
NODE_21025_length_641_cov_7.719557	84	138	8	35	54	0.6481481
NODE_21025_length_641_cov_7.719557	113	193	6	20	80	0.2500000
NODE_21025_length_641_cov_7.719557	113	193	8	60	80	0.7500000
NODE_21026_length_641_cov_7.675277	232	312	0	45	80	0.5625000
NODE_21026_length_641_cov_7.675277	232	312	2	16	80	0.2000000
NODE_21026_length_641_cov_7.675277	232	312	6	19	80	0.2375000
NODE_21026_length_641_cov_7.675277	285	365	2	8	80	0.1000000
NODE_21026_length_641_cov_7.675277	285	365	6	72	80	0.9000000
NODE_21027_length_641_cov_7.675277	255	335	4	7	80	0.0875000
NODE_21027_length_641_cov_7.675277	255	335	6	61	80	0.7625000
NODE_21027_length_641_cov_7.675277	255	335	8	12	80	0.1500000
NODE_21027_length_641_cov_7.675277	308	388	0	16	80	0.2000000
NODE_21027_length_641_cov_7.675277	308	388	2	8	80	0.1000000
NODE_21027_length_641_cov_7.675277	308	388	4	36	80	0.4500000
NODE_21027_length_641_cov_7.675277	308	388	6	20	80	0.2500000
NODE_21028_length_641_cov_7.627306	262	342	0	80	80	1.0000000
NODE_21028_length_641_cov_7.627306	315	395	0	80	80	1.0000000
NODE_21029_length_641_cov_7.282288	247	300	0	53	53	1.0000000
NODE_21031_length_641_cov_5.029520	138	218	0	14	80	0.1750000
NODE_21031_length_641_cov_5.029520	138	218	4	66	80	0.8250000
NODE_21031_length_641_cov_5.029520	191	271	0	67	80	0.8375000
NODE_21031_length_641_cov_5.029520	191	271	4	13	80	0.1625000
NODE_21034_length_641_cov_4.701107	238	282	6	44	44	1.0000000
NODE_21109_length_640_cov_39.676525	524	597	48	1	73	0.0136986
NODE_21109_length_640_cov_39.676525	524	597	49	2	73	0.0273973
NODE_21109_length_640_cov_39.676525	524	597	55	1	73	0.0136986
NODE_21109_length_640_cov_39.676525	524	597	57	10	73	0.1369863
NODE_21109_length_640_cov_39.676525	524	597	59	2	73	0.0273973
NODE_21109_length_640_cov_39.676525	524	597	63	2	73	0.0273973
NODE_21109_length_640_cov_39.676525	524	597	65	1	73	0.0136986
NODE_21109_length_640_cov_39.676525	524	597	66	1	73	0.0136986
NODE_21109_length_640_cov_39.676525	524	597	68	1	73	0.0136986
NODE_21109_length_640_cov_39.676525	524	597	72	6	73	0.0821918
NODE_21109_length_640_cov_39.676525	524	597	74	2	73	0.0273973
NODE_21109_length_640_cov_39.676525	524	597	76	3	73	0.0410959
NODE_21109_length_640_cov_39.676525	524	597	78	1	73	0.0136986
NODE_21109_length_640_cov_39.676525	524	597	80	3	73	0.0410959
NODE_21109_length_640_cov_39.676525	524	597	87	3	73	0.0410959
NODE_21109_length_640_cov_39.676525	524	597	88	2	73	0.0273973
NODE_21109_length_640_cov_39.676525	524	597	90	2	73	0.0273973
NODE_21109_length_640_cov_39.676525	524	597	96	2	73	0.0273973
NODE_21109_length_640_cov_39.676525	524	597	98	1	73	0.0136986
NODE_21109_length_640_cov_39.676525	524	597	100	2	73	0.0273973
NODE_21109_length_640_cov_39.676525	524	597	101	4	73	0.0547945
NODE_21109_length_640_cov_39.676525	524	597	109	4	73	0.0547945
NODE_21109_length_640_cov_39.676525	524	597	110	1	73	0.0136986
NODE_21109_length_640_cov_39.676525	524	597	111	2	73	0.0273973
NODE_21109_length_640_cov_39.676525	524	597	113	2	73	0.0273973
NODE_21109_length_640_cov_39.676525	524	597	114	1	73	0.0136986
NODE_21109_length_640_cov_39.676525	524	597	115	6	73	0.0821918
NODE_21109_length_640_cov_39.676525	524	597	118	2	73	0.0273973
NODE_21109_length_640_cov_39.676525	524	597	120	1	73	0.0136986
NODE_21109_length_640_cov_39.676525	524	597	123	1	73	0.0136986
NODE_21109_length_640_cov_39.676525	524	597	124	1	73	0.0136986
NODE_21109_length_640_cov_39.676525	564	605	45	7	41	0.1707317
NODE_21109_length_640_cov_39.676525	564	605	47	1	41	0.0243902
NODE_21109_length_640_cov_39.676525	564	605	48	1	41	0.0243902
NODE_21109_length_640_cov_39.676525	564	605	49	2	41	0.0487805
NODE_21109_length_640_cov_39.676525	564	605	55	1	41	0.0243902
NODE_21109_length_640_cov_39.676525	564	605	57	10	41	0.2439024
NODE_21109_length_640_cov_39.676525	564	605	59	2	41	0.0487805
NODE_21109_length_640_cov_39.676525	564	605	63	2	41	0.0487805
NODE_21109_length_640_cov_39.676525	564	605	65	1	41	0.0243902
NODE_21109_length_640_cov_39.676525	564	605	66	1	41	0.0243902
NODE_21109_length_640_cov_39.676525	564	605	68	1	41	0.0243902
NODE_21109_length_640_cov_39.676525	564	605	72	6	41	0.1463415
NODE_21109_length_640_cov_39.676525	564	605	74	2	41	0.0487805
NODE_21109_length_640_cov_39.676525	564	605	76	3	41	0.0731707
NODE_21109_length_640_cov_39.676525	564	605	78	1	41	0.0243902
NODE_21110_length_640_cov_19.578558	273	353	0	22	80	0.2750000
NODE_21110_length_640_cov_19.578558	273	353	2	58	80	0.7250000
NODE_21110_length_640_cov_19.578558	326	406	0	75	80	0.9375000
NODE_21110_length_640_cov_19.578558	326	406	2	5	80	0.0625000
NODE_21111_length_640_cov_15.717190	178	258	0	54	80	0.6750000
NODE_21111_length_640_cov_15.717190	178	258	2	26	80	0.3250000
NODE_21111_length_640_cov_15.717190	231	311	0	1	80	0.0125000
NODE_21111_length_640_cov_15.717190	231	311	2	79	80	0.9875000
NODE_21112_length_640_cov_15.338262	319	399	4	80	80	1.0000000
NODE_21112_length_640_cov_15.338262	372	452	0	16	80	0.2000000
NODE_21112_length_640_cov_15.338262	372	452	4	64	80	0.8000000
NODE_21113_length_640_cov_9.523105	20	43	0	23	23	1.0000000
NODE_21118_length_640_cov_5.123845	272	335	0	54	63	0.8571429
NODE_21118_length_640_cov_5.123845	272	335	2	9	63	0.1428571
NODE_21121_length_640_cov_4.410351	254	334	0	80	80	1.0000000
NODE_21121_length_640_cov_4.410351	307	387	0	80	80	1.0000000
NODE_21129_length_640_cov_3.406654	244	324	0	80	80	1.0000000
NODE_21140_length_640_cov_2.316081	21	57	0	36	36	1.0000000
NODE_21190_length_639_cov_58.092593	302	377	0	75	75	1.0000000
NODE_21190_length_639_cov_58.092593	350	430	0	80	80	1.0000000
NODE_21191_length_639_cov_32.951852	213	293	0	22	80	0.2750000
NODE_21191_length_639_cov_32.951852	213	293	2	13	80	0.1625000
NODE_21191_length_639_cov_32.951852	213	293	4	45	80	0.5625000
NODE_21191_length_639_cov_32.951852	266	346	0	75	80	0.9375000
NODE_21191_length_639_cov_32.951852	266	346	2	5	80	0.0625000
NODE_21192_length_639_cov_24.564815	290	370	0	22	80	0.2750000
NODE_21192_length_639_cov_24.564815	290	370	2	58	80	0.7250000
NODE_21192_length_639_cov_24.564815	343	423	0	62	80	0.7750000
NODE_21192_length_639_cov_24.564815	343	423	2	18	80	0.2250000
NODE_21193_length_639_cov_14.448148	288	368	0	15	80	0.1875000
NODE_21193_length_639_cov_14.448148	288	368	2	65	80	0.8125000
NODE_21193_length_639_cov_14.448148	341	421	0	9	80	0.1125000
NODE_21193_length_639_cov_14.448148	341	421	2	71	80	0.8875000
NODE_21195_length_639_cov_9.001852	265	345	0	80	80	1.0000000
NODE_21195_length_639_cov_9.001852	318	398	0	70	80	0.8750000
NODE_21195_length_639_cov_9.001852	318	398	2	10	80	0.1250000
NODE_21197_length_639_cov_8.444444	161	241	0	80	80	1.0000000
NODE_21197_length_639_cov_8.444444	214	294	0	80	80	1.0000000
NODE_21202_length_639_cov_6.283333	157	176	0	19	19	1.0000000
NODE_21207_length_639_cov_4.188889	258	335	0	77	77	1.0000000
NODE_21207_length_639_cov_4.188889	308	354	0	46	46	1.0000000
NODE_21213_length_639_cov_3.448148	126	206	0	80	80	1.0000000
NODE_21213_length_639_cov_3.448148	179	259	0	80	80	1.0000000
NODE_21223_length_639_cov_2.683333	256	288	0	32	32	1.0000000
NODE_21224_length_639_cov_2.555556	189	240	16	7	51	0.1372549
NODE_21224_length_639_cov_2.555556	189	240	20	2	51	0.0392157
NODE_21224_length_639_cov_2.555556	189	240	22	1	51	0.0196078
NODE_21224_length_639_cov_2.555556	189	240	24	41	51	0.8039216
NODE_21225_length_639_cov_2.477778	562	635	0	71	73	0.9726027
NODE_21225_length_639_cov_2.477778	562	635	2	2	73	0.0273973
NODE_21265_length_639_cov_1.179630	542	564	0	22	22	1.0000000
NODE_21269_length_639_cov_1.051852	404	455	0	34	51	0.6666667
NODE_21269_length_639_cov_1.051852	404	455	2	17	51	0.3333333
NODE_21278_length_638_cov_13.018553	273	353	0	80	80	1.0000000
NODE_21278_length_638_cov_13.018553	326	406	0	80	80	1.0000000
NODE_21279_length_638_cov_12.656772	343	423	0	2	80	0.0250000
NODE_21279_length_638_cov_12.656772	343	423	12	78	80	0.9750000
NODE_21279_length_638_cov_12.656772	396	476	11	42	80	0.5250000
NODE_21279_length_638_cov_12.656772	396	476	12	38	80	0.4750000
NODE_21280_length_638_cov_11.877551	298	378	8	80	80	1.0000000
NODE_21280_length_638_cov_11.877551	351	431	0	29	80	0.3625000
NODE_21280_length_638_cov_11.877551	351	431	4	15	80	0.1875000
NODE_21280_length_638_cov_11.877551	351	431	8	36	80	0.4500000
NODE_21281_length_638_cov_8.779221	330	408	0	78	78	1.0000000
NODE_21281_length_638_cov_8.779221	383	461	0	78	78	1.0000000
NODE_21284_length_638_cov_5.543599	315	395	0	80	80	1.0000000
NODE_21290_length_638_cov_3.966605	307	387	0	80	80	1.0000000
NODE_21301_length_638_cov_2.786642	157	208	0	51	51	1.0000000
NODE_21301_length_638_cov_2.786642	181	261	0	80	80	1.0000000
NODE_21364_length_637_cov_67.157993	285	365	2	5	80	0.0625000
NODE_21364_length_637_cov_67.157993	285	365	6	34	80	0.4250000
NODE_21364_length_637_cov_67.157993	285	365	8	41	80	0.5125000
NODE_21364_length_637_cov_67.157993	338	418	0	5	80	0.0625000
NODE_21364_length_637_cov_67.157993	338	418	2	10	80	0.1250000
NODE_21364_length_637_cov_67.157993	338	418	4	7	80	0.0875000
NODE_21364_length_637_cov_67.157993	338	418	8	58	80	0.7250000
NODE_21364_length_637_cov_67.157993	414	494	0	80	80	1.0000000
NODE_21364_length_637_cov_67.157993	467	547	0	63	80	0.7875000
NODE_21364_length_637_cov_67.157993	467	547	2	17	80	0.2125000
NODE_21365_length_637_cov_63.029740	195	275	0	80	80	1.0000000
NODE_21365_length_637_cov_63.029740	248	328	0	80	80	1.0000000
NODE_21366_length_637_cov_44.923792	53	133	2	16	80	0.2000000
NODE_21366_length_637_cov_44.923792	53	133	4	64	80	0.8000000
NODE_21366_length_637_cov_44.923792	54	133	2	15	79	0.1898734
NODE_21366_length_637_cov_44.923792	54	133	4	64	79	0.8101266
NODE_21366_length_637_cov_44.923792	106	186	0	17	80	0.2125000
NODE_21366_length_637_cov_44.923792	106	186	1	4	80	0.0500000
NODE_21366_length_637_cov_44.923792	106	186	2	19	80	0.2375000
NODE_21366_length_637_cov_44.923792	106	186	4	40	80	0.5000000
NODE_21366_length_637_cov_44.923792	106	186	0	17	80	0.2125000
NODE_21366_length_637_cov_44.923792	106	186	1	4	80	0.0500000
NODE_21366_length_637_cov_44.923792	106	186	2	19	80	0.2375000
NODE_21366_length_637_cov_44.923792	106	186	4	40	80	0.5000000
NODE_21366_length_637_cov_44.923792	182	262	0	80	80	1.0000000
NODE_21366_length_637_cov_44.923792	235	315	0	80	80	1.0000000
NODE_21367_length_637_cov_44.193309	193	273	0	80	80	1.0000000
NODE_21367_length_637_cov_44.193309	246	326	0	80	80	1.0000000
NODE_21368_length_637_cov_37.855019	215	295	41	5	80	0.0625000
NODE_21368_length_637_cov_37.855019	215	295	42	2	80	0.0250000
NODE_21368_length_637_cov_37.855019	215	295	47	3	80	0.0375000
NODE_21368_length_637_cov_37.855019	215	295	48	70	80	0.8750000
NODE_21368_length_637_cov_37.855019	268	347	2	6	79	0.0759494
NODE_21368_length_637_cov_37.855019	268	347	36	10	79	0.1265823
NODE_21368_length_637_cov_37.855019	268	347	37	1	79	0.0126582
NODE_21368_length_637_cov_37.855019	268	347	38	20	79	0.2531646
NODE_21368_length_637_cov_37.855019	268	347	40	14	79	0.1772152
NODE_21368_length_637_cov_37.855019	268	347	41	1	79	0.0126582
NODE_21368_length_637_cov_37.855019	268	347	42	1	79	0.0126582
NODE_21368_length_637_cov_37.855019	268	347	47	1	79	0.0126582
NODE_21368_length_637_cov_37.855019	268	347	48	25	79	0.3164557
NODE_21369_length_637_cov_33.957249	332	412	0	80	80	1.0000000
NODE_21369_length_637_cov_33.957249	385	465	0	80	80	1.0000000
NODE_21370_length_637_cov_23.682156	275	355	2	63	80	0.7875000
NODE_21370_length_637_cov_23.682156	275	355	4	17	80	0.2125000
NODE_21370_length_637_cov_23.682156	328	408	0	14	80	0.1750000
NODE_21370_length_637_cov_23.682156	328	408	2	61	80	0.7625000
NODE_21370_length_637_cov_23.682156	328	408	4	5	80	0.0625000
NODE_21371_length_637_cov_19.676580	267	347	2	63	80	0.7875000
NODE_21371_length_637_cov_19.676580	267	347	4	17	80	0.2125000
NODE_21371_length_637_cov_19.676580	320	400	0	21	80	0.2625000
NODE_21371_length_637_cov_19.676580	320	400	2	45	80	0.5625000
NODE_21371_length_637_cov_19.676580	320	400	4	14	80	0.1750000
NODE_21373_length_637_cov_9.182156	226	276	0	50	50	1.0000000
NODE_21373_length_637_cov_9.182156	312	357	2	45	45	1.0000000
NODE_21374_length_637_cov_9.078067	276	357	4	37	81	0.4567901
NODE_21374_length_637_cov_9.078067	276	357	6	40	81	0.4938272
NODE_21374_length_637_cov_9.078067	276	357	8	2	81	0.0246914
NODE_21374_length_637_cov_9.078067	276	357	10	2	81	0.0246914
NODE_21374_length_637_cov_9.078067	330	410	0	5	80	0.0625000
NODE_21374_length_637_cov_9.078067	330	410	2	45	80	0.5625000
NODE_21374_length_637_cov_9.078067	330	410	3	2	80	0.0250000
NODE_21374_length_637_cov_9.078067	330	410	4	28	80	0.3500000
NODE_21375_length_637_cov_8.566914	235	315	0	54	80	0.6750000
NODE_21375_length_637_cov_8.566914	235	315	2	26	80	0.3250000
NODE_21375_length_637_cov_8.566914	288	368	0	1	80	0.0125000
NODE_21375_length_637_cov_8.566914	288	368	2	79	80	0.9875000
NODE_21378_length_637_cov_6.652416	337	415	4	7	78	0.0897436
NODE_21378_length_637_cov_6.652416	337	415	6	8	78	0.1025641
NODE_21378_length_637_cov_6.652416	337	415	8	6	78	0.0769231
NODE_21378_length_637_cov_6.652416	337	415	10	57	78	0.7307692
NODE_21378_length_637_cov_6.652416	390	472	4	17	82	0.2073171
NODE_21378_length_637_cov_6.652416	390	472	6	22	82	0.2682927
NODE_21378_length_637_cov_6.652416	390	472	7	1	82	0.0121951
NODE_21378_length_637_cov_6.652416	390	472	8	23	82	0.2804878
NODE_21378_length_637_cov_6.652416	390	472	10	19	82	0.2317073
NODE_21385_length_637_cov_4.522305	284	364	0	80	80	1.0000000
NODE_21385_length_637_cov_4.522305	337	417	0	30	80	0.3750000
NODE_21385_length_637_cov_4.522305	337	417	2	50	80	0.6250000
NODE_21389_length_637_cov_4.131970	292	370	0	78	78	1.0000000
NODE_21389_length_637_cov_4.131970	343	423	0	80	80	1.0000000
NODE_21457_length_636_cov_19.938547	214	294	10	80	80	1.0000000
NODE_21457_length_636_cov_19.938547	267	347	0	22	80	0.2750000
NODE_21457_length_636_cov_19.938547	267	347	4	12	80	0.1500000
NODE_21457_length_636_cov_19.938547	267	347	10	46	80	0.5750000
NODE_21458_length_636_cov_12.283054	295	375	2	24	80	0.3000000
NODE_21458_length_636_cov_12.283054	295	375	8	43	80	0.5375000
NODE_21458_length_636_cov_12.283054	295	375	10	13	80	0.1625000
NODE_21458_length_636_cov_12.283054	348	428	2	2	80	0.0250000
NODE_21458_length_636_cov_12.283054	348	428	8	62	80	0.7750000
NODE_21458_length_636_cov_12.283054	348	428	10	16	80	0.2000000
NODE_21460_length_636_cov_8.312849	346	413	0	67	67	1.0000000
NODE_21460_length_636_cov_8.312849	399	479	0	80	80	1.0000000
NODE_21467_length_636_cov_4.324022	185	251	0	66	66	1.0000000
NODE_21467_length_636_cov_4.324022	224	266	0	42	42	1.0000000
NODE_21467_length_636_cov_4.324022	224	264	0	40	40	1.0000000
NODE_21539_length_635_cov_45.483209	195	239	182	1	44	0.0227273
NODE_21539_length_635_cov_45.483209	195	239	184	1	44	0.0227273
NODE_21539_length_635_cov_45.483209	195	239	190	3	44	0.0681818
NODE_21539_length_635_cov_45.483209	195	239	195	1	44	0.0227273
NODE_21539_length_635_cov_45.483209	195	239	196	1	44	0.0227273
NODE_21539_length_635_cov_45.483209	195	239	197	1	44	0.0227273
NODE_21539_length_635_cov_45.483209	195	239	198	9	44	0.2045455
NODE_21539_length_635_cov_45.483209	195	239	199	2	44	0.0454545
NODE_21539_length_635_cov_45.483209	195	239	200	5	44	0.1136364
NODE_21539_length_635_cov_45.483209	195	239	201	1	44	0.0227273
NODE_21539_length_635_cov_45.483209	195	239	202	9	44	0.2045455
NODE_21539_length_635_cov_45.483209	195	239	203	2	44	0.0454545
NODE_21539_length_635_cov_45.483209	195	239	204	6	44	0.1363636
NODE_21539_length_635_cov_45.483209	195	239	207	2	44	0.0454545
NODE_21539_length_635_cov_45.483209	225	268	154	1	43	0.0232558
NODE_21539_length_635_cov_45.483209	225	268	156	2	43	0.0465116
NODE_21539_length_635_cov_45.483209	225	268	165	1	43	0.0232558
NODE_21539_length_635_cov_45.483209	225	268	166	1	43	0.0232558
NODE_21539_length_635_cov_45.483209	225	268	167	2	43	0.0465116
NODE_21539_length_635_cov_45.483209	225	268	172	1	43	0.0232558
NODE_21539_length_635_cov_45.483209	225	268	174	1	43	0.0232558
NODE_21539_length_635_cov_45.483209	225	268	179	1	43	0.0232558
NODE_21539_length_635_cov_45.483209	225	268	186	3	43	0.0697674
NODE_21539_length_635_cov_45.483209	225	268	188	1	43	0.0232558
NODE_21539_length_635_cov_45.483209	225	268	190	4	43	0.0930233
NODE_21539_length_635_cov_45.483209	225	268	192	3	43	0.0697674
NODE_21539_length_635_cov_45.483209	225	268	193	1	43	0.0232558
NODE_21539_length_635_cov_45.483209	225	268	194	3	43	0.0697674
NODE_21539_length_635_cov_45.483209	225	268	196	2	43	0.0465116
NODE_21539_length_635_cov_45.483209	225	268	198	1	43	0.0232558
NODE_21539_length_635_cov_45.483209	225	268	199	1	43	0.0232558
NODE_21539_length_635_cov_45.483209	225	268	200	4	43	0.0930233
NODE_21539_length_635_cov_45.483209	225	268	202	5	43	0.1162791
NODE_21539_length_635_cov_45.483209	225	268	203	2	43	0.0465116
NODE_21539_length_635_cov_45.483209	225	268	204	3	43	0.0697674
NODE_21539_length_635_cov_45.483209	248	298	69	1	50	0.0200000
NODE_21539_length_635_cov_45.483209	248	298	74	1	50	0.0200000
NODE_21539_length_635_cov_45.483209	248	298	75	1	50	0.0200000
NODE_21539_length_635_cov_45.483209	248	298	76	1	50	0.0200000
NODE_21539_length_635_cov_45.483209	248	298	77	1	50	0.0200000
NODE_21539_length_635_cov_45.483209	248	298	84	1	50	0.0200000
NODE_21539_length_635_cov_45.483209	248	298	89	1	50	0.0200000
NODE_21539_length_635_cov_45.483209	248	298	90	2	50	0.0400000
NODE_21539_length_635_cov_45.483209	248	298	95	1	50	0.0200000
NODE_21539_length_635_cov_45.483209	248	298	97	1	50	0.0200000
NODE_21539_length_635_cov_45.483209	248	298	99	1	50	0.0200000
NODE_21539_length_635_cov_45.483209	248	298	103	1	50	0.0200000
NODE_21539_length_635_cov_45.483209	248	298	111	2	50	0.0400000
NODE_21539_length_635_cov_45.483209	248	298	113	1	50	0.0200000
NODE_21539_length_635_cov_45.483209	248	298	121	3	50	0.0600000
NODE_21539_length_635_cov_45.483209	248	298	122	2	50	0.0400000
NODE_21539_length_635_cov_45.483209	248	298	124	1	50	0.0200000
NODE_21539_length_635_cov_45.483209	248	298	126	1	50	0.0200000
NODE_21539_length_635_cov_45.483209	248	298	132	2	50	0.0400000
NODE_21539_length_635_cov_45.483209	248	298	147	1	50	0.0200000
NODE_21539_length_635_cov_45.483209	248	298	148	1	50	0.0200000
NODE_21539_length_635_cov_45.483209	248	298	150	1	50	0.0200000
NODE_21539_length_635_cov_45.483209	248	298	152	2	50	0.0400000
NODE_21539_length_635_cov_45.483209	248	298	154	1	50	0.0200000
NODE_21539_length_635_cov_45.483209	248	298	156	2	50	0.0400000
NODE_21539_length_635_cov_45.483209	248	298	165	1	50	0.0200000
NODE_21539_length_635_cov_45.483209	248	298	166	1	50	0.0200000
NODE_21539_length_635_cov_45.483209	248	298	167	2	50	0.0400000
NODE_21539_length_635_cov_45.483209	248	298	172	1	50	0.0200000
NODE_21539_length_635_cov_45.483209	248	298	174	1	50	0.0200000
NODE_21539_length_635_cov_45.483209	248	298	179	1	50	0.0200000
NODE_21539_length_635_cov_45.483209	248	298	186	3	50	0.0600000
NODE_21539_length_635_cov_45.483209	248	298	188	1	50	0.0200000
NODE_21539_length_635_cov_45.483209	248	298	190	4	50	0.0800000
NODE_21539_length_635_cov_45.483209	248	298	192	2	50	0.0400000
NODE_21541_length_635_cov_23.895522	179	259	0	16	80	0.2000000
NODE_21541_length_635_cov_23.895522	179	259	5	64	80	0.8000000
NODE_21541_length_635_cov_23.895522	232	312	0	63	80	0.7875000
NODE_21541_length_635_cov_23.895522	232	312	5	17	80	0.2125000
NODE_21543_length_635_cov_14.772388	48	128	0	80	80	1.0000000
NODE_21543_length_635_cov_14.772388	101	181	0	80	80	1.0000000
NODE_21549_length_635_cov_6.180970	276	356	0	80	80	1.0000000
NODE_21549_length_635_cov_6.180970	329	409	0	80	80	1.0000000
NODE_21554_length_635_cov_4.421642	442	522	0	80	80	1.0000000
NODE_21560_length_635_cov_2.985075	296	376	20	5	80	0.0625000
NODE_21560_length_635_cov_2.985075	296	376	22	7	80	0.0875000
NODE_21560_length_635_cov_2.985075	296	376	24	2	80	0.0250000
NODE_21560_length_635_cov_2.985075	296	376	26	54	80	0.6750000
NODE_21560_length_635_cov_2.985075	296	376	28	12	80	0.1500000
NODE_21625_length_634_cov_53.315888	349	429	0	3	80	0.0375000
NODE_21625_length_634_cov_53.315888	349	429	2	20	80	0.2500000
NODE_21625_length_634_cov_53.315888	349	429	4	14	80	0.1750000
NODE_21625_length_634_cov_53.315888	349	429	10	21	80	0.2625000
NODE_21625_length_634_cov_53.315888	349	429	14	22	80	0.2750000
NODE_21625_length_634_cov_53.315888	402	482	0	56	80	0.7000000
NODE_21625_length_634_cov_53.315888	402	482	2	20	80	0.2500000
NODE_21625_length_634_cov_53.315888	402	482	4	4	80	0.0500000
NODE_21626_length_634_cov_28.530841	156	236	0	9	80	0.1125000
NODE_21626_length_634_cov_28.530841	156	236	2	39	80	0.4875000
NODE_21626_length_634_cov_28.530841	156	236	6	32	80	0.4000000
NODE_21626_length_634_cov_28.530841	209	289	4	15	80	0.1875000
NODE_21626_length_634_cov_28.530841	209	289	6	65	80	0.8125000
NODE_21627_length_634_cov_19.117757	151	229	0	15	78	0.1923077
NODE_21627_length_634_cov_19.117757	151	229	2	63	78	0.8076923
NODE_21627_length_634_cov_19.117757	204	268	0	45	64	0.7031250
NODE_21627_length_634_cov_19.117757	204	268	2	19	64	0.2968750
NODE_21628_length_634_cov_18.762617	84	164	0	80	80	1.0000000
NODE_21628_length_634_cov_18.762617	137	217	0	80	80	1.0000000
NODE_21629_length_634_cov_18.136449	162	242	0	55	80	0.6875000
NODE_21629_length_634_cov_18.136449	162	242	4	25	80	0.3125000
NODE_21629_length_634_cov_18.136449	215	295	0	2	80	0.0250000
NODE_21629_length_634_cov_18.136449	215	295	4	78	80	0.9750000
NODE_21635_length_634_cov_9.988785	508	553	0	29	45	0.6444445
NODE_21635_length_634_cov_9.988785	508	553	4	16	45	0.3555556
NODE_21636_length_634_cov_9.381308	267	353	2	18	86	0.2093023
NODE_21636_length_634_cov_9.381308	267	353	6	22	86	0.2558140
NODE_21636_length_634_cov_9.381308	267	353	10	12	86	0.1395349
NODE_21636_length_634_cov_9.381308	267	353	14	34	86	0.3953488
NODE_21636_length_634_cov_9.381308	324	404	8	38	80	0.4750000
NODE_21636_length_634_cov_9.381308	324	404	10	12	80	0.1500000
NODE_21636_length_634_cov_9.381308	324	404	14	30	80	0.3750000
NODE_21651_length_634_cov_3.702804	460	532	0	72	72	1.0000000
NODE_21720_length_633_cov_30.076779	180	214	0	34	34	1.0000000
NODE_21720_length_633_cov_30.076779	187	267	0	80	80	1.0000000
NODE_21720_length_633_cov_30.076779	263	343	0	80	80	1.0000000
NODE_21720_length_633_cov_30.076779	316	396	0	80	80	1.0000000
NODE_21721_length_633_cov_17.595506	282	362	0	6	80	0.0750000
NODE_21721_length_633_cov_17.595506	282	362	2	7	80	0.0875000
NODE_21721_length_633_cov_17.595506	282	362	4	67	80	0.8375000
NODE_21721_length_633_cov_17.595506	335	415	0	20	80	0.2500000
NODE_21721_length_633_cov_17.595506	335	415	2	11	80	0.1375000
NODE_21721_length_633_cov_17.595506	335	415	4	49	80	0.6125000
NODE_21722_length_633_cov_17.327715	228	308	0	38	80	0.4750000
NODE_21722_length_633_cov_17.327715	228	308	2	42	80	0.5250000
NODE_21722_length_633_cov_17.327715	281	361	0	7	80	0.0875000
NODE_21722_length_633_cov_17.327715	281	361	2	73	80	0.9125000
NODE_21723_length_633_cov_9.689139	79	147	18	4	68	0.0588235
NODE_21723_length_633_cov_9.689139	79	147	22	7	68	0.1029412
NODE_21723_length_633_cov_9.689139	79	147	24	16	68	0.2352941
NODE_21723_length_633_cov_9.689139	79	147	26	41	68	0.6029412
NODE_21729_length_633_cov_7.018727	309	389	0	80	80	1.0000000
NODE_21729_length_633_cov_7.018727	362	442	0	80	80	1.0000000
NODE_21755_length_633_cov_2.644195	166	240	0	25	74	0.3378378
NODE_21755_length_633_cov_2.644195	166	240	1	29	74	0.3918919
NODE_21755_length_633_cov_2.644195	166	240	6	20	74	0.2702703
NODE_21816_length_632_cov_25.425891	332	412	0	8	80	0.1000000
NODE_21816_length_632_cov_25.425891	332	412	2	19	80	0.2375000
NODE_21816_length_632_cov_25.425891	332	412	4	28	80	0.3500000
NODE_21816_length_632_cov_25.425891	332	412	6	25	80	0.3125000
NODE_21816_length_632_cov_25.425891	385	465	0	61	80	0.7625000
NODE_21816_length_632_cov_25.425891	385	465	2	19	80	0.2375000
NODE_21817_length_632_cov_21.613508	243	323	0	80	80	1.0000000
NODE_21817_length_632_cov_21.613508	296	376	0	80	80	1.0000000
NODE_21818_length_632_cov_16.465291	293	373	0	80	80	1.0000000
NODE_21818_length_632_cov_16.465291	346	426	0	80	80	1.0000000
NODE_21819_length_632_cov_13.260788	232	312	0	9	80	0.1125000
NODE_21819_length_632_cov_13.260788	232	312	2	59	80	0.7375000
NODE_21819_length_632_cov_13.260788	232	312	4	12	80	0.1500000
NODE_21819_length_632_cov_13.260788	285	365	0	9	80	0.1125000
NODE_21819_length_632_cov_13.260788	285	365	2	6	80	0.0750000
NODE_21819_length_632_cov_13.260788	285	365	4	65	80	0.8125000
NODE_21821_length_632_cov_9.106942	188	268	0	80	80	1.0000000
NODE_21821_length_632_cov_9.106942	241	321	0	80	80	1.0000000
NODE_21834_length_632_cov_4.135084	229	309	0	80	80	1.0000000
NODE_21834_length_632_cov_4.135084	282	359	0	77	77	1.0000000
NODE_21841_length_632_cov_2.939962	216	274	10	6	58	0.1034483
NODE_21841_length_632_cov_2.939962	216	274	12	2	58	0.0344828
NODE_21841_length_632_cov_2.939962	216	274	14	8	58	0.1379310
NODE_21841_length_632_cov_2.939962	216	274	18	42	58	0.7241379
NODE_21841_length_632_cov_2.939962	247	327	14	3	80	0.0375000
NODE_21841_length_632_cov_2.939962	247	327	16	39	80	0.4875000
NODE_21841_length_632_cov_2.939962	247	327	18	38	80	0.4750000
NODE_21848_length_632_cov_2.330206	57	76	0	19	19	1.0000000
NODE_21912_length_631_cov_31.469925	321	396	6	75	75	1.0000000
NODE_21912_length_631_cov_31.469925	369	449	0	36	80	0.4500000
NODE_21912_length_631_cov_31.469925	369	449	6	44	80	0.5500000
NODE_21913_length_631_cov_26.453008	383	463	0	80	80	1.0000000
NODE_21913_length_631_cov_26.453008	436	516	0	80	80	1.0000000
NODE_21917_length_631_cov_8.374060	318	398	2	20	80	0.2500000
NODE_21917_length_631_cov_8.374060	318	398	4	19	80	0.2375000
NODE_21917_length_631_cov_8.374060	318	398	6	41	80	0.5125000
NODE_21917_length_631_cov_8.374060	371	451	4	64	80	0.8000000
NODE_21917_length_631_cov_8.374060	371	451	6	16	80	0.2000000
NODE_21924_length_631_cov_5.507519	335	386	0	2	51	0.0392157
NODE_21924_length_631_cov_5.507519	335	386	4	19	51	0.3725490
NODE_21924_length_631_cov_5.507519	335	386	6	30	51	0.5882353
NODE_21927_length_631_cov_5.227444	443	523	0	54	80	0.6750000
NODE_21927_length_631_cov_5.227444	443	523	2	26	80	0.3250000
NODE_21927_length_631_cov_5.227444	496	576	0	80	80	1.0000000
NODE_21942_length_631_cov_2.926692	307	354	0	12	47	0.2553191
NODE_21942_length_631_cov_2.926692	307	354	2	35	47	0.7446808
NODE_21983_length_631_cov_1.383459	248	267	0	19	19	1.0000000
NODE_22011_length_630_cov_41.728814	6	86	0	80	80	1.0000000
NODE_22011_length_630_cov_41.728814	59	139	0	80	80	1.0000000
NODE_22012_length_630_cov_24.856874	421	501	10	53	80	0.6625000
NODE_22012_length_630_cov_24.856874	421	501	12	24	80	0.3000000
NODE_22012_length_630_cov_24.856874	421	501	14	3	80	0.0375000
NODE_22012_length_630_cov_24.856874	474	554	4	8	80	0.1000000
NODE_22012_length_630_cov_24.856874	474	554	6	33	80	0.4125000
NODE_22012_length_630_cov_24.856874	474	554	9	1	80	0.0125000
NODE_22012_length_630_cov_24.856874	474	554	10	14	80	0.1750000
NODE_22012_length_630_cov_24.856874	474	554	12	21	80	0.2625000
NODE_22012_length_630_cov_24.856874	474	554	14	3	80	0.0375000
NODE_22013_length_630_cov_14.323917	196	276	0	80	80	1.0000000
NODE_22013_length_630_cov_14.323917	249	329	0	80	80	1.0000000
NODE_22014_length_630_cov_9.964218	284	364	0	80	80	1.0000000
NODE_22014_length_630_cov_9.964218	337	417	0	48	80	0.6000000
NODE_22014_length_630_cov_9.964218	337	417	2	32	80	0.4000000
NODE_22086_length_629_cov_38.271698	288	368	2	80	80	1.0000000
NODE_22086_length_629_cov_38.271698	341	421	0	41	80	0.5125000
NODE_22086_length_629_cov_38.271698	341	421	2	39	80	0.4875000
NODE_22087_length_629_cov_27.556604	212	292	0	80	80	1.0000000
NODE_22087_length_629_cov_27.556604	265	345	0	80	80	1.0000000
NODE_22088_length_629_cov_24.150943	356	436	0	80	80	1.0000000
NODE_22088_length_629_cov_24.150943	409	489	0	80	80	1.0000000
NODE_22091_length_629_cov_13.641509	176	256	0	80	80	1.0000000
NODE_22091_length_629_cov_13.641509	229	309	0	80	80	1.0000000
NODE_22101_length_629_cov_4.264151	362	442	2	9	80	0.1125000
NODE_22101_length_629_cov_4.264151	362	442	4	28	80	0.3500000
NODE_22101_length_629_cov_4.264151	362	442	5	17	80	0.2125000
NODE_22101_length_629_cov_4.264151	362	442	6	26	80	0.3250000
NODE_22188_length_628_cov_5.015123	210	274	0	41	64	0.6406250
NODE_22188_length_628_cov_5.015123	210	274	4	23	64	0.3593750
NODE_22257_length_627_cov_24.500000	217	297	0	3	80	0.0375000
NODE_22257_length_627_cov_24.500000	217	297	2	77	80	0.9625000
NODE_22257_length_627_cov_24.500000	270	350	0	56	80	0.7000000
NODE_22257_length_627_cov_24.500000	270	350	2	24	80	0.3000000
NODE_22258_length_627_cov_20.395833	84	164	0	29	80	0.3625000
NODE_22258_length_627_cov_20.395833	84	164	4	14	80	0.1750000
NODE_22258_length_627_cov_20.395833	84	164	6	37	80	0.4625000
NODE_22258_length_627_cov_20.395833	137	217	6	32	80	0.4000000
NODE_22258_length_627_cov_20.395833	137	217	9	44	80	0.5500000
NODE_22258_length_627_cov_20.395833	137	217	10	4	80	0.0500000
NODE_22259_length_627_cov_19.676136	308	388	4	28	80	0.3500000
NODE_22259_length_627_cov_19.676136	308	388	6	52	80	0.6500000
NODE_22259_length_627_cov_19.676136	361	441	0	47	80	0.5875000
NODE_22259_length_627_cov_19.676136	361	441	4	21	80	0.2625000
NODE_22259_length_627_cov_19.676136	361	441	6	12	80	0.1500000
NODE_22260_length_627_cov_17.634470	264	296	0	32	32	1.0000000
NODE_22260_length_627_cov_17.634470	360	385	0	25	25	1.0000000
NODE_22260_length_627_cov_17.634470	365	385	0	20	20	1.0000000
NODE_22260_length_627_cov_17.634470	385	424	2	39	39	1.0000000
NODE_22267_length_627_cov_5.634470	298	346	1	5	48	0.1041667
NODE_22267_length_627_cov_5.634470	298	346	2	43	48	0.8958333
NODE_22274_length_627_cov_4.517045	323	403	0	60	80	0.7500000
NODE_22274_length_627_cov_4.517045	323	403	2	20	80	0.2500000
NODE_22274_length_627_cov_4.517045	376	456	0	80	80	1.0000000
NODE_22357_length_626_cov_24.184061	140	220	2	10	80	0.1250000
NODE_22357_length_626_cov_24.184061	140	220	6	23	80	0.2875000
NODE_22357_length_626_cov_24.184061	140	220	8	34	80	0.4250000
NODE_22357_length_626_cov_24.184061	140	220	10	13	80	0.1625000
NODE_22357_length_626_cov_24.184061	193	273	6	23	80	0.2875000
NODE_22357_length_626_cov_24.184061	193	273	8	16	80	0.2000000
NODE_22357_length_626_cov_24.184061	193	273	10	41	80	0.5125000
NODE_22358_length_626_cov_21.189753	342	419	32	3	77	0.0389610
NODE_22358_length_626_cov_21.189753	342	419	33	3	77	0.0389610
NODE_22358_length_626_cov_21.189753	342	419	37	2	77	0.0259740
NODE_22358_length_626_cov_21.189753	342	419	38	3	77	0.0389610
NODE_22358_length_626_cov_21.189753	342	419	40	8	77	0.1038961
NODE_22358_length_626_cov_21.189753	342	419	41	9	77	0.1168831
NODE_22358_length_626_cov_21.189753	342	419	42	3	77	0.0389610
NODE_22358_length_626_cov_21.189753	342	419	43	11	77	0.1428571
NODE_22358_length_626_cov_21.189753	342	419	45	28	77	0.3636364
NODE_22358_length_626_cov_21.189753	342	419	48	2	77	0.0259740
NODE_22358_length_626_cov_21.189753	342	419	49	5	77	0.0649351
NODE_22358_length_626_cov_21.189753	342	419	32	3	77	0.0389610
NODE_22358_length_626_cov_21.189753	342	419	33	3	77	0.0389610
NODE_22358_length_626_cov_21.189753	342	419	37	2	77	0.0259740
NODE_22358_length_626_cov_21.189753	342	419	38	3	77	0.0389610
NODE_22358_length_626_cov_21.189753	342	419	40	8	77	0.1038961
NODE_22358_length_626_cov_21.189753	342	419	41	9	77	0.1168831
NODE_22358_length_626_cov_21.189753	342	419	42	3	77	0.0389610
NODE_22358_length_626_cov_21.189753	342	419	43	11	77	0.1428571
NODE_22358_length_626_cov_21.189753	342	419	45	28	77	0.3636364
NODE_22358_length_626_cov_21.189753	342	419	48	2	77	0.0259740
NODE_22358_length_626_cov_21.189753	342	419	49	5	77	0.0649351
NODE_22358_length_626_cov_21.189753	392	453	15	19	61	0.3114754
NODE_22358_length_626_cov_21.189753	392	453	18	1	61	0.0163934
NODE_22358_length_626_cov_21.189753	392	453	19	3	61	0.0491803
NODE_22358_length_626_cov_21.189753	392	453	25	2	61	0.0327869
NODE_22358_length_626_cov_21.189753	392	453	31	5	61	0.0819672
NODE_22358_length_626_cov_21.189753	392	453	32	4	61	0.0655738
NODE_22358_length_626_cov_21.189753	392	453	33	6	61	0.0983607
NODE_22358_length_626_cov_21.189753	392	453	37	2	61	0.0327869
NODE_22358_length_626_cov_21.189753	392	453	38	3	61	0.0491803
NODE_22358_length_626_cov_21.189753	392	453	40	8	61	0.1311475
NODE_22358_length_626_cov_21.189753	392	453	43	8	61	0.1311475
NODE_22364_length_626_cov_7.100569	236	311	0	75	75	1.0000000
NODE_22364_length_626_cov_7.100569	284	364	0	33	80	0.4125000
NODE_22364_length_626_cov_7.100569	284	364	1	47	80	0.5875000
NODE_22366_length_626_cov_6.296015	193	273	0	80	80	1.0000000
NODE_22366_length_626_cov_6.296015	246	326	0	80	80	1.0000000
NODE_22367_length_626_cov_6.163188	257	337	0	80	80	1.0000000
NODE_22367_length_626_cov_6.163188	310	390	0	80	80	1.0000000
NODE_22438_length_625_cov_33.100760	239	319	0	80	80	1.0000000
NODE_22438_length_625_cov_33.100760	292	372	0	80	80	1.0000000
NODE_22438_length_625_cov_33.100760	368	448	0	66	80	0.8250000
NODE_22438_length_625_cov_33.100760	368	448	2	14	80	0.1750000
NODE_22438_length_625_cov_33.100760	421	501	0	13	80	0.1625000
NODE_22438_length_625_cov_33.100760	421	501	2	67	80	0.8375000
NODE_22439_length_625_cov_21.062738	267	347	2	55	80	0.6875000
NODE_22439_length_625_cov_21.062738	267	347	4	2	80	0.0250000
NODE_22439_length_625_cov_21.062738	267	347	5	1	80	0.0125000
NODE_22439_length_625_cov_21.062738	267	347	6	22	80	0.2750000
NODE_22439_length_625_cov_21.062738	320	400	2	2	80	0.0250000
NODE_22439_length_625_cov_21.062738	320	400	4	45	80	0.5625000
NODE_22439_length_625_cov_21.062738	320	400	5	1	80	0.0125000
NODE_22439_length_625_cov_21.062738	320	400	6	32	80	0.4000000
NODE_22440_length_625_cov_14.237643	28	108	0	12	80	0.1500000
NODE_22440_length_625_cov_14.237643	28	108	6	68	80	0.8500000
NODE_22440_length_625_cov_14.237643	81	161	6	80	80	1.0000000
NODE_22441_length_625_cov_14.207224	358	438	0	22	80	0.2750000
NODE_22441_length_625_cov_14.207224	358	438	2	58	80	0.7250000
NODE_22441_length_625_cov_14.207224	411	491	0	34	80	0.4250000
NODE_22441_length_625_cov_14.207224	411	491	2	46	80	0.5750000
NODE_22455_length_625_cov_4.157795	548	600	0	52	52	1.0000000
NODE_22466_length_625_cov_2.929658	118	198	0	80	80	1.0000000
NODE_22466_length_625_cov_2.929658	171	251	0	80	80	1.0000000
NODE_22491_length_625_cov_1.570342	471	502	0	31	31	1.0000000
NODE_22542_length_624_cov_9.598095	77	126	0	49	49	1.0000000
NODE_22542_length_624_cov_9.598095	103	183	0	80	80	1.0000000
NODE_22544_length_624_cov_8.485714	271	351	3	3	80	0.0375000
NODE_22544_length_624_cov_8.485714	271	351	6	58	80	0.7250000
NODE_22544_length_624_cov_8.485714	271	351	8	19	80	0.2375000
NODE_22544_length_624_cov_8.485714	324	404	6	8	80	0.1000000
NODE_22544_length_624_cov_8.485714	324	404	8	72	80	0.9000000
NODE_22546_length_624_cov_6.691429	386	466	0	6	80	0.0750000
NODE_22546_length_624_cov_6.691429	386	466	4	74	80	0.9250000
NODE_22546_length_624_cov_6.691429	439	519	0	59	80	0.7375000
NODE_22546_length_624_cov_6.691429	439	519	4	21	80	0.2625000
NODE_22547_length_624_cov_5.592381	312	387	4	2	75	0.0266667
NODE_22547_length_624_cov_5.592381	312	387	6	41	75	0.5466667
NODE_22547_length_624_cov_5.592381	312	387	12	32	75	0.4266667
NODE_22551_length_624_cov_4.638095	328	388	6	21	60	0.3500000
NODE_22551_length_624_cov_4.638095	328	388	8	39	60	0.6500000
NODE_22642_length_623_cov_41.877863	419	499	0	5	80	0.0625000
NODE_22642_length_623_cov_41.877863	419	499	5	1	80	0.0125000
NODE_22642_length_623_cov_41.877863	419	499	6	74	80	0.9250000
NODE_22642_length_623_cov_41.877863	472	552	0	58	80	0.7250000
NODE_22642_length_623_cov_41.877863	472	552	5	1	80	0.0125000
NODE_22642_length_623_cov_41.877863	472	552	6	21	80	0.2625000
NODE_22643_length_623_cov_31.875954	148	228	12	4	80	0.0500000
NODE_22643_length_623_cov_31.875954	148	228	14	3	80	0.0375000
NODE_22643_length_623_cov_31.875954	148	228	16	4	80	0.0500000
NODE_22643_length_623_cov_31.875954	148	228	18	62	80	0.7750000
NODE_22643_length_623_cov_31.875954	148	228	20	7	80	0.0875000
NODE_22643_length_623_cov_31.875954	201	281	0	5	80	0.0625000
NODE_22643_length_623_cov_31.875954	201	281	8	4	80	0.0500000
NODE_22643_length_623_cov_31.875954	201	281	10	43	80	0.5375000
NODE_22643_length_623_cov_31.875954	201	281	12	5	80	0.0625000
NODE_22643_length_623_cov_31.875954	201	281	18	16	80	0.2000000
NODE_22643_length_623_cov_31.875954	201	281	20	7	80	0.0875000
NODE_22644_length_623_cov_31.192748	313	393	0	19	80	0.2375000
NODE_22644_length_623_cov_31.192748	313	393	2	61	80	0.7625000
NODE_22644_length_623_cov_31.192748	366	446	0	72	80	0.9000000
NODE_22644_length_623_cov_31.192748	366	446	2	8	80	0.1000000
NODE_22645_length_623_cov_20.187023	287	367	0	80	80	1.0000000
NODE_22645_length_623_cov_20.187023	340	420	0	80	80	1.0000000
NODE_22646_length_623_cov_12.045802	377	457	0	80	80	1.0000000
NODE_22646_length_623_cov_12.045802	430	510	0	80	80	1.0000000
NODE_22668_length_623_cov_2.891221	457	535	0	78	78	1.0000000
NODE_22725_length_622_cov_19.042065	368	448	8	30	80	0.3750000
NODE_22725_length_622_cov_19.042065	368	448	10	12	80	0.1500000
NODE_22725_length_622_cov_19.042065	368	448	12	10	80	0.1250000
NODE_22725_length_622_cov_19.042065	368	448	15	21	80	0.2625000
NODE_22725_length_622_cov_19.042065	368	448	16	4	80	0.0500000
NODE_22725_length_622_cov_19.042065	368	448	18	3	80	0.0375000
NODE_22725_length_622_cov_19.042065	421	501	6	10	80	0.1250000
NODE_22725_length_622_cov_19.042065	421	501	8	18	80	0.2250000
NODE_22725_length_622_cov_19.042065	421	501	12	1	80	0.0125000
NODE_22725_length_622_cov_19.042065	421	501	13	7	80	0.0875000
NODE_22725_length_622_cov_19.042065	421	501	15	38	80	0.4750000
NODE_22725_length_622_cov_19.042065	421	501	16	4	80	0.0500000
NODE_22725_length_622_cov_19.042065	421	501	18	2	80	0.0250000
NODE_22726_length_622_cov_13.470363	109	189	0	9	80	0.1125000
NODE_22726_length_622_cov_13.470363	109	189	5	1	80	0.0125000
NODE_22726_length_622_cov_13.470363	109	189	6	70	80	0.8750000
NODE_22726_length_622_cov_13.470363	162	242	6	80	80	1.0000000
NODE_22752_length_622_cov_2.407266	94	170	0	76	76	1.0000000
NODE_22796_length_622_cov_1.353728	346	376	3	13	30	0.4333333
NODE_22796_length_622_cov_1.353728	346	376	4	17	30	0.5666667
NODE_22819_length_621_cov_46.247126	0	52	0	52	52	1.0000000
NODE_22819_length_621_cov_46.247126	25	105	0	67	80	0.8375000
NODE_22819_length_621_cov_46.247126	25	105	4	13	80	0.1625000
NODE_22819_length_621_cov_46.247126	101	181	4	63	80	0.7875000
NODE_22819_length_621_cov_46.247126	101	181	6	17	80	0.2125000
NODE_22819_length_621_cov_46.247126	154	234	2	21	80	0.2625000
NODE_22819_length_621_cov_46.247126	154	234	4	10	80	0.1250000
NODE_22819_length_621_cov_46.247126	154	234	6	49	80	0.6125000
NODE_22820_length_621_cov_45.764368	344	424	0	4	80	0.0500000
NODE_22820_length_621_cov_45.764368	344	424	2	76	80	0.9500000
NODE_22820_length_621_cov_45.764368	397	477	0	27	80	0.3375000
NODE_22820_length_621_cov_45.764368	397	477	2	53	80	0.6625000
NODE_22821_length_621_cov_35.147510	393	473	0	19	80	0.2375000
NODE_22821_length_621_cov_35.147510	393	473	2	61	80	0.7625000
NODE_22821_length_621_cov_35.147510	446	526	0	62	80	0.7750000
NODE_22821_length_621_cov_35.147510	446	526	2	18	80	0.2250000
NODE_22822_length_621_cov_13.842912	231	311	0	2	80	0.0250000
NODE_22822_length_621_cov_13.842912	231	311	2	78	80	0.9750000
NODE_22822_length_621_cov_13.842912	284	364	0	46	80	0.5750000
NODE_22822_length_621_cov_13.842912	284	364	2	34	80	0.4250000
NODE_22825_length_621_cov_6.279693	376	406	0	30	30	1.0000000
NODE_22845_length_621_cov_2.645594	367	426	0	59	59	1.0000000
NODE_22914_length_620_cov_23.913628	433	513	0	38	80	0.4750000
NODE_22914_length_620_cov_23.913628	433	513	2	42	80	0.5250000
NODE_22914_length_620_cov_23.913628	486	566	0	80	80	1.0000000
NODE_22915_length_620_cov_9.222649	186	266	0	25	80	0.3125000
NODE_22915_length_620_cov_9.222649	186	266	4	55	80	0.6875000
NODE_22915_length_620_cov_9.222649	239	319	0	78	80	0.9750000
NODE_22915_length_620_cov_9.222649	239	319	4	2	80	0.0250000
NODE_22919_length_620_cov_7.804223	57	137	0	24	80	0.3000000
NODE_22919_length_620_cov_7.804223	57	137	2	56	80	0.7000000
NODE_22919_length_620_cov_7.804223	110	190	0	11	80	0.1375000
NODE_22919_length_620_cov_7.804223	110	190	2	58	80	0.7250000
NODE_22919_length_620_cov_7.804223	110	190	4	11	80	0.1375000
NODE_22920_length_620_cov_6.909789	199	279	0	80	80	1.0000000
NODE_22920_length_620_cov_6.909789	252	332	0	80	80	1.0000000
NODE_22930_length_620_cov_4.560461	309	347	22	22	38	0.5789474
NODE_22930_length_620_cov_4.560461	309	347	24	16	38	0.4210526
NODE_22930_length_620_cov_4.560461	395	421	2	21	26	0.8076923
NODE_22930_length_620_cov_4.560461	395	421	4	5	26	0.1923077
NODE_22930_length_620_cov_4.560461	395	451	2	32	56	0.5714286
NODE_22930_length_620_cov_4.560461	395	451	4	6	56	0.1071429
NODE_22930_length_620_cov_4.560461	395	451	6	3	56	0.0535714
NODE_22930_length_620_cov_4.560461	395	451	8	15	56	0.2678571
NODE_23031_length_619_cov_26.309615	118	198	0	25	80	0.3125000
NODE_23031_length_619_cov_26.309615	118	198	2	55	80	0.6875000
NODE_23031_length_619_cov_26.309615	171	251	0	5	80	0.0625000
NODE_23031_length_619_cov_26.309615	171	251	1	1	80	0.0125000
NODE_23031_length_619_cov_26.309615	171	251	2	74	80	0.9250000
NODE_23033_length_619_cov_10.417308	427	487	4	60	60	1.0000000
NODE_23034_length_619_cov_7.944231	213	293	0	80	80	1.0000000
NODE_23034_length_619_cov_7.944231	266	346	0	80	80	1.0000000
NODE_23135_length_618_cov_14.477842	223	299	2	32	76	0.4210526
NODE_23135_length_618_cov_14.477842	223	299	6	6	76	0.0789474
NODE_23135_length_618_cov_14.477842	223	299	8	31	76	0.4078947
NODE_23135_length_618_cov_14.477842	223	299	10	5	76	0.0657895
NODE_23135_length_618_cov_14.477842	223	299	14	2	76	0.0263158
NODE_23135_length_618_cov_14.477842	223	299	2	32	76	0.4210526
NODE_23135_length_618_cov_14.477842	223	299	6	6	76	0.0789474
NODE_23135_length_618_cov_14.477842	223	299	8	31	76	0.4078947
NODE_23135_length_618_cov_14.477842	223	299	10	5	76	0.0657895
NODE_23135_length_618_cov_14.477842	223	299	14	2	76	0.0263158
NODE_23135_length_618_cov_14.477842	276	337	8	16	61	0.2622951
NODE_23135_length_618_cov_14.477842	276	337	10	5	61	0.0819672
NODE_23135_length_618_cov_14.477842	276	337	14	19	61	0.3114754
NODE_23135_length_618_cov_14.477842	276	337	16	21	61	0.3442623
NODE_23136_length_618_cov_13.840077	377	457	0	80	80	1.0000000
NODE_23136_length_618_cov_13.840077	430	510	0	80	80	1.0000000
NODE_23137_length_618_cov_12.048170	348	428	2	57	80	0.7125000
NODE_23137_length_618_cov_12.048170	348	428	4	23	80	0.2875000
NODE_23137_length_618_cov_12.048170	401	481	0	26	80	0.3250000
NODE_23137_length_618_cov_12.048170	401	481	1	11	80	0.1375000
NODE_23137_length_618_cov_12.048170	401	481	2	43	80	0.5375000
NODE_23138_length_618_cov_8.799615	353	433	2	1	80	0.0125000
NODE_23138_length_618_cov_8.799615	353	433	4	79	80	0.9875000
NODE_23138_length_618_cov_8.799615	406	486	0	44	80	0.5500000
NODE_23138_length_618_cov_8.799615	406	486	2	10	80	0.1250000
NODE_23138_length_618_cov_8.799615	406	486	4	26	80	0.3250000
NODE_23147_length_618_cov_3.793834	412	478	0	66	66	1.0000000
NODE_23148_length_618_cov_3.761079	305	385	0	80	80	1.0000000
NODE_23252_length_617_cov_29.565637	378	458	0	19	80	0.2375000
NODE_23252_length_617_cov_29.565637	378	458	2	61	80	0.7625000
NODE_23252_length_617_cov_29.565637	431	511	0	34	80	0.4250000
NODE_23252_length_617_cov_29.565637	431	511	2	46	80	0.5750000
NODE_23253_length_617_cov_16.781853	253	333	0	71	80	0.8875000
NODE_23253_length_617_cov_16.781853	253	333	2	9	80	0.1125000
NODE_23253_length_617_cov_16.781853	306	386	0	22	80	0.2750000
NODE_23253_length_617_cov_16.781853	306	386	2	58	80	0.7250000
NODE_23254_length_617_cov_9.175676	373	453	0	24	80	0.3000000
NODE_23254_length_617_cov_9.175676	373	453	2	56	80	0.7000000
NODE_23254_length_617_cov_9.175676	426	506	0	13	80	0.1625000
NODE_23254_length_617_cov_9.175676	426	506	2	67	80	0.8375000
NODE_23255_length_617_cov_8.774131	320	406	0	50	86	0.5813953
NODE_23255_length_617_cov_8.774131	320	406	4	19	86	0.2209302
NODE_23255_length_617_cov_8.774131	320	406	6	17	86	0.1976744
NODE_23255_length_617_cov_8.774131	379	458	4	10	79	0.1265823
NODE_23255_length_617_cov_8.774131	379	458	6	69	79	0.8734177
NODE_23257_length_617_cov_8.416988	359	439	0	80	80	1.0000000
NODE_23257_length_617_cov_8.416988	412	492	0	32	80	0.4000000
NODE_23257_length_617_cov_8.416988	412	492	2	48	80	0.6000000
NODE_23259_length_617_cov_7.683398	197	275	1	17	78	0.2179487
NODE_23259_length_617_cov_7.683398	197	275	2	48	78	0.6153846
NODE_23259_length_617_cov_7.683398	197	275	5	1	78	0.0128205
NODE_23259_length_617_cov_7.683398	197	275	8	12	78	0.1538462
NODE_23259_length_617_cov_7.683398	250	330	2	12	80	0.1500000
NODE_23259_length_617_cov_7.683398	250	330	5	1	80	0.0125000
NODE_23259_length_617_cov_7.683398	250	330	7	3	80	0.0375000
NODE_23259_length_617_cov_7.683398	250	330	8	64	80	0.8000000
NODE_23263_length_617_cov_5.330116	288	360	6	54	72	0.7500000
NODE_23263_length_617_cov_5.330116	288	360	12	18	72	0.2500000
NODE_23263_length_617_cov_5.330116	333	413	5	29	80	0.3625000
NODE_23263_length_617_cov_5.330116	333	413	6	16	80	0.2000000
NODE_23263_length_617_cov_5.330116	333	413	8	15	80	0.1875000
NODE_23263_length_617_cov_5.330116	333	413	12	20	80	0.2500000
NODE_23302_length_617_cov_1.967181	384	430	0	46	46	1.0000000
NODE_23311_length_617_cov_1.847490	273	344	2	3	71	0.0422535
NODE_23311_length_617_cov_1.847490	273	344	4	5	71	0.0704225
NODE_23311_length_617_cov_1.847490	273	344	6	31	71	0.4366197
NODE_23311_length_617_cov_1.847490	273	344	8	32	71	0.4507042
NODE_23331_length_617_cov_1.322394	269	318	35	10	49	0.2040816
NODE_23331_length_617_cov_1.322394	269	318	37	3	49	0.0612245
NODE_23331_length_617_cov_1.322394	269	318	39	7	49	0.1428571
NODE_23331_length_617_cov_1.322394	269	318	41	4	49	0.0816327
NODE_23331_length_617_cov_1.322394	269	318	45	5	49	0.1020408
NODE_23331_length_617_cov_1.322394	269	318	46	1	49	0.0204082
NODE_23331_length_617_cov_1.322394	269	318	48	4	49	0.0816327
NODE_23331_length_617_cov_1.322394	269	318	49	2	49	0.0408163
NODE_23331_length_617_cov_1.322394	269	318	51	3	49	0.0612245
NODE_23331_length_617_cov_1.322394	269	318	52	7	49	0.1428571
NODE_23331_length_617_cov_1.322394	269	318	53	2	49	0.0408163
NODE_23331_length_617_cov_1.322394	269	318	54	1	49	0.0204082
NODE_23365_length_616_cov_15.914894	292	370	0	78	78	1.0000000
NODE_23365_length_616_cov_15.914894	343	423	0	80	80	1.0000000
NODE_23366_length_616_cov_14.276596	191	271	0	80	80	1.0000000
NODE_23366_length_616_cov_14.276596	244	319	0	75	75	1.0000000
NODE_23366_length_616_cov_14.276596	368	448	0	8	80	0.1000000
NODE_23366_length_616_cov_14.276596	368	448	6	72	80	0.9000000
NODE_23367_length_616_cov_12.119923	273	353	0	80	80	1.0000000
NODE_23367_length_616_cov_12.119923	326	406	0	80	80	1.0000000
NODE_23373_length_616_cov_6.379110	305	385	0	80	80	1.0000000
NODE_23373_length_616_cov_6.379110	358	438	0	80	80	1.0000000
NODE_23381_length_616_cov_4.441006	286	350	0	64	64	1.0000000
NODE_23381_length_616_cov_4.441006	286	306	0	20	20	1.0000000
NODE_23400_length_616_cov_2.541586	375	415	0	40	40	1.0000000
NODE_23430_length_616_cov_1.491296	105	183	0	19	78	0.2435897
NODE_23430_length_616_cov_1.491296	105	183	2	59	78	0.7564102
NODE_23474_length_615_cov_27.519380	302	382	0	80	80	1.0000000
NODE_23474_length_615_cov_27.519380	355	435	0	80	80	1.0000000
NODE_23475_length_615_cov_17.792636	239	319	0	80	80	1.0000000
NODE_23475_length_615_cov_17.792636	292	372	0	80	80	1.0000000
NODE_23477_length_615_cov_11.835271	240	320	0	71	80	0.8875000
NODE_23477_length_615_cov_11.835271	240	320	2	9	80	0.1125000
NODE_23477_length_615_cov_11.835271	293	373	0	80	80	1.0000000
NODE_23478_length_615_cov_8.591085	287	367	0	80	80	1.0000000
NODE_23478_length_615_cov_8.591085	340	420	0	80	80	1.0000000
NODE_23513_length_615_cov_2.461240	429	509	0	80	80	1.0000000
NODE_23513_length_615_cov_2.461240	482	562	0	80	80	1.0000000
NODE_23516_length_615_cov_2.379845	405	467	2	3	62	0.0483871
NODE_23516_length_615_cov_2.379845	405	467	4	2	62	0.0322581
NODE_23516_length_615_cov_2.379845	405	467	6	57	62	0.9193549
NODE_23516_length_615_cov_2.379845	440	520	4	26	80	0.3250000
NODE_23516_length_615_cov_2.379845	440	520	6	54	80	0.6750000
NODE_23517_length_615_cov_2.294574	205	268	0	63	63	1.0000000
NODE_23554_length_615_cov_1.122093	255	335	0	28	80	0.3500000
NODE_23554_length_615_cov_1.122093	255	335	2	52	80	0.6500000
NODE_23566_length_615_cov_0.887597	561	582	4	21	21	1.0000000
NODE_23575_length_614_cov_17.772816	257	337	0	58	80	0.7250000
NODE_23575_length_614_cov_17.772816	257	337	2	22	80	0.2750000
NODE_23575_length_614_cov_17.772816	310	390	0	21	80	0.2625000
NODE_23575_length_614_cov_17.772816	310	390	2	59	80	0.7375000
NODE_23576_length_614_cov_10.706796	425	505	2	51	80	0.6375000
NODE_23576_length_614_cov_10.706796	425	505	4	29	80	0.3625000
NODE_23576_length_614_cov_10.706796	478	558	0	37	80	0.4625000
NODE_23576_length_614_cov_10.706796	478	558	2	43	80	0.5375000
NODE_23578_length_614_cov_8.545631	193	273	2	17	80	0.2125000
NODE_23578_length_614_cov_8.545631	193	273	4	40	80	0.5000000
NODE_23578_length_614_cov_8.545631	193	273	14	6	80	0.0750000
NODE_23578_length_614_cov_8.545631	193	273	16	2	80	0.0250000
NODE_23578_length_614_cov_8.545631	193	273	18	4	80	0.0500000
NODE_23578_length_614_cov_8.545631	193	273	20	11	80	0.1375000
NODE_23578_length_614_cov_8.545631	246	326	4	44	80	0.5500000
NODE_23578_length_614_cov_8.545631	246	326	8	5	80	0.0625000
NODE_23578_length_614_cov_8.545631	246	326	10	30	80	0.3750000
NODE_23578_length_614_cov_8.545631	246	326	12	1	80	0.0125000
NODE_23604_length_614_cov_2.450485	315	393	0	78	78	1.0000000
NODE_23604_length_614_cov_2.450485	355	383	0	28	28	1.0000000
NODE_23604_length_614_cov_2.450485	368	448	0	80	80	1.0000000
NODE_23604_length_614_cov_2.450485	379	448	0	69	69	1.0000000
NODE_23662_length_613_cov_18.075875	211	291	0	31	80	0.3875000
NODE_23662_length_613_cov_18.075875	211	291	2	49	80	0.6125000
NODE_23662_length_613_cov_18.075875	264	344	0	53	80	0.6625000
NODE_23662_length_613_cov_18.075875	264	344	2	27	80	0.3375000
NODE_23663_length_613_cov_16.118677	283	363	0	21	80	0.2625000
NODE_23663_length_613_cov_16.118677	283	363	6	14	80	0.1750000
NODE_23663_length_613_cov_16.118677	283	363	8	7	80	0.0875000
NODE_23663_length_613_cov_16.118677	283	363	10	27	80	0.3375000
NODE_23663_length_613_cov_16.118677	283	363	14	11	80	0.1375000
NODE_23663_length_613_cov_16.118677	336	416	0	74	80	0.9250000
NODE_23663_length_613_cov_16.118677	336	416	6	6	80	0.0750000
NODE_23665_length_613_cov_12.883268	155	235	0	49	80	0.6125000
NODE_23665_length_613_cov_12.883268	155	235	2	31	80	0.3875000
NODE_23665_length_613_cov_12.883268	208	288	0	13	80	0.1625000
NODE_23665_length_613_cov_12.883268	208	288	2	67	80	0.8375000
NODE_23674_length_613_cov_3.857977	167	247	0	80	80	1.0000000
NODE_23674_length_613_cov_3.857977	220	300	0	80	80	1.0000000
NODE_23771_length_612_cov_24.023392	173	253	0	80	80	1.0000000
NODE_23771_length_612_cov_24.023392	226	306	0	80	80	1.0000000
NODE_23772_length_612_cov_23.846004	141	221	0	2	80	0.0250000
NODE_23772_length_612_cov_23.846004	141	221	2	21	80	0.2625000
NODE_23772_length_612_cov_23.846004	141	221	6	57	80	0.7125000
NODE_23772_length_612_cov_23.846004	194	274	0	44	80	0.5500000
NODE_23772_length_612_cov_23.846004	194	274	2	32	80	0.4000000
NODE_23772_length_612_cov_23.846004	194	274	6	4	80	0.0500000
NODE_23773_length_612_cov_12.448343	244	324	0	80	80	1.0000000
NODE_23773_length_612_cov_12.448343	297	377	0	80	80	1.0000000
NODE_23774_length_612_cov_12.068226	267	347	0	7	80	0.0875000
NODE_23774_length_612_cov_12.068226	267	347	7	21	80	0.2625000
NODE_23774_length_612_cov_12.068226	267	347	9	28	80	0.3500000
NODE_23774_length_612_cov_12.068226	267	347	10	24	80	0.3000000
NODE_23774_length_612_cov_12.068226	320	400	0	60	80	0.7500000
NODE_23774_length_612_cov_12.068226	320	400	7	20	80	0.2500000
NODE_23779_length_612_cov_6.393762	242	322	0	80	80	1.0000000
NODE_23779_length_612_cov_6.393762	295	375	0	80	80	1.0000000
NODE_23814_length_612_cov_1.904483	288	354	0	66	66	1.0000000
NODE_23869_length_611_cov_38.705078	132	212	4	51	80	0.6375000
NODE_23869_length_611_cov_38.705078	132	212	8	29	80	0.3625000
NODE_23869_length_611_cov_38.705078	185	262	8	77	77	1.0000000
NODE_23869_length_611_cov_38.705078	185	262	8	77	77	1.0000000
NODE_23871_length_611_cov_12.669922	264	344	0	63	80	0.7875000
NODE_23871_length_611_cov_12.669922	264	344	2	17	80	0.2125000
NODE_23871_length_611_cov_12.669922	317	397	0	10	80	0.1250000
NODE_23871_length_611_cov_12.669922	317	397	2	70	80	0.8750000
NODE_23880_length_611_cov_4.943359	27	107	0	24	80	0.3000000
NODE_23880_length_611_cov_4.943359	27	107	6	56	80	0.7000000
NODE_23880_length_611_cov_4.943359	80	137	5	12	57	0.2105263
NODE_23880_length_611_cov_4.943359	80	137	6	45	57	0.7894737
NODE_23880_length_611_cov_4.943359	143	209	2	28	66	0.4242424
NODE_23880_length_611_cov_4.943359	143	209	4	5	66	0.0757576
NODE_23880_length_611_cov_4.943359	143	209	6	13	66	0.1969697
NODE_23880_length_611_cov_4.943359	143	209	8	20	66	0.3030303
NODE_23880_length_611_cov_4.943359	182	262	2	4	80	0.0500000
NODE_23880_length_611_cov_4.943359	182	262	4	9	80	0.1125000
NODE_23880_length_611_cov_4.943359	182	262	6	9	80	0.1125000
NODE_23880_length_611_cov_4.943359	182	262	8	58	80	0.7250000
NODE_23894_length_611_cov_3.294922	271	300	4	15	29	0.5172414
NODE_23894_length_611_cov_3.294922	271	300	8	14	29	0.4827586
NODE_23894_length_611_cov_3.294922	434	469	4	6	35	0.1714286
NODE_23894_length_611_cov_3.294922	434	469	6	29	35	0.8285714
NODE_23897_length_611_cov_3.162109	313	342	2	19	29	0.6551724
NODE_23897_length_611_cov_3.162109	313	342	4	10	29	0.3448276
NODE_23973_length_610_cov_20.673190	87	167	0	17	80	0.2125000
NODE_23973_length_610_cov_20.673190	87	167	2	28	80	0.3500000
NODE_23973_length_610_cov_20.673190	87	167	4	35	80	0.4375000
NODE_23973_length_610_cov_20.673190	140	220	2	80	80	1.0000000
NODE_23974_length_610_cov_10.191781	250	330	6	80	80	1.0000000
NODE_23974_length_610_cov_10.191781	303	383	0	49	80	0.6125000
NODE_23974_length_610_cov_10.191781	303	383	6	31	80	0.3875000
NODE_23980_length_610_cov_4.998043	129	181	0	52	52	1.0000000
NODE_23980_length_610_cov_4.998043	182	234	0	52	52	1.0000000
NODE_23989_length_610_cov_3.479452	215	267	0	52	52	1.0000000
NODE_24059_length_609_cov_21.117647	80	160	0	80	80	1.0000000
NODE_24059_length_609_cov_21.117647	133	213	0	80	80	1.0000000
NODE_24060_length_609_cov_11.300000	218	298	6	2	80	0.0250000
NODE_24060_length_609_cov_11.300000	218	298	14	22	80	0.2750000
NODE_24060_length_609_cov_11.300000	218	298	17	10	80	0.1250000
NODE_24060_length_609_cov_11.300000	218	298	18	5	80	0.0625000
NODE_24060_length_609_cov_11.300000	218	298	19	13	80	0.1625000
NODE_24060_length_609_cov_11.300000	218	298	20	28	80	0.3500000
NODE_24060_length_609_cov_11.300000	271	351	0	15	80	0.1875000
NODE_24060_length_609_cov_11.300000	271	351	4	2	80	0.0250000
NODE_24060_length_609_cov_11.300000	271	351	6	2	80	0.0250000
NODE_24060_length_609_cov_11.300000	271	351	13	15	80	0.1875000
NODE_24060_length_609_cov_11.300000	271	351	17	29	80	0.3625000
NODE_24060_length_609_cov_11.300000	271	351	19	13	80	0.1625000
NODE_24060_length_609_cov_11.300000	271	351	20	4	80	0.0500000
NODE_24061_length_609_cov_10.778431	239	319	0	80	80	1.0000000
NODE_24061_length_609_cov_10.778431	292	372	0	80	80	1.0000000
NODE_24062_length_609_cov_10.298039	340	420	0	80	80	1.0000000
NODE_24062_length_609_cov_10.298039	393	473	0	51	80	0.6375000
NODE_24062_length_609_cov_10.298039	393	473	2	29	80	0.3625000
NODE_24062_length_609_cov_10.298039	469	537	2	68	68	1.0000000
NODE_24063_length_609_cov_10.270588	217	297	0	80	80	1.0000000
NODE_24063_length_609_cov_10.270588	270	353	0	44	83	0.5301205
NODE_24063_length_609_cov_10.270588	270	353	2	39	83	0.4698795
NODE_24064_length_609_cov_8.345098	408	488	0	80	80	1.0000000
NODE_24064_length_609_cov_8.345098	461	515	0	54	54	1.0000000
NODE_24064_length_609_cov_8.345098	537	566	0	29	29	1.0000000
NODE_24066_length_609_cov_6.054902	219	299	0	80	80	1.0000000
NODE_24066_length_609_cov_6.054902	272	352	0	80	80	1.0000000
NODE_24067_length_609_cov_5.986275	219	299	0	80	80	1.0000000
NODE_24067_length_609_cov_5.986275	272	352	0	80	80	1.0000000
NODE_24160_length_608_cov_76.257367	300	380	60	12	80	0.1500000
NODE_24160_length_608_cov_76.257367	300	380	61	26	80	0.3250000
NODE_24160_length_608_cov_76.257367	300	380	62	20	80	0.2500000
NODE_24160_length_608_cov_76.257367	300	380	63	3	80	0.0375000
NODE_24160_length_608_cov_76.257367	300	380	65	19	80	0.2375000
NODE_24160_length_608_cov_76.257367	353	433	2	2	80	0.0250000
NODE_24160_length_608_cov_76.257367	353	433	4	11	80	0.1375000
NODE_24160_length_608_cov_76.257367	353	433	6	9	80	0.1125000
NODE_24160_length_608_cov_76.257367	353	433	11	1	80	0.0125000
NODE_24160_length_608_cov_76.257367	353	433	12	15	80	0.1875000
NODE_24160_length_608_cov_76.257367	353	433	37	1	80	0.0125000
NODE_24160_length_608_cov_76.257367	353	433	41	1	80	0.0125000
NODE_24160_length_608_cov_76.257367	353	433	42	3	80	0.0375000
NODE_24160_length_608_cov_76.257367	353	433	61	6	80	0.0750000
NODE_24160_length_608_cov_76.257367	353	433	63	3	80	0.0375000
NODE_24160_length_608_cov_76.257367	353	433	65	28	80	0.3500000
NODE_24161_length_608_cov_13.271120	252	332	2	9	80	0.1125000
NODE_24161_length_608_cov_13.271120	252	332	6	61	80	0.7625000
NODE_24161_length_608_cov_13.271120	252	332	8	10	80	0.1250000
NODE_24161_length_608_cov_13.271120	305	385	0	50	80	0.6250000
NODE_24161_length_608_cov_13.271120	305	385	2	12	80	0.1500000
NODE_24161_length_608_cov_13.271120	305	385	6	18	80	0.2250000
NODE_24162_length_608_cov_11.583497	63	139	0	27	76	0.3552631
NODE_24162_length_608_cov_11.583497	63	139	4	49	76	0.6447368
NODE_24162_length_608_cov_11.583497	112	192	4	43	80	0.5375000
NODE_24162_length_608_cov_11.583497	112	192	6	15	80	0.1875000
NODE_24162_length_608_cov_11.583497	112	192	8	22	80	0.2750000
NODE_24164_length_608_cov_8.076621	53	133	18	1	80	0.0125000
NODE_24164_length_608_cov_8.076621	53	133	22	1	80	0.0125000
NODE_24164_length_608_cov_8.076621	53	133	23	6	80	0.0750000
NODE_24164_length_608_cov_8.076621	53	133	25	1	80	0.0125000
NODE_24164_length_608_cov_8.076621	53	133	29	3	80	0.0375000
NODE_24164_length_608_cov_8.076621	53	133	31	2	80	0.0250000
NODE_24164_length_608_cov_8.076621	53	133	37	2	80	0.0250000
NODE_24164_length_608_cov_8.076621	53	133	41	2	80	0.0250000
NODE_24164_length_608_cov_8.076621	53	133	51	2	80	0.0250000
NODE_24164_length_608_cov_8.076621	53	133	53	2	80	0.0250000
NODE_24164_length_608_cov_8.076621	53	133	55	7	80	0.0875000
NODE_24164_length_608_cov_8.076621	53	133	57	3	80	0.0375000
NODE_24164_length_608_cov_8.076621	53	133	61	3	80	0.0375000
NODE_24164_length_608_cov_8.076621	53	133	65	3	80	0.0375000
NODE_24164_length_608_cov_8.076621	53	133	69	7	80	0.0875000
NODE_24164_length_608_cov_8.076621	53	133	71	1	80	0.0125000
NODE_24164_length_608_cov_8.076621	53	133	72	2	80	0.0250000
NODE_24164_length_608_cov_8.076621	53	133	73	15	80	0.1875000
NODE_24164_length_608_cov_8.076621	53	133	75	11	80	0.1375000
NODE_24164_length_608_cov_8.076621	53	133	77	6	80	0.0750000
NODE_24164_length_608_cov_8.076621	106	186	0	28	80	0.3500000
NODE_24164_length_608_cov_8.076621	106	186	2	13	80	0.1625000
NODE_24164_length_608_cov_8.076621	106	186	8	3	80	0.0375000
NODE_24164_length_608_cov_8.076621	106	186	10	2	80	0.0250000
NODE_24164_length_608_cov_8.076621	106	186	12	4	80	0.0500000
NODE_24164_length_608_cov_8.076621	106	186	17	3	80	0.0375000
NODE_24164_length_608_cov_8.076621	106	186	18	1	80	0.0125000
NODE_24164_length_608_cov_8.076621	106	186	22	1	80	0.0125000
NODE_24164_length_608_cov_8.076621	106	186	23	6	80	0.0750000
NODE_24164_length_608_cov_8.076621	106	186	25	1	80	0.0125000
NODE_24164_length_608_cov_8.076621	106	186	29	3	80	0.0375000
NODE_24164_length_608_cov_8.076621	106	186	31	2	80	0.0250000
NODE_24164_length_608_cov_8.076621	106	186	37	2	80	0.0250000
NODE_24164_length_608_cov_8.076621	106	186	41	2	80	0.0250000
NODE_24164_length_608_cov_8.076621	106	186	51	2	80	0.0250000
NODE_24164_length_608_cov_8.076621	106	186	53	2	80	0.0250000
NODE_24164_length_608_cov_8.076621	106	186	55	5	80	0.0625000
NODE_24165_length_608_cov_7.994106	279	326	0	19	47	0.4042553
NODE_24165_length_608_cov_7.994106	279	326	2	28	47	0.5957447
NODE_24165_length_608_cov_7.994106	348	373	0	25	25	1.0000000
NODE_24166_length_608_cov_7.939096	247	277	0	30	30	1.0000000
NODE_24177_length_608_cov_3.829077	313	393	0	18	80	0.2250000
NODE_24177_length_608_cov_3.829077	313	393	2	62	80	0.7750000
NODE_24177_length_608_cov_3.829077	366	446	0	27	80	0.3375000
NODE_24177_length_608_cov_3.829077	366	446	2	53	80	0.6625000
NODE_24251_length_608_cov_1.064833	472	512	0	40	40	1.0000000
NODE_24281_length_607_cov_61.316929	347	427	11	2	80	0.0250000
NODE_24281_length_607_cov_61.316929	347	427	12	10	80	0.1250000
NODE_24281_length_607_cov_61.316929	347	427	14	10	80	0.1250000
NODE_24281_length_607_cov_61.316929	347	427	17	1	80	0.0125000
NODE_24281_length_607_cov_61.316929	347	427	18	4	80	0.0500000
NODE_24281_length_607_cov_61.316929	347	427	20	3	80	0.0375000
NODE_24281_length_607_cov_61.316929	347	427	24	13	80	0.1625000
NODE_24281_length_607_cov_61.316929	347	427	31	3	80	0.0375000
NODE_24281_length_607_cov_61.316929	347	427	32	4	80	0.0500000
NODE_24281_length_607_cov_61.316929	347	427	34	29	80	0.3625000
NODE_24281_length_607_cov_61.316929	347	427	39	1	80	0.0125000
NODE_24281_length_607_cov_61.316929	347	427	11	2	80	0.0250000
NODE_24281_length_607_cov_61.316929	347	427	12	10	80	0.1250000
NODE_24281_length_607_cov_61.316929	347	427	14	10	80	0.1250000
NODE_24281_length_607_cov_61.316929	347	427	17	1	80	0.0125000
NODE_24281_length_607_cov_61.316929	347	427	18	4	80	0.0500000
NODE_24281_length_607_cov_61.316929	347	427	20	3	80	0.0375000
NODE_24281_length_607_cov_61.316929	347	427	24	13	80	0.1625000
NODE_24281_length_607_cov_61.316929	347	427	31	3	80	0.0375000
NODE_24281_length_607_cov_61.316929	347	427	32	4	80	0.0500000
NODE_24281_length_607_cov_61.316929	347	427	34	29	80	0.3625000
NODE_24281_length_607_cov_61.316929	347	427	39	1	80	0.0125000
NODE_24281_length_607_cov_61.316929	347	427	11	2	80	0.0250000
NODE_24281_length_607_cov_61.316929	347	427	12	10	80	0.1250000
NODE_24281_length_607_cov_61.316929	347	427	14	10	80	0.1250000
NODE_24281_length_607_cov_61.316929	347	427	17	1	80	0.0125000
NODE_24281_length_607_cov_61.316929	347	427	18	4	80	0.0500000
NODE_24281_length_607_cov_61.316929	347	427	20	3	80	0.0375000
NODE_24281_length_607_cov_61.316929	347	427	24	13	80	0.1625000
NODE_24281_length_607_cov_61.316929	347	427	31	3	80	0.0375000
NODE_24281_length_607_cov_61.316929	347	427	32	4	80	0.0500000
NODE_24281_length_607_cov_61.316929	347	427	34	29	80	0.3625000
NODE_24281_length_607_cov_61.316929	347	427	39	1	80	0.0125000
NODE_24281_length_607_cov_61.316929	364	427	14	5	63	0.0793651
NODE_24281_length_607_cov_61.316929	364	427	17	1	63	0.0158730
NODE_24281_length_607_cov_61.316929	364	427	18	4	63	0.0634921
NODE_24281_length_607_cov_61.316929	364	427	20	3	63	0.0476190
NODE_24281_length_607_cov_61.316929	364	427	24	13	63	0.2063492
NODE_24281_length_607_cov_61.316929	364	427	31	3	63	0.0476190
NODE_24281_length_607_cov_61.316929	364	427	32	4	63	0.0634921
NODE_24281_length_607_cov_61.316929	364	427	34	29	63	0.4603175
NODE_24281_length_607_cov_61.316929	364	427	39	1	63	0.0158730
NODE_24281_length_607_cov_61.316929	400	480	23	12	80	0.1500000
NODE_24281_length_607_cov_61.316929	400	480	27	1	80	0.0125000
NODE_24281_length_607_cov_61.316929	400	480	31	4	80	0.0500000
NODE_24281_length_607_cov_61.316929	400	480	32	1	80	0.0125000
NODE_24281_length_607_cov_61.316929	400	480	33	12	80	0.1500000
NODE_24281_length_607_cov_61.316929	400	480	34	26	80	0.3250000
NODE_24281_length_607_cov_61.316929	400	480	35	1	80	0.0125000
NODE_24281_length_607_cov_61.316929	400	480	37	8	80	0.1000000
NODE_24281_length_607_cov_61.316929	400	480	39	15	80	0.1875000
NODE_24281_length_607_cov_61.316929	400	480	23	12	80	0.1500000
NODE_24281_length_607_cov_61.316929	400	480	27	1	80	0.0125000
NODE_24281_length_607_cov_61.316929	400	480	31	4	80	0.0500000
NODE_24281_length_607_cov_61.316929	400	480	32	1	80	0.0125000
NODE_24281_length_607_cov_61.316929	400	480	33	12	80	0.1500000
NODE_24281_length_607_cov_61.316929	400	480	34	26	80	0.3250000
NODE_24281_length_607_cov_61.316929	400	480	35	1	80	0.0125000
NODE_24281_length_607_cov_61.316929	400	480	37	8	80	0.1000000
NODE_24281_length_607_cov_61.316929	400	480	39	15	80	0.1875000
NODE_24281_length_607_cov_61.316929	400	480	23	12	80	0.1500000
NODE_24281_length_607_cov_61.316929	400	480	27	1	80	0.0125000
NODE_24281_length_607_cov_61.316929	400	480	31	4	80	0.0500000
NODE_24281_length_607_cov_61.316929	400	480	32	1	80	0.0125000
NODE_24281_length_607_cov_61.316929	400	480	33	12	80	0.1500000
NODE_24281_length_607_cov_61.316929	400	480	34	26	80	0.3250000
NODE_24281_length_607_cov_61.316929	400	480	35	1	80	0.0125000
NODE_24281_length_607_cov_61.316929	400	480	37	8	80	0.1000000
NODE_24281_length_607_cov_61.316929	400	480	39	15	80	0.1875000
NODE_24281_length_607_cov_61.316929	400	480	23	12	80	0.1500000
NODE_24281_length_607_cov_61.316929	400	480	27	1	80	0.0125000
NODE_24281_length_607_cov_61.316929	400	480	31	4	80	0.0500000
NODE_24281_length_607_cov_61.316929	400	480	32	1	80	0.0125000
NODE_24281_length_607_cov_61.316929	400	480	33	12	80	0.1500000
NODE_24281_length_607_cov_61.316929	400	480	34	26	80	0.3250000
NODE_24281_length_607_cov_61.316929	400	480	35	1	80	0.0125000
NODE_24281_length_607_cov_61.316929	400	480	37	8	80	0.1000000
NODE_24281_length_607_cov_61.316929	400	480	39	15	80	0.1875000
NODE_24281_length_607_cov_61.316929	476	556	23	3	80	0.0375000
NODE_24281_length_607_cov_61.316929	476	556	27	5	80	0.0625000
NODE_24281_length_607_cov_61.316929	476	556	29	8	80	0.1000000
NODE_24281_length_607_cov_61.316929	476	556	31	5	80	0.0625000
NODE_24281_length_607_cov_61.316929	476	556	33	8	80	0.1000000
NODE_24281_length_607_cov_61.316929	476	556	34	6	80	0.0750000
NODE_24281_length_607_cov_61.316929	476	556	38	9	80	0.1125000
NODE_24281_length_607_cov_61.316929	476	556	40	4	80	0.0500000
NODE_24281_length_607_cov_61.316929	476	556	42	4	80	0.0500000
NODE_24281_length_607_cov_61.316929	476	556	47	3	80	0.0375000
NODE_24281_length_607_cov_61.316929	476	556	50	25	80	0.3125000
NODE_24281_length_607_cov_61.316929	476	556	23	3	80	0.0375000
NODE_24281_length_607_cov_61.316929	476	556	27	5	80	0.0625000
NODE_24281_length_607_cov_61.316929	476	556	29	8	80	0.1000000
NODE_24281_length_607_cov_61.316929	476	556	31	5	80	0.0625000
NODE_24281_length_607_cov_61.316929	476	556	33	8	80	0.1000000
NODE_24281_length_607_cov_61.316929	476	556	34	6	80	0.0750000
NODE_24281_length_607_cov_61.316929	476	556	38	9	80	0.1125000
NODE_24281_length_607_cov_61.316929	476	556	40	4	80	0.0500000
NODE_24281_length_607_cov_61.316929	476	556	42	4	80	0.0500000
NODE_24281_length_607_cov_61.316929	476	556	47	3	80	0.0375000
NODE_24281_length_607_cov_61.316929	476	556	50	25	80	0.3125000
NODE_24281_length_607_cov_61.316929	476	556	23	3	80	0.0375000
NODE_24281_length_607_cov_61.316929	476	556	27	5	80	0.0625000
NODE_24281_length_607_cov_61.316929	476	556	29	8	80	0.1000000
NODE_24281_length_607_cov_61.316929	476	556	31	5	80	0.0625000
NODE_24281_length_607_cov_61.316929	476	556	33	8	80	0.1000000
NODE_24281_length_607_cov_61.316929	476	556	34	6	80	0.0750000
NODE_24281_length_607_cov_61.316929	476	556	38	9	80	0.1125000
NODE_24281_length_607_cov_61.316929	476	556	40	4	80	0.0500000
NODE_24281_length_607_cov_61.316929	476	556	42	4	80	0.0500000
NODE_24281_length_607_cov_61.316929	476	556	47	3	80	0.0375000
NODE_24281_length_607_cov_61.316929	476	556	50	25	80	0.3125000
NODE_24281_length_607_cov_61.316929	529	595	20	8	66	0.1212121
NODE_24281_length_607_cov_61.316929	529	595	28	7	66	0.1060606
NODE_24281_length_607_cov_61.316929	529	595	30	4	66	0.0606061
NODE_24281_length_607_cov_61.316929	529	595	31	9	66	0.1363636
NODE_24281_length_607_cov_61.316929	529	595	33	15	66	0.2272727
NODE_24281_length_607_cov_61.316929	529	595	34	6	66	0.0909091
NODE_24281_length_607_cov_61.316929	529	595	38	9	66	0.1363636
NODE_24281_length_607_cov_61.316929	529	595	40	4	66	0.0606061
NODE_24281_length_607_cov_61.316929	529	595	42	4	66	0.0606061
NODE_24281_length_607_cov_61.316929	529	607	1	6	78	0.0769231
NODE_24281_length_607_cov_61.316929	529	607	5	2	78	0.0256410
NODE_24281_length_607_cov_61.316929	529	607	20	12	78	0.1538462
NODE_24281_length_607_cov_61.316929	529	607	28	7	78	0.0897436
NODE_24281_length_607_cov_61.316929	529	607	30	4	78	0.0512821
NODE_24281_length_607_cov_61.316929	529	607	31	9	78	0.1153846
NODE_24281_length_607_cov_61.316929	529	607	33	15	78	0.1923077
NODE_24281_length_607_cov_61.316929	529	607	34	6	78	0.0769231
NODE_24281_length_607_cov_61.316929	529	607	38	9	78	0.1153846
NODE_24281_length_607_cov_61.316929	529	607	40	4	78	0.0512821
NODE_24281_length_607_cov_61.316929	529	607	42	4	78	0.0512821
NODE_24281_length_607_cov_61.316929	529	600	5	1	71	0.0140845
NODE_24281_length_607_cov_61.316929	529	600	20	12	71	0.1690141
NODE_24281_length_607_cov_61.316929	529	600	28	7	71	0.0985916
NODE_24281_length_607_cov_61.316929	529	600	30	4	71	0.0563380
NODE_24281_length_607_cov_61.316929	529	600	31	9	71	0.1267606
NODE_24281_length_607_cov_61.316929	529	600	33	15	71	0.2112676
NODE_24281_length_607_cov_61.316929	529	600	34	6	71	0.0845070
NODE_24281_length_607_cov_61.316929	529	600	38	9	71	0.1267606
NODE_24281_length_607_cov_61.316929	529	600	40	4	71	0.0563380
NODE_24281_length_607_cov_61.316929	529	600	42	4	71	0.0563380
NODE_24281_length_607_cov_61.316929	534	607	1	6	73	0.0821918
NODE_24281_length_607_cov_61.316929	534	607	5	2	73	0.0273973
NODE_24281_length_607_cov_61.316929	534	607	20	12	73	0.1643836
NODE_24281_length_607_cov_61.316929	534	607	28	7	73	0.0958904
NODE_24281_length_607_cov_61.316929	534	607	30	4	73	0.0547945
NODE_24281_length_607_cov_61.316929	534	607	31	9	73	0.1232877
NODE_24281_length_607_cov_61.316929	534	607	33	15	73	0.2054795
NODE_24281_length_607_cov_61.316929	534	607	34	6	73	0.0821918
NODE_24281_length_607_cov_61.316929	534	607	38	9	73	0.1232877
NODE_24281_length_607_cov_61.316929	534	607	40	3	73	0.0410959
NODE_24282_length_607_cov_16.852362	383	463	0	80	80	1.0000000
NODE_24282_length_607_cov_16.852362	436	516	0	80	80	1.0000000
NODE_24283_length_607_cov_12.889764	67	147	3	7	80	0.0875000
NODE_24283_length_607_cov_12.889764	67	147	5	4	80	0.0500000
NODE_24283_length_607_cov_12.889764	67	147	6	69	80	0.8625000
NODE_24283_length_607_cov_12.889764	120	200	3	8	80	0.1000000
NODE_24283_length_607_cov_12.889764	120	200	4	5	80	0.0625000
NODE_24283_length_607_cov_12.889764	120	200	5	5	80	0.0625000
NODE_24283_length_607_cov_12.889764	120	200	6	44	80	0.5500000
NODE_24283_length_607_cov_12.889764	120	200	7	18	80	0.2250000
NODE_24284_length_607_cov_11.023622	122	202	0	80	80	1.0000000
NODE_24284_length_607_cov_11.023622	175	255	0	80	80	1.0000000
NODE_24285_length_607_cov_10.690945	199	279	0	38	80	0.4750000
NODE_24285_length_607_cov_10.690945	199	279	4	42	80	0.5250000
NODE_24285_length_607_cov_10.690945	252	332	0	6	80	0.0750000
NODE_24285_length_607_cov_10.690945	252	332	3	47	80	0.5875000
NODE_24285_length_607_cov_10.690945	252	332	4	27	80	0.3375000
NODE_24290_length_607_cov_5.818898	301	386	0	85	85	1.0000000
NODE_24291_length_607_cov_5.771654	278	358	0	80	80	1.0000000
NODE_24291_length_607_cov_5.771654	331	411	0	30	80	0.3750000
NODE_24291_length_607_cov_5.771654	331	411	2	50	80	0.6250000
NODE_24295_length_607_cov_4.816929	282	362	0	80	80	1.0000000
NODE_24295_length_607_cov_4.816929	335	415	0	80	80	1.0000000
NODE_24300_length_607_cov_4.015748	295	354	0	59	59	1.0000000
NODE_24310_length_607_cov_3.088583	107	158	0	51	51	1.0000000
NODE_24331_length_607_cov_1.791339	204	247	0	43	43	1.0000000
NODE_24400_length_606_cov_42.264300	182	262	0	32	80	0.4000000
NODE_24400_length_606_cov_42.264300	182	262	2	13	80	0.1625000
NODE_24400_length_606_cov_42.264300	182	262	4	33	80	0.4125000
NODE_24400_length_606_cov_42.264300	182	262	6	2	80	0.0250000
NODE_24400_length_606_cov_42.264300	235	315	4	25	80	0.3125000
NODE_24400_length_606_cov_42.264300	235	315	6	55	80	0.6875000
NODE_24402_length_606_cov_26.341223	371	451	0	80	80	1.0000000
NODE_24402_length_606_cov_26.341223	424	504	0	80	80	1.0000000
NODE_24403_length_606_cov_14.895464	308	388	0	80	80	1.0000000
NODE_24403_length_606_cov_14.895464	361	441	0	80	80	1.0000000
NODE_24406_length_606_cov_7.934911	412	492	2	77	80	0.9625000
NODE_24406_length_606_cov_7.934911	412	492	3	3	80	0.0375000
NODE_24406_length_606_cov_7.934911	465	545	0	17	80	0.2125000
NODE_24406_length_606_cov_7.934911	465	545	1	20	80	0.2500000
NODE_24406_length_606_cov_7.934911	465	545	2	43	80	0.5375000
NODE_24407_length_606_cov_7.481262	250	330	0	1	80	0.0125000
NODE_24407_length_606_cov_7.481262	250	330	2	79	80	0.9875000
NODE_24407_length_606_cov_7.481262	303	383	0	3	80	0.0375000
NODE_24407_length_606_cov_7.481262	303	383	2	26	80	0.3250000
NODE_24407_length_606_cov_7.481262	303	383	4	9	80	0.1125000
NODE_24407_length_606_cov_7.481262	303	383	6	10	80	0.1250000
NODE_24407_length_606_cov_7.481262	303	383	8	6	80	0.0750000
NODE_24407_length_606_cov_7.481262	303	383	10	3	80	0.0375000
NODE_24407_length_606_cov_7.481262	303	383	16	9	80	0.1125000
NODE_24407_length_606_cov_7.481262	303	383	18	5	80	0.0625000
NODE_24407_length_606_cov_7.481262	303	383	20	4	80	0.0500000
NODE_24407_length_606_cov_7.481262	303	383	22	5	80	0.0625000
NODE_24409_length_606_cov_6.842209	139	219	0	80	80	1.0000000
NODE_24409_length_606_cov_6.842209	192	272	0	80	80	1.0000000
NODE_24428_length_606_cov_3.384615	156	206	0	50	50	1.0000000
NODE_24433_length_606_cov_2.670611	113	193	0	34	80	0.4250000
NODE_24433_length_606_cov_2.670611	113	193	2	6	80	0.0750000
NODE_24433_length_606_cov_2.670611	113	193	4	40	80	0.5000000
NODE_24525_length_605_cov_63.343874	7	83	2	76	76	1.0000000
NODE_24525_length_605_cov_63.343874	12	83	2	71	71	1.0000000
NODE_24525_length_605_cov_63.343874	17	83	2	66	66	1.0000000
NODE_24525_length_605_cov_63.343874	56	136	0	27	80	0.3375000
NODE_24525_length_605_cov_63.343874	56	136	2	53	80	0.6625000
NODE_24525_length_605_cov_63.343874	56	136	0	27	80	0.3375000
NODE_24525_length_605_cov_63.343874	56	136	2	53	80	0.6625000
NODE_24525_length_605_cov_63.343874	56	136	0	27	80	0.3375000
NODE_24525_length_605_cov_63.343874	56	136	2	53	80	0.6625000
NODE_24525_length_605_cov_63.343874	132	212	0	9	80	0.1125000
NODE_24525_length_605_cov_63.343874	132	212	4	9	80	0.1125000
NODE_24525_length_605_cov_63.343874	132	212	6	62	80	0.7750000
NODE_24525_length_605_cov_63.343874	132	212	0	9	80	0.1125000
NODE_24525_length_605_cov_63.343874	132	212	4	9	80	0.1125000
NODE_24525_length_605_cov_63.343874	132	212	6	62	80	0.7750000
NODE_24525_length_605_cov_63.343874	132	210	0	9	78	0.1153846
NODE_24525_length_605_cov_63.343874	132	210	4	9	78	0.1153846
NODE_24525_length_605_cov_63.343874	132	210	6	60	78	0.7692308
NODE_24525_length_605_cov_63.343874	132	212	0	9	80	0.1125000
NODE_24525_length_605_cov_63.343874	132	212	4	9	80	0.1125000
NODE_24525_length_605_cov_63.343874	132	212	6	62	80	0.7750000
NODE_24525_length_605_cov_63.343874	132	212	0	9	80	0.1125000
NODE_24525_length_605_cov_63.343874	132	212	4	9	80	0.1125000
NODE_24525_length_605_cov_63.343874	132	212	6	62	80	0.7750000
NODE_24525_length_605_cov_63.343874	185	265	0	24	80	0.3000000
NODE_24525_length_605_cov_63.343874	185	265	2	26	80	0.3250000
NODE_24525_length_605_cov_63.343874	185	265	6	30	80	0.3750000
NODE_24526_length_605_cov_48.191700	298	374	0	39	76	0.5131579
NODE_24526_length_605_cov_48.191700	298	374	2	3	76	0.0394737
NODE_24526_length_605_cov_48.191700	298	374	4	3	76	0.0394737
NODE_24526_length_605_cov_48.191700	298	374	6	31	76	0.4078947
NODE_24526_length_605_cov_48.191700	347	427	2	4	80	0.0500000
NODE_24526_length_605_cov_48.191700	347	427	4	11	80	0.1375000
NODE_24526_length_605_cov_48.191700	347	427	6	65	80	0.8125000
NODE_24528_length_605_cov_33.328063	57	137	186	1	80	0.0125000
NODE_24528_length_605_cov_33.328063	57	137	188	3	80	0.0375000
NODE_24528_length_605_cov_33.328063	57	137	195	1	80	0.0125000
NODE_24528_length_605_cov_33.328063	57	137	197	1	80	0.0125000
NODE_24528_length_605_cov_33.328063	57	137	199	4	80	0.0500000
NODE_24528_length_605_cov_33.328063	57	137	206	1	80	0.0125000
NODE_24528_length_605_cov_33.328063	57	137	210	1	80	0.0125000
NODE_24528_length_605_cov_33.328063	57	137	213	1	80	0.0125000
NODE_24528_length_605_cov_33.328063	57	137	215	2	80	0.0250000
NODE_24528_length_605_cov_33.328063	57	137	219	1	80	0.0125000
NODE_24528_length_605_cov_33.328063	57	137	221	1	80	0.0125000
NODE_24528_length_605_cov_33.328063	57	137	227	1	80	0.0125000
NODE_24528_length_605_cov_33.328063	57	137	229	3	80	0.0375000
NODE_24528_length_605_cov_33.328063	57	137	231	1	80	0.0125000
NODE_24528_length_605_cov_33.328063	57	137	232	1	80	0.0125000
NODE_24528_length_605_cov_33.328063	57	137	233	3	80	0.0375000
NODE_24528_length_605_cov_33.328063	57	137	237	2	80	0.0250000
NODE_24528_length_605_cov_33.328063	57	137	239	1	80	0.0125000
NODE_24528_length_605_cov_33.328063	57	137	241	1	80	0.0125000
NODE_24528_length_605_cov_33.328063	57	137	250	1	80	0.0125000
NODE_24528_length_605_cov_33.328063	57	137	252	1	80	0.0125000
NODE_24528_length_605_cov_33.328063	57	137	255	1	80	0.0125000
NODE_24528_length_605_cov_33.328063	57	137	259	1	80	0.0125000
NODE_24528_length_605_cov_33.328063	57	137	269	1	80	0.0125000
NODE_24528_length_605_cov_33.328063	57	137	274	1	80	0.0125000
NODE_24528_length_605_cov_33.328063	57	137	278	2	80	0.0250000
NODE_24528_length_605_cov_33.328063	57	137	284	1	80	0.0125000
NODE_24528_length_605_cov_33.328063	57	137	285	1	80	0.0125000
NODE_24528_length_605_cov_33.328063	57	137	287	1	80	0.0125000
NODE_24528_length_605_cov_33.328063	57	137	288	6	80	0.0750000
NODE_24528_length_605_cov_33.328063	57	137	291	1	80	0.0125000
NODE_24528_length_605_cov_33.328063	57	137	294	1	80	0.0125000
NODE_24528_length_605_cov_33.328063	57	137	299	1	80	0.0125000
NODE_24528_length_605_cov_33.328063	57	137	305	1	80	0.0125000
NODE_24528_length_605_cov_33.328063	57	137	312	1	80	0.0125000
NODE_24528_length_605_cov_33.328063	57	137	313	1	80	0.0125000
NODE_24528_length_605_cov_33.328063	57	137	324	2	80	0.0250000
NODE_24528_length_605_cov_33.328063	57	137	326	1	80	0.0125000
NODE_24528_length_605_cov_33.328063	57	137	327	1	80	0.0125000
NODE_24528_length_605_cov_33.328063	57	137	328	3	80	0.0375000
NODE_24528_length_605_cov_33.328063	57	137	329	2	80	0.0250000
NODE_24528_length_605_cov_33.328063	57	137	330	3	80	0.0375000
NODE_24528_length_605_cov_33.328063	57	137	331	2	80	0.0250000
NODE_24528_length_605_cov_33.328063	57	137	334	2	80	0.0250000
NODE_24528_length_605_cov_33.328063	57	137	335	4	80	0.0500000
NODE_24528_length_605_cov_33.328063	57	137	337	3	80	0.0375000
NODE_24528_length_605_cov_33.328063	57	137	338	1	80	0.0125000
NODE_24528_length_605_cov_33.328063	57	137	342	2	80	0.0250000
NODE_24528_length_605_cov_33.328063	57	137	344	1	80	0.0125000
NODE_24528_length_605_cov_33.328063	140	175	416	1	35	0.0285714
NODE_24528_length_605_cov_33.328063	140	175	418	1	35	0.0285714
NODE_24528_length_605_cov_33.328063	140	175	425	1	35	0.0285714
NODE_24528_length_605_cov_33.328063	140	175	427	2	35	0.0571429
NODE_24528_length_605_cov_33.328063	140	175	429	1	35	0.0285714
NODE_24528_length_605_cov_33.328063	140	175	431	1	35	0.0285714
NODE_24528_length_605_cov_33.328063	140	175	437	1	35	0.0285714
NODE_24528_length_605_cov_33.328063	140	175	454	1	35	0.0285714
NODE_24528_length_605_cov_33.328063	140	175	461	1	35	0.0285714
NODE_24528_length_605_cov_33.328063	140	175	465	1	35	0.0285714
NODE_24528_length_605_cov_33.328063	140	175	474	1	35	0.0285714
NODE_24528_length_605_cov_33.328063	140	175	482	1	35	0.0285714
NODE_24528_length_605_cov_33.328063	140	175	508	1	35	0.0285714
NODE_24528_length_605_cov_33.328063	140	175	522	2	35	0.0571429
NODE_24528_length_605_cov_33.328063	140	175	526	1	35	0.0285714
NODE_24528_length_605_cov_33.328063	140	175	534	1	35	0.0285714
NODE_24528_length_605_cov_33.328063	140	175	535	1	35	0.0285714
NODE_24528_length_605_cov_33.328063	140	175	536	1	35	0.0285714
NODE_24528_length_605_cov_33.328063	140	175	537	1	35	0.0285714
NODE_24528_length_605_cov_33.328063	140	175	539	1	35	0.0285714
NODE_24528_length_605_cov_33.328063	140	175	540	1	35	0.0285714
NODE_24528_length_605_cov_33.328063	140	175	543	1	35	0.0285714
NODE_24528_length_605_cov_33.328063	140	175	546	1	35	0.0285714
NODE_24528_length_605_cov_33.328063	140	175	547	3	35	0.0857143
NODE_24528_length_605_cov_33.328063	140	175	551	1	35	0.0285714
NODE_24528_length_605_cov_33.328063	140	175	553	1	35	0.0285714
NODE_24528_length_605_cov_33.328063	140	175	555	2	35	0.0571429
NODE_24528_length_605_cov_33.328063	140	175	567	1	35	0.0285714
NODE_24528_length_605_cov_33.328063	140	175	572	1	35	0.0285714
NODE_24528_length_605_cov_33.328063	140	175	582	1	35	0.0285714
NODE_24529_length_605_cov_26.717391	353	433	0	80	80	1.0000000
NODE_24529_length_605_cov_26.717391	406	486	0	80	80	1.0000000
NODE_24530_length_605_cov_17.677866	215	295	0	53	80	0.6625000
NODE_24530_length_605_cov_17.677866	215	295	2	27	80	0.3375000
NODE_24530_length_605_cov_17.677866	268	348	2	56	80	0.7000000
NODE_24530_length_605_cov_17.677866	268	348	4	24	80	0.3000000
NODE_24531_length_605_cov_15.225296	144	224	0	80	80	1.0000000
NODE_24531_length_605_cov_15.225296	197	277	0	80	80	1.0000000
NODE_24532_length_605_cov_14.990119	136	216	0	80	80	1.0000000
NODE_24532_length_605_cov_14.990119	189	269	0	80	80	1.0000000
NODE_24533_length_605_cov_10.835968	103	183	0	80	80	1.0000000
NODE_24533_length_605_cov_10.835968	156	236	0	80	80	1.0000000
NODE_24534_length_605_cov_9.169960	306	377	0	21	71	0.2957746
NODE_24534_length_605_cov_9.169960	306	377	2	5	71	0.0704225
NODE_24534_length_605_cov_9.169960	306	377	4	45	71	0.6338028
NODE_24534_length_605_cov_9.169960	359	432	4	73	73	1.0000000
NODE_24546_length_605_cov_4.308300	159	239	0	80	80	1.0000000
NODE_24546_length_605_cov_4.308300	271	338	8	9	67	0.1343284
NODE_24546_length_605_cov_4.308300	271	338	10	3	67	0.0447761
NODE_24546_length_605_cov_4.308300	271	338	12	6	67	0.0895522
NODE_24546_length_605_cov_4.308300	271	338	14	7	67	0.1044776
NODE_24546_length_605_cov_4.308300	271	338	16	11	67	0.1641791
NODE_24546_length_605_cov_4.308300	271	338	18	31	67	0.4626866
NODE_24546_length_605_cov_4.308300	275	350	8	5	75	0.0666667
NODE_24546_length_605_cov_4.308300	275	350	10	3	75	0.0400000
NODE_24546_length_605_cov_4.308300	275	350	12	6	75	0.0800000
NODE_24546_length_605_cov_4.308300	275	350	14	7	75	0.0933333
NODE_24546_length_605_cov_4.308300	275	350	16	11	75	0.1466667
NODE_24546_length_605_cov_4.308300	275	350	18	43	75	0.5733333
NODE_24546_length_605_cov_4.308300	315	372	8	1	57	0.0175439
NODE_24546_length_605_cov_4.308300	315	372	10	2	57	0.0350877
NODE_24546_length_605_cov_4.308300	315	372	12	8	57	0.1403509
NODE_24546_length_605_cov_4.308300	315	372	14	4	57	0.0701754
NODE_24546_length_605_cov_4.308300	315	372	16	6	57	0.1052632
NODE_24546_length_605_cov_4.308300	315	372	18	36	57	0.6315789
NODE_24546_length_605_cov_4.308300	328	373	6	1	45	0.0222222
NODE_24546_length_605_cov_4.308300	328	373	8	1	45	0.0222222
NODE_24546_length_605_cov_4.308300	328	373	10	2	45	0.0444444
NODE_24546_length_605_cov_4.308300	328	373	12	8	45	0.1777778
NODE_24546_length_605_cov_4.308300	328	373	14	4	45	0.0888889
NODE_24546_length_605_cov_4.308300	328	373	16	6	45	0.1333333
NODE_24546_length_605_cov_4.308300	328	373	18	23	45	0.5111111
NODE_24558_length_605_cov_3.120553	216	287	0	71	71	1.0000000
NODE_24561_length_605_cov_2.909091	408	487	10	7	79	0.0886076
NODE_24561_length_605_cov_2.909091	408	487	12	3	79	0.0379747
NODE_24561_length_605_cov_2.909091	408	487	14	12	79	0.1518987
NODE_24561_length_605_cov_2.909091	408	487	16	19	79	0.2405063
NODE_24561_length_605_cov_2.909091	408	487	18	24	79	0.3037975
NODE_24561_length_605_cov_2.909091	408	487	19	2	79	0.0253165
NODE_24561_length_605_cov_2.909091	408	487	20	6	79	0.0759494
NODE_24561_length_605_cov_2.909091	408	487	21	6	79	0.0759494
NODE_24577_length_605_cov_1.897233	230	273	2	43	43	1.0000000
NODE_24603_length_605_cov_1.339921	168	210	0	42	42	1.0000000
NODE_24636_length_604_cov_30.411881	93	173	0	80	80	1.0000000
NODE_24636_length_604_cov_30.411881	146	226	0	80	80	1.0000000
NODE_24637_length_604_cov_20.099010	414	494	0	80	80	1.0000000
NODE_24637_length_604_cov_20.099010	467	547	0	80	80	1.0000000
NODE_24639_length_604_cov_10.291089	184	264	2	26	80	0.3250000
NODE_24639_length_604_cov_10.291089	184	264	4	54	80	0.6750000
NODE_24639_length_604_cov_10.291089	237	317	0	22	80	0.2750000
NODE_24639_length_604_cov_10.291089	237	317	2	57	80	0.7125000
NODE_24639_length_604_cov_10.291089	237	317	4	1	80	0.0125000
NODE_24646_length_604_cov_6.033663	265	345	0	16	80	0.2000000
NODE_24646_length_604_cov_6.033663	265	345	2	12	80	0.1500000
NODE_24646_length_604_cov_6.033663	265	345	6	52	80	0.6500000
NODE_24646_length_604_cov_6.033663	318	397	6	27	79	0.3417721
NODE_24646_length_604_cov_6.033663	318	397	10	1	79	0.0126582
NODE_24646_length_604_cov_6.033663	318	397	12	8	79	0.1012658
NODE_24646_length_604_cov_6.033663	318	397	14	9	79	0.1139240
NODE_24646_length_604_cov_6.033663	318	397	16	34	79	0.4303797
NODE_24654_length_604_cov_4.316832	40	106	0	66	66	1.0000000
NODE_24654_length_604_cov_4.316832	377	435	0	58	58	1.0000000
NODE_24692_length_604_cov_1.805941	299	380	0	45	81	0.5555556
NODE_24692_length_604_cov_1.805941	299	380	2	36	81	0.4444444
NODE_24692_length_604_cov_1.805941	353	433	0	80	80	1.0000000
NODE_24732_length_603_cov_18.761905	108	188	2	80	80	1.0000000
NODE_24732_length_603_cov_18.761905	161	241	0	28	80	0.3500000
NODE_24732_length_603_cov_18.761905	161	241	2	52	80	0.6500000
NODE_24734_length_603_cov_8.996032	163	243	2	62	80	0.7750000
NODE_24734_length_603_cov_8.996032	163	243	3	6	80	0.0750000
NODE_24734_length_603_cov_8.996032	163	243	4	11	80	0.1375000
NODE_24734_length_603_cov_8.996032	163	243	5	1	80	0.0125000
NODE_24734_length_603_cov_8.996032	216	296	0	18	80	0.2250000
NODE_24734_length_603_cov_8.996032	216	296	2	62	80	0.7750000
NODE_24735_length_603_cov_8.970238	413	493	2	2	80	0.0250000
NODE_24735_length_603_cov_8.970238	413	493	4	21	80	0.2625000
NODE_24735_length_603_cov_8.970238	413	493	6	57	80	0.7125000
NODE_24736_length_603_cov_7.212302	324	404	0	80	80	1.0000000
NODE_24736_length_603_cov_7.212302	377	457	0	80	80	1.0000000
NODE_24739_length_603_cov_5.831349	351	385	0	34	34	1.0000000
NODE_24744_length_603_cov_4.744048	103	183	0	69	80	0.8625000
NODE_24744_length_603_cov_4.744048	103	183	2	11	80	0.1375000
NODE_24744_length_603_cov_4.744048	156	236	0	16	80	0.2000000
NODE_24744_length_603_cov_4.744048	156	236	2	64	80	0.8000000
NODE_24748_length_603_cov_4.115079	219	259	0	13	40	0.3250000
NODE_24748_length_603_cov_4.115079	219	259	2	22	40	0.5500000
NODE_24748_length_603_cov_4.115079	219	259	4	5	40	0.1250000
NODE_24755_length_603_cov_3.269841	186	223	0	37	37	1.0000000
NODE_24755_length_603_cov_3.269841	196	276	0	80	80	1.0000000
NODE_24755_length_603_cov_3.269841	367	441	0	74	74	1.0000000
NODE_24843_length_602_cov_33.208748	106	186	0	62	80	0.7750000
NODE_24843_length_602_cov_33.208748	106	186	2	18	80	0.2250000
NODE_24843_length_602_cov_33.208748	159	239	0	9	80	0.1125000
NODE_24843_length_602_cov_33.208748	159	239	2	71	80	0.8875000
NODE_24844_length_602_cov_28.922465	319	399	10	10	80	0.1250000
NODE_24844_length_602_cov_28.922465	319	399	12	70	80	0.8750000
NODE_24844_length_602_cov_28.922465	372	452	0	14	80	0.1750000
NODE_24844_length_602_cov_28.922465	372	452	5	1	80	0.0125000
NODE_24844_length_602_cov_28.922465	372	452	7	13	80	0.1625000
NODE_24844_length_602_cov_28.922465	372	452	12	52	80	0.6500000
NODE_24846_length_602_cov_10.930417	248	328	0	58	80	0.7250000
NODE_24846_length_602_cov_10.930417	248	328	2	22	80	0.2750000
NODE_24846_length_602_cov_10.930417	301	381	0	80	80	1.0000000
NODE_24847_length_602_cov_10.447316	148	207	8	35	59	0.5932204
NODE_24847_length_602_cov_10.447316	148	207	10	16	59	0.2711864
NODE_24847_length_602_cov_10.447316	148	207	11	8	59	0.1355932
NODE_24847_length_602_cov_10.447316	181	207	8	26	26	1.0000000
NODE_24847_length_602_cov_10.447316	259	291	2	32	32	1.0000000
NODE_24851_length_602_cov_7.787276	544	565	0	21	21	1.0000000
NODE_24875_length_602_cov_3.332008	157	239	0	82	82	1.0000000
NODE_24957_length_601_cov_14.952191	183	263	0	80	80	1.0000000
NODE_24957_length_601_cov_14.952191	236	316	0	80	80	1.0000000
NODE_24958_length_601_cov_14.747012	324	404	0	58	80	0.7250000
NODE_24958_length_601_cov_14.747012	324	404	2	22	80	0.2750000
NODE_24958_length_601_cov_14.747012	377	457	0	5	80	0.0625000
NODE_24958_length_601_cov_14.747012	377	457	2	75	80	0.9375000
NODE_24959_length_601_cov_11.561753	226	306	0	28	80	0.3500000
NODE_24959_length_601_cov_11.561753	226	306	2	52	80	0.6500000
NODE_24959_length_601_cov_11.561753	279	359	0	80	80	1.0000000
NODE_24960_length_601_cov_10.826693	320	388	0	43	68	0.6323529
NODE_24960_length_601_cov_10.826693	320	388	2	25	68	0.3676471
NODE_24961_length_601_cov_10.392430	243	323	0	80	80	1.0000000
NODE_24961_length_601_cov_10.392430	296	375	0	79	79	1.0000000
NODE_24965_length_601_cov_7.037849	236	316	2	80	80	1.0000000
NODE_24965_length_601_cov_7.037849	289	369	0	48	80	0.6000000
NODE_24965_length_601_cov_7.037849	289	369	2	32	80	0.4000000
NODE_24969_length_601_cov_5.798805	290	361	0	71	71	1.0000000
NODE_24970_length_601_cov_5.657371	228	308	2	7	80	0.0875000
NODE_24970_length_601_cov_5.657371	228	308	4	17	80	0.2125000
NODE_24970_length_601_cov_5.657371	228	308	6	14	80	0.1750000
NODE_24970_length_601_cov_5.657371	228	308	15	26	80	0.3250000
NODE_24970_length_601_cov_5.657371	228	308	16	7	80	0.0875000
NODE_24970_length_601_cov_5.657371	228	308	17	9	80	0.1125000
NODE_24973_length_601_cov_5.039841	395	462	0	16	67	0.2388060
NODE_24973_length_601_cov_5.039841	395	462	2	51	67	0.7611941
NODE_24975_length_601_cov_4.735060	184	247	0	63	63	1.0000000
NODE_24995_length_601_cov_2.599602	371	430	0	59	59	1.0000000
NODE_24995_length_601_cov_2.599602	441	494	0	53	53	1.0000000
NODE_25090_length_600_cov_6.341317	125	147	0	22	22	1.0000000
NODE_25103_length_600_cov_3.754491	142	222	6	6	80	0.0750000
NODE_25103_length_600_cov_3.754491	142	222	10	21	80	0.2625000
NODE_25103_length_600_cov_3.754491	142	222	14	53	80	0.6625000
NODE_25126_length_600_cov_2.081836	282	328	0	46	46	1.0000000
NODE_25141_length_600_cov_1.728543	381	423	0	42	42	1.0000000
NODE_25190_length_599_cov_36.488000	25	105	10	80	80	1.0000000
NODE_25191_length_599_cov_27.870000	255	335	0	38	80	0.4750000
NODE_25191_length_599_cov_27.870000	255	335	2	42	80	0.5250000
NODE_25191_length_599_cov_27.870000	308	388	0	8	80	0.1000000
NODE_25191_length_599_cov_27.870000	308	388	2	72	80	0.9000000
NODE_25192_length_599_cov_22.640000	229	309	0	10	80	0.1250000
NODE_25192_length_599_cov_22.640000	229	309	2	4	80	0.0500000
NODE_25192_length_599_cov_22.640000	229	309	5	41	80	0.5125000
NODE_25192_length_599_cov_22.640000	229	309	6	25	80	0.3125000
NODE_25192_length_599_cov_22.640000	229	309	0	10	80	0.1250000
NODE_25192_length_599_cov_22.640000	229	309	2	4	80	0.0500000
NODE_25192_length_599_cov_22.640000	229	309	5	41	80	0.5125000
NODE_25192_length_599_cov_22.640000	229	309	6	25	80	0.3125000
NODE_25192_length_599_cov_22.640000	229	309	0	10	80	0.1250000
NODE_25192_length_599_cov_22.640000	229	309	2	4	80	0.0500000
NODE_25192_length_599_cov_22.640000	229	309	5	41	80	0.5125000
NODE_25192_length_599_cov_22.640000	229	309	6	25	80	0.3125000
NODE_25192_length_599_cov_22.640000	229	309	0	10	80	0.1250000
NODE_25192_length_599_cov_22.640000	229	309	2	4	80	0.0500000
NODE_25192_length_599_cov_22.640000	229	309	5	41	80	0.5125000
NODE_25192_length_599_cov_22.640000	229	309	6	25	80	0.3125000
NODE_25192_length_599_cov_22.640000	229	309	0	10	80	0.1250000
NODE_25192_length_599_cov_22.640000	229	309	2	4	80	0.0500000
NODE_25192_length_599_cov_22.640000	229	309	5	41	80	0.5125000
NODE_25192_length_599_cov_22.640000	229	309	6	25	80	0.3125000
NODE_25192_length_599_cov_22.640000	282	362	0	63	80	0.7875000
NODE_25192_length_599_cov_22.640000	282	362	2	4	80	0.0500000
NODE_25192_length_599_cov_22.640000	282	362	5	13	80	0.1625000
NODE_25192_length_599_cov_22.640000	282	362	0	63	80	0.7875000
NODE_25192_length_599_cov_22.640000	282	362	2	4	80	0.0500000
NODE_25192_length_599_cov_22.640000	282	362	5	13	80	0.1625000
NODE_25192_length_599_cov_22.640000	282	353	0	54	71	0.7605634
NODE_25192_length_599_cov_22.640000	282	353	2	4	71	0.0563380
NODE_25192_length_599_cov_22.640000	282	353	5	13	71	0.1830986
NODE_25192_length_599_cov_22.640000	285	355	0	56	70	0.8000000
NODE_25192_length_599_cov_22.640000	285	355	2	4	70	0.0571429
NODE_25192_length_599_cov_22.640000	285	355	5	10	70	0.1428571
NODE_25192_length_599_cov_22.640000	287	362	0	63	75	0.8400000
NODE_25192_length_599_cov_22.640000	287	362	2	4	75	0.0533333
NODE_25192_length_599_cov_22.640000	287	362	5	8	75	0.1066667
NODE_25193_length_599_cov_14.618000	279	359	0	80	80	1.0000000
NODE_25193_length_599_cov_14.618000	332	412	0	80	80	1.0000000
NODE_25195_length_599_cov_10.308000	245	325	0	80	80	1.0000000
NODE_25195_length_599_cov_10.308000	298	378	0	80	80	1.0000000
NODE_25196_length_599_cov_9.224000	160	240	0	80	80	1.0000000
NODE_25196_length_599_cov_9.224000	213	297	0	84	84	1.0000000
NODE_25201_length_599_cov_5.536000	58	112	0	54	54	1.0000000
NODE_25208_length_599_cov_3.810000	271	334	0	63	63	1.0000000
NODE_25208_length_599_cov_3.810000	324	390	0	66	66	1.0000000
NODE_25211_length_599_cov_3.598000	238	318	2	80	80	1.0000000
NODE_25211_length_599_cov_3.598000	291	371	0	49	80	0.6125000
NODE_25211_length_599_cov_3.598000	291	371	2	31	80	0.3875000
NODE_25308_length_598_cov_54.450902	264	344	0	18	80	0.2250000
NODE_25308_length_598_cov_54.450902	264	344	2	18	80	0.2250000
NODE_25308_length_598_cov_54.450902	264	344	4	44	80	0.5500000
NODE_25308_length_598_cov_54.450902	317	397	0	20	80	0.2500000
NODE_25308_length_598_cov_54.450902	317	397	2	1	80	0.0125000
NODE_25308_length_598_cov_54.450902	317	397	4	59	80	0.7375000
NODE_25309_length_598_cov_8.326653	204	284	0	80	80	1.0000000
NODE_25309_length_598_cov_8.326653	257	337	0	80	80	1.0000000
NODE_25316_length_598_cov_5.623246	169	240	2	27	71	0.3802817
NODE_25316_length_598_cov_5.623246	169	240	4	10	71	0.1408451
NODE_25316_length_598_cov_5.623246	169	240	6	25	71	0.3521127
NODE_25316_length_598_cov_5.623246	169	240	8	9	71	0.1267606
NODE_25320_length_598_cov_4.929860	73	153	0	80	80	1.0000000
NODE_25320_length_598_cov_4.929860	126	206	0	80	80	1.0000000
NODE_25421_length_597_cov_15.142570	197	277	0	4	80	0.0500000
NODE_25421_length_597_cov_15.142570	197	277	4	76	80	0.9500000
NODE_25421_length_597_cov_15.142570	250	330	0	52	80	0.6500000
NODE_25421_length_597_cov_15.142570	250	330	4	28	80	0.3500000
NODE_25422_length_597_cov_12.387550	118	198	0	45	80	0.5625000
NODE_25422_length_597_cov_12.387550	118	198	2	14	80	0.1750000
NODE_25422_length_597_cov_12.387550	118	198	4	21	80	0.2625000
NODE_25422_length_597_cov_12.387550	171	251	0	80	80	1.0000000
NODE_25423_length_597_cov_7.016064	213	293	0	80	80	1.0000000
NODE_25423_length_597_cov_7.016064	266	346	0	80	80	1.0000000
NODE_25426_length_597_cov_6.212851	374	449	0	73	75	0.9733334
NODE_25426_length_597_cov_6.212851	374	449	2	2	75	0.0266667
NODE_25434_length_597_cov_4.273092	368	448	0	11	80	0.1375000
NODE_25434_length_597_cov_4.273092	368	448	2	69	80	0.8625000
NODE_25434_length_597_cov_4.273092	421	507	0	51	86	0.5930232
NODE_25434_length_597_cov_4.273092	421	507	2	35	86	0.4069767
NODE_25464_length_597_cov_2.162651	92	172	0	80	80	1.0000000
NODE_25464_length_597_cov_2.162651	145	225	0	80	80	1.0000000
NODE_25467_length_597_cov_2.096386	440	509	0	18	69	0.2608696
NODE_25467_length_597_cov_2.096386	440	509	2	51	69	0.7391304
NODE_25469_length_597_cov_1.977912	392	472	8	21	80	0.2625000
NODE_25469_length_597_cov_1.977912	392	472	10	24	80	0.3000000
NODE_25469_length_597_cov_1.977912	392	472	12	35	80	0.4375000
NODE_25469_length_597_cov_1.977912	437	494	4	1	57	0.0175439
NODE_25469_length_597_cov_1.977912	437	494	6	17	57	0.2982456
NODE_25469_length_597_cov_1.977912	437	494	8	18	57	0.3157895
NODE_25469_length_597_cov_1.977912	437	494	10	16	57	0.2807018
NODE_25469_length_597_cov_1.977912	437	494	12	5	57	0.0877193
NODE_25469_length_597_cov_1.977912	445	525	2	3	80	0.0375000
NODE_25469_length_597_cov_1.977912	445	525	4	29	80	0.3625000
NODE_25469_length_597_cov_1.977912	445	525	6	17	80	0.2125000
NODE_25469_length_597_cov_1.977912	445	525	8	18	80	0.2250000
NODE_25469_length_597_cov_1.977912	445	525	10	13	80	0.1625000
NODE_25552_length_596_cov_32.293763	221	301	0	61	80	0.7625000
NODE_25552_length_596_cov_32.293763	221	301	2	19	80	0.2375000
NODE_25552_length_596_cov_32.293763	274	354	0	8	80	0.1000000
NODE_25552_length_596_cov_32.293763	274	354	2	72	80	0.9000000
NODE_25552_length_596_cov_32.293763	351	406	0	51	55	0.9272727
NODE_25552_length_596_cov_32.293763	351	406	2	4	55	0.0727273
NODE_25552_length_596_cov_32.293763	381	459	0	78	78	1.0000000
NODE_25553_length_596_cov_26.891348	199	279	6	6	80	0.0750000
NODE_25553_length_596_cov_26.891348	199	279	10	26	80	0.3250000
NODE_25553_length_596_cov_26.891348	199	279	11	4	80	0.0500000
NODE_25553_length_596_cov_26.891348	199	279	13	23	80	0.2875000
NODE_25553_length_596_cov_26.891348	199	279	14	21	80	0.2625000
NODE_25553_length_596_cov_26.891348	252	332	0	26	80	0.3250000
NODE_25553_length_596_cov_26.891348	252	332	2	8	80	0.1000000
NODE_25553_length_596_cov_26.891348	252	332	6	25	80	0.3125000
NODE_25553_length_596_cov_26.891348	252	332	11	4	80	0.0500000
NODE_25553_length_596_cov_26.891348	252	332	13	17	80	0.2125000
NODE_25554_length_596_cov_17.082495	179	259	2	80	80	1.0000000
NODE_25554_length_596_cov_17.082495	232	312	0	35	80	0.4375000
NODE_25554_length_596_cov_17.082495	232	312	2	45	80	0.5625000
NODE_25555_length_596_cov_10.372233	354	434	0	80	80	1.0000000
NODE_25555_length_596_cov_10.372233	407	487	0	80	80	1.0000000
NODE_25557_length_596_cov_6.955734	142	222	4	80	80	1.0000000
NODE_25558_length_596_cov_6.225352	242	322	0	75	80	0.9375000
NODE_25558_length_596_cov_6.225352	242	322	2	5	80	0.0625000
NODE_25558_length_596_cov_6.225352	308	375	0	67	67	1.0000000
NODE_25567_length_596_cov_4.197183	369	444	0	47	75	0.6266667
NODE_25567_length_596_cov_4.197183	369	444	2	28	75	0.3733333
NODE_25593_length_596_cov_2.066398	534	583	0	49	49	1.0000000
NODE_25666_length_595_cov_52.532258	248	328	2	9	80	0.1125000
NODE_25666_length_595_cov_52.532258	248	328	6	71	80	0.8875000
NODE_25666_length_595_cov_52.532258	301	381	0	2	80	0.0250000
NODE_25666_length_595_cov_52.532258	301	381	4	33	80	0.4125000
NODE_25666_length_595_cov_52.532258	301	381	6	45	80	0.5625000
NODE_25667_length_595_cov_38.584677	122	202	0	45	80	0.5625000
NODE_25667_length_595_cov_38.584677	122	202	4	17	80	0.2125000
NODE_25667_length_595_cov_38.584677	122	202	5	1	80	0.0125000
NODE_25667_length_595_cov_38.584677	122	202	6	17	80	0.2125000
NODE_25667_length_595_cov_38.584677	175	255	4	20	80	0.2500000
NODE_25667_length_595_cov_38.584677	175	255	5	1	80	0.0125000
NODE_25667_length_595_cov_38.584677	175	255	6	55	80	0.6875000
NODE_25667_length_595_cov_38.584677	175	255	8	4	80	0.0500000
NODE_25669_length_595_cov_10.576613	323	403	0	80	80	1.0000000
NODE_25669_length_595_cov_10.576613	376	456	0	43	80	0.5375000
NODE_25669_length_595_cov_10.576613	376	456	2	37	80	0.4625000
NODE_25672_length_595_cov_7.917339	342	415	0	18	73	0.2465753
NODE_25672_length_595_cov_7.917339	342	415	2	2	73	0.0273973
NODE_25672_length_595_cov_7.917339	342	415	6	4	73	0.0547945
NODE_25672_length_595_cov_7.917339	342	415	8	28	73	0.3835616
NODE_25672_length_595_cov_7.917339	342	415	10	21	73	0.2876712
NODE_25672_length_595_cov_7.917339	388	438	8	15	50	0.3000000
NODE_25672_length_595_cov_7.917339	388	438	10	35	50	0.7000000
NODE_25702_length_595_cov_2.792339	178	258	4	13	80	0.1625000
NODE_25702_length_595_cov_2.792339	178	258	8	51	80	0.6375000
NODE_25702_length_595_cov_2.792339	178	258	10	16	80	0.2000000
NODE_25702_length_595_cov_2.792339	231	311	2	35	80	0.4375000
NODE_25702_length_595_cov_2.792339	231	311	6	13	80	0.1625000
NODE_25702_length_595_cov_2.792339	231	311	8	32	80	0.4000000
NODE_25807_length_594_cov_34.157576	283	363	2	47	80	0.5875000
NODE_25807_length_594_cov_34.157576	283	363	4	18	80	0.2250000
NODE_25807_length_594_cov_34.157576	283	363	6	15	80	0.1875000
NODE_25807_length_594_cov_34.157576	336	416	0	15	80	0.1875000
NODE_25807_length_594_cov_34.157576	336	416	4	56	80	0.7000000
NODE_25807_length_594_cov_34.157576	336	416	6	9	80	0.1125000
NODE_25811_length_594_cov_8.933333	258	338	0	49	80	0.6125000
NODE_25811_length_594_cov_8.933333	258	338	2	31	80	0.3875000
NODE_25811_length_594_cov_8.933333	311	389	2	78	78	1.0000000
NODE_25815_length_594_cov_5.759596	82	118	2	36	36	1.0000000
NODE_25815_length_594_cov_5.759596	114	194	0	57	80	0.7125000
NODE_25815_length_594_cov_5.759596	114	194	2	23	80	0.2875000
NODE_25815_length_594_cov_5.759596	167	242	0	75	75	1.0000000
NODE_25825_length_594_cov_3.913131	275	355	2	80	80	1.0000000
NODE_25844_length_594_cov_2.470707	209	247	3	8	38	0.2105263
NODE_25844_length_594_cov_2.470707	209	247	4	30	38	0.7894737
NODE_25919_length_594_cov_0.698990	33	73	0	40	40	1.0000000
NODE_25928_length_593_cov_124.985830	247	285	53	6	38	0.1578947
NODE_25928_length_593_cov_124.985830	247	285	55	6	38	0.1578947
NODE_25928_length_593_cov_124.985830	247	285	58	2	38	0.0526316
NODE_25928_length_593_cov_124.985830	247	285	70	1	38	0.0263158
NODE_25928_length_593_cov_124.985830	247	285	72	1	38	0.0263158
NODE_25928_length_593_cov_124.985830	247	285	75	2	38	0.0526316
NODE_25928_length_593_cov_124.985830	247	285	85	2	38	0.0526316
NODE_25928_length_593_cov_124.985830	247	285	90	5	38	0.1315790
NODE_25928_length_593_cov_124.985830	247	285	95	1	38	0.0263158
NODE_25928_length_593_cov_124.985830	247	285	99	2	38	0.0526316
NODE_25928_length_593_cov_124.985830	247	285	103	2	38	0.0526316
NODE_25928_length_593_cov_124.985830	247	285	105	1	38	0.0263158
NODE_25928_length_593_cov_124.985830	247	285	106	1	38	0.0263158
NODE_25928_length_593_cov_124.985830	247	285	108	5	38	0.1315790
NODE_25928_length_593_cov_124.985830	247	285	112	1	38	0.0263158
NODE_25929_length_593_cov_36.161943	150	230	0	9	80	0.1125000
NODE_25929_length_593_cov_36.161943	150	230	2	71	80	0.8875000
NODE_25929_length_593_cov_36.161943	203	283	0	62	80	0.7750000
NODE_25929_length_593_cov_36.161943	203	283	2	18	80	0.2250000
NODE_25930_length_593_cov_14.979757	219	299	0	80	80	1.0000000
NODE_25930_length_593_cov_14.979757	272	352	0	80	80	1.0000000
NODE_25931_length_593_cov_11.018219	324	404	0	29	80	0.3625000
NODE_25931_length_593_cov_11.018219	324	404	2	10	80	0.1250000
NODE_25931_length_593_cov_11.018219	324	404	4	41	80	0.5125000
NODE_25931_length_593_cov_11.018219	377	457	0	4	80	0.0500000
NODE_25931_length_593_cov_11.018219	377	457	2	39	80	0.4875000
NODE_25931_length_593_cov_11.018219	377	457	4	37	80	0.4625000
NODE_25946_length_593_cov_3.232794	210	273	2	63	63	1.0000000
NODE_25946_length_593_cov_3.232794	263	326	0	8	63	0.1269841
NODE_25946_length_593_cov_3.232794	263	326	1	11	63	0.1746032
NODE_25946_length_593_cov_3.232794	263	326	2	44	63	0.6984127
NODE_25996_length_593_cov_1.261134	227	249	0	22	22	1.0000000
NODE_26033_length_592_cov_18.908722	163	243	0	80	80	1.0000000
NODE_26033_length_592_cov_18.908722	230	296	0	66	66	1.0000000
NODE_26034_length_592_cov_7.531440	232	312	0	44	80	0.5500000
NODE_26034_length_592_cov_7.531440	232	312	2	36	80	0.4500000
NODE_26034_length_592_cov_7.531440	285	361	2	65	76	0.8552632
NODE_26034_length_592_cov_7.531440	285	361	4	11	76	0.1447368
NODE_26035_length_592_cov_7.000000	77	157	0	80	80	1.0000000
NODE_26035_length_592_cov_7.000000	130	210	0	80	80	1.0000000
NODE_26040_length_592_cov_5.036511	270	349	4	15	79	0.1898734
NODE_26040_length_592_cov_5.036511	270	349	6	64	79	0.8101266
NODE_26041_length_592_cov_5.024341	205	285	0	26	80	0.3250000
NODE_26041_length_592_cov_5.024341	205	285	2	4	80	0.0500000
NODE_26041_length_592_cov_5.024341	205	285	4	28	80	0.3500000
NODE_26041_length_592_cov_5.024341	205	285	6	18	80	0.2250000
NODE_26041_length_592_cov_5.024341	205	285	8	4	80	0.0500000
NODE_26041_length_592_cov_5.024341	258	309	4	5	51	0.0980392
NODE_26041_length_592_cov_5.024341	258	309	6	25	51	0.4901961
NODE_26041_length_592_cov_5.024341	258	309	8	21	51	0.4117647
NODE_26062_length_592_cov_2.866126	61	127	0	66	66	1.0000000
NODE_26069_length_592_cov_2.361055	476	526	2	50	50	1.0000000
NODE_26142_length_591_cov_11.286585	245	325	0	50	80	0.6250000
NODE_26142_length_591_cov_11.286585	245	325	2	30	80	0.3750000
NODE_26142_length_591_cov_11.286585	298	378	0	80	80	1.0000000
NODE_26143_length_591_cov_9.432927	241	321	0	80	80	1.0000000
NODE_26143_length_591_cov_9.432927	294	374	0	80	80	1.0000000
NODE_26184_length_591_cov_2.365854	396	476	0	47	80	0.5875000
NODE_26184_length_591_cov_2.365854	396	476	2	33	80	0.4125000
NODE_26184_length_591_cov_2.365854	449	529	2	80	80	1.0000000
NODE_26272_length_590_cov_29.661914	26	106	0	33	80	0.4125000
NODE_26272_length_590_cov_29.661914	26	106	2	47	80	0.5875000
NODE_26272_length_590_cov_29.661914	79	159	0	30	80	0.3750000
NODE_26272_length_590_cov_29.661914	79	159	2	50	80	0.6250000
NODE_26272_length_590_cov_29.661914	155	235	0	80	80	1.0000000
NODE_26272_length_590_cov_29.661914	208	288	0	80	80	1.0000000
NODE_26273_length_590_cov_21.360489	178	258	2	27	80	0.3375000
NODE_26273_length_590_cov_21.360489	178	258	4	53	80	0.6625000
NODE_26273_length_590_cov_21.360489	231	311	0	28	80	0.3500000
NODE_26273_length_590_cov_21.360489	231	311	2	45	80	0.5625000
NODE_26273_length_590_cov_21.360489	231	311	4	7	80	0.0875000
NODE_26274_length_590_cov_18.395112	161	241	0	9	80	0.1125000
NODE_26274_length_590_cov_18.395112	161	241	2	71	80	0.8875000
NODE_26274_length_590_cov_18.395112	214	294	2	80	80	1.0000000
NODE_26275_length_590_cov_17.376782	238	318	8	4	80	0.0500000
NODE_26275_length_590_cov_17.376782	238	318	12	14	80	0.1750000
NODE_26275_length_590_cov_17.376782	238	318	14	44	80	0.5500000
NODE_26275_length_590_cov_17.376782	238	318	16	18	80	0.2250000
NODE_26275_length_590_cov_17.376782	291	371	2	2	80	0.0250000
NODE_26275_length_590_cov_17.376782	291	371	4	48	80	0.6000000
NODE_26275_length_590_cov_17.376782	291	371	8	7	80	0.0875000
NODE_26275_length_590_cov_17.376782	291	371	12	1	80	0.0125000
NODE_26275_length_590_cov_17.376782	291	371	14	21	80	0.2625000
NODE_26275_length_590_cov_17.376782	291	371	16	1	80	0.0125000
NODE_26279_length_590_cov_6.205703	262	333	0	40	71	0.5633803
NODE_26279_length_590_cov_6.205703	262	333	2	31	71	0.4366197
NODE_26283_length_590_cov_5.319756	224	304	4	21	80	0.2625000
NODE_26283_length_590_cov_5.319756	224	304	6	59	80	0.7375000
NODE_26283_length_590_cov_5.319756	277	357	2	28	80	0.3500000
NODE_26283_length_590_cov_5.319756	277	357	5	1	80	0.0125000
NODE_26283_length_590_cov_5.319756	277	357	6	51	80	0.6375000
NODE_26366_length_590_cov_0.971487	0	32	0	29	32	0.9062500
NODE_26366_length_590_cov_0.971487	0	32	2	3	32	0.0937500
NODE_26390_length_589_cov_15.810204	384	464	0	80	80	1.0000000
NODE_26390_length_589_cov_15.810204	437	517	0	80	80	1.0000000
NODE_26391_length_589_cov_13.855102	320	400	0	80	80	1.0000000
NODE_26391_length_589_cov_13.855102	373	453	0	44	80	0.5500000
NODE_26391_length_589_cov_13.855102	373	453	2	36	80	0.4500000
NODE_26395_length_589_cov_6.297959	186	266	0	1	80	0.0125000
NODE_26395_length_589_cov_6.297959	186	266	1	28	80	0.3500000
NODE_26395_length_589_cov_6.297959	186	266	2	51	80	0.6375000
NODE_26395_length_589_cov_6.297959	239	319	2	80	80	1.0000000
NODE_26430_length_589_cov_2.320408	431	511	0	37	80	0.4625000
NODE_26430_length_589_cov_2.320408	431	511	4	43	80	0.5375000
NODE_26515_length_588_cov_49.936605	264	341	0	77	77	1.0000000
NODE_26515_length_588_cov_49.936605	314	394	0	80	80	1.0000000
NODE_26516_length_588_cov_33.691207	273	353	6	40	80	0.5000000
NODE_26516_length_588_cov_33.691207	273	353	8	10	80	0.1250000
NODE_26516_length_588_cov_33.691207	273	353	12	30	80	0.3750000
NODE_26516_length_588_cov_33.691207	326	406	9	16	80	0.2000000
NODE_26516_length_588_cov_33.691207	326	406	10	1	80	0.0125000
NODE_26516_length_588_cov_33.691207	326	406	12	63	80	0.7875000
NODE_26517_length_588_cov_16.564417	245	325	0	80	80	1.0000000
NODE_26517_length_588_cov_16.564417	298	378	0	80	80	1.0000000
NODE_26518_length_588_cov_14.595092	266	346	0	80	80	1.0000000
NODE_26518_length_588_cov_14.595092	319	399	0	80	80	1.0000000
NODE_26522_length_588_cov_7.439673	155	235	1	7	80	0.0875000
NODE_26522_length_588_cov_7.439673	155	235	2	73	80	0.9125000
NODE_26522_length_588_cov_7.439673	208	288	1	60	80	0.7500000
NODE_26522_length_588_cov_7.439673	208	288	2	20	80	0.2500000
NODE_26523_length_588_cov_7.094070	191	263	0	7	72	0.0972222
NODE_26523_length_588_cov_7.094070	191	263	2	20	72	0.2777778
NODE_26523_length_588_cov_7.094070	191	263	4	45	72	0.6250000
NODE_26523_length_588_cov_7.094070	244	310	2	12	66	0.1818182
NODE_26523_length_588_cov_7.094070	244	310	4	20	66	0.3030303
NODE_26523_length_588_cov_7.094070	244	310	8	4	66	0.0606061
NODE_26523_length_588_cov_7.094070	244	310	10	13	66	0.1969697
NODE_26523_length_588_cov_7.094070	244	310	12	17	66	0.2575758
NODE_26523_length_588_cov_7.094070	439	519	0	39	80	0.4875000
NODE_26523_length_588_cov_7.094070	439	519	2	41	80	0.5125000
NODE_26523_length_588_cov_7.094070	492	572	0	18	80	0.2250000
NODE_26523_length_588_cov_7.094070	492	572	2	62	80	0.7750000
NODE_26534_length_588_cov_4.167689	65	122	0	14	57	0.2456140
NODE_26534_length_588_cov_4.167689	65	122	2	10	57	0.1754386
NODE_26534_length_588_cov_4.167689	65	122	4	33	57	0.5789474
NODE_26634_length_587_cov_39.782787	123	203	4	80	80	1.0000000
NODE_26634_length_587_cov_39.782787	176	256	0	36	80	0.4500000
NODE_26634_length_587_cov_39.782787	176	256	4	44	80	0.5500000
NODE_26634_length_587_cov_39.782787	252	332	0	80	80	1.0000000
NODE_26634_length_587_cov_39.782787	305	385	0	80	80	1.0000000
NODE_26635_length_587_cov_31.807377	141	221	0	80	80	1.0000000
NODE_26635_length_587_cov_31.807377	194	274	0	80	80	1.0000000
NODE_26636_length_587_cov_12.629098	219	299	10	21	80	0.2625000
NODE_26636_length_587_cov_12.629098	219	299	12	4	80	0.0500000
NODE_26636_length_587_cov_12.629098	219	299	14	22	80	0.2750000
NODE_26636_length_587_cov_12.629098	219	299	16	6	80	0.0750000
NODE_26636_length_587_cov_12.629098	219	299	18	19	80	0.2375000
NODE_26636_length_587_cov_12.629098	219	299	20	8	80	0.1000000
NODE_26636_length_587_cov_12.629098	272	352	4	2	80	0.0250000
NODE_26636_length_587_cov_12.629098	272	352	6	32	80	0.4000000
NODE_26636_length_587_cov_12.629098	272	352	8	12	80	0.1500000
NODE_26636_length_587_cov_12.629098	272	352	10	28	80	0.3500000
NODE_26636_length_587_cov_12.629098	272	352	14	6	80	0.0750000
NODE_26639_length_587_cov_9.067623	203	283	0	50	80	0.6250000
NODE_26639_length_587_cov_9.067623	203	283	2	30	80	0.3750000
NODE_26639_length_587_cov_9.067623	256	336	2	80	80	1.0000000
NODE_26640_length_587_cov_8.411885	253	311	0	58	58	1.0000000
NODE_26656_length_587_cov_3.231557	201	256	2	4	55	0.0727273
NODE_26656_length_587_cov_3.231557	201	256	6	51	55	0.9272727
NODE_26665_length_587_cov_2.850410	255	288	4	33	33	1.0000000
NODE_26749_length_586_cov_37.843943	268	348	0	41	80	0.5125000
NODE_26749_length_586_cov_37.843943	268	348	8	39	80	0.4875000
NODE_26749_length_586_cov_37.843943	321	401	8	68	80	0.8500000
NODE_26749_length_586_cov_37.843943	321	401	10	12	80	0.1500000
NODE_26749_length_586_cov_37.843943	397	477	0	4	80	0.0500000
NODE_26749_length_586_cov_37.843943	397	477	2	64	80	0.8000000
NODE_26749_length_586_cov_37.843943	397	477	10	12	80	0.1500000
NODE_26749_length_586_cov_37.843943	450	531	0	58	81	0.7160494
NODE_26749_length_586_cov_37.843943	450	531	2	23	81	0.2839506
NODE_26750_length_586_cov_12.831622	186	266	0	80	80	1.0000000
NODE_26750_length_586_cov_12.831622	239	319	0	80	80	1.0000000
NODE_26752_length_586_cov_11.264887	108	188	0	80	80	1.0000000
NODE_26752_length_586_cov_11.264887	161	241	0	80	80	1.0000000
NODE_26754_length_586_cov_9.624230	299	360	2	61	61	1.0000000
NODE_26754_length_586_cov_9.624230	299	360	2	61	61	1.0000000
NODE_26754_length_586_cov_9.624230	299	360	2	61	61	1.0000000
NODE_26754_length_586_cov_9.624230	301	360	2	59	59	1.0000000
NODE_26756_length_586_cov_8.591376	273	353	0	5	80	0.0625000
NODE_26756_length_586_cov_8.591376	273	353	4	75	80	0.9375000
NODE_26756_length_586_cov_8.591376	326	406	0	11	80	0.1375000
NODE_26756_length_586_cov_8.591376	326	406	4	69	80	0.8625000
NODE_26758_length_586_cov_6.135524	334	375	0	41	41	1.0000000
NODE_26758_length_586_cov_6.135524	334	375	0	41	41	1.0000000
NODE_26760_length_586_cov_5.634497	150	230	0	80	80	1.0000000
NODE_26760_length_586_cov_5.634497	203	283	0	80	80	1.0000000
NODE_26765_length_586_cov_4.626283	296	362	6	10	66	0.1515152
NODE_26765_length_586_cov_4.626283	296	362	8	56	66	0.8484849
NODE_26765_length_586_cov_4.626283	453	533	2	9	80	0.1125000
NODE_26765_length_586_cov_4.626283	453	533	6	28	80	0.3500000
NODE_26765_length_586_cov_4.626283	453	533	8	43	80	0.5375000
NODE_26885_length_585_cov_112.094650	456	536	140	2	80	0.0250000
NODE_26885_length_585_cov_112.094650	456	536	144	1	80	0.0125000
NODE_26885_length_585_cov_112.094650	456	536	146	1	80	0.0125000
NODE_26885_length_585_cov_112.094650	456	536	157	3	80	0.0375000
NODE_26885_length_585_cov_112.094650	456	536	161	2	80	0.0250000
NODE_26885_length_585_cov_112.094650	456	536	163	1	80	0.0125000
NODE_26885_length_585_cov_112.094650	456	536	168	1	80	0.0125000
NODE_26885_length_585_cov_112.094650	456	536	169	4	80	0.0500000
NODE_26885_length_585_cov_112.094650	456	536	170	5	80	0.0625000
NODE_26885_length_585_cov_112.094650	456	536	171	2	80	0.0250000
NODE_26885_length_585_cov_112.094650	456	536	173	2	80	0.0250000
NODE_26885_length_585_cov_112.094650	456	536	175	1	80	0.0125000
NODE_26885_length_585_cov_112.094650	456	536	176	1	80	0.0125000
NODE_26885_length_585_cov_112.094650	456	536	177	2	80	0.0250000
NODE_26885_length_585_cov_112.094650	456	536	180	2	80	0.0250000
NODE_26885_length_585_cov_112.094650	456	536	182	1	80	0.0125000
NODE_26885_length_585_cov_112.094650	456	536	183	2	80	0.0250000
NODE_26885_length_585_cov_112.094650	456	536	184	3	80	0.0375000
NODE_26885_length_585_cov_112.094650	456	536	186	3	80	0.0375000
NODE_26885_length_585_cov_112.094650	456	536	187	2	80	0.0250000
NODE_26885_length_585_cov_112.094650	456	536	188	1	80	0.0125000
NODE_26885_length_585_cov_112.094650	456	536	189	8	80	0.1000000
NODE_26885_length_585_cov_112.094650	456	536	192	7	80	0.0875000
NODE_26885_length_585_cov_112.094650	456	536	193	12	80	0.1500000
NODE_26885_length_585_cov_112.094650	456	536	195	11	80	0.1375000
NODE_26885_length_585_cov_112.094650	509	585	6	1	76	0.0131579
NODE_26885_length_585_cov_112.094650	509	585	8	1	76	0.0131579
NODE_26885_length_585_cov_112.094650	509	585	10	6	76	0.0789474
NODE_26885_length_585_cov_112.094650	509	585	14	2	76	0.0263158
NODE_26885_length_585_cov_112.094650	509	585	22	3	76	0.0394737
NODE_26885_length_585_cov_112.094650	509	585	29	1	76	0.0131579
NODE_26885_length_585_cov_112.094650	509	585	42	1	76	0.0131579
NODE_26885_length_585_cov_112.094650	509	585	44	3	76	0.0394737
NODE_26885_length_585_cov_112.094650	509	585	54	1	76	0.0131579
NODE_26885_length_585_cov_112.094650	509	585	58	1	76	0.0131579
NODE_26885_length_585_cov_112.094650	509	585	79	1	76	0.0131579
NODE_26885_length_585_cov_112.094650	509	585	80	3	76	0.0394737
NODE_26885_length_585_cov_112.094650	509	585	83	3	76	0.0394737
NODE_26885_length_585_cov_112.094650	509	585	85	1	76	0.0131579
NODE_26885_length_585_cov_112.094650	509	585	89	2	76	0.0263158
NODE_26885_length_585_cov_112.094650	509	585	93	2	76	0.0263158
NODE_26885_length_585_cov_112.094650	509	585	96	1	76	0.0131579
NODE_26885_length_585_cov_112.094650	509	585	98	2	76	0.0263158
NODE_26885_length_585_cov_112.094650	509	585	102	3	76	0.0394737
NODE_26885_length_585_cov_112.094650	509	585	104	4	76	0.0526316
NODE_26885_length_585_cov_112.094650	509	585	143	1	76	0.0131579
NODE_26885_length_585_cov_112.094650	509	585	144	1	76	0.0131579
NODE_26885_length_585_cov_112.094650	509	585	146	1	76	0.0131579
NODE_26885_length_585_cov_112.094650	509	585	152	1	76	0.0131579
NODE_26885_length_585_cov_112.094650	509	585	166	1	76	0.0131579
NODE_26885_length_585_cov_112.094650	509	585	168	3	76	0.0394737
NODE_26885_length_585_cov_112.094650	509	585	170	5	76	0.0657895
NODE_26885_length_585_cov_112.094650	509	585	176	1	76	0.0131579
NODE_26885_length_585_cov_112.094650	509	585	182	1	76	0.0131579
NODE_26885_length_585_cov_112.094650	509	585	184	1	76	0.0131579
NODE_26885_length_585_cov_112.094650	509	585	186	3	76	0.0394737
NODE_26885_length_585_cov_112.094650	509	585	187	2	76	0.0263158
NODE_26885_length_585_cov_112.094650	509	585	188	1	76	0.0131579
NODE_26885_length_585_cov_112.094650	509	585	189	8	76	0.1052632
NODE_26885_length_585_cov_112.094650	509	585	193	4	76	0.0526316
NODE_26886_length_585_cov_23.872428	168	248	0	80	80	1.0000000
NODE_26886_length_585_cov_23.872428	222	301	0	79	79	1.0000000
NODE_26887_length_585_cov_18.981481	360	440	0	80	80	1.0000000
NODE_26887_length_585_cov_18.981481	413	493	0	80	80	1.0000000
NODE_26888_length_585_cov_13.967078	323	387	0	64	64	1.0000000
NODE_26889_length_585_cov_10.555556	229	309	0	33	80	0.4125000
NODE_26889_length_585_cov_10.555556	229	309	2	47	80	0.5875000
NODE_26889_length_585_cov_10.555556	282	362	0	15	80	0.1875000
NODE_26889_length_585_cov_10.555556	282	362	2	65	80	0.8125000
NODE_26891_length_585_cov_9.216049	233	313	0	7	80	0.0875000
NODE_26891_length_585_cov_9.216049	233	313	2	73	80	0.9125000
NODE_26891_length_585_cov_9.216049	286	366	0	37	80	0.4625000
NODE_26891_length_585_cov_9.216049	286	366	2	43	80	0.5375000
NODE_26894_length_585_cov_8.090535	292	372	0	80	80	1.0000000
NODE_26894_length_585_cov_8.090535	345	425	0	80	80	1.0000000
NODE_26895_length_585_cov_8.018519	339	381	0	42	42	1.0000000
NODE_26895_length_585_cov_8.018519	354	419	0	65	65	1.0000000
NODE_26900_length_585_cov_4.954733	147	227	0	80	80	1.0000000
NODE_26912_length_585_cov_3.751029	288	368	8	34	80	0.4250000
NODE_26912_length_585_cov_3.751029	288	368	9	18	80	0.2250000
NODE_26912_length_585_cov_3.751029	288	368	12	7	80	0.0875000
NODE_26912_length_585_cov_3.751029	288	368	13	15	80	0.1875000
NODE_26912_length_585_cov_3.751029	288	368	16	6	80	0.0750000
NODE_26912_length_585_cov_3.751029	341	421	4	11	80	0.1375000
NODE_26912_length_585_cov_3.751029	341	421	8	69	80	0.8625000
NODE_27019_length_584_cov_21.657732	57	137	0	31	80	0.3875000
NODE_27019_length_584_cov_21.657732	57	137	6	1	80	0.0125000
NODE_27019_length_584_cov_21.657732	57	137	9	29	80	0.3625000
NODE_27019_length_584_cov_21.657732	57	137	11	19	80	0.2375000
NODE_27019_length_584_cov_21.657732	110	190	0	3	80	0.0375000
NODE_27019_length_584_cov_21.657732	110	190	6	2	80	0.0250000
NODE_27019_length_584_cov_21.657732	110	190	8	10	80	0.1250000
NODE_27019_length_584_cov_21.657732	110	190	9	8	80	0.1000000
NODE_27019_length_584_cov_21.657732	110	190	11	57	80	0.7125000
NODE_27020_length_584_cov_11.915464	280	360	0	22	80	0.2750000
NODE_27020_length_584_cov_11.915464	280	360	2	14	80	0.1750000
NODE_27020_length_584_cov_11.915464	280	360	4	44	80	0.5500000
NODE_27020_length_584_cov_11.915464	333	413	0	23	80	0.2875000
NODE_27020_length_584_cov_11.915464	333	413	2	27	80	0.3375000
NODE_27020_length_584_cov_11.915464	333	413	4	30	80	0.3750000
NODE_27021_length_584_cov_11.197938	217	297	0	33	80	0.4125000
NODE_27021_length_584_cov_11.197938	217	297	2	47	80	0.5875000
NODE_27021_length_584_cov_11.197938	270	350	0	54	80	0.6750000
NODE_27021_length_584_cov_11.197938	270	350	2	26	80	0.3250000
NODE_27022_length_584_cov_9.824742	375	441	0	66	66	1.0000000
NODE_27022_length_584_cov_9.824742	375	441	0	66	66	1.0000000
NODE_27023_length_584_cov_9.160825	369	449	0	80	80	1.0000000
NODE_27023_length_584_cov_9.160825	422	502	0	80	80	1.0000000
NODE_27023_length_584_cov_9.160825	422	502	0	80	80	1.0000000
NODE_27026_length_584_cov_7.736082	51	131	0	44	80	0.5500000
NODE_27026_length_584_cov_7.736082	51	131	2	36	80	0.4500000
NODE_27026_length_584_cov_7.736082	104	184	2	80	80	1.0000000
NODE_27031_length_584_cov_7.113402	213	293	0	39	80	0.4875000
NODE_27031_length_584_cov_7.113402	213	293	4	41	80	0.5125000
NODE_27031_length_584_cov_7.113402	266	346	2	2	80	0.0250000
NODE_27031_length_584_cov_7.113402	266	346	4	55	80	0.6875000
NODE_27031_length_584_cov_7.113402	266	346	6	23	80	0.2875000
NODE_27035_length_584_cov_5.843299	281	341	6	17	60	0.2833333
NODE_27035_length_584_cov_5.843299	281	341	10	2	60	0.0333333
NODE_27035_length_584_cov_5.843299	281	341	11	1	60	0.0166667
NODE_27035_length_584_cov_5.843299	281	341	12	40	60	0.6666667
NODE_27039_length_584_cov_5.032990	240	320	0	80	80	1.0000000
NODE_27039_length_584_cov_5.032990	293	373	0	80	80	1.0000000
NODE_27061_length_584_cov_2.707216	186	257	0	71	71	1.0000000
NODE_27147_length_583_cov_7.973140	232	312	0	80	80	1.0000000
NODE_27147_length_583_cov_7.973140	285	365	0	80	80	1.0000000
NODE_27148_length_583_cov_6.731405	328	408	0	5	80	0.0625000
NODE_27148_length_583_cov_6.731405	328	408	2	75	80	0.9375000
NODE_27148_length_583_cov_6.731405	381	461	0	58	80	0.7250000
NODE_27148_length_583_cov_6.731405	381	461	2	22	80	0.2750000
NODE_27149_length_583_cov_6.363636	161	231	0	52	70	0.7428572
NODE_27149_length_583_cov_6.363636	161	231	4	18	70	0.2571429
NODE_27152_length_583_cov_5.766529	132	186	0	44	54	0.8148148
NODE_27152_length_583_cov_5.766529	132	186	2	10	54	0.1851852
NODE_27263_length_583_cov_0.762397	9	50	0	40	41	0.9756098
NODE_27263_length_583_cov_0.762397	9	50	2	1	41	0.0243902
NODE_27278_length_582_cov_74.269151	295	375	4	17	80	0.2125000
NODE_27278_length_582_cov_74.269151	295	375	6	7	80	0.0875000
NODE_27278_length_582_cov_74.269151	295	375	8	36	80	0.4500000
NODE_27278_length_582_cov_74.269151	295	375	10	20	80	0.2500000
NODE_27278_length_582_cov_74.269151	348	428	2	39	80	0.4875000
NODE_27278_length_582_cov_74.269151	348	428	6	21	80	0.2625000
NODE_27278_length_582_cov_74.269151	348	428	10	20	80	0.2500000
NODE_27279_length_582_cov_53.093168	11	91	0	80	80	1.0000000
NODE_27279_length_582_cov_53.093168	64	144	0	80	80	1.0000000
NODE_27279_length_582_cov_53.093168	140	220	0	13	80	0.1625000
NODE_27279_length_582_cov_53.093168	140	220	2	67	80	0.8375000
NODE_27279_length_582_cov_53.093168	193	273	0	49	80	0.6125000
NODE_27279_length_582_cov_53.093168	193	273	2	31	80	0.3875000
NODE_27280_length_582_cov_47.393375	345	425	2	63	80	0.7875000
NODE_27280_length_582_cov_47.393375	345	425	4	17	80	0.2125000
NODE_27280_length_582_cov_47.393375	398	478	0	33	80	0.4125000
NODE_27280_length_582_cov_47.393375	398	478	2	45	80	0.5625000
NODE_27280_length_582_cov_47.393375	398	478	4	2	80	0.0250000
NODE_27281_length_582_cov_16.358178	297	377	0	80	80	1.0000000
NODE_27281_length_582_cov_16.358178	350	431	0	81	81	1.0000000
NODE_27282_length_582_cov_14.107660	128	208	2	38	80	0.4750000
NODE_27282_length_582_cov_14.107660	128	208	4	31	80	0.3875000
NODE_27282_length_582_cov_14.107660	128	208	6	11	80	0.1375000
NODE_27282_length_582_cov_14.107660	181	261	0	34	80	0.4250000
NODE_27282_length_582_cov_14.107660	181	261	2	46	80	0.5750000
NODE_27283_length_582_cov_7.923395	208	287	2	24	79	0.3037975
NODE_27283_length_582_cov_7.923395	208	287	4	39	79	0.4936709
NODE_27283_length_582_cov_7.923395	208	287	6	16	79	0.2025317
NODE_27283_length_582_cov_7.923395	262	340	2	70	78	0.8974359
NODE_27283_length_582_cov_7.923395	262	340	4	8	78	0.1025641
NODE_27284_length_582_cov_7.722567	216	296	0	13	80	0.1625000
NODE_27284_length_582_cov_7.722567	216	296	2	67	80	0.8375000
NODE_27284_length_582_cov_7.722567	269	349	0	26	80	0.3250000
NODE_27284_length_582_cov_7.722567	269	349	2	54	80	0.6750000
NODE_27289_length_582_cov_4.956522	294	325	2	31	31	1.0000000
NODE_27295_length_582_cov_4.308489	151	192	10	8	41	0.1951219
NODE_27295_length_582_cov_4.308489	151	192	14	23	41	0.5609756
NODE_27295_length_582_cov_4.308489	151	192	16	10	41	0.2439024
NODE_27297_length_582_cov_3.838509	223	299	4	41	76	0.5394737
NODE_27297_length_582_cov_3.838509	223	299	6	33	76	0.4342105
NODE_27297_length_582_cov_3.838509	223	299	8	2	76	0.0263158
NODE_27297_length_582_cov_3.838509	272	354	2	7	82	0.0853659
NODE_27297_length_582_cov_3.838509	272	354	4	58	82	0.7073171
NODE_27297_length_582_cov_3.838509	272	354	6	15	82	0.1829268
NODE_27297_length_582_cov_3.838509	272	354	8	2	82	0.0243902
NODE_27350_length_582_cov_1.650104	375	450	0	75	75	1.0000000
NODE_27405_length_581_cov_16.890041	244	316	2	32	72	0.4444444
NODE_27405_length_581_cov_16.890041	244	316	4	40	72	0.5555556
NODE_27413_length_581_cov_6.340249	262	342	0	80	80	1.0000000
NODE_27413_length_581_cov_6.340249	315	395	0	80	80	1.0000000
NODE_27416_length_581_cov_5.827801	122	192	6	18	70	0.2571429
NODE_27416_length_581_cov_5.827801	122	192	8	13	70	0.1857143
NODE_27416_length_581_cov_5.827801	122	192	10	31	70	0.4428571
NODE_27416_length_581_cov_5.827801	122	192	12	8	70	0.1142857
NODE_27420_length_581_cov_5.072614	392	466	0	56	74	0.7567568
NODE_27420_length_581_cov_5.072614	392	466	2	18	74	0.2432432
NODE_27420_length_581_cov_5.072614	424	444	0	20	20	1.0000000
NODE_27464_length_581_cov_1.881743	474	538	0	64	64	1.0000000
NODE_27541_length_580_cov_39.353430	358	438	0	26	80	0.3250000
NODE_27541_length_580_cov_39.353430	358	438	4	11	80	0.1375000
NODE_27541_length_580_cov_39.353430	358	438	7	1	80	0.0125000
NODE_27541_length_580_cov_39.353430	358	438	8	10	80	0.1250000
NODE_27541_length_580_cov_39.353430	358	438	9	28	80	0.3500000
NODE_27541_length_580_cov_39.353430	358	438	11	4	80	0.0500000
NODE_27541_length_580_cov_39.353430	411	491	9	23	80	0.2875000
NODE_27541_length_580_cov_39.353430	411	491	11	57	80	0.7125000
NODE_27541_length_580_cov_39.353430	487	567	0	23	80	0.2875000
NODE_27541_length_580_cov_39.353430	487	567	4	1	80	0.0125000
NODE_27541_length_580_cov_39.353430	487	567	5	10	80	0.1250000
NODE_27541_length_580_cov_39.353430	487	567	9	38	80	0.4750000
NODE_27541_length_580_cov_39.353430	487	567	11	8	80	0.1000000
NODE_27541_length_580_cov_39.353430	487	567	0	23	80	0.2875000
NODE_27541_length_580_cov_39.353430	487	567	4	1	80	0.0125000
NODE_27541_length_580_cov_39.353430	487	567	5	10	80	0.1250000
NODE_27541_length_580_cov_39.353430	487	567	9	38	80	0.4750000
NODE_27541_length_580_cov_39.353430	487	567	11	8	80	0.1000000
NODE_27541_length_580_cov_39.353430	487	567	0	23	80	0.2875000
NODE_27541_length_580_cov_39.353430	487	567	4	1	80	0.0125000
NODE_27541_length_580_cov_39.353430	487	567	5	10	80	0.1250000
NODE_27541_length_580_cov_39.353430	487	567	9	38	80	0.4750000
NODE_27541_length_580_cov_39.353430	487	567	11	8	80	0.1000000
NODE_27541_length_580_cov_39.353430	487	567	0	23	80	0.2875000
NODE_27541_length_580_cov_39.353430	487	567	4	1	80	0.0125000
NODE_27541_length_580_cov_39.353430	487	567	5	10	80	0.1250000
NODE_27541_length_580_cov_39.353430	487	567	9	38	80	0.4750000
NODE_27541_length_580_cov_39.353430	487	567	11	8	80	0.1000000
NODE_27541_length_580_cov_39.353430	487	567	0	23	80	0.2875000
NODE_27541_length_580_cov_39.353430	487	567	4	1	80	0.0125000
NODE_27541_length_580_cov_39.353430	487	567	5	10	80	0.1250000
NODE_27541_length_580_cov_39.353430	487	567	9	38	80	0.4750000
NODE_27541_length_580_cov_39.353430	487	567	11	8	80	0.1000000
NODE_27541_length_580_cov_39.353430	487	567	0	23	80	0.2875000
NODE_27541_length_580_cov_39.353430	487	567	4	1	80	0.0125000
NODE_27541_length_580_cov_39.353430	487	567	5	10	80	0.1250000
NODE_27541_length_580_cov_39.353430	487	567	9	38	80	0.4750000
NODE_27541_length_580_cov_39.353430	487	567	11	8	80	0.1000000
NODE_27544_length_580_cov_8.925156	198	238	0	40	40	1.0000000
NODE_27544_length_580_cov_8.925156	258	338	0	80	80	1.0000000
NODE_27545_length_580_cov_8.634096	197	277	2	80	80	1.0000000
NODE_27545_length_580_cov_8.634096	250	330	2	58	80	0.7250000
NODE_27545_length_580_cov_8.634096	250	330	4	22	80	0.2750000
NODE_27551_length_580_cov_6.291060	356	398	0	42	42	1.0000000
NODE_27554_length_580_cov_5.494802	110	190	0	80	80	1.0000000
NODE_27554_length_580_cov_5.494802	163	243	0	80	80	1.0000000
NODE_27559_length_580_cov_4.563410	231	292	6	48	61	0.7868853
NODE_27559_length_580_cov_4.563410	231	292	7	1	61	0.0163934
NODE_27559_length_580_cov_4.563410	231	292	8	6	61	0.0983607
NODE_27559_length_580_cov_4.563410	231	292	10	6	61	0.0983607
NODE_27559_length_580_cov_4.563410	322	357	4	30	35	0.8571429
NODE_27559_length_580_cov_4.563410	322	357	6	5	35	0.1428571
NODE_27590_length_580_cov_2.264033	215	277	0	62	62	1.0000000
NODE_27597_length_580_cov_2.116424	265	345	0	80	80	1.0000000
NODE_27659_length_579_cov_24.231250	159	239	6	49	80	0.6125000
NODE_27659_length_579_cov_24.231250	159	239	8	31	80	0.3875000
NODE_27659_length_579_cov_24.231250	212	287	1	6	75	0.0800000
NODE_27659_length_579_cov_24.231250	212	287	2	27	75	0.3600000
NODE_27659_length_579_cov_24.231250	212	287	6	16	75	0.2133333
NODE_27659_length_579_cov_24.231250	212	287	8	26	75	0.3466667
NODE_27660_length_579_cov_12.602083	246	326	0	80	80	1.0000000
NODE_27660_length_579_cov_12.602083	299	377	0	78	78	1.0000000
NODE_27663_length_579_cov_9.195833	254	334	2	20	80	0.2500000
NODE_27663_length_579_cov_9.195833	254	334	3	10	80	0.1250000
NODE_27663_length_579_cov_9.195833	254	334	4	5	80	0.0625000
NODE_27663_length_579_cov_9.195833	254	334	8	11	80	0.1375000
NODE_27663_length_579_cov_9.195833	254	334	9	3	80	0.0375000
NODE_27663_length_579_cov_9.195833	254	334	10	31	80	0.3875000
NODE_27663_length_579_cov_9.195833	307	387	4	6	80	0.0750000
NODE_27663_length_579_cov_9.195833	307	387	8	40	80	0.5000000
NODE_27663_length_579_cov_9.195833	307	387	10	34	80	0.4250000
NODE_27663_length_579_cov_9.195833	383	463	0	38	80	0.4750000
NODE_27663_length_579_cov_9.195833	383	463	2	15	80	0.1875000
NODE_27663_length_579_cov_9.195833	383	463	4	27	80	0.3375000
NODE_27664_length_579_cov_6.600000	169	249	0	80	80	1.0000000
NODE_27664_length_579_cov_6.600000	222	302	0	80	80	1.0000000
NODE_27667_length_579_cov_5.956250	225	295	8	43	70	0.6142857
NODE_27667_length_579_cov_5.956250	225	295	10	17	70	0.2428571
NODE_27667_length_579_cov_5.956250	225	295	12	10	70	0.1428571
NODE_27667_length_579_cov_5.956250	279	316	4	7	37	0.1891892
NODE_27667_length_579_cov_5.956250	279	316	6	1	37	0.0270270
NODE_27667_length_579_cov_5.956250	279	316	8	29	37	0.7837838
NODE_27674_length_579_cov_4.850000	105	185	0	80	80	1.0000000
NODE_27674_length_579_cov_4.850000	158	238	0	80	80	1.0000000
NODE_27688_length_579_cov_3.291667	290	343	2	3	53	0.0566038
NODE_27688_length_579_cov_3.291667	290	343	4	50	53	0.9433962
NODE_27695_length_579_cov_2.420833	251	331	0	33	80	0.4125000
NODE_27695_length_579_cov_2.420833	251	331	2	3	80	0.0375000
NODE_27695_length_579_cov_2.420833	251	331	4	34	80	0.4250000
NODE_27695_length_579_cov_2.420833	251	331	6	10	80	0.1250000
NODE_27695_length_579_cov_2.420833	304	384	0	80	80	1.0000000
NODE_27724_length_579_cov_1.435417	463	497	0	34	34	1.0000000
NODE_27781_length_578_cov_70.192067	100	180	0	80	80	1.0000000
NODE_27781_length_578_cov_70.192067	153	233	0	80	80	1.0000000
NODE_27782_length_578_cov_51.676409	129	209	2	80	80	1.0000000
NODE_27782_length_578_cov_51.676409	182	262	0	33	80	0.4125000
NODE_27782_length_578_cov_51.676409	182	262	2	47	80	0.5875000
NODE_27783_length_578_cov_32.152401	310	390	2	23	80	0.2875000
NODE_27783_length_578_cov_32.152401	310	390	4	57	80	0.7125000
NODE_27783_length_578_cov_32.152401	363	443	0	29	80	0.3625000
NODE_27783_length_578_cov_32.152401	363	443	2	47	80	0.5875000
NODE_27783_length_578_cov_32.152401	363	443	4	4	80	0.0500000
NODE_27784_length_578_cov_30.484342	215	295	0	80	80	1.0000000
NODE_27784_length_578_cov_30.484342	268	348	0	80	80	1.0000000
NODE_27785_length_578_cov_15.983299	213	265	0	52	52	1.0000000
NODE_27786_length_578_cov_14.968685	147	227	0	75	80	0.9375000
NODE_27786_length_578_cov_14.968685	147	227	2	5	80	0.0625000
NODE_27786_length_578_cov_14.968685	200	280	0	22	80	0.2750000
NODE_27786_length_578_cov_14.968685	200	280	2	58	80	0.7250000
NODE_27787_length_578_cov_9.567850	273	328	0	55	55	1.0000000
NODE_27792_length_578_cov_6.670146	273	353	0	23	80	0.2875000
NODE_27792_length_578_cov_6.670146	273	353	2	1	80	0.0125000
NODE_27792_length_578_cov_6.670146	273	353	3	20	80	0.2500000
NODE_27792_length_578_cov_6.670146	273	353	4	5	80	0.0625000
NODE_27792_length_578_cov_6.670146	273	353	6	31	80	0.3875000
NODE_27792_length_578_cov_6.670146	326	406	0	15	80	0.1875000
NODE_27792_length_578_cov_6.670146	326	406	4	1	80	0.0125000
NODE_27792_length_578_cov_6.670146	326	406	6	64	80	0.8000000
NODE_27793_length_578_cov_6.465553	320	400	0	80	80	1.0000000
NODE_27793_length_578_cov_6.465553	373	453	0	80	80	1.0000000
NODE_27863_length_578_cov_1.480167	185	265	0	80	80	1.0000000
NODE_27863_length_578_cov_1.480167	238	318	0	80	80	1.0000000
NODE_27935_length_577_cov_11.638075	312	392	0	80	80	1.0000000
NODE_27942_length_577_cov_4.912134	218	249	4	31	31	1.0000000
NODE_27942_length_577_cov_4.912134	301	330	2	5	29	0.1724138
NODE_27942_length_577_cov_4.912134	301	330	4	24	29	0.8275862
NODE_27961_length_577_cov_2.970711	78	126	10	2	48	0.0416667
NODE_27961_length_577_cov_2.970711	78	126	11	2	48	0.0416667
NODE_27961_length_577_cov_2.970711	78	126	14	16	48	0.3333333
NODE_27961_length_577_cov_2.970711	78	126	16	28	48	0.5833333
NODE_27968_length_577_cov_2.631799	169	253	10	26	84	0.3095238
NODE_27968_length_577_cov_2.631799	169	253	12	18	84	0.2142857
NODE_27968_length_577_cov_2.631799	169	253	14	28	84	0.3333333
NODE_27968_length_577_cov_2.631799	169	253	16	12	84	0.1428571
NODE_27968_length_577_cov_2.631799	226	269	10	9	43	0.2093023
NODE_27968_length_577_cov_2.631799	226	269	12	7	43	0.1627907
NODE_27968_length_577_cov_2.631799	226	269	14	27	43	0.6279070
NODE_28003_length_577_cov_1.468619	71	146	0	75	75	1.0000000
NODE_28003_length_577_cov_1.468619	119	199	0	80	80	1.0000000
NODE_28058_length_576_cov_10.903564	194	274	0	78	80	0.9750000
NODE_28058_length_576_cov_10.903564	194	274	2	2	80	0.0250000
NODE_28059_length_576_cov_9.039832	271	351	0	80	80	1.0000000
NODE_28059_length_576_cov_9.039832	324	404	0	80	80	1.0000000
NODE_28060_length_576_cov_8.490566	338	418	0	70	80	0.8750000
NODE_28060_length_576_cov_8.490566	338	418	2	10	80	0.1250000
NODE_28060_length_576_cov_8.490566	391	471	0	17	80	0.2125000
NODE_28060_length_576_cov_8.490566	391	471	2	63	80	0.7875000
NODE_28061_length_576_cov_7.002096	157	237	0	80	80	1.0000000
NODE_28061_length_576_cov_7.002096	210	290	0	80	80	1.0000000
NODE_28076_length_576_cov_3.322851	118	183	14	17	65	0.2615385
NODE_28076_length_576_cov_3.322851	118	183	16	10	65	0.1538462
NODE_28076_length_576_cov_3.322851	118	183	18	35	65	0.5384616
NODE_28076_length_576_cov_3.322851	118	183	20	3	65	0.0461538
NODE_28102_length_576_cov_1.964361	148	228	0	80	80	1.0000000
NODE_28102_length_576_cov_1.964361	201	281	0	80	80	1.0000000
NODE_28104_length_576_cov_1.951782	159	239	0	80	80	1.0000000
NODE_28104_length_576_cov_1.951782	212	292	0	80	80	1.0000000
NODE_28116_length_576_cov_1.584906	381	455	0	3	74	0.0405405
NODE_28116_length_576_cov_1.584906	381	455	2	71	74	0.9594595
NODE_28179_length_575_cov_15.319328	319	399	0	80	80	1.0000000
NODE_28179_length_575_cov_15.319328	372	452	0	80	80	1.0000000
NODE_28181_length_575_cov_8.254202	286	366	0	80	80	1.0000000
NODE_28181_length_575_cov_8.254202	339	419	0	41	80	0.5125000
NODE_28181_length_575_cov_8.254202	339	419	2	39	80	0.4875000
NODE_28182_length_575_cov_7.558824	300	380	2	19	80	0.2375000
NODE_28182_length_575_cov_7.558824	300	380	4	61	80	0.7625000
NODE_28313_length_574_cov_6.282105	185	265	0	7	80	0.0875000
NODE_28313_length_574_cov_6.282105	185	265	4	5	80	0.0625000
NODE_28313_length_574_cov_6.282105	185	265	5	4	80	0.0500000
NODE_28313_length_574_cov_6.282105	185	265	9	8	80	0.1000000
NODE_28313_length_574_cov_6.282105	185	265	13	1	80	0.0125000
NODE_28313_length_574_cov_6.282105	185	265	14	10	80	0.1250000
NODE_28313_length_574_cov_6.282105	185	265	16	15	80	0.1875000
NODE_28313_length_574_cov_6.282105	185	265	18	25	80	0.3125000
NODE_28313_length_574_cov_6.282105	185	265	20	5	80	0.0625000
NODE_28313_length_574_cov_6.282105	238	318	0	60	80	0.7500000
NODE_28313_length_574_cov_6.282105	238	318	4	5	80	0.0625000
NODE_28313_length_574_cov_6.282105	238	318	5	4	80	0.0500000
NODE_28313_length_574_cov_6.282105	238	318	9	8	80	0.1000000
NODE_28313_length_574_cov_6.282105	238	318	13	1	80	0.0125000
NODE_28313_length_574_cov_6.282105	238	318	14	2	80	0.0250000
NODE_28330_length_574_cov_2.993684	215	234	0	19	19	1.0000000
NODE_28438_length_573_cov_53.668776	393	473	0	80	80	1.0000000
NODE_28438_length_573_cov_53.668776	446	526	0	80	80	1.0000000
NODE_28439_length_573_cov_30.658228	451	531	0	22	80	0.2750000
NODE_28439_length_573_cov_30.658228	451	531	2	20	80	0.2500000
NODE_28439_length_573_cov_30.658228	451	531	4	28	80	0.3500000
NODE_28439_length_573_cov_30.658228	451	531	6	10	80	0.1250000
NODE_28440_length_573_cov_30.116034	435	515	29	2	80	0.0250000
NODE_28440_length_573_cov_30.116034	435	515	31	3	80	0.0375000
NODE_28440_length_573_cov_30.116034	435	515	33	7	80	0.0875000
NODE_28440_length_573_cov_30.116034	435	515	34	10	80	0.1250000
NODE_28440_length_573_cov_30.116034	435	515	35	1	80	0.0125000
NODE_28440_length_573_cov_30.116034	435	515	36	10	80	0.1250000
NODE_28440_length_573_cov_30.116034	435	515	37	7	80	0.0875000
NODE_28440_length_573_cov_30.116034	435	515	38	3	80	0.0375000
NODE_28440_length_573_cov_30.116034	435	515	39	2	80	0.0250000
NODE_28440_length_573_cov_30.116034	435	515	40	6	80	0.0750000
NODE_28440_length_573_cov_30.116034	435	515	41	2	80	0.0250000
NODE_28440_length_573_cov_30.116034	435	515	42	1	80	0.0125000
NODE_28440_length_573_cov_30.116034	435	515	44	2	80	0.0250000
NODE_28440_length_573_cov_30.116034	435	515	45	1	80	0.0125000
NODE_28440_length_573_cov_30.116034	435	515	46	5	80	0.0625000
NODE_28440_length_573_cov_30.116034	435	515	47	2	80	0.0250000
NODE_28440_length_573_cov_30.116034	435	515	48	2	80	0.0250000
NODE_28440_length_573_cov_30.116034	435	515	49	5	80	0.0625000
NODE_28440_length_573_cov_30.116034	435	515	50	9	80	0.1125000
NODE_28440_length_573_cov_30.116034	488	568	6	5	80	0.0625000
NODE_28440_length_573_cov_30.116034	488	568	7	4	80	0.0500000
NODE_28440_length_573_cov_30.116034	488	568	9	8	80	0.1000000
NODE_28440_length_573_cov_30.116034	488	568	14	6	80	0.0750000
NODE_28440_length_573_cov_30.116034	488	568	18	9	80	0.1125000
NODE_28440_length_573_cov_30.116034	488	568	24	5	80	0.0625000
NODE_28440_length_573_cov_30.116034	488	568	25	1	80	0.0125000
NODE_28440_length_573_cov_30.116034	488	568	26	8	80	0.1000000
NODE_28440_length_573_cov_30.116034	488	568	28	1	80	0.0125000
NODE_28440_length_573_cov_30.116034	488	568	30	3	80	0.0375000
NODE_28440_length_573_cov_30.116034	488	568	34	13	80	0.1625000
NODE_28440_length_573_cov_30.116034	488	568	36	10	80	0.1250000
NODE_28440_length_573_cov_30.116034	488	568	37	3	80	0.0375000
NODE_28440_length_573_cov_30.116034	488	568	38	3	80	0.0375000
NODE_28440_length_573_cov_30.116034	488	568	40	1	80	0.0125000
NODE_28441_length_573_cov_24.234177	210	290	0	80	80	1.0000000
NODE_28441_length_573_cov_24.234177	263	343	0	80	80	1.0000000
NODE_28442_length_573_cov_13.464135	278	358	0	75	80	0.9375000
NODE_28442_length_573_cov_13.464135	278	358	2	5	80	0.0625000
NODE_28442_length_573_cov_13.464135	331	411	0	22	80	0.2750000
NODE_28442_length_573_cov_13.464135	331	411	2	58	80	0.7250000
NODE_28443_length_573_cov_8.761603	124	204	2	33	80	0.4125000
NODE_28443_length_573_cov_8.761603	124	204	4	34	80	0.4250000
NODE_28443_length_573_cov_8.761603	124	204	6	13	80	0.1625000
NODE_28443_length_573_cov_8.761603	177	257	2	49	80	0.6125000
NODE_28443_length_573_cov_8.761603	177	257	4	24	80	0.3000000
NODE_28443_length_573_cov_8.761603	177	257	6	7	80	0.0875000
NODE_28456_length_573_cov_3.364979	365	398	32	21	33	0.6363636
NODE_28456_length_573_cov_3.364979	365	398	34	12	33	0.3636364
NODE_28565_length_572_cov_17.530655	312	392	0	80	80	1.0000000
NODE_28565_length_572_cov_17.530655	365	445	0	80	80	1.0000000
NODE_28567_length_572_cov_8.059197	250	321	2	71	71	1.0000000
NODE_28568_length_572_cov_7.873150	134	214	0	80	80	1.0000000
NODE_28568_length_572_cov_7.873150	187	267	0	38	80	0.4750000
NODE_28568_length_572_cov_7.873150	187	267	2	42	80	0.5250000
NODE_28570_length_572_cov_6.706131	365	445	0	80	80	1.0000000
NODE_28570_length_572_cov_6.706131	418	498	0	80	80	1.0000000
NODE_28573_length_572_cov_5.625793	137	217	0	55	80	0.6875000
NODE_28573_length_572_cov_5.625793	137	217	2	25	80	0.3125000
NODE_28573_length_572_cov_5.625793	190	270	0	4	80	0.0500000
NODE_28573_length_572_cov_5.625793	190	270	2	76	80	0.9500000
NODE_28574_length_572_cov_5.617336	331	401	4	9	70	0.1285714
NODE_28574_length_572_cov_5.617336	331	401	10	61	70	0.8714285
NODE_28578_length_572_cov_4.596195	212	288	0	76	76	1.0000000
NODE_28578_length_572_cov_4.596195	261	341	0	61	80	0.7625000
NODE_28578_length_572_cov_4.596195	261	341	2	19	80	0.2375000
NODE_28585_length_572_cov_3.843552	210	290	2	63	80	0.7875000
NODE_28585_length_572_cov_3.843552	210	290	4	6	80	0.0750000
NODE_28585_length_572_cov_3.843552	210	290	6	11	80	0.1375000
NODE_28585_length_572_cov_3.843552	263	343	2	10	80	0.1250000
NODE_28585_length_572_cov_3.843552	263	343	4	59	80	0.7375000
NODE_28585_length_572_cov_3.843552	263	343	6	11	80	0.1375000
NODE_28621_length_572_cov_2.319239	357	431	8	17	74	0.2297297
NODE_28621_length_572_cov_2.319239	357	431	9	1	74	0.0135135
NODE_28621_length_572_cov_2.319239	357	431	10	18	74	0.2432432
NODE_28621_length_572_cov_2.319239	357	431	11	21	74	0.2837838
NODE_28621_length_572_cov_2.319239	357	431	12	17	74	0.2297297
NODE_28621_length_572_cov_2.319239	410	478	4	25	68	0.3676471
NODE_28621_length_572_cov_2.319239	410	478	6	7	68	0.1029412
NODE_28621_length_572_cov_2.319239	410	478	8	10	68	0.1470588
NODE_28621_length_572_cov_2.319239	410	478	10	16	68	0.2352941
NODE_28621_length_572_cov_2.319239	410	478	12	10	68	0.1470588
NODE_28625_length_572_cov_2.107822	184	254	8	70	70	1.0000000
NODE_28625_length_572_cov_2.107822	415	493	0	7	78	0.0897436
NODE_28625_length_572_cov_2.107822	415	493	2	71	78	0.9102564
NODE_28631_length_572_cov_1.947146	327	363	2	22	36	0.6111111
NODE_28631_length_572_cov_1.947146	327	363	4	14	36	0.3888889
NODE_28631_length_572_cov_1.947146	328	354	2	21	26	0.8076923
NODE_28631_length_572_cov_1.947146	328	354	4	5	26	0.1923077
NODE_28700_length_571_cov_14.262712	237	317	0	80	80	1.0000000
NODE_28700_length_571_cov_14.262712	290	370	0	80	80	1.0000000
NODE_28717_length_571_cov_4.033898	154	234	0	80	80	1.0000000
NODE_28717_length_571_cov_4.033898	207	273	0	66	66	1.0000000
NODE_28809_length_570_cov_28.269639	487	559	12	12	72	0.1666667
NODE_28809_length_570_cov_28.269639	487	559	18	1	72	0.0138889
NODE_28809_length_570_cov_28.269639	487	559	20	1	72	0.0138889
NODE_28809_length_570_cov_28.269639	487	559	24	2	72	0.0277778
NODE_28809_length_570_cov_28.269639	487	559	25	8	72	0.1111111
NODE_28809_length_570_cov_28.269639	487	559	26	8	72	0.1111111
NODE_28809_length_570_cov_28.269639	487	559	28	3	72	0.0416667
NODE_28809_length_570_cov_28.269639	487	559	32	2	72	0.0277778
NODE_28809_length_570_cov_28.269639	487	559	33	4	72	0.0555556
NODE_28809_length_570_cov_28.269639	487	559	35	25	72	0.3472222
NODE_28809_length_570_cov_28.269639	487	559	37	6	72	0.0833333
NODE_28812_length_570_cov_10.161359	167	247	2	44	80	0.5500000
NODE_28812_length_570_cov_10.161359	167	247	4	36	80	0.4500000
NODE_28812_length_570_cov_10.161359	220	256	4	36	36	1.0000000
NODE_28819_length_570_cov_5.010616	179	216	6	7	37	0.1891892
NODE_28819_length_570_cov_5.010616	179	216	8	30	37	0.8108108
NODE_28819_length_570_cov_5.010616	189	269	2	12	80	0.1500000
NODE_28819_length_570_cov_5.010616	189	269	4	2	80	0.0250000
NODE_28819_length_570_cov_5.010616	189	269	6	44	80	0.5500000
NODE_28819_length_570_cov_5.010616	189	269	8	22	80	0.2750000
NODE_28828_length_570_cov_3.898089	236	316	2	1	80	0.0125000
NODE_28828_length_570_cov_3.898089	236	316	4	32	80	0.4000000
NODE_28828_length_570_cov_3.898089	236	316	6	24	80	0.3000000
NODE_28828_length_570_cov_3.898089	236	316	8	23	80	0.2875000
NODE_28828_length_570_cov_3.898089	289	369	0	6	80	0.0750000
NODE_28828_length_570_cov_3.898089	289	369	2	10	80	0.1250000
NODE_28828_length_570_cov_3.898089	289	369	4	38	80	0.4750000
NODE_28828_length_570_cov_3.898089	289	369	6	3	80	0.0375000
NODE_28828_length_570_cov_3.898089	289	369	8	23	80	0.2875000
NODE_28840_length_570_cov_2.938429	202	280	3	15	78	0.1923077
NODE_28840_length_570_cov_2.938429	202	280	5	9	78	0.1153846
NODE_28840_length_570_cov_2.938429	202	280	7	1	78	0.0128205
NODE_28840_length_570_cov_2.938429	202	280	10	21	78	0.2692308
NODE_28840_length_570_cov_2.938429	202	280	11	9	78	0.1153846
NODE_28840_length_570_cov_2.938429	202	280	13	7	78	0.0897436
NODE_28840_length_570_cov_2.938429	202	280	15	16	78	0.2051282
NODE_28840_length_570_cov_2.938429	262	333	2	33	71	0.4647887
NODE_28840_length_570_cov_2.938429	262	333	3	24	71	0.3380282
NODE_28840_length_570_cov_2.938429	262	333	5	14	71	0.1971831
NODE_28842_length_570_cov_2.891720	204	260	0	5	56	0.0892857
NODE_28842_length_570_cov_2.891720	204	260	4	51	56	0.9107143
NODE_28950_length_569_cov_20.559574	275	355	0	80	80	1.0000000
NODE_28950_length_569_cov_20.559574	328	408	0	28	80	0.3500000
NODE_28950_length_569_cov_20.559574	328	408	2	52	80	0.6500000
NODE_28951_length_569_cov_15.282979	272	352	2	68	80	0.8500000
NODE_28951_length_569_cov_15.282979	272	352	4	12	80	0.1500000
NODE_28951_length_569_cov_15.282979	325	405	0	17	80	0.2125000
NODE_28951_length_569_cov_15.282979	325	405	2	63	80	0.7875000
NODE_28952_length_569_cov_11.023404	280	360	2	39	80	0.4875000
NODE_28952_length_569_cov_11.023404	280	360	4	41	80	0.5125000
NODE_28952_length_569_cov_11.023404	333	413	0	40	80	0.5000000
NODE_28952_length_569_cov_11.023404	333	413	2	40	80	0.5000000
NODE_28953_length_569_cov_9.310638	231	277	0	3	46	0.0652174
NODE_28953_length_569_cov_9.310638	231	277	4	14	46	0.3043478
NODE_28953_length_569_cov_9.310638	231	277	6	5	46	0.1086956
NODE_28953_length_569_cov_9.310638	231	277	8	21	46	0.4565217
NODE_28953_length_569_cov_9.310638	231	277	10	3	46	0.0652174
NODE_28956_length_569_cov_6.989362	258	338	4	19	80	0.2375000
NODE_28956_length_569_cov_6.989362	258	338	6	61	80	0.7625000
NODE_28956_length_569_cov_6.989362	294	329	6	35	35	1.0000000
NODE_28956_length_569_cov_6.989362	296	338	6	42	42	1.0000000
NODE_28957_length_569_cov_6.978723	264	344	0	80	80	1.0000000
NODE_28957_length_569_cov_6.978723	317	397	0	37	80	0.4625000
NODE_28957_length_569_cov_6.978723	317	397	2	43	80	0.5375000
NODE_28960_length_569_cov_6.434043	228	308	0	80	80	1.0000000
NODE_28973_length_569_cov_3.353191	340	419	0	38	79	0.4810127
NODE_28973_length_569_cov_3.353191	340	419	2	41	79	0.5189874
NODE_28981_length_569_cov_3.027660	277	348	0	36	71	0.5070422
NODE_28981_length_569_cov_3.027660	277	348	2	8	71	0.1126761
NODE_28981_length_569_cov_3.027660	277	348	4	27	71	0.3802817
NODE_29072_length_568_cov_59.729211	124	204	2	3	80	0.0375000
NODE_29072_length_568_cov_59.729211	124	204	16	76	80	0.9500000
NODE_29072_length_568_cov_59.729211	124	204	18	1	80	0.0125000
NODE_29072_length_568_cov_59.729211	177	257	0	28	80	0.3500000
NODE_29072_length_568_cov_59.729211	177	257	2	28	80	0.3500000
NODE_29072_length_568_cov_59.729211	177	257	16	24	80	0.3000000
NODE_29075_length_568_cov_7.763326	215	294	0	79	79	1.0000000
NODE_29075_length_568_cov_7.763326	267	347	0	80	80	1.0000000
NODE_29078_length_568_cov_6.257996	397	471	0	18	74	0.2432432
NODE_29078_length_568_cov_6.257996	397	471	2	56	74	0.7567568
NODE_29091_length_568_cov_3.748401	170	236	0	66	66	1.0000000
NODE_29091_length_568_cov_3.748401	262	311	0	49	49	1.0000000
NODE_29133_length_568_cov_1.769723	192	233	0	41	41	1.0000000
NODE_29160_length_568_cov_1.358209	355	432	0	17	77	0.2207792
NODE_29160_length_568_cov_1.358209	355	432	2	18	77	0.2337662
NODE_29160_length_568_cov_1.358209	355	432	4	37	77	0.4805195
NODE_29160_length_568_cov_1.358209	355	432	6	5	77	0.0649351
NODE_29182_length_568_cov_1.038380	195	275	0	80	80	1.0000000
NODE_29216_length_567_cov_21.155983	347	427	0	18	80	0.2250000
NODE_29216_length_567_cov_21.155983	347	427	2	62	80	0.7750000
NODE_29216_length_567_cov_21.155983	400	480	0	57	80	0.7125000
NODE_29216_length_567_cov_21.155983	400	480	2	23	80	0.2875000
NODE_29217_length_567_cov_18.292735	367	447	0	10	80	0.1250000
NODE_29217_length_567_cov_18.292735	367	447	4	70	80	0.8750000
NODE_29217_length_567_cov_18.292735	420	500	4	80	80	1.0000000
NODE_29218_length_567_cov_17.579060	259	339	0	80	80	1.0000000
NODE_29218_length_567_cov_17.579060	312	392	0	80	80	1.0000000
NODE_29220_length_567_cov_15.457265	276	356	2	1	80	0.0125000
NODE_29220_length_567_cov_15.457265	276	356	6	21	80	0.2625000
NODE_29220_length_567_cov_15.457265	276	356	8	58	80	0.7250000
NODE_29220_length_567_cov_15.457265	329	409	0	19	80	0.2375000
NODE_29220_length_567_cov_15.457265	329	409	4	23	80	0.2875000
NODE_29220_length_567_cov_15.457265	329	409	6	23	80	0.2875000
NODE_29220_length_567_cov_15.457265	329	409	8	15	80	0.1875000
NODE_29221_length_567_cov_14.393162	270	350	0	80	80	1.0000000
NODE_29221_length_567_cov_14.393162	323	403	0	80	80	1.0000000
NODE_29225_length_567_cov_6.611111	356	436	0	80	80	1.0000000
NODE_29225_length_567_cov_6.611111	409	489	0	71	80	0.8875000
NODE_29225_length_567_cov_6.611111	409	489	2	9	80	0.1125000
NODE_29245_length_567_cov_2.884615	204	284	0	80	80	1.0000000
NODE_29245_length_567_cov_2.884615	204	254	0	50	50	1.0000000
NODE_29245_length_567_cov_2.884615	266	297	0	31	31	1.0000000
NODE_29363_length_566_cov_47.747323	157	237	0	48	80	0.6000000
NODE_29363_length_566_cov_47.747323	157	237	2	32	80	0.4000000
NODE_29363_length_566_cov_47.747323	210	290	2	80	80	1.0000000
NODE_29364_length_566_cov_44.824411	14	94	15	1	80	0.0125000
NODE_29364_length_566_cov_44.824411	14	94	19	1	80	0.0125000
NODE_29364_length_566_cov_44.824411	14	94	21	3	80	0.0375000
NODE_29364_length_566_cov_44.824411	14	94	23	3	80	0.0375000
NODE_29364_length_566_cov_44.824411	14	94	24	1	80	0.0125000
NODE_29364_length_566_cov_44.824411	14	94	26	2	80	0.0250000
NODE_29364_length_566_cov_44.824411	14	94	34	1	80	0.0125000
NODE_29364_length_566_cov_44.824411	14	94	42	4	80	0.0500000
NODE_29364_length_566_cov_44.824411	14	94	52	2	80	0.0250000
NODE_29364_length_566_cov_44.824411	14	94	54	5	80	0.0625000
NODE_29364_length_566_cov_44.824411	14	94	56	9	80	0.1125000
NODE_29364_length_566_cov_44.824411	14	94	58	48	80	0.6000000
NODE_29364_length_566_cov_44.824411	15	94	19	1	79	0.0126582
NODE_29364_length_566_cov_44.824411	15	94	21	3	79	0.0379747
NODE_29364_length_566_cov_44.824411	15	94	23	3	79	0.0379747
NODE_29364_length_566_cov_44.824411	15	94	24	1	79	0.0126582
NODE_29364_length_566_cov_44.824411	15	94	26	2	79	0.0253165
NODE_29364_length_566_cov_44.824411	15	94	34	1	79	0.0126582
NODE_29364_length_566_cov_44.824411	15	94	42	4	79	0.0506329
NODE_29364_length_566_cov_44.824411	15	94	52	2	79	0.0253165
NODE_29364_length_566_cov_44.824411	15	94	54	5	79	0.0632911
NODE_29364_length_566_cov_44.824411	15	94	56	9	79	0.1139240
NODE_29364_length_566_cov_44.824411	15	94	58	48	79	0.6075949
NODE_29364_length_566_cov_44.824411	67	147	10	4	80	0.0500000
NODE_29364_length_566_cov_44.824411	67	147	12	2	80	0.0250000
NODE_29364_length_566_cov_44.824411	67	147	14	7	80	0.0875000
NODE_29364_length_566_cov_44.824411	67	147	18	1	80	0.0125000
NODE_29364_length_566_cov_44.824411	67	147	20	3	80	0.0375000
NODE_29364_length_566_cov_44.824411	67	147	24	2	80	0.0250000
NODE_29364_length_566_cov_44.824411	67	147	26	2	80	0.0250000
NODE_29364_length_566_cov_44.824411	67	147	28	2	80	0.0250000
NODE_29364_length_566_cov_44.824411	67	147	30	1	80	0.0125000
NODE_29364_length_566_cov_44.824411	67	147	39	1	80	0.0125000
NODE_29364_length_566_cov_44.824411	67	147	41	2	80	0.0250000
NODE_29364_length_566_cov_44.824411	67	147	43	1	80	0.0125000
NODE_29364_length_566_cov_44.824411	67	147	47	2	80	0.0250000
NODE_29364_length_566_cov_44.824411	67	147	50	6	80	0.0750000
NODE_29364_length_566_cov_44.824411	67	147	56	5	80	0.0625000
NODE_29364_length_566_cov_44.824411	67	147	58	39	80	0.4875000
NODE_29364_length_566_cov_44.824411	67	147	10	4	80	0.0500000
NODE_29364_length_566_cov_44.824411	67	147	12	2	80	0.0250000
NODE_29364_length_566_cov_44.824411	67	147	14	7	80	0.0875000
NODE_29364_length_566_cov_44.824411	67	147	18	1	80	0.0125000
NODE_29364_length_566_cov_44.824411	67	147	20	3	80	0.0375000
NODE_29364_length_566_cov_44.824411	67	147	24	2	80	0.0250000
NODE_29364_length_566_cov_44.824411	67	147	26	2	80	0.0250000
NODE_29364_length_566_cov_44.824411	67	147	28	2	80	0.0250000
NODE_29364_length_566_cov_44.824411	67	147	30	1	80	0.0125000
NODE_29364_length_566_cov_44.824411	67	147	39	1	80	0.0125000
NODE_29364_length_566_cov_44.824411	67	147	41	2	80	0.0250000
NODE_29364_length_566_cov_44.824411	67	147	43	1	80	0.0125000
NODE_29364_length_566_cov_44.824411	67	147	47	2	80	0.0250000
NODE_29364_length_566_cov_44.824411	67	147	50	6	80	0.0750000
NODE_29364_length_566_cov_44.824411	67	147	56	5	80	0.0625000
NODE_29364_length_566_cov_44.824411	67	147	58	39	80	0.4875000
NODE_29364_length_566_cov_44.824411	77	147	10	4	70	0.0571429
NODE_29364_length_566_cov_44.824411	77	147	12	2	70	0.0285714
NODE_29364_length_566_cov_44.824411	77	147	14	7	70	0.1000000
NODE_29364_length_566_cov_44.824411	77	147	18	1	70	0.0142857
NODE_29364_length_566_cov_44.824411	77	147	20	3	70	0.0428571
NODE_29364_length_566_cov_44.824411	77	147	24	2	70	0.0285714
NODE_29364_length_566_cov_44.824411	77	147	26	2	70	0.0285714
NODE_29364_length_566_cov_44.824411	77	147	28	2	70	0.0285714
NODE_29364_length_566_cov_44.824411	77	147	30	1	70	0.0142857
NODE_29364_length_566_cov_44.824411	77	147	39	1	70	0.0142857
NODE_29364_length_566_cov_44.824411	77	147	41	2	70	0.0285714
NODE_29364_length_566_cov_44.824411	77	147	43	1	70	0.0142857
NODE_29364_length_566_cov_44.824411	77	147	47	2	70	0.0285714
NODE_29364_length_566_cov_44.824411	77	147	50	6	70	0.0857143
NODE_29364_length_566_cov_44.824411	77	147	56	5	70	0.0714286
NODE_29364_length_566_cov_44.824411	77	147	58	29	70	0.4142857
NODE_29364_length_566_cov_44.824411	143	223	2	13	80	0.1625000
NODE_29364_length_566_cov_44.824411	143	223	6	11	80	0.1375000
NODE_29364_length_566_cov_44.824411	143	223	8	30	80	0.3750000
NODE_29364_length_566_cov_44.824411	143	223	10	14	80	0.1750000
NODE_29364_length_566_cov_44.824411	143	223	12	12	80	0.1500000
NODE_29364_length_566_cov_44.824411	196	276	8	7	80	0.0875000
NODE_29364_length_566_cov_44.824411	196	276	10	61	80	0.7625000
NODE_29364_length_566_cov_44.824411	196	276	12	12	80	0.1500000
NODE_29367_length_566_cov_18.494647	344	424	2	9	80	0.1125000
NODE_29367_length_566_cov_18.494647	344	424	8	41	80	0.5125000
NODE_29367_length_566_cov_18.494647	344	424	10	30	80	0.3750000
NODE_29367_length_566_cov_18.494647	397	477	2	8	80	0.1000000
NODE_29367_length_566_cov_18.494647	397	477	6	44	80	0.5500000
NODE_29367_length_566_cov_18.494647	397	477	8	14	80	0.1750000
NODE_29367_length_566_cov_18.494647	397	477	10	14	80	0.1750000
NODE_29368_length_566_cov_17.537473	324	404	0	9	80	0.1125000
NODE_29368_length_566_cov_17.537473	324	404	2	71	80	0.8875000
NODE_29368_length_566_cov_17.537473	377	457	0	62	80	0.7750000
NODE_29368_length_566_cov_17.537473	377	457	2	18	80	0.2250000
NODE_29369_length_566_cov_13.019272	157	237	0	21	80	0.2625000
NODE_29369_length_566_cov_13.019272	157	237	2	59	80	0.7375000
NODE_29369_length_566_cov_13.019272	210	290	0	74	80	0.9250000
NODE_29369_length_566_cov_13.019272	210	290	2	6	80	0.0750000
NODE_29371_length_566_cov_9.513919	191	279	0	88	88	1.0000000
NODE_29371_length_566_cov_9.513919	252	332	0	80	80	1.0000000
NODE_29397_length_566_cov_3.239829	292	334	0	42	42	1.0000000
NODE_29397_length_566_cov_3.239829	351	375	0	24	24	1.0000000
NODE_29437_length_566_cov_1.698073	432	481	0	49	49	1.0000000
NODE_29472_length_566_cov_0.957173	378	405	0	27	27	1.0000000
NODE_29503_length_565_cov_10.508584	202	280	0	78	78	1.0000000
NODE_29503_length_565_cov_10.508584	253	334	0	81	81	1.0000000
NODE_29509_length_565_cov_7.560086	170	246	2	24	76	0.3157895
NODE_29509_length_565_cov_7.560086	170	246	4	8	76	0.1052632
NODE_29509_length_565_cov_7.560086	170	246	6	25	76	0.3289474
NODE_29509_length_565_cov_7.560086	170	246	8	19	76	0.2500000
NODE_29520_length_565_cov_4.045064	231	311	2	7	80	0.0875000
NODE_29520_length_565_cov_4.045064	231	311	4	10	80	0.1250000
NODE_29520_length_565_cov_4.045064	231	311	6	63	80	0.7875000
NODE_29520_length_565_cov_4.045064	284	364	2	5	80	0.0625000
NODE_29520_length_565_cov_4.045064	284	364	4	25	80	0.3125000
NODE_29520_length_565_cov_4.045064	284	364	6	50	80	0.6250000
NODE_29528_length_565_cov_3.399142	161	241	0	33	80	0.4125000
NODE_29528_length_565_cov_3.399142	161	241	4	47	80	0.5875000
NODE_29528_length_565_cov_3.399142	214	294	4	80	80	1.0000000
NODE_29542_length_565_cov_2.542918	302	382	0	80	80	1.0000000
NODE_29542_length_565_cov_2.542918	355	435	0	80	80	1.0000000
NODE_29650_length_564_cov_46.901075	129	209	17	59	80	0.7375000
NODE_29650_length_564_cov_46.901075	129	209	18	21	80	0.2625000
NODE_29650_length_564_cov_46.901075	182	262	0	33	80	0.4125000
NODE_29650_length_564_cov_46.901075	182	262	9	19	80	0.2375000
NODE_29650_length_564_cov_46.901075	182	262	17	28	80	0.3500000
NODE_29651_length_564_cov_13.520430	300	380	0	80	80	1.0000000
NODE_29651_length_564_cov_13.520430	353	433	0	80	80	1.0000000
NODE_29653_length_564_cov_7.965591	291	332	0	41	41	1.0000000
NODE_29796_length_563_cov_24.487069	97	177	0	80	80	1.0000000
NODE_29796_length_563_cov_24.487069	150	230	0	80	80	1.0000000
NODE_29800_length_563_cov_6.758621	301	367	0	3	66	0.0454545
NODE_29800_length_563_cov_6.758621	301	367	4	21	66	0.3181818
NODE_29800_length_563_cov_6.758621	301	367	6	8	66	0.1212121
NODE_29800_length_563_cov_6.758621	301	367	10	4	66	0.0606061
NODE_29800_length_563_cov_6.758621	301	367	12	2	66	0.0303030
NODE_29800_length_563_cov_6.758621	301	367	14	2	66	0.0303030
NODE_29800_length_563_cov_6.758621	301	367	18	8	66	0.1212121
NODE_29800_length_563_cov_6.758621	301	367	20	2	66	0.0303030
NODE_29800_length_563_cov_6.758621	301	367	23	7	66	0.1060606
NODE_29800_length_563_cov_6.758621	301	367	24	8	66	0.1212121
NODE_29800_length_563_cov_6.758621	301	367	26	1	66	0.0151515
NODE_29800_length_563_cov_6.758621	378	422	0	9	44	0.2045455
NODE_29800_length_563_cov_6.758621	378	422	2	35	44	0.7954546
NODE_29802_length_563_cov_5.762931	48	135	0	87	87	1.0000000
NODE_29802_length_563_cov_5.762931	108	188	0	80	80	1.0000000
NODE_29808_length_563_cov_4.176724	197	277	0	80	80	1.0000000
NODE_29808_length_563_cov_4.176724	250	330	0	80	80	1.0000000
NODE_29809_length_563_cov_4.155172	273	315	0	9	42	0.2142857
NODE_29809_length_563_cov_4.155172	273	315	4	33	42	0.7857143
NODE_29809_length_563_cov_4.155172	288	358	4	42	70	0.6000000
NODE_29809_length_563_cov_4.155172	288	358	6	28	70	0.4000000
NODE_29925_length_562_cov_31.194384	47	127	0	80	80	1.0000000
NODE_29925_length_562_cov_31.194384	100	180	0	80	80	1.0000000
NODE_29926_length_562_cov_29.857451	33	113	2	80	80	1.0000000
NODE_29926_length_562_cov_29.857451	86	166	0	28	80	0.3500000
NODE_29926_length_562_cov_29.857451	86	166	2	52	80	0.6500000
NODE_29927_length_562_cov_23.194384	245	325	0	6	80	0.0750000
NODE_29927_length_562_cov_23.194384	245	325	2	9	80	0.1125000
NODE_29927_length_562_cov_23.194384	245	325	4	65	80	0.8125000
NODE_29927_length_562_cov_23.194384	298	378	0	59	80	0.7375000
NODE_29927_length_562_cov_23.194384	298	378	2	9	80	0.1125000
NODE_29927_length_562_cov_23.194384	298	378	4	12	80	0.1500000
NODE_29930_length_562_cov_10.304536	271	321	0	28	50	0.5600000
NODE_29930_length_562_cov_10.304536	271	321	2	22	50	0.4400000
NODE_29931_length_562_cov_9.131749	265	346	0	81	81	1.0000000
NODE_29931_length_562_cov_9.131749	319	399	0	80	80	1.0000000
NODE_29960_length_562_cov_2.961123	350	398	0	48	48	1.0000000
NODE_30083_length_561_cov_18.049784	54	134	0	55	80	0.6875000
NODE_30083_length_561_cov_18.049784	54	134	2	25	80	0.3125000
NODE_30083_length_561_cov_18.049784	107	187	0	2	80	0.0250000
NODE_30083_length_561_cov_18.049784	107	187	2	78	80	0.9750000
NODE_30087_length_561_cov_5.348485	208	274	0	26	66	0.3939394
NODE_30087_length_561_cov_5.348485	208	274	2	20	66	0.3030303
NODE_30087_length_561_cov_5.348485	208	274	4	20	66	0.3030303
NODE_30105_length_561_cov_2.787879	216	285	0	54	69	0.7826087
NODE_30105_length_561_cov_2.787879	216	285	2	15	69	0.2173913
NODE_30120_length_561_cov_2.233766	339	419	0	80	80	1.0000000
NODE_30120_length_561_cov_2.233766	391	445	0	54	54	1.0000000
NODE_30120_length_561_cov_2.233766	392	438	0	46	46	1.0000000
NODE_30133_length_561_cov_1.803030	258	334	2	52	76	0.6842105
NODE_30133_length_561_cov_1.803030	258	334	3	1	76	0.0131579
NODE_30133_length_561_cov_1.803030	258	334	5	23	76	0.3026316
NODE_30224_length_560_cov_41.433839	67	147	2	34	80	0.4250000
NODE_30224_length_560_cov_41.433839	67	147	4	41	80	0.5125000
NODE_30224_length_560_cov_41.433839	67	147	6	5	80	0.0625000
NODE_30224_length_560_cov_41.433839	120	200	0	8	80	0.1000000
NODE_30224_length_560_cov_41.433839	120	200	2	16	80	0.2000000
NODE_30224_length_560_cov_41.433839	120	200	4	56	80	0.7000000
NODE_30225_length_560_cov_35.993492	366	446	5	48	80	0.6000000
NODE_30225_length_560_cov_35.993492	366	446	6	32	80	0.4000000
NODE_30225_length_560_cov_35.993492	419	499	0	32	80	0.4000000
NODE_30225_length_560_cov_35.993492	419	499	4	1	80	0.0125000
NODE_30225_length_560_cov_35.993492	419	499	5	17	80	0.2125000
NODE_30225_length_560_cov_35.993492	419	499	6	30	80	0.3750000
NODE_30226_length_560_cov_20.433839	342	422	0	19	80	0.2375000
NODE_30226_length_560_cov_20.433839	342	422	4	61	80	0.7625000
NODE_30226_length_560_cov_20.433839	395	475	0	35	80	0.4375000
NODE_30226_length_560_cov_20.433839	395	475	3	1	80	0.0125000
NODE_30226_length_560_cov_20.433839	395	475	4	44	80	0.5500000
NODE_30227_length_560_cov_13.850325	274	327	0	53	53	1.0000000
NODE_30228_length_560_cov_12.075922	233	314	11	20	81	0.2469136
NODE_30228_length_560_cov_12.075922	233	314	17	6	81	0.0740741
NODE_30228_length_560_cov_12.075922	233	314	19	8	81	0.0987654
NODE_30228_length_560_cov_12.075922	233	314	21	4	81	0.0493827
NODE_30228_length_560_cov_12.075922	233	314	22	1	81	0.0123457
NODE_30228_length_560_cov_12.075922	233	314	23	1	81	0.0123457
NODE_30228_length_560_cov_12.075922	233	314	24	17	81	0.2098765
NODE_30228_length_560_cov_12.075922	233	314	26	24	81	0.2962963
NODE_30229_length_560_cov_8.594360	263	343	0	80	80	1.0000000
NODE_30229_length_560_cov_8.594360	316	396	0	80	80	1.0000000
NODE_30237_length_560_cov_5.227766	264	328	2	11	64	0.1718750
NODE_30237_length_560_cov_5.227766	264	328	4	53	64	0.8281250
NODE_30238_length_560_cov_5.056399	299	379	0	36	80	0.4500000
NODE_30238_length_560_cov_5.056399	299	379	2	44	80	0.5500000
NODE_30238_length_560_cov_5.056399	352	432	2	80	80	1.0000000
NODE_30244_length_560_cov_4.518438	156	236	0	80	80	1.0000000
NODE_30281_length_560_cov_2.154013	204	275	0	71	71	1.0000000
NODE_30281_length_560_cov_2.154013	255	335	0	32	80	0.4000000
NODE_30281_length_560_cov_2.154013	255	335	2	48	80	0.6000000
NODE_30288_length_560_cov_2.017354	52	114	0	62	62	1.0000000
NODE_30363_length_559_cov_37.526087	289	370	0	81	81	1.0000000
NODE_30363_length_559_cov_37.526087	343	423	0	80	80	1.0000000
NODE_30363_length_559_cov_37.526087	419	500	0	81	81	1.0000000
NODE_30363_length_559_cov_37.526087	473	553	0	80	80	1.0000000
NODE_30365_length_559_cov_19.126087	388	468	8	40	80	0.5000000
NODE_30365_length_559_cov_19.126087	388	468	10	7	80	0.0875000
NODE_30365_length_559_cov_19.126087	388	468	11	11	80	0.1375000
NODE_30365_length_559_cov_19.126087	388	468	12	22	80	0.2750000
NODE_30365_length_559_cov_19.126087	441	521	2	24	80	0.3000000
NODE_30365_length_559_cov_19.126087	441	521	4	14	80	0.1750000
NODE_30365_length_559_cov_19.126087	441	521	8	9	80	0.1125000
NODE_30365_length_559_cov_19.126087	441	521	11	17	80	0.2125000
NODE_30365_length_559_cov_19.126087	441	521	12	16	80	0.2000000
NODE_30366_length_559_cov_12.489130	262	341	0	24	79	0.3037975
NODE_30366_length_559_cov_12.489130	262	341	2	10	79	0.1265823
NODE_30366_length_559_cov_12.489130	262	341	4	45	79	0.5696203
NODE_30366_length_559_cov_12.489130	316	394	0	77	78	0.9871795
NODE_30366_length_559_cov_12.489130	316	394	2	1	78	0.0128205
NODE_30370_length_559_cov_6.530435	283	363	0	51	80	0.6375000
NODE_30370_length_559_cov_6.530435	283	363	4	29	80	0.3625000
NODE_30377_length_559_cov_4.930435	112	192	0	80	80	1.0000000
NODE_30377_length_559_cov_4.930435	165	244	0	79	79	1.0000000
NODE_30419_length_559_cov_1.776087	395	433	68	5	38	0.1315790
NODE_30419_length_559_cov_1.776087	395	433	69	8	38	0.2105263
NODE_30419_length_559_cov_1.776087	395	433	71	2	38	0.0526316
NODE_30419_length_559_cov_1.776087	395	433	72	2	38	0.0526316
NODE_30419_length_559_cov_1.776087	395	433	73	8	38	0.2105263
NODE_30419_length_559_cov_1.776087	395	433	75	1	38	0.0263158
NODE_30419_length_559_cov_1.776087	395	433	76	2	38	0.0526316
NODE_30419_length_559_cov_1.776087	395	433	77	2	38	0.0526316
NODE_30419_length_559_cov_1.776087	395	433	78	1	38	0.0263158
NODE_30419_length_559_cov_1.776087	395	433	80	1	38	0.0263158
NODE_30419_length_559_cov_1.776087	395	433	82	2	38	0.0526316
NODE_30419_length_559_cov_1.776087	395	433	84	2	38	0.0526316
NODE_30419_length_559_cov_1.776087	395	433	86	2	38	0.0526316
NODE_30480_length_558_cov_13.102397	297	364	0	42	67	0.6268657
NODE_30480_length_558_cov_13.102397	297	364	2	25	67	0.3731343
NODE_30482_length_558_cov_9.309368	369	449	0	62	80	0.7750000
NODE_30482_length_558_cov_9.309368	369	449	2	18	80	0.2250000
NODE_30482_length_558_cov_9.309368	422	502	0	80	80	1.0000000
NODE_30489_length_558_cov_5.921569	304	361	0	14	57	0.2456140
NODE_30489_length_558_cov_5.921569	304	361	2	43	57	0.7543859
NODE_30493_length_558_cov_4.801743	197	266	2	69	69	1.0000000
NODE_30493_length_558_cov_4.801743	197	277	0	11	80	0.1375000
NODE_30493_length_558_cov_4.801743	197	277	2	69	80	0.8625000
NODE_30493_length_558_cov_4.801743	250	330	0	44	80	0.5500000
NODE_30493_length_558_cov_4.801743	250	330	2	36	80	0.4500000
NODE_30493_length_558_cov_4.801743	250	330	0	44	80	0.5500000
NODE_30493_length_558_cov_4.801743	250	330	2	36	80	0.4500000
NODE_30495_length_558_cov_4.570806	188	244	4	56	56	1.0000000
NODE_30536_length_558_cov_2.259259	236	294	2	23	58	0.3965517
NODE_30536_length_558_cov_2.259259	236	294	4	35	58	0.6034483
NODE_30536_length_558_cov_2.259259	267	347	2	38	80	0.4750000
NODE_30536_length_558_cov_2.259259	267	347	4	42	80	0.5250000
NODE_30568_length_558_cov_1.544662	403	483	0	46	80	0.5750000
NODE_30568_length_558_cov_1.544662	403	483	4	34	80	0.4250000
NODE_30568_length_558_cov_1.544662	456	536	4	80	80	1.0000000
NODE_30623_length_557_cov_9.141921	255	335	0	80	80	1.0000000
NODE_30623_length_557_cov_9.141921	308	388	0	80	80	1.0000000
NODE_30626_length_557_cov_7.316594	210	290	0	36	80	0.4500000
NODE_30626_length_557_cov_7.316594	210	290	1	12	80	0.1500000
NODE_30626_length_557_cov_7.316594	210	290	2	13	80	0.1625000
NODE_30626_length_557_cov_7.316594	210	290	4	2	80	0.0250000
NODE_30626_length_557_cov_7.316594	210	290	6	17	80	0.2125000
NODE_30626_length_557_cov_7.316594	263	341	0	78	78	1.0000000
NODE_30636_length_557_cov_4.259825	185	267	2	15	82	0.1829268
NODE_30636_length_557_cov_4.259825	185	267	4	60	82	0.7317073
NODE_30636_length_557_cov_4.259825	185	267	6	7	82	0.0853659
NODE_30646_length_557_cov_3.794760	131	188	4	57	57	1.0000000
NODE_30646_length_557_cov_3.794760	139	219	2	26	80	0.3250000
NODE_30646_length_557_cov_3.794760	139	219	4	54	80	0.6750000
NODE_30650_length_557_cov_3.517467	246	325	0	25	79	0.3164557
NODE_30650_length_557_cov_3.517467	246	325	4	54	79	0.6835443
NODE_30650_length_557_cov_3.517467	298	378	0	32	80	0.4000000
NODE_30650_length_557_cov_3.517467	298	378	2	46	80	0.5750000
NODE_30650_length_557_cov_3.517467	298	378	4	2	80	0.0250000
NODE_30652_length_557_cov_3.390830	366	395	19	4	29	0.1379310
NODE_30652_length_557_cov_3.390830	366	395	21	8	29	0.2758621
NODE_30652_length_557_cov_3.390830	366	395	23	9	29	0.3103448
NODE_30652_length_557_cov_3.390830	366	395	25	4	29	0.1379310
NODE_30652_length_557_cov_3.390830	366	395	26	4	29	0.1379310
NODE_30792_length_556_cov_37.258206	122	202	0	28	80	0.3500000
NODE_30792_length_556_cov_37.258206	122	202	3	2	80	0.0250000
NODE_30792_length_556_cov_37.258206	122	202	4	50	80	0.6250000
NODE_30792_length_556_cov_37.258206	175	255	0	5	80	0.0625000
NODE_30792_length_556_cov_37.258206	175	255	3	1	80	0.0125000
NODE_30792_length_556_cov_37.258206	175	255	4	74	80	0.9250000
NODE_30793_length_556_cov_15.266958	360	440	0	4	80	0.0500000
NODE_30793_length_556_cov_15.266958	360	440	2	24	80	0.3000000
NODE_30793_length_556_cov_15.266958	360	440	4	1	80	0.0125000
NODE_30793_length_556_cov_15.266958	360	440	6	51	80	0.6375000
NODE_30793_length_556_cov_15.266958	413	493	0	57	80	0.7125000
NODE_30793_length_556_cov_15.266958	413	493	2	23	80	0.2875000
NODE_30794_length_556_cov_12.781182	341	421	0	15	80	0.1875000
NODE_30794_length_556_cov_12.781182	341	421	2	65	80	0.8125000
NODE_30794_length_556_cov_12.781182	394	474	0	34	80	0.4250000
NODE_30794_length_556_cov_12.781182	394	474	2	46	80	0.5750000
NODE_30795_length_556_cov_11.131291	304	384	0	9	80	0.1125000
NODE_30795_length_556_cov_11.131291	304	384	2	71	80	0.8875000
NODE_30795_length_556_cov_11.131291	357	437	0	62	80	0.7750000
NODE_30795_length_556_cov_11.131291	357	437	2	18	80	0.2250000
NODE_30797_length_556_cov_7.168490	163	243	0	80	80	1.0000000
NODE_30797_length_556_cov_7.168490	216	296	0	80	80	1.0000000
NODE_30798_length_556_cov_7.089716	325	379	2	40	54	0.7407407
NODE_30798_length_556_cov_7.089716	325	379	8	14	54	0.2592593
NODE_30801_length_556_cov_6.505470	232	312	0	29	80	0.3625000
NODE_30801_length_556_cov_6.505470	232	312	2	29	80	0.3625000
NODE_30801_length_556_cov_6.505470	232	312	6	22	80	0.2750000
NODE_30801_length_556_cov_6.505470	285	365	2	5	80	0.0625000
NODE_30801_length_556_cov_6.505470	285	365	6	75	80	0.9375000
NODE_30802_length_556_cov_6.496718	140	179	2	11	39	0.2820513
NODE_30802_length_556_cov_6.496718	140	179	6	23	39	0.5897436
NODE_30802_length_556_cov_6.496718	140	179	8	5	39	0.1282051
NODE_30802_length_556_cov_6.496718	226	255	2	29	29	1.0000000
NODE_30809_length_556_cov_4.457330	197	277	16	20	80	0.2500000
NODE_30809_length_556_cov_4.457330	197	277	20	21	80	0.2625000
NODE_30809_length_556_cov_4.457330	197	277	22	12	80	0.1500000
NODE_30809_length_556_cov_4.457330	197	277	24	1	80	0.0125000
NODE_30809_length_556_cov_4.457330	197	277	25	4	80	0.0500000
NODE_30809_length_556_cov_4.457330	197	277	26	14	80	0.1750000
NODE_30809_length_556_cov_4.457330	197	277	27	4	80	0.0500000
NODE_30809_length_556_cov_4.457330	197	277	28	1	80	0.0125000
NODE_30809_length_556_cov_4.457330	197	277	31	3	80	0.0375000
NODE_30818_length_556_cov_3.761488	234	307	0	27	73	0.3698630
NODE_30818_length_556_cov_3.761488	234	307	3	3	73	0.0410959
NODE_30818_length_556_cov_3.761488	234	307	5	4	73	0.0547945
NODE_30818_length_556_cov_3.761488	234	307	6	39	73	0.5342466
NODE_30930_length_555_cov_20.949561	322	402	0	12	80	0.1500000
NODE_30930_length_555_cov_20.949561	322	402	2	39	80	0.4875000
NODE_30930_length_555_cov_20.949561	322	402	9	29	80	0.3625000
NODE_30930_length_555_cov_20.949561	375	455	0	50	80	0.6250000
NODE_30930_length_555_cov_20.949561	375	455	2	30	80	0.3750000
NODE_30931_length_555_cov_16.822368	268	348	0	80	80	1.0000000
NODE_30931_length_555_cov_16.822368	321	401	0	80	80	1.0000000
NODE_30933_length_555_cov_9.912281	313	393	0	80	80	1.0000000
NODE_30935_length_555_cov_8.057018	277	357	0	80	80	1.0000000
NODE_30935_length_555_cov_8.057018	330	410	0	80	80	1.0000000
NODE_30938_length_555_cov_6.778509	62	92	0	30	30	1.0000000
NODE_30986_length_555_cov_2.177632	208	288	0	23	80	0.2875000
NODE_30986_length_555_cov_2.177632	208	288	2	57	80	0.7125000
NODE_30986_length_555_cov_2.177632	261	329	0	39	68	0.5735294
NODE_30986_length_555_cov_2.177632	261	329	2	29	68	0.4264706
NODE_31092_length_554_cov_11.942857	118	198	0	80	80	1.0000000
NODE_31092_length_554_cov_11.942857	171	251	0	80	80	1.0000000
NODE_31096_length_554_cov_8.426374	242	322	0	15	80	0.1875000
NODE_31096_length_554_cov_8.426374	242	322	1	5	80	0.0625000
NODE_31096_length_554_cov_8.426374	242	322	2	60	80	0.7500000
NODE_31096_length_554_cov_8.426374	295	375	0	15	80	0.1875000
NODE_31096_length_554_cov_8.426374	295	375	1	5	80	0.0625000
NODE_31096_length_554_cov_8.426374	295	375	2	60	80	0.7500000
NODE_31101_length_554_cov_6.116484	264	344	0	80	80	1.0000000
NODE_31101_length_554_cov_6.116484	317	393	0	76	76	1.0000000
NODE_31115_length_554_cov_3.586813	207	286	0	52	79	0.6582279
NODE_31115_length_554_cov_3.586813	207	286	2	27	79	0.3417721
NODE_31240_length_553_cov_42.017621	197	277	0	38	80	0.4750000
NODE_31240_length_553_cov_42.017621	197	277	2	42	80	0.5250000
NODE_31240_length_553_cov_42.017621	250	330	0	2	80	0.0250000
NODE_31240_length_553_cov_42.017621	250	330	2	78	80	0.9750000
NODE_31241_length_553_cov_28.944934	333	413	0	13	80	0.1625000
NODE_31241_length_553_cov_28.944934	333	413	2	67	80	0.8375000
NODE_31241_length_553_cov_28.944934	386	466	0	66	80	0.8250000
NODE_31241_length_553_cov_28.944934	386	466	2	14	80	0.1750000
NODE_31242_length_553_cov_12.176211	242	322	2	15	80	0.1875000
NODE_31242_length_553_cov_12.176211	242	322	6	15	80	0.1875000
NODE_31242_length_553_cov_12.176211	242	322	7	6	80	0.0750000
NODE_31242_length_553_cov_12.176211	242	322	8	44	80	0.5500000
NODE_31242_length_553_cov_12.176211	295	375	6	68	80	0.8500000
NODE_31242_length_553_cov_12.176211	295	375	7	5	80	0.0625000
NODE_31242_length_553_cov_12.176211	295	375	8	7	80	0.0875000
NODE_31244_length_553_cov_9.876652	232	312	4	64	80	0.8000000
NODE_31244_length_553_cov_9.876652	232	312	6	16	80	0.2000000
NODE_31244_length_553_cov_9.876652	285	365	2	10	80	0.1250000
NODE_31244_length_553_cov_9.876652	285	365	4	13	80	0.1625000
NODE_31244_length_553_cov_9.876652	285	365	6	57	80	0.7125000
NODE_31246_length_553_cov_9.306167	207	287	2	40	80	0.5000000
NODE_31246_length_553_cov_9.306167	207	287	3	1	80	0.0125000
NODE_31246_length_553_cov_9.306167	207	287	4	39	80	0.4875000
NODE_31246_length_553_cov_9.306167	207	287	2	40	80	0.5000000
NODE_31246_length_553_cov_9.306167	207	287	3	1	80	0.0125000
NODE_31246_length_553_cov_9.306167	207	287	4	39	80	0.4875000
NODE_31246_length_553_cov_9.306167	260	340	2	80	80	1.0000000
NODE_31259_length_553_cov_3.729075	36	93	12	2	57	0.0350877
NODE_31259_length_553_cov_3.729075	36	93	14	55	57	0.9649123
NODE_31259_length_553_cov_3.729075	89	146	5	2	57	0.0350877
NODE_31259_length_553_cov_3.729075	89	146	6	7	57	0.1228070
NODE_31259_length_553_cov_3.729075	89	146	8	22	57	0.3859649
NODE_31259_length_553_cov_3.729075	89	146	10	4	57	0.0701754
NODE_31259_length_553_cov_3.729075	89	146	12	1	57	0.0175439
NODE_31259_length_553_cov_3.729075	89	146	14	21	57	0.3684210
NODE_31266_length_553_cov_3.310573	226	293	0	67	67	1.0000000
NODE_31279_length_553_cov_2.678414	102	180	0	78	78	1.0000000
NODE_31279_length_553_cov_2.678414	248	275	0	27	27	1.0000000
NODE_31295_length_553_cov_1.958150	416	462	10	1	46	0.0217391
NODE_31295_length_553_cov_1.958150	416	462	12	2	46	0.0434783
NODE_31295_length_553_cov_1.958150	416	462	14	2	46	0.0434783
NODE_31295_length_553_cov_1.958150	416	462	16	3	46	0.0652174
NODE_31295_length_553_cov_1.958150	416	462	18	18	46	0.3913043
NODE_31295_length_553_cov_1.958150	416	462	20	2	46	0.0434783
NODE_31295_length_553_cov_1.958150	416	462	22	3	46	0.0652174
NODE_31295_length_553_cov_1.958150	416	462	24	9	46	0.1956522
NODE_31295_length_553_cov_1.958150	416	462	26	6	46	0.1304348
NODE_31295_length_553_cov_1.958150	469	515	20	10	46	0.2173913
NODE_31295_length_553_cov_1.958150	469	515	22	2	46	0.0434783
NODE_31295_length_553_cov_1.958150	469	515	24	1	46	0.0217391
NODE_31295_length_553_cov_1.958150	469	515	26	33	46	0.7173913
NODE_31377_length_552_cov_92.070640	298	378	0	54	80	0.6750000
NODE_31377_length_552_cov_92.070640	298	378	1	24	80	0.3000000
NODE_31377_length_552_cov_92.070640	298	378	2	2	80	0.0250000
NODE_31377_length_552_cov_92.070640	298	378	0	54	80	0.6750000
NODE_31377_length_552_cov_92.070640	298	378	1	24	80	0.3000000
NODE_31377_length_552_cov_92.070640	298	378	2	2	80	0.0250000
NODE_31377_length_552_cov_92.070640	374	454	1	2	80	0.0250000
NODE_31377_length_552_cov_92.070640	374	454	2	40	80	0.5000000
NODE_31377_length_552_cov_92.070640	374	454	6	17	80	0.2125000
NODE_31377_length_552_cov_92.070640	374	454	8	21	80	0.2625000
NODE_31377_length_552_cov_92.070640	374	454	1	2	80	0.0250000
NODE_31377_length_552_cov_92.070640	374	454	2	40	80	0.5000000
NODE_31377_length_552_cov_92.070640	374	454	6	17	80	0.2125000
NODE_31377_length_552_cov_92.070640	374	454	8	21	80	0.2625000
NODE_31377_length_552_cov_92.070640	374	454	1	2	80	0.0250000
NODE_31377_length_552_cov_92.070640	374	454	2	40	80	0.5000000
NODE_31377_length_552_cov_92.070640	374	454	6	17	80	0.2125000
NODE_31377_length_552_cov_92.070640	374	454	8	21	80	0.2625000
NODE_31377_length_552_cov_92.070640	374	454	1	2	80	0.0250000
NODE_31377_length_552_cov_92.070640	374	454	2	40	80	0.5000000
NODE_31377_length_552_cov_92.070640	374	454	6	17	80	0.2125000
NODE_31377_length_552_cov_92.070640	374	454	8	21	80	0.2625000
NODE_31377_length_552_cov_92.070640	374	450	1	2	76	0.0263158
NODE_31377_length_552_cov_92.070640	374	450	2	40	76	0.5263158
NODE_31377_length_552_cov_92.070640	374	450	6	17	76	0.2236842
NODE_31377_length_552_cov_92.070640	374	450	8	17	76	0.2236842
NODE_31377_length_552_cov_92.070640	427	507	6	6	80	0.0750000
NODE_31377_length_552_cov_92.070640	427	507	7	5	80	0.0625000
NODE_31377_length_552_cov_92.070640	427	507	8	69	80	0.8625000
NODE_31377_length_552_cov_92.070640	427	507	6	6	80	0.0750000
NODE_31377_length_552_cov_92.070640	427	507	7	5	80	0.0625000
NODE_31377_length_552_cov_92.070640	427	507	8	69	80	0.8625000
NODE_31377_length_552_cov_92.070640	427	498	6	6	71	0.0845070
NODE_31377_length_552_cov_92.070640	427	498	8	65	71	0.9154930
NODE_31377_length_552_cov_92.070640	430	500	6	3	70	0.0428571
NODE_31377_length_552_cov_92.070640	430	500	8	67	70	0.9571428
NODE_31377_length_552_cov_92.070640	432	507	6	1	75	0.0133333
NODE_31377_length_552_cov_92.070640	432	507	7	5	75	0.0666667
NODE_31377_length_552_cov_92.070640	432	507	8	69	75	0.9200000
NODE_31378_length_552_cov_20.432671	151	231	2	51	80	0.6375000
NODE_31378_length_552_cov_20.432671	151	231	3	23	80	0.2875000
NODE_31378_length_552_cov_20.432671	151	231	4	6	80	0.0750000
NODE_31378_length_552_cov_20.432671	204	284	0	15	80	0.1875000
NODE_31378_length_552_cov_20.432671	204	284	1	6	80	0.0750000
NODE_31378_length_552_cov_20.432671	204	284	3	55	80	0.6875000
NODE_31378_length_552_cov_20.432671	204	284	4	4	80	0.0500000
NODE_31379_length_552_cov_18.075055	257	333	0	25	76	0.3289474
NODE_31379_length_552_cov_18.075055	257	333	2	4	76	0.0526316
NODE_31379_length_552_cov_18.075055	257	333	4	7	76	0.0921053
NODE_31379_length_552_cov_18.075055	257	333	6	40	76	0.5263158
NODE_31380_length_552_cov_13.331126	214	294	4	37	80	0.4625000
NODE_31380_length_552_cov_13.331126	214	294	6	43	80	0.5375000
NODE_31380_length_552_cov_13.331126	267	347	0	7	80	0.0875000
NODE_31380_length_552_cov_13.331126	267	347	4	73	80	0.9125000
NODE_31381_length_552_cov_12.774834	360	440	0	80	80	1.0000000
NODE_31381_length_552_cov_12.774834	413	493	0	80	80	1.0000000
NODE_31384_length_552_cov_8.883002	310	390	0	29	80	0.3625000
NODE_31384_length_552_cov_8.883002	310	390	2	51	80	0.6375000
NODE_31384_length_552_cov_8.883002	363	443	0	33	80	0.4125000
NODE_31384_length_552_cov_8.883002	363	443	2	47	80	0.5875000
NODE_31385_length_552_cov_6.916115	206	281	4	75	75	1.0000000
NODE_31538_length_551_cov_34.070796	324	406	0	82	82	1.0000000
NODE_31538_length_551_cov_34.070796	379	444	0	65	65	1.0000000
NODE_31541_length_551_cov_10.252212	164	244	0	80	80	1.0000000
NODE_31541_length_551_cov_10.252212	217	297	0	80	80	1.0000000
NODE_31543_length_551_cov_8.075221	363	406	0	5	43	0.1162791
NODE_31543_length_551_cov_8.075221	363	406	2	36	43	0.8372093
NODE_31543_length_551_cov_8.075221	363	406	4	2	43	0.0465116
NODE_31547_length_551_cov_5.668142	213	293	2	8	80	0.1000000
NODE_31547_length_551_cov_5.668142	213	293	4	72	80	0.9000000
NODE_31547_length_551_cov_5.668142	266	346	2	25	80	0.3125000
NODE_31547_length_551_cov_5.668142	266	346	4	55	80	0.6875000
NODE_31552_length_551_cov_4.212389	171	242	0	9	71	0.1267606
NODE_31552_length_551_cov_4.212389	171	242	2	37	71	0.5211267
NODE_31552_length_551_cov_4.212389	171	242	4	25	71	0.3521127
NODE_31552_length_551_cov_4.212389	215	263	0	30	48	0.6250000
NODE_31552_length_551_cov_4.212389	215	263	2	18	48	0.3750000
NODE_31563_length_551_cov_3.307522	227	307	0	80	80	1.0000000
NODE_31563_length_551_cov_3.307522	280	360	0	80	80	1.0000000
NODE_31693_length_550_cov_17.308204	101	181	0	80	80	1.0000000
NODE_31693_length_550_cov_17.308204	154	234	0	80	80	1.0000000
NODE_31700_length_550_cov_5.580931	286	329	0	43	43	1.0000000
NODE_31701_length_550_cov_5.490022	458	500	0	42	42	1.0000000
NODE_31701_length_550_cov_5.490022	459	523	0	64	64	1.0000000
NODE_31703_length_550_cov_5.243902	194	274	0	80	80	1.0000000
NODE_31703_length_550_cov_5.243902	247	327	0	80	80	1.0000000
NODE_31706_length_550_cov_4.815965	184	264	0	80	80	1.0000000
NODE_31726_length_550_cov_3.252772	308	388	0	2	80	0.0250000
NODE_31726_length_550_cov_3.252772	308	388	2	12	80	0.1500000
NODE_31726_length_550_cov_3.252772	308	388	4	12	80	0.1500000
NODE_31726_length_550_cov_3.252772	308	388	5	13	80	0.1625000
NODE_31726_length_550_cov_3.252772	308	388	7	41	80	0.5125000
NODE_31756_length_550_cov_1.864745	189	259	0	26	70	0.3714286
NODE_31756_length_550_cov_1.864745	189	259	4	44	70	0.6285715
NODE_31756_length_550_cov_1.864745	189	258	0	26	69	0.3768116
NODE_31756_length_550_cov_1.864745	189	258	4	43	69	0.6231884
NODE_31847_length_549_cov_31.826667	216	292	56	1	76	0.0131579
NODE_31847_length_549_cov_31.826667	216	292	58	3	76	0.0394737
NODE_31847_length_549_cov_31.826667	216	292	61	1	76	0.0131579
NODE_31847_length_549_cov_31.826667	216	292	62	2	76	0.0263158
NODE_31847_length_549_cov_31.826667	216	292	64	4	76	0.0526316
NODE_31847_length_549_cov_31.826667	216	292	66	5	76	0.0657895
NODE_31847_length_549_cov_31.826667	216	292	68	4	76	0.0526316
NODE_31847_length_549_cov_31.826667	216	292	70	2	76	0.0263158
NODE_31847_length_549_cov_31.826667	216	292	72	13	76	0.1710526
NODE_31847_length_549_cov_31.826667	216	292	74	5	76	0.0657895
NODE_31847_length_549_cov_31.826667	216	292	76	11	76	0.1447368
NODE_31847_length_549_cov_31.826667	216	292	78	1	76	0.0131579
NODE_31847_length_549_cov_31.826667	216	292	80	8	76	0.1052632
NODE_31847_length_549_cov_31.826667	216	292	82	2	76	0.0263158
NODE_31847_length_549_cov_31.826667	216	292	83	1	76	0.0131579
NODE_31847_length_549_cov_31.826667	216	292	84	13	76	0.1710526
NODE_31847_length_549_cov_31.826667	267	331	22	1	64	0.0156250
NODE_31847_length_549_cov_31.826667	267	331	24	2	64	0.0312500
NODE_31847_length_549_cov_31.826667	267	331	28	1	64	0.0156250
NODE_31847_length_549_cov_31.826667	267	331	30	4	64	0.0625000
NODE_31847_length_549_cov_31.826667	267	331	34	3	64	0.0468750
NODE_31847_length_549_cov_31.826667	267	331	36	2	64	0.0312500
NODE_31847_length_549_cov_31.826667	267	331	38	1	64	0.0156250
NODE_31847_length_549_cov_31.826667	267	331	40	14	64	0.2187500
NODE_31847_length_549_cov_31.826667	267	331	44	1	64	0.0156250
NODE_31847_length_549_cov_31.826667	267	331	48	2	64	0.0312500
NODE_31847_length_549_cov_31.826667	267	331	54	2	64	0.0312500
NODE_31847_length_549_cov_31.826667	267	331	58	1	64	0.0156250
NODE_31847_length_549_cov_31.826667	267	331	60	1	64	0.0156250
NODE_31847_length_549_cov_31.826667	267	331	64	5	64	0.0781250
NODE_31847_length_549_cov_31.826667	267	331	66	5	64	0.0781250
NODE_31847_length_549_cov_31.826667	267	331	68	4	64	0.0625000
NODE_31847_length_549_cov_31.826667	267	331	78	1	64	0.0156250
NODE_31847_length_549_cov_31.826667	267	331	80	1	64	0.0156250
NODE_31847_length_549_cov_31.826667	267	331	82	1	64	0.0156250
NODE_31847_length_549_cov_31.826667	267	331	83	1	64	0.0156250
NODE_31847_length_549_cov_31.826667	267	331	84	11	64	0.1718750
NODE_31848_length_549_cov_14.124444	174	263	0	15	89	0.1685393
NODE_31848_length_549_cov_14.124444	174	263	2	56	89	0.6292135
NODE_31848_length_549_cov_14.124444	174	263	4	5	89	0.0561798
NODE_31848_length_549_cov_14.124444	174	263	6	13	89	0.1460674
NODE_31848_length_549_cov_14.124444	242	315	2	3	73	0.0410959
NODE_31848_length_549_cov_14.124444	242	315	4	26	73	0.3561644
NODE_31848_length_549_cov_14.124444	242	315	6	44	73	0.6027398
NODE_31857_length_549_cov_5.375556	181	257	144	1	76	0.0131579
NODE_31857_length_549_cov_5.375556	181	257	157	4	76	0.0526316
NODE_31857_length_549_cov_5.375556	181	257	161	3	76	0.0394737
NODE_31857_length_549_cov_5.375556	181	257	162	3	76	0.0394737
NODE_31857_length_549_cov_5.375556	181	257	163	2	76	0.0263158
NODE_31857_length_549_cov_5.375556	181	257	164	4	76	0.0526316
NODE_31857_length_549_cov_5.375556	181	257	165	4	76	0.0526316
NODE_31857_length_549_cov_5.375556	181	257	166	4	76	0.0526316
NODE_31857_length_549_cov_5.375556	181	257	167	4	76	0.0526316
NODE_31857_length_549_cov_5.375556	181	257	169	5	76	0.0657895
NODE_31857_length_549_cov_5.375556	181	257	171	1	76	0.0131579
NODE_31857_length_549_cov_5.375556	181	257	173	2	76	0.0263158
NODE_31857_length_549_cov_5.375556	181	257	174	1	76	0.0131579
NODE_31857_length_549_cov_5.375556	181	257	175	5	76	0.0657895
NODE_31857_length_549_cov_5.375556	181	257	177	4	76	0.0526316
NODE_31857_length_549_cov_5.375556	181	257	178	4	76	0.0526316
NODE_31857_length_549_cov_5.375556	181	257	180	4	76	0.0526316
NODE_31857_length_549_cov_5.375556	181	257	181	3	76	0.0394737
NODE_31857_length_549_cov_5.375556	181	257	182	8	76	0.1052632
NODE_31857_length_549_cov_5.375556	181	257	184	10	76	0.1315790
NODE_31859_length_549_cov_4.933333	260	340	0	80	80	1.0000000
NODE_31864_length_549_cov_4.537778	345	430	0	36	85	0.4235294
NODE_31864_length_549_cov_4.537778	345	430	2	49	85	0.5764706
NODE_31864_length_549_cov_4.537778	403	483	0	2	80	0.0250000
NODE_31864_length_549_cov_4.537778	403	483	2	78	80	0.9750000
NODE_31865_length_549_cov_4.124444	406	486	29	4	80	0.0500000
NODE_31865_length_549_cov_4.124444	406	486	32	1	80	0.0125000
NODE_31865_length_549_cov_4.124444	406	486	35	1	80	0.0125000
NODE_31865_length_549_cov_4.124444	406	486	39	4	80	0.0500000
NODE_31865_length_549_cov_4.124444	406	486	41	2	80	0.0250000
NODE_31865_length_549_cov_4.124444	406	486	43	6	80	0.0750000
NODE_31865_length_549_cov_4.124444	406	486	45	22	80	0.2750000
NODE_31865_length_549_cov_4.124444	406	486	46	1	80	0.0125000
NODE_31865_length_549_cov_4.124444	406	486	47	16	80	0.2000000
NODE_31865_length_549_cov_4.124444	406	486	49	11	80	0.1375000
NODE_31865_length_549_cov_4.124444	406	486	51	12	80	0.1500000
NODE_31866_length_549_cov_3.931111	182	219	2	37	37	1.0000000
NODE_31868_length_549_cov_3.893333	287	367	0	80	80	1.0000000
NODE_31868_length_549_cov_3.893333	340	420	0	80	80	1.0000000
NODE_31887_length_549_cov_2.673333	282	343	4	2	61	0.0327869
NODE_31887_length_549_cov_2.673333	282	343	6	29	61	0.4754098
NODE_31887_length_549_cov_2.673333	282	343	8	21	61	0.3442623
NODE_31887_length_549_cov_2.673333	282	343	12	9	61	0.1475410
NODE_31890_length_549_cov_2.622222	144	220	0	16	76	0.2105263
NODE_31890_length_549_cov_2.622222	144	220	2	60	76	0.7894737
NODE_32013_length_548_cov_13.962138	285	371	0	86	86	1.0000000
NODE_32013_length_548_cov_13.962138	344	424	0	80	80	1.0000000
NODE_32022_length_548_cov_4.683742	261	336	0	75	75	1.0000000
NODE_32023_length_548_cov_4.670379	140	182	0	42	42	1.0000000
NODE_32023_length_548_cov_4.670379	282	311	2	29	29	1.0000000
NODE_32023_length_548_cov_4.670379	410	455	4	45	45	1.0000000
NODE_32029_length_548_cov_3.630290	111	177	0	3	66	0.0454545
NODE_32029_length_548_cov_3.630290	111	177	2	63	66	0.9545454
NODE_32039_length_548_cov_3.080178	142	191	2	9	49	0.1836735
NODE_32039_length_548_cov_3.080178	142	191	4	16	49	0.3265306
NODE_32039_length_548_cov_3.080178	142	191	6	24	49	0.4897959
NODE_32180_length_547_cov_23.982143	243	323	0	45	80	0.5625000
NODE_32180_length_547_cov_23.982143	243	323	2	35	80	0.4375000
NODE_32180_length_547_cov_23.982143	243	323	0	45	80	0.5625000
NODE_32180_length_547_cov_23.982143	243	323	2	35	80	0.4375000
NODE_32180_length_547_cov_23.982143	252	323	0	45	71	0.6338028
NODE_32180_length_547_cov_23.982143	252	323	2	26	71	0.3661972
NODE_32181_length_547_cov_23.555804	42	122	2	4	80	0.0500000
NODE_32181_length_547_cov_23.555804	42	122	4	61	80	0.7625000
NODE_32181_length_547_cov_23.555804	42	122	6	15	80	0.1875000
NODE_32181_length_547_cov_23.555804	95	175	2	57	80	0.7125000
NODE_32181_length_547_cov_23.555804	95	175	4	8	80	0.1000000
NODE_32181_length_547_cov_23.555804	95	175	6	15	80	0.1875000
NODE_32183_length_547_cov_12.819196	190	270	0	6	80	0.0750000
NODE_32183_length_547_cov_12.819196	190	270	4	15	80	0.1875000
NODE_32183_length_547_cov_12.819196	190	270	6	59	80	0.7375000
NODE_32195_length_547_cov_5.207589	290	370	4	45	80	0.5625000
NODE_32195_length_547_cov_5.207589	290	370	6	4	80	0.0500000
NODE_32195_length_547_cov_5.207589	290	370	8	1	80	0.0125000
NODE_32195_length_547_cov_5.207589	290	370	9	13	80	0.1625000
NODE_32195_length_547_cov_5.207589	290	370	10	17	80	0.2125000
NODE_32195_length_547_cov_5.207589	343	423	8	1	80	0.0125000
NODE_32195_length_547_cov_5.207589	343	423	9	16	80	0.2000000
NODE_32195_length_547_cov_5.207589	343	423	10	13	80	0.1625000
NODE_32195_length_547_cov_5.207589	343	423	15	3	80	0.0375000
NODE_32195_length_547_cov_5.207589	343	423	20	1	80	0.0125000
NODE_32195_length_547_cov_5.207589	343	423	21	3	80	0.0375000
NODE_32195_length_547_cov_5.207589	343	423	23	1	80	0.0125000
NODE_32195_length_547_cov_5.207589	343	423	24	6	80	0.0750000
NODE_32195_length_547_cov_5.207589	343	423	25	4	80	0.0500000
NODE_32195_length_547_cov_5.207589	343	423	28	9	80	0.1125000
NODE_32195_length_547_cov_5.207589	343	423	34	23	80	0.2875000
NODE_32197_length_547_cov_4.975446	411	488	0	20	77	0.2597403
NODE_32197_length_547_cov_4.975446	411	488	2	10	77	0.1298701
NODE_32197_length_547_cov_4.975446	411	488	6	7	77	0.0909091
NODE_32197_length_547_cov_4.975446	411	488	10	40	77	0.5194805
NODE_32197_length_547_cov_4.975446	461	542	8	5	81	0.0617284
NODE_32197_length_547_cov_4.975446	461	542	10	76	81	0.9382716
NODE_32199_length_547_cov_4.683036	451	492	0	41	41	1.0000000
NODE_32204_length_547_cov_4.138393	97	175	0	13	78	0.1666667
NODE_32204_length_547_cov_4.138393	97	175	2	28	78	0.3589744
NODE_32204_length_547_cov_4.138393	97	175	4	37	78	0.4743590
NODE_32204_length_547_cov_4.138393	151	228	0	66	77	0.8571429
NODE_32204_length_547_cov_4.138393	151	228	2	11	77	0.1428571
NODE_32206_length_547_cov_4.026786	136	216	0	80	80	1.0000000
NODE_32206_length_547_cov_4.026786	189	269	0	80	80	1.0000000
NODE_32215_length_547_cov_3.468750	219	299	0	53	80	0.6625000
NODE_32215_length_547_cov_3.468750	219	299	2	27	80	0.3375000
NODE_32222_length_547_cov_2.901786	304	384	0	80	80	1.0000000
NODE_32347_length_546_cov_17.733781	159	239	0	15	80	0.1875000
NODE_32347_length_546_cov_17.733781	159	239	7	31	80	0.3875000
NODE_32347_length_546_cov_17.733781	159	239	8	34	80	0.4250000
NODE_32347_length_546_cov_17.733781	212	293	0	28	81	0.3456790
NODE_32347_length_546_cov_17.733781	212	293	7	37	81	0.4567901
NODE_32347_length_546_cov_17.733781	212	293	8	16	81	0.1975309
NODE_32348_length_546_cov_16.275168	272	352	0	80	80	1.0000000
NODE_32348_length_546_cov_16.275168	325	405	0	80	80	1.0000000
NODE_32349_length_546_cov_8.201342	179	259	2	9	80	0.1125000
NODE_32349_length_546_cov_8.201342	179	259	4	1	80	0.0125000
NODE_32349_length_546_cov_8.201342	179	259	6	70	80	0.8750000
NODE_32351_length_546_cov_7.454139	241	321	0	80	80	1.0000000
NODE_32351_length_546_cov_7.454139	294	374	0	80	80	1.0000000
NODE_32380_length_546_cov_3.192394	171	251	0	80	80	1.0000000
NODE_32510_length_545_cov_31.524664	38	118	0	30	80	0.3750000
NODE_32510_length_545_cov_31.524664	38	118	2	39	80	0.4875000
NODE_32510_length_545_cov_31.524664	38	118	10	6	80	0.0750000
NODE_32510_length_545_cov_31.524664	38	118	13	5	80	0.0625000
NODE_32510_length_545_cov_31.524664	91	171	2	16	80	0.2000000
NODE_32510_length_545_cov_31.524664	91	171	10	6	80	0.0750000
NODE_32510_length_545_cov_31.524664	91	171	13	45	80	0.5625000
NODE_32510_length_545_cov_31.524664	91	171	24	13	80	0.1625000
NODE_32517_length_545_cov_5.524664	268	348	0	33	80	0.4125000
NODE_32517_length_545_cov_5.524664	268	348	4	47	80	0.5875000
NODE_32525_length_545_cov_3.885650	137	217	0	24	80	0.3000000
NODE_32525_length_545_cov_3.885650	137	217	2	56	80	0.7000000
NODE_32571_length_545_cov_2.013453	246	318	0	72	72	1.0000000
NODE_32599_length_545_cov_1.450673	130	179	0	49	49	1.0000000
NODE_32616_length_545_cov_1.179372	431	469	0	38	38	1.0000000
NODE_32673_length_544_cov_37.705618	258	338	0	71	80	0.8875000
NODE_32673_length_544_cov_37.705618	258	338	2	9	80	0.1125000
NODE_32673_length_544_cov_37.705618	311	391	0	80	80	1.0000000
NODE_32674_length_544_cov_33.847191	189	269	0	80	80	1.0000000
NODE_32674_length_544_cov_33.847191	242	327	0	85	85	1.0000000
NODE_32675_length_544_cov_19.467416	251	331	0	80	80	1.0000000
NODE_32675_length_544_cov_19.467416	304	384	0	80	80	1.0000000
NODE_32676_length_544_cov_16.775281	163	243	0	44	80	0.5500000
NODE_32676_length_544_cov_16.775281	163	243	3	1	80	0.0125000
NODE_32676_length_544_cov_16.775281	163	243	4	35	80	0.4375000
NODE_32676_length_544_cov_16.775281	216	296	0	80	80	1.0000000
NODE_32677_length_544_cov_8.943820	81	161	0	24	80	0.3000000
NODE_32677_length_544_cov_8.943820	81	161	3	2	80	0.0250000
NODE_32677_length_544_cov_8.943820	81	161	4	26	80	0.3250000
NODE_32677_length_544_cov_8.943820	81	161	6	28	80	0.3500000
NODE_32677_length_544_cov_8.943820	134	214	0	3	80	0.0375000
NODE_32677_length_544_cov_8.943820	134	214	2	4	80	0.0500000
NODE_32677_length_544_cov_8.943820	134	214	4	28	80	0.3500000
NODE_32677_length_544_cov_8.943820	134	214	6	45	80	0.5625000
NODE_32678_length_544_cov_8.537079	283	363	0	27	80	0.3375000
NODE_32678_length_544_cov_8.537079	283	363	2	27	80	0.3375000
NODE_32678_length_544_cov_8.537079	283	363	4	26	80	0.3250000
NODE_32678_length_544_cov_8.537079	336	416	0	33	80	0.4125000
NODE_32678_length_544_cov_8.537079	336	416	2	47	80	0.5875000
NODE_32680_length_544_cov_8.440449	209	289	0	54	80	0.6750000
NODE_32680_length_544_cov_8.440449	209	289	2	26	80	0.3250000
NODE_32680_length_544_cov_8.440449	262	342	0	1	80	0.0125000
NODE_32680_length_544_cov_8.440449	262	342	2	79	80	0.9875000
NODE_32681_length_544_cov_7.604494	332	412	0	43	80	0.5375000
NODE_32681_length_544_cov_7.604494	332	412	2	37	80	0.4625000
NODE_32681_length_544_cov_7.604494	385	465	0	4	80	0.0500000
NODE_32681_length_544_cov_7.604494	385	465	2	76	80	0.9500000
NODE_32684_length_544_cov_6.000000	461	513	4	7	52	0.1346154
NODE_32684_length_544_cov_6.000000	461	513	5	19	52	0.3653846
NODE_32684_length_544_cov_6.000000	461	513	7	17	52	0.3269231
NODE_32684_length_544_cov_6.000000	461	513	9	9	52	0.1730769
NODE_32830_length_543_cov_38.790541	116	196	0	31	80	0.3875000
NODE_32830_length_543_cov_38.790541	116	196	2	49	80	0.6125000
NODE_32830_length_543_cov_38.790541	169	249	0	19	80	0.2375000
NODE_32830_length_543_cov_38.790541	169	249	2	61	80	0.7625000
NODE_32831_length_543_cov_31.713964	193	273	0	32	80	0.4000000
NODE_32831_length_543_cov_31.713964	193	273	2	48	80	0.6000000
NODE_32831_length_543_cov_31.713964	246	326	0	2	80	0.0250000
NODE_32831_length_543_cov_31.713964	246	326	2	78	80	0.9750000
NODE_32832_length_543_cov_13.689189	118	198	0	64	80	0.8000000
NODE_32832_length_543_cov_13.689189	118	198	2	16	80	0.2000000
NODE_32832_length_543_cov_13.689189	171	251	0	11	80	0.1375000
NODE_32832_length_543_cov_13.689189	171	251	2	69	80	0.8625000
NODE_32833_length_543_cov_10.601351	271	351	0	20	80	0.2500000
NODE_32833_length_543_cov_10.601351	271	351	2	60	80	0.7500000
NODE_32833_length_543_cov_10.601351	324	404	0	59	80	0.7375000
NODE_32833_length_543_cov_10.601351	324	404	2	21	80	0.2625000
NODE_32833_length_543_cov_10.601351	400	480	2	80	80	1.0000000
NODE_32833_length_543_cov_10.601351	453	533	0	15	80	0.1875000
NODE_32833_length_543_cov_10.601351	453	533	2	65	80	0.8125000
NODE_32834_length_543_cov_9.202703	291	341	3	14	50	0.2800000
NODE_32834_length_543_cov_9.202703	291	341	4	26	50	0.5200000
NODE_32834_length_543_cov_9.202703	291	341	5	10	50	0.2000000
NODE_32834_length_543_cov_9.202703	347	384	3	37	37	1.0000000
NODE_32835_length_543_cov_7.722973	300	378	8	21	78	0.2692308
NODE_32835_length_543_cov_7.722973	300	378	12	1	78	0.0128205
NODE_32835_length_543_cov_7.722973	300	378	13	7	78	0.0897436
NODE_32835_length_543_cov_7.722973	300	378	14	3	78	0.0384615
NODE_32835_length_543_cov_7.722973	300	378	16	46	78	0.5897436
NODE_32835_length_543_cov_7.722973	351	431	0	20	80	0.2500000
NODE_32835_length_543_cov_7.722973	351	431	6	30	80	0.3750000
NODE_32835_length_543_cov_7.722973	351	431	8	24	80	0.3000000
NODE_32835_length_543_cov_7.722973	351	431	12	1	80	0.0125000
NODE_32835_length_543_cov_7.722973	351	431	13	5	80	0.0625000
NODE_32836_length_543_cov_6.815315	181	260	0	79	79	1.0000000
NODE_32845_length_543_cov_4.704955	145	225	0	80	80	1.0000000
NODE_32845_length_543_cov_4.704955	198	275	0	77	77	1.0000000
NODE_32864_length_543_cov_3.301802	247	312	0	65	65	1.0000000
NODE_32875_length_543_cov_2.635135	253	316	6	3	63	0.0476190
NODE_32875_length_543_cov_2.635135	253	316	7	8	63	0.1269841
NODE_32875_length_543_cov_2.635135	253	316	8	7	63	0.1111111
NODE_32875_length_543_cov_2.635135	253	316	9	13	63	0.2063492
NODE_32875_length_543_cov_2.635135	253	316	10	6	63	0.0952381
NODE_32875_length_543_cov_2.635135	253	316	14	26	63	0.4126984
NODE_32875_length_543_cov_2.635135	293	373	14	26	80	0.3250000
NODE_32875_length_543_cov_2.635135	293	373	16	2	80	0.0250000
NODE_32875_length_543_cov_2.635135	293	373	18	13	80	0.1625000
NODE_32875_length_543_cov_2.635135	293	373	20	9	80	0.1125000
NODE_32875_length_543_cov_2.635135	293	373	22	25	80	0.3125000
NODE_32875_length_543_cov_2.635135	293	373	24	5	80	0.0625000
NODE_33002_length_543_cov_0.682432	98	178	6	68	80	0.8500000
NODE_33002_length_543_cov_0.682432	98	178	10	12	80	0.1500000
NODE_33012_length_542_cov_57.370203	287	367	0	80	80	1.0000000
NODE_33012_length_542_cov_57.370203	340	378	0	38	38	1.0000000
NODE_33014_length_542_cov_11.616253	277	357	0	80	80	1.0000000
NODE_33014_length_542_cov_11.616253	330	410	0	80	80	1.0000000
NODE_33015_length_542_cov_9.988713	253	333	0	4	80	0.0500000
NODE_33015_length_542_cov_9.988713	253	333	4	9	80	0.1125000
NODE_33015_length_542_cov_9.988713	253	333	6	67	80	0.8375000
NODE_33015_length_542_cov_9.988713	306	386	0	57	80	0.7125000
NODE_33015_length_542_cov_9.988713	306	386	4	9	80	0.1125000
NODE_33015_length_542_cov_9.988713	306	386	6	14	80	0.1750000
NODE_33018_length_542_cov_7.934537	215	295	2	12	80	0.1500000
NODE_33018_length_542_cov_7.934537	215	295	4	68	80	0.8500000
NODE_33018_length_542_cov_7.934537	268	348	0	25	80	0.3125000
NODE_33018_length_542_cov_7.934537	268	348	2	23	80	0.2875000
NODE_33018_length_542_cov_7.934537	268	348	4	32	80	0.4000000
NODE_33020_length_542_cov_7.266366	159	239	0	80	80	1.0000000
NODE_33021_length_542_cov_7.069977	230	304	0	74	74	1.0000000
NODE_33021_length_542_cov_7.069977	284	362	0	78	78	1.0000000
NODE_33025_length_542_cov_4.783296	237	267	9	5	30	0.1666667
NODE_33025_length_542_cov_4.783296	237	267	11	2	30	0.0666667
NODE_33025_length_542_cov_4.783296	237	267	13	20	30	0.6666667
NODE_33025_length_542_cov_4.783296	237	267	14	3	30	0.1000000
NODE_33035_length_542_cov_3.882619	275	303	4	28	28	1.0000000
NODE_33040_length_542_cov_3.600451	82	131	2	7	49	0.1428571
NODE_33040_length_542_cov_3.600451	82	131	5	1	49	0.0204082
NODE_33040_length_542_cov_3.600451	82	131	6	35	49	0.7142857
NODE_33040_length_542_cov_3.600451	82	131	10	2	49	0.0408163
NODE_33040_length_542_cov_3.600451	82	131	12	4	49	0.0816327
NODE_33188_length_541_cov_22.463801	247	327	0	80	80	1.0000000
NODE_33188_length_541_cov_22.463801	300	380	0	80	80	1.0000000
NODE_33190_length_541_cov_11.070136	60	140	0	80	80	1.0000000
NODE_33190_length_541_cov_11.070136	113	193	0	80	80	1.0000000
NODE_33204_length_541_cov_3.690045	179	250	0	7	71	0.0985916
NODE_33204_length_541_cov_3.690045	179	250	2	3	71	0.0422535
NODE_33204_length_541_cov_3.690045	179	250	3	7	71	0.0985916
NODE_33204_length_541_cov_3.690045	179	250	5	10	71	0.1408451
NODE_33204_length_541_cov_3.690045	179	250	6	44	71	0.6197183
NODE_33300_length_541_cov_1.187783	352	400	7	8	48	0.1666667
NODE_33300_length_541_cov_1.187783	352	400	8	1	48	0.0208333
NODE_33300_length_541_cov_1.187783	352	400	9	14	48	0.2916667
NODE_33300_length_541_cov_1.187783	352	400	10	25	48	0.5208333
NODE_33359_length_540_cov_78.353741	219	299	0	17	80	0.2125000
NODE_33359_length_540_cov_78.353741	219	299	4	63	80	0.7875000
NODE_33359_length_540_cov_78.353741	272	352	0	70	80	0.8750000
NODE_33359_length_540_cov_78.353741	272	352	4	10	80	0.1250000
NODE_33360_length_540_cov_33.473923	59	139	16	80	80	1.0000000
NODE_33360_length_540_cov_33.473923	112	192	0	18	80	0.2250000
NODE_33360_length_540_cov_33.473923	112	192	15	1	80	0.0125000
NODE_33360_length_540_cov_33.473923	112	192	16	61	80	0.7625000
NODE_33361_length_540_cov_20.380952	97	177	0	80	80	1.0000000
NODE_33361_length_540_cov_20.380952	150	230	0	80	80	1.0000000
NODE_33362_length_540_cov_12.657596	248	328	0	80	80	1.0000000
NODE_33362_length_540_cov_12.657596	301	381	0	80	80	1.0000000
NODE_33363_length_540_cov_11.111111	180	260	0	27	80	0.3375000
NODE_33363_length_540_cov_11.111111	180	260	2	53	80	0.6625000
NODE_33363_length_540_cov_11.111111	233	313	0	14	80	0.1750000
NODE_33363_length_540_cov_11.111111	233	313	2	66	80	0.8250000
NODE_33365_length_540_cov_6.328798	260	340	0	20	80	0.2500000
NODE_33365_length_540_cov_6.328798	260	340	2	60	80	0.7500000
NODE_33365_length_540_cov_6.328798	313	393	0	43	80	0.5375000
NODE_33365_length_540_cov_6.328798	313	393	2	37	80	0.4625000
NODE_33382_length_540_cov_3.587302	351	411	2	60	60	1.0000000
NODE_33503_length_539_cov_1023.604545	264	344	331	1	80	0.0125000
NODE_33503_length_539_cov_1023.604545	264	344	334	1	80	0.0125000
NODE_33503_length_539_cov_1023.604545	264	344	370	1	80	0.0125000
NODE_33503_length_539_cov_1023.604545	264	344	375	1	80	0.0125000
NODE_33503_length_539_cov_1023.604545	264	344	379	1	80	0.0125000
NODE_33503_length_539_cov_1023.604545	264	344	380	1	80	0.0125000
NODE_33503_length_539_cov_1023.604545	264	344	392	1	80	0.0125000
NODE_33503_length_539_cov_1023.604545	264	344	410	1	80	0.0125000
NODE_33503_length_539_cov_1023.604545	264	344	411	1	80	0.0125000
NODE_33503_length_539_cov_1023.604545	264	344	424	2	80	0.0250000
NODE_33503_length_539_cov_1023.604545	264	344	456	1	80	0.0125000
NODE_33503_length_539_cov_1023.604545	264	344	461	1	80	0.0125000
NODE_33503_length_539_cov_1023.604545	264	344	464	2	80	0.0250000
NODE_33503_length_539_cov_1023.604545	264	344	481	1	80	0.0125000
NODE_33503_length_539_cov_1023.604545	264	344	493	1	80	0.0125000
NODE_33503_length_539_cov_1023.604545	264	344	500	1	80	0.0125000
NODE_33503_length_539_cov_1023.604545	264	344	509	1	80	0.0125000
NODE_33503_length_539_cov_1023.604545	264	344	520	1	80	0.0125000
NODE_33503_length_539_cov_1023.604545	264	344	529	1	80	0.0125000
NODE_33503_length_539_cov_1023.604545	264	344	538	1	80	0.0125000
NODE_33503_length_539_cov_1023.604545	264	344	558	1	80	0.0125000
NODE_33503_length_539_cov_1023.604545	264	344	577	1	80	0.0125000
NODE_33503_length_539_cov_1023.604545	264	344	603	1	80	0.0125000
NODE_33503_length_539_cov_1023.604545	264	344	620	1	80	0.0125000
NODE_33503_length_539_cov_1023.604545	264	344	637	1	80	0.0125000
NODE_33503_length_539_cov_1023.604545	264	344	667	1	80	0.0125000
NODE_33503_length_539_cov_1023.604545	264	344	678	1	80	0.0125000
NODE_33503_length_539_cov_1023.604545	264	344	710	1	80	0.0125000
NODE_33503_length_539_cov_1023.604545	264	344	737	1	80	0.0125000
NODE_33503_length_539_cov_1023.604545	264	344	752	1	80	0.0125000
NODE_33503_length_539_cov_1023.604545	264	344	771	1	80	0.0125000
NODE_33503_length_539_cov_1023.604545	264	344	791	1	80	0.0125000
NODE_33503_length_539_cov_1023.604545	264	344	797	1	80	0.0125000
NODE_33503_length_539_cov_1023.604545	264	344	802	1	80	0.0125000
NODE_33503_length_539_cov_1023.604545	264	344	843	1	80	0.0125000
NODE_33503_length_539_cov_1023.604545	264	344	865	1	80	0.0125000
NODE_33503_length_539_cov_1023.604545	264	344	877	1	80	0.0125000
NODE_33503_length_539_cov_1023.604545	264	344	887	1	80	0.0125000
NODE_33503_length_539_cov_1023.604545	264	344	896	1	80	0.0125000
NODE_33503_length_539_cov_1023.604545	264	344	900	1	80	0.0125000
NODE_33503_length_539_cov_1023.604545	264	344	930	1	80	0.0125000
NODE_33503_length_539_cov_1023.604545	264	344	939	1	80	0.0125000
NODE_33503_length_539_cov_1023.604545	264	344	943	2	80	0.0250000
NODE_33503_length_539_cov_1023.604545	264	344	944	1	80	0.0125000
NODE_33503_length_539_cov_1023.604545	264	344	947	1	80	0.0125000
NODE_33503_length_539_cov_1023.604545	264	344	971	1	80	0.0125000
NODE_33503_length_539_cov_1023.604545	264	344	978	1	80	0.0125000
NODE_33503_length_539_cov_1023.604545	264	344	990	1	80	0.0125000
NODE_33503_length_539_cov_1023.604545	264	344	996	1	80	0.0125000
NODE_33503_length_539_cov_1023.604545	264	344	997	1	80	0.0125000
NODE_33503_length_539_cov_1023.604545	264	344	1003	1	80	0.0125000
NODE_33503_length_539_cov_1023.604545	264	344	1004	1	80	0.0125000
NODE_33503_length_539_cov_1023.604545	264	344	1012	1	80	0.0125000
NODE_33503_length_539_cov_1023.604545	264	344	1018	1	80	0.0125000
NODE_33503_length_539_cov_1023.604545	264	344	1034	1	80	0.0125000
NODE_33503_length_539_cov_1023.604545	264	344	1053	1	80	0.0125000
NODE_33503_length_539_cov_1023.604545	264	344	1055	1	80	0.0125000
NODE_33503_length_539_cov_1023.604545	264	344	1064	1	80	0.0125000
NODE_33503_length_539_cov_1023.604545	264	344	1075	1	80	0.0125000
NODE_33503_length_539_cov_1023.604545	264	344	1086	1	80	0.0125000
NODE_33503_length_539_cov_1023.604545	264	344	1121	1	80	0.0125000
NODE_33503_length_539_cov_1023.604545	264	344	1131	1	80	0.0125000
NODE_33503_length_539_cov_1023.604545	264	344	1147	1	80	0.0125000
NODE_33503_length_539_cov_1023.604545	264	344	1161	1	80	0.0125000
NODE_33503_length_539_cov_1023.604545	264	344	1187	1	80	0.0125000
NODE_33503_length_539_cov_1023.604545	264	344	1195	1	80	0.0125000
NODE_33503_length_539_cov_1023.604545	264	344	1202	1	80	0.0125000
NODE_33503_length_539_cov_1023.604545	264	344	1225	1	80	0.0125000
NODE_33503_length_539_cov_1023.604545	264	344	1235	1	80	0.0125000
NODE_33503_length_539_cov_1023.604545	264	344	1246	1	80	0.0125000
NODE_33503_length_539_cov_1023.604545	264	344	1247	1	80	0.0125000
NODE_33503_length_539_cov_1023.604545	264	344	1252	1	80	0.0125000
NODE_33503_length_539_cov_1023.604545	264	344	1256	1	80	0.0125000
NODE_33503_length_539_cov_1023.604545	264	344	1265	1	80	0.0125000
NODE_33503_length_539_cov_1023.604545	264	344	1274	1	80	0.0125000
NODE_33503_length_539_cov_1023.604545	264	344	1275	1	80	0.0125000
NODE_33503_length_539_cov_1023.604545	264	344	1280	1	80	0.0125000
NODE_33503_length_539_cov_1023.604545	317	397	1003	1	80	0.0125000
NODE_33503_length_539_cov_1023.604545	317	397	1004	1	80	0.0125000
NODE_33503_length_539_cov_1023.604545	317	397	1012	1	80	0.0125000
NODE_33503_length_539_cov_1023.604545	317	397	1018	1	80	0.0125000
NODE_33503_length_539_cov_1023.604545	317	397	1034	1	80	0.0125000
NODE_33503_length_539_cov_1023.604545	317	397	1053	1	80	0.0125000
NODE_33503_length_539_cov_1023.604545	317	397	1055	1	80	0.0125000
NODE_33503_length_539_cov_1023.604545	317	397	1064	1	80	0.0125000
NODE_33503_length_539_cov_1023.604545	317	397	1075	1	80	0.0125000
NODE_33503_length_539_cov_1023.604545	317	397	1086	1	80	0.0125000
NODE_33503_length_539_cov_1023.604545	317	397	1121	1	80	0.0125000
NODE_33503_length_539_cov_1023.604545	317	397	1131	1	80	0.0125000
NODE_33503_length_539_cov_1023.604545	317	397	1147	1	80	0.0125000
NODE_33503_length_539_cov_1023.604545	317	397	1161	1	80	0.0125000
NODE_33503_length_539_cov_1023.604545	317	397	1187	1	80	0.0125000
NODE_33503_length_539_cov_1023.604545	317	397	1195	1	80	0.0125000
NODE_33503_length_539_cov_1023.604545	317	397	1202	1	80	0.0125000
NODE_33503_length_539_cov_1023.604545	317	397	1225	1	80	0.0125000
NODE_33503_length_539_cov_1023.604545	317	397	1235	1	80	0.0125000
NODE_33503_length_539_cov_1023.604545	317	397	1237	1	80	0.0125000
NODE_33503_length_539_cov_1023.604545	317	397	1238	1	80	0.0125000
NODE_33503_length_539_cov_1023.604545	317	397	1239	2	80	0.0250000
NODE_33503_length_539_cov_1023.604545	317	397	1240	1	80	0.0125000
NODE_33503_length_539_cov_1023.604545	317	397	1242	1	80	0.0125000
NODE_33503_length_539_cov_1023.604545	317	397	1246	2	80	0.0250000
NODE_33503_length_539_cov_1023.604545	317	397	1247	2	80	0.0250000
NODE_33503_length_539_cov_1023.604545	317	397	1248	1	80	0.0125000
NODE_33503_length_539_cov_1023.604545	317	397	1250	1	80	0.0125000
NODE_33503_length_539_cov_1023.604545	317	397	1252	1	80	0.0125000
NODE_33503_length_539_cov_1023.604545	317	397	1256	1	80	0.0125000
NODE_33503_length_539_cov_1023.604545	317	397	1257	1	80	0.0125000
NODE_33503_length_539_cov_1023.604545	317	397	1258	1	80	0.0125000
NODE_33503_length_539_cov_1023.604545	317	397	1260	1	80	0.0125000
NODE_33503_length_539_cov_1023.604545	317	397	1265	1	80	0.0125000
NODE_33503_length_539_cov_1023.604545	317	397	1270	1	80	0.0125000
NODE_33503_length_539_cov_1023.604545	317	397	1273	2	80	0.0250000
NODE_33503_length_539_cov_1023.604545	317	397	1274	1	80	0.0125000
NODE_33503_length_539_cov_1023.604545	317	397	1275	1	80	0.0125000
NODE_33503_length_539_cov_1023.604545	317	397	1276	1	80	0.0125000
NODE_33503_length_539_cov_1023.604545	317	397	1277	1	80	0.0125000
NODE_33503_length_539_cov_1023.604545	317	397	1278	1	80	0.0125000
NODE_33503_length_539_cov_1023.604545	317	397	1280	1	80	0.0125000
NODE_33503_length_539_cov_1023.604545	317	397	1282	2	80	0.0250000
NODE_33503_length_539_cov_1023.604545	317	397	1283	1	80	0.0125000
NODE_33503_length_539_cov_1023.604545	317	397	1285	1	80	0.0125000
NODE_33503_length_539_cov_1023.604545	317	397	1286	1	80	0.0125000
NODE_33503_length_539_cov_1023.604545	317	397	1288	1	80	0.0125000
NODE_33503_length_539_cov_1023.604545	317	397	1290	1	80	0.0125000
NODE_33503_length_539_cov_1023.604545	317	397	1291	1	80	0.0125000
NODE_33503_length_539_cov_1023.604545	317	397	1293	1	80	0.0125000
NODE_33503_length_539_cov_1023.604545	317	397	1295	1	80	0.0125000
NODE_33503_length_539_cov_1023.604545	317	397	1296	1	80	0.0125000
NODE_33503_length_539_cov_1023.604545	317	397	1297	1	80	0.0125000
NODE_33503_length_539_cov_1023.604545	317	397	1298	1	80	0.0125000
NODE_33503_length_539_cov_1023.604545	317	397	1299	1	80	0.0125000
NODE_33503_length_539_cov_1023.604545	317	397	1301	1	80	0.0125000
NODE_33503_length_539_cov_1023.604545	317	397	1310	2	80	0.0250000
NODE_33503_length_539_cov_1023.604545	317	397	1313	1	80	0.0125000
NODE_33503_length_539_cov_1023.604545	317	397	1316	1	80	0.0125000
NODE_33503_length_539_cov_1023.604545	317	397	1320	1	80	0.0125000
NODE_33503_length_539_cov_1023.604545	317	397	1324	1	80	0.0125000
NODE_33503_length_539_cov_1023.604545	317	397	1326	1	80	0.0125000
NODE_33503_length_539_cov_1023.604545	317	397	1328	1	80	0.0125000
NODE_33503_length_539_cov_1023.604545	317	397	1329	1	80	0.0125000
NODE_33503_length_539_cov_1023.604545	317	397	1330	1	80	0.0125000
NODE_33503_length_539_cov_1023.604545	317	397	1331	2	80	0.0250000
NODE_33503_length_539_cov_1023.604545	317	397	1332	1	80	0.0125000
NODE_33503_length_539_cov_1023.604545	317	397	1337	1	80	0.0125000
NODE_33503_length_539_cov_1023.604545	317	397	1341	1	80	0.0125000
NODE_33503_length_539_cov_1023.604545	317	397	1342	1	80	0.0125000
NODE_33503_length_539_cov_1023.604545	317	397	1344	1	80	0.0125000
NODE_33503_length_539_cov_1023.604545	317	397	1345	1	80	0.0125000
NODE_33503_length_539_cov_1023.604545	317	397	1347	1	80	0.0125000
NODE_33504_length_539_cov_99.579545	478	539	0	61	61	1.0000000
NODE_33505_length_539_cov_15.247727	217	297	2	22	80	0.2750000
NODE_33505_length_539_cov_15.247727	217	297	4	10	80	0.1250000
NODE_33505_length_539_cov_15.247727	217	297	6	48	80	0.6000000
NODE_33505_length_539_cov_15.247727	270	350	0	22	80	0.2750000
NODE_33505_length_539_cov_15.247727	270	350	2	53	80	0.6625000
NODE_33505_length_539_cov_15.247727	270	350	4	5	80	0.0625000
NODE_33506_length_539_cov_14.172727	278	350	2	5	72	0.0694444
NODE_33506_length_539_cov_14.172727	278	350	4	67	72	0.9305556
NODE_33507_length_539_cov_13.154545	118	198	0	65	80	0.8125000
NODE_33507_length_539_cov_13.154545	118	198	2	15	80	0.1875000
NODE_33507_length_539_cov_13.154545	171	251	0	80	80	1.0000000
NODE_33508_length_539_cov_10.811364	48	128	0	80	80	1.0000000
NODE_33508_length_539_cov_10.811364	101	181	0	33	80	0.4125000
NODE_33508_length_539_cov_10.811364	101	181	2	47	80	0.5875000
NODE_33509_length_539_cov_9.563636	201	277	2	32	76	0.4210526
NODE_33509_length_539_cov_9.563636	201	277	4	14	76	0.1842105
NODE_33509_length_539_cov_9.563636	201	277	6	19	76	0.2500000
NODE_33509_length_539_cov_9.563636	201	277	10	11	76	0.1447368
NODE_33510_length_539_cov_7.934091	311	369	0	29	58	0.5000000
NODE_33510_length_539_cov_7.934091	311	369	2	29	58	0.5000000
NODE_33510_length_539_cov_7.934091	342	422	2	80	80	1.0000000
NODE_33517_length_539_cov_5.740909	251	319	6	45	68	0.6617647
NODE_33517_length_539_cov_5.740909	251	319	12	23	68	0.3382353
NODE_33517_length_539_cov_5.740909	301	372	6	8	71	0.1126761
NODE_33517_length_539_cov_5.740909	301	372	12	63	71	0.8873239
NODE_33533_length_539_cov_3.627273	80	157	0	77	77	1.0000000
NODE_33533_length_539_cov_3.627273	130	175	0	45	45	1.0000000
NODE_33569_length_539_cov_2.143182	325	371	0	26	46	0.5652174
NODE_33569_length_539_cov_2.143182	325	371	2	20	46	0.4347826
NODE_33595_length_539_cov_1.618182	408	456	2	34	48	0.7083333
NODE_33595_length_539_cov_1.618182	408	456	4	14	48	0.2916667
NODE_33623_length_539_cov_1.129545	97	134	0	37	37	1.0000000
NODE_33669_length_538_cov_23.193622	171	256	0	18	85	0.2117647
NODE_33669_length_538_cov_23.193622	171	256	2	10	85	0.1176471
NODE_33669_length_538_cov_23.193622	171	256	4	57	85	0.6705883
NODE_33669_length_538_cov_23.193622	225	305	0	67	80	0.8375000
NODE_33669_length_538_cov_23.193622	225	305	2	10	80	0.1250000
NODE_33669_length_538_cov_23.193622	225	305	4	3	80	0.0375000
NODE_33672_length_538_cov_7.378132	145	225	6	30	80	0.3750000
NODE_33672_length_538_cov_7.378132	145	225	8	50	80	0.6250000
NODE_33672_length_538_cov_7.378132	198	278	2	20	80	0.2500000
NODE_33672_length_538_cov_7.378132	198	278	4	4	80	0.0500000
NODE_33672_length_538_cov_7.378132	198	278	6	55	80	0.6875000
NODE_33672_length_538_cov_7.378132	198	278	8	1	80	0.0125000
NODE_33683_length_538_cov_4.496583	277	357	0	80	80	1.0000000
NODE_33683_length_538_cov_4.496583	330	410	0	80	80	1.0000000
NODE_33687_length_538_cov_3.753986	251	309	0	12	58	0.2068966
NODE_33687_length_538_cov_3.753986	251	309	2	46	58	0.7931035
NODE_33713_length_538_cov_2.239180	256	338	2	26	82	0.3170732
NODE_33713_length_538_cov_2.239180	256	338	4	13	82	0.1585366
NODE_33713_length_538_cov_2.239180	256	338	6	15	82	0.1829268
NODE_33713_length_538_cov_2.239180	256	338	8	1	82	0.0121951
NODE_33713_length_538_cov_2.239180	256	338	13	9	82	0.1097561
NODE_33713_length_538_cov_2.239180	256	338	15	1	82	0.0121951
NODE_33713_length_538_cov_2.239180	256	338	17	14	82	0.1707317
NODE_33713_length_538_cov_2.239180	256	338	19	3	82	0.0365854
NODE_33814_length_538_cov_0.822323	397	477	4	14	80	0.1750000
NODE_33814_length_538_cov_0.822323	397	477	6	14	80	0.1750000
NODE_33814_length_538_cov_0.822323	397	477	8	52	80	0.6500000
NODE_33852_length_537_cov_13.031963	258	309	0	51	51	1.0000000
NODE_33854_length_537_cov_9.552511	198	278	4	80	80	1.0000000
NODE_33854_length_537_cov_9.552511	251	332	0	16	81	0.1975309
NODE_33854_length_537_cov_9.552511	251	332	2	23	81	0.2839506
NODE_33854_length_537_cov_9.552511	251	332	4	42	81	0.5185185
NODE_33960_length_537_cov_1.244292	107	187	10	4	80	0.0500000
NODE_33960_length_537_cov_1.244292	107	187	12	1	80	0.0125000
NODE_33960_length_537_cov_1.244292	107	187	14	2	80	0.0250000
NODE_33960_length_537_cov_1.244292	107	187	16	5	80	0.0625000
NODE_33960_length_537_cov_1.244292	107	187	18	3	80	0.0375000
NODE_33960_length_537_cov_1.244292	107	187	22	2	80	0.0250000
NODE_33960_length_537_cov_1.244292	107	187	24	2	80	0.0250000
NODE_33960_length_537_cov_1.244292	107	187	26	2	80	0.0250000
NODE_33960_length_537_cov_1.244292	107	187	31	1	80	0.0125000
NODE_33960_length_537_cov_1.244292	107	187	35	1	80	0.0125000
NODE_33960_length_537_cov_1.244292	107	187	39	2	80	0.0250000
NODE_33960_length_537_cov_1.244292	107	187	41	1	80	0.0125000
NODE_33960_length_537_cov_1.244292	107	187	42	2	80	0.0250000
NODE_33960_length_537_cov_1.244292	107	187	46	1	80	0.0125000
NODE_33960_length_537_cov_1.244292	107	187	49	1	80	0.0125000
NODE_33960_length_537_cov_1.244292	107	187	51	1	80	0.0125000
NODE_33960_length_537_cov_1.244292	107	187	53	1	80	0.0125000
NODE_33960_length_537_cov_1.244292	107	187	54	1	80	0.0125000
NODE_33960_length_537_cov_1.244292	107	187	57	1	80	0.0125000
NODE_33960_length_537_cov_1.244292	107	187	59	2	80	0.0250000
NODE_33960_length_537_cov_1.244292	107	187	61	1	80	0.0125000
NODE_33960_length_537_cov_1.244292	107	187	65	5	80	0.0625000
NODE_33960_length_537_cov_1.244292	107	187	67	1	80	0.0125000
NODE_33960_length_537_cov_1.244292	107	187	70	2	80	0.0250000
NODE_33960_length_537_cov_1.244292	107	187	76	1	80	0.0125000
NODE_33960_length_537_cov_1.244292	107	187	77	6	80	0.0750000
NODE_33960_length_537_cov_1.244292	107	187	79	5	80	0.0625000
NODE_33960_length_537_cov_1.244292	107	187	83	5	80	0.0625000
NODE_33960_length_537_cov_1.244292	107	187	85	7	80	0.0875000
NODE_33960_length_537_cov_1.244292	107	187	89	11	80	0.1375000
NODE_34029_length_536_cov_87.622426	430	462	133	1	32	0.0312500
NODE_34029_length_536_cov_87.622426	430	462	139	2	32	0.0625000
NODE_34029_length_536_cov_87.622426	430	462	141	1	32	0.0312500
NODE_34029_length_536_cov_87.622426	430	462	143	3	32	0.0937500
NODE_34029_length_536_cov_87.622426	430	462	147	13	32	0.4062500
NODE_34029_length_536_cov_87.622426	430	462	148	1	32	0.0312500
NODE_34029_length_536_cov_87.622426	430	462	150	7	32	0.2187500
NODE_34029_length_536_cov_87.622426	430	462	154	4	32	0.1250000
NODE_34030_length_536_cov_11.629291	119	199	0	80	80	1.0000000
NODE_34030_length_536_cov_11.629291	172	252	0	80	80	1.0000000
NODE_34032_length_536_cov_6.613272	286	372	0	72	86	0.8372093
NODE_34032_length_536_cov_6.613272	286	372	2	8	86	0.0930233
NODE_34032_length_536_cov_6.613272	286	372	3	6	86	0.0697674
NODE_34035_length_536_cov_5.810069	191	271	0	58	80	0.7250000
NODE_34035_length_536_cov_5.810069	191	271	2	22	80	0.2750000
NODE_34035_length_536_cov_5.810069	244	324	0	5	80	0.0625000
NODE_34035_length_536_cov_5.810069	244	324	2	26	80	0.3250000
NODE_34035_length_536_cov_5.810069	244	324	4	49	80	0.6125000
NODE_34035_length_536_cov_5.810069	374	404	0	30	30	1.0000000
NODE_34039_length_536_cov_4.729977	202	245	0	43	43	1.0000000
NODE_34057_length_536_cov_3.297483	86	126	0	40	40	1.0000000
NODE_34068_length_536_cov_2.796339	223	280	2	57	57	1.0000000
NODE_34094_length_536_cov_1.956522	181	230	17	3	49	0.0612245
NODE_34094_length_536_cov_1.956522	181	230	19	1	49	0.0204082
NODE_34094_length_536_cov_1.956522	181	230	20	13	49	0.2653061
NODE_34094_length_536_cov_1.956522	181	230	21	1	49	0.0204082
NODE_34094_length_536_cov_1.956522	181	230	22	11	49	0.2244898
NODE_34094_length_536_cov_1.956522	181	230	24	15	49	0.3061225
NODE_34094_length_536_cov_1.956522	181	230	26	5	49	0.1020408
NODE_34095_length_536_cov_1.951945	203	284	2	4	81	0.0493827
NODE_34095_length_536_cov_1.951945	203	284	4	1	81	0.0123457
NODE_34095_length_536_cov_1.951945	203	284	6	3	81	0.0370370
NODE_34095_length_536_cov_1.951945	203	284	10	1	81	0.0123457
NODE_34095_length_536_cov_1.951945	203	284	12	1	81	0.0123457
NODE_34095_length_536_cov_1.951945	203	284	16	2	81	0.0246914
NODE_34095_length_536_cov_1.951945	203	284	18	7	81	0.0864198
NODE_34095_length_536_cov_1.951945	203	284	19	2	81	0.0246914
NODE_34095_length_536_cov_1.951945	203	284	20	1	81	0.0123457
NODE_34095_length_536_cov_1.951945	203	284	22	59	81	0.7283950
NODE_34095_length_536_cov_1.951945	306	368	0	14	62	0.2258064
NODE_34095_length_536_cov_1.951945	306	368	2	1	62	0.0161290
NODE_34095_length_536_cov_1.951945	306	368	4	47	62	0.7580645
NODE_34209_length_535_cov_32.277523	158	238	0	80	80	1.0000000
NODE_34209_length_535_cov_32.277523	211	291	0	80	80	1.0000000
NODE_34215_length_535_cov_5.910550	110	162	0	52	52	1.0000000
NODE_34229_length_535_cov_3.795872	217	297	14	11	80	0.1375000
NODE_34229_length_535_cov_3.795872	217	297	24	6	80	0.0750000
NODE_34229_length_535_cov_3.795872	217	297	26	10	80	0.1250000
NODE_34229_length_535_cov_3.795872	217	297	27	2	80	0.0250000
NODE_34229_length_535_cov_3.795872	217	297	28	6	80	0.0750000
NODE_34229_length_535_cov_3.795872	217	297	29	26	80	0.3250000
NODE_34229_length_535_cov_3.795872	217	297	30	19	80	0.2375000
NODE_34375_length_534_cov_54.331034	435	498	0	54	63	0.8571429
NODE_34375_length_534_cov_54.331034	435	498	2	3	63	0.0476190
NODE_34375_length_534_cov_54.331034	435	498	10	1	63	0.0158730
NODE_34375_length_534_cov_54.331034	435	498	18	1	63	0.0158730
NODE_34375_length_534_cov_54.331034	435	498	58	2	63	0.0317460
NODE_34375_length_534_cov_54.331034	435	498	63	2	63	0.0317460
NODE_34375_length_534_cov_54.331034	471	534	0	63	63	1.0000000
NODE_34377_length_534_cov_15.462069	460	534	6	40	74	0.5405405
NODE_34377_length_534_cov_15.462069	460	534	8	34	74	0.4594595
NODE_34377_length_534_cov_15.462069	512	534	6	22	22	1.0000000
NODE_34378_length_534_cov_10.308046	268	348	0	80	80	1.0000000
NODE_34378_length_534_cov_10.308046	321	401	0	80	80	1.0000000
NODE_34380_length_534_cov_9.041379	204	284	6	69	80	0.8625000
NODE_34380_length_534_cov_9.041379	204	284	10	11	80	0.1375000
NODE_34380_length_534_cov_9.041379	257	332	6	29	75	0.3866667
NODE_34380_length_534_cov_9.041379	257	332	10	46	75	0.6133333
NODE_34383_length_534_cov_6.958621	273	303	0	30	30	1.0000000
NODE_34392_length_534_cov_5.022989	291	371	4	7	80	0.0875000
NODE_34392_length_534_cov_5.022989	291	371	6	6	80	0.0750000
NODE_34392_length_534_cov_5.022989	291	371	10	38	80	0.4750000
NODE_34392_length_534_cov_5.022989	291	371	12	8	80	0.1000000
NODE_34392_length_534_cov_5.022989	291	371	16	9	80	0.1125000
NODE_34392_length_534_cov_5.022989	291	371	18	11	80	0.1375000
NODE_34392_length_534_cov_5.022989	291	371	20	1	80	0.0125000
NODE_34402_length_534_cov_3.873563	110	190	2	23	80	0.2875000
NODE_34402_length_534_cov_3.873563	110	190	4	4	80	0.0500000
NODE_34402_length_534_cov_3.873563	110	190	10	9	80	0.1125000
NODE_34402_length_534_cov_3.873563	110	190	12	44	80	0.5500000
NODE_34409_length_534_cov_3.202299	221	301	0	80	80	1.0000000
NODE_34411_length_534_cov_3.158621	171	200	8	29	29	1.0000000
NODE_34418_length_534_cov_3.002299	175	219	0	29	44	0.6590909
NODE_34418_length_534_cov_3.002299	175	219	2	15	44	0.3409091
NODE_34489_length_534_cov_1.344828	475	518	0	43	43	1.0000000
NODE_34494_length_534_cov_1.291954	273	336	11	1	63	0.0158730
NODE_34494_length_534_cov_1.291954	273	336	13	22	63	0.3492064
NODE_34494_length_534_cov_1.291954	273	336	15	40	63	0.6349207
NODE_34511_length_534_cov_1.160920	227	264	4	6	37	0.1621622
NODE_34511_length_534_cov_1.160920	227	264	6	31	37	0.8378378
NODE_34570_length_533_cov_13.956221	216	296	0	80	80	1.0000000
NODE_34570_length_533_cov_13.956221	269	349	0	80	80	1.0000000
NODE_34575_length_533_cov_8.207373	244	322	0	78	78	1.0000000
NODE_34576_length_533_cov_8.023041	230	310	2	8	80	0.1000000
NODE_34576_length_533_cov_8.023041	230	310	4	61	80	0.7625000
NODE_34576_length_533_cov_8.023041	230	310	6	11	80	0.1375000
NODE_34576_length_533_cov_8.023041	283	364	0	12	81	0.1481481
NODE_34576_length_533_cov_8.023041	283	364	2	50	81	0.6172839
NODE_34576_length_533_cov_8.023041	283	364	4	12	81	0.1481481
NODE_34576_length_533_cov_8.023041	283	364	6	7	81	0.0864198
NODE_34585_length_533_cov_5.170507	308	369	0	61	61	1.0000000
NODE_34588_length_533_cov_4.988479	229	309	0	45	80	0.5625000
NODE_34588_length_533_cov_4.988479	229	309	2	2	80	0.0250000
NODE_34588_length_533_cov_4.988479	229	309	4	33	80	0.4125000
NODE_34588_length_533_cov_4.988479	282	362	0	80	80	1.0000000
NODE_34600_length_533_cov_3.638249	201	265	0	5	64	0.0781250
NODE_34600_length_533_cov_3.638249	201	265	2	59	64	0.9218750
NODE_34603_length_533_cov_3.511521	138	218	0	5	80	0.0625000
NODE_34603_length_533_cov_3.511521	138	218	2	75	80	0.9375000
NODE_34615_length_533_cov_3.073733	294	340	0	46	46	1.0000000
NODE_34617_length_533_cov_3.052995	256	304	6	19	48	0.3958333
NODE_34617_length_533_cov_3.052995	256	304	8	29	48	0.6041667
NODE_34631_length_533_cov_2.366359	229	311	0	16	82	0.1951219
NODE_34631_length_533_cov_2.366359	229	311	2	47	82	0.5731707
NODE_34631_length_533_cov_2.366359	229	311	4	19	82	0.2317073
NODE_34635_length_533_cov_2.288018	468	490	0	22	22	1.0000000
NODE_34767_length_532_cov_73.279446	0	64	2	3	64	0.0468750
NODE_34767_length_532_cov_73.279446	0	64	6	2	64	0.0312500
NODE_34767_length_532_cov_73.279446	0	64	8	6	64	0.0937500
NODE_34767_length_532_cov_73.279446	0	64	10	17	64	0.2656250
NODE_34767_length_532_cov_73.279446	0	64	12	34	64	0.5312500
NODE_34767_length_532_cov_73.279446	0	64	14	2	64	0.0312500
NODE_34768_length_532_cov_23.055427	168	248	0	48	80	0.6000000
NODE_34768_length_532_cov_23.055427	168	248	2	32	80	0.4000000
NODE_34768_length_532_cov_23.055427	221	301	2	78	80	0.9750000
NODE_34768_length_532_cov_23.055427	221	301	4	2	80	0.0250000
NODE_34769_length_532_cov_22.778291	256	336	14	8	80	0.1000000
NODE_34769_length_532_cov_22.778291	256	336	16	19	80	0.2375000
NODE_34769_length_532_cov_22.778291	256	336	17	2	80	0.0250000
NODE_34769_length_532_cov_22.778291	256	336	18	31	80	0.3875000
NODE_34769_length_532_cov_22.778291	256	336	20	20	80	0.2500000
NODE_34769_length_532_cov_22.778291	309	389	14	29	80	0.3625000
NODE_34769_length_532_cov_22.778291	309	389	16	26	80	0.3250000
NODE_34769_length_532_cov_22.778291	309	389	18	11	80	0.1375000
NODE_34769_length_532_cov_22.778291	309	389	20	14	80	0.1750000
NODE_34770_length_532_cov_13.279446	85	165	0	41	80	0.5125000
NODE_34770_length_532_cov_13.279446	85	165	2	39	80	0.4875000
NODE_34770_length_532_cov_13.279446	138	218	0	17	80	0.2125000
NODE_34770_length_532_cov_13.279446	138	218	2	63	80	0.7875000
NODE_34774_length_532_cov_7.591224	171	235	0	64	64	1.0000000
NODE_34774_length_532_cov_7.591224	172	235	0	63	63	1.0000000
NODE_34774_length_532_cov_7.591224	173	226	0	53	53	1.0000000
NODE_34774_length_532_cov_7.591224	173	228	0	55	55	1.0000000
NODE_34774_length_532_cov_7.591224	208	282	0	42	74	0.5675676
NODE_34774_length_532_cov_7.591224	208	282	2	32	74	0.4324324
NODE_34774_length_532_cov_7.591224	208	282	0	42	74	0.5675676
NODE_34774_length_532_cov_7.591224	208	282	2	32	74	0.4324324
NODE_34774_length_532_cov_7.591224	208	282	0	42	74	0.5675676
NODE_34774_length_532_cov_7.591224	208	282	2	32	74	0.4324324
NODE_34774_length_532_cov_7.591224	208	282	0	42	74	0.5675676
NODE_34774_length_532_cov_7.591224	208	282	2	32	74	0.4324324
NODE_34788_length_532_cov_4.524249	84	151	0	67	67	1.0000000
NODE_34788_length_532_cov_4.524249	137	218	0	81	81	1.0000000
NODE_34838_length_532_cov_1.866051	263	309	0	46	46	1.0000000
NODE_34845_length_532_cov_1.757506	126	146	0	20	20	1.0000000
NODE_34948_length_531_cov_35.539352	7	45	0	38	38	1.0000000
NODE_34948_length_531_cov_35.539352	18	98	0	80	80	1.0000000
NODE_34949_length_531_cov_13.162037	129	209	0	80	80	1.0000000
NODE_34949_length_531_cov_13.162037	182	251	0	69	69	1.0000000
NODE_34953_length_531_cov_6.821759	242	322	0	80	80	1.0000000
NODE_34953_length_531_cov_6.821759	295	375	0	80	80	1.0000000
NODE_34958_length_531_cov_5.261574	261	336	10	19	75	0.2533333
NODE_34958_length_531_cov_5.261574	261	336	16	11	75	0.1466667
NODE_34958_length_531_cov_5.261574	261	336	18	45	75	0.6000000
NODE_34958_length_531_cov_5.261574	309	362	2	3	53	0.0566038
NODE_34958_length_531_cov_5.261574	309	362	8	5	53	0.0943396
NODE_34958_length_531_cov_5.261574	309	362	10	7	53	0.1320755
NODE_34958_length_531_cov_5.261574	309	362	12	2	53	0.0377358
NODE_34958_length_531_cov_5.261574	309	362	14	8	53	0.1509434
NODE_34958_length_531_cov_5.261574	309	362	16	6	53	0.1132075
NODE_34958_length_531_cov_5.261574	309	362	18	22	53	0.4150943
NODE_34963_length_531_cov_4.527778	177	255	0	66	78	0.8461539
NODE_34963_length_531_cov_4.527778	177	255	2	12	78	0.1538462
NODE_34965_length_531_cov_4.319444	283	363	0	80	80	1.0000000
NODE_34965_length_531_cov_4.319444	336	416	0	80	80	1.0000000
NODE_34979_length_531_cov_3.488426	238	318	0	42	80	0.5250000
NODE_34979_length_531_cov_3.488426	238	318	2	32	80	0.4000000
NODE_34979_length_531_cov_3.488426	238	318	4	6	80	0.0750000
NODE_34979_length_531_cov_3.488426	291	371	2	21	80	0.2625000
NODE_34979_length_531_cov_3.488426	291	371	4	59	80	0.7375000
NODE_34980_length_531_cov_3.375000	153	207	0	17	54	0.3148148
NODE_34980_length_531_cov_3.375000	153	207	2	2	54	0.0370370
NODE_34980_length_531_cov_3.375000	153	207	4	5	54	0.0925926
NODE_34980_length_531_cov_3.375000	153	207	8	4	54	0.0740741
NODE_34980_length_531_cov_3.375000	153	207	10	5	54	0.0925926
NODE_34980_length_531_cov_3.375000	153	207	12	11	54	0.2037037
NODE_34980_length_531_cov_3.375000	153	207	14	1	54	0.0185185
NODE_34980_length_531_cov_3.375000	153	207	16	9	54	0.1666667
NODE_34980_length_531_cov_3.375000	180	260	8	1	80	0.0125000
NODE_34980_length_531_cov_3.375000	180	260	10	5	80	0.0625000
NODE_34980_length_531_cov_3.375000	180	260	12	15	80	0.1875000
NODE_34980_length_531_cov_3.375000	180	260	14	3	80	0.0375000
NODE_34980_length_531_cov_3.375000	180	260	16	23	80	0.2875000
NODE_34980_length_531_cov_3.375000	180	260	18	12	80	0.1500000
NODE_34980_length_531_cov_3.375000	180	260	20	21	80	0.2625000
NODE_34986_length_531_cov_3.111111	243	323	0	29	80	0.3625000
NODE_34986_length_531_cov_3.111111	243	323	2	51	80	0.6375000
NODE_34986_length_531_cov_3.111111	296	376	0	80	80	1.0000000
NODE_35008_length_531_cov_2.201389	302	373	2	71	71	1.0000000
NODE_35008_length_531_cov_2.201389	350	426	0	49	76	0.6447368
NODE_35008_length_531_cov_2.201389	350	426	2	27	76	0.3552631
NODE_35141_length_530_cov_30.605568	250	330	0	19	80	0.2375000
NODE_35141_length_530_cov_30.605568	250	330	4	21	80	0.2625000
NODE_35141_length_530_cov_30.605568	250	330	6	29	80	0.3625000
NODE_35141_length_530_cov_30.605568	250	330	8	11	80	0.1375000
NODE_35141_length_530_cov_30.605568	303	383	6	16	80	0.2000000
NODE_35141_length_530_cov_30.605568	303	383	8	64	80	0.8000000
NODE_35142_length_530_cov_16.937355	404	484	1	2	80	0.0250000
NODE_35142_length_530_cov_16.937355	404	484	2	3	80	0.0375000
NODE_35142_length_530_cov_16.937355	404	484	10	1	80	0.0125000
NODE_35142_length_530_cov_16.937355	404	484	18	1	80	0.0125000
NODE_35142_length_530_cov_16.937355	404	484	31	5	80	0.0625000
NODE_35142_length_530_cov_16.937355	404	484	33	1	80	0.0125000
NODE_35142_length_530_cov_16.937355	404	484	34	67	80	0.8375000
NODE_35142_length_530_cov_16.937355	457	530	4	3	73	0.0410959
NODE_35142_length_530_cov_16.937355	457	530	6	8	73	0.1095890
NODE_35142_length_530_cov_16.937355	457	530	10	6	73	0.0821918
NODE_35142_length_530_cov_16.937355	457	530	15	1	73	0.0136986
NODE_35142_length_530_cov_16.937355	457	530	20	2	73	0.0273973
NODE_35142_length_530_cov_16.937355	457	530	22	1	73	0.0136986
NODE_35142_length_530_cov_16.937355	457	530	24	1	73	0.0136986
NODE_35142_length_530_cov_16.937355	457	530	26	1	73	0.0136986
NODE_35142_length_530_cov_16.937355	457	530	32	1	73	0.0136986
NODE_35142_length_530_cov_16.937355	457	530	34	49	73	0.6712329
NODE_35143_length_530_cov_9.902552	273	353	0	80	80	1.0000000
NODE_35143_length_530_cov_9.902552	326	406	0	80	80	1.0000000
NODE_35144_length_530_cov_7.928074	46	126	0	80	80	1.0000000
NODE_35144_length_530_cov_7.928074	99	179	0	80	80	1.0000000
NODE_35150_length_530_cov_4.647332	188	268	0	80	80	1.0000000
NODE_35150_length_530_cov_4.647332	241	321	0	80	80	1.0000000
NODE_35154_length_530_cov_4.389791	162	242	26	2	80	0.0250000
NODE_35154_length_530_cov_4.389791	162	242	28	3	80	0.0375000
NODE_35154_length_530_cov_4.389791	162	242	34	5	80	0.0625000
NODE_35154_length_530_cov_4.389791	162	242	40	2	80	0.0250000
NODE_35154_length_530_cov_4.389791	162	242	44	5	80	0.0625000
NODE_35154_length_530_cov_4.389791	162	242	46	1	80	0.0125000
NODE_35154_length_530_cov_4.389791	162	242	48	6	80	0.0750000
NODE_35154_length_530_cov_4.389791	162	242	50	4	80	0.0500000
NODE_35154_length_530_cov_4.389791	162	242	51	1	80	0.0125000
NODE_35154_length_530_cov_4.389791	162	242	52	1	80	0.0125000
NODE_35154_length_530_cov_4.389791	162	242	54	2	80	0.0250000
NODE_35154_length_530_cov_4.389791	162	242	57	5	80	0.0625000
NODE_35154_length_530_cov_4.389791	162	242	59	3	80	0.0375000
NODE_35154_length_530_cov_4.389791	162	242	61	5	80	0.0625000
NODE_35154_length_530_cov_4.389791	162	242	62	2	80	0.0250000
NODE_35154_length_530_cov_4.389791	162	242	63	2	80	0.0250000
NODE_35154_length_530_cov_4.389791	162	242	65	1	80	0.0125000
NODE_35154_length_530_cov_4.389791	162	242	69	1	80	0.0125000
NODE_35154_length_530_cov_4.389791	162	242	71	13	80	0.1625000
NODE_35154_length_530_cov_4.389791	162	242	73	2	80	0.0250000
NODE_35154_length_530_cov_4.389791	162	242	75	2	80	0.0250000
NODE_35154_length_530_cov_4.389791	162	242	76	1	80	0.0125000
NODE_35154_length_530_cov_4.389791	162	242	77	3	80	0.0375000
NODE_35154_length_530_cov_4.389791	162	242	79	3	80	0.0375000
NODE_35154_length_530_cov_4.389791	162	242	81	5	80	0.0625000
NODE_35159_length_530_cov_4.046404	76	111	0	35	35	1.0000000
NODE_35319_length_529_cov_38.983721	140	220	6	4	80	0.0500000
NODE_35319_length_529_cov_38.983721	140	220	8	1	80	0.0125000
NODE_35319_length_529_cov_38.983721	140	220	10	27	80	0.3375000
NODE_35319_length_529_cov_38.983721	140	220	14	48	80	0.6000000
NODE_35320_length_529_cov_18.223256	189	269	0	80	80	1.0000000
NODE_35320_length_529_cov_18.223256	242	322	0	80	80	1.0000000
NODE_35321_length_529_cov_17.009302	358	438	3	1	80	0.0125000
NODE_35321_length_529_cov_17.009302	358	438	4	29	80	0.3625000
NODE_35321_length_529_cov_17.009302	358	438	16	12	80	0.1500000
NODE_35321_length_529_cov_17.009302	358	438	18	12	80	0.1500000
NODE_35321_length_529_cov_17.009302	358	438	19	21	80	0.2625000
NODE_35321_length_529_cov_17.009302	358	438	20	5	80	0.0625000
NODE_35321_length_529_cov_17.009302	411	491	16	65	80	0.8125000
NODE_35321_length_529_cov_17.009302	411	491	19	10	80	0.1250000
NODE_35321_length_529_cov_17.009302	411	491	20	5	80	0.0625000
NODE_35331_length_529_cov_6.195349	211	291	0	21	80	0.2625000
NODE_35331_length_529_cov_6.195349	211	291	1	3	80	0.0375000
NODE_35331_length_529_cov_6.195349	211	291	2	56	80	0.7000000
NODE_35331_length_529_cov_6.195349	264	322	0	52	58	0.8965517
NODE_35331_length_529_cov_6.195349	264	322	1	3	58	0.0517241
NODE_35331_length_529_cov_6.195349	264	322	2	3	58	0.0517241
NODE_35336_length_529_cov_5.176744	139	207	0	47	68	0.6911765
NODE_35336_length_529_cov_5.176744	139	207	6	21	68	0.3088235
NODE_35336_length_529_cov_5.176744	185	260	0	1	75	0.0133333
NODE_35336_length_529_cov_5.176744	185	260	4	2	75	0.0266667
NODE_35336_length_529_cov_5.176744	185	260	6	72	75	0.9600000
NODE_35364_length_529_cov_2.883721	223	281	0	38	58	0.6551724
NODE_35364_length_529_cov_2.883721	223	281	5	20	58	0.3448276
NODE_35374_length_529_cov_2.660465	89	168	0	40	79	0.5063291
NODE_35374_length_529_cov_2.660465	89	168	2	39	79	0.4936709
NODE_35375_length_529_cov_2.595349	278	321	0	3	43	0.0697674
NODE_35375_length_529_cov_2.595349	278	321	1	40	43	0.9302326
NODE_35384_length_529_cov_2.272093	247	313	0	66	66	1.0000000
NODE_35427_length_529_cov_1.597674	289	332	0	43	43	1.0000000
NODE_35521_length_528_cov_25.808858	233	313	0	40	80	0.5000000
NODE_35521_length_528_cov_25.808858	233	313	2	40	80	0.5000000
NODE_35521_length_528_cov_25.808858	286	366	0	80	80	1.0000000
NODE_35522_length_528_cov_17.331002	219	299	0	80	80	1.0000000
NODE_35522_length_528_cov_17.331002	272	352	0	80	80	1.0000000
NODE_35523_length_528_cov_16.165501	262	342	0	12	80	0.1500000
NODE_35523_length_528_cov_16.165501	262	342	4	68	80	0.8500000
NODE_35523_length_528_cov_16.165501	315	395	0	65	80	0.8125000
NODE_35523_length_528_cov_16.165501	315	395	4	15	80	0.1875000
NODE_35529_length_528_cov_5.776224	204	284	0	24	80	0.3000000
NODE_35529_length_528_cov_5.776224	204	284	2	56	80	0.7000000
NODE_35529_length_528_cov_5.776224	257	337	0	2	80	0.0250000
NODE_35529_length_528_cov_5.776224	257	337	2	78	80	0.9750000
NODE_35542_length_528_cov_4.016317	235	315	0	80	80	1.0000000
NODE_35542_length_528_cov_4.016317	288	368	0	80	80	1.0000000
NODE_35545_length_528_cov_3.799534	144	192	0	48	48	1.0000000
NODE_35561_length_528_cov_2.902098	252	305	0	20	53	0.3773585
NODE_35561_length_528_cov_2.902098	252	305	2	29	53	0.5471698
NODE_35561_length_528_cov_2.902098	252	305	4	4	53	0.0754717
NODE_35575_length_528_cov_2.324009	137	188	12	11	51	0.2156863
NODE_35575_length_528_cov_2.324009	137	188	14	35	51	0.6862745
NODE_35575_length_528_cov_2.324009	137	188	16	5	51	0.0980392
NODE_35575_length_528_cov_2.324009	161	241	6	12	80	0.1500000
NODE_35575_length_528_cov_2.324009	161	241	8	27	80	0.3375000
NODE_35575_length_528_cov_2.324009	161	241	10	7	80	0.0875000
NODE_35575_length_528_cov_2.324009	161	241	12	11	80	0.1375000
NODE_35575_length_528_cov_2.324009	161	241	14	23	80	0.2875000
NODE_35597_length_528_cov_1.755245	268	348	4	4	80	0.0500000
NODE_35597_length_528_cov_1.755245	268	348	10	1	80	0.0125000
NODE_35597_length_528_cov_1.755245	268	348	12	7	80	0.0875000
NODE_35597_length_528_cov_1.755245	268	348	13	8	80	0.1000000
NODE_35597_length_528_cov_1.755245	268	348	14	3	80	0.0375000
NODE_35597_length_528_cov_1.755245	268	348	15	2	80	0.0250000
NODE_35597_length_528_cov_1.755245	268	348	16	34	80	0.4250000
NODE_35597_length_528_cov_1.755245	268	348	18	21	80	0.2625000
NODE_35597_length_528_cov_1.755245	321	401	4	12	80	0.1500000
NODE_35597_length_528_cov_1.755245	321	401	6	2	80	0.0250000
NODE_35597_length_528_cov_1.755245	321	401	8	1	80	0.0125000
NODE_35597_length_528_cov_1.755245	321	401	10	1	80	0.0125000
NODE_35597_length_528_cov_1.755245	321	401	12	3	80	0.0375000
NODE_35597_length_528_cov_1.755245	321	401	14	37	80	0.4625000
NODE_35597_length_528_cov_1.755245	321	401	15	1	80	0.0125000
NODE_35597_length_528_cov_1.755245	321	401	16	8	80	0.1000000
NODE_35597_length_528_cov_1.755245	321	401	18	15	80	0.1875000
NODE_35687_length_527_cov_19.247664	306	386	2	16	80	0.2000000
NODE_35687_length_527_cov_19.247664	306	386	4	64	80	0.8000000
NODE_35687_length_527_cov_19.247664	359	439	2	4	80	0.0500000
NODE_35687_length_527_cov_19.247664	359	439	4	76	80	0.9500000
NODE_35688_length_527_cov_15.974299	250	349	0	99	99	1.0000000
NODE_35688_length_527_cov_15.974299	322	402	0	80	80	1.0000000
NODE_35691_length_527_cov_8.221963	235	315	0	69	80	0.8625000
NODE_35691_length_527_cov_8.221963	235	315	2	1	80	0.0125000
NODE_35691_length_527_cov_8.221963	235	315	4	10	80	0.1250000
NODE_35691_length_527_cov_8.221963	288	368	0	16	80	0.2000000
NODE_35691_length_527_cov_8.221963	288	368	2	1	80	0.0125000
NODE_35691_length_527_cov_8.221963	288	368	4	33	80	0.4125000
NODE_35691_length_527_cov_8.221963	288	368	5	3	80	0.0375000
NODE_35691_length_527_cov_8.221963	288	368	6	27	80	0.3375000
NODE_35693_length_527_cov_7.200935	190	270	2	80	80	1.0000000
NODE_35693_length_527_cov_7.200935	243	346	0	39	103	0.3786408
NODE_35693_length_527_cov_7.200935	243	346	2	64	103	0.6213592
NODE_35693_length_527_cov_7.200935	342	422	0	44	80	0.5500000
NODE_35693_length_527_cov_7.200935	342	422	2	36	80	0.4500000
NODE_35693_length_527_cov_7.200935	395	475	2	80	80	1.0000000
NODE_35696_length_527_cov_6.862150	279	359	0	80	80	1.0000000
NODE_35697_length_527_cov_6.046729	155	235	0	80	80	1.0000000
NODE_35697_length_527_cov_6.046729	208	288	0	80	80	1.0000000
NODE_35736_length_527_cov_2.238318	226	306	0	12	80	0.1500000
NODE_35736_length_527_cov_2.238318	226	306	2	68	80	0.8500000
NODE_35858_length_526_cov_50.866511	169	242	0	13	73	0.1780822
NODE_35858_length_526_cov_50.866511	169	242	2	7	73	0.0958904
NODE_35858_length_526_cov_50.866511	169	242	7	1	73	0.0136986
NODE_35858_length_526_cov_50.866511	169	242	8	11	73	0.1506849
NODE_35858_length_526_cov_50.866511	169	242	10	41	73	0.5616438
NODE_35858_length_526_cov_50.866511	215	295	4	2	80	0.0250000
NODE_35858_length_526_cov_50.866511	215	295	6	9	80	0.1125000
NODE_35858_length_526_cov_50.866511	215	295	8	15	80	0.1875000
NODE_35858_length_526_cov_50.866511	215	295	10	28	80	0.3500000
NODE_35858_length_526_cov_50.866511	215	295	14	26	80	0.3250000
NODE_35858_length_526_cov_50.866511	291	371	4	11	80	0.1375000
NODE_35858_length_526_cov_50.866511	291	371	6	54	80	0.6750000
NODE_35858_length_526_cov_50.866511	291	371	8	15	80	0.1875000
NODE_35858_length_526_cov_50.866511	344	424	0	31	80	0.3875000
NODE_35858_length_526_cov_50.866511	344	424	2	3	80	0.0375000
NODE_35858_length_526_cov_50.866511	344	424	6	14	80	0.1750000
NODE_35858_length_526_cov_50.866511	344	424	8	32	80	0.4000000
NODE_35860_length_526_cov_26.395785	315	395	4	67	80	0.8375000
NODE_35860_length_526_cov_26.395785	315	395	5	13	80	0.1625000
NODE_35860_length_526_cov_26.395785	368	448	1	18	80	0.2250000
NODE_35860_length_526_cov_26.395785	368	448	3	33	80	0.4125000
NODE_35860_length_526_cov_26.395785	368	448	4	14	80	0.1750000
NODE_35860_length_526_cov_26.395785	368	448	5	15	80	0.1875000
NODE_35861_length_526_cov_16.611241	305	385	0	80	80	1.0000000
NODE_35861_length_526_cov_16.611241	358	438	0	80	80	1.0000000
NODE_35866_length_526_cov_6.215457	303	351	0	21	48	0.4375000
NODE_35866_length_526_cov_6.215457	303	351	1	21	48	0.4375000
NODE_35866_length_526_cov_6.215457	303	351	2	6	48	0.1250000
NODE_35877_length_526_cov_3.936768	118	142	0	24	24	1.0000000
NODE_35877_length_526_cov_3.936768	118	163	0	45	45	1.0000000
NODE_35901_length_526_cov_2.466042	138	184	2	46	46	1.0000000
NODE_36055_length_525_cov_33.910798	98	178	0	29	80	0.3625000
NODE_36055_length_525_cov_33.910798	98	178	2	3	80	0.0375000
NODE_36055_length_525_cov_33.910798	98	178	4	23	80	0.2875000
NODE_36055_length_525_cov_33.910798	98	178	6	11	80	0.1375000
NODE_36055_length_525_cov_33.910798	98	178	8	1	80	0.0125000
NODE_36055_length_525_cov_33.910798	98	178	10	13	80	0.1625000
NODE_36055_length_525_cov_33.910798	151	231	0	80	80	1.0000000
NODE_36055_length_525_cov_33.910798	159	231	0	72	72	1.0000000
NODE_36058_length_525_cov_8.788732	175	255	0	80	80	1.0000000
NODE_36058_length_525_cov_8.788732	228	308	0	80	80	1.0000000
NODE_36059_length_525_cov_7.880282	242	285	0	43	43	1.0000000
NODE_36098_length_525_cov_2.417840	229	306	0	9	77	0.1168831
NODE_36098_length_525_cov_2.417840	229	306	2	68	77	0.8831169
NODE_36230_length_524_cov_21.649412	262	342	0	2	80	0.0250000
NODE_36230_length_524_cov_21.649412	262	342	4	30	80	0.3750000
NODE_36230_length_524_cov_21.649412	262	342	6	48	80	0.6000000
NODE_36230_length_524_cov_21.649412	315	395	2	16	80	0.2000000
NODE_36230_length_524_cov_21.649412	315	395	6	64	80	0.8000000
NODE_36231_length_524_cov_14.131765	136	201	0	11	65	0.1692308
NODE_36231_length_524_cov_14.131765	136	201	3	2	65	0.0307692
NODE_36231_length_524_cov_14.131765	136	201	4	52	65	0.8000000
NODE_36232_length_524_cov_10.392941	237	317	0	33	80	0.4125000
NODE_36232_length_524_cov_10.392941	237	317	2	47	80	0.5875000
NODE_36232_length_524_cov_10.392941	290	370	2	80	80	1.0000000
NODE_36262_length_524_cov_3.221176	195	272	0	77	77	1.0000000
NODE_36262_length_524_cov_3.221176	253	324	0	71	71	1.0000000
NODE_36264_length_524_cov_3.148235	317	397	2	80	80	1.0000000
NODE_36410_length_523_cov_113.438679	0	48	0	39	48	0.8125000
NODE_36410_length_523_cov_113.438679	0	48	2	9	48	0.1875000
NODE_36410_length_523_cov_113.438679	14	69	0	25	55	0.4545455
NODE_36410_length_523_cov_113.438679	14	69	2	30	55	0.5454546
NODE_36410_length_523_cov_113.438679	25	101	0	14	76	0.1842105
NODE_36410_length_523_cov_113.438679	25	101	2	37	76	0.4868421
NODE_36410_length_523_cov_113.438679	25	101	4	5	76	0.0657895
NODE_36410_length_523_cov_113.438679	25	101	9	1	76	0.0131579
NODE_36410_length_523_cov_113.438679	25	101	11	19	76	0.2500000
NODE_36410_length_523_cov_113.438679	105	181	11	1	76	0.0131579
NODE_36410_length_523_cov_113.438679	105	181	13	4	76	0.0526316
NODE_36410_length_523_cov_113.438679	105	181	14	2	76	0.0263158
NODE_36410_length_523_cov_113.438679	105	181	16	4	76	0.0526316
NODE_36410_length_523_cov_113.438679	105	181	18	14	76	0.1842105
NODE_36410_length_523_cov_113.438679	105	181	22	2	76	0.0263158
NODE_36410_length_523_cov_113.438679	105	181	24	6	76	0.0789474
NODE_36410_length_523_cov_113.438679	105	181	28	2	76	0.0263158
NODE_36410_length_523_cov_113.438679	105	181	30	11	76	0.1447368
NODE_36410_length_523_cov_113.438679	105	181	34	3	76	0.0394737
NODE_36410_length_523_cov_113.438679	105	181	36	2	76	0.0263158
NODE_36410_length_523_cov_113.438679	105	181	40	2	76	0.0263158
NODE_36410_length_523_cov_113.438679	105	181	42	2	76	0.0263158
NODE_36410_length_523_cov_113.438679	105	181	44	13	76	0.1710526
NODE_36410_length_523_cov_113.438679	105	181	45	1	76	0.0131579
NODE_36410_length_523_cov_113.438679	105	181	46	7	76	0.0921053
NODE_36410_length_523_cov_113.438679	154	234	36	4	80	0.0500000
NODE_36410_length_523_cov_113.438679	154	234	37	1	80	0.0125000
NODE_36410_length_523_cov_113.438679	154	234	38	10	80	0.1250000
NODE_36410_length_523_cov_113.438679	154	234	40	14	80	0.1750000
NODE_36410_length_523_cov_113.438679	154	234	42	7	80	0.0875000
NODE_36410_length_523_cov_113.438679	154	234	43	2	80	0.0250000
NODE_36410_length_523_cov_113.438679	154	234	44	22	80	0.2750000
NODE_36410_length_523_cov_113.438679	154	234	45	2	80	0.0250000
NODE_36410_length_523_cov_113.438679	154	234	46	8	80	0.1000000
NODE_36410_length_523_cov_113.438679	154	234	47	5	80	0.0625000
NODE_36410_length_523_cov_113.438679	154	234	48	1	80	0.0125000
NODE_36410_length_523_cov_113.438679	154	234	49	4	80	0.0500000
NODE_36410_length_523_cov_113.438679	312	355	16	9	43	0.2093023
NODE_36410_length_523_cov_113.438679	312	355	20	5	43	0.1162791
NODE_36410_length_523_cov_113.438679	312	355	21	11	43	0.2558140
NODE_36410_length_523_cov_113.438679	312	355	22	4	43	0.0930233
NODE_36410_length_523_cov_113.438679	312	355	23	7	43	0.1627907
NODE_36410_length_523_cov_113.438679	312	355	24	7	43	0.1627907
NODE_36412_length_523_cov_64.695755	35	115	0	80	80	1.0000000
NODE_36412_length_523_cov_64.695755	88	168	0	80	80	1.0000000
NODE_36414_length_523_cov_20.724057	235	315	8	1	80	0.0125000
NODE_36414_length_523_cov_20.724057	235	315	10	13	80	0.1625000
NODE_36414_length_523_cov_20.724057	235	315	12	66	80	0.8250000
NODE_36414_length_523_cov_20.724057	288	368	0	16	80	0.2000000
NODE_36414_length_523_cov_20.724057	288	368	8	33	80	0.4125000
NODE_36414_length_523_cov_20.724057	288	368	10	5	80	0.0625000
NODE_36414_length_523_cov_20.724057	288	368	12	26	80	0.3250000
NODE_36415_length_523_cov_18.500000	164	244	0	38	80	0.4750000
NODE_36415_length_523_cov_18.500000	164	244	2	42	80	0.5250000
NODE_36415_length_523_cov_18.500000	217	297	0	16	80	0.2000000
NODE_36415_length_523_cov_18.500000	217	297	2	64	80	0.8000000
NODE_36416_length_523_cov_15.216981	62	142	0	65	80	0.8125000
NODE_36416_length_523_cov_15.216981	62	142	2	15	80	0.1875000
NODE_36416_length_523_cov_15.216981	115	195	0	12	80	0.1500000
NODE_36416_length_523_cov_15.216981	115	195	2	68	80	0.8500000
NODE_36417_length_523_cov_10.575472	157	183	4	15	26	0.5769231
NODE_36417_length_523_cov_10.575472	157	183	6	11	26	0.4230769
NODE_36418_length_523_cov_9.962264	212	292	0	80	80	1.0000000
NODE_36418_length_523_cov_9.962264	265	345	0	80	80	1.0000000
NODE_36427_length_523_cov_4.943396	108	188	8	19	80	0.2375000
NODE_36427_length_523_cov_4.943396	108	188	10	12	80	0.1500000
NODE_36427_length_523_cov_4.943396	108	188	12	2	80	0.0250000
NODE_36427_length_523_cov_4.943396	108	188	14	23	80	0.2875000
NODE_36427_length_523_cov_4.943396	108	188	16	23	80	0.2875000
NODE_36427_length_523_cov_4.943396	108	188	18	1	80	0.0125000
NODE_36427_length_523_cov_4.943396	161	241	11	3	80	0.0375000
NODE_36427_length_523_cov_4.943396	161	241	12	25	80	0.3125000
NODE_36427_length_523_cov_4.943396	161	241	13	13	80	0.1625000
NODE_36427_length_523_cov_4.943396	161	241	14	21	80	0.2625000
NODE_36427_length_523_cov_4.943396	161	241	16	17	80	0.2125000
NODE_36427_length_523_cov_4.943396	161	241	18	1	80	0.0125000
NODE_36429_length_523_cov_4.787736	110	141	16	2	31	0.0645161
NODE_36429_length_523_cov_4.787736	110	141	18	5	31	0.1612903
NODE_36429_length_523_cov_4.787736	110	141	24	13	31	0.4193548
NODE_36429_length_523_cov_4.787736	110	141	26	11	31	0.3548387
NODE_36429_length_523_cov_4.787736	131	194	14	1	63	0.0158730
NODE_36429_length_523_cov_4.787736	131	194	16	4	63	0.0634921
NODE_36429_length_523_cov_4.787736	131	194	18	1	63	0.0158730
NODE_36429_length_523_cov_4.787736	131	194	20	9	63	0.1428571
NODE_36429_length_523_cov_4.787736	131	194	24	30	63	0.4761905
NODE_36429_length_523_cov_4.787736	131	194	26	18	63	0.2857143
NODE_36439_length_523_cov_3.792453	139	219	0	80	80	1.0000000
NODE_36439_length_523_cov_3.792453	192	272	0	80	80	1.0000000
NODE_36481_length_523_cov_2.259434	337	372	4	35	35	1.0000000
NODE_36490_length_523_cov_2.096698	307	351	2	4	44	0.0909091
NODE_36490_length_523_cov_2.096698	307	351	4	8	44	0.1818182
NODE_36490_length_523_cov_2.096698	307	351	8	12	44	0.2727273
NODE_36490_length_523_cov_2.096698	307	351	10	3	44	0.0681818
NODE_36490_length_523_cov_2.096698	307	351	12	4	44	0.0909091
NODE_36490_length_523_cov_2.096698	307	351	14	1	44	0.0227273
NODE_36490_length_523_cov_2.096698	307	351	16	2	44	0.0454545
NODE_36490_length_523_cov_2.096698	307	351	18	4	44	0.0909091
NODE_36490_length_523_cov_2.096698	307	351	20	1	44	0.0227273
NODE_36490_length_523_cov_2.096698	307	351	24	2	44	0.0454545
NODE_36490_length_523_cov_2.096698	307	351	26	3	44	0.0681818
NODE_36518_length_523_cov_1.700472	176	195	0	19	19	1.0000000
NODE_36632_length_522_cov_33.579196	55	135	0	80	80	1.0000000
NODE_36632_length_522_cov_33.579196	108	188	0	80	80	1.0000000
NODE_36634_length_522_cov_12.851064	266	342	0	63	76	0.8289474
NODE_36634_length_522_cov_12.851064	266	342	2	13	76	0.1710526
NODE_36634_length_522_cov_12.851064	319	395	0	76	76	1.0000000
NODE_36637_length_522_cov_7.349882	212	283	0	28	71	0.3943662
NODE_36637_length_522_cov_7.349882	212	283	2	43	71	0.6056338
NODE_36637_length_522_cov_7.349882	400	469	0	69	69	1.0000000
NODE_36670_length_522_cov_2.933806	178	258	0	58	80	0.7250000
NODE_36670_length_522_cov_2.933806	178	258	2	22	80	0.2750000
NODE_36670_length_522_cov_2.933806	231	311	0	80	80	1.0000000
NODE_36676_length_522_cov_2.661939	187	241	0	25	54	0.4629630
NODE_36676_length_522_cov_2.661939	187	241	2	29	54	0.5370370
NODE_36820_length_521_cov_9.303318	106	186	0	12	80	0.1500000
NODE_36820_length_521_cov_9.303318	106	186	2	68	80	0.8500000
NODE_36820_length_521_cov_9.303318	159	239	0	24	80	0.3000000
NODE_36820_length_521_cov_9.303318	159	239	2	56	80	0.7000000
NODE_36832_length_521_cov_4.971564	218	298	0	80	80	1.0000000
NODE_36832_length_521_cov_4.971564	271	351	0	80	80	1.0000000
NODE_36845_length_521_cov_3.504739	113	191	0	78	78	1.0000000
NODE_36845_length_521_cov_3.504739	164	205	0	41	41	1.0000000
NODE_36848_length_521_cov_3.324645	158	244	0	3	86	0.0348837
NODE_36848_length_521_cov_3.324645	158	244	2	1	86	0.0116279
NODE_36848_length_521_cov_3.324645	158	244	4	33	86	0.3837209
NODE_36848_length_521_cov_3.324645	158	244	6	6	86	0.0697674
NODE_36848_length_521_cov_3.324645	158	244	7	4	86	0.0465116
NODE_36848_length_521_cov_3.324645	158	244	8	5	86	0.0581395
NODE_36848_length_521_cov_3.324645	158	244	10	27	86	0.3139535
NODE_36848_length_521_cov_3.324645	158	244	12	7	86	0.0813954
NODE_36848_length_521_cov_3.324645	217	280	6	2	63	0.0317460
NODE_36848_length_521_cov_3.324645	217	280	8	1	63	0.0158730
NODE_36848_length_521_cov_3.324645	217	280	10	25	63	0.3968254
NODE_36848_length_521_cov_3.324645	217	280	12	35	63	0.5555556
NODE_36916_length_521_cov_1.613744	165	227	2	62	62	1.0000000
NODE_37036_length_520_cov_50.676960	0	75	0	75	75	1.0000000
NODE_37036_length_520_cov_50.676960	48	128	0	80	80	1.0000000
NODE_37036_length_520_cov_50.676960	124	204	0	50	80	0.6250000
NODE_37036_length_520_cov_50.676960	124	204	2	17	80	0.2125000
NODE_37036_length_520_cov_50.676960	124	204	4	13	80	0.1625000
NODE_37036_length_520_cov_50.676960	177	257	2	14	80	0.1750000
NODE_37036_length_520_cov_50.676960	177	257	4	66	80	0.8250000
NODE_37037_length_520_cov_43.294537	10	90	0	80	80	1.0000000
NODE_37037_length_520_cov_43.294537	10	90	0	80	80	1.0000000
NODE_37037_length_520_cov_43.294537	10	90	0	80	80	1.0000000
NODE_37037_length_520_cov_43.294537	10	90	0	80	80	1.0000000
NODE_37037_length_520_cov_43.294537	10	90	0	80	80	1.0000000
NODE_37037_length_520_cov_43.294537	10	90	0	80	80	1.0000000
NODE_37037_length_520_cov_43.294537	63	129	0	66	66	1.0000000
NODE_37037_length_520_cov_43.294537	63	142	0	79	79	1.0000000
NODE_37037_length_520_cov_43.294537	63	143	0	80	80	1.0000000
NODE_37037_length_520_cov_43.294537	63	133	0	70	70	1.0000000
NODE_37037_length_520_cov_43.294537	66	133	0	67	67	1.0000000
NODE_37037_length_520_cov_43.294537	68	143	0	75	75	1.0000000
NODE_37038_length_520_cov_29.427553	224	304	0	20	80	0.2500000
NODE_37038_length_520_cov_29.427553	224	304	2	60	80	0.7500000
NODE_37038_length_520_cov_29.427553	277	357	0	39	80	0.4875000
NODE_37038_length_520_cov_29.427553	277	357	2	41	80	0.5125000
NODE_37038_length_520_cov_29.427553	353	433	0	80	80	1.0000000
NODE_37038_length_520_cov_29.427553	406	486	0	80	80	1.0000000
NODE_37039_length_520_cov_14.365796	103	183	0	80	80	1.0000000
NODE_37039_length_520_cov_14.365796	156	237	0	81	81	1.0000000
NODE_37059_length_520_cov_4.121140	79	159	0	80	80	1.0000000
NODE_37059_length_520_cov_4.121140	132	212	0	80	80	1.0000000
NODE_37063_length_520_cov_3.900238	203	233	6	30	30	1.0000000
NODE_37235_length_519_cov_42.842857	8	88	0	15	80	0.1875000
NODE_37235_length_519_cov_42.842857	8	88	2	8	80	0.1000000
NODE_37235_length_519_cov_42.842857	8	88	8	15	80	0.1875000
NODE_37235_length_519_cov_42.842857	8	88	10	10	80	0.1250000
NODE_37235_length_519_cov_42.842857	8	88	12	18	80	0.2250000
NODE_37235_length_519_cov_42.842857	8	88	14	14	80	0.1750000
NODE_37235_length_519_cov_42.842857	61	139	12	13	78	0.1666667
NODE_37235_length_519_cov_42.842857	61	139	14	15	78	0.1923077
NODE_37235_length_519_cov_42.842857	61	139	16	5	78	0.0641026
NODE_37235_length_519_cov_42.842857	61	139	18	14	78	0.1794872
NODE_37235_length_519_cov_42.842857	61	139	21	2	78	0.0256410
NODE_37235_length_519_cov_42.842857	61	139	23	3	78	0.0384615
NODE_37235_length_519_cov_42.842857	61	139	25	9	78	0.1153846
NODE_37235_length_519_cov_42.842857	61	139	26	7	78	0.0897436
NODE_37235_length_519_cov_42.842857	61	139	27	5	78	0.0641026
NODE_37235_length_519_cov_42.842857	61	139	28	5	78	0.0641026
NODE_37236_length_519_cov_19.269048	284	363	2	5	79	0.0632911
NODE_37236_length_519_cov_19.269048	284	363	5	19	79	0.2405063
NODE_37236_length_519_cov_19.269048	284	363	6	20	79	0.2531646
NODE_37236_length_519_cov_19.269048	284	363	7	1	79	0.0126582
NODE_37236_length_519_cov_19.269048	284	363	8	34	79	0.4303797
NODE_37236_length_519_cov_19.269048	336	416	0	30	80	0.3750000
NODE_37236_length_519_cov_19.269048	336	416	2	28	80	0.3500000
NODE_37236_length_519_cov_19.269048	336	416	5	19	80	0.2375000
NODE_37236_length_519_cov_19.269048	336	416	7	1	80	0.0125000
NODE_37236_length_519_cov_19.269048	336	416	8	2	80	0.0250000
NODE_37237_length_519_cov_8.500000	195	267	0	43	72	0.5972222
NODE_37237_length_519_cov_8.500000	195	267	2	15	72	0.2083333
NODE_37237_length_519_cov_8.500000	195	267	4	14	72	0.1944444
NODE_37245_length_519_cov_5.169048	282	346	0	64	64	1.0000000
NODE_37290_length_519_cov_2.783333	174	235	0	61	61	1.0000000
NODE_37349_length_519_cov_1.538095	147	213	0	66	66	1.0000000
NODE_37447_length_518_cov_40.026253	385	465	2	28	80	0.3500000
NODE_37447_length_518_cov_40.026253	385	465	8	15	80	0.1875000
NODE_37447_length_518_cov_40.026253	385	465	10	37	80	0.4625000
NODE_37447_length_518_cov_40.026253	438	518	0	48	80	0.6000000
NODE_37447_length_518_cov_40.026253	438	518	2	32	80	0.4000000
NODE_37449_length_518_cov_12.083532	144	224	0	17	80	0.2125000
NODE_37449_length_518_cov_12.083532	144	224	4	63	80	0.7875000
NODE_37449_length_518_cov_12.083532	197	277	0	3	80	0.0375000
NODE_37449_length_518_cov_12.083532	197	277	4	77	80	0.9625000
NODE_37449_length_518_cov_12.083532	407	481	0	74	74	1.0000000
NODE_37449_length_518_cov_12.083532	454	518	0	64	64	1.0000000
NODE_37450_length_518_cov_11.467780	171	200	0	7	29	0.2413793
NODE_37450_length_518_cov_11.467780	171	200	1	18	29	0.6206896
NODE_37450_length_518_cov_11.467780	171	200	2	4	29	0.1379310
NODE_37450_length_518_cov_11.467780	253	320	0	67	67	1.0000000
NODE_37450_length_518_cov_11.467780	253	282	0	29	29	1.0000000
NODE_37454_length_518_cov_7.441527	188	273	0	85	85	1.0000000
NODE_37461_length_518_cov_5.563246	315	366	6	6	51	0.1176471
NODE_37461_length_518_cov_5.563246	315	366	8	1	51	0.0196078
NODE_37461_length_518_cov_5.563246	315	366	10	44	51	0.8627451
NODE_37461_length_518_cov_5.563246	339	383	4	2	44	0.0454545
NODE_37461_length_518_cov_5.563246	339	383	8	5	44	0.1136364
NODE_37461_length_518_cov_5.563246	339	383	10	37	44	0.8409091
NODE_37465_length_518_cov_4.732697	214	276	0	62	62	1.0000000
NODE_37465_length_518_cov_4.732697	350	430	0	80	80	1.0000000
NODE_37479_length_518_cov_3.503580	291	333	0	42	42	1.0000000
NODE_37479_length_518_cov_3.503580	306	363	0	57	57	1.0000000
NODE_37483_length_518_cov_3.136038	269	338	0	17	69	0.2463768
NODE_37483_length_518_cov_3.136038	269	338	2	5	69	0.0724638
NODE_37483_length_518_cov_3.136038	269	338	6	18	69	0.2608696
NODE_37483_length_518_cov_3.136038	269	338	8	29	69	0.4202898
NODE_37483_length_518_cov_3.136038	269	348	0	17	79	0.2151899
NODE_37483_length_518_cov_3.136038	269	348	2	5	79	0.0632911
NODE_37483_length_518_cov_3.136038	269	348	6	18	79	0.2278481
NODE_37483_length_518_cov_3.136038	269	348	8	29	79	0.3670886
NODE_37483_length_518_cov_3.136038	269	348	10	4	79	0.0506329
NODE_37483_length_518_cov_3.136038	269	348	12	6	79	0.0759494
NODE_37483_length_518_cov_3.136038	269	349	0	17	80	0.2125000
NODE_37483_length_518_cov_3.136038	269	349	2	5	80	0.0625000
NODE_37483_length_518_cov_3.136038	269	349	6	18	80	0.2250000
NODE_37483_length_518_cov_3.136038	269	349	8	29	80	0.3625000
NODE_37483_length_518_cov_3.136038	269	349	10	4	80	0.0500000
NODE_37483_length_518_cov_3.136038	269	349	12	7	80	0.0875000
NODE_37483_length_518_cov_3.136038	322	402	6	2	80	0.0250000
NODE_37483_length_518_cov_3.136038	322	402	8	28	80	0.3500000
NODE_37483_length_518_cov_3.136038	322	402	10	26	80	0.3250000
NODE_37483_length_518_cov_3.136038	322	402	12	24	80	0.3000000
NODE_37483_length_518_cov_3.136038	322	364	8	16	42	0.3809524
NODE_37483_length_518_cov_3.136038	322	364	10	4	42	0.0952381
NODE_37483_length_518_cov_3.136038	322	364	12	22	42	0.5238096
NODE_37483_length_518_cov_3.136038	322	368	8	16	46	0.3478261
NODE_37483_length_518_cov_3.136038	322	368	10	6	46	0.1304348
NODE_37483_length_518_cov_3.136038	322	368	12	24	46	0.5217391
NODE_37483_length_518_cov_3.136038	331	366	8	7	35	0.2000000
NODE_37483_length_518_cov_3.136038	331	366	10	4	35	0.1142857
NODE_37483_length_518_cov_3.136038	331	366	12	24	35	0.6857143
NODE_37637_length_517_cov_55.267943	177	257	2	14	80	0.1750000
NODE_37637_length_517_cov_55.267943	177	257	4	50	80	0.6250000
NODE_37637_length_517_cov_55.267943	177	257	6	16	80	0.2000000
NODE_37637_length_517_cov_55.267943	230	310	0	48	80	0.6000000
NODE_37637_length_517_cov_55.267943	230	310	2	19	80	0.2375000
NODE_37637_length_517_cov_55.267943	230	310	4	13	80	0.1625000
NODE_37639_length_517_cov_30.863636	0	72	0	46	72	0.6388889
NODE_37639_length_517_cov_30.863636	0	72	2	26	72	0.3611111
NODE_37639_length_517_cov_30.863636	0	72	0	46	72	0.6388889
NODE_37639_length_517_cov_30.863636	0	72	2	26	72	0.3611111
NODE_37639_length_517_cov_30.863636	45	125	0	1	80	0.0125000
NODE_37639_length_517_cov_30.863636	45	125	2	30	80	0.3750000
NODE_37639_length_517_cov_30.863636	45	125	4	27	80	0.3375000
NODE_37639_length_517_cov_30.863636	45	125	5	2	80	0.0250000
NODE_37639_length_517_cov_30.863636	45	125	6	20	80	0.2500000
NODE_37639_length_517_cov_30.863636	45	99	0	1	54	0.0185185
NODE_37639_length_517_cov_30.863636	45	99	2	30	54	0.5555556
NODE_37639_length_517_cov_30.863636	45	99	4	23	54	0.4259259
NODE_37641_length_517_cov_12.258373	305	385	0	80	80	1.0000000
NODE_37641_length_517_cov_12.258373	358	438	0	80	80	1.0000000
NODE_37643_length_517_cov_7.131579	100	152	0	8	52	0.1538462
NODE_37643_length_517_cov_7.131579	100	152	1	44	52	0.8461539
NODE_37662_length_517_cov_4.492823	140	220	2	15	80	0.1875000
NODE_37662_length_517_cov_4.492823	140	220	4	34	80	0.4250000
NODE_37662_length_517_cov_4.492823	140	220	6	31	80	0.3875000
NODE_37662_length_517_cov_4.492823	193	273	2	4	80	0.0500000
NODE_37662_length_517_cov_4.492823	193	273	4	12	80	0.1500000
NODE_37662_length_517_cov_4.492823	193	273	6	64	80	0.8000000
NODE_37697_length_517_cov_2.437799	331	388	6	11	57	0.1929825
NODE_37697_length_517_cov_2.437799	331	388	8	33	57	0.5789474
NODE_37697_length_517_cov_2.437799	331	388	10	13	57	0.2280702
NODE_37850_length_516_cov_17.570743	147	227	0	59	80	0.7375000
NODE_37850_length_516_cov_17.570743	147	227	2	21	80	0.2625000
NODE_37850_length_516_cov_17.570743	200	280	0	23	80	0.2875000
NODE_37850_length_516_cov_17.570743	200	280	2	57	80	0.7125000
NODE_37861_length_516_cov_5.268585	402	448	4	46	46	1.0000000
NODE_37862_length_516_cov_5.067146	114	194	0	80	80	1.0000000
NODE_37862_length_516_cov_5.067146	167	247	0	80	80	1.0000000
NODE_37864_length_516_cov_4.788969	156	236	0	80	80	1.0000000
NODE_37864_length_516_cov_4.788969	209	277	0	68	68	1.0000000
NODE_37881_length_516_cov_3.167866	48	93	2	1	45	0.0222222
NODE_37881_length_516_cov_3.167866	48	93	8	3	45	0.0666667
NODE_37881_length_516_cov_3.167866	48	93	12	5	45	0.1111111
NODE_37881_length_516_cov_3.167866	48	93	14	16	45	0.3555556
NODE_37881_length_516_cov_3.167866	48	93	16	5	45	0.1111111
NODE_37881_length_516_cov_3.167866	48	93	22	4	45	0.0888889
NODE_37881_length_516_cov_3.167866	48	93	26	4	45	0.0888889
NODE_37881_length_516_cov_3.167866	48	93	28	2	45	0.0444444
NODE_37881_length_516_cov_3.167866	48	93	34	3	45	0.0666667
NODE_37881_length_516_cov_3.167866	48	93	36	2	45	0.0444444
NODE_37881_length_516_cov_3.167866	103	177	6	3	74	0.0405405
NODE_37881_length_516_cov_3.167866	103	177	8	19	74	0.2567568
NODE_37881_length_516_cov_3.167866	103	177	26	14	74	0.1891892
NODE_37881_length_516_cov_3.167866	103	177	30	1	74	0.0135135
NODE_37881_length_516_cov_3.167866	103	177	32	1	74	0.0135135
NODE_37881_length_516_cov_3.167866	103	177	34	31	74	0.4189189
NODE_37881_length_516_cov_3.167866	103	177	36	5	74	0.0675676
NODE_38044_length_515_cov_69.442308	177	257	16	11	80	0.1375000
NODE_38044_length_515_cov_69.442308	177	257	18	69	80	0.8625000
NODE_38044_length_515_cov_69.442308	177	257	16	11	80	0.1375000
NODE_38044_length_515_cov_69.442308	177	257	18	69	80	0.8625000
NODE_38044_length_515_cov_69.442308	177	257	16	11	80	0.1375000
NODE_38044_length_515_cov_69.442308	177	257	18	69	80	0.8625000
NODE_38044_length_515_cov_69.442308	230	291	10	19	61	0.3114754
NODE_38044_length_515_cov_69.442308	230	291	12	13	61	0.2131148
NODE_38044_length_515_cov_69.442308	230	291	15	1	61	0.0163934
NODE_38044_length_515_cov_69.442308	230	291	18	28	61	0.4590164
NODE_38044_length_515_cov_69.442308	230	308	10	36	78	0.4615385
NODE_38044_length_515_cov_69.442308	230	308	12	13	78	0.1666667
NODE_38044_length_515_cov_69.442308	230	308	15	1	78	0.0128205
NODE_38044_length_515_cov_69.442308	230	308	18	28	78	0.3589744
NODE_38044_length_515_cov_69.442308	235	308	10	36	73	0.4931507
NODE_38044_length_515_cov_69.442308	235	308	12	13	73	0.1780822
NODE_38044_length_515_cov_69.442308	235	308	15	1	73	0.0136986
NODE_38044_length_515_cov_69.442308	235	308	18	23	73	0.3150685
NODE_38045_length_515_cov_13.271635	168	248	0	80	80	1.0000000
NODE_38045_length_515_cov_13.271635	221	301	0	80	80	1.0000000
NODE_38048_length_515_cov_8.314904	213	290	0	39	77	0.5064935
NODE_38048_length_515_cov_8.314904	213	290	2	38	77	0.4935065
NODE_38054_length_515_cov_5.487981	317	402	0	28	85	0.3294118
NODE_38054_length_515_cov_5.487981	317	402	2	3	85	0.0352941
NODE_38054_length_515_cov_5.487981	317	402	4	3	85	0.0352941
NODE_38054_length_515_cov_5.487981	317	402	6	6	85	0.0705882
NODE_38054_length_515_cov_5.487981	317	402	11	36	85	0.4235294
NODE_38054_length_515_cov_5.487981	317	402	15	2	85	0.0235294
NODE_38054_length_515_cov_5.487981	317	402	16	7	85	0.0823529
NODE_38242_length_514_cov_26.910843	170	250	0	27	80	0.3375000
NODE_38242_length_514_cov_26.910843	170	250	2	53	80	0.6625000
NODE_38242_length_514_cov_26.910843	223	303	0	6	80	0.0750000
NODE_38242_length_514_cov_26.910843	223	303	2	74	80	0.9250000
NODE_38243_length_514_cov_12.775904	85	149	0	64	64	1.0000000
NODE_38243_length_514_cov_12.775904	123	202	0	79	79	1.0000000
NODE_38244_length_514_cov_11.156627	124	204	4	80	80	1.0000000
NODE_38244_length_514_cov_11.156627	177	257	0	43	80	0.5375000
NODE_38244_length_514_cov_11.156627	177	257	4	37	80	0.4625000
NODE_38253_length_514_cov_5.802410	165	217	0	52	52	1.0000000
NODE_38253_length_514_cov_5.802410	190	270	0	80	80	1.0000000
NODE_38254_length_514_cov_5.554217	192	272	0	80	80	1.0000000
NODE_38254_length_514_cov_5.554217	294	340	0	46	46	1.0000000
NODE_38257_length_514_cov_5.322892	230	260	0	6	30	0.2000000
NODE_38257_length_514_cov_5.322892	230	260	2	5	30	0.1666667
NODE_38257_length_514_cov_5.322892	230	260	3	2	30	0.0666667
NODE_38257_length_514_cov_5.322892	230	260	4	17	30	0.5666667
NODE_38262_length_514_cov_4.337349	220	300	0	80	80	1.0000000
NODE_38286_length_514_cov_3.012048	264	328	0	64	64	1.0000000
NODE_38432_length_513_cov_14.613527	118	198	0	24	80	0.3000000
NODE_38432_length_513_cov_14.613527	118	198	4	30	80	0.3750000
NODE_38432_length_513_cov_14.613527	118	198	6	6	80	0.0750000
NODE_38432_length_513_cov_14.613527	118	198	10	20	80	0.2500000
NODE_38432_length_513_cov_14.613527	171	251	4	1	80	0.0125000
NODE_38432_length_513_cov_14.613527	171	251	5	2	80	0.0250000
NODE_38432_length_513_cov_14.613527	171	251	6	6	80	0.0750000
NODE_38432_length_513_cov_14.613527	171	251	7	1	80	0.0125000
NODE_38432_length_513_cov_14.613527	171	251	10	65	80	0.8125000
NODE_38432_length_513_cov_14.613527	171	251	11	5	80	0.0625000
NODE_38433_length_513_cov_9.898551	253	333	0	80	80	1.0000000
NODE_38433_length_513_cov_9.898551	306	386	0	80	80	1.0000000
NODE_38434_length_513_cov_9.164251	185	265	0	12	80	0.1500000
NODE_38434_length_513_cov_9.164251	185	265	2	68	80	0.8500000
NODE_38434_length_513_cov_9.164251	238	318	0	47	80	0.5875000
NODE_38434_length_513_cov_9.164251	238	318	2	33	80	0.4125000
NODE_38441_length_513_cov_6.123188	284	364	0	64	80	0.8000000
NODE_38441_length_513_cov_6.123188	284	364	2	16	80	0.2000000
NODE_38441_length_513_cov_6.123188	337	417	0	11	80	0.1375000
NODE_38441_length_513_cov_6.123188	337	417	2	69	80	0.8625000
NODE_38460_length_513_cov_3.456522	283	350	12	35	67	0.5223880
NODE_38460_length_513_cov_3.456522	283	350	14	32	67	0.4776119
NODE_38460_length_513_cov_3.456522	336	398	12	2	62	0.0322581
NODE_38460_length_513_cov_3.456522	336	398	14	60	62	0.9677419
NODE_38482_length_513_cov_2.309179	134	174	0	40	40	1.0000000
NODE_38482_length_513_cov_2.309179	170	223	0	53	53	1.0000000
NODE_38482_length_513_cov_2.309179	238	285	0	47	47	1.0000000
NODE_38515_length_513_cov_1.671498	427	476	0	35	49	0.7142857
NODE_38515_length_513_cov_1.671498	427	476	2	14	49	0.2857143
NODE_38646_length_512_cov_45.070218	34	114	0	63	80	0.7875000
NODE_38646_length_512_cov_45.070218	34	114	2	2	80	0.0250000
NODE_38646_length_512_cov_45.070218	34	114	4	15	80	0.1875000
NODE_38646_length_512_cov_45.070218	87	167	0	10	80	0.1250000
NODE_38646_length_512_cov_45.070218	87	167	2	2	80	0.0250000
NODE_38646_length_512_cov_45.070218	87	167	4	68	80	0.8500000
NODE_38647_length_512_cov_39.639225	323	404	0	78	81	0.9629630
NODE_38647_length_512_cov_39.639225	323	404	2	3	81	0.0370370
NODE_38647_length_512_cov_39.639225	377	457	0	80	80	1.0000000
NODE_38648_length_512_cov_8.581114	192	256	18	20	64	0.3125000
NODE_38648_length_512_cov_8.581114	192	256	20	6	64	0.0937500
NODE_38648_length_512_cov_8.581114	192	256	21	6	64	0.0937500
NODE_38648_length_512_cov_8.581114	192	256	23	11	64	0.1718750
NODE_38648_length_512_cov_8.581114	192	256	25	3	64	0.0468750
NODE_38648_length_512_cov_8.581114	192	256	26	11	64	0.1718750
NODE_38648_length_512_cov_8.581114	192	256	28	7	64	0.1093750
NODE_38661_length_512_cov_4.869249	327	407	0	80	80	1.0000000
NODE_38661_length_512_cov_4.869249	380	460	0	80	80	1.0000000
NODE_38668_length_512_cov_4.157385	161	204	0	43	43	1.0000000
NODE_38668_length_512_cov_4.157385	178	257	0	79	79	1.0000000
NODE_38677_length_512_cov_3.435835	138	218	0	21	80	0.2625000
NODE_38677_length_512_cov_3.435835	138	218	2	59	80	0.7375000
NODE_38677_length_512_cov_3.435835	191	271	0	20	80	0.2500000
NODE_38677_length_512_cov_3.435835	191	271	2	60	80	0.7500000
NODE_38693_length_512_cov_2.888620	320	400	0	60	80	0.7500000
NODE_38693_length_512_cov_2.888620	320	400	2	14	80	0.1750000
NODE_38693_length_512_cov_2.888620	320	400	4	6	80	0.0750000
NODE_38768_length_512_cov_1.341404	198	269	0	1	71	0.0140845
NODE_38768_length_512_cov_1.341404	198	269	4	1	71	0.0140845
NODE_38768_length_512_cov_1.341404	198	269	10	1	71	0.0140845
NODE_38768_length_512_cov_1.341404	198	269	12	2	71	0.0281690
NODE_38768_length_512_cov_1.341404	198	269	14	4	71	0.0563380
NODE_38768_length_512_cov_1.341404	198	269	16	5	71	0.0704225
NODE_38768_length_512_cov_1.341404	198	269	18	1	71	0.0140845
NODE_38768_length_512_cov_1.341404	198	269	20	4	71	0.0563380
NODE_38768_length_512_cov_1.341404	198	269	22	13	71	0.1830986
NODE_38768_length_512_cov_1.341404	198	269	23	3	71	0.0422535
NODE_38768_length_512_cov_1.341404	198	269	24	6	71	0.0845070
NODE_38768_length_512_cov_1.341404	198	269	26	3	71	0.0422535
NODE_38768_length_512_cov_1.341404	198	269	27	1	71	0.0140845
NODE_38768_length_512_cov_1.341404	198	269	29	9	71	0.1267606
NODE_38768_length_512_cov_1.341404	198	269	30	2	71	0.0281690
NODE_38768_length_512_cov_1.341404	198	269	38	12	71	0.1690141
NODE_38768_length_512_cov_1.341404	198	269	40	1	71	0.0140845
NODE_38768_length_512_cov_1.341404	198	269	42	1	71	0.0140845
NODE_38768_length_512_cov_1.341404	198	269	44	1	71	0.0140845
NODE_38866_length_511_cov_9.796117	251	331	0	80	80	1.0000000
NODE_38866_length_511_cov_9.796117	304	370	0	66	66	1.0000000
NODE_38869_length_511_cov_8.873786	239	319	2	1	80	0.0125000
NODE_38869_length_511_cov_8.873786	239	319	3	17	80	0.2125000
NODE_38869_length_511_cov_8.873786	239	319	4	62	80	0.7750000
NODE_38869_length_511_cov_8.873786	292	356	0	3	64	0.0468750
NODE_38869_length_511_cov_8.873786	292	356	2	35	64	0.5468750
NODE_38869_length_511_cov_8.873786	292	356	3	17	64	0.2656250
NODE_38869_length_511_cov_8.873786	292	356	4	9	64	0.1406250
NODE_38870_length_511_cov_8.434466	232	312	0	80	80	1.0000000
NODE_38870_length_511_cov_8.434466	285	366	0	81	81	1.0000000
NODE_38872_length_511_cov_7.519417	157	237	0	80	80	1.0000000
NODE_38872_length_511_cov_7.519417	210	290	0	80	80	1.0000000
NODE_38877_length_511_cov_5.762136	102	179	2	12	77	0.1558442
NODE_38877_length_511_cov_5.762136	102	179	6	65	77	0.8441558
NODE_38877_length_511_cov_5.762136	155	230	4	29	75	0.3866667
NODE_38877_length_511_cov_5.762136	155	230	6	46	75	0.6133333
NODE_38878_length_511_cov_5.655340	133	213	0	18	80	0.2250000
NODE_38878_length_511_cov_5.655340	133	213	2	62	80	0.7750000
NODE_38878_length_511_cov_5.655340	186	266	0	71	80	0.8875000
NODE_38878_length_511_cov_5.655340	186	266	2	9	80	0.1125000
NODE_38911_length_511_cov_2.978155	219	255	2	8	36	0.2222222
NODE_38911_length_511_cov_2.978155	219	255	4	28	36	0.7777778
NODE_39013_length_511_cov_1.225728	99	127	0	28	28	1.0000000
NODE_39092_length_511_cov_0.708738	98	146	0	48	48	1.0000000
NODE_39105_length_510_cov_18.206813	334	414	0	76	80	0.9500000
NODE_39105_length_510_cov_18.206813	334	414	2	4	80	0.0500000
NODE_39105_length_510_cov_18.206813	387	467	0	80	80	1.0000000
NODE_39110_length_510_cov_8.017032	211	291	0	80	80	1.0000000
NODE_39110_length_510_cov_8.017032	264	344	0	80	80	1.0000000
NODE_39110_length_510_cov_8.017032	391	413	0	22	22	1.0000000
NODE_39112_length_510_cov_6.476886	208	251	0	43	43	1.0000000
NODE_39115_length_510_cov_6.133820	149	200	0	51	51	1.0000000
NODE_39122_length_510_cov_4.313869	32	106	2	8	74	0.1081081
NODE_39122_length_510_cov_4.313869	32	106	4	4	74	0.0540541
NODE_39122_length_510_cov_4.313869	32	106	6	62	74	0.8378378
NODE_39131_length_510_cov_3.435523	149	213	3	1	64	0.0156250
NODE_39131_length_510_cov_3.435523	149	213	4	63	64	0.9843750
NODE_39131_length_510_cov_3.435523	191	249	3	37	58	0.6379310
NODE_39131_length_510_cov_3.435523	191	249	4	21	58	0.3620690
NODE_39293_length_509_cov_13.378049	160	240	0	80	80	1.0000000
NODE_39293_length_509_cov_13.378049	213	294	0	81	81	1.0000000
NODE_39302_length_509_cov_5.190244	203	283	14	1	80	0.0125000
NODE_39302_length_509_cov_5.190244	203	283	16	2	80	0.0250000
NODE_39302_length_509_cov_5.190244	203	283	18	4	80	0.0500000
NODE_39302_length_509_cov_5.190244	203	283	22	9	80	0.1125000
NODE_39302_length_509_cov_5.190244	203	283	24	5	80	0.0625000
NODE_39302_length_509_cov_5.190244	203	283	26	59	80	0.7375000
NODE_39302_length_509_cov_5.190244	256	336	2	6	80	0.0750000
NODE_39302_length_509_cov_5.190244	256	336	4	3	80	0.0375000
NODE_39302_length_509_cov_5.190244	256	336	6	9	80	0.1125000
NODE_39302_length_509_cov_5.190244	256	336	8	3	80	0.0375000
NODE_39302_length_509_cov_5.190244	256	336	9	2	80	0.0250000
NODE_39302_length_509_cov_5.190244	256	336	13	1	80	0.0125000
NODE_39302_length_509_cov_5.190244	256	336	16	16	80	0.2000000
NODE_39302_length_509_cov_5.190244	256	336	18	2	80	0.0250000
NODE_39302_length_509_cov_5.190244	256	336	22	2	80	0.0250000
NODE_39302_length_509_cov_5.190244	256	336	24	2	80	0.0250000
NODE_39302_length_509_cov_5.190244	256	336	26	34	80	0.4250000
NODE_39309_length_509_cov_4.478049	221	301	0	80	80	1.0000000
NODE_39309_length_509_cov_4.478049	274	354	0	80	80	1.0000000
NODE_39311_length_509_cov_4.451220	203	283	8	6	80	0.0750000
NODE_39311_length_509_cov_4.451220	203	283	10	45	80	0.5625000
NODE_39311_length_509_cov_4.451220	203	283	12	29	80	0.3625000
NODE_39322_length_509_cov_3.443902	133	185	0	51	52	0.9807692
NODE_39322_length_509_cov_3.443902	133	185	2	1	52	0.0192308
NODE_39326_length_509_cov_3.207317	367	445	0	78	78	1.0000000
NODE_39337_length_509_cov_2.853659	194	274	0	80	80	1.0000000
NODE_39480_length_509_cov_0.809756	229	272	0	43	43	1.0000000
NODE_39506_length_508_cov_22.009780	440	508	0	68	68	1.0000000
NODE_39512_length_508_cov_5.158924	248	284	0	36	36	1.0000000
NODE_39539_length_508_cov_2.662592	165	244	0	2	79	0.0253165
NODE_39539_length_508_cov_2.662592	165	244	2	47	79	0.5949367
NODE_39539_length_508_cov_2.662592	165	244	4	26	79	0.3291139
NODE_39539_length_508_cov_2.662592	165	244	6	4	79	0.0506329
NODE_39698_length_507_cov_32.286765	0	61	5	5	61	0.0819672
NODE_39698_length_507_cov_32.286765	0	61	7	2	61	0.0327869
NODE_39698_length_507_cov_32.286765	0	61	9	1	61	0.0163934
NODE_39698_length_507_cov_32.286765	0	61	18	3	61	0.0491803
NODE_39698_length_507_cov_32.286765	0	61	20	1	61	0.0163934
NODE_39698_length_507_cov_32.286765	0	61	24	3	61	0.0491803
NODE_39698_length_507_cov_32.286765	0	61	25	1	61	0.0163934
NODE_39698_length_507_cov_32.286765	0	61	28	2	61	0.0327869
NODE_39698_length_507_cov_32.286765	0	61	39	1	61	0.0163934
NODE_39698_length_507_cov_32.286765	0	61	40	1	61	0.0163934
NODE_39698_length_507_cov_32.286765	0	61	42	3	61	0.0491803
NODE_39698_length_507_cov_32.286765	0	61	48	1	61	0.0163934
NODE_39698_length_507_cov_32.286765	0	61	50	1	61	0.0163934
NODE_39698_length_507_cov_32.286765	0	61	52	2	61	0.0327869
NODE_39698_length_507_cov_32.286765	0	61	54	1	61	0.0163934
NODE_39698_length_507_cov_32.286765	0	61	58	1	61	0.0163934
NODE_39698_length_507_cov_32.286765	0	61	60	1	61	0.0163934
NODE_39698_length_507_cov_32.286765	0	61	64	2	61	0.0327869
NODE_39698_length_507_cov_32.286765	0	61	66	1	61	0.0163934
NODE_39698_length_507_cov_32.286765	0	61	70	2	61	0.0327869
NODE_39698_length_507_cov_32.286765	0	61	71	1	61	0.0163934
NODE_39698_length_507_cov_32.286765	0	61	73	1	61	0.0163934
NODE_39698_length_507_cov_32.286765	0	61	77	4	61	0.0655738
NODE_39698_length_507_cov_32.286765	0	61	79	2	61	0.0327869
NODE_39698_length_507_cov_32.286765	0	61	81	3	61	0.0491803
NODE_39698_length_507_cov_32.286765	0	61	82	1	61	0.0163934
NODE_39698_length_507_cov_32.286765	0	61	88	1	61	0.0163934
NODE_39698_length_507_cov_32.286765	0	61	89	1	61	0.0163934
NODE_39698_length_507_cov_32.286765	0	61	91	2	61	0.0327869
NODE_39698_length_507_cov_32.286765	0	61	95	8	61	0.1311475
NODE_39698_length_507_cov_32.286765	0	61	99	1	61	0.0163934
NODE_39698_length_507_cov_32.286765	0	61	101	1	61	0.0163934
NODE_39698_length_507_cov_32.286765	53	97	95	6	44	0.1363636
NODE_39698_length_507_cov_32.286765	53	97	99	1	44	0.0227273
NODE_39698_length_507_cov_32.286765	53	97	101	1	44	0.0227273
NODE_39698_length_507_cov_32.286765	53	97	103	2	44	0.0454545
NODE_39698_length_507_cov_32.286765	53	97	111	3	44	0.0681818
NODE_39698_length_507_cov_32.286765	53	97	113	5	44	0.1136364
NODE_39698_length_507_cov_32.286765	53	97	115	1	44	0.0227273
NODE_39698_length_507_cov_32.286765	53	97	117	1	44	0.0227273
NODE_39698_length_507_cov_32.286765	53	97	121	1	44	0.0227273
NODE_39698_length_507_cov_32.286765	53	97	125	3	44	0.0681818
NODE_39698_length_507_cov_32.286765	53	97	129	1	44	0.0227273
NODE_39698_length_507_cov_32.286765	53	97	133	1	44	0.0227273
NODE_39698_length_507_cov_32.286765	53	97	143	2	44	0.0454545
NODE_39698_length_507_cov_32.286765	53	97	145	2	44	0.0454545
NODE_39698_length_507_cov_32.286765	53	97	146	1	44	0.0227273
NODE_39698_length_507_cov_32.286765	53	97	156	1	44	0.0227273
NODE_39698_length_507_cov_32.286765	53	97	162	1	44	0.0227273
NODE_39698_length_507_cov_32.286765	53	97	163	1	44	0.0227273
NODE_39698_length_507_cov_32.286765	53	97	165	1	44	0.0227273
NODE_39698_length_507_cov_32.286765	53	97	171	1	44	0.0227273
NODE_39698_length_507_cov_32.286765	53	97	177	1	44	0.0227273
NODE_39698_length_507_cov_32.286765	53	97	179	1	44	0.0227273
NODE_39698_length_507_cov_32.286765	53	97	181	4	44	0.0909091
NODE_39698_length_507_cov_32.286765	53	97	185	2	44	0.0454545
NODE_39701_length_507_cov_7.553922	203	283	6	2	80	0.0250000
NODE_39701_length_507_cov_7.553922	203	283	14	26	80	0.3250000
NODE_39701_length_507_cov_7.553922	203	283	16	6	80	0.0750000
NODE_39701_length_507_cov_7.553922	203	283	18	17	80	0.2125000
NODE_39701_length_507_cov_7.553922	203	283	19	3	80	0.0375000
NODE_39701_length_507_cov_7.553922	203	283	21	26	80	0.3250000
NODE_39709_length_507_cov_5.154412	296	362	2	27	66	0.4090909
NODE_39709_length_507_cov_5.154412	296	362	3	5	66	0.0757576
NODE_39709_length_507_cov_5.154412	296	362	4	34	66	0.5151515
NODE_39714_length_507_cov_4.710784	248	328	4	70	80	0.8750000
NODE_39714_length_507_cov_4.710784	248	328	6	10	80	0.1250000
NODE_39714_length_507_cov_4.710784	308	379	0	50	71	0.7042254
NODE_39714_length_507_cov_4.710784	308	379	4	21	71	0.2957746
NODE_39728_length_507_cov_3.649510	80	109	6	10	29	0.3448276
NODE_39728_length_507_cov_3.649510	80	109	8	1	29	0.0344828
NODE_39728_length_507_cov_3.649510	80	109	10	5	29	0.1724138
NODE_39728_length_507_cov_3.649510	80	109	12	7	29	0.2413793
NODE_39728_length_507_cov_3.649510	80	109	14	6	29	0.2068966
NODE_39728_length_507_cov_3.649510	184	266	20	3	82	0.0365854
NODE_39728_length_507_cov_3.649510	184	266	22	4	82	0.0487805
NODE_39728_length_507_cov_3.649510	184	266	24	6	82	0.0731707
NODE_39728_length_507_cov_3.649510	184	266	26	5	82	0.0609756
NODE_39728_length_507_cov_3.649510	184	266	28	1	82	0.0121951
NODE_39728_length_507_cov_3.649510	184	266	30	6	82	0.0731707
NODE_39728_length_507_cov_3.649510	184	266	32	11	82	0.1341463
NODE_39728_length_507_cov_3.649510	184	266	34	3	82	0.0365854
NODE_39728_length_507_cov_3.649510	184	266	36	13	82	0.1585366
NODE_39728_length_507_cov_3.649510	184	266	38	13	82	0.1585366
NODE_39728_length_507_cov_3.649510	184	266	40	17	82	0.2073171
NODE_39728_length_507_cov_3.649510	189	273	16	4	84	0.0476190
NODE_39728_length_507_cov_3.649510	189	273	20	6	84	0.0714286
NODE_39728_length_507_cov_3.649510	189	273	22	4	84	0.0476190
NODE_39728_length_507_cov_3.649510	189	273	24	6	84	0.0714286
NODE_39728_length_507_cov_3.649510	189	273	26	5	84	0.0595238
NODE_39728_length_507_cov_3.649510	189	273	28	1	84	0.0119048
NODE_39728_length_507_cov_3.649510	189	273	30	6	84	0.0714286
NODE_39728_length_507_cov_3.649510	189	273	32	11	84	0.1309524
NODE_39728_length_507_cov_3.649510	189	273	34	3	84	0.0357143
NODE_39728_length_507_cov_3.649510	189	273	36	13	84	0.1547619
NODE_39728_length_507_cov_3.649510	189	273	38	13	84	0.1547619
NODE_39728_length_507_cov_3.649510	189	273	40	12	84	0.1428571
NODE_39728_length_507_cov_3.649510	207	266	20	3	59	0.0508475
NODE_39728_length_507_cov_3.649510	207	266	22	4	59	0.0677966
NODE_39728_length_507_cov_3.649510	207	266	24	6	59	0.1016949
NODE_39728_length_507_cov_3.649510	207	266	26	5	59	0.0847458
NODE_39728_length_507_cov_3.649510	207	266	28	1	59	0.0169492
NODE_39728_length_507_cov_3.649510	207	266	30	6	59	0.1016949
NODE_39728_length_507_cov_3.649510	207	266	32	11	59	0.1864407
NODE_39728_length_507_cov_3.649510	207	266	34	3	59	0.0508475
NODE_39728_length_507_cov_3.649510	207	266	36	13	59	0.2203390
NODE_39728_length_507_cov_3.649510	207	266	38	3	59	0.0508475
NODE_39728_length_507_cov_3.649510	207	266	40	4	59	0.0677966
NODE_39747_length_507_cov_2.754902	345	425	0	10	80	0.1250000
NODE_39747_length_507_cov_2.754902	345	425	2	28	80	0.3500000
NODE_39747_length_507_cov_2.754902	345	425	4	42	80	0.5250000
NODE_39747_length_507_cov_2.754902	428	463	0	17	35	0.4857143
NODE_39747_length_507_cov_2.754902	428	463	2	18	35	0.5142857
NODE_39918_length_506_cov_31.987715	71	156	22	3	85	0.0352941
NODE_39918_length_506_cov_31.987715	71	156	28	7	85	0.0823529
NODE_39918_length_506_cov_31.987715	71	156	29	36	85	0.4235294
NODE_39918_length_506_cov_31.987715	71	156	31	3	85	0.0352941
NODE_39918_length_506_cov_31.987715	71	156	33	36	85	0.4235294
NODE_39918_length_506_cov_31.987715	71	156	22	3	85	0.0352941
NODE_39918_length_506_cov_31.987715	71	156	28	7	85	0.0823529
NODE_39918_length_506_cov_31.987715	71	156	29	36	85	0.4235294
NODE_39918_length_506_cov_31.987715	71	156	31	3	85	0.0352941
NODE_39918_length_506_cov_31.987715	71	156	33	36	85	0.4235294
NODE_39918_length_506_cov_31.987715	71	156	22	3	85	0.0352941
NODE_39918_length_506_cov_31.987715	71	156	28	7	85	0.0823529
NODE_39918_length_506_cov_31.987715	71	156	29	36	85	0.4235294
NODE_39918_length_506_cov_31.987715	71	156	31	3	85	0.0352941
NODE_39918_length_506_cov_31.987715	71	156	33	36	85	0.4235294
NODE_39918_length_506_cov_31.987715	129	209	4	24	80	0.3000000
NODE_39918_length_506_cov_31.987715	129	209	6	18	80	0.2250000
NODE_39918_length_506_cov_31.987715	129	209	15	1	80	0.0125000
NODE_39918_length_506_cov_31.987715	129	209	27	4	80	0.0500000
NODE_39918_length_506_cov_31.987715	129	209	33	33	80	0.4125000
NODE_39919_length_506_cov_15.877150	210	279	4	8	69	0.1159420
NODE_39919_length_506_cov_15.877150	210	279	6	32	69	0.4637681
NODE_39919_length_506_cov_15.877150	210	279	7	18	69	0.2608696
NODE_39919_length_506_cov_15.877150	210	279	8	5	69	0.0724638
NODE_39919_length_506_cov_15.877150	210	279	9	6	69	0.0869565
NODE_39920_length_506_cov_15.461916	334	414	0	4	80	0.0500000
NODE_39920_length_506_cov_15.461916	334	414	2	76	80	0.9500000
NODE_39920_length_506_cov_15.461916	387	467	0	8	80	0.1000000
NODE_39920_length_506_cov_15.461916	387	467	2	72	80	0.9000000
NODE_39921_length_506_cov_9.749386	197	276	0	71	79	0.8987342
NODE_39921_length_506_cov_9.749386	197	276	2	8	79	0.1012658
NODE_39921_length_506_cov_9.749386	249	329	0	80	80	1.0000000
NODE_39947_length_506_cov_3.122850	218	298	0	80	80	1.0000000
NODE_39947_length_506_cov_3.122850	271	351	0	80	80	1.0000000
NODE_39951_length_506_cov_2.894349	190	270	0	80	80	1.0000000
NODE_40133_length_505_cov_35.541872	373	453	0	19	80	0.2375000
NODE_40133_length_505_cov_35.541872	373	453	4	61	80	0.7625000
NODE_40135_length_505_cov_10.339901	30	110	0	2	80	0.0250000
NODE_40135_length_505_cov_10.339901	30	110	2	78	80	0.9750000
NODE_40135_length_505_cov_10.339901	83	163	0	25	80	0.3125000
NODE_40135_length_505_cov_10.339901	83	163	2	55	80	0.6875000
NODE_40158_length_505_cov_3.554187	225	305	0	80	80	1.0000000
NODE_40158_length_505_cov_3.554187	278	358	0	80	80	1.0000000
NODE_40160_length_505_cov_3.403941	207	287	0	36	80	0.4500000
NODE_40160_length_505_cov_3.403941	207	287	1	44	80	0.5500000
NODE_40175_length_505_cov_2.975369	162	227	2	65	65	1.0000000
NODE_40222_length_505_cov_1.864532	55	126	0	30	71	0.4225352
NODE_40222_length_505_cov_1.864532	55	126	2	41	71	0.5774648
NODE_40368_length_504_cov_115.891358	122	202	331	1	80	0.0125000
NODE_40368_length_504_cov_115.891358	122	202	333	1	80	0.0125000
NODE_40368_length_504_cov_115.891358	122	202	342	1	80	0.0125000
NODE_40368_length_504_cov_115.891358	122	202	350	1	80	0.0125000
NODE_40368_length_504_cov_115.891358	122	202	354	1	80	0.0125000
NODE_40368_length_504_cov_115.891358	122	202	372	1	80	0.0125000
NODE_40368_length_504_cov_115.891358	122	202	374	1	80	0.0125000
NODE_40368_length_504_cov_115.891358	122	202	377	3	80	0.0375000
NODE_40368_length_504_cov_115.891358	122	202	383	1	80	0.0125000
NODE_40368_length_504_cov_115.891358	122	202	402	2	80	0.0250000
NODE_40368_length_504_cov_115.891358	122	202	405	1	80	0.0125000
NODE_40368_length_504_cov_115.891358	122	202	406	1	80	0.0125000
NODE_40368_length_504_cov_115.891358	122	202	407	1	80	0.0125000
NODE_40368_length_504_cov_115.891358	122	202	413	1	80	0.0125000
NODE_40368_length_504_cov_115.891358	122	202	420	1	80	0.0125000
NODE_40368_length_504_cov_115.891358	122	202	422	2	80	0.0250000
NODE_40368_length_504_cov_115.891358	122	202	423	1	80	0.0125000
NODE_40368_length_504_cov_115.891358	122	202	424	1	80	0.0125000
NODE_40368_length_504_cov_115.891358	122	202	426	2	80	0.0250000
NODE_40368_length_504_cov_115.891358	122	202	428	1	80	0.0125000
NODE_40368_length_504_cov_115.891358	122	202	429	1	80	0.0125000
NODE_40368_length_504_cov_115.891358	122	202	430	1	80	0.0125000
NODE_40368_length_504_cov_115.891358	122	202	433	1	80	0.0125000
NODE_40368_length_504_cov_115.891358	122	202	435	1	80	0.0125000
NODE_40368_length_504_cov_115.891358	122	202	441	1	80	0.0125000
NODE_40368_length_504_cov_115.891358	122	202	451	1	80	0.0125000
NODE_40368_length_504_cov_115.891358	122	202	454	1	80	0.0125000
NODE_40368_length_504_cov_115.891358	122	202	461	1	80	0.0125000
NODE_40368_length_504_cov_115.891358	122	202	463	2	80	0.0250000
NODE_40368_length_504_cov_115.891358	122	202	466	3	80	0.0375000
NODE_40368_length_504_cov_115.891358	122	202	467	2	80	0.0250000
NODE_40368_length_504_cov_115.891358	122	202	476	1	80	0.0125000
NODE_40368_length_504_cov_115.891358	122	202	479	1	80	0.0125000
NODE_40368_length_504_cov_115.891358	122	202	480	1	80	0.0125000
NODE_40368_length_504_cov_115.891358	122	202	482	1	80	0.0125000
NODE_40368_length_504_cov_115.891358	122	202	494	1	80	0.0125000
NODE_40368_length_504_cov_115.891358	122	202	512	1	80	0.0125000
NODE_40368_length_504_cov_115.891358	122	202	518	1	80	0.0125000
NODE_40368_length_504_cov_115.891358	122	202	528	1	80	0.0125000
NODE_40368_length_504_cov_115.891358	122	202	530	2	80	0.0250000
NODE_40368_length_504_cov_115.891358	122	202	532	1	80	0.0125000
NODE_40368_length_504_cov_115.891358	122	202	542	1	80	0.0125000
NODE_40368_length_504_cov_115.891358	122	202	546	1	80	0.0125000
NODE_40368_length_504_cov_115.891358	122	202	548	1	80	0.0125000
NODE_40368_length_504_cov_115.891358	122	202	551	1	80	0.0125000
NODE_40368_length_504_cov_115.891358	122	202	552	1	80	0.0125000
NODE_40368_length_504_cov_115.891358	122	202	556	1	80	0.0125000
NODE_40368_length_504_cov_115.891358	122	202	564	3	80	0.0375000
NODE_40368_length_504_cov_115.891358	122	202	566	2	80	0.0250000
NODE_40368_length_504_cov_115.891358	122	202	567	1	80	0.0125000
NODE_40368_length_504_cov_115.891358	122	202	568	1	80	0.0125000
NODE_40368_length_504_cov_115.891358	122	202	576	2	80	0.0250000
NODE_40368_length_504_cov_115.891358	122	202	582	1	80	0.0125000
NODE_40368_length_504_cov_115.891358	122	202	596	1	80	0.0125000
NODE_40368_length_504_cov_115.891358	122	202	600	2	80	0.0250000
NODE_40368_length_504_cov_115.891358	122	202	602	1	80	0.0125000
NODE_40368_length_504_cov_115.891358	122	202	609	3	80	0.0375000
NODE_40368_length_504_cov_115.891358	122	202	612	1	80	0.0125000
NODE_40368_length_504_cov_115.891358	122	202	633	1	80	0.0125000
NODE_40368_length_504_cov_115.891358	122	202	636	1	80	0.0125000
NODE_40368_length_504_cov_115.891358	122	202	637	1	80	0.0125000
NODE_40368_length_504_cov_115.891358	122	202	640	2	80	0.0250000
NODE_40368_length_504_cov_115.891358	175	255	423	1	80	0.0125000
NODE_40368_length_504_cov_115.891358	175	255	436	1	80	0.0125000
NODE_40368_length_504_cov_115.891358	175	255	441	1	80	0.0125000
NODE_40368_length_504_cov_115.891358	175	255	448	1	80	0.0125000
NODE_40368_length_504_cov_115.891358	175	255	449	1	80	0.0125000
NODE_40368_length_504_cov_115.891358	175	255	451	1	80	0.0125000
NODE_40368_length_504_cov_115.891358	175	255	459	1	80	0.0125000
NODE_40368_length_504_cov_115.891358	175	255	465	1	80	0.0125000
NODE_40368_length_504_cov_115.891358	175	255	480	1	80	0.0125000
NODE_40368_length_504_cov_115.891358	175	255	492	1	80	0.0125000
NODE_40368_length_504_cov_115.891358	175	255	495	1	80	0.0125000
NODE_40368_length_504_cov_115.891358	175	255	497	1	80	0.0125000
NODE_40368_length_504_cov_115.891358	175	255	505	1	80	0.0125000
NODE_40368_length_504_cov_115.891358	175	255	509	1	80	0.0125000
NODE_40368_length_504_cov_115.891358	175	255	515	1	80	0.0125000
NODE_40368_length_504_cov_115.891358	175	255	523	1	80	0.0125000
NODE_40368_length_504_cov_115.891358	175	255	535	2	80	0.0250000
NODE_40368_length_504_cov_115.891358	175	255	538	1	80	0.0125000
NODE_40368_length_504_cov_115.891358	175	255	545	1	80	0.0125000
NODE_40368_length_504_cov_115.891358	175	255	546	1	80	0.0125000
NODE_40368_length_504_cov_115.891358	175	255	551	1	80	0.0125000
NODE_40368_length_504_cov_115.891358	175	255	552	3	80	0.0375000
NODE_40368_length_504_cov_115.891358	175	255	556	1	80	0.0125000
NODE_40368_length_504_cov_115.891358	175	255	561	1	80	0.0125000
NODE_40368_length_504_cov_115.891358	175	255	564	3	80	0.0375000
NODE_40368_length_504_cov_115.891358	175	255	566	2	80	0.0250000
NODE_40368_length_504_cov_115.891358	175	255	567	1	80	0.0125000
NODE_40368_length_504_cov_115.891358	175	255	568	1	80	0.0125000
NODE_40368_length_504_cov_115.891358	175	255	569	1	80	0.0125000
NODE_40368_length_504_cov_115.891358	175	255	570	1	80	0.0125000
NODE_40368_length_504_cov_115.891358	175	255	575	1	80	0.0125000
NODE_40368_length_504_cov_115.891358	175	255	576	3	80	0.0375000
NODE_40368_length_504_cov_115.891358	175	255	577	1	80	0.0125000
NODE_40368_length_504_cov_115.891358	175	255	581	1	80	0.0125000
NODE_40368_length_504_cov_115.891358	175	255	582	1	80	0.0125000
NODE_40368_length_504_cov_115.891358	175	255	596	1	80	0.0125000
NODE_40368_length_504_cov_115.891358	175	255	600	3	80	0.0375000
NODE_40368_length_504_cov_115.891358	175	255	601	1	80	0.0125000
NODE_40368_length_504_cov_115.891358	175	255	602	2	80	0.0250000
NODE_40368_length_504_cov_115.891358	175	255	604	1	80	0.0125000
NODE_40368_length_504_cov_115.891358	175	255	606	2	80	0.0250000
NODE_40368_length_504_cov_115.891358	175	255	609	3	80	0.0375000
NODE_40368_length_504_cov_115.891358	175	255	610	1	80	0.0125000
NODE_40368_length_504_cov_115.891358	175	255	611	1	80	0.0125000
NODE_40368_length_504_cov_115.891358	175	255	612	1	80	0.0125000
NODE_40368_length_504_cov_115.891358	175	255	613	1	80	0.0125000
NODE_40368_length_504_cov_115.891358	175	255	614	1	80	0.0125000
NODE_40368_length_504_cov_115.891358	175	255	615	1	80	0.0125000
NODE_40368_length_504_cov_115.891358	175	255	617	1	80	0.0125000
NODE_40368_length_504_cov_115.891358	175	255	618	1	80	0.0125000
NODE_40368_length_504_cov_115.891358	175	255	620	4	80	0.0500000
NODE_40368_length_504_cov_115.891358	175	255	621	1	80	0.0125000
NODE_40368_length_504_cov_115.891358	175	255	622	1	80	0.0125000
NODE_40368_length_504_cov_115.891358	175	255	627	1	80	0.0125000
NODE_40368_length_504_cov_115.891358	175	255	629	1	80	0.0125000
NODE_40368_length_504_cov_115.891358	175	255	630	2	80	0.0250000
NODE_40368_length_504_cov_115.891358	175	255	633	1	80	0.0125000
NODE_40368_length_504_cov_115.891358	175	255	635	1	80	0.0125000
NODE_40368_length_504_cov_115.891358	175	255	636	1	80	0.0125000
NODE_40368_length_504_cov_115.891358	175	255	637	1	80	0.0125000
NODE_40368_length_504_cov_115.891358	175	255	640	2	80	0.0250000
NODE_40369_length_504_cov_33.360494	28	108	2	1	80	0.0125000
NODE_40369_length_504_cov_33.360494	28	108	4	24	80	0.3000000
NODE_40369_length_504_cov_33.360494	28	108	6	55	80	0.6875000
NODE_40369_length_504_cov_33.360494	81	161	0	5	80	0.0625000
NODE_40369_length_504_cov_33.360494	81	161	2	49	80	0.6125000
NODE_40369_length_504_cov_33.360494	81	161	6	26	80	0.3250000
NODE_40370_length_504_cov_15.669136	176	256	0	80	80	1.0000000
NODE_40370_length_504_cov_15.669136	229	309	0	80	80	1.0000000
NODE_40371_length_504_cov_13.202469	134	215	0	11	81	0.1358025
NODE_40371_length_504_cov_13.202469	134	215	2	12	81	0.1481481
NODE_40371_length_504_cov_13.202469	134	215	5	3	81	0.0370370
NODE_40371_length_504_cov_13.202469	134	215	6	18	81	0.2222222
NODE_40371_length_504_cov_13.202469	134	215	7	37	81	0.4567901
NODE_40371_length_504_cov_13.202469	188	268	3	25	80	0.3125000
NODE_40371_length_504_cov_13.202469	188	268	5	16	80	0.2000000
NODE_40371_length_504_cov_13.202469	188	268	7	39	80	0.4875000
NODE_40377_length_504_cov_6.770370	55	135	0	80	80	1.0000000
NODE_40377_length_504_cov_6.770370	108	188	0	80	80	1.0000000
NODE_40427_length_504_cov_2.234568	359	407	12	14	48	0.2916667
NODE_40427_length_504_cov_2.234568	359	407	14	34	48	0.7083333
NODE_40428_length_504_cov_2.227160	307	370	0	5	63	0.0793651
NODE_40428_length_504_cov_2.227160	307	370	2	58	63	0.9206349
NODE_40434_length_504_cov_2.116049	245	325	4	80	80	1.0000000
NODE_40434_length_504_cov_2.116049	298	378	2	17	80	0.2125000
NODE_40434_length_504_cov_2.116049	298	378	3	17	80	0.2125000
NODE_40434_length_504_cov_2.116049	298	378	4	46	80	0.5750000
NODE_40446_length_504_cov_1.925926	196	262	2	25	66	0.3787879
NODE_40446_length_504_cov_1.925926	196	262	4	41	66	0.6212121
NODE_40601_length_503_cov_11.356436	268	348	0	80	80	1.0000000
NODE_40601_length_503_cov_11.356436	321	401	0	80	80	1.0000000
NODE_40615_length_503_cov_5.537129	314	381	2	41	67	0.6119403
NODE_40615_length_503_cov_5.537129	314	381	4	26	67	0.3880597
NODE_40645_length_503_cov_3.012376	264	285	0	21	21	1.0000000
NODE_40652_length_503_cov_2.757426	266	334	0	4	68	0.0588235
NODE_40652_length_503_cov_2.757426	266	334	2	12	68	0.1764706
NODE_40652_length_503_cov_2.757426	266	334	4	52	68	0.7647059
NODE_40652_length_503_cov_2.757426	307	387	4	59	80	0.7375000
NODE_40652_length_503_cov_2.757426	307	387	6	15	80	0.1875000
NODE_40652_length_503_cov_2.757426	307	387	8	6	80	0.0750000
NODE_40655_length_503_cov_2.705446	158	237	0	79	79	1.0000000
NODE_40655_length_503_cov_2.705446	211	291	0	80	80	1.0000000
NODE_40656_length_503_cov_2.705446	251	331	4	3	80	0.0375000
NODE_40656_length_503_cov_2.705446	251	331	6	33	80	0.4125000
NODE_40656_length_503_cov_2.705446	251	331	12	44	80	0.5500000
NODE_40656_length_503_cov_2.705446	251	321	4	3	70	0.0428571
NODE_40656_length_503_cov_2.705446	251	321	6	33	70	0.4714286
NODE_40656_length_503_cov_2.705446	251	321	12	34	70	0.4857143
NODE_40656_length_503_cov_2.705446	330	384	6	10	54	0.1851852
NODE_40656_length_503_cov_2.705446	330	384	8	1	54	0.0185185
NODE_40656_length_503_cov_2.705446	330	384	10	3	54	0.0555556
NODE_40656_length_503_cov_2.705446	330	384	11	13	54	0.2407407
NODE_40656_length_503_cov_2.705446	330	384	12	27	54	0.5000000
NODE_40656_length_503_cov_2.705446	338	384	6	10	46	0.2173913
NODE_40656_length_503_cov_2.705446	338	384	8	1	46	0.0217391
NODE_40656_length_503_cov_2.705446	338	384	10	3	46	0.0652174
NODE_40656_length_503_cov_2.705446	338	384	11	13	46	0.2826087
NODE_40656_length_503_cov_2.705446	338	384	12	19	46	0.4130435
NODE_40664_length_503_cov_2.584158	95	163	0	64	68	0.9411765
NODE_40664_length_503_cov_2.584158	95	163	2	4	68	0.0588235
NODE_40857_length_502_cov_45.292804	353	433	40	4	80	0.0500000
NODE_40857_length_502_cov_45.292804	353	433	41	6	80	0.0750000
NODE_40857_length_502_cov_45.292804	353	433	42	2	80	0.0250000
NODE_40857_length_502_cov_45.292804	353	433	44	3	80	0.0375000
NODE_40857_length_502_cov_45.292804	353	433	57	5	80	0.0625000
NODE_40857_length_502_cov_45.292804	353	433	61	1	80	0.0125000
NODE_40857_length_502_cov_45.292804	353	433	65	2	80	0.0250000
NODE_40857_length_502_cov_45.292804	353	433	66	6	80	0.0750000
NODE_40857_length_502_cov_45.292804	353	433	67	29	80	0.3625000
NODE_40857_length_502_cov_45.292804	353	433	71	2	80	0.0250000
NODE_40857_length_502_cov_45.292804	353	433	73	7	80	0.0875000
NODE_40857_length_502_cov_45.292804	353	433	75	12	80	0.1500000
NODE_40857_length_502_cov_45.292804	353	433	77	1	80	0.0125000
NODE_40864_length_502_cov_5.980149	305	381	2	9	76	0.1184211
NODE_40864_length_502_cov_5.980149	305	381	5	2	76	0.0263158
NODE_40864_length_502_cov_5.980149	305	381	6	5	76	0.0657895
NODE_40864_length_502_cov_5.980149	305	381	8	4	76	0.0526316
NODE_40864_length_502_cov_5.980149	305	381	10	1	76	0.0131579
NODE_40864_length_502_cov_5.980149	305	381	12	20	76	0.2631579
NODE_40864_length_502_cov_5.980149	305	381	14	11	76	0.1447368
NODE_40864_length_502_cov_5.980149	305	381	18	20	76	0.2631579
NODE_40864_length_502_cov_5.980149	305	381	20	4	76	0.0526316
NODE_41070_length_501_cov_208.708955	288	350	254	1	62	0.0161290
NODE_41070_length_501_cov_208.708955	288	350	260	1	62	0.0161290
NODE_41070_length_501_cov_208.708955	288	350	262	1	62	0.0161290
NODE_41070_length_501_cov_208.708955	288	350	266	2	62	0.0322581
NODE_41070_length_501_cov_208.708955	288	350	268	1	62	0.0161290
NODE_41070_length_501_cov_208.708955	288	350	270	1	62	0.0161290
NODE_41070_length_501_cov_208.708955	288	350	271	2	62	0.0322581
NODE_41070_length_501_cov_208.708955	288	350	281	1	62	0.0161290
NODE_41070_length_501_cov_208.708955	288	350	323	1	62	0.0161290
NODE_41070_length_501_cov_208.708955	288	350	328	1	62	0.0161290
NODE_41070_length_501_cov_208.708955	288	350	351	1	62	0.0161290
NODE_41070_length_501_cov_208.708955	288	350	354	1	62	0.0161290
NODE_41070_length_501_cov_208.708955	288	350	355	1	62	0.0161290
NODE_41070_length_501_cov_208.708955	288	350	357	1	62	0.0161290
NODE_41070_length_501_cov_208.708955	288	350	358	3	62	0.0483871
NODE_41070_length_501_cov_208.708955	288	350	359	1	62	0.0161290
NODE_41070_length_501_cov_208.708955	288	350	360	1	62	0.0161290
NODE_41070_length_501_cov_208.708955	288	350	361	1	62	0.0161290
NODE_41070_length_501_cov_208.708955	288	350	366	1	62	0.0161290
NODE_41070_length_501_cov_208.708955	288	350	396	1	62	0.0161290
NODE_41070_length_501_cov_208.708955	288	350	402	1	62	0.0161290
NODE_41070_length_501_cov_208.708955	288	350	408	2	62	0.0322581
NODE_41070_length_501_cov_208.708955	288	350	410	1	62	0.0161290
NODE_41070_length_501_cov_208.708955	288	350	412	1	62	0.0161290
NODE_41070_length_501_cov_208.708955	288	350	417	3	62	0.0483871
NODE_41070_length_501_cov_208.708955	288	350	423	1	62	0.0161290
NODE_41070_length_501_cov_208.708955	288	350	425	1	62	0.0161290
NODE_41070_length_501_cov_208.708955	288	350	433	3	62	0.0483871
NODE_41070_length_501_cov_208.708955	288	350	438	1	62	0.0161290
NODE_41070_length_501_cov_208.708955	288	350	439	2	62	0.0322581
NODE_41070_length_501_cov_208.708955	288	350	445	1	62	0.0161290
NODE_41070_length_501_cov_208.708955	288	350	447	1	62	0.0161290
NODE_41070_length_501_cov_208.708955	288	350	457	1	62	0.0161290
NODE_41070_length_501_cov_208.708955	288	350	458	1	62	0.0161290
NODE_41070_length_501_cov_208.708955	288	350	459	1	62	0.0161290
NODE_41070_length_501_cov_208.708955	288	350	460	4	62	0.0645161
NODE_41070_length_501_cov_208.708955	288	350	461	2	62	0.0322581
NODE_41070_length_501_cov_208.708955	288	350	462	1	62	0.0161290
NODE_41070_length_501_cov_208.708955	288	350	465	1	62	0.0161290
NODE_41070_length_501_cov_208.708955	288	350	472	2	62	0.0322581
NODE_41070_length_501_cov_208.708955	288	350	475	2	62	0.0322581
NODE_41070_length_501_cov_208.708955	288	350	477	2	62	0.0322581
NODE_41070_length_501_cov_208.708955	288	350	479	3	62	0.0483871
NODE_41070_length_501_cov_208.708955	327	413	144	1	86	0.0116279
NODE_41070_length_501_cov_208.708955	327	413	146	1	86	0.0116279
NODE_41070_length_501_cov_208.708955	327	413	149	2	86	0.0232558
NODE_41070_length_501_cov_208.708955	327	413	154	1	86	0.0116279
NODE_41070_length_501_cov_208.708955	327	413	167	1	86	0.0116279
NODE_41070_length_501_cov_208.708955	327	413	188	1	86	0.0116279
NODE_41070_length_501_cov_208.708955	327	413	221	1	86	0.0116279
NODE_41070_length_501_cov_208.708955	327	413	236	1	86	0.0116279
NODE_41070_length_501_cov_208.708955	327	413	240	1	86	0.0116279
NODE_41070_length_501_cov_208.708955	327	413	244	1	86	0.0116279
NODE_41070_length_501_cov_208.708955	327	413	248	1	86	0.0116279
NODE_41070_length_501_cov_208.708955	327	413	251	1	86	0.0116279
NODE_41070_length_501_cov_208.708955	327	413	279	2	86	0.0232558
NODE_41070_length_501_cov_208.708955	327	413	299	1	86	0.0116279
NODE_41070_length_501_cov_208.708955	327	413	301	1	86	0.0116279
NODE_41070_length_501_cov_208.708955	327	413	317	1	86	0.0116279
NODE_41070_length_501_cov_208.708955	327	413	318	1	86	0.0116279
NODE_41070_length_501_cov_208.708955	327	413	321	1	86	0.0116279
NODE_41070_length_501_cov_208.708955	327	413	325	1	86	0.0116279
NODE_41070_length_501_cov_208.708955	327	413	343	1	86	0.0116279
NODE_41070_length_501_cov_208.708955	327	413	347	2	86	0.0232558
NODE_41070_length_501_cov_208.708955	327	413	349	2	86	0.0232558
NODE_41070_length_501_cov_208.708955	327	413	379	1	86	0.0116279
NODE_41070_length_501_cov_208.708955	327	413	380	1	86	0.0116279
NODE_41070_length_501_cov_208.708955	327	413	383	4	86	0.0465116
NODE_41070_length_501_cov_208.708955	327	413	385	2	86	0.0232558
NODE_41070_length_501_cov_208.708955	327	413	389	1	86	0.0116279
NODE_41070_length_501_cov_208.708955	327	413	394	1	86	0.0116279
NODE_41070_length_501_cov_208.708955	327	413	396	1	86	0.0116279
NODE_41070_length_501_cov_208.708955	327	413	397	1	86	0.0116279
NODE_41070_length_501_cov_208.708955	327	413	398	1	86	0.0116279
NODE_41070_length_501_cov_208.708955	327	413	406	2	86	0.0232558
NODE_41070_length_501_cov_208.708955	327	413	420	1	86	0.0116279
NODE_41070_length_501_cov_208.708955	327	413	424	1	86	0.0116279
NODE_41070_length_501_cov_208.708955	327	413	435	4	86	0.0465116
NODE_41070_length_501_cov_208.708955	327	413	436	1	86	0.0116279
NODE_41070_length_501_cov_208.708955	327	413	437	1	86	0.0116279
NODE_41070_length_501_cov_208.708955	327	413	438	1	86	0.0116279
NODE_41070_length_501_cov_208.708955	327	413	445	2	86	0.0232558
NODE_41070_length_501_cov_208.708955	327	413	447	1	86	0.0116279
NODE_41070_length_501_cov_208.708955	327	413	457	1	86	0.0116279
NODE_41070_length_501_cov_208.708955	327	413	458	1	86	0.0116279
NODE_41070_length_501_cov_208.708955	327	413	459	4	86	0.0465116
NODE_41070_length_501_cov_208.708955	327	413	460	4	86	0.0465116
NODE_41070_length_501_cov_208.708955	327	413	461	3	86	0.0348837
NODE_41070_length_501_cov_208.708955	327	413	462	2	86	0.0232558
NODE_41070_length_501_cov_208.708955	327	413	463	1	86	0.0116279
NODE_41070_length_501_cov_208.708955	327	413	464	1	86	0.0116279
NODE_41070_length_501_cov_208.708955	327	413	465	1	86	0.0116279
NODE_41070_length_501_cov_208.708955	327	413	466	1	86	0.0116279
NODE_41070_length_501_cov_208.708955	327	413	470	1	86	0.0116279
NODE_41070_length_501_cov_208.708955	327	413	472	3	86	0.0348837
NODE_41070_length_501_cov_208.708955	327	413	474	1	86	0.0116279
NODE_41070_length_501_cov_208.708955	327	413	475	2	86	0.0232558
NODE_41070_length_501_cov_208.708955	327	413	477	4	86	0.0465116
NODE_41070_length_501_cov_208.708955	327	413	479	3	86	0.0348837
NODE_41071_length_501_cov_29.126866	23	103	0	80	80	1.0000000
NODE_41071_length_501_cov_29.126866	76	156	0	80	80	1.0000000
NODE_41072_length_501_cov_23.736318	85	165	0	43	80	0.5375000
NODE_41072_length_501_cov_23.736318	85	165	6	37	80	0.4625000
NODE_41072_length_501_cov_23.736318	138	218	0	3	80	0.0375000
NODE_41072_length_501_cov_23.736318	138	218	6	77	80	0.9625000
NODE_41075_length_501_cov_7.820896	270	350	0	56	80	0.7000000
NODE_41075_length_501_cov_7.820896	270	350	2	24	80	0.3000000
NODE_41075_length_501_cov_7.820896	323	403	0	3	80	0.0375000
NODE_41075_length_501_cov_7.820896	323	403	2	58	80	0.7250000
NODE_41075_length_501_cov_7.820896	323	403	4	19	80	0.2375000
NODE_41080_length_501_cov_6.437811	309	389	2	53	80	0.6625000
NODE_41080_length_501_cov_6.437811	309	389	4	27	80	0.3375000
NODE_41097_length_501_cov_3.656716	289	312	0	23	23	1.0000000
NODE_41097_length_501_cov_3.656716	355	420	0	65	65	1.0000000
NODE_41103_length_501_cov_3.477612	329	409	6	4	80	0.0500000
NODE_41103_length_501_cov_3.477612	329	409	8	17	80	0.2125000
NODE_41103_length_501_cov_3.477612	329	409	10	59	80	0.7375000
NODE_41109_length_501_cov_3.134328	266	345	2	69	79	0.8734177
NODE_41109_length_501_cov_3.134328	266	345	4	10	79	0.1265823
NODE_41308_length_500_cov_77.895262	456	500	0	44	44	1.0000000
NODE_41309_length_500_cov_35.805486	326	406	0	80	80	1.0000000
NODE_41309_length_500_cov_35.805486	379	459	0	80	80	1.0000000
NODE_41310_length_500_cov_13.084788	160	221	24	8	61	0.1311475
NODE_41310_length_500_cov_13.084788	160	221	26	53	61	0.8688524
NODE_41311_length_500_cov_12.650873	215	295	0	80	80	1.0000000
NODE_41311_length_500_cov_12.650873	268	348	0	80	80	1.0000000
NODE_41312_length_500_cov_12.009975	203	268	6	13	65	0.2000000
NODE_41312_length_500_cov_12.009975	203	268	10	6	65	0.0923077
NODE_41312_length_500_cov_12.009975	203	268	12	46	65	0.7076923
NODE_41312_length_500_cov_12.009975	241	321	4	6	80	0.0750000
NODE_41312_length_500_cov_12.009975	241	321	10	44	80	0.5500000
NODE_41312_length_500_cov_12.009975	241	321	12	30	80	0.3750000
NODE_41325_length_500_cov_4.653367	224	295	0	71	71	1.0000000
NODE_41415_length_500_cov_1.650873	355	435	0	12	80	0.1500000
NODE_41415_length_500_cov_1.650873	355	435	2	41	80	0.5125000
NODE_41415_length_500_cov_1.650873	355	435	4	27	80	0.3375000
NODE_41415_length_500_cov_1.650873	408	488	2	63	80	0.7875000
NODE_41415_length_500_cov_1.650873	408	488	4	17	80	0.2125000
NODE_41462_length_500_cov_1.231920	169	212	2	2	43	0.0465116
NODE_41462_length_500_cov_1.231920	169	212	4	2	43	0.0465116
NODE_41462_length_500_cov_1.231920	169	212	5	1	43	0.0232558
NODE_41462_length_500_cov_1.231920	169	212	6	38	43	0.8837209
NODE_41542_length_499_cov_358.730000	425	492	13	1	67	0.0149254
NODE_41542_length_499_cov_358.730000	425	492	16	1	67	0.0149254
NODE_41542_length_499_cov_358.730000	425	492	24	1	67	0.0149254
NODE_41542_length_499_cov_358.730000	425	492	33	1	67	0.0149254
NODE_41542_length_499_cov_358.730000	425	492	35	2	67	0.0298507
NODE_41542_length_499_cov_358.730000	425	492	39	1	67	0.0149254
NODE_41542_length_499_cov_358.730000	425	492	40	1	67	0.0149254
NODE_41542_length_499_cov_358.730000	425	492	42	1	67	0.0149254
NODE_41542_length_499_cov_358.730000	425	492	49	1	67	0.0149254
NODE_41542_length_499_cov_358.730000	425	492	57	2	67	0.0298507
NODE_41542_length_499_cov_358.730000	425	492	59	1	67	0.0149254
NODE_41542_length_499_cov_358.730000	425	492	61	2	67	0.0298507
NODE_41542_length_499_cov_358.730000	425	492	63	4	67	0.0597015
NODE_41542_length_499_cov_358.730000	425	492	68	1	67	0.0149254
NODE_41542_length_499_cov_358.730000	425	492	70	1	67	0.0149254
NODE_41542_length_499_cov_358.730000	425	492	72	1	67	0.0149254
NODE_41542_length_499_cov_358.730000	425	492	74	1	67	0.0149254
NODE_41542_length_499_cov_358.730000	425	492	76	2	67	0.0298507
NODE_41542_length_499_cov_358.730000	425	492	79	1	67	0.0149254
NODE_41542_length_499_cov_358.730000	425	492	81	1	67	0.0149254
NODE_41542_length_499_cov_358.730000	425	492	82	1	67	0.0149254
NODE_41542_length_499_cov_358.730000	425	492	84	8	67	0.1194030
NODE_41542_length_499_cov_358.730000	425	492	86	1	67	0.0149254
NODE_41542_length_499_cov_358.730000	425	492	92	1	67	0.0149254
NODE_41542_length_499_cov_358.730000	425	492	94	2	67	0.0298507
NODE_41542_length_499_cov_358.730000	425	492	100	1	67	0.0149254
NODE_41542_length_499_cov_358.730000	425	492	102	1	67	0.0149254
NODE_41542_length_499_cov_358.730000	425	492	104	5	67	0.0746269
NODE_41542_length_499_cov_358.730000	425	492	108	2	67	0.0298507
NODE_41542_length_499_cov_358.730000	425	492	110	1	67	0.0149254
NODE_41542_length_499_cov_358.730000	425	492	114	4	67	0.0597015
NODE_41542_length_499_cov_358.730000	425	492	118	8	67	0.1194030
NODE_41542_length_499_cov_358.730000	425	492	119	1	67	0.0149254
NODE_41542_length_499_cov_358.730000	425	492	121	1	67	0.0149254
NODE_41542_length_499_cov_358.730000	425	492	123	3	67	0.0447761
NODE_41543_length_499_cov_21.135000	52	132	0	80	80	1.0000000
NODE_41543_length_499_cov_21.135000	105	185	0	80	80	1.0000000
NODE_41544_length_499_cov_11.917500	50	130	0	7	80	0.0875000
NODE_41544_length_499_cov_11.917500	50	130	2	73	80	0.9125000
NODE_41544_length_499_cov_11.917500	103	183	2	47	80	0.5875000
NODE_41544_length_499_cov_11.917500	103	183	4	33	80	0.4125000
NODE_41549_length_499_cov_5.007500	0	54	0	54	54	1.0000000
NODE_41563_length_499_cov_3.482500	307	336	18	1	29	0.0344828
NODE_41563_length_499_cov_3.482500	307	336	20	5	29	0.1724138
NODE_41563_length_499_cov_3.482500	307	336	24	23	29	0.7931035
NODE_41594_length_499_cov_2.420000	198	247	2	37	49	0.7551020
NODE_41594_length_499_cov_2.420000	198	247	4	10	49	0.2040816
NODE_41594_length_499_cov_2.420000	198	247	8	2	49	0.0408163
NODE_41662_length_499_cov_1.445000	311	372	0	29	61	0.4754098
NODE_41662_length_499_cov_1.445000	311	372	2	32	61	0.5245901
NODE_41770_length_498_cov_31.704261	12	92	0	80	80	1.0000000
NODE_41770_length_498_cov_31.704261	65	145	0	80	80	1.0000000
NODE_41775_length_498_cov_7.002506	256	336	2	80	80	1.0000000
NODE_41780_length_498_cov_5.759398	217	247	0	30	30	1.0000000
NODE_41814_length_498_cov_3.075188	225	262	6	23	37	0.6216216
NODE_41814_length_498_cov_3.075188	225	262	13	1	37	0.0270270
NODE_41814_length_498_cov_3.075188	225	262	14	9	37	0.2432432
NODE_41814_length_498_cov_3.075188	225	262	20	4	37	0.1081081
NODE_41814_length_498_cov_3.075188	246	324	6	2	78	0.0256410
NODE_41814_length_498_cov_3.075188	246	324	13	1	78	0.0128205
NODE_41814_length_498_cov_3.075188	246	324	14	9	78	0.1153846
NODE_41814_length_498_cov_3.075188	246	324	20	5	78	0.0641026
NODE_41814_length_498_cov_3.075188	246	324	24	1	78	0.0128205
NODE_41814_length_498_cov_3.075188	246	324	26	1	78	0.0128205
NODE_41814_length_498_cov_3.075188	246	324	28	4	78	0.0512821
NODE_41814_length_498_cov_3.075188	246	324	30	18	78	0.2307692
NODE_41814_length_498_cov_3.075188	246	324	32	33	78	0.4230769
NODE_41814_length_498_cov_3.075188	246	324	34	4	78	0.0512821
NODE_42016_length_497_cov_44.105528	169	249	2	15	80	0.1875000
NODE_42016_length_497_cov_44.105528	169	249	4	42	80	0.5250000
NODE_42016_length_497_cov_44.105528	169	249	6	23	80	0.2875000
NODE_42016_length_497_cov_44.105528	222	302	0	3	80	0.0375000
NODE_42016_length_497_cov_44.105528	222	302	2	65	80	0.8125000
NODE_42016_length_497_cov_44.105528	222	302	4	12	80	0.1500000
NODE_42017_length_497_cov_10.145729	85	165	6	80	80	1.0000000
NODE_42017_length_497_cov_10.145729	138	226	0	23	88	0.2613636
NODE_42017_length_497_cov_10.145729	138	226	4	25	88	0.2840909
NODE_42017_length_497_cov_10.145729	138	226	6	40	88	0.4545455
NODE_42024_length_497_cov_6.618090	231	304	2	9	73	0.1232877
NODE_42024_length_497_cov_6.618090	231	304	4	13	73	0.1780822
NODE_42024_length_497_cov_6.618090	231	304	6	51	73	0.6986302
NODE_42024_length_497_cov_6.618090	284	364	0	14	80	0.1750000
NODE_42024_length_497_cov_6.618090	284	364	2	55	80	0.6875000
NODE_42024_length_497_cov_6.618090	284	364	6	11	80	0.1375000
NODE_42065_length_497_cov_2.889447	109	189	0	23	80	0.2875000
NODE_42065_length_497_cov_2.889447	109	189	2	4	80	0.0500000
NODE_42065_length_497_cov_2.889447	109	189	4	13	80	0.1625000
NODE_42065_length_497_cov_2.889447	109	189	7	21	80	0.2625000
NODE_42065_length_497_cov_2.889447	109	189	9	19	80	0.2375000
NODE_42065_length_497_cov_2.889447	162	242	7	8	80	0.1000000
NODE_42065_length_497_cov_2.889447	162	242	8	22	80	0.2750000
NODE_42065_length_497_cov_2.889447	162	242	9	22	80	0.2750000
NODE_42065_length_497_cov_2.889447	162	242	10	28	80	0.3500000
NODE_42071_length_497_cov_2.623116	302	368	1	1	66	0.0151515
NODE_42071_length_497_cov_2.623116	302	368	2	11	66	0.1666667
NODE_42071_length_497_cov_2.623116	302	368	6	17	66	0.2575758
NODE_42071_length_497_cov_2.623116	302	368	8	37	66	0.5606061
NODE_42071_length_497_cov_2.623116	355	406	3	14	51	0.2745098
NODE_42071_length_497_cov_2.623116	355	406	5	3	51	0.0588235
NODE_42071_length_497_cov_2.623116	355	406	6	7	51	0.1372549
NODE_42071_length_497_cov_2.623116	355	406	8	27	51	0.5294118
NODE_42100_length_497_cov_1.909548	106	186	21	2	80	0.0250000
NODE_42100_length_497_cov_1.909548	106	186	27	5	80	0.0625000
NODE_42100_length_497_cov_1.909548	106	186	28	13	80	0.1625000
NODE_42100_length_497_cov_1.909548	106	186	30	18	80	0.2250000
NODE_42100_length_497_cov_1.909548	106	186	31	10	80	0.1250000
NODE_42100_length_497_cov_1.909548	106	186	33	7	80	0.0875000
NODE_42100_length_497_cov_1.909548	106	186	34	1	80	0.0125000
NODE_42100_length_497_cov_1.909548	106	186	36	4	80	0.0500000
NODE_42100_length_497_cov_1.909548	106	186	38	20	80	0.2500000
NODE_42100_length_497_cov_1.909548	159	240	14	4	81	0.0493827
NODE_42100_length_497_cov_1.909548	159	240	16	2	81	0.0246914
NODE_42100_length_497_cov_1.909548	159	240	18	1	81	0.0123457
NODE_42100_length_497_cov_1.909548	159	240	22	3	81	0.0370370
NODE_42100_length_497_cov_1.909548	159	240	24	3	81	0.0370370
NODE_42100_length_497_cov_1.909548	159	240	26	1	81	0.0123457
NODE_42100_length_497_cov_1.909548	159	240	28	1	81	0.0123457
NODE_42100_length_497_cov_1.909548	159	240	30	3	81	0.0370370
NODE_42100_length_497_cov_1.909548	159	240	32	3	81	0.0370370
NODE_42100_length_497_cov_1.909548	159	240	33	2	81	0.0246914
NODE_42100_length_497_cov_1.909548	159	240	34	6	81	0.0740741
NODE_42100_length_497_cov_1.909548	159	240	36	5	81	0.0617284
NODE_42100_length_497_cov_1.909548	159	240	38	27	81	0.3333333
NODE_42100_length_497_cov_1.909548	159	240	40	1	81	0.0123457
NODE_42100_length_497_cov_1.909548	159	240	44	1	81	0.0123457
NODE_42100_length_497_cov_1.909548	159	240	46	14	81	0.1728395
NODE_42100_length_497_cov_1.909548	159	240	48	4	81	0.0493827
NODE_42100_length_497_cov_1.909548	262	324	8	3	62	0.0483871
NODE_42100_length_497_cov_1.909548	262	324	14	4	62	0.0645161
NODE_42100_length_497_cov_1.909548	262	324	16	2	62	0.0322581
NODE_42100_length_497_cov_1.909548	262	324	18	2	62	0.0322581
NODE_42100_length_497_cov_1.909548	262	324	24	2	62	0.0322581
NODE_42100_length_497_cov_1.909548	262	324	29	1	62	0.0161290
NODE_42100_length_497_cov_1.909548	262	324	31	1	62	0.0161290
NODE_42100_length_497_cov_1.909548	262	324	37	1	62	0.0161290
NODE_42100_length_497_cov_1.909548	262	324	39	8	62	0.1290323
NODE_42100_length_497_cov_1.909548	262	324	41	1	62	0.0161290
NODE_42100_length_497_cov_1.909548	262	324	43	1	62	0.0161290
NODE_42100_length_497_cov_1.909548	262	324	44	9	62	0.1451613
NODE_42100_length_497_cov_1.909548	262	324	45	4	62	0.0645161
NODE_42100_length_497_cov_1.909548	262	324	46	23	62	0.3709677
NODE_42131_length_497_cov_1.500000	259	339	0	70	80	0.8750000
NODE_42131_length_497_cov_1.500000	259	339	2	10	80	0.1250000
NODE_42136_length_497_cov_1.404523	211	263	0	52	52	1.0000000
NODE_42279_length_496_cov_5.619647	239	269	4	1	30	0.0333333
NODE_42279_length_496_cov_5.619647	239	269	5	16	30	0.5333334
NODE_42279_length_496_cov_5.619647	239	269	6	13	30	0.4333333
NODE_42281_length_496_cov_5.392947	103	168	0	65	65	1.0000000
NODE_42281_length_496_cov_5.392947	141	221	0	80	80	1.0000000
NODE_42281_length_496_cov_5.392947	217	295	0	78	78	1.0000000
NODE_42281_length_496_cov_5.392947	270	295	0	25	25	1.0000000
NODE_42287_length_496_cov_4.397985	388	467	0	79	79	1.0000000
NODE_42288_length_496_cov_4.193955	235	315	2	13	80	0.1625000
NODE_42288_length_496_cov_4.193955	235	315	4	67	80	0.8375000
NODE_42297_length_496_cov_3.531486	192	273	6	30	81	0.3703704
NODE_42297_length_496_cov_3.531486	192	273	8	46	81	0.5679013
NODE_42297_length_496_cov_3.531486	192	273	10	5	81	0.0617284
NODE_42297_length_496_cov_3.531486	245	325	6	80	80	1.0000000
NODE_42298_length_496_cov_3.377834	252	332	0	80	80	1.0000000
NODE_42298_length_496_cov_3.377834	305	383	0	78	78	1.0000000
NODE_42316_length_496_cov_2.659950	203	251	0	48	48	1.0000000
NODE_42328_length_496_cov_2.445844	95	165	0	70	70	1.0000000
NODE_42328_length_496_cov_2.445844	148	228	0	80	80	1.0000000
NODE_42333_length_496_cov_2.214106	299	359	6	2	60	0.0333333
NODE_42333_length_496_cov_2.214106	299	359	8	19	60	0.3166667
NODE_42333_length_496_cov_2.214106	299	359	12	39	60	0.6500000
NODE_42415_length_496_cov_1.395466	273	317	0	11	44	0.2500000
NODE_42415_length_496_cov_1.395466	273	317	6	33	44	0.7500000
NODE_42461_length_496_cov_0.979849	214	294	0	24	80	0.3000000
NODE_42461_length_496_cov_0.979849	214	294	2	38	80	0.4750000
NODE_42461_length_496_cov_0.979849	214	294	5	18	80	0.2250000
NODE_42525_length_495_cov_34.888889	209	264	0	12	55	0.2181818
NODE_42525_length_495_cov_34.888889	209	264	2	1	55	0.0181818
NODE_42525_length_495_cov_34.888889	209	264	4	42	55	0.7636364
NODE_42526_length_495_cov_12.800505	268	348	0	80	80	1.0000000
NODE_42526_length_495_cov_12.800505	321	401	0	80	80	1.0000000
NODE_42529_length_495_cov_7.080808	386	416	2	30	30	1.0000000
NODE_42548_length_495_cov_3.868687	218	298	0	67	80	0.8375000
NODE_42548_length_495_cov_3.868687	218	298	2	13	80	0.1625000
NODE_42736_length_495_cov_0.792929	274	309	4	1	35	0.0285714
NODE_42736_length_495_cov_0.792929	274	309	6	34	35	0.9714286
NODE_42773_length_494_cov_20.096203	182	262	0	10	80	0.1250000
NODE_42773_length_494_cov_20.096203	182	262	4	1	80	0.0125000
NODE_42773_length_494_cov_20.096203	182	262	5	14	80	0.1750000
NODE_42773_length_494_cov_20.096203	182	262	7	11	80	0.1375000
NODE_42773_length_494_cov_20.096203	182	262	21	1	80	0.0125000
NODE_42773_length_494_cov_20.096203	182	262	23	8	80	0.1000000
NODE_42773_length_494_cov_20.096203	182	262	29	29	80	0.3625000
NODE_42773_length_494_cov_20.096203	182	262	31	1	80	0.0125000
NODE_42773_length_494_cov_20.096203	182	262	33	2	80	0.0250000
NODE_42773_length_494_cov_20.096203	182	262	35	3	80	0.0375000
NODE_42773_length_494_cov_20.096203	235	315	29	21	80	0.2625000
NODE_42773_length_494_cov_20.096203	235	315	31	1	80	0.0125000
NODE_42773_length_494_cov_20.096203	235	315	33	23	80	0.2875000
NODE_42773_length_494_cov_20.096203	235	315	34	3	80	0.0375000
NODE_42773_length_494_cov_20.096203	235	315	35	32	80	0.4000000
NODE_42778_length_494_cov_7.498734	187	240	2	32	53	0.6037736
NODE_42778_length_494_cov_7.498734	187	240	3	6	53	0.1132075
NODE_42778_length_494_cov_7.498734	187	240	4	15	53	0.2830189
NODE_42788_length_494_cov_4.283544	255	332	0	16	77	0.2077922
NODE_42788_length_494_cov_4.283544	255	332	4	61	77	0.7922078
NODE_42804_length_494_cov_3.496203	209	276	0	67	67	1.0000000
NODE_42812_length_494_cov_3.032911	385	432	0	10	47	0.2127660
NODE_42812_length_494_cov_3.032911	385	432	2	37	47	0.7872341
NODE_42816_length_494_cov_2.908861	189	269	4	6	80	0.0750000
NODE_42816_length_494_cov_2.908861	189	269	6	1	80	0.0125000
NODE_42816_length_494_cov_2.908861	189	269	10	3	80	0.0375000
NODE_42816_length_494_cov_2.908861	189	269	12	5	80	0.0625000
NODE_42816_length_494_cov_2.908861	189	269	14	65	80	0.8125000
NODE_42822_length_494_cov_2.777215	145	188	0	43	43	1.0000000
NODE_42834_length_494_cov_2.531646	371	430	2	59	59	1.0000000
NODE_42834_length_494_cov_2.531646	428	494	0	59	66	0.8939394
NODE_42834_length_494_cov_2.531646	428	494	2	7	66	0.1060606
NODE_43021_length_493_cov_34.946701	140	220	0	80	80	1.0000000
NODE_43021_length_493_cov_34.946701	193	265	0	72	72	1.0000000
NODE_43022_length_493_cov_12.451777	173	253	2	7	80	0.0875000
NODE_43022_length_493_cov_12.451777	173	253	4	73	80	0.9125000
NODE_43022_length_493_cov_12.451777	226	306	0	7	80	0.0875000
NODE_43022_length_493_cov_12.451777	226	306	2	22	80	0.2750000
NODE_43022_length_493_cov_12.451777	226	306	4	51	80	0.6375000
NODE_43025_length_493_cov_8.540609	116	146	0	5	30	0.1666667
NODE_43025_length_493_cov_8.540609	116	146	4	25	30	0.8333333
NODE_43025_length_493_cov_8.540609	119	199	0	2	80	0.0250000
NODE_43025_length_493_cov_8.540609	119	199	4	78	80	0.9750000
NODE_43031_length_493_cov_6.144670	300	380	0	80	80	1.0000000
NODE_43031_length_493_cov_6.144670	353	433	0	80	80	1.0000000
NODE_43046_length_493_cov_3.840102	178	258	0	80	80	1.0000000
NODE_43046_length_493_cov_3.840102	231	311	0	80	80	1.0000000
NODE_43125_length_493_cov_1.588832	126	206	0	80	80	1.0000000
NODE_43125_length_493_cov_1.588832	179	259	0	80	80	1.0000000
NODE_43261_length_492_cov_5.488550	117	197	0	80	80	1.0000000
NODE_43261_length_492_cov_5.488550	170	250	0	80	80	1.0000000
NODE_43270_length_492_cov_4.445293	158	234	4	7	76	0.0921053
NODE_43270_length_492_cov_4.445293	158	234	6	54	76	0.7105263
NODE_43270_length_492_cov_4.445293	158	234	10	15	76	0.1973684
NODE_43270_length_492_cov_4.445293	207	285	4	19	78	0.2435897
NODE_43270_length_492_cov_4.445293	207	285	6	58	78	0.7435898
NODE_43270_length_492_cov_4.445293	207	285	10	1	78	0.0128205
NODE_43273_length_492_cov_4.244275	272	315	0	15	43	0.3488372
NODE_43273_length_492_cov_4.244275	272	315	2	28	43	0.6511628
NODE_43293_length_492_cov_3.297710	113	193	0	7	80	0.0875000
NODE_43293_length_492_cov_3.297710	113	193	2	73	80	0.9125000
NODE_43528_length_491_cov_17.196429	138	218	0	80	80	1.0000000
NODE_43528_length_491_cov_17.196429	191	271	0	80	80	1.0000000
NODE_43529_length_491_cov_17.193878	77	157	0	80	80	1.0000000
NODE_43529_length_491_cov_17.193878	130	210	0	80	80	1.0000000
NODE_43535_length_491_cov_5.505102	215	284	4	12	69	0.1739130
NODE_43535_length_491_cov_5.505102	215	284	6	17	69	0.2463768
NODE_43535_length_491_cov_5.505102	215	284	8	40	69	0.5797101
NODE_43535_length_491_cov_5.505102	215	295	4	12	80	0.1500000
NODE_43535_length_491_cov_5.505102	215	295	6	28	80	0.3500000
NODE_43535_length_491_cov_5.505102	215	295	8	40	80	0.5000000
NODE_43535_length_491_cov_5.505102	268	348	4	5	80	0.0625000
NODE_43535_length_491_cov_5.505102	268	348	6	58	80	0.7250000
NODE_43535_length_491_cov_5.505102	268	348	8	17	80	0.2125000
NODE_43536_length_491_cov_5.477041	169	222	0	53	53	1.0000000
NODE_43546_length_491_cov_4.176020	383	449	3	13	66	0.1969697
NODE_43546_length_491_cov_4.176020	383	449	5	36	66	0.5454546
NODE_43546_length_491_cov_4.176020	383	449	6	17	66	0.2575758
NODE_43546_length_491_cov_4.176020	422	476	4	18	54	0.3333333
NODE_43546_length_491_cov_4.176020	422	476	5	10	54	0.1851852
NODE_43546_length_491_cov_4.176020	422	476	6	26	54	0.4814815
NODE_43570_length_491_cov_2.887755	348	428	0	80	80	1.0000000
NODE_43570_length_491_cov_2.887755	401	472	0	71	71	1.0000000
NODE_43575_length_491_cov_2.693878	239	316	0	24	77	0.3116883
NODE_43575_length_491_cov_2.693878	239	316	2	3	77	0.0389610
NODE_43575_length_491_cov_2.693878	239	316	4	50	77	0.6493506
NODE_43744_length_490_cov_10.058824	192	272	0	42	80	0.5250000
NODE_43744_length_490_cov_10.058824	192	272	2	2	80	0.0250000
NODE_43744_length_490_cov_10.058824	192	272	6	36	80	0.4500000
NODE_43744_length_490_cov_10.058824	245	325	6	43	80	0.5375000
NODE_43744_length_490_cov_10.058824	245	325	7	37	80	0.4625000
NODE_43748_length_490_cov_6.652174	304	363	0	59	59	1.0000000
NODE_43816_length_490_cov_2.212276	241	300	0	42	59	0.7118644
NODE_43816_length_490_cov_2.212276	241	300	2	17	59	0.2881356
NODE_43816_length_490_cov_2.212276	280	358	0	3	78	0.0384615
NODE_43816_length_490_cov_2.212276	280	358	2	75	78	0.9615384
NODE_43886_length_490_cov_1.360614	97	159	0	26	62	0.4193548
NODE_43886_length_490_cov_1.360614	97	159	2	12	62	0.1935484
NODE_43886_length_490_cov_1.360614	97	159	4	4	62	0.0645161
NODE_43886_length_490_cov_1.360614	97	159	6	7	62	0.1129032
NODE_43886_length_490_cov_1.360614	97	159	8	13	62	0.2096774
NODE_43886_length_490_cov_1.360614	132	212	2	3	80	0.0375000
NODE_43886_length_490_cov_1.360614	132	212	4	4	80	0.0500000
NODE_43886_length_490_cov_1.360614	132	212	6	7	80	0.0875000
NODE_43886_length_490_cov_1.360614	132	212	8	44	80	0.5500000
NODE_43886_length_490_cov_1.360614	132	212	9	6	80	0.0750000
NODE_43886_length_490_cov_1.360614	132	212	10	16	80	0.2000000
NODE_43993_length_489_cov_55.992308	50	130	0	80	80	1.0000000
NODE_43993_length_489_cov_55.992308	103	183	0	80	80	1.0000000
NODE_43993_length_489_cov_55.992308	179	259	0	80	80	1.0000000
NODE_43993_length_489_cov_55.992308	232	312	0	80	80	1.0000000
NODE_43994_length_489_cov_31.707692	299	384	0	75	85	0.8823529
NODE_43994_length_489_cov_31.707692	299	384	2	10	85	0.1176471
NODE_43994_length_489_cov_31.707692	299	384	0	75	85	0.8823529
NODE_43994_length_489_cov_31.707692	299	384	2	10	85	0.1176471
NODE_43996_length_489_cov_13.661538	227	307	8	3	80	0.0375000
NODE_43996_length_489_cov_13.661538	227	307	12	47	80	0.5875000
NODE_43996_length_489_cov_13.661538	227	307	14	5	80	0.0625000
NODE_43996_length_489_cov_13.661538	227	307	16	25	80	0.3125000
NODE_43996_length_489_cov_13.661538	280	358	2	18	78	0.2307692
NODE_43996_length_489_cov_13.661538	280	358	7	2	78	0.0256410
NODE_43996_length_489_cov_13.661538	280	358	11	1	78	0.0128205
NODE_43996_length_489_cov_13.661538	280	358	12	8	78	0.1025641
NODE_43996_length_489_cov_13.661538	280	358	14	9	78	0.1153846
NODE_43996_length_489_cov_13.661538	280	358	16	40	78	0.5128205
NODE_43997_length_489_cov_12.017949	214	294	0	80	80	1.0000000
NODE_43997_length_489_cov_12.017949	267	347	0	80	80	1.0000000
NODE_43998_length_489_cov_10.774359	262	304	0	40	42	0.9523810
NODE_43998_length_489_cov_10.774359	262	304	2	2	42	0.0476190
NODE_44001_length_489_cov_8.094872	141	221	2	54	80	0.6750000
NODE_44001_length_489_cov_8.094872	141	221	4	26	80	0.3250000
NODE_44001_length_489_cov_8.094872	194	247	2	53	53	1.0000000
NODE_44007_length_489_cov_5.284615	176	256	2	18	80	0.2250000
NODE_44007_length_489_cov_5.284615	176	256	5	42	80	0.5250000
NODE_44007_length_489_cov_5.284615	176	256	6	20	80	0.2500000
NODE_44007_length_489_cov_5.284615	229	309	0	20	80	0.2500000
NODE_44007_length_489_cov_5.284615	229	309	5	9	80	0.1125000
NODE_44007_length_489_cov_5.284615	229	309	6	51	80	0.6375000
NODE_44096_length_489_cov_1.646154	234	278	0	44	44	1.0000000
NODE_44105_length_489_cov_1.574359	351	391	0	40	40	1.0000000
NODE_44105_length_489_cov_1.574359	351	383	0	32	32	1.0000000
NODE_44105_length_489_cov_1.574359	365	445	0	80	80	1.0000000
NODE_44105_length_489_cov_1.574359	365	445	0	80	80	1.0000000
NODE_44105_length_489_cov_1.574359	366	445	0	79	79	1.0000000
NODE_44231_length_488_cov_15.406170	235	313	0	50	78	0.6410257
NODE_44231_length_488_cov_15.406170	235	313	2	28	78	0.3589744
NODE_44231_length_488_cov_15.406170	286	367	2	81	81	1.0000000
NODE_44234_length_488_cov_8.416452	210	290	0	80	80	1.0000000
NODE_44234_length_488_cov_8.416452	263	343	0	80	80	1.0000000
NODE_44240_length_488_cov_6.084833	254	302	10	48	48	1.0000000
NODE_44243_length_488_cov_5.434447	210	279	0	69	69	1.0000000
NODE_44243_length_488_cov_5.434447	265	300	0	35	35	1.0000000
NODE_44263_length_488_cov_3.431877	212	248	2	36	36	1.0000000
NODE_44264_length_488_cov_3.424165	320	367	0	27	47	0.5744681
NODE_44264_length_488_cov_3.424165	320	367	7	12	47	0.2553191
NODE_44264_length_488_cov_3.424165	320	367	8	8	47	0.1702128
NODE_44264_length_488_cov_3.424165	320	378	0	27	58	0.4655173
NODE_44264_length_488_cov_3.424165	320	378	7	12	58	0.2068966
NODE_44264_length_488_cov_3.424165	320	378	8	19	58	0.3275862
NODE_44264_length_488_cov_3.424165	351	393	7	8	42	0.1904762
NODE_44264_length_488_cov_3.424165	351	393	8	34	42	0.8095238
NODE_44264_length_488_cov_3.424165	360	395	8	35	35	1.0000000
NODE_44274_length_488_cov_2.850900	276	356	0	20	80	0.2500000
NODE_44274_length_488_cov_2.850900	276	356	2	60	80	0.7500000
NODE_44376_length_488_cov_1.562982	31	67	0	36	36	1.0000000
NODE_44496_length_487_cov_7.028351	278	358	15	1	80	0.0125000
NODE_44496_length_487_cov_7.028351	278	358	18	5	80	0.0625000
NODE_44496_length_487_cov_7.028351	278	358	22	13	80	0.1625000
NODE_44496_length_487_cov_7.028351	278	358	25	14	80	0.1750000
NODE_44496_length_487_cov_7.028351	278	358	26	47	80	0.5875000
NODE_44498_length_487_cov_6.804124	242	313	0	35	71	0.4929577
NODE_44498_length_487_cov_6.804124	242	313	2	36	71	0.5070422
NODE_44498_length_487_cov_6.804124	286	366	0	80	80	1.0000000
NODE_44500_length_487_cov_5.917526	140	220	0	80	80	1.0000000
NODE_44500_length_487_cov_5.917526	193	273	0	37	80	0.4625000
NODE_44500_length_487_cov_5.917526	193	273	2	43	80	0.5375000
NODE_44520_length_487_cov_3.296392	235	315	8	20	80	0.2500000
NODE_44520_length_487_cov_3.296392	235	315	10	21	80	0.2625000
NODE_44520_length_487_cov_3.296392	235	315	12	7	80	0.0875000
NODE_44520_length_487_cov_3.296392	235	315	14	1	80	0.0125000
NODE_44520_length_487_cov_3.296392	235	315	18	1	80	0.0125000
NODE_44520_length_487_cov_3.296392	235	315	22	4	80	0.0500000
NODE_44520_length_487_cov_3.296392	235	315	26	1	80	0.0125000
NODE_44520_length_487_cov_3.296392	235	315	30	15	80	0.1875000
NODE_44520_length_487_cov_3.296392	235	315	34	10	80	0.1250000
NODE_44521_length_487_cov_3.237113	301	363	0	62	62	1.0000000
NODE_44525_length_487_cov_3.074742	214	294	0	41	80	0.5125000
NODE_44525_length_487_cov_3.074742	214	294	2	21	80	0.2625000
NODE_44525_length_487_cov_3.074742	214	294	4	3	80	0.0375000
NODE_44525_length_487_cov_3.074742	214	294	8	7	80	0.0875000
NODE_44525_length_487_cov_3.074742	214	294	10	3	80	0.0375000
NODE_44525_length_487_cov_3.074742	214	294	12	5	80	0.0625000
NODE_44723_length_486_cov_6.609819	206	286	0	80	80	1.0000000
NODE_44728_length_486_cov_5.428941	147	227	0	12	80	0.1500000
NODE_44728_length_486_cov_5.428941	147	227	2	21	80	0.2625000
NODE_44728_length_486_cov_5.428941	147	227	8	7	80	0.0875000
NODE_44728_length_486_cov_5.428941	147	227	10	40	80	0.5000000
NODE_44754_length_486_cov_3.072351	131	211	0	80	80	1.0000000
NODE_44754_length_486_cov_3.072351	190	235	0	45	45	1.0000000
NODE_44769_length_486_cov_2.581395	156	236	0	80	80	1.0000000
NODE_44769_length_486_cov_2.581395	209	289	0	80	80	1.0000000
NODE_44781_length_486_cov_2.343669	189	230	0	41	41	1.0000000
NODE_44781_length_486_cov_2.343669	242	306	0	64	64	1.0000000
NODE_44959_length_485_cov_29.505181	270	350	0	80	80	1.0000000
NODE_44959_length_485_cov_29.505181	323	403	0	80	80	1.0000000
NODE_44959_length_485_cov_29.505181	399	479	0	80	80	1.0000000
NODE_44960_length_485_cov_10.450777	67	153	0	86	86	1.0000000
NODE_44960_length_485_cov_10.450777	133	206	0	73	73	1.0000000
NODE_44965_length_485_cov_5.922280	196	273	5	8	77	0.1038961
NODE_44965_length_485_cov_5.922280	196	273	6	7	77	0.0909091
NODE_44965_length_485_cov_5.922280	196	273	7	10	77	0.1298701
NODE_44965_length_485_cov_5.922280	196	273	8	6	77	0.0779221
NODE_44965_length_485_cov_5.922280	196	273	10	46	77	0.5974026
NODE_44965_length_485_cov_5.922280	246	326	0	40	80	0.5000000
NODE_44965_length_485_cov_5.922280	246	326	4	10	80	0.1250000
NODE_44965_length_485_cov_5.922280	246	326	5	11	80	0.1375000
NODE_44965_length_485_cov_5.922280	246	326	7	10	80	0.1250000
NODE_44965_length_485_cov_5.922280	246	326	8	6	80	0.0750000
NODE_44965_length_485_cov_5.922280	246	326	10	3	80	0.0375000
NODE_44966_length_485_cov_5.818653	279	359	4	80	80	1.0000000
NODE_44966_length_485_cov_5.818653	332	412	0	6	80	0.0750000
NODE_44966_length_485_cov_5.818653	332	412	4	74	80	0.9250000
NODE_44968_length_485_cov_5.670984	321	396	2	6	75	0.0800000
NODE_44968_length_485_cov_5.670984	321	396	6	32	75	0.4266667
NODE_44968_length_485_cov_5.670984	321	396	10	37	75	0.4933333
NODE_44992_length_485_cov_3.518135	162	210	4	48	48	1.0000000
NODE_45005_length_485_cov_2.790155	193	253	2	60	60	1.0000000
NODE_45021_length_485_cov_2.427461	170	249	0	79	79	1.0000000
NODE_45100_length_485_cov_1.264249	232	251	0	19	19	1.0000000
NODE_45193_length_484_cov_33.384416	92	172	0	7	80	0.0875000
NODE_45193_length_484_cov_33.384416	92	172	2	73	80	0.9125000
NODE_45193_length_484_cov_33.384416	145	225	0	14	80	0.1750000
NODE_45193_length_484_cov_33.384416	145	225	2	66	80	0.8250000
NODE_45195_length_484_cov_9.111688	136	216	0	26	80	0.3250000
NODE_45195_length_484_cov_9.111688	136	216	4	54	80	0.6750000
NODE_45195_length_484_cov_9.111688	189	270	0	29	81	0.3580247
NODE_45195_length_484_cov_9.111688	189	270	4	52	81	0.6419753
NODE_45196_length_484_cov_8.353247	165	244	0	79	79	1.0000000
NODE_45196_length_484_cov_8.353247	217	297	0	80	80	1.0000000
NODE_45197_length_484_cov_8.119481	108	188	0	6	80	0.0750000
NODE_45197_length_484_cov_8.119481	108	188	2	74	80	0.9250000
NODE_45197_length_484_cov_8.119481	161	241	0	59	80	0.7375000
NODE_45197_length_484_cov_8.119481	161	241	2	21	80	0.2625000
NODE_45200_length_484_cov_7.703896	208	288	0	13	80	0.1625000
NODE_45200_length_484_cov_7.703896	208	288	2	67	80	0.8375000
NODE_45200_length_484_cov_7.703896	261	341	0	15	80	0.1875000
NODE_45200_length_484_cov_7.703896	261	341	2	65	80	0.8125000
NODE_45202_length_484_cov_7.153247	230	292	0	62	62	1.0000000
NODE_45204_length_484_cov_6.594805	221	301	0	80	80	1.0000000
NODE_45204_length_484_cov_6.594805	274	354	0	70	80	0.8750000
NODE_45204_length_484_cov_6.594805	274	354	3	2	80	0.0250000
NODE_45204_length_484_cov_6.594805	274	354	4	8	80	0.1000000
NODE_45218_length_484_cov_4.044156	267	347	0	80	80	1.0000000
NODE_45218_length_484_cov_4.044156	342	396	0	27	54	0.5000000
NODE_45218_length_484_cov_4.044156	342	396	2	27	54	0.5000000
NODE_45225_length_484_cov_3.787013	287	331	0	44	44	1.0000000
NODE_45225_length_484_cov_3.787013	307	386	0	79	79	1.0000000
NODE_45225_length_484_cov_3.787013	317	386	0	69	69	1.0000000
NODE_45276_length_484_cov_2.254545	79	132	0	22	53	0.4150943
NODE_45276_length_484_cov_2.254545	79	132	2	31	53	0.5849057
NODE_45352_length_484_cov_1.322078	429	477	0	48	48	1.0000000
NODE_45353_length_484_cov_1.314286	431	472	2	41	41	1.0000000
NODE_45459_length_483_cov_40.815104	396	473	0	77	77	1.0000000
NODE_45459_length_483_cov_40.815104	396	473	0	77	77	1.0000000
NODE_45473_length_483_cov_5.289062	124	185	0	26	61	0.4262295
NODE_45473_length_483_cov_5.289062	124	185	2	35	61	0.5737705
NODE_45494_length_483_cov_4.114583	226	306	0	48	80	0.6000000
NODE_45494_length_483_cov_4.114583	226	306	2	32	80	0.4000000
NODE_45494_length_483_cov_4.114583	226	305	0	48	79	0.6075949
NODE_45494_length_483_cov_4.114583	226	305	2	31	79	0.3924051
NODE_45494_length_483_cov_4.114583	226	306	0	48	80	0.6000000
NODE_45494_length_483_cov_4.114583	226	306	2	32	80	0.4000000
NODE_45494_length_483_cov_4.114583	226	306	0	48	80	0.6000000
NODE_45494_length_483_cov_4.114583	226	306	2	32	80	0.4000000
NODE_45494_length_483_cov_4.114583	279	359	2	80	80	1.0000000
NODE_45494_length_483_cov_4.114583	279	325	2	46	46	1.0000000
NODE_45494_length_483_cov_4.114583	297	323	2	26	26	1.0000000
NODE_45495_length_483_cov_4.046875	68	117	0	43	49	0.8775510
NODE_45495_length_483_cov_4.046875	68	117	2	6	49	0.1224490
NODE_45495_length_483_cov_4.046875	184	250	0	66	66	1.0000000
NODE_45635_length_483_cov_1.205729	249	291	0	42	42	1.0000000
NODE_45725_length_482_cov_37.900783	72	152	0	15	80	0.1875000
NODE_45725_length_482_cov_37.900783	72	152	2	18	80	0.2250000
NODE_45725_length_482_cov_37.900783	72	152	5	5	80	0.0625000
NODE_45725_length_482_cov_37.900783	72	152	8	2	80	0.0250000
NODE_45725_length_482_cov_37.900783	72	152	9	40	80	0.5000000
NODE_45725_length_482_cov_37.900783	125	205	0	68	80	0.8500000
NODE_45725_length_482_cov_37.900783	125	205	2	12	80	0.1500000
NODE_45728_length_482_cov_10.545692	233	297	0	64	64	1.0000000
NODE_45729_length_482_cov_9.342037	281	333	0	24	52	0.4615385
NODE_45729_length_482_cov_9.342037	281	333	1	1	52	0.0192308
NODE_45729_length_482_cov_9.342037	281	333	2	27	52	0.5192308
NODE_45730_length_482_cov_8.190601	247	311	6	6	64	0.0937500
NODE_45730_length_482_cov_8.190601	247	311	8	19	64	0.2968750
NODE_45730_length_482_cov_8.190601	247	311	10	3	64	0.0468750
NODE_45730_length_482_cov_8.190601	247	311	12	36	64	0.5625000
NODE_45730_length_482_cov_8.190601	284	355	4	42	71	0.5915493
NODE_45730_length_482_cov_8.190601	284	355	6	8	71	0.1126761
NODE_45730_length_482_cov_8.190601	284	355	8	19	71	0.2676056
NODE_45730_length_482_cov_8.190601	284	355	10	2	71	0.0281690
NODE_45734_length_482_cov_6.002611	112	192	0	80	80	1.0000000
NODE_45734_length_482_cov_6.002611	165	245	0	80	80	1.0000000
NODE_45735_length_482_cov_5.953003	315	395	0	56	80	0.7000000
NODE_45735_length_482_cov_5.953003	315	395	2	24	80	0.3000000
NODE_45735_length_482_cov_5.953003	368	441	0	73	73	1.0000000
NODE_45748_length_482_cov_4.530026	20	85	0	65	65	1.0000000
NODE_45759_length_482_cov_3.791123	278	358	0	80	80	1.0000000
NODE_45759_length_482_cov_3.791123	331	411	0	80	80	1.0000000
NODE_45842_length_482_cov_1.647520	382	446	0	11	64	0.1718750
NODE_45842_length_482_cov_1.647520	382	446	2	2	64	0.0312500
NODE_45842_length_482_cov_1.647520	382	446	4	9	64	0.1406250
NODE_45842_length_482_cov_1.647520	382	446	6	42	64	0.6562500
NODE_45842_length_482_cov_1.647520	435	482	0	1	47	0.0212766
NODE_45842_length_482_cov_1.647520	435	482	4	8	47	0.1702128
NODE_45842_length_482_cov_1.647520	435	482	6	38	47	0.8085107
NODE_45994_length_481_cov_50.623037	154	234	1	37	80	0.4625000
NODE_45994_length_481_cov_50.623037	154	234	3	8	80	0.1000000
NODE_45994_length_481_cov_50.623037	154	234	5	10	80	0.1250000
NODE_45994_length_481_cov_50.623037	154	234	6	25	80	0.3125000
NODE_45994_length_481_cov_50.623037	207	287	5	2	80	0.0250000
NODE_45994_length_481_cov_50.623037	207	287	6	46	80	0.5750000
NODE_45994_length_481_cov_50.623037	207	287	8	4	80	0.0500000
NODE_45994_length_481_cov_50.623037	207	287	10	28	80	0.3500000
NODE_45995_length_481_cov_30.939791	149	198	0	49	49	1.0000000
NODE_45995_length_481_cov_30.939791	171	235	0	64	64	1.0000000
NODE_45995_length_481_cov_30.939791	171	235	0	64	64	1.0000000
NODE_45996_length_481_cov_30.183246	0	41	0	31	41	0.7560976
NODE_45996_length_481_cov_30.183246	0	41	2	10	41	0.2439024
NODE_45996_length_481_cov_30.183246	0	39	0	31	39	0.7948718
NODE_45996_length_481_cov_30.183246	0	39	2	8	39	0.2051282
NODE_45996_length_481_cov_30.183246	0	44	0	31	44	0.7045454
NODE_45996_length_481_cov_30.183246	0	44	2	13	44	0.2954545
NODE_45996_length_481_cov_30.183246	0	44	0	31	44	0.7045454
NODE_45996_length_481_cov_30.183246	0	44	2	13	44	0.2954545
NODE_45996_length_481_cov_30.183246	0	44	0	31	44	0.7045454
NODE_45996_length_481_cov_30.183246	0	44	2	13	44	0.2954545
NODE_45996_length_481_cov_30.183246	0	44	0	31	44	0.7045454
NODE_45996_length_481_cov_30.183246	0	44	2	13	44	0.2954545
NODE_45996_length_481_cov_30.183246	17	97	0	14	80	0.1750000
NODE_45996_length_481_cov_30.183246	17	97	2	66	80	0.8250000
NODE_45996_length_481_cov_30.183246	17	97	0	14	80	0.1750000
NODE_45996_length_481_cov_30.183246	17	97	2	66	80	0.8250000
NODE_45996_length_481_cov_30.183246	17	97	0	14	80	0.1750000
NODE_45996_length_481_cov_30.183246	17	97	2	66	80	0.8250000
NODE_45996_length_481_cov_30.183246	17	97	0	14	80	0.1750000
NODE_45996_length_481_cov_30.183246	17	97	2	66	80	0.8250000
NODE_45996_length_481_cov_30.183246	17	97	0	14	80	0.1750000
NODE_45996_length_481_cov_30.183246	17	97	2	66	80	0.8250000
NODE_45996_length_481_cov_30.183246	17	97	0	14	80	0.1750000
NODE_45996_length_481_cov_30.183246	17	97	2	66	80	0.8250000
NODE_45997_length_481_cov_12.709424	250	330	0	80	80	1.0000000
NODE_45997_length_481_cov_12.709424	303	383	0	80	80	1.0000000
NODE_46037_length_481_cov_3.002618	197	277	0	80	80	1.0000000
NODE_46064_length_481_cov_2.261780	271	351	2	2	80	0.0250000
NODE_46064_length_481_cov_2.261780	271	351	4	57	80	0.7125000
NODE_46064_length_481_cov_2.261780	271	351	6	21	80	0.2625000
NODE_46256_length_480_cov_22.346457	318	398	0	80	80	1.0000000
NODE_46256_length_480_cov_22.346457	371	451	0	80	80	1.0000000
NODE_46257_length_480_cov_16.488189	252	332	10	32	80	0.4000000
NODE_46257_length_480_cov_16.488189	252	332	13	1	80	0.0125000
NODE_46257_length_480_cov_16.488189	252	332	14	1	80	0.0125000
NODE_46257_length_480_cov_16.488189	252	332	16	46	80	0.5750000
NODE_46257_length_480_cov_16.488189	305	385	4	26	80	0.3250000
NODE_46257_length_480_cov_16.488189	305	385	6	19	80	0.2375000
NODE_46257_length_480_cov_16.488189	305	385	10	17	80	0.2125000
NODE_46257_length_480_cov_16.488189	305	385	16	18	80	0.2250000
NODE_46258_length_480_cov_12.874016	164	234	0	19	70	0.2714286
NODE_46258_length_480_cov_12.874016	164	234	2	50	70	0.7142857
NODE_46258_length_480_cov_12.874016	164	234	4	1	70	0.0142857
NODE_46258_length_480_cov_12.874016	207	273	0	13	66	0.1969697
NODE_46258_length_480_cov_12.874016	207	273	2	13	66	0.1969697
NODE_46258_length_480_cov_12.874016	207	273	4	40	66	0.6060606
NODE_46260_length_480_cov_11.879265	170	250	0	80	80	1.0000000
NODE_46260_length_480_cov_11.879265	223	303	0	80	80	1.0000000
NODE_46261_length_480_cov_8.774278	114	143	0	29	29	1.0000000
NODE_46261_length_480_cov_8.774278	165	245	0	10	80	0.1250000
NODE_46261_length_480_cov_8.774278	165	245	6	70	80	0.8750000
NODE_46261_length_480_cov_8.774278	218	298	2	14	80	0.1750000
NODE_46261_length_480_cov_8.774278	218	298	5	9	80	0.1125000
NODE_46261_length_480_cov_8.774278	218	298	6	38	80	0.4750000
NODE_46261_length_480_cov_8.774278	218	298	7	19	80	0.2375000
NODE_46261_length_480_cov_8.774278	385	428	0	10	43	0.2325581
NODE_46261_length_480_cov_8.774278	385	428	2	33	43	0.7674419
NODE_46271_length_480_cov_5.671916	231	302	4	45	71	0.6338028
NODE_46271_length_480_cov_5.671916	231	302	6	26	71	0.3661972
NODE_46283_length_480_cov_4.354331	126	187	0	1	61	0.0163934
NODE_46283_length_480_cov_4.354331	126	187	2	60	61	0.9836066
NODE_46283_length_480_cov_4.354331	218	298	0	50	80	0.6250000
NODE_46283_length_480_cov_4.354331	218	298	2	30	80	0.3750000
NODE_46445_length_480_cov_1.152231	142	216	0	63	74	0.8513514
NODE_46445_length_480_cov_1.152231	142	216	2	11	74	0.1486486
NODE_46470_length_480_cov_0.973753	31	71	0	40	40	1.0000000
NODE_46533_length_479_cov_28.205263	308	388	17	27	80	0.3375000
NODE_46533_length_479_cov_28.205263	308	388	19	4	80	0.0500000
NODE_46533_length_479_cov_28.205263	308	388	21	46	80	0.5750000
NODE_46533_length_479_cov_28.205263	308	388	23	3	80	0.0375000
NODE_46533_length_479_cov_28.205263	361	441	13	4	80	0.0500000
NODE_46533_length_479_cov_28.205263	361	441	15	15	80	0.1875000
NODE_46533_length_479_cov_28.205263	361	441	19	38	80	0.4750000
NODE_46533_length_479_cov_28.205263	361	441	21	23	80	0.2875000
NODE_46534_length_479_cov_23.944737	189	269	0	80	80	1.0000000
NODE_46534_length_479_cov_23.944737	242	322	0	80	80	1.0000000
NODE_46554_length_479_cov_4.942105	283	363	4	26	80	0.3250000
NODE_46554_length_479_cov_4.942105	283	363	8	8	80	0.1000000
NODE_46554_length_479_cov_4.942105	283	363	10	13	80	0.1625000
NODE_46554_length_479_cov_4.942105	283	363	11	13	80	0.1625000
NODE_46554_length_479_cov_4.942105	283	363	12	20	80	0.2500000
NODE_46554_length_479_cov_4.942105	336	416	6	14	80	0.1750000
NODE_46554_length_479_cov_4.942105	336	416	8	1	80	0.0125000
NODE_46554_length_479_cov_4.942105	336	416	10	51	80	0.6375000
NODE_46554_length_479_cov_4.942105	336	416	11	13	80	0.1625000
NODE_46554_length_479_cov_4.942105	336	416	12	1	80	0.0125000
NODE_46574_length_479_cov_3.494737	217	279	4	4	62	0.0645161
NODE_46574_length_479_cov_3.494737	217	279	6	36	62	0.5806451
NODE_46574_length_479_cov_3.494737	217	279	8	22	62	0.3548387
NODE_46574_length_479_cov_3.494737	272	332	2	32	60	0.5333334
NODE_46574_length_479_cov_3.494737	272	332	4	25	60	0.4166667
NODE_46574_length_479_cov_3.494737	272	332	6	3	60	0.0500000
NODE_46611_length_479_cov_2.281579	219	265	2	20	46	0.4347826
NODE_46611_length_479_cov_2.281579	219	265	8	6	46	0.1304348
NODE_46611_length_479_cov_2.281579	219	265	14	2	46	0.0434783
NODE_46611_length_479_cov_2.281579	219	265	16	12	46	0.2608696
NODE_46611_length_479_cov_2.281579	219	265	18	6	46	0.1304348
NODE_46638_length_479_cov_1.839474	376	431	6	2	55	0.0363636
NODE_46638_length_479_cov_1.839474	376	431	7	2	55	0.0363636
NODE_46638_length_479_cov_1.839474	376	431	9	11	55	0.2000000
NODE_46638_length_479_cov_1.839474	376	431	10	8	55	0.1454545
NODE_46638_length_479_cov_1.839474	376	431	11	4	55	0.0727273
NODE_46638_length_479_cov_1.839474	376	431	12	11	55	0.2000000
NODE_46638_length_479_cov_1.839474	376	431	14	17	55	0.3090909
NODE_46654_length_479_cov_1.710526	203	265	0	2	62	0.0322581
NODE_46654_length_479_cov_1.710526	203	265	2	60	62	0.9677419
NODE_46654_length_479_cov_1.710526	248	318	0	35	70	0.5000000
NODE_46654_length_479_cov_1.710526	248	318	1	1	70	0.0142857
NODE_46654_length_479_cov_1.710526	248	318	2	34	70	0.4857143
NODE_46828_length_478_cov_336.139842	153	233	167	2	80	0.0250000
NODE_46828_length_478_cov_336.139842	153	233	171	1	80	0.0125000
NODE_46828_length_478_cov_336.139842	153	233	175	1	80	0.0125000
NODE_46828_length_478_cov_336.139842	153	233	185	1	80	0.0125000
NODE_46828_length_478_cov_336.139842	153	233	187	1	80	0.0125000
NODE_46828_length_478_cov_336.139842	153	233	200	2	80	0.0250000
NODE_46828_length_478_cov_336.139842	153	233	202	1	80	0.0125000
NODE_46828_length_478_cov_336.139842	153	233	205	1	80	0.0125000
NODE_46828_length_478_cov_336.139842	153	233	211	1	80	0.0125000
NODE_46828_length_478_cov_336.139842	153	233	214	1	80	0.0125000
NODE_46828_length_478_cov_336.139842	153	233	232	2	80	0.0250000
NODE_46828_length_478_cov_336.139842	153	233	246	1	80	0.0125000
NODE_46828_length_478_cov_336.139842	153	233	249	1	80	0.0125000
NODE_46828_length_478_cov_336.139842	153	233	251	3	80	0.0375000
NODE_46828_length_478_cov_336.139842	153	233	252	3	80	0.0375000
NODE_46828_length_478_cov_336.139842	153	233	253	2	80	0.0250000
NODE_46828_length_478_cov_336.139842	153	233	254	2	80	0.0250000
NODE_46828_length_478_cov_336.139842	153	233	261	1	80	0.0125000
NODE_46828_length_478_cov_336.139842	153	233	264	1	80	0.0125000
NODE_46828_length_478_cov_336.139842	153	233	265	1	80	0.0125000
NODE_46828_length_478_cov_336.139842	153	233	266	1	80	0.0125000
NODE_46828_length_478_cov_336.139842	153	233	267	1	80	0.0125000
NODE_46828_length_478_cov_336.139842	153	233	269	2	80	0.0250000
NODE_46828_length_478_cov_336.139842	153	233	270	3	80	0.0375000
NODE_46828_length_478_cov_336.139842	153	233	271	2	80	0.0250000
NODE_46828_length_478_cov_336.139842	153	233	272	2	80	0.0250000
NODE_46828_length_478_cov_336.139842	153	233	276	1	80	0.0125000
NODE_46828_length_478_cov_336.139842	153	233	278	1	80	0.0125000
NODE_46828_length_478_cov_336.139842	153	233	294	1	80	0.0125000
NODE_46828_length_478_cov_336.139842	153	233	300	1	80	0.0125000
NODE_46828_length_478_cov_336.139842	153	233	304	1	80	0.0125000
NODE_46828_length_478_cov_336.139842	153	233	318	1	80	0.0125000
NODE_46828_length_478_cov_336.139842	153	233	322	1	80	0.0125000
NODE_46828_length_478_cov_336.139842	153	233	329	1	80	0.0125000
NODE_46828_length_478_cov_336.139842	153	233	332	1	80	0.0125000
NODE_46828_length_478_cov_336.139842	153	233	344	1	80	0.0125000
NODE_46828_length_478_cov_336.139842	153	233	352	1	80	0.0125000
NODE_46828_length_478_cov_336.139842	153	233	359	3	80	0.0375000
NODE_46828_length_478_cov_336.139842	153	233	360	2	80	0.0250000
NODE_46828_length_478_cov_336.139842	153	233	361	1	80	0.0125000
NODE_46828_length_478_cov_336.139842	153	233	363	2	80	0.0250000
NODE_46828_length_478_cov_336.139842	153	233	366	2	80	0.0250000
NODE_46828_length_478_cov_336.139842	153	233	368	1	80	0.0125000
NODE_46828_length_478_cov_336.139842	153	233	370	1	80	0.0125000
NODE_46828_length_478_cov_336.139842	153	233	374	1	80	0.0125000
NODE_46828_length_478_cov_336.139842	153	233	383	2	80	0.0250000
NODE_46828_length_478_cov_336.139842	153	233	385	1	80	0.0125000
NODE_46828_length_478_cov_336.139842	153	233	386	1	80	0.0125000
NODE_46828_length_478_cov_336.139842	153	233	387	3	80	0.0375000
NODE_46828_length_478_cov_336.139842	153	233	389	1	80	0.0125000
NODE_46828_length_478_cov_336.139842	153	233	390	4	80	0.0500000
NODE_46828_length_478_cov_336.139842	153	233	395	1	80	0.0125000
NODE_46828_length_478_cov_336.139842	153	233	398	3	80	0.0375000
NODE_46828_length_478_cov_336.139842	206	286	322	2	80	0.0250000
NODE_46828_length_478_cov_336.139842	206	286	323	1	80	0.0125000
NODE_46828_length_478_cov_336.139842	206	286	324	1	80	0.0125000
NODE_46828_length_478_cov_336.139842	206	286	326	3	80	0.0375000
NODE_46828_length_478_cov_336.139842	206	286	330	1	80	0.0125000
NODE_46828_length_478_cov_336.139842	206	286	331	1	80	0.0125000
NODE_46828_length_478_cov_336.139842	206	286	332	1	80	0.0125000
NODE_46828_length_478_cov_336.139842	206	286	333	1	80	0.0125000
NODE_46828_length_478_cov_336.139842	206	286	334	1	80	0.0125000
NODE_46828_length_478_cov_336.139842	206	286	339	2	80	0.0250000
NODE_46828_length_478_cov_336.139842	206	286	343	1	80	0.0125000
NODE_46828_length_478_cov_336.139842	206	286	345	1	80	0.0125000
NODE_46828_length_478_cov_336.139842	206	286	348	1	80	0.0125000
NODE_46828_length_478_cov_336.139842	206	286	354	1	80	0.0125000
NODE_46828_length_478_cov_336.139842	206	286	356	4	80	0.0500000
NODE_46828_length_478_cov_336.139842	206	286	358	2	80	0.0250000
NODE_46828_length_478_cov_336.139842	206	286	359	4	80	0.0500000
NODE_46828_length_478_cov_336.139842	206	286	360	1	80	0.0125000
NODE_46828_length_478_cov_336.139842	206	286	361	2	80	0.0250000
NODE_46828_length_478_cov_336.139842	206	286	363	2	80	0.0250000
NODE_46828_length_478_cov_336.139842	206	286	366	2	80	0.0250000
NODE_46828_length_478_cov_336.139842	206	286	368	1	80	0.0125000
NODE_46828_length_478_cov_336.139842	206	286	370	1	80	0.0125000
NODE_46828_length_478_cov_336.139842	206	286	373	1	80	0.0125000
NODE_46828_length_478_cov_336.139842	206	286	374	1	80	0.0125000
NODE_46828_length_478_cov_336.139842	206	286	377	1	80	0.0125000
NODE_46828_length_478_cov_336.139842	206	286	383	2	80	0.0250000
NODE_46828_length_478_cov_336.139842	206	286	385	1	80	0.0125000
NODE_46828_length_478_cov_336.139842	206	286	386	1	80	0.0125000
NODE_46828_length_478_cov_336.139842	206	286	387	4	80	0.0500000
NODE_46828_length_478_cov_336.139842	206	286	389	1	80	0.0125000
NODE_46828_length_478_cov_336.139842	206	286	390	4	80	0.0500000
NODE_46828_length_478_cov_336.139842	206	286	395	2	80	0.0250000
NODE_46828_length_478_cov_336.139842	206	286	398	7	80	0.0875000
NODE_46828_length_478_cov_336.139842	206	286	399	1	80	0.0125000
NODE_46828_length_478_cov_336.139842	206	286	402	4	80	0.0500000
NODE_46828_length_478_cov_336.139842	206	286	405	1	80	0.0125000
NODE_46828_length_478_cov_336.139842	206	286	407	2	80	0.0250000
NODE_46828_length_478_cov_336.139842	206	286	409	3	80	0.0375000
NODE_46828_length_478_cov_336.139842	206	286	410	1	80	0.0125000
NODE_46828_length_478_cov_336.139842	206	286	411	1	80	0.0125000
NODE_46828_length_478_cov_336.139842	206	286	413	1	80	0.0125000
NODE_46828_length_478_cov_336.139842	206	286	415	1	80	0.0125000
NODE_46828_length_478_cov_336.139842	206	286	417	3	80	0.0375000
NODE_46846_length_478_cov_4.448549	150	230	0	80	80	1.0000000
NODE_46846_length_478_cov_4.448549	203	284	0	81	81	1.0000000
NODE_46874_length_478_cov_2.627968	228	278	0	3	50	0.0600000
NODE_46874_length_478_cov_2.627968	228	278	3	1	50	0.0200000
NODE_46874_length_478_cov_2.627968	228	278	4	7	50	0.1400000
NODE_46874_length_478_cov_2.627968	228	278	6	27	50	0.5400000
NODE_46874_length_478_cov_2.627968	228	278	8	12	50	0.2400000
NODE_47128_length_477_cov_36.230159	225	305	0	36	80	0.4500000
NODE_47128_length_477_cov_36.230159	225	305	4	44	80	0.5500000
NODE_47128_length_477_cov_36.230159	278	358	4	80	80	1.0000000
NODE_47129_length_477_cov_33.111111	307	387	4	21	80	0.2625000
NODE_47129_length_477_cov_33.111111	307	387	6	10	80	0.1250000
NODE_47129_length_477_cov_33.111111	307	387	14	12	80	0.1500000
NODE_47129_length_477_cov_33.111111	307	387	16	37	80	0.4625000
NODE_47129_length_477_cov_33.111111	360	440	12	18	80	0.2250000
NODE_47129_length_477_cov_33.111111	360	440	14	47	80	0.5875000
NODE_47129_length_477_cov_33.111111	360	440	16	15	80	0.1875000
NODE_47133_length_477_cov_11.235450	119	199	0	80	80	1.0000000
NODE_47133_length_477_cov_11.235450	172	247	0	75	75	1.0000000
NODE_47135_length_477_cov_9.359788	221	301	0	3	80	0.0375000
NODE_47135_length_477_cov_9.359788	221	301	4	1	80	0.0125000
NODE_47135_length_477_cov_9.359788	221	301	5	8	80	0.1000000
NODE_47135_length_477_cov_9.359788	221	301	6	68	80	0.8500000
NODE_47135_length_477_cov_9.359788	274	354	0	24	80	0.3000000
NODE_47135_length_477_cov_9.359788	274	354	5	2	80	0.0250000
NODE_47135_length_477_cov_9.359788	274	354	6	54	80	0.6750000
NODE_47139_length_477_cov_7.436508	230	304	6	17	74	0.2297297
NODE_47139_length_477_cov_7.436508	230	304	8	14	74	0.1891892
NODE_47139_length_477_cov_7.436508	230	304	10	9	74	0.1216216
NODE_47139_length_477_cov_7.436508	230	304	11	1	74	0.0135135
NODE_47139_length_477_cov_7.436508	230	304	12	5	74	0.0675676
NODE_47139_length_477_cov_7.436508	230	304	18	18	74	0.2432432
NODE_47139_length_477_cov_7.436508	230	304	20	10	74	0.1351351
NODE_47140_length_477_cov_7.433862	43	123	0	80	80	1.0000000
NODE_47140_length_477_cov_7.433862	96	176	0	80	80	1.0000000
NODE_47143_length_477_cov_6.846561	163	243	0	80	80	1.0000000
NODE_47143_length_477_cov_6.846561	216	296	0	80	80	1.0000000
NODE_47147_length_477_cov_5.677249	150	228	0	78	78	1.0000000
NODE_47148_length_477_cov_5.084656	227	288	2	18	61	0.2950820
NODE_47148_length_477_cov_5.084656	227	288	4	43	61	0.7049180
NODE_47253_length_477_cov_1.629630	115	171	0	13	56	0.2321429
NODE_47253_length_477_cov_1.629630	115	171	2	43	56	0.7678571
NODE_47253_length_477_cov_1.629630	167	224	2	25	57	0.4385965
NODE_47253_length_477_cov_1.629630	167	224	4	32	57	0.5614035
NODE_47375_length_477_cov_0.859788	445	477	0	32	32	1.0000000
NODE_47427_length_476_cov_7.533156	221	301	0	54	80	0.6750000
NODE_47427_length_476_cov_7.533156	221	301	2	26	80	0.3250000
NODE_47427_length_476_cov_7.533156	274	354	0	1	80	0.0125000
NODE_47427_length_476_cov_7.533156	274	354	2	79	80	0.9875000
NODE_47529_length_476_cov_1.618037	385	444	0	59	59	1.0000000
NODE_47601_length_476_cov_1.129973	15	34	0	11	19	0.5789474
NODE_47601_length_476_cov_1.129973	15	34	3	8	19	0.4210526
NODE_47620_length_476_cov_1.037135	180	243	0	63	63	1.0000000
NODE_47620_length_476_cov_1.037135	237	296	0	42	59	0.7118644
NODE_47620_length_476_cov_1.037135	237	296	2	6	59	0.1016949
NODE_47620_length_476_cov_1.037135	237	296	4	3	59	0.0508475
NODE_47620_length_476_cov_1.037135	237	296	6	8	59	0.1355932
NODE_47693_length_475_cov_34.460106	270	350	0	80	80	1.0000000
NODE_47693_length_475_cov_34.460106	323	403	0	80	80	1.0000000
NODE_47694_length_475_cov_30.087766	273	353	0	45	80	0.5625000
NODE_47694_length_475_cov_30.087766	273	353	2	21	80	0.2625000
NODE_47694_length_475_cov_30.087766	273	353	4	14	80	0.1750000
NODE_47694_length_475_cov_30.087766	326	406	2	24	80	0.3000000
NODE_47694_length_475_cov_30.087766	326	406	4	56	80	0.7000000
NODE_47695_length_475_cov_10.247340	42	122	0	80	80	1.0000000
NODE_47701_length_475_cov_8.393617	9	89	0	80	80	1.0000000
NODE_47701_length_475_cov_8.393617	62	142	0	80	80	1.0000000
NODE_47828_length_475_cov_1.531915	272	352	0	77	80	0.9625000
NODE_47828_length_475_cov_1.531915	272	352	2	3	80	0.0375000
NODE_47839_length_475_cov_1.457447	50	93	0	43	43	1.0000000
NODE_47979_length_474_cov_49.453333	392	472	52	1	80	0.0125000
NODE_47979_length_474_cov_49.453333	392	472	54	1	80	0.0125000
NODE_47979_length_474_cov_49.453333	392	472	57	1	80	0.0125000
NODE_47979_length_474_cov_49.453333	392	472	60	2	80	0.0250000
NODE_47979_length_474_cov_49.453333	392	472	64	2	80	0.0250000
NODE_47979_length_474_cov_49.453333	392	472	66	1	80	0.0125000
NODE_47979_length_474_cov_49.453333	392	472	69	1	80	0.0125000
NODE_47979_length_474_cov_49.453333	392	472	78	2	80	0.0250000
NODE_47979_length_474_cov_49.453333	392	472	81	1	80	0.0125000
NODE_47979_length_474_cov_49.453333	392	472	84	1	80	0.0125000
NODE_47979_length_474_cov_49.453333	392	472	86	2	80	0.0250000
NODE_47979_length_474_cov_49.453333	392	472	92	1	80	0.0125000
NODE_47979_length_474_cov_49.453333	392	472	93	1	80	0.0125000
NODE_47979_length_474_cov_49.453333	392	472	99	2	80	0.0250000
NODE_47979_length_474_cov_49.453333	392	472	117	1	80	0.0125000
NODE_47979_length_474_cov_49.453333	392	472	130	2	80	0.0250000
NODE_47979_length_474_cov_49.453333	392	472	136	1	80	0.0125000
NODE_47979_length_474_cov_49.453333	392	472	141	1	80	0.0125000
NODE_47979_length_474_cov_49.453333	392	472	143	1	80	0.0125000
NODE_47979_length_474_cov_49.453333	392	472	145	1	80	0.0125000
NODE_47979_length_474_cov_49.453333	392	472	146	1	80	0.0125000
NODE_47979_length_474_cov_49.453333	392	472	148	1	80	0.0125000
NODE_47979_length_474_cov_49.453333	392	472	154	1	80	0.0125000
NODE_47979_length_474_cov_49.453333	392	472	156	1	80	0.0125000
NODE_47979_length_474_cov_49.453333	392	472	158	1	80	0.0125000
NODE_47979_length_474_cov_49.453333	392	472	166	3	80	0.0375000
NODE_47979_length_474_cov_49.453333	392	472	174	1	80	0.0125000
NODE_47979_length_474_cov_49.453333	392	472	177	1	80	0.0125000
NODE_47979_length_474_cov_49.453333	392	472	179	3	80	0.0375000
NODE_47979_length_474_cov_49.453333	392	472	182	2	80	0.0250000
NODE_47979_length_474_cov_49.453333	392	472	186	1	80	0.0125000
NODE_47979_length_474_cov_49.453333	392	472	198	1	80	0.0125000
NODE_47979_length_474_cov_49.453333	392	472	204	1	80	0.0125000
NODE_47979_length_474_cov_49.453333	392	472	206	4	80	0.0500000
NODE_47979_length_474_cov_49.453333	392	472	207	1	80	0.0125000
NODE_47979_length_474_cov_49.453333	392	472	209	1	80	0.0125000
NODE_47979_length_474_cov_49.453333	392	472	215	1	80	0.0125000
NODE_47979_length_474_cov_49.453333	392	472	223	2	80	0.0250000
NODE_47979_length_474_cov_49.453333	392	472	225	1	80	0.0125000
NODE_47979_length_474_cov_49.453333	392	472	231	1	80	0.0125000
NODE_47979_length_474_cov_49.453333	392	472	237	2	80	0.0250000
NODE_47979_length_474_cov_49.453333	392	472	240	4	80	0.0500000
NODE_47979_length_474_cov_49.453333	392	472	242	1	80	0.0125000
NODE_47979_length_474_cov_49.453333	392	472	244	1	80	0.0125000
NODE_47979_length_474_cov_49.453333	392	472	246	1	80	0.0125000
NODE_47979_length_474_cov_49.453333	392	472	248	2	80	0.0250000
NODE_47979_length_474_cov_49.453333	392	472	249	1	80	0.0125000
NODE_47979_length_474_cov_49.453333	392	472	253	1	80	0.0125000
NODE_47979_length_474_cov_49.453333	392	472	257	1	80	0.0125000
NODE_47979_length_474_cov_49.453333	392	472	263	1	80	0.0125000
NODE_47979_length_474_cov_49.453333	392	472	275	2	80	0.0250000
NODE_47979_length_474_cov_49.453333	392	472	276	1	80	0.0125000
NODE_47979_length_474_cov_49.453333	392	472	278	2	80	0.0250000
NODE_47979_length_474_cov_49.453333	392	472	291	1	80	0.0125000
NODE_47979_length_474_cov_49.453333	392	472	294	3	80	0.0375000
NODE_47979_length_474_cov_49.453333	392	472	298	1	80	0.0125000
NODE_47979_length_474_cov_49.453333	445	474	50	2	29	0.0689655
NODE_47979_length_474_cov_49.453333	445	474	52	1	29	0.0344828
NODE_47979_length_474_cov_49.453333	445	474	54	1	29	0.0344828
NODE_47979_length_474_cov_49.453333	445	474	57	1	29	0.0344828
NODE_47979_length_474_cov_49.453333	445	474	60	2	29	0.0689655
NODE_47979_length_474_cov_49.453333	445	474	64	2	29	0.0689655
NODE_47979_length_474_cov_49.453333	445	474	66	1	29	0.0344828
NODE_47979_length_474_cov_49.453333	445	474	69	1	29	0.0344828
NODE_47979_length_474_cov_49.453333	445	474	78	2	29	0.0689655
NODE_47979_length_474_cov_49.453333	445	474	81	1	29	0.0344828
NODE_47979_length_474_cov_49.453333	445	474	84	1	29	0.0344828
NODE_47979_length_474_cov_49.453333	445	474	86	2	29	0.0689655
NODE_47979_length_474_cov_49.453333	445	474	92	1	29	0.0344828
NODE_47979_length_474_cov_49.453333	445	474	93	1	29	0.0344828
NODE_47979_length_474_cov_49.453333	445	474	99	2	29	0.0689655
NODE_47979_length_474_cov_49.453333	445	474	117	1	29	0.0344828
NODE_47979_length_474_cov_49.453333	445	474	130	2	29	0.0689655
NODE_47979_length_474_cov_49.453333	445	474	136	1	29	0.0344828
NODE_47979_length_474_cov_49.453333	445	474	141	1	29	0.0344828
NODE_47979_length_474_cov_49.453333	445	474	143	1	29	0.0344828
NODE_47979_length_474_cov_49.453333	445	474	145	1	29	0.0344828
NODE_47979_length_474_cov_49.453333	445	474	146	1	29	0.0344828
NODE_47981_length_474_cov_24.930667	287	367	0	13	80	0.1625000
NODE_47981_length_474_cov_24.930667	287	367	2	67	80	0.8375000
NODE_47981_length_474_cov_24.930667	340	420	0	51	80	0.6375000
NODE_47981_length_474_cov_24.930667	340	420	2	29	80	0.3625000
NODE_47982_length_474_cov_15.952000	258	338	0	80	80	1.0000000
NODE_47982_length_474_cov_15.952000	311	391	0	80	80	1.0000000
NODE_48003_length_474_cov_3.986667	172	252	10	52	80	0.6500000
NODE_48003_length_474_cov_3.986667	172	252	12	28	80	0.3500000
NODE_48015_length_474_cov_3.496000	163	243	2	2	80	0.0250000
NODE_48015_length_474_cov_3.496000	163	243	6	7	80	0.0875000
NODE_48015_length_474_cov_3.496000	163	243	8	1	80	0.0125000
NODE_48015_length_474_cov_3.496000	163	243	10	12	80	0.1500000
NODE_48015_length_474_cov_3.496000	163	243	12	58	80	0.7250000
NODE_48038_length_474_cov_2.784000	259	300	0	41	41	1.0000000
NODE_48116_length_474_cov_1.538667	41	62	0	21	21	1.0000000
NODE_48181_length_474_cov_1.085333	0	50	0	50	50	1.0000000
NODE_48184_length_474_cov_1.056000	95	133	0	38	38	1.0000000
NODE_48266_length_473_cov_82.374332	123	203	0	80	80	1.0000000
NODE_48266_length_473_cov_82.374332	176	256	0	80	80	1.0000000
NODE_48267_length_473_cov_54.882353	199	279	0	80	80	1.0000000
NODE_48267_length_473_cov_54.882353	252	332	0	80	80	1.0000000
NODE_48268_length_473_cov_48.997326	119	194	22	12	75	0.1600000
NODE_48268_length_473_cov_48.997326	119	194	24	33	75	0.4400000
NODE_48268_length_473_cov_48.997326	119	194	25	11	75	0.1466667
NODE_48268_length_473_cov_48.997326	119	194	26	19	75	0.2533333
NODE_48268_length_473_cov_48.997326	119	194	22	12	75	0.1600000
NODE_48268_length_473_cov_48.997326	119	194	24	33	75	0.4400000
NODE_48268_length_473_cov_48.997326	119	194	25	11	75	0.1466667
NODE_48268_length_473_cov_48.997326	119	194	26	19	75	0.2533333
NODE_48268_length_473_cov_48.997326	167	247	24	41	80	0.5125000
NODE_48268_length_473_cov_48.997326	167	247	25	4	80	0.0500000
NODE_48268_length_473_cov_48.997326	167	247	26	35	80	0.4375000
NODE_48269_length_473_cov_30.679144	174	254	2	32	80	0.4000000
NODE_48269_length_473_cov_30.679144	174	254	4	1	80	0.0125000
NODE_48269_length_473_cov_30.679144	174	254	6	1	80	0.0125000
NODE_48269_length_473_cov_30.679144	174	254	14	2	80	0.0250000
NODE_48269_length_473_cov_30.679144	174	254	18	1	80	0.0125000
NODE_48269_length_473_cov_30.679144	174	254	22	21	80	0.2625000
NODE_48269_length_473_cov_30.679144	174	254	24	1	80	0.0125000
NODE_48269_length_473_cov_30.679144	174	254	26	1	80	0.0125000
NODE_48269_length_473_cov_30.679144	174	254	28	4	80	0.0500000
NODE_48269_length_473_cov_30.679144	174	254	30	2	80	0.0250000
NODE_48269_length_473_cov_30.679144	174	254	32	2	80	0.0250000
NODE_48269_length_473_cov_30.679144	174	254	34	3	80	0.0375000
NODE_48269_length_473_cov_30.679144	174	254	38	1	80	0.0125000
NODE_48269_length_473_cov_30.679144	174	254	40	8	80	0.1000000
NODE_48269_length_473_cov_30.679144	226	307	0	21	81	0.2592593
NODE_48269_length_473_cov_30.679144	226	307	2	60	81	0.7407407
NODE_48269_length_473_cov_30.679144	227	307	0	21	80	0.2625000
NODE_48269_length_473_cov_30.679144	227	307	2	59	80	0.7375000
NODE_48270_length_473_cov_24.967914	295	370	0	33	75	0.4400000
NODE_48270_length_473_cov_24.967914	295	370	4	35	75	0.4666667
NODE_48270_length_473_cov_24.967914	295	370	6	7	75	0.0933333
NODE_48270_length_473_cov_24.967914	343	423	4	20	80	0.2500000
NODE_48270_length_473_cov_24.967914	343	423	6	60	80	0.7500000
NODE_48271_length_473_cov_18.540107	168	248	2	2	80	0.0250000
NODE_48271_length_473_cov_18.540107	168	248	4	25	80	0.3125000
NODE_48271_length_473_cov_18.540107	168	248	6	53	80	0.6625000
NODE_48271_length_473_cov_18.540107	221	301	2	8	80	0.1000000
NODE_48271_length_473_cov_18.540107	221	301	3	2	80	0.0250000
NODE_48271_length_473_cov_18.540107	221	301	4	70	80	0.8750000
NODE_48272_length_473_cov_15.871658	143	223	0	64	80	0.8000000
NODE_48272_length_473_cov_15.871658	143	223	2	16	80	0.2000000
NODE_48272_length_473_cov_15.871658	196	276	0	80	80	1.0000000
NODE_48291_length_473_cov_4.363636	160	240	0	44	80	0.5500000
NODE_48291_length_473_cov_4.363636	160	240	2	36	80	0.4500000
NODE_48291_length_473_cov_4.363636	213	293	0	67	80	0.8375000
NODE_48291_length_473_cov_4.363636	213	293	2	13	80	0.1625000
NODE_48320_length_473_cov_2.959893	199	267	0	68	68	1.0000000
NODE_48325_length_473_cov_2.804813	207	269	0	55	62	0.8870968
NODE_48325_length_473_cov_2.804813	207	269	2	7	62	0.1129032
NODE_48350_length_473_cov_2.251337	48	128	0	56	80	0.7000000
NODE_48350_length_473_cov_2.251337	48	128	2	24	80	0.3000000
NODE_48350_length_473_cov_2.251337	101	181	0	3	80	0.0375000
NODE_48350_length_473_cov_2.251337	101	181	2	25	80	0.3125000
NODE_48350_length_473_cov_2.251337	101	181	4	14	80	0.1750000
NODE_48350_length_473_cov_2.251337	101	181	6	38	80	0.4750000
NODE_48568_length_472_cov_50.077748	1	81	0	3	80	0.0375000
NODE_48568_length_472_cov_50.077748	1	81	6	28	80	0.3500000
NODE_48568_length_472_cov_50.077748	1	81	10	41	80	0.5125000
NODE_48568_length_472_cov_50.077748	1	81	13	2	80	0.0250000
NODE_48568_length_472_cov_50.077748	1	81	14	6	80	0.0750000
NODE_48568_length_472_cov_50.077748	1	81	0	3	80	0.0375000
NODE_48568_length_472_cov_50.077748	1	81	6	28	80	0.3500000
NODE_48568_length_472_cov_50.077748	1	81	10	41	80	0.5125000
NODE_48568_length_472_cov_50.077748	1	81	13	2	80	0.0250000
NODE_48568_length_472_cov_50.077748	1	81	14	6	80	0.0750000
NODE_48568_length_472_cov_50.077748	1	81	0	3	80	0.0375000
NODE_48568_length_472_cov_50.077748	1	81	6	28	80	0.3500000
NODE_48568_length_472_cov_50.077748	1	81	10	41	80	0.5125000
NODE_48568_length_472_cov_50.077748	1	81	13	2	80	0.0250000
NODE_48568_length_472_cov_50.077748	1	81	14	6	80	0.0750000
NODE_48568_length_472_cov_50.077748	1	81	0	3	80	0.0375000
NODE_48568_length_472_cov_50.077748	1	81	6	28	80	0.3500000
NODE_48568_length_472_cov_50.077748	1	81	10	41	80	0.5125000
NODE_48568_length_472_cov_50.077748	1	81	13	2	80	0.0250000
NODE_48568_length_472_cov_50.077748	1	81	14	6	80	0.0750000
NODE_48568_length_472_cov_50.077748	1	81	0	3	80	0.0375000
NODE_48568_length_472_cov_50.077748	1	81	6	28	80	0.3500000
NODE_48568_length_472_cov_50.077748	1	81	10	41	80	0.5125000
NODE_48568_length_472_cov_50.077748	1	81	13	2	80	0.0250000
NODE_48568_length_472_cov_50.077748	1	81	14	6	80	0.0750000
NODE_48568_length_472_cov_50.077748	10	81	6	22	71	0.3098592
NODE_48568_length_472_cov_50.077748	10	81	10	41	71	0.5774648
NODE_48568_length_472_cov_50.077748	10	81	13	2	71	0.0281690
NODE_48568_length_472_cov_50.077748	10	81	14	6	71	0.0845070
NODE_48568_length_472_cov_50.077748	54	131	10	19	77	0.2467532
NODE_48568_length_472_cov_50.077748	54	131	13	2	77	0.0259740
NODE_48568_length_472_cov_50.077748	54	131	14	56	77	0.7272727
NODE_48568_length_472_cov_50.077748	54	131	10	19	77	0.2467532
NODE_48568_length_472_cov_50.077748	54	131	13	2	77	0.0259740
NODE_48568_length_472_cov_50.077748	54	131	14	56	77	0.7272727
NODE_48568_length_472_cov_50.077748	54	131	10	19	77	0.2467532
NODE_48568_length_472_cov_50.077748	54	131	13	2	77	0.0259740
NODE_48568_length_472_cov_50.077748	54	131	14	56	77	0.7272727
NODE_48568_length_472_cov_50.077748	130	204	4	8	74	0.1081081
NODE_48568_length_472_cov_50.077748	130	204	7	1	74	0.0135135
NODE_48568_length_472_cov_50.077748	130	204	8	16	74	0.2162162
NODE_48568_length_472_cov_50.077748	130	204	11	8	74	0.1081081
NODE_48568_length_472_cov_50.077748	130	204	12	28	74	0.3783784
NODE_48568_length_472_cov_50.077748	130	204	14	13	74	0.1756757
NODE_48569_length_472_cov_10.469169	294	374	0	6	80	0.0750000
NODE_48569_length_472_cov_10.469169	294	374	6	74	80	0.9250000
NODE_48569_length_472_cov_10.469169	347	427	0	18	80	0.2250000
NODE_48569_length_472_cov_10.469169	347	427	6	62	80	0.7750000
NODE_48570_length_472_cov_10.195710	143	223	0	80	80	1.0000000
NODE_48570_length_472_cov_10.195710	196	276	0	80	80	1.0000000
NODE_48593_length_472_cov_4.375335	165	245	0	57	80	0.7125000
NODE_48593_length_472_cov_4.375335	165	245	2	2	80	0.0250000
NODE_48593_length_472_cov_4.375335	165	245	4	21	80	0.2625000
NODE_48593_length_472_cov_4.375335	218	251	0	4	33	0.1212121
NODE_48593_length_472_cov_4.375335	218	251	2	2	33	0.0606061
NODE_48593_length_472_cov_4.375335	218	251	4	27	33	0.8181818
NODE_48614_length_472_cov_3.495979	305	349	0	44	44	1.0000000
NODE_48620_length_472_cov_3.093834	220	295	0	47	75	0.6266667
NODE_48620_length_472_cov_3.093834	220	295	2	28	75	0.3733333
NODE_48638_length_472_cov_2.592493	431	471	0	40	40	1.0000000
NODE_48745_length_472_cov_1.294906	43	98	0	8	55	0.1454545
NODE_48745_length_472_cov_1.294906	43	98	4	47	55	0.8545455
NODE_48745_length_472_cov_1.294906	71	151	4	80	80	1.0000000
NODE_48768_length_472_cov_1.211796	106	126	0	20	20	1.0000000
NODE_48873_length_471_cov_39.319892	119	193	0	31	74	0.4189189
NODE_48873_length_471_cov_39.319892	119	193	3	14	74	0.1891892
NODE_48873_length_471_cov_39.319892	119	193	6	25	74	0.3378378
NODE_48873_length_471_cov_39.319892	119	193	12	2	74	0.0270270
NODE_48873_length_471_cov_39.319892	119	193	18	1	74	0.0135135
NODE_48873_length_471_cov_39.319892	119	193	65	1	74	0.0135135
NODE_48874_length_471_cov_24.279570	185	265	2	22	80	0.2750000
NODE_48874_length_471_cov_24.279570	185	265	8	58	80	0.7250000
NODE_48874_length_471_cov_24.279570	238	318	0	24	80	0.3000000
NODE_48874_length_471_cov_24.279570	238	318	2	51	80	0.6375000
NODE_48874_length_471_cov_24.279570	238	318	8	5	80	0.0625000
NODE_48875_length_471_cov_19.669355	83	163	0	11	80	0.1375000
NODE_48875_length_471_cov_19.669355	83	163	4	69	80	0.8625000
NODE_48875_length_471_cov_19.669355	136	216	0	64	80	0.8000000
NODE_48875_length_471_cov_19.669355	136	216	4	16	80	0.2000000
NODE_48876_length_471_cov_14.387097	198	278	0	13	80	0.1625000
NODE_48876_length_471_cov_14.387097	198	278	2	67	80	0.8375000
NODE_48876_length_471_cov_14.387097	251	331	0	66	80	0.8250000
NODE_48876_length_471_cov_14.387097	251	331	2	14	80	0.1750000
NODE_48881_length_471_cov_6.948925	186	213	0	15	27	0.5555556
NODE_48881_length_471_cov_6.948925	186	213	2	12	27	0.4444444
NODE_48881_length_471_cov_6.948925	204	284	0	80	80	1.0000000
NODE_48881_length_471_cov_6.948925	244	275	0	31	31	1.0000000
NODE_48881_length_471_cov_6.948925	257	337	0	39	80	0.4875000
NODE_48881_length_471_cov_6.948925	257	337	2	41	80	0.5125000
NODE_48881_length_471_cov_6.948925	268	337	0	28	69	0.4057971
NODE_48881_length_471_cov_6.948925	268	337	2	41	69	0.5942029
NODE_48902_length_471_cov_3.803763	83	162	0	79	79	1.0000000
NODE_48902_length_471_cov_3.803763	135	215	0	80	80	1.0000000
NODE_48924_length_471_cov_2.954301	284	315	20	7	31	0.2258064
NODE_48924_length_471_cov_2.954301	284	315	21	4	31	0.1290323
NODE_48924_length_471_cov_2.954301	284	315	24	20	31	0.6451613
NODE_48957_length_471_cov_2.287634	133	200	11	2	67	0.0298507
NODE_48957_length_471_cov_2.287634	133	200	13	2	67	0.0298507
NODE_48957_length_471_cov_2.287634	133	200	17	1	67	0.0149254
NODE_48957_length_471_cov_2.287634	133	200	18	7	67	0.1044776
NODE_48957_length_471_cov_2.287634	133	200	22	6	67	0.0895522
NODE_48957_length_471_cov_2.287634	133	200	24	2	67	0.0298507
NODE_48957_length_471_cov_2.287634	133	200	26	2	67	0.0298507
NODE_48957_length_471_cov_2.287634	133	200	27	1	67	0.0149254
NODE_48957_length_471_cov_2.287634	133	200	29	19	67	0.2835821
NODE_48957_length_471_cov_2.287634	133	200	31	4	67	0.0597015
NODE_48957_length_471_cov_2.287634	133	200	33	4	67	0.0597015
NODE_48957_length_471_cov_2.287634	133	200	35	2	67	0.0298507
NODE_48957_length_471_cov_2.287634	133	200	36	1	67	0.0149254
NODE_48957_length_471_cov_2.287634	133	200	37	1	67	0.0149254
NODE_48957_length_471_cov_2.287634	133	200	39	13	67	0.1940299
NODE_49186_length_470_cov_57.078167	184	264	0	71	80	0.8875000
NODE_49186_length_470_cov_57.078167	184	264	2	9	80	0.1125000
NODE_49186_length_470_cov_57.078167	237	317	0	18	80	0.2250000
NODE_49186_length_470_cov_57.078167	237	317	2	62	80	0.7750000
NODE_49186_length_470_cov_57.078167	313	393	2	14	80	0.1750000
NODE_49186_length_470_cov_57.078167	313	393	10	1	80	0.0125000
NODE_49186_length_470_cov_57.078167	313	393	12	18	80	0.2250000
NODE_49186_length_470_cov_57.078167	313	393	14	18	80	0.2250000
NODE_49186_length_470_cov_57.078167	313	393	16	3	80	0.0375000
NODE_49186_length_470_cov_57.078167	313	393	19	19	80	0.2375000
NODE_49186_length_470_cov_57.078167	313	393	20	7	80	0.0875000
NODE_49186_length_470_cov_57.078167	366	446	12	8	80	0.1000000
NODE_49186_length_470_cov_57.078167	366	446	14	9	80	0.1125000
NODE_49186_length_470_cov_57.078167	366	446	16	1	80	0.0125000
NODE_49186_length_470_cov_57.078167	366	446	18	6	80	0.0750000
NODE_49186_length_470_cov_57.078167	366	446	19	49	80	0.6125000
NODE_49186_length_470_cov_57.078167	366	446	20	7	80	0.0875000
NODE_49187_length_470_cov_34.035040	228	308	0	80	80	1.0000000
NODE_49187_length_470_cov_34.035040	281	361	0	80	80	1.0000000
NODE_49187_length_470_cov_34.035040	357	437	0	80	80	1.0000000
NODE_49187_length_470_cov_34.035040	410	470	0	60	60	1.0000000
NODE_49188_length_470_cov_15.539084	142	222	0	80	80	1.0000000
NODE_49188_length_470_cov_15.539084	195	275	0	80	80	1.0000000
NODE_49193_length_470_cov_6.070081	272	330	36	1	58	0.0172414
NODE_49193_length_470_cov_6.070081	272	330	40	1	58	0.0172414
NODE_49193_length_470_cov_6.070081	272	330	41	1	58	0.0172414
NODE_49193_length_470_cov_6.070081	272	330	42	13	58	0.2241379
NODE_49193_length_470_cov_6.070081	272	330	43	6	58	0.1034483
NODE_49193_length_470_cov_6.070081	272	330	46	2	58	0.0344828
NODE_49193_length_470_cov_6.070081	272	330	47	1	58	0.0172414
NODE_49193_length_470_cov_6.070081	272	330	49	3	58	0.0517241
NODE_49193_length_470_cov_6.070081	272	330	51	1	58	0.0172414
NODE_49193_length_470_cov_6.070081	272	330	53	6	58	0.1034483
NODE_49193_length_470_cov_6.070081	272	330	55	8	58	0.1379310
NODE_49193_length_470_cov_6.070081	272	330	57	5	58	0.0862069
NODE_49193_length_470_cov_6.070081	272	330	58	3	58	0.0517241
NODE_49193_length_470_cov_6.070081	272	330	60	7	58	0.1206897
NODE_49193_length_470_cov_6.070081	325	383	2	1	58	0.0172414
NODE_49193_length_470_cov_6.070081	325	383	3	5	58	0.0862069
NODE_49193_length_470_cov_6.070081	325	383	5	5	58	0.0862069
NODE_49193_length_470_cov_6.070081	325	383	6	8	58	0.1379310
NODE_49193_length_470_cov_6.070081	325	383	9	1	58	0.0172414
NODE_49193_length_470_cov_6.070081	325	383	10	6	58	0.1034483
NODE_49193_length_470_cov_6.070081	325	383	14	4	58	0.0689655
NODE_49193_length_470_cov_6.070081	325	383	15	1	58	0.0172414
NODE_49193_length_470_cov_6.070081	325	383	16	1	58	0.0172414
NODE_49193_length_470_cov_6.070081	325	383	22	1	58	0.0172414
NODE_49193_length_470_cov_6.070081	325	383	23	2	58	0.0344828
NODE_49193_length_470_cov_6.070081	325	383	28	1	58	0.0172414
NODE_49193_length_470_cov_6.070081	325	383	30	4	58	0.0689655
NODE_49193_length_470_cov_6.070081	325	383	31	8	58	0.1379310
NODE_49193_length_470_cov_6.070081	325	383	32	1	58	0.0172414
NODE_49193_length_470_cov_6.070081	325	383	36	5	58	0.0862069
NODE_49193_length_470_cov_6.070081	325	383	40	1	58	0.0172414
NODE_49193_length_470_cov_6.070081	325	383	41	1	58	0.0172414
NODE_49193_length_470_cov_6.070081	325	383	42	2	58	0.0344828
NODE_49215_length_470_cov_3.735849	194	251	0	57	57	1.0000000
NODE_49260_length_470_cov_2.363881	403	422	2	19	19	1.0000000
NODE_49260_length_470_cov_2.363881	403	422	2	19	19	1.0000000
NODE_49389_length_470_cov_1.142857	414	470	0	12	56	0.2142857
NODE_49389_length_470_cov_1.142857	414	470	2	38	56	0.6785714
NODE_49389_length_470_cov_1.142857	414	470	4	6	56	0.1071429
NODE_49502_length_469_cov_221.024324	150	228	310	1	78	0.0128205
NODE_49502_length_469_cov_221.024324	150	228	324	1	78	0.0128205
NODE_49502_length_469_cov_221.024324	150	228	325	1	78	0.0128205
NODE_49502_length_469_cov_221.024324	150	228	333	1	78	0.0128205
NODE_49502_length_469_cov_221.024324	150	228	353	1	78	0.0128205
NODE_49502_length_469_cov_221.024324	150	228	354	2	78	0.0256410
NODE_49502_length_469_cov_221.024324	150	228	365	1	78	0.0128205
NODE_49502_length_469_cov_221.024324	150	228	368	1	78	0.0128205
NODE_49502_length_469_cov_221.024324	150	228	378	1	78	0.0128205
NODE_49502_length_469_cov_221.024324	150	228	379	5	78	0.0641026
NODE_49502_length_469_cov_221.024324	150	228	389	1	78	0.0128205
NODE_49502_length_469_cov_221.024324	150	228	390	2	78	0.0256410
NODE_49502_length_469_cov_221.024324	150	228	392	1	78	0.0128205
NODE_49502_length_469_cov_221.024324	150	228	394	2	78	0.0256410
NODE_49502_length_469_cov_221.024324	150	228	399	1	78	0.0128205
NODE_49502_length_469_cov_221.024324	150	228	404	3	78	0.0384615
NODE_49502_length_469_cov_221.024324	150	228	405	3	78	0.0384615
NODE_49502_length_469_cov_221.024324	150	228	406	2	78	0.0256410
NODE_49502_length_469_cov_221.024324	150	228	408	1	78	0.0128205
NODE_49502_length_469_cov_221.024324	150	228	410	1	78	0.0128205
NODE_49502_length_469_cov_221.024324	150	228	413	1	78	0.0128205
NODE_49502_length_469_cov_221.024324	150	228	416	1	78	0.0128205
NODE_49502_length_469_cov_221.024324	150	228	417	3	78	0.0384615
NODE_49502_length_469_cov_221.024324	150	228	423	2	78	0.0256410
NODE_49502_length_469_cov_221.024324	150	228	429	1	78	0.0128205
NODE_49502_length_469_cov_221.024324	150	228	432	2	78	0.0256410
NODE_49502_length_469_cov_221.024324	150	228	433	1	78	0.0128205
NODE_49502_length_469_cov_221.024324	150	228	436	1	78	0.0128205
NODE_49502_length_469_cov_221.024324	150	228	438	1	78	0.0128205
NODE_49502_length_469_cov_221.024324	150	228	442	1	78	0.0128205
NODE_49502_length_469_cov_221.024324	150	228	443	1	78	0.0128205
NODE_49502_length_469_cov_221.024324	150	228	445	2	78	0.0256410
NODE_49502_length_469_cov_221.024324	150	228	447	2	78	0.0256410
NODE_49502_length_469_cov_221.024324	150	228	449	3	78	0.0384615
NODE_49502_length_469_cov_221.024324	150	228	450	4	78	0.0512821
NODE_49502_length_469_cov_221.024324	150	228	451	1	78	0.0128205
NODE_49502_length_469_cov_221.024324	150	228	452	5	78	0.0641026
NODE_49502_length_469_cov_221.024324	150	228	453	1	78	0.0128205
NODE_49502_length_469_cov_221.024324	150	228	454	3	78	0.0384615
NODE_49502_length_469_cov_221.024324	150	228	455	1	78	0.0128205
NODE_49502_length_469_cov_221.024324	150	228	456	1	78	0.0128205
NODE_49502_length_469_cov_221.024324	150	228	458	2	78	0.0256410
NODE_49502_length_469_cov_221.024324	150	228	462	2	78	0.0256410
NODE_49502_length_469_cov_221.024324	150	228	463	1	78	0.0128205
NODE_49502_length_469_cov_221.024324	150	228	465	1	78	0.0128205
NODE_49502_length_469_cov_221.024324	150	228	466	1	78	0.0128205
NODE_49502_length_469_cov_221.024324	150	228	469	1	78	0.0128205
NODE_49502_length_469_cov_221.024324	150	228	310	1	78	0.0128205
NODE_49502_length_469_cov_221.024324	150	228	324	1	78	0.0128205
NODE_49502_length_469_cov_221.024324	150	228	325	1	78	0.0128205
NODE_49502_length_469_cov_221.024324	150	228	333	1	78	0.0128205
NODE_49502_length_469_cov_221.024324	150	228	353	1	78	0.0128205
NODE_49502_length_469_cov_221.024324	150	228	354	2	78	0.0256410
NODE_49502_length_469_cov_221.024324	150	228	365	1	78	0.0128205
NODE_49502_length_469_cov_221.024324	150	228	368	1	78	0.0128205
NODE_49502_length_469_cov_221.024324	150	228	378	1	78	0.0128205
NODE_49502_length_469_cov_221.024324	150	228	379	5	78	0.0641026
NODE_49502_length_469_cov_221.024324	150	228	389	1	78	0.0128205
NODE_49502_length_469_cov_221.024324	150	228	390	2	78	0.0256410
NODE_49502_length_469_cov_221.024324	150	228	392	1	78	0.0128205
NODE_49502_length_469_cov_221.024324	150	228	394	2	78	0.0256410
NODE_49502_length_469_cov_221.024324	150	228	399	1	78	0.0128205
NODE_49502_length_469_cov_221.024324	150	228	404	3	78	0.0384615
NODE_49502_length_469_cov_221.024324	150	228	405	3	78	0.0384615
NODE_49502_length_469_cov_221.024324	150	228	406	2	78	0.0256410
NODE_49502_length_469_cov_221.024324	150	228	408	1	78	0.0128205
NODE_49502_length_469_cov_221.024324	150	228	410	1	78	0.0128205
NODE_49502_length_469_cov_221.024324	150	228	413	1	78	0.0128205
NODE_49502_length_469_cov_221.024324	150	228	416	1	78	0.0128205
NODE_49502_length_469_cov_221.024324	150	228	417	3	78	0.0384615
NODE_49502_length_469_cov_221.024324	150	228	423	2	78	0.0256410
NODE_49502_length_469_cov_221.024324	150	228	429	1	78	0.0128205
NODE_49502_length_469_cov_221.024324	150	228	432	2	78	0.0256410
NODE_49502_length_469_cov_221.024324	150	228	433	1	78	0.0128205
NODE_49502_length_469_cov_221.024324	150	228	436	1	78	0.0128205
NODE_49502_length_469_cov_221.024324	150	228	438	1	78	0.0128205
NODE_49502_length_469_cov_221.024324	150	228	442	1	78	0.0128205
NODE_49502_length_469_cov_221.024324	150	228	443	1	78	0.0128205
NODE_49502_length_469_cov_221.024324	150	228	445	2	78	0.0256410
NODE_49502_length_469_cov_221.024324	150	228	447	2	78	0.0256410
NODE_49502_length_469_cov_221.024324	150	228	449	3	78	0.0384615
NODE_49502_length_469_cov_221.024324	150	228	450	4	78	0.0512821
NODE_49502_length_469_cov_221.024324	150	228	451	1	78	0.0128205
NODE_49502_length_469_cov_221.024324	150	228	452	5	78	0.0641026
NODE_49502_length_469_cov_221.024324	150	228	453	1	78	0.0128205
NODE_49502_length_469_cov_221.024324	150	228	454	3	78	0.0384615
NODE_49502_length_469_cov_221.024324	150	228	455	1	78	0.0128205
NODE_49502_length_469_cov_221.024324	150	228	456	1	78	0.0128205
NODE_49502_length_469_cov_221.024324	150	228	458	2	78	0.0256410
NODE_49502_length_469_cov_221.024324	150	228	462	2	78	0.0256410
NODE_49502_length_469_cov_221.024324	150	228	463	1	78	0.0128205
NODE_49502_length_469_cov_221.024324	150	228	465	1	78	0.0128205
NODE_49502_length_469_cov_221.024324	150	228	466	1	78	0.0128205
NODE_49502_length_469_cov_221.024324	150	228	469	1	78	0.0128205
NODE_49502_length_469_cov_221.024324	150	219	378	1	69	0.0144928
NODE_49502_length_469_cov_221.024324	150	219	379	5	69	0.0724638
NODE_49502_length_469_cov_221.024324	150	219	389	1	69	0.0144928
NODE_49502_length_469_cov_221.024324	150	219	390	2	69	0.0289855
NODE_49502_length_469_cov_221.024324	150	219	392	1	69	0.0144928
NODE_49502_length_469_cov_221.024324	150	219	394	2	69	0.0289855
NODE_49502_length_469_cov_221.024324	150	219	399	1	69	0.0144928
NODE_49502_length_469_cov_221.024324	150	219	404	3	69	0.0434783
NODE_49502_length_469_cov_221.024324	150	219	405	3	69	0.0434783
NODE_49502_length_469_cov_221.024324	150	219	406	2	69	0.0289855
NODE_49502_length_469_cov_221.024324	150	219	408	1	69	0.0144928
NODE_49502_length_469_cov_221.024324	150	219	410	1	69	0.0144928
NODE_49502_length_469_cov_221.024324	150	219	413	1	69	0.0144928
NODE_49502_length_469_cov_221.024324	150	219	416	1	69	0.0144928
NODE_49502_length_469_cov_221.024324	150	219	417	3	69	0.0434783
NODE_49502_length_469_cov_221.024324	150	219	423	2	69	0.0289855
NODE_49502_length_469_cov_221.024324	150	219	429	1	69	0.0144928
NODE_49502_length_469_cov_221.024324	150	219	432	2	69	0.0289855
NODE_49502_length_469_cov_221.024324	150	219	433	1	69	0.0144928
NODE_49502_length_469_cov_221.024324	150	219	436	1	69	0.0144928
NODE_49502_length_469_cov_221.024324	150	219	438	1	69	0.0144928
NODE_49502_length_469_cov_221.024324	150	219	442	1	69	0.0144928
NODE_49502_length_469_cov_221.024324	150	219	443	1	69	0.0144928
NODE_49502_length_469_cov_221.024324	150	219	445	2	69	0.0289855
NODE_49502_length_469_cov_221.024324	150	219	447	2	69	0.0289855
NODE_49502_length_469_cov_221.024324	150	219	449	3	69	0.0434783
NODE_49502_length_469_cov_221.024324	150	219	450	4	69	0.0579710
NODE_49502_length_469_cov_221.024324	150	219	451	1	69	0.0144928
NODE_49502_length_469_cov_221.024324	150	219	452	5	69	0.0724638
NODE_49502_length_469_cov_221.024324	150	219	453	1	69	0.0144928
NODE_49502_length_469_cov_221.024324	150	219	454	3	69	0.0434783
NODE_49502_length_469_cov_221.024324	150	219	455	1	69	0.0144928
NODE_49502_length_469_cov_221.024324	150	219	456	1	69	0.0144928
NODE_49502_length_469_cov_221.024324	150	219	458	2	69	0.0289855
NODE_49502_length_469_cov_221.024324	150	219	462	2	69	0.0289855
NODE_49502_length_469_cov_221.024324	150	219	463	1	69	0.0144928
NODE_49502_length_469_cov_221.024324	150	219	465	1	69	0.0144928
NODE_49502_length_469_cov_221.024324	150	219	466	1	69	0.0144928
NODE_49502_length_469_cov_221.024324	150	219	469	1	69	0.0144928
NODE_49557_length_469_cov_2.686486	263	343	0	80	80	1.0000000
NODE_49561_length_469_cov_2.521622	237	289	0	52	52	1.0000000
NODE_49579_length_469_cov_2.224324	279	331	0	52	52	1.0000000
NODE_49796_length_468_cov_8.043360	190	250	0	5	60	0.0833333
NODE_49796_length_468_cov_8.043360	190	250	2	55	60	0.9166667
NODE_49796_length_468_cov_8.043360	223	303	0	32	80	0.4000000
NODE_49796_length_468_cov_8.043360	223	303	2	48	80	0.6000000
NODE_49800_length_468_cov_6.046070	152	232	0	80	80	1.0000000
NODE_49800_length_468_cov_6.046070	205	285	0	80	80	1.0000000
NODE_49801_length_468_cov_5.997290	81	161	0	80	80	1.0000000
NODE_49801_length_468_cov_5.997290	134	214	0	41	80	0.5125000
NODE_49801_length_468_cov_5.997290	134	214	2	39	80	0.4875000
NODE_49801_length_468_cov_5.997290	210	270	2	6	60	0.1000000
NODE_49801_length_468_cov_5.997290	210	270	8	54	60	0.9000000
NODE_49803_length_468_cov_5.872629	133	201	6	2	68	0.0294118
NODE_49803_length_468_cov_5.872629	133	201	10	10	68	0.1470588
NODE_49803_length_468_cov_5.872629	133	201	12	16	68	0.2352941
NODE_49803_length_468_cov_5.872629	133	201	14	40	68	0.5882353
NODE_49807_length_468_cov_5.384824	305	356	2	51	51	1.0000000
NODE_49894_length_468_cov_2.067751	45	96	6	51	51	1.0000000
NODE_49913_length_468_cov_1.891599	4	63	0	59	59	1.0000000
NODE_49928_length_468_cov_1.758808	140	218	0	78	78	1.0000000
NODE_49928_length_468_cov_1.758808	191	257	0	66	66	1.0000000
NODE_49974_length_468_cov_1.390244	291	310	0	19	19	1.0000000
NODE_49974_length_468_cov_1.390244	369	405	0	36	36	1.0000000
NODE_50133_length_467_cov_14.100543	176	256	0	28	80	0.3500000
NODE_50133_length_467_cov_14.100543	176	256	4	52	80	0.6500000
NODE_50134_length_467_cov_11.902174	193	236	0	43	43	1.0000000
NODE_50135_length_467_cov_10.875000	226	306	0	17	80	0.2125000
NODE_50135_length_467_cov_10.875000	226	306	2	47	80	0.5875000
NODE_50135_length_467_cov_10.875000	226	306	4	16	80	0.2000000
NODE_50135_length_467_cov_10.875000	279	359	0	70	80	0.8750000
NODE_50135_length_467_cov_10.875000	279	359	2	10	80	0.1250000
NODE_50144_length_467_cov_6.625000	206	275	0	16	69	0.2318841
NODE_50144_length_467_cov_6.625000	206	275	4	14	69	0.2028985
NODE_50144_length_467_cov_6.625000	206	275	10	4	69	0.0579710
NODE_50144_length_467_cov_6.625000	206	275	14	14	69	0.2028985
NODE_50144_length_467_cov_6.625000	206	275	16	15	69	0.2173913
NODE_50144_length_467_cov_6.625000	206	275	18	6	69	0.0869565
NODE_50144_length_467_cov_6.625000	257	328	4	6	71	0.0845070
NODE_50144_length_467_cov_6.625000	257	328	8	3	71	0.0422535
NODE_50144_length_467_cov_6.625000	257	328	10	2	71	0.0281690
NODE_50144_length_467_cov_6.625000	257	328	14	14	71	0.1971831
NODE_50144_length_467_cov_6.625000	257	328	16	40	71	0.5633803
NODE_50144_length_467_cov_6.625000	257	328	18	6	71	0.0845070
NODE_50197_length_467_cov_2.709239	247	327	0	80	80	1.0000000
NODE_50215_length_467_cov_2.296196	284	329	0	45	45	1.0000000
NODE_50238_length_467_cov_2.027174	218	269	0	51	51	1.0000000
NODE_50252_length_467_cov_1.836957	55	118	5	63	63	1.0000000
NODE_50267_length_467_cov_1.603261	92	141	2	49	49	1.0000000
NODE_50283_length_467_cov_1.426630	135	183	4	48	48	1.0000000
NODE_50447_length_466_cov_42.839237	0	47	0	47	47	1.0000000
NODE_50447_length_466_cov_42.839237	20	100	0	80	80	1.0000000
NODE_50447_length_466_cov_42.839237	96	176	0	80	80	1.0000000
NODE_50447_length_466_cov_42.839237	149	229	0	80	80	1.0000000
NODE_50448_length_466_cov_36.901907	85	165	2	9	80	0.1125000
NODE_50448_length_466_cov_36.901907	85	165	4	44	80	0.5500000
NODE_50448_length_466_cov_36.901907	85	165	6	27	80	0.3375000
NODE_50448_length_466_cov_36.901907	138	218	0	22	80	0.2750000
NODE_50448_length_466_cov_36.901907	138	218	2	40	80	0.5000000
NODE_50448_length_466_cov_36.901907	138	218	4	18	80	0.2250000
NODE_50448_length_466_cov_36.901907	214	294	0	64	80	0.8000000
NODE_50448_length_466_cov_36.901907	214	294	2	2	80	0.0250000
NODE_50448_length_466_cov_36.901907	214	294	6	14	80	0.1750000
NODE_50448_length_466_cov_36.901907	267	347	0	11	80	0.1375000
NODE_50448_length_466_cov_36.901907	267	347	2	2	80	0.0250000
NODE_50448_length_466_cov_36.901907	267	347	6	67	80	0.8375000
NODE_50457_length_466_cov_5.122616	275	316	0	41	41	1.0000000
NODE_50457_length_466_cov_5.122616	276	316	0	40	40	1.0000000
NODE_50457_length_466_cov_5.122616	289	338	0	49	49	1.0000000
NODE_50515_length_466_cov_2.602180	9	90	1	1	81	0.0123457
NODE_50515_length_466_cov_2.602180	9	90	2	12	81	0.1481481
NODE_50515_length_466_cov_2.602180	9	90	4	68	81	0.8395061
NODE_50515_length_466_cov_2.602180	312	341	2	28	29	0.9655172
NODE_50515_length_466_cov_2.602180	312	341	4	1	29	0.0344828
NODE_50549_length_466_cov_2.108992	130	182	4	33	52	0.6346154
NODE_50549_length_466_cov_2.108992	130	182	6	19	52	0.3653846
NODE_50562_length_466_cov_1.980926	183	265	0	82	82	1.0000000
NODE_50787_length_465_cov_13.019126	170	250	0	27	80	0.3375000
NODE_50787_length_465_cov_13.019126	170	250	6	53	80	0.6625000
NODE_50787_length_465_cov_13.019126	223	301	0	13	78	0.1666667
NODE_50787_length_465_cov_13.019126	223	301	2	6	78	0.0769231
NODE_50787_length_465_cov_13.019126	223	301	4	4	78	0.0512821
NODE_50787_length_465_cov_13.019126	223	301	6	55	78	0.7051282
NODE_50799_length_465_cov_5.363388	316	393	0	77	77	1.0000000
NODE_50800_length_465_cov_4.898907	376	406	0	30	30	1.0000000
NODE_50869_length_465_cov_2.366120	147	227	0	80	80	1.0000000
NODE_50869_length_465_cov_2.366120	200	271	0	71	71	1.0000000
NODE_50911_length_465_cov_1.737705	338	383	10	26	45	0.5777778
NODE_50911_length_465_cov_1.737705	338	383	14	19	45	0.4222222
NODE_51100_length_464_cov_8.473973	209	289	2	18	80	0.2250000
NODE_51100_length_464_cov_8.473973	209	289	4	30	80	0.3750000
NODE_51100_length_464_cov_8.473973	209	289	6	32	80	0.4000000
NODE_51100_length_464_cov_8.473973	262	342	0	15	80	0.1875000
NODE_51100_length_464_cov_8.473973	262	342	2	23	80	0.2875000
NODE_51100_length_464_cov_8.473973	262	342	4	42	80	0.5250000
NODE_51148_length_464_cov_2.528767	136	199	0	63	63	1.0000000
NODE_51167_length_464_cov_2.134247	130	203	2	9	73	0.1232877
NODE_51167_length_464_cov_2.134247	130	203	4	64	73	0.8767123
NODE_51186_length_464_cov_1.901370	58	138	0	72	80	0.9000000
NODE_51186_length_464_cov_1.901370	58	138	2	8	80	0.1000000
NODE_51203_length_464_cov_1.706849	186	265	4	79	79	1.0000000
NODE_51377_length_463_cov_64.420330	375	455	0	7	80	0.0875000
NODE_51377_length_463_cov_64.420330	375	455	6	5	80	0.0625000
NODE_51377_length_463_cov_64.420330	375	455	10	5	80	0.0625000
NODE_51377_length_463_cov_64.420330	375	455	12	31	80	0.3875000
NODE_51377_length_463_cov_64.420330	375	455	19	26	80	0.3250000
NODE_51377_length_463_cov_64.420330	375	455	22	1	80	0.0125000
NODE_51377_length_463_cov_64.420330	375	455	23	5	80	0.0625000
NODE_51377_length_463_cov_64.420330	375	455	0	7	80	0.0875000
NODE_51377_length_463_cov_64.420330	375	455	6	5	80	0.0625000
NODE_51377_length_463_cov_64.420330	375	455	10	5	80	0.0625000
NODE_51377_length_463_cov_64.420330	375	455	12	31	80	0.3875000
NODE_51377_length_463_cov_64.420330	375	455	19	26	80	0.3250000
NODE_51377_length_463_cov_64.420330	375	455	22	1	80	0.0125000
NODE_51377_length_463_cov_64.420330	375	455	23	5	80	0.0625000
NODE_51377_length_463_cov_64.420330	375	455	0	7	80	0.0875000
NODE_51377_length_463_cov_64.420330	375	455	6	5	80	0.0625000
NODE_51377_length_463_cov_64.420330	375	455	10	5	80	0.0625000
NODE_51377_length_463_cov_64.420330	375	455	12	31	80	0.3875000
NODE_51377_length_463_cov_64.420330	375	455	19	26	80	0.3250000
NODE_51377_length_463_cov_64.420330	375	455	22	1	80	0.0125000
NODE_51377_length_463_cov_64.420330	375	455	23	5	80	0.0625000
NODE_51377_length_463_cov_64.420330	375	455	0	7	80	0.0875000
NODE_51377_length_463_cov_64.420330	375	455	6	5	80	0.0625000
NODE_51377_length_463_cov_64.420330	375	455	10	5	80	0.0625000
NODE_51377_length_463_cov_64.420330	375	455	12	31	80	0.3875000
NODE_51377_length_463_cov_64.420330	375	455	19	26	80	0.3250000
NODE_51377_length_463_cov_64.420330	375	455	22	1	80	0.0125000
NODE_51377_length_463_cov_64.420330	375	455	23	5	80	0.0625000
NODE_51377_length_463_cov_64.420330	375	455	0	7	80	0.0875000
NODE_51377_length_463_cov_64.420330	375	455	6	5	80	0.0625000
NODE_51377_length_463_cov_64.420330	375	455	10	5	80	0.0625000
NODE_51377_length_463_cov_64.420330	375	455	12	31	80	0.3875000
NODE_51377_length_463_cov_64.420330	375	455	19	26	80	0.3250000
NODE_51377_length_463_cov_64.420330	375	455	22	1	80	0.0125000
NODE_51377_length_463_cov_64.420330	375	455	23	5	80	0.0625000
NODE_51378_length_463_cov_49.673077	0	71	0	33	71	0.4647887
NODE_51378_length_463_cov_49.673077	0	71	2	6	71	0.0845070
NODE_51378_length_463_cov_49.673077	0	71	6	15	71	0.2112676
NODE_51378_length_463_cov_49.673077	0	71	12	4	71	0.0563380
NODE_51378_length_463_cov_49.673077	0	71	13	3	71	0.0422535
NODE_51378_length_463_cov_49.673077	0	71	17	2	71	0.0281690
NODE_51378_length_463_cov_49.673077	0	71	20	8	71	0.1126761
NODE_51378_length_463_cov_49.673077	44	121	6	10	77	0.1298701
NODE_51378_length_463_cov_49.673077	44	121	12	4	77	0.0519481
NODE_51378_length_463_cov_49.673077	44	121	13	3	77	0.0389610
NODE_51378_length_463_cov_49.673077	44	121	17	2	77	0.0259740
NODE_51378_length_463_cov_49.673077	44	121	20	12	77	0.1558442
NODE_51378_length_463_cov_49.673077	44	121	25	11	77	0.1428571
NODE_51378_length_463_cov_49.673077	44	121	27	7	77	0.0909091
NODE_51378_length_463_cov_49.673077	44	121	28	7	77	0.0909091
NODE_51378_length_463_cov_49.673077	44	121	30	11	77	0.1428571
NODE_51378_length_463_cov_49.673077	44	121	32	10	77	0.1298701
NODE_51379_length_463_cov_41.005495	8	88	0	22	80	0.2750000
NODE_51379_length_463_cov_41.005495	8	88	4	4	80	0.0500000
NODE_51379_length_463_cov_41.005495	8	88	10	2	80	0.0250000
NODE_51379_length_463_cov_41.005495	8	88	12	52	80	0.6500000
NODE_51379_length_463_cov_41.005495	61	141	10	25	80	0.3125000
NODE_51379_length_463_cov_41.005495	61	141	12	55	80	0.6875000
NODE_51380_length_463_cov_30.626374	318	398	0	80	80	1.0000000
NODE_51380_length_463_cov_30.626374	371	451	0	80	80	1.0000000
NODE_51381_length_463_cov_27.475275	211	291	2	42	80	0.5250000
NODE_51381_length_463_cov_27.475275	211	291	4	38	80	0.4750000
NODE_51381_length_463_cov_27.475275	264	344	0	36	80	0.4500000
NODE_51381_length_463_cov_27.475275	264	344	2	44	80	0.5500000
NODE_51383_length_463_cov_11.211538	304	377	0	5	73	0.0684932
NODE_51383_length_463_cov_11.211538	304	377	6	9	73	0.1232877
NODE_51383_length_463_cov_11.211538	304	377	10	59	73	0.8082192
NODE_51383_length_463_cov_11.211538	350	430	0	58	80	0.7250000
NODE_51383_length_463_cov_11.211538	350	430	6	9	80	0.1125000
NODE_51383_length_463_cov_11.211538	350	430	10	13	80	0.1625000
NODE_51391_length_463_cov_5.711538	181	261	0	80	80	1.0000000
NODE_51391_length_463_cov_5.711538	234	314	0	80	80	1.0000000
NODE_51399_length_463_cov_4.398352	119	169	0	50	50	1.0000000
NODE_51402_length_463_cov_4.186813	175	233	9	23	58	0.3965517
NODE_51402_length_463_cov_4.186813	175	233	10	26	58	0.4482759
NODE_51402_length_463_cov_4.186813	175	233	12	9	58	0.1551724
NODE_51402_length_463_cov_4.186813	206	251	6	11	45	0.2444444
NODE_51402_length_463_cov_4.186813	206	251	8	4	45	0.0888889
NODE_51402_length_463_cov_4.186813	206	251	9	26	45	0.5777778
NODE_51402_length_463_cov_4.186813	206	251	10	4	45	0.0888889
NODE_51408_length_463_cov_3.846154	235	268	4	33	33	1.0000000
NODE_51421_length_463_cov_3.063187	193	248	0	37	55	0.6727273
NODE_51421_length_463_cov_3.063187	193	248	8	18	55	0.3272727
NODE_51421_length_463_cov_3.063187	222	301	0	8	79	0.1012658
NODE_51421_length_463_cov_3.063187	222	301	8	71	79	0.8987342
NODE_51680_length_462_cov_21.876033	93	173	0	80	80	1.0000000
NODE_51680_length_462_cov_21.876033	146	226	0	80	80	1.0000000
NODE_51687_length_462_cov_5.033058	93	154	0	61	61	1.0000000
NODE_51687_length_462_cov_5.033058	159	209	0	50	50	1.0000000
NODE_51699_length_462_cov_4.101928	168	246	0	78	78	1.0000000
NODE_51699_length_462_cov_4.101928	184	208	0	24	24	1.0000000
NODE_51699_length_462_cov_4.101928	219	299	0	80	80	1.0000000
NODE_51708_length_462_cov_3.630854	149	194	0	24	45	0.5333334
NODE_51708_length_462_cov_3.630854	149	194	4	8	45	0.1777778
NODE_51708_length_462_cov_3.630854	149	194	6	13	45	0.2888889
NODE_51720_length_462_cov_3.079890	103	147	2	17	44	0.3863636
NODE_51720_length_462_cov_3.079890	103	147	4	20	44	0.4545455
NODE_51720_length_462_cov_3.079890	103	147	6	7	44	0.1590909
NODE_51735_length_462_cov_2.677686	78	118	0	40	40	1.0000000
NODE_51763_length_462_cov_2.209366	18	58	0	40	40	1.0000000
NODE_51817_length_462_cov_1.570248	68	113	0	45	45	1.0000000
NODE_51995_length_461_cov_35.116022	0	79	0	79	79	1.0000000
NODE_51995_length_461_cov_35.116022	52	132	0	80	80	1.0000000
NODE_51996_length_461_cov_11.124309	77	157	0	50	80	0.6250000
NODE_51996_length_461_cov_11.124309	77	157	2	30	80	0.3750000
NODE_51996_length_461_cov_11.124309	130	210	0	26	80	0.3250000
NODE_51996_length_461_cov_11.124309	130	210	2	54	80	0.6750000
NODE_52010_length_461_cov_5.361878	246	322	0	44	76	0.5789474
NODE_52010_length_461_cov_5.361878	246	322	2	32	76	0.4210526
NODE_52018_length_461_cov_4.472376	268	333	0	65	65	1.0000000
NODE_52021_length_461_cov_4.168508	159	234	0	75	75	1.0000000
NODE_52047_length_461_cov_2.892265	233	312	0	60	79	0.7594936
NODE_52047_length_461_cov_2.892265	233	312	2	19	79	0.2405063
NODE_52073_length_461_cov_2.392265	186	223	0	27	37	0.7297297
NODE_52073_length_461_cov_2.392265	186	223	2	10	37	0.2702703
NODE_52154_length_461_cov_1.389503	283	349	0	66	66	1.0000000
NODE_52292_length_460_cov_172.986150	0	68	14	1	68	0.0147059
NODE_52292_length_460_cov_172.986150	0	68	18	1	68	0.0147059
NODE_52292_length_460_cov_172.986150	0	68	19	1	68	0.0147059
NODE_52292_length_460_cov_172.986150	0	68	23	1	68	0.0147059
NODE_52292_length_460_cov_172.986150	0	68	24	1	68	0.0147059
NODE_52292_length_460_cov_172.986150	0	68	27	1	68	0.0147059
NODE_52292_length_460_cov_172.986150	0	68	36	1	68	0.0147059
NODE_52292_length_460_cov_172.986150	0	68	41	1	68	0.0147059
NODE_52292_length_460_cov_172.986150	0	68	47	2	68	0.0294118
NODE_52292_length_460_cov_172.986150	0	68	69	1	68	0.0147059
NODE_52292_length_460_cov_172.986150	0	68	81	1	68	0.0147059
NODE_52292_length_460_cov_172.986150	0	68	96	1	68	0.0147059
NODE_52292_length_460_cov_172.986150	0	68	103	1	68	0.0147059
NODE_52292_length_460_cov_172.986150	0	68	106	1	68	0.0147059
NODE_52292_length_460_cov_172.986150	0	68	112	1	68	0.0147059
NODE_52292_length_460_cov_172.986150	0	68	128	1	68	0.0147059
NODE_52292_length_460_cov_172.986150	0	68	139	1	68	0.0147059
NODE_52292_length_460_cov_172.986150	0	68	148	1	68	0.0147059
NODE_52292_length_460_cov_172.986150	0	68	150	1	68	0.0147059
NODE_52292_length_460_cov_172.986150	0	68	165	1	68	0.0147059
NODE_52292_length_460_cov_172.986150	0	68	173	1	68	0.0147059
NODE_52292_length_460_cov_172.986150	0	68	175	1	68	0.0147059
NODE_52292_length_460_cov_172.986150	0	68	187	1	68	0.0147059
NODE_52292_length_460_cov_172.986150	0	68	191	1	68	0.0147059
NODE_52292_length_460_cov_172.986150	0	68	195	2	68	0.0294118
NODE_52292_length_460_cov_172.986150	0	68	207	1	68	0.0147059
NODE_52292_length_460_cov_172.986150	0	68	213	1	68	0.0147059
NODE_52292_length_460_cov_172.986150	0	68	223	1	68	0.0147059
NODE_52292_length_460_cov_172.986150	0	68	227	2	68	0.0294118
NODE_52292_length_460_cov_172.986150	0	68	233	2	68	0.0294118
NODE_52292_length_460_cov_172.986150	0	68	237	3	68	0.0441176
NODE_52292_length_460_cov_172.986150	0	68	247	2	68	0.0294118
NODE_52292_length_460_cov_172.986150	0	68	252	1	68	0.0147059
NODE_52292_length_460_cov_172.986150	0	68	256	2	68	0.0294118
NODE_52292_length_460_cov_172.986150	0	68	270	2	68	0.0294118
NODE_52292_length_460_cov_172.986150	0	68	272	2	68	0.0294118
NODE_52292_length_460_cov_172.986150	0	68	278	1	68	0.0147059
NODE_52292_length_460_cov_172.986150	0	68	286	1	68	0.0147059
NODE_52292_length_460_cov_172.986150	0	68	288	1	68	0.0147059
NODE_52292_length_460_cov_172.986150	0	68	292	1	68	0.0147059
NODE_52292_length_460_cov_172.986150	0	68	298	2	68	0.0294118
NODE_52292_length_460_cov_172.986150	0	68	308	6	68	0.0882353
NODE_52292_length_460_cov_172.986150	0	68	309	1	68	0.0147059
NODE_52292_length_460_cov_172.986150	0	68	313	1	68	0.0147059
NODE_52292_length_460_cov_172.986150	0	68	315	1	68	0.0147059
NODE_52292_length_460_cov_172.986150	0	68	317	4	68	0.0588235
NODE_52292_length_460_cov_172.986150	0	68	323	1	68	0.0147059
NODE_52292_length_460_cov_172.986150	0	68	326	2	68	0.0294118
NODE_52292_length_460_cov_172.986150	41	121	256	1	80	0.0125000
NODE_52292_length_460_cov_172.986150	41	121	270	2	80	0.0250000
NODE_52292_length_460_cov_172.986150	41	121	272	2	80	0.0250000
NODE_52292_length_460_cov_172.986150	41	121	278	1	80	0.0125000
NODE_52292_length_460_cov_172.986150	41	121	286	1	80	0.0125000
NODE_52292_length_460_cov_172.986150	41	121	288	1	80	0.0125000
NODE_52292_length_460_cov_172.986150	41	121	292	1	80	0.0125000
NODE_52292_length_460_cov_172.986150	41	121	298	2	80	0.0250000
NODE_52292_length_460_cov_172.986150	41	121	308	6	80	0.0750000
NODE_52292_length_460_cov_172.986150	41	121	309	1	80	0.0125000
NODE_52292_length_460_cov_172.986150	41	121	313	1	80	0.0125000
NODE_52292_length_460_cov_172.986150	41	121	315	1	80	0.0125000
NODE_52292_length_460_cov_172.986150	41	121	317	4	80	0.0500000
NODE_52292_length_460_cov_172.986150	41	121	323	1	80	0.0125000
NODE_52292_length_460_cov_172.986150	41	121	326	2	80	0.0250000
NODE_52292_length_460_cov_172.986150	41	121	328	1	80	0.0125000
NODE_52292_length_460_cov_172.986150	41	121	336	1	80	0.0125000
NODE_52292_length_460_cov_172.986150	41	121	338	3	80	0.0375000
NODE_52292_length_460_cov_172.986150	41	121	339	1	80	0.0125000
NODE_52292_length_460_cov_172.986150	41	121	341	2	80	0.0250000
NODE_52292_length_460_cov_172.986150	41	121	343	1	80	0.0125000
NODE_52292_length_460_cov_172.986150	41	121	345	2	80	0.0250000
NODE_52292_length_460_cov_172.986150	41	121	349	1	80	0.0125000
NODE_52292_length_460_cov_172.986150	41	121	353	1	80	0.0125000
NODE_52292_length_460_cov_172.986150	41	121	359	1	80	0.0125000
NODE_52292_length_460_cov_172.986150	41	121	361	1	80	0.0125000
NODE_52292_length_460_cov_172.986150	41	121	363	1	80	0.0125000
NODE_52292_length_460_cov_172.986150	41	121	374	6	80	0.0750000
NODE_52292_length_460_cov_172.986150	41	121	375	2	80	0.0250000
NODE_52292_length_460_cov_172.986150	41	121	377	1	80	0.0125000
NODE_52292_length_460_cov_172.986150	41	121	379	1	80	0.0125000
NODE_52292_length_460_cov_172.986150	41	121	381	1	80	0.0125000
NODE_52292_length_460_cov_172.986150	41	121	387	1	80	0.0125000
NODE_52292_length_460_cov_172.986150	41	121	396	1	80	0.0125000
NODE_52292_length_460_cov_172.986150	41	121	397	1	80	0.0125000
NODE_52292_length_460_cov_172.986150	41	121	399	1	80	0.0125000
NODE_52292_length_460_cov_172.986150	41	121	402	3	80	0.0375000
NODE_52292_length_460_cov_172.986150	41	121	405	1	80	0.0125000
NODE_52292_length_460_cov_172.986150	41	121	408	1	80	0.0125000
NODE_52292_length_460_cov_172.986150	41	121	414	2	80	0.0250000
NODE_52292_length_460_cov_172.986150	41	121	415	1	80	0.0125000
NODE_52292_length_460_cov_172.986150	41	121	417	2	80	0.0250000
NODE_52292_length_460_cov_172.986150	41	121	418	2	80	0.0250000
NODE_52292_length_460_cov_172.986150	41	121	419	1	80	0.0125000
NODE_52292_length_460_cov_172.986150	41	121	424	1	80	0.0125000
NODE_52292_length_460_cov_172.986150	41	121	426	1	80	0.0125000
NODE_52292_length_460_cov_172.986150	41	121	427	1	80	0.0125000
NODE_52292_length_460_cov_172.986150	41	121	433	1	80	0.0125000
NODE_52292_length_460_cov_172.986150	41	121	440	1	80	0.0125000
NODE_52292_length_460_cov_172.986150	41	121	444	1	80	0.0125000
NODE_52292_length_460_cov_172.986150	41	121	447	1	80	0.0125000
NODE_52292_length_460_cov_172.986150	41	121	450	2	80	0.0250000
NODE_52293_length_460_cov_62.512465	9	48	4	14	39	0.3589744
NODE_52293_length_460_cov_62.512465	9	48	6	9	39	0.2307692
NODE_52293_length_460_cov_62.512465	9	48	8	5	39	0.1282051
NODE_52293_length_460_cov_62.512465	9	48	10	11	39	0.2820513
NODE_52294_length_460_cov_33.146814	0	47	0	47	47	1.0000000
NODE_52294_length_460_cov_33.146814	43	115	0	72	72	1.0000000
NODE_52294_length_460_cov_33.146814	96	165	0	69	69	1.0000000
NODE_52295_length_460_cov_26.049861	0	63	4	4	63	0.0634921
NODE_52295_length_460_cov_26.049861	0	63	6	11	63	0.1746032
NODE_52295_length_460_cov_26.049861	0	63	8	8	63	0.1269841
NODE_52295_length_460_cov_26.049861	0	63	10	3	63	0.0476190
NODE_52295_length_460_cov_26.049861	0	63	12	8	63	0.1269841
NODE_52295_length_460_cov_26.049861	0	63	14	13	63	0.2063492
NODE_52295_length_460_cov_26.049861	0	63	30	1	63	0.0158730
NODE_52295_length_460_cov_26.049861	0	63	34	2	63	0.0317460
NODE_52295_length_460_cov_26.049861	0	63	38	8	63	0.1269841
NODE_52295_length_460_cov_26.049861	0	63	40	5	63	0.0793651
NODE_52296_length_460_cov_25.709141	246	326	0	80	80	1.0000000
NODE_52296_length_460_cov_25.709141	299	379	0	80	80	1.0000000
NODE_52297_length_460_cov_11.063712	273	353	0	40	80	0.5000000
NODE_52297_length_460_cov_11.063712	273	353	2	40	80	0.5000000
NODE_52297_length_460_cov_11.063712	326	406	0	7	80	0.0875000
NODE_52297_length_460_cov_11.063712	326	406	2	73	80	0.9125000
NODE_52303_length_460_cov_7.285319	172	250	0	78	78	1.0000000
NODE_52312_length_460_cov_5.163435	120	200	6	32	80	0.4000000
NODE_52312_length_460_cov_5.163435	120	200	8	2	80	0.0250000
NODE_52312_length_460_cov_5.163435	120	200	10	6	80	0.0750000
NODE_52312_length_460_cov_5.163435	120	200	11	40	80	0.5000000
NODE_52312_length_460_cov_5.163435	173	253	4	9	80	0.1125000
NODE_52312_length_460_cov_5.163435	173	253	6	18	80	0.2250000
NODE_52312_length_460_cov_5.163435	173	253	8	7	80	0.0875000
NODE_52312_length_460_cov_5.163435	173	253	11	32	80	0.4000000
NODE_52312_length_460_cov_5.163435	173	253	13	10	80	0.1250000
NODE_52312_length_460_cov_5.163435	173	253	14	4	80	0.0500000
NODE_52333_length_460_cov_3.457064	150	230	0	45	80	0.5625000
NODE_52333_length_460_cov_3.457064	150	230	2	35	80	0.4375000
NODE_52333_length_460_cov_3.457064	203	246	2	43	43	1.0000000
NODE_52339_length_460_cov_3.027701	167	230	0	32	63	0.5079365
NODE_52339_length_460_cov_3.027701	167	230	2	31	63	0.4920635
NODE_52347_length_460_cov_2.819945	195	266	0	71	71	1.0000000
NODE_52358_length_460_cov_2.626039	223	277	0	54	54	1.0000000
NODE_52612_length_459_cov_34.927778	165	239	0	66	74	0.8918919
NODE_52612_length_459_cov_34.927778	165	239	2	8	74	0.1081081
NODE_52612_length_459_cov_34.927778	212	292	0	80	80	1.0000000
NODE_52617_length_459_cov_7.261111	143	189	0	46	46	1.0000000
NODE_52617_length_459_cov_7.261111	162	242	0	80	80	1.0000000
NODE_52635_length_459_cov_4.127778	153	233	13	19	80	0.2375000
NODE_52635_length_459_cov_4.127778	153	233	14	61	80	0.7625000
NODE_52685_length_459_cov_2.158333	219	285	0	66	66	1.0000000
NODE_52685_length_459_cov_2.158333	283	342	0	59	59	1.0000000
NODE_52704_length_459_cov_1.722222	280	353	0	33	73	0.4520548
NODE_52704_length_459_cov_1.722222	280	353	1	1	73	0.0136986
NODE_52704_length_459_cov_1.722222	280	353	2	25	73	0.3424658
NODE_52704_length_459_cov_1.722222	280	353	4	14	73	0.1917808
NODE_52920_length_458_cov_71.047354	0	51	0	51	51	1.0000000
NODE_52920_length_458_cov_71.047354	24	104	0	80	80	1.0000000
NODE_52920_length_458_cov_71.047354	100	180	0	47	80	0.5875000
NODE_52920_length_458_cov_71.047354	100	180	2	1	80	0.0125000
NODE_52920_length_458_cov_71.047354	100	180	16	32	80	0.4000000
NODE_52920_length_458_cov_71.047354	153	233	13	4	80	0.0500000
NODE_52920_length_458_cov_71.047354	153	233	15	34	80	0.4250000
NODE_52920_length_458_cov_71.047354	153	233	16	42	80	0.5250000
NODE_52921_length_458_cov_47.966574	151	231	0	80	80	1.0000000
NODE_52921_length_458_cov_47.966574	204	284	0	80	80	1.0000000
NODE_52921_length_458_cov_47.966574	280	360	0	80	80	1.0000000
NODE_52921_length_458_cov_47.966574	333	413	0	80	80	1.0000000
NODE_52924_length_458_cov_9.935933	267	347	6	54	80	0.6750000
NODE_52924_length_458_cov_9.935933	267	347	8	26	80	0.3250000
NODE_52924_length_458_cov_9.935933	320	400	0	19	80	0.2375000
NODE_52924_length_458_cov_9.935933	320	400	2	24	80	0.3000000
NODE_52924_length_458_cov_9.935933	320	400	4	10	80	0.1250000
NODE_52924_length_458_cov_9.935933	320	400	6	16	80	0.2000000
NODE_52924_length_458_cov_9.935933	320	400	8	11	80	0.1375000
NODE_52929_length_458_cov_7.598886	87	167	2	50	80	0.6250000
NODE_52929_length_458_cov_7.598886	87	167	4	30	80	0.3750000
NODE_52967_length_458_cov_3.061281	62	91	0	29	29	1.0000000
NODE_52967_length_458_cov_3.061281	185	224	2	39	39	1.0000000
NODE_52992_length_458_cov_2.454039	210	251	2	41	41	1.0000000
NODE_53107_length_458_cov_1.139276	242	289	2	19	47	0.4042553
NODE_53107_length_458_cov_1.139276	242	289	4	13	47	0.2765957
NODE_53107_length_458_cov_1.139276	242	289	8	15	47	0.3191489
NODE_53107_length_458_cov_1.139276	262	328	2	7	66	0.1060606
NODE_53107_length_458_cov_1.139276	262	328	4	5	66	0.0757576
NODE_53107_length_458_cov_1.139276	262	328	6	1	66	0.0151515
NODE_53107_length_458_cov_1.139276	262	328	8	53	66	0.8030303
NODE_53205_length_457_cov_20.754190	123	203	2	39	80	0.4875000
NODE_53205_length_457_cov_20.754190	123	203	6	41	80	0.5125000
NODE_53205_length_457_cov_20.754190	176	256	4	48	80	0.6000000
NODE_53205_length_457_cov_20.754190	176	256	6	32	80	0.4000000
NODE_53207_length_457_cov_13.918994	218	298	0	80	80	1.0000000
NODE_53207_length_457_cov_13.918994	218	298	0	80	80	1.0000000
NODE_53207_length_457_cov_13.918994	218	298	0	80	80	1.0000000
NODE_53207_length_457_cov_13.918994	218	298	0	80	80	1.0000000
NODE_53207_length_457_cov_13.918994	271	320	0	49	49	1.0000000
NODE_53207_length_457_cov_13.918994	271	320	0	49	49	1.0000000
NODE_53207_length_457_cov_13.918994	271	320	0	49	49	1.0000000
NODE_53216_length_457_cov_6.050279	264	326	1	8	62	0.1290323
NODE_53216_length_457_cov_6.050279	264	326	5	6	62	0.0967742
NODE_53216_length_457_cov_6.050279	264	326	6	16	62	0.2580645
NODE_53216_length_457_cov_6.050279	264	326	8	2	62	0.0322581
NODE_53216_length_457_cov_6.050279	264	326	10	30	62	0.4838710
NODE_53220_length_457_cov_5.078212	71	149	0	78	78	1.0000000
NODE_53220_length_457_cov_5.078212	122	202	0	80	80	1.0000000
NODE_53225_length_457_cov_4.530726	193	273	0	39	80	0.4875000
NODE_53225_length_457_cov_4.530726	193	273	2	41	80	0.5125000
NODE_53225_length_457_cov_4.530726	246	315	2	69	69	1.0000000
NODE_53230_length_457_cov_3.986034	192	272	0	80	80	1.0000000
NODE_53267_length_457_cov_2.636872	117	197	2	1	80	0.0125000
NODE_53267_length_457_cov_2.636872	117	197	4	2	80	0.0250000
NODE_53267_length_457_cov_2.636872	117	197	8	55	80	0.6875000
NODE_53267_length_457_cov_2.636872	117	197	10	22	80	0.2750000
NODE_53462_length_457_cov_0.916201	108	188	0	80	80	1.0000000
NODE_53462_length_457_cov_0.916201	108	188	0	80	80	1.0000000
NODE_53462_length_457_cov_0.916201	161	241	0	80	80	1.0000000
NODE_53462_length_457_cov_0.916201	161	241	0	80	80	1.0000000
NODE_53512_length_456_cov_34.731092	0	63	0	63	63	1.0000000
NODE_53512_length_456_cov_34.731092	36	116	0	80	80	1.0000000
NODE_53512_length_456_cov_34.731092	112	194	0	18	82	0.2195122
NODE_53512_length_456_cov_34.731092	112	194	2	64	82	0.7804878
NODE_53532_length_456_cov_4.582633	269	349	0	80	80	1.0000000
NODE_53533_length_456_cov_4.554622	124	206	0	44	82	0.5365854
NODE_53533_length_456_cov_4.554622	124	206	2	38	82	0.4634146
NODE_53533_length_456_cov_4.554622	179	263	0	84	84	1.0000000
NODE_53546_length_456_cov_3.669468	123	186	2	15	63	0.2380952
NODE_53546_length_456_cov_3.669468	123	186	3	25	63	0.3968254
NODE_53546_length_456_cov_3.669468	123	186	4	21	63	0.3333333
NODE_53546_length_456_cov_3.669468	123	186	6	2	63	0.0317460
NODE_53566_length_456_cov_2.921569	302	362	0	60	60	1.0000000
NODE_53859_length_455_cov_113.589888	137	220	2	7	83	0.0843373
NODE_53859_length_455_cov_113.589888	137	220	6	23	83	0.2771084
NODE_53859_length_455_cov_113.589888	137	220	7	20	83	0.2409639
NODE_53859_length_455_cov_113.589888	137	220	8	33	83	0.3975904
NODE_53859_length_455_cov_113.589888	198	268	2	55	70	0.7857143
NODE_53859_length_455_cov_113.589888	198	268	8	15	70	0.2142857
NODE_53859_length_455_cov_113.589888	269	348	2	21	79	0.2658228
NODE_53859_length_455_cov_113.589888	269	348	6	11	79	0.1392405
NODE_53859_length_455_cov_113.589888	269	348	7	9	79	0.1139240
NODE_53859_length_455_cov_113.589888	269	348	8	38	79	0.4810127
NODE_53859_length_455_cov_113.589888	321	401	8	80	80	1.0000000
NODE_53860_length_455_cov_52.941011	260	340	0	31	80	0.3875000
NODE_53860_length_455_cov_52.941011	260	340	4	49	80	0.6125000
NODE_53860_length_455_cov_52.941011	313	393	0	80	80	1.0000000
NODE_53863_length_455_cov_8.584270	250	302	0	52	52	1.0000000
NODE_53863_length_455_cov_8.584270	275	355	0	80	80	1.0000000
NODE_53864_length_455_cov_8.084270	146	226	2	17	80	0.2125000
NODE_53864_length_455_cov_8.084270	146	226	4	9	80	0.1125000
NODE_53864_length_455_cov_8.084270	146	226	6	46	80	0.5750000
NODE_53864_length_455_cov_8.084270	146	226	8	8	80	0.1000000
NODE_53864_length_455_cov_8.084270	199	279	2	44	80	0.5500000
NODE_53864_length_455_cov_8.084270	199	279	4	35	80	0.4375000
NODE_53864_length_455_cov_8.084270	199	279	6	1	80	0.0125000
NODE_53870_length_455_cov_6.022472	122	203	0	35	81	0.4320988
NODE_53870_length_455_cov_6.022472	122	203	2	19	81	0.2345679
NODE_53870_length_455_cov_6.022472	122	203	4	27	81	0.3333333
NODE_53872_length_455_cov_5.140449	181	232	0	17	51	0.3333333
NODE_53872_length_455_cov_5.140449	181	232	4	8	51	0.1568628
NODE_53872_length_455_cov_5.140449	181	232	8	8	51	0.1568628
NODE_53872_length_455_cov_5.140449	181	232	10	18	51	0.3529412
NODE_54512_length_453_cov_29.528249	44	124	0	80	80	1.0000000
NODE_54512_length_453_cov_29.528249	97	177	0	80	80	1.0000000
NODE_54512_length_453_cov_29.528249	173	253	0	80	80	1.0000000
NODE_54512_length_453_cov_29.528249	226	301	0	39	75	0.5200000
NODE_54512_length_453_cov_29.528249	226	301	4	36	75	0.4800000
NODE_54513_length_453_cov_11.146893	95	140	0	45	45	1.0000000
NODE_54513_length_453_cov_11.146893	146	220	0	74	74	1.0000000
NODE_54517_length_453_cov_7.709040	194	252	2	12	58	0.2068966
NODE_54517_length_453_cov_7.709040	194	252	4	43	58	0.7413793
NODE_54517_length_453_cov_7.709040	194	252	6	3	58	0.0517241
NODE_54518_length_453_cov_7.440678	250	319	0	69	69	1.0000000
NODE_54533_length_453_cov_4.282486	190	270	4	80	80	1.0000000
NODE_54533_length_453_cov_4.282486	243	283	4	40	40	1.0000000
NODE_54566_length_453_cov_2.836158	186	266	0	16	80	0.2000000
NODE_54566_length_453_cov_2.836158	186	266	2	64	80	0.8000000
NODE_54566_length_453_cov_2.836158	239	319	0	13	80	0.1625000
NODE_54566_length_453_cov_2.836158	239	319	2	67	80	0.8375000
NODE_54592_length_453_cov_2.048023	139	174	8	14	35	0.4000000
NODE_54592_length_453_cov_2.048023	139	174	10	8	35	0.2285714
NODE_54592_length_453_cov_2.048023	139	174	14	13	35	0.3714286
NODE_54600_length_453_cov_2.002825	78	98	0	20	20	1.0000000
NODE_54767_length_453_cov_0.774011	174	195	0	21	21	1.0000000
NODE_54822_length_452_cov_36.028329	0	72	0	72	72	1.0000000
NODE_54822_length_452_cov_36.028329	0	72	0	72	72	1.0000000
NODE_54822_length_452_cov_36.028329	45	99	0	54	54	1.0000000
NODE_54822_length_452_cov_36.028329	45	125	0	80	80	1.0000000
NODE_54823_length_452_cov_17.424929	29	109	0	80	80	1.0000000
NODE_54823_length_452_cov_17.424929	82	162	0	80	80	1.0000000
NODE_54844_length_452_cov_4.317280	141	200	0	59	59	1.0000000
NODE_54886_length_452_cov_2.634561	262	338	2	6	76	0.0789474
NODE_54886_length_452_cov_2.634561	262	338	4	70	76	0.9210526
NODE_55146_length_451_cov_37.090909	230	310	1	2	80	0.0250000
NODE_55146_length_451_cov_37.090909	230	310	2	3	80	0.0375000
NODE_55146_length_451_cov_37.090909	230	310	5	17	80	0.2125000
NODE_55146_length_451_cov_37.090909	230	310	6	58	80	0.7250000
NODE_55146_length_451_cov_37.090909	283	363	1	37	80	0.4625000
NODE_55146_length_451_cov_37.090909	283	363	2	19	80	0.2375000
NODE_55146_length_451_cov_37.090909	283	363	6	24	80	0.3000000
NODE_55147_length_451_cov_16.517045	205	286	2	81	81	1.0000000
NODE_55147_length_451_cov_16.517045	259	339	0	22	80	0.2750000
NODE_55147_length_451_cov_16.517045	259	339	2	58	80	0.7250000
NODE_55148_length_451_cov_13.153409	182	262	0	29	80	0.3625000
NODE_55148_length_451_cov_13.153409	182	262	8	44	80	0.5500000
NODE_55148_length_451_cov_13.153409	182	262	10	7	80	0.0875000
NODE_55148_length_451_cov_13.153409	235	315	2	9	80	0.1125000
NODE_55148_length_451_cov_13.153409	235	315	8	20	80	0.2500000
NODE_55148_length_451_cov_13.153409	235	315	10	51	80	0.6375000
NODE_55149_length_451_cov_11.926136	141	221	0	80	80	1.0000000
NODE_55149_length_451_cov_11.926136	331	411	0	12	80	0.1500000
NODE_55149_length_451_cov_11.926136	331	411	4	5	80	0.0625000
NODE_55149_length_451_cov_11.926136	331	411	6	1	80	0.0125000
NODE_55149_length_451_cov_11.926136	331	411	10	17	80	0.2125000
NODE_55149_length_451_cov_11.926136	331	411	12	45	80	0.5625000
NODE_55154_length_451_cov_7.102273	81	143	0	62	62	1.0000000
NODE_55161_length_451_cov_5.610795	1	31	0	30	30	1.0000000
NODE_55161_length_451_cov_5.610795	60	90	0	30	30	1.0000000
NODE_55166_length_451_cov_5.065341	219	285	0	5	66	0.0757576
NODE_55166_length_451_cov_5.065341	219	285	2	61	66	0.9242424
NODE_55166_length_451_cov_5.065341	272	322	0	5	50	0.1000000
NODE_55166_length_451_cov_5.065341	272	322	2	30	50	0.6000000
NODE_55166_length_451_cov_5.065341	272	322	4	15	50	0.3000000
NODE_55184_length_451_cov_3.696023	253	332	8	17	79	0.2151899
NODE_55184_length_451_cov_3.696023	253	332	10	32	79	0.4050633
NODE_55184_length_451_cov_3.696023	253	332	12	23	79	0.2911392
NODE_55184_length_451_cov_3.696023	253	332	14	7	79	0.0886076
NODE_55188_length_451_cov_3.406250	176	247	4	7	71	0.0985916
NODE_55188_length_451_cov_3.406250	176	247	8	3	71	0.0422535
NODE_55188_length_451_cov_3.406250	176	247	12	7	71	0.0985916
NODE_55188_length_451_cov_3.406250	176	247	14	2	71	0.0281690
NODE_55188_length_451_cov_3.406250	176	247	16	2	71	0.0281690
NODE_55188_length_451_cov_3.406250	176	247	20	16	71	0.2253521
NODE_55188_length_451_cov_3.406250	176	247	22	34	71	0.4788733
NODE_55188_length_451_cov_3.406250	220	300	2	4	80	0.0500000
NODE_55188_length_451_cov_3.406250	220	300	4	6	80	0.0750000
NODE_55188_length_451_cov_3.406250	220	300	8	5	80	0.0625000
NODE_55188_length_451_cov_3.406250	220	300	10	2	80	0.0250000
NODE_55188_length_451_cov_3.406250	220	300	12	5	80	0.0625000
NODE_55188_length_451_cov_3.406250	220	300	14	5	80	0.0625000
NODE_55188_length_451_cov_3.406250	220	300	16	14	80	0.1750000
NODE_55188_length_451_cov_3.406250	220	300	18	1	80	0.0125000
NODE_55188_length_451_cov_3.406250	220	300	22	29	80	0.3625000
NODE_55188_length_451_cov_3.406250	220	300	24	9	80	0.1125000
NODE_55198_length_451_cov_3.025568	72	148	2	7	76	0.0921053
NODE_55198_length_451_cov_3.025568	72	148	3	10	76	0.1315790
NODE_55198_length_451_cov_3.025568	72	148	5	36	76	0.4736842
NODE_55198_length_451_cov_3.025568	72	148	6	23	76	0.3026316
NODE_55213_length_451_cov_2.607955	84	143	0	59	59	1.0000000
NODE_55213_length_451_cov_2.607955	257	326	0	69	69	1.0000000
NODE_55234_length_451_cov_2.125000	156	224	0	68	68	1.0000000
NODE_55436_length_450_cov_105.723647	317	386	0	67	69	0.9710145
NODE_55436_length_450_cov_105.723647	317	386	6	2	69	0.0289855
NODE_55438_length_450_cov_27.982906	98	120	2	22	22	1.0000000
NODE_55438_length_450_cov_27.982906	225	305	0	80	80	1.0000000
NODE_55438_length_450_cov_27.982906	278	358	0	80	80	1.0000000
NODE_55459_length_450_cov_3.991453	220	290	0	70	70	1.0000000
NODE_55459_length_450_cov_3.991453	223	290	0	67	67	1.0000000
NODE_55459_length_450_cov_3.991453	268	348	0	80	80	1.0000000
NODE_55459_length_450_cov_3.991453	268	348	0	80	80	1.0000000
NODE_55459_length_450_cov_3.991453	278	348	0	70	70	1.0000000
NODE_55459_length_450_cov_3.991453	344	363	0	19	19	1.0000000
NODE_55466_length_450_cov_3.717949	107	177	0	70	70	1.0000000
NODE_55483_length_450_cov_3.162393	99	157	0	58	58	1.0000000
NODE_55550_length_450_cov_1.857550	114	172	0	1	58	0.0172414
NODE_55550_length_450_cov_1.857550	114	172	4	3	58	0.0517241
NODE_55550_length_450_cov_1.857550	114	172	8	1	58	0.0172414
NODE_55550_length_450_cov_1.857550	114	172	10	10	58	0.1724138
NODE_55550_length_450_cov_1.857550	114	172	14	12	58	0.2068966
NODE_55550_length_450_cov_1.857550	114	172	16	9	58	0.1551724
NODE_55550_length_450_cov_1.857550	114	172	20	3	58	0.0517241
NODE_55550_length_450_cov_1.857550	114	172	22	19	58	0.3275862
NODE_55560_length_450_cov_1.749288	321	376	0	27	55	0.4909091
NODE_55560_length_450_cov_1.749288	321	376	4	28	55	0.5090909
NODE_55565_length_450_cov_1.723647	101	161	11	15	60	0.2500000
NODE_55565_length_450_cov_1.723647	101	161	13	1	60	0.0166667
NODE_55565_length_450_cov_1.723647	101	161	17	9	60	0.1500000
NODE_55565_length_450_cov_1.723647	101	161	19	11	60	0.1833333
NODE_55565_length_450_cov_1.723647	101	161	21	24	60	0.4000000
NODE_55685_length_450_cov_1.017094	116	196	0	80	80	1.0000000
NODE_55761_length_449_cov_46.882857	237	317	0	80	80	1.0000000
NODE_55761_length_449_cov_46.882857	290	370	0	48	80	0.6000000
NODE_55761_length_449_cov_46.882857	290	370	2	32	80	0.4000000
NODE_55762_length_449_cov_36.031429	238	318	15	21	80	0.2625000
NODE_55762_length_449_cov_36.031429	238	318	16	16	80	0.2000000
NODE_55762_length_449_cov_36.031429	238	318	17	43	80	0.5375000
NODE_55762_length_449_cov_36.031429	291	371	0	10	80	0.1250000
NODE_55762_length_449_cov_36.031429	291	371	14	1	80	0.0125000
NODE_55762_length_449_cov_36.031429	291	371	15	38	80	0.4750000
NODE_55762_length_449_cov_36.031429	291	371	16	31	80	0.3875000
NODE_55783_length_449_cov_4.594286	137	184	4	9	47	0.1914894
NODE_55783_length_449_cov_4.594286	137	184	6	2	47	0.0425532
NODE_55783_length_449_cov_4.594286	137	184	8	36	47	0.7659575
NODE_55794_length_449_cov_3.797143	204	284	0	30	80	0.3750000
NODE_55794_length_449_cov_3.797143	204	284	2	50	80	0.6250000
NODE_55844_length_449_cov_2.445714	346	376	0	30	30	1.0000000
NODE_56144_length_448_cov_44.664756	126	206	0	67	80	0.8375000
NODE_56144_length_448_cov_44.664756	126	206	4	13	80	0.1625000
NODE_56144_length_448_cov_44.664756	179	259	0	14	80	0.1750000
NODE_56144_length_448_cov_44.664756	179	259	4	66	80	0.8250000
NODE_56145_length_448_cov_36.148997	195	275	2	26	80	0.3250000
NODE_56145_length_448_cov_36.148997	195	275	4	2	80	0.0250000
NODE_56145_length_448_cov_36.148997	195	275	6	2	80	0.0250000
NODE_56145_length_448_cov_36.148997	195	275	15	7	80	0.0875000
NODE_56145_length_448_cov_36.148997	195	275	17	1	80	0.0125000
NODE_56145_length_448_cov_36.148997	195	275	21	9	80	0.1125000
NODE_56145_length_448_cov_36.148997	195	275	23	9	80	0.1125000
NODE_56145_length_448_cov_36.148997	195	275	24	1	80	0.0125000
NODE_56145_length_448_cov_36.148997	195	275	30	23	80	0.2875000
NODE_56145_length_448_cov_36.148997	248	328	16	11	80	0.1375000
NODE_56145_length_448_cov_36.148997	248	328	18	1	80	0.0125000
NODE_56145_length_448_cov_36.148997	248	328	22	6	80	0.0750000
NODE_56145_length_448_cov_36.148997	248	328	23	3	80	0.0375000
NODE_56145_length_448_cov_36.148997	248	328	24	1	80	0.0125000
NODE_56145_length_448_cov_36.148997	248	328	26	29	80	0.3625000
NODE_56145_length_448_cov_36.148997	248	328	28	2	80	0.0250000
NODE_56145_length_448_cov_36.148997	248	328	30	27	80	0.3375000
NODE_56145_length_448_cov_36.148997	324	404	4	2	80	0.0250000
NODE_56145_length_448_cov_36.148997	324	404	10	2	80	0.0250000
NODE_56145_length_448_cov_36.148997	324	404	11	24	80	0.3000000
NODE_56145_length_448_cov_36.148997	324	404	12	1	80	0.0125000
NODE_56145_length_448_cov_36.148997	324	404	16	18	80	0.2250000
NODE_56145_length_448_cov_36.148997	324	404	17	1	80	0.0125000
NODE_56145_length_448_cov_36.148997	324	404	18	32	80	0.4000000
NODE_56145_length_448_cov_36.148997	377	448	0	23	71	0.3239437
NODE_56145_length_448_cov_36.148997	377	448	1	1	71	0.0140845
NODE_56145_length_448_cov_36.148997	377	448	2	12	71	0.1690141
NODE_56145_length_448_cov_36.148997	377	448	4	10	71	0.1408451
NODE_56145_length_448_cov_36.148997	377	448	10	2	71	0.0281690
NODE_56145_length_448_cov_36.148997	377	448	11	23	71	0.3239437
NODE_56146_length_448_cov_31.816619	43	123	0	4	80	0.0500000
NODE_56146_length_448_cov_31.816619	43	123	2	1	80	0.0125000
NODE_56146_length_448_cov_31.816619	43	123	4	75	80	0.9375000
NODE_56151_length_448_cov_6.779370	197	277	2	23	80	0.2875000
NODE_56151_length_448_cov_6.779370	197	277	4	29	80	0.3625000
NODE_56151_length_448_cov_6.779370	197	277	6	28	80	0.3500000
NODE_56151_length_448_cov_6.779370	250	313	2	3	63	0.0476190
NODE_56151_length_448_cov_6.779370	250	313	4	36	63	0.5714286
NODE_56151_length_448_cov_6.779370	250	313	6	24	63	0.3809524
NODE_56180_length_448_cov_3.664756	148	189	0	41	41	1.0000000
NODE_56189_length_448_cov_3.108883	242	324	0	82	82	1.0000000
NODE_56233_length_448_cov_2.263610	292	360	0	68	68	1.0000000
NODE_56518_length_447_cov_10.505747	205	234	2	29	29	1.0000000
NODE_56518_length_447_cov_10.505747	267	326	0	59	59	1.0000000
NODE_56518_length_447_cov_10.505747	299	379	0	80	80	1.0000000
NODE_56527_length_447_cov_5.767241	176	256	2	15	80	0.1875000
NODE_56527_length_447_cov_5.767241	176	256	4	65	80	0.8125000
NODE_56527_length_447_cov_5.767241	229	309	0	44	80	0.5500000
NODE_56527_length_447_cov_5.767241	229	309	2	24	80	0.3000000
NODE_56527_length_447_cov_5.767241	229	309	4	12	80	0.1500000
NODE_56539_length_447_cov_4.583333	265	289	0	24	24	1.0000000
NODE_56545_length_447_cov_4.037356	58	138	0	80	80	1.0000000
NODE_56545_length_447_cov_4.037356	111	191	0	80	80	1.0000000
NODE_56890_length_446_cov_42.527378	239	310	12	15	71	0.2112676
NODE_56890_length_446_cov_42.527378	239	310	16	11	71	0.1549296
NODE_56890_length_446_cov_42.527378	239	310	18	5	71	0.0704225
NODE_56890_length_446_cov_42.527378	239	310	22	14	71	0.1971831
NODE_56890_length_446_cov_42.527378	239	310	24	5	71	0.0704225
NODE_56890_length_446_cov_42.527378	239	310	33	7	71	0.0985916
NODE_56890_length_446_cov_42.527378	239	310	34	6	71	0.0845070
NODE_56890_length_446_cov_42.527378	239	310	35	1	71	0.0140845
NODE_56890_length_446_cov_42.527378	239	310	36	3	71	0.0422535
NODE_56890_length_446_cov_42.527378	239	310	37	4	71	0.0563380
NODE_56890_length_446_cov_42.527378	359	433	2	7	74	0.0945946
NODE_56890_length_446_cov_42.527378	359	433	14	8	74	0.1081081
NODE_56890_length_446_cov_42.527378	359	433	18	13	74	0.1756757
NODE_56890_length_446_cov_42.527378	359	433	20	29	74	0.3918919
NODE_56890_length_446_cov_42.527378	359	433	22	17	74	0.2297297
NODE_56891_length_446_cov_12.749280	92	172	0	32	80	0.4000000
NODE_56891_length_446_cov_12.749280	92	172	4	48	80	0.6000000
NODE_56891_length_446_cov_12.749280	145	225	0	17	80	0.2125000
NODE_56891_length_446_cov_12.749280	145	225	4	63	80	0.7875000
NODE_56896_length_446_cov_6.902017	175	217	0	42	42	1.0000000
NODE_56902_length_446_cov_5.930836	165	245	0	80	80	1.0000000
NODE_56902_length_446_cov_5.930836	165	245	0	80	80	1.0000000
NODE_56902_length_446_cov_5.930836	165	235	0	70	70	1.0000000
NODE_56902_length_446_cov_5.930836	218	298	0	80	80	1.0000000
NODE_56902_length_446_cov_5.930836	218	297	0	79	79	1.0000000
NODE_56919_length_446_cov_3.896254	215	274	6	26	59	0.4406780
NODE_56919_length_446_cov_3.896254	215	274	8	12	59	0.2033898
NODE_56919_length_446_cov_3.896254	215	274	12	21	59	0.3559322
NODE_56934_length_446_cov_3.282421	130	168	0	22	38	0.5789474
NODE_56934_length_446_cov_3.282421	130	168	2	16	38	0.4210526
NODE_56952_length_446_cov_2.775216	337	417	0	1	80	0.0125000
NODE_56952_length_446_cov_2.775216	337	417	2	16	80	0.2000000
NODE_56952_length_446_cov_2.775216	337	417	4	63	80	0.7875000
NODE_56995_length_446_cov_2.161383	17	97	0	80	80	1.0000000
NODE_57022_length_446_cov_1.907781	196	225	1	29	29	1.0000000
NODE_57277_length_445_cov_75.572254	108	188	0	80	80	1.0000000
NODE_57277_length_445_cov_75.572254	161	241	0	80	80	1.0000000
NODE_57277_length_445_cov_75.572254	237	317	0	80	80	1.0000000
NODE_57277_length_445_cov_75.572254	290	370	0	80	80	1.0000000
NODE_57278_length_445_cov_33.973988	83	163	0	80	80	1.0000000
NODE_57278_length_445_cov_33.973988	136	216	0	80	80	1.0000000
NODE_57280_length_445_cov_9.323699	78	148	0	70	70	1.0000000
NODE_57280_length_445_cov_9.323699	121	201	0	80	80	1.0000000
NODE_57284_length_445_cov_6.439306	210	282	0	1	72	0.0138889
NODE_57284_length_445_cov_6.439306	210	282	2	71	72	0.9861111
NODE_57286_length_445_cov_5.479769	115	184	0	69	69	1.0000000
NODE_57286_length_445_cov_5.479769	157	237	0	80	80	1.0000000
NODE_57286_length_445_cov_5.479769	233	309	0	76	76	1.0000000
NODE_57286_length_445_cov_5.479769	286	309	0	23	23	1.0000000
NODE_57345_length_445_cov_2.843931	124	199	2	46	75	0.6133333
NODE_57345_length_445_cov_2.843931	124	199	4	29	75	0.3866667
NODE_57352_length_445_cov_2.682081	202	248	0	46	46	1.0000000
NODE_57400_length_445_cov_1.884393	252	332	0	51	80	0.6375000
NODE_57400_length_445_cov_1.884393	252	332	2	29	80	0.3625000
NODE_57409_length_445_cov_1.783237	132	203	0	71	71	1.0000000
NODE_57409_length_445_cov_1.783237	256	331	0	37	75	0.4933333
NODE_57409_length_445_cov_1.783237	256	331	2	38	75	0.5066667
NODE_57409_length_445_cov_1.783237	256	278	0	22	22	1.0000000
NODE_57644_length_444_cov_34.075362	243	323	0	80	80	1.0000000
NODE_57644_length_444_cov_34.075362	296	376	0	80	80	1.0000000
NODE_57645_length_444_cov_22.524638	98	178	0	80	80	1.0000000
NODE_57645_length_444_cov_22.524638	151	231	0	80	80	1.0000000
NODE_57646_length_444_cov_16.544928	263	343	0	51	80	0.6375000
NODE_57646_length_444_cov_16.544928	263	343	2	29	80	0.3625000
NODE_57646_length_444_cov_16.544928	316	396	0	80	80	1.0000000
NODE_57647_length_444_cov_12.684058	293	373	0	3	80	0.0375000
NODE_57647_length_444_cov_12.684058	293	373	2	46	80	0.5750000
NODE_57647_length_444_cov_12.684058	293	373	4	31	80	0.3875000
NODE_57647_length_444_cov_12.684058	346	426	0	56	80	0.7000000
NODE_57647_length_444_cov_12.684058	346	426	2	24	80	0.3000000
NODE_57649_length_444_cov_9.284058	176	256	0	80	80	1.0000000
NODE_57649_length_444_cov_9.284058	229	309	0	80	80	1.0000000
NODE_57666_length_444_cov_5.159420	170	241	0	71	71	1.0000000
NODE_57668_length_444_cov_5.060870	201	245	0	1	44	0.0227273
NODE_57668_length_444_cov_5.060870	201	245	2	43	44	0.9772727
NODE_57668_length_444_cov_5.060870	218	298	0	35	80	0.4375000
NODE_57668_length_444_cov_5.060870	218	298	2	45	80	0.5625000
NODE_57717_length_444_cov_2.744928	73	136	2	6	63	0.0952381
NODE_57717_length_444_cov_2.744928	73	136	4	24	63	0.3809524
NODE_57717_length_444_cov_2.744928	73	136	6	3	63	0.0476190
NODE_57717_length_444_cov_2.744928	73	136	8	4	63	0.0634921
NODE_57717_length_444_cov_2.744928	73	136	10	2	63	0.0317460
NODE_57717_length_444_cov_2.744928	73	136	12	24	63	0.3809524
NODE_57770_length_444_cov_2.028986	46	113	24	1	67	0.0149254
NODE_57770_length_444_cov_2.028986	46	113	26	2	67	0.0298507
NODE_57770_length_444_cov_2.028986	46	113	28	2	67	0.0298507
NODE_57770_length_444_cov_2.028986	46	113	30	1	67	0.0149254
NODE_57770_length_444_cov_2.028986	46	113	32	1	67	0.0149254
NODE_57770_length_444_cov_2.028986	46	113	36	2	67	0.0298507
NODE_57770_length_444_cov_2.028986	46	113	38	1	67	0.0149254
NODE_57770_length_444_cov_2.028986	46	113	40	3	67	0.0447761
NODE_57770_length_444_cov_2.028986	46	113	42	4	67	0.0597015
NODE_57770_length_444_cov_2.028986	46	113	44	3	67	0.0447761
NODE_57770_length_444_cov_2.028986	46	113	48	1	67	0.0149254
NODE_57770_length_444_cov_2.028986	46	113	50	2	67	0.0298507
NODE_57770_length_444_cov_2.028986	46	113	52	1	67	0.0149254
NODE_57770_length_444_cov_2.028986	46	113	60	2	67	0.0298507
NODE_57770_length_444_cov_2.028986	46	113	64	1	67	0.0149254
NODE_57770_length_444_cov_2.028986	46	113	68	2	67	0.0298507
NODE_57770_length_444_cov_2.028986	46	113	76	1	67	0.0149254
NODE_57770_length_444_cov_2.028986	46	113	78	5	67	0.0746269
NODE_57770_length_444_cov_2.028986	46	113	80	1	67	0.0149254
NODE_57770_length_444_cov_2.028986	46	113	86	1	67	0.0149254
NODE_57770_length_444_cov_2.028986	46	113	90	2	67	0.0298507
NODE_57770_length_444_cov_2.028986	46	113	96	1	67	0.0149254
NODE_57770_length_444_cov_2.028986	46	113	98	1	67	0.0149254
NODE_57770_length_444_cov_2.028986	46	113	108	2	67	0.0298507
NODE_57770_length_444_cov_2.028986	46	113	110	2	67	0.0298507
NODE_57770_length_444_cov_2.028986	46	113	112	1	67	0.0149254
NODE_57770_length_444_cov_2.028986	46	113	114	1	67	0.0149254
NODE_57770_length_444_cov_2.028986	46	113	116	2	67	0.0298507
NODE_57770_length_444_cov_2.028986	46	113	118	7	67	0.1044776
NODE_57770_length_444_cov_2.028986	46	113	122	1	67	0.0149254
NODE_57770_length_444_cov_2.028986	46	113	124	4	67	0.0597015
NODE_57770_length_444_cov_2.028986	46	113	126	3	67	0.0447761
NODE_57770_length_444_cov_2.028986	46	113	130	3	67	0.0447761
NODE_57770_length_444_cov_2.028986	86	166	78	1	80	0.0125000
NODE_57770_length_444_cov_2.028986	86	166	84	2	80	0.0250000
NODE_57770_length_444_cov_2.028986	86	166	86	1	80	0.0125000
NODE_57770_length_444_cov_2.028986	86	166	88	1	80	0.0125000
NODE_57770_length_444_cov_2.028986	86	166	92	1	80	0.0125000
NODE_57770_length_444_cov_2.028986	86	166	98	2	80	0.0250000
NODE_57770_length_444_cov_2.028986	86	166	102	5	80	0.0625000
NODE_57770_length_444_cov_2.028986	86	166	106	1	80	0.0125000
NODE_57770_length_444_cov_2.028986	86	166	108	4	80	0.0500000
NODE_57770_length_444_cov_2.028986	86	166	110	4	80	0.0500000
NODE_57770_length_444_cov_2.028986	86	166	112	3	80	0.0375000
NODE_57770_length_444_cov_2.028986	86	166	114	4	80	0.0500000
NODE_57770_length_444_cov_2.028986	86	166	116	3	80	0.0375000
NODE_57770_length_444_cov_2.028986	86	166	118	9	80	0.1125000
NODE_57770_length_444_cov_2.028986	86	166	120	1	80	0.0125000
NODE_57770_length_444_cov_2.028986	86	166	122	3	80	0.0375000
NODE_57770_length_444_cov_2.028986	86	166	124	8	80	0.1000000
NODE_57770_length_444_cov_2.028986	86	166	126	3	80	0.0375000
NODE_57770_length_444_cov_2.028986	86	166	128	5	80	0.0625000
NODE_57770_length_444_cov_2.028986	86	166	130	9	80	0.1125000
NODE_57770_length_444_cov_2.028986	86	166	131	1	80	0.0125000
NODE_57770_length_444_cov_2.028986	86	166	132	7	80	0.0875000
NODE_57770_length_444_cov_2.028986	86	166	134	2	80	0.0250000
NODE_57873_length_444_cov_1.234783	335	407	0	72	72	1.0000000
NODE_57892_length_444_cov_1.173913	7	87	6	19	80	0.2375000
NODE_57892_length_444_cov_1.173913	7	87	8	61	80	0.7625000
NODE_58026_length_443_cov_71.284884	209	289	4	11	80	0.1375000
NODE_58026_length_443_cov_71.284884	209	289	8	69	80	0.8625000
NODE_58026_length_443_cov_71.284884	262	342	4	28	80	0.3500000
NODE_58026_length_443_cov_71.284884	262	342	8	52	80	0.6500000
NODE_58026_length_443_cov_71.284884	338	418	0	58	80	0.7250000
NODE_58026_length_443_cov_71.284884	338	418	4	22	80	0.2750000
NODE_58026_length_443_cov_71.284884	391	443	0	52	52	1.0000000
NODE_58027_length_443_cov_68.973837	314	394	14	9	80	0.1125000
NODE_58027_length_443_cov_68.973837	314	394	16	6	80	0.0750000
NODE_58027_length_443_cov_68.973837	314	394	18	25	80	0.3125000
NODE_58027_length_443_cov_68.973837	314	394	22	40	80	0.5000000
NODE_58027_length_443_cov_68.973837	367	443	10	18	76	0.2368421
NODE_58027_length_443_cov_68.973837	367	443	14	25	76	0.3289474
NODE_58027_length_443_cov_68.973837	367	443	18	30	76	0.3947369
NODE_58027_length_443_cov_68.973837	367	443	22	3	76	0.0394737
NODE_58028_length_443_cov_61.116279	34	114	8	3	80	0.0375000
NODE_58028_length_443_cov_61.116279	34	114	9	15	80	0.1875000
NODE_58028_length_443_cov_61.116279	34	114	17	13	80	0.1625000
NODE_58028_length_443_cov_61.116279	34	114	19	5	80	0.0625000
NODE_58028_length_443_cov_61.116279	34	114	25	1	80	0.0125000
NODE_58028_length_443_cov_61.116279	34	114	33	1	80	0.0125000
NODE_58028_length_443_cov_61.116279	34	114	35	1	80	0.0125000
NODE_58028_length_443_cov_61.116279	34	114	39	9	80	0.1125000
NODE_58028_length_443_cov_61.116279	34	114	41	13	80	0.1625000
NODE_58028_length_443_cov_61.116279	34	114	43	19	80	0.2375000
NODE_58028_length_443_cov_61.116279	87	167	41	8	80	0.1000000
NODE_58028_length_443_cov_61.116279	87	167	43	24	80	0.3000000
NODE_58028_length_443_cov_61.116279	87	167	44	48	80	0.6000000
NODE_58041_length_443_cov_4.895349	127	207	2	13	80	0.1625000
NODE_58041_length_443_cov_4.895349	127	207	4	6	80	0.0750000
NODE_58041_length_443_cov_4.895349	127	207	6	61	80	0.7625000
NODE_58086_length_443_cov_2.581395	121	195	0	45	74	0.6081081
NODE_58086_length_443_cov_2.581395	121	195	2	29	74	0.3918919
NODE_58088_length_443_cov_2.508721	297	347	0	38	50	0.7600000
NODE_58088_length_443_cov_2.508721	297	347	2	12	50	0.2400000
NODE_58088_length_443_cov_2.508721	320	395	0	15	75	0.2000000
NODE_58088_length_443_cov_2.508721	320	395	2	60	75	0.8000000
NODE_58091_length_443_cov_2.456395	114	192	0	17	78	0.2179487
NODE_58091_length_443_cov_2.456395	114	192	2	61	78	0.7820513
NODE_58091_length_443_cov_2.456395	118	141	2	23	23	1.0000000
NODE_58237_length_443_cov_1.151163	144	224	0	5	80	0.0625000
NODE_58237_length_443_cov_1.151163	144	224	2	4	80	0.0500000
NODE_58237_length_443_cov_1.151163	144	224	4	1	80	0.0125000
NODE_58237_length_443_cov_1.151163	144	224	8	3	80	0.0375000
NODE_58237_length_443_cov_1.151163	144	224	10	5	80	0.0625000
NODE_58237_length_443_cov_1.151163	144	224	12	62	80	0.7750000
NODE_58321_length_443_cov_0.715116	52	104	0	52	52	1.0000000
NODE_58321_length_443_cov_0.715116	105	146	0	21	41	0.5121951
NODE_58321_length_443_cov_0.715116	105	146	2	20	41	0.4878049
NODE_58346_length_442_cov_42.956268	290	375	2	8	85	0.0941176
NODE_58346_length_442_cov_42.956268	290	375	4	6	85	0.0705882
NODE_58346_length_442_cov_42.956268	290	375	5	1	85	0.0117647
NODE_58346_length_442_cov_42.956268	290	375	6	3	85	0.0352941
NODE_58346_length_442_cov_42.956268	290	375	12	1	85	0.0117647
NODE_58346_length_442_cov_42.956268	290	375	16	1	85	0.0117647
NODE_58346_length_442_cov_42.956268	290	375	18	7	85	0.0823529
NODE_58346_length_442_cov_42.956268	290	375	19	4	85	0.0470588
NODE_58346_length_442_cov_42.956268	290	375	20	4	85	0.0470588
NODE_58346_length_442_cov_42.956268	290	375	21	2	85	0.0235294
NODE_58346_length_442_cov_42.956268	290	375	23	6	85	0.0705882
NODE_58346_length_442_cov_42.956268	290	375	25	10	85	0.1176471
NODE_58346_length_442_cov_42.956268	290	375	26	5	85	0.0588235
NODE_58346_length_442_cov_42.956268	290	375	27	27	85	0.3176471
NODE_58346_length_442_cov_42.956268	290	375	2	8	85	0.0941176
NODE_58346_length_442_cov_42.956268	290	375	4	6	85	0.0705882
NODE_58346_length_442_cov_42.956268	290	375	5	1	85	0.0117647
NODE_58346_length_442_cov_42.956268	290	375	6	3	85	0.0352941
NODE_58346_length_442_cov_42.956268	290	375	12	1	85	0.0117647
NODE_58346_length_442_cov_42.956268	290	375	16	1	85	0.0117647
NODE_58346_length_442_cov_42.956268	290	375	18	7	85	0.0823529
NODE_58346_length_442_cov_42.956268	290	375	19	4	85	0.0470588
NODE_58346_length_442_cov_42.956268	290	375	20	4	85	0.0470588
NODE_58346_length_442_cov_42.956268	290	375	21	2	85	0.0235294
NODE_58346_length_442_cov_42.956268	290	375	23	6	85	0.0705882
NODE_58346_length_442_cov_42.956268	290	375	25	10	85	0.1176471
NODE_58346_length_442_cov_42.956268	290	375	26	5	85	0.0588235
NODE_58346_length_442_cov_42.956268	290	375	27	27	85	0.3176471
NODE_58347_length_442_cov_24.093294	225	305	0	36	80	0.4500000
NODE_58347_length_442_cov_24.093294	225	305	2	39	80	0.4875000
NODE_58347_length_442_cov_24.093294	225	305	6	5	80	0.0625000
NODE_58347_length_442_cov_24.093294	278	358	0	14	80	0.1750000
NODE_58347_length_442_cov_24.093294	278	358	2	8	80	0.1000000
NODE_58347_length_442_cov_24.093294	278	358	6	58	80	0.7250000
NODE_58348_length_442_cov_8.956268	173	192	0	19	19	1.0000000
NODE_58361_length_442_cov_5.052478	213	293	0	80	80	1.0000000
NODE_58361_length_442_cov_5.052478	266	346	0	35	80	0.4375000
NODE_58361_length_442_cov_5.052478	266	346	2	45	80	0.5625000
NODE_58376_length_442_cov_3.871720	297	372	0	3	75	0.0400000
NODE_58376_length_442_cov_3.871720	297	372	2	5	75	0.0666667
NODE_58376_length_442_cov_3.871720	297	372	4	10	75	0.1333333
NODE_58376_length_442_cov_3.871720	297	372	6	19	75	0.2533333
NODE_58376_length_442_cov_3.871720	297	372	8	38	75	0.5066667
NODE_58376_length_442_cov_3.871720	360	413	6	31	53	0.5849057
NODE_58376_length_442_cov_3.871720	360	413	8	16	53	0.3018868
NODE_58376_length_442_cov_3.871720	360	413	10	6	53	0.1132075
NODE_58378_length_442_cov_3.804665	211	244	0	27	33	0.8181818
NODE_58378_length_442_cov_3.804665	211	244	2	3	33	0.0909091
NODE_58378_length_442_cov_3.804665	211	244	4	1	33	0.0303030
NODE_58378_length_442_cov_3.804665	211	244	10	1	33	0.0303030
NODE_58378_length_442_cov_3.804665	211	244	19	1	33	0.0303030
NODE_58405_length_442_cov_3.206997	149	217	8	28	68	0.4117647
NODE_58405_length_442_cov_3.206997	149	217	10	40	68	0.5882353
NODE_58438_length_442_cov_2.434402	203	274	31	5	71	0.0704225
NODE_58438_length_442_cov_2.434402	203	274	35	1	71	0.0140845
NODE_58438_length_442_cov_2.434402	203	274	36	2	71	0.0281690
NODE_58438_length_442_cov_2.434402	203	274	44	1	71	0.0140845
NODE_58438_length_442_cov_2.434402	203	274	46	7	71	0.0985916
NODE_58438_length_442_cov_2.434402	203	274	52	27	71	0.3802817
NODE_58438_length_442_cov_2.434402	203	274	54	3	71	0.0422535
NODE_58438_length_442_cov_2.434402	203	274	56	11	71	0.1549296
NODE_58438_length_442_cov_2.434402	203	274	57	1	71	0.0140845
NODE_58438_length_442_cov_2.434402	203	274	58	4	71	0.0563380
NODE_58438_length_442_cov_2.434402	203	274	60	6	71	0.0845070
NODE_58438_length_442_cov_2.434402	203	274	62	1	71	0.0140845
NODE_58438_length_442_cov_2.434402	203	274	68	1	71	0.0140845
NODE_58438_length_442_cov_2.434402	203	274	70	1	71	0.0140845
NODE_58438_length_442_cov_2.434402	247	327	52	10	80	0.1250000
NODE_58438_length_442_cov_2.434402	247	327	54	3	80	0.0375000
NODE_58438_length_442_cov_2.434402	247	327	57	1	80	0.0125000
NODE_58438_length_442_cov_2.434402	247	327	58	4	80	0.0500000
NODE_58438_length_442_cov_2.434402	247	327	60	6	80	0.0750000
NODE_58438_length_442_cov_2.434402	247	327	62	1	80	0.0125000
NODE_58438_length_442_cov_2.434402	247	327	68	1	80	0.0125000
NODE_58438_length_442_cov_2.434402	247	327	70	3	80	0.0375000
NODE_58438_length_442_cov_2.434402	247	327	72	2	80	0.0250000
NODE_58438_length_442_cov_2.434402	247	327	74	8	80	0.1000000
NODE_58438_length_442_cov_2.434402	247	327	76	5	80	0.0625000
NODE_58438_length_442_cov_2.434402	247	327	80	5	80	0.0625000
NODE_58438_length_442_cov_2.434402	247	327	82	2	80	0.0250000
NODE_58438_length_442_cov_2.434402	247	327	85	2	80	0.0250000
NODE_58438_length_442_cov_2.434402	247	327	86	3	80	0.0375000
NODE_58438_length_442_cov_2.434402	247	327	87	3	80	0.0375000
NODE_58438_length_442_cov_2.434402	247	327	88	10	80	0.1250000
NODE_58438_length_442_cov_2.434402	247	327	89	4	80	0.0500000
NODE_58438_length_442_cov_2.434402	247	327	90	7	80	0.0875000
NODE_58503_length_442_cov_1.746356	95	161	0	25	66	0.3787879
NODE_58503_length_442_cov_1.746356	95	161	2	2	66	0.0303030
NODE_58503_length_442_cov_1.746356	95	161	4	24	66	0.3636364
NODE_58503_length_442_cov_1.746356	95	161	6	1	66	0.0151515
NODE_58503_length_442_cov_1.746356	95	161	8	14	66	0.2121212
NODE_58503_length_442_cov_1.746356	95	122	0	25	27	0.9259259
NODE_58503_length_442_cov_1.746356	95	122	2	2	27	0.0740741
NODE_58759_length_441_cov_21.877193	28	108	0	80	80	1.0000000
NODE_58759_length_441_cov_21.877193	81	161	0	80	80	1.0000000
NODE_58760_length_441_cov_13.546784	152	232	2	80	80	1.0000000
NODE_58760_length_441_cov_13.546784	205	285	0	44	80	0.5500000
NODE_58760_length_441_cov_13.546784	205	285	2	36	80	0.4500000
NODE_58771_length_441_cov_5.710526	200	280	0	6	80	0.0750000
NODE_58771_length_441_cov_5.710526	200	280	2	74	80	0.9250000
NODE_58771_length_441_cov_5.710526	253	333	0	43	80	0.5375000
NODE_58771_length_441_cov_5.710526	253	333	2	37	80	0.4625000
NODE_58817_length_441_cov_3.096491	240	324	0	40	84	0.4761905
NODE_58817_length_441_cov_3.096491	240	324	2	8	84	0.0952381
NODE_58817_length_441_cov_3.096491	240	324	4	36	84	0.4285714
NODE_58820_length_441_cov_3.023392	105	163	0	1	58	0.0172414
NODE_58820_length_441_cov_3.023392	105	163	1	10	58	0.1724138
NODE_58820_length_441_cov_3.023392	105	163	2	45	58	0.7758621
NODE_58820_length_441_cov_3.023392	105	163	4	2	58	0.0344828
NODE_58852_length_441_cov_2.438596	19	99	0	23	80	0.2875000
NODE_58852_length_441_cov_2.438596	19	99	4	57	80	0.7125000
NODE_58852_length_441_cov_2.438596	72	126	4	54	54	1.0000000
NODE_58970_length_441_cov_1.435673	105	156	6	51	51	1.0000000
NODE_59142_length_440_cov_43.131965	122	202	0	38	80	0.4750000
NODE_59142_length_440_cov_43.131965	122	202	2	42	80	0.5250000
NODE_59142_length_440_cov_43.131965	175	255	2	35	80	0.4375000
NODE_59142_length_440_cov_43.131965	175	255	3	23	80	0.2875000
NODE_59142_length_440_cov_43.131965	175	255	4	6	80	0.0750000
NODE_59142_length_440_cov_43.131965	175	255	8	16	80	0.2000000
NODE_59142_length_440_cov_43.131965	251	331	8	61	80	0.7625000
NODE_59142_length_440_cov_43.131965	251	331	10	2	80	0.0250000
NODE_59142_length_440_cov_43.131965	251	331	12	17	80	0.2125000
NODE_59142_length_440_cov_43.131965	304	384	2	6	80	0.0750000
NODE_59142_length_440_cov_43.131965	304	384	3	7	80	0.0875000
NODE_59142_length_440_cov_43.131965	304	384	5	17	80	0.2125000
NODE_59142_length_440_cov_43.131965	304	384	6	23	80	0.2875000
NODE_59142_length_440_cov_43.131965	304	384	8	8	80	0.1000000
NODE_59142_length_440_cov_43.131965	304	384	10	2	80	0.0250000
NODE_59142_length_440_cov_43.131965	304	384	12	17	80	0.2125000
NODE_59143_length_440_cov_42.929619	116	196	0	80	80	1.0000000
NODE_59143_length_440_cov_42.929619	169	249	0	80	80	1.0000000
NODE_59147_length_440_cov_8.164223	45	125	0	80	80	1.0000000
NODE_59147_length_440_cov_8.164223	98	178	0	80	80	1.0000000
NODE_59157_length_440_cov_5.193548	146	210	0	10	64	0.1562500
NODE_59157_length_440_cov_5.193548	146	210	7	2	64	0.0312500
NODE_59157_length_440_cov_5.193548	146	210	8	11	64	0.1718750
NODE_59157_length_440_cov_5.193548	146	210	10	41	64	0.6406250
NODE_59157_length_440_cov_5.193548	146	210	0	10	64	0.1562500
NODE_59157_length_440_cov_5.193548	146	210	7	2	64	0.0312500
NODE_59157_length_440_cov_5.193548	146	210	8	11	64	0.1718750
NODE_59157_length_440_cov_5.193548	146	210	10	41	64	0.6406250
NODE_59157_length_440_cov_5.193548	146	210	0	10	64	0.1562500
NODE_59157_length_440_cov_5.193548	146	210	7	2	64	0.0312500
NODE_59157_length_440_cov_5.193548	146	210	8	11	64	0.1718750
NODE_59157_length_440_cov_5.193548	146	210	10	41	64	0.6406250
NODE_59164_length_440_cov_4.595308	153	233	0	80	80	1.0000000
NODE_59164_length_440_cov_4.595308	153	180	0	27	27	1.0000000
NODE_59188_length_440_cov_3.431085	84	150	8	66	66	1.0000000
NODE_59191_length_440_cov_3.331378	139	195	2	2	56	0.0357143
NODE_59191_length_440_cov_3.331378	139	195	6	13	56	0.2321429
NODE_59191_length_440_cov_3.331378	139	195	8	41	56	0.7321429
NODE_59517_length_439_cov_76.552941	0	68	0	2	68	0.0294118
NODE_59517_length_439_cov_76.552941	0	68	10	8	68	0.1176471
NODE_59517_length_439_cov_76.552941	0	68	11	29	68	0.4264706
NODE_59517_length_439_cov_76.552941	0	68	17	10	68	0.1470588
NODE_59517_length_439_cov_76.552941	0	68	19	1	68	0.0147059
NODE_59517_length_439_cov_76.552941	0	68	21	9	68	0.1323529
NODE_59517_length_439_cov_76.552941	0	68	23	9	68	0.1323529
NODE_59517_length_439_cov_76.552941	0	68	0	2	68	0.0294118
NODE_59517_length_439_cov_76.552941	0	68	10	8	68	0.1176471
NODE_59517_length_439_cov_76.552941	0	68	11	29	68	0.4264706
NODE_59517_length_439_cov_76.552941	0	68	17	10	68	0.1470588
NODE_59517_length_439_cov_76.552941	0	68	19	1	68	0.0147059
NODE_59517_length_439_cov_76.552941	0	68	21	9	68	0.1323529
NODE_59517_length_439_cov_76.552941	0	68	23	9	68	0.1323529
NODE_59517_length_439_cov_76.552941	0	68	0	2	68	0.0294118
NODE_59517_length_439_cov_76.552941	0	68	10	8	68	0.1176471
NODE_59517_length_439_cov_76.552941	0	68	11	29	68	0.4264706
NODE_59517_length_439_cov_76.552941	0	68	17	10	68	0.1470588
NODE_59517_length_439_cov_76.552941	0	68	19	1	68	0.0147059
NODE_59517_length_439_cov_76.552941	0	68	21	9	68	0.1323529
NODE_59517_length_439_cov_76.552941	0	68	23	9	68	0.1323529
NODE_59517_length_439_cov_76.552941	1	68	0	1	67	0.0149254
NODE_59517_length_439_cov_76.552941	1	68	10	8	67	0.1194030
NODE_59517_length_439_cov_76.552941	1	68	11	29	67	0.4328358
NODE_59517_length_439_cov_76.552941	1	68	17	10	67	0.1492537
NODE_59517_length_439_cov_76.552941	1	68	19	1	67	0.0149254
NODE_59517_length_439_cov_76.552941	1	68	21	9	67	0.1343284
NODE_59517_length_439_cov_76.552941	1	68	23	9	67	0.1343284
NODE_59517_length_439_cov_76.552941	64	144	16	3	80	0.0375000
NODE_59517_length_439_cov_76.552941	64	144	18	4	80	0.0500000
NODE_59517_length_439_cov_76.552941	64	144	23	4	80	0.0500000
NODE_59517_length_439_cov_76.552941	64	144	25	24	80	0.3000000
NODE_59517_length_439_cov_76.552941	64	144	26	3	80	0.0375000
NODE_59517_length_439_cov_76.552941	64	144	27	11	80	0.1375000
NODE_59517_length_439_cov_76.552941	64	144	28	18	80	0.2250000
NODE_59517_length_439_cov_76.552941	64	144	30	13	80	0.1625000
NODE_59517_length_439_cov_76.552941	64	144	16	3	80	0.0375000
NODE_59517_length_439_cov_76.552941	64	144	18	4	80	0.0500000
NODE_59517_length_439_cov_76.552941	64	144	23	4	80	0.0500000
NODE_59517_length_439_cov_76.552941	64	144	25	24	80	0.3000000
NODE_59517_length_439_cov_76.552941	64	144	26	3	80	0.0375000
NODE_59517_length_439_cov_76.552941	64	144	27	11	80	0.1375000
NODE_59517_length_439_cov_76.552941	64	144	28	18	80	0.2250000
NODE_59517_length_439_cov_76.552941	64	144	30	13	80	0.1625000
NODE_59517_length_439_cov_76.552941	117	197	4	10	80	0.1250000
NODE_59517_length_439_cov_76.552941	117	197	6	14	80	0.1750000
NODE_59517_length_439_cov_76.552941	117	197	8	8	80	0.1000000
NODE_59517_length_439_cov_76.552941	117	197	14	18	80	0.2250000
NODE_59517_length_439_cov_76.552941	117	197	16	6	80	0.0750000
NODE_59517_length_439_cov_76.552941	117	197	18	4	80	0.0500000
NODE_59517_length_439_cov_76.552941	117	197	28	18	80	0.2250000
NODE_59517_length_439_cov_76.552941	117	197	30	2	80	0.0250000
NODE_59517_length_439_cov_76.552941	117	195	4	8	78	0.1025641
NODE_59517_length_439_cov_76.552941	117	195	6	14	78	0.1794872
NODE_59517_length_439_cov_76.552941	117	195	8	8	78	0.1025641
NODE_59517_length_439_cov_76.552941	117	195	14	18	78	0.2307692
NODE_59517_length_439_cov_76.552941	117	195	16	6	78	0.0769231
NODE_59517_length_439_cov_76.552941	117	195	18	4	78	0.0512821
NODE_59517_length_439_cov_76.552941	117	195	28	18	78	0.2307692
NODE_59517_length_439_cov_76.552941	117	195	30	2	78	0.0256410
NODE_59533_length_439_cov_4.408824	174	238	0	24	64	0.3750000
NODE_59533_length_439_cov_4.408824	174	238	2	40	64	0.6250000
NODE_59536_length_439_cov_4.255882	258	318	0	60	60	1.0000000
NODE_59560_length_439_cov_3.011765	57	128	50	21	71	0.2957746
NODE_59560_length_439_cov_3.011765	57	128	52	4	71	0.0563380
NODE_59560_length_439_cov_3.011765	57	128	54	8	71	0.1126761
NODE_59560_length_439_cov_3.011765	57	128	56	2	71	0.0281690
NODE_59560_length_439_cov_3.011765	57	128	57	14	71	0.1971831
NODE_59560_length_439_cov_3.011765	57	128	58	22	71	0.3098592
NODE_59560_length_439_cov_3.011765	101	140	44	2	39	0.0512821
NODE_59560_length_439_cov_3.011765	101	140	50	1	39	0.0256410
NODE_59560_length_439_cov_3.011765	101	140	51	2	39	0.0512821
NODE_59560_length_439_cov_3.011765	101	140	52	1	39	0.0256410
NODE_59560_length_439_cov_3.011765	101	140	55	3	39	0.0769231
NODE_59560_length_439_cov_3.011765	101	140	57	17	39	0.4358974
NODE_59560_length_439_cov_3.011765	101	140	58	13	39	0.3333333
NODE_59592_length_439_cov_2.252941	227	269	0	42	42	1.0000000
NODE_59599_length_439_cov_2.135294	116	179	7	1	63	0.0158730
NODE_59599_length_439_cov_2.135294	116	179	8	42	63	0.6666667
NODE_59599_length_439_cov_2.135294	116	179	10	4	63	0.0634921
NODE_59599_length_439_cov_2.135294	116	179	12	16	63	0.2539683
NODE_59617_length_439_cov_1.929412	388	439	0	30	51	0.5882353
NODE_59617_length_439_cov_1.929412	388	439	2	21	51	0.4117647
NODE_59897_length_438_cov_29.952802	196	276	0	68	80	0.8500000
NODE_59897_length_438_cov_29.952802	196	276	4	12	80	0.1500000
NODE_59897_length_438_cov_29.952802	249	329	0	15	80	0.1875000
NODE_59897_length_438_cov_29.952802	249	329	4	65	80	0.8125000
NODE_59898_length_438_cov_16.330383	225	305	0	45	80	0.5625000
NODE_59898_length_438_cov_16.330383	225	305	6	35	80	0.4375000
NODE_59898_length_438_cov_16.330383	278	358	6	80	80	1.0000000
NODE_59899_length_438_cov_15.436578	74	154	0	80	80	1.0000000
NODE_59899_length_438_cov_15.436578	127	207	0	80	80	1.0000000
NODE_59901_length_438_cov_9.306785	256	309	0	17	53	0.3207547
NODE_59901_length_438_cov_9.306785	256	309	2	36	53	0.6792453
NODE_59901_length_438_cov_9.306785	282	327	2	45	45	1.0000000
NODE_59916_length_438_cov_4.808260	46	133	0	9	87	0.1034483
NODE_59916_length_438_cov_4.808260	46	133	4	42	87	0.4827586
NODE_59916_length_438_cov_4.808260	46	133	6	36	87	0.4137931
NODE_59916_length_438_cov_4.808260	106	186	2	39	80	0.4875000
NODE_59916_length_438_cov_4.808260	106	186	6	41	80	0.5125000
NODE_59920_length_438_cov_4.622419	135	184	2	31	49	0.6326531
NODE_59920_length_438_cov_4.622419	135	184	4	18	49	0.3673469
NODE_59936_length_438_cov_3.651917	86	166	0	80	80	1.0000000
NODE_59936_length_438_cov_3.651917	139	219	0	65	80	0.8125000
NODE_59936_length_438_cov_3.651917	139	219	2	15	80	0.1875000
NODE_59952_length_438_cov_3.109145	215	273	0	58	58	1.0000000
NODE_59957_length_438_cov_3.005900	175	258	0	83	83	1.0000000
NODE_60317_length_437_cov_57.260355	272	352	0	80	80	1.0000000
NODE_60317_length_437_cov_57.260355	325	405	0	80	80	1.0000000
NODE_60318_length_437_cov_40.964497	0	73	0	41	73	0.5616438
NODE_60318_length_437_cov_40.964497	0	73	4	32	73	0.4383562
NODE_60318_length_437_cov_40.964497	46	126	4	80	80	1.0000000
NODE_60319_length_437_cov_30.843195	140	220	0	80	80	1.0000000
NODE_60319_length_437_cov_30.843195	193	273	0	80	80	1.0000000
NODE_60320_length_437_cov_14.736686	164	244	0	80	80	1.0000000
NODE_60320_length_437_cov_14.736686	217	297	0	80	80	1.0000000
NODE_60331_length_437_cov_6.032544	249	320	0	71	71	1.0000000
NODE_60332_length_437_cov_6.020710	272	352	2	12	80	0.1500000
NODE_60332_length_437_cov_6.020710	272	352	4	12	80	0.1500000
NODE_60332_length_437_cov_6.020710	272	352	6	45	80	0.5625000
NODE_60332_length_437_cov_6.020710	272	352	8	11	80	0.1375000
NODE_60332_length_437_cov_6.020710	325	405	2	65	80	0.8125000
NODE_60332_length_437_cov_6.020710	325	405	4	12	80	0.1500000
NODE_60332_length_437_cov_6.020710	325	405	6	3	80	0.0375000
NODE_60336_length_437_cov_5.526627	129	209	0	80	80	1.0000000
NODE_60336_length_437_cov_5.526627	182	262	0	80	80	1.0000000
NODE_60348_length_437_cov_4.505917	247	327	0	32	80	0.4000000
NODE_60348_length_437_cov_4.505917	247	327	2	48	80	0.6000000
NODE_60361_length_437_cov_3.470414	204	259	0	55	55	1.0000000
NODE_60369_length_437_cov_3.301775	95	149	0	54	54	1.0000000
NODE_60381_length_437_cov_2.911243	91	171	0	34	80	0.4250000
NODE_60381_length_437_cov_2.911243	91	171	2	1	80	0.0125000
NODE_60381_length_437_cov_2.911243	91	171	4	1	80	0.0125000
NODE_60381_length_437_cov_2.911243	91	171	6	20	80	0.2500000
NODE_60381_length_437_cov_2.911243	91	171	8	24	80	0.3000000
NODE_60400_length_437_cov_2.650888	190	239	8	13	49	0.2653061
NODE_60400_length_437_cov_2.650888	190	239	10	36	49	0.7346939
NODE_60400_length_437_cov_2.650888	212	292	0	8	80	0.1000000
NODE_60400_length_437_cov_2.650888	212	292	7	2	80	0.0250000
NODE_60400_length_437_cov_2.650888	212	292	8	4	80	0.0500000
NODE_60400_length_437_cov_2.650888	212	292	10	66	80	0.8250000
NODE_60411_length_437_cov_2.514793	292	333	0	41	41	1.0000000
NODE_60509_length_437_cov_1.473373	252	324	0	46	72	0.6388889
NODE_60509_length_437_cov_1.473373	252	324	2	26	72	0.3611111
NODE_60709_length_436_cov_125.940653	204	284	8	20	80	0.2500000
NODE_60709_length_436_cov_125.940653	204	284	10	19	80	0.2375000
NODE_60709_length_436_cov_125.940653	204	284	12	19	80	0.2375000
NODE_60709_length_436_cov_125.940653	204	284	14	18	80	0.2250000
NODE_60709_length_436_cov_125.940653	204	284	16	4	80	0.0500000
NODE_60709_length_436_cov_125.940653	255	301	4	2	46	0.0434783
NODE_60709_length_436_cov_125.940653	255	301	6	12	46	0.2608696
NODE_60709_length_436_cov_125.940653	255	301	8	23	46	0.5000000
NODE_60709_length_436_cov_125.940653	255	301	10	9	46	0.1956522
NODE_60709_length_436_cov_125.940653	257	337	2	10	80	0.1250000
NODE_60709_length_436_cov_125.940653	257	337	4	28	80	0.3500000
NODE_60709_length_436_cov_125.940653	257	337	6	12	80	0.1500000
NODE_60709_length_436_cov_125.940653	257	337	8	23	80	0.2875000
NODE_60709_length_436_cov_125.940653	257	337	10	7	80	0.0875000
NODE_60709_length_436_cov_125.940653	333	413	0	56	80	0.7000000
NODE_60709_length_436_cov_125.940653	333	413	2	24	80	0.3000000
NODE_60709_length_436_cov_125.940653	386	436	0	50	50	1.0000000
NODE_60712_length_436_cov_45.459941	166	246	0	13	80	0.1625000
NODE_60712_length_436_cov_45.459941	166	246	2	13	80	0.1625000
NODE_60712_length_436_cov_45.459941	166	246	4	12	80	0.1500000
NODE_60712_length_436_cov_45.459941	166	246	6	42	80	0.5250000
NODE_60712_length_436_cov_45.459941	219	299	2	14	80	0.1750000
NODE_60712_length_436_cov_45.459941	219	299	4	7	80	0.0875000
NODE_60712_length_436_cov_45.459941	219	299	6	59	80	0.7375000
NODE_60712_length_436_cov_45.459941	295	375	2	80	80	1.0000000
NODE_60712_length_436_cov_45.459941	348	428	0	26	80	0.3250000
NODE_60712_length_436_cov_45.459941	348	428	2	54	80	0.6750000
NODE_60713_length_436_cov_10.560831	74	154	0	80	80	1.0000000
NODE_60713_length_436_cov_10.560831	127	207	0	80	80	1.0000000
NODE_60716_length_436_cov_8.317507	51	127	0	11	76	0.1447368
NODE_60716_length_436_cov_8.317507	51	127	8	65	76	0.8552632
NODE_60716_length_436_cov_8.317507	104	182	8	78	78	1.0000000
NODE_60760_length_436_cov_3.109792	153	205	0	52	52	1.0000000
NODE_60786_length_436_cov_2.551929	182	258	0	4	76	0.0526316
NODE_60786_length_436_cov_2.551929	182	258	2	72	76	0.9473684
NODE_60786_length_436_cov_2.551929	235	315	0	7	80	0.0875000
NODE_60786_length_436_cov_2.551929	235	315	2	73	80	0.9125000
NODE_60934_length_436_cov_1.207715	105	181	0	76	76	1.0000000
NODE_61088_length_435_cov_17.401786	55	135	0	46	80	0.5750000
NODE_61088_length_435_cov_17.401786	55	135	2	1	80	0.0125000
NODE_61088_length_435_cov_17.401786	55	135	4	5	80	0.0625000
NODE_61088_length_435_cov_17.401786	55	135	6	12	80	0.1500000
NODE_61088_length_435_cov_17.401786	55	135	10	16	80	0.2000000
NODE_61088_length_435_cov_17.401786	108	188	6	24	80	0.3000000
NODE_61088_length_435_cov_17.401786	108	188	8	1	80	0.0125000
NODE_61088_length_435_cov_17.401786	108	188	10	55	80	0.6875000
NODE_61094_length_435_cov_6.910714	113	193	4	10	80	0.1250000
NODE_61094_length_435_cov_6.910714	113	193	6	65	80	0.8125000
NODE_61094_length_435_cov_6.910714	113	193	8	5	80	0.0625000
NODE_61094_length_435_cov_6.910714	147	194	4	11	47	0.2340426
NODE_61094_length_435_cov_6.910714	147	194	6	36	47	0.7659575
NODE_61094_length_435_cov_6.910714	149	184	4	1	35	0.0285714
NODE_61094_length_435_cov_6.910714	149	184	6	34	35	0.9714286
NODE_61094_length_435_cov_6.910714	151	193	4	10	42	0.2380952
NODE_61094_length_435_cov_6.910714	151	193	6	32	42	0.7619048
NODE_61094_length_435_cov_6.910714	166	251	0	13	85	0.1529412
NODE_61094_length_435_cov_6.910714	166	251	2	14	85	0.1647059
NODE_61094_length_435_cov_6.910714	166	251	4	41	85	0.4823529
NODE_61094_length_435_cov_6.910714	166	251	6	17	85	0.2000000
NODE_61094_length_435_cov_6.910714	167	251	0	13	84	0.1547619
NODE_61094_length_435_cov_6.910714	167	251	2	14	84	0.1666667
NODE_61094_length_435_cov_6.910714	167	251	4	41	84	0.4880952
NODE_61094_length_435_cov_6.910714	167	251	6	16	84	0.1904762
NODE_61102_length_435_cov_5.630952	159	217	0	58	58	1.0000000
NODE_61102_length_435_cov_5.630952	190	270	0	80	80	1.0000000
NODE_61112_length_435_cov_4.601190	271	309	0	38	38	1.0000000
NODE_61112_length_435_cov_4.601190	282	344	0	47	62	0.7580645
NODE_61112_length_435_cov_4.601190	282	344	2	15	62	0.2419355
NODE_61122_length_435_cov_3.770833	209	240	0	31	31	1.0000000
NODE_61137_length_435_cov_2.836310	113	194	4	3	81	0.0370370
NODE_61137_length_435_cov_2.836310	113	194	6	27	81	0.3333333
NODE_61137_length_435_cov_2.836310	113	194	8	3	81	0.0370370
NODE_61137_length_435_cov_2.836310	113	194	10	3	81	0.0370370
NODE_61137_length_435_cov_2.836310	113	194	12	45	81	0.5555556
NODE_61357_length_435_cov_0.988095	286	322	0	36	36	1.0000000
NODE_61451_length_434_cov_136.483582	0	58	16	1	58	0.0172414
NODE_61451_length_434_cov_136.483582	0	58	18	1	58	0.0172414
NODE_61451_length_434_cov_136.483582	0	58	26	1	58	0.0172414
NODE_61451_length_434_cov_136.483582	0	58	30	2	58	0.0344828
NODE_61451_length_434_cov_136.483582	0	58	34	1	58	0.0172414
NODE_61451_length_434_cov_136.483582	0	58	52	1	58	0.0172414
NODE_61451_length_434_cov_136.483582	0	58	54	1	58	0.0172414
NODE_61451_length_434_cov_136.483582	0	58	65	1	58	0.0172414
NODE_61451_length_434_cov_136.483582	0	58	74	1	58	0.0172414
NODE_61451_length_434_cov_136.483582	0	58	76	1	58	0.0172414
NODE_61451_length_434_cov_136.483582	0	58	92	2	58	0.0344828
NODE_61451_length_434_cov_136.483582	0	58	98	3	58	0.0517241
NODE_61451_length_434_cov_136.483582	0	58	110	2	58	0.0344828
NODE_61451_length_434_cov_136.483582	0	58	113	1	58	0.0172414
NODE_61451_length_434_cov_136.483582	0	58	115	1	58	0.0172414
NODE_61451_length_434_cov_136.483582	0	58	118	1	58	0.0172414
NODE_61451_length_434_cov_136.483582	0	58	125	1	58	0.0172414
NODE_61451_length_434_cov_136.483582	0	58	132	1	58	0.0172414
NODE_61451_length_434_cov_136.483582	0	58	142	3	58	0.0517241
NODE_61451_length_434_cov_136.483582	0	58	144	1	58	0.0172414
NODE_61451_length_434_cov_136.483582	0	58	150	1	58	0.0172414
NODE_61451_length_434_cov_136.483582	0	58	154	1	58	0.0172414
NODE_61451_length_434_cov_136.483582	0	58	164	2	58	0.0344828
NODE_61451_length_434_cov_136.483582	0	58	169	1	58	0.0172414
NODE_61451_length_434_cov_136.483582	0	58	179	1	58	0.0172414
NODE_61451_length_434_cov_136.483582	0	58	183	4	58	0.0689655
NODE_61451_length_434_cov_136.483582	0	58	184	1	58	0.0172414
NODE_61451_length_434_cov_136.483582	0	58	186	2	58	0.0344828
NODE_61451_length_434_cov_136.483582	0	58	188	4	58	0.0689655
NODE_61451_length_434_cov_136.483582	0	58	190	1	58	0.0172414
NODE_61451_length_434_cov_136.483582	0	58	194	1	58	0.0172414
NODE_61451_length_434_cov_136.483582	0	58	195	7	58	0.1206897
NODE_61451_length_434_cov_136.483582	0	58	199	5	58	0.0862069
NODE_61451_length_434_cov_136.483582	31	111	169	1	80	0.0125000
NODE_61451_length_434_cov_136.483582	31	111	179	1	80	0.0125000
NODE_61451_length_434_cov_136.483582	31	111	183	4	80	0.0500000
NODE_61451_length_434_cov_136.483582	31	111	184	1	80	0.0125000
NODE_61451_length_434_cov_136.483582	31	111	186	2	80	0.0250000
NODE_61451_length_434_cov_136.483582	31	111	188	4	80	0.0500000
NODE_61451_length_434_cov_136.483582	31	111	190	1	80	0.0125000
NODE_61451_length_434_cov_136.483582	31	111	194	1	80	0.0125000
NODE_61451_length_434_cov_136.483582	31	111	195	7	80	0.0875000
NODE_61451_length_434_cov_136.483582	31	111	199	6	80	0.0750000
NODE_61451_length_434_cov_136.483582	31	111	201	2	80	0.0250000
NODE_61451_length_434_cov_136.483582	31	111	202	1	80	0.0125000
NODE_61451_length_434_cov_136.483582	31	111	204	1	80	0.0125000
NODE_61451_length_434_cov_136.483582	31	111	206	6	80	0.0750000
NODE_61451_length_434_cov_136.483582	31	111	208	4	80	0.0500000
NODE_61451_length_434_cov_136.483582	31	111	210	3	80	0.0375000
NODE_61451_length_434_cov_136.483582	31	111	212	4	80	0.0500000
NODE_61451_length_434_cov_136.483582	31	111	214	7	80	0.0875000
NODE_61451_length_434_cov_136.483582	31	111	216	3	80	0.0375000
NODE_61451_length_434_cov_136.483582	31	111	220	5	80	0.0625000
NODE_61451_length_434_cov_136.483582	31	111	222	1	80	0.0125000
NODE_61451_length_434_cov_136.483582	31	111	224	2	80	0.0250000
NODE_61451_length_434_cov_136.483582	31	111	226	3	80	0.0375000
NODE_61451_length_434_cov_136.483582	31	111	228	3	80	0.0375000
NODE_61451_length_434_cov_136.483582	31	111	230	1	80	0.0125000
NODE_61451_length_434_cov_136.483582	31	111	232	5	80	0.0625000
NODE_61451_length_434_cov_136.483582	31	111	234	1	80	0.0125000
NODE_61452_length_434_cov_43.214925	291	366	7	75	75	1.0000000
NODE_61452_length_434_cov_43.214925	344	424	1	16	80	0.2000000
NODE_61452_length_434_cov_43.214925	344	424	5	25	80	0.3125000
NODE_61452_length_434_cov_43.214925	344	424	7	39	80	0.4875000
NODE_61452_length_434_cov_43.214925	344	424	1	16	80	0.2000000
NODE_61452_length_434_cov_43.214925	344	424	5	25	80	0.3125000
NODE_61452_length_434_cov_43.214925	344	424	7	39	80	0.4875000
NODE_61453_length_434_cov_22.373134	80	160	0	80	80	1.0000000
NODE_61453_length_434_cov_22.373134	133	213	0	80	80	1.0000000
NODE_61455_length_434_cov_11.549254	74	145	0	71	71	1.0000000
NODE_61455_length_434_cov_11.549254	118	198	0	80	80	1.0000000
NODE_61477_length_434_cov_4.125373	191	233	0	6	42	0.1428571
NODE_61477_length_434_cov_4.125373	191	233	2	36	42	0.8571429
NODE_61477_length_434_cov_4.125373	200	235	0	8	35	0.2285714
NODE_61477_length_434_cov_4.125373	200	235	2	27	35	0.7714286
NODE_61497_length_434_cov_3.104478	191	263	0	1	72	0.0138889
NODE_61497_length_434_cov_3.104478	191	263	2	3	72	0.0416667
NODE_61497_length_434_cov_3.104478	191	263	4	68	72	0.9444444
NODE_61528_length_434_cov_2.197015	129	168	0	39	39	1.0000000
NODE_61563_length_434_cov_1.883582	88	133	0	45	45	1.0000000
NODE_61563_length_434_cov_1.883582	141	182	0	41	41	1.0000000
NODE_61603_length_434_cov_1.626866	163	243	8	10	80	0.1250000
NODE_61603_length_434_cov_1.626866	163	243	10	7	80	0.0875000
NODE_61603_length_434_cov_1.626866	163	243	12	11	80	0.1375000
NODE_61603_length_434_cov_1.626866	163	243	16	50	80	0.6250000
NODE_61603_length_434_cov_1.626866	163	243	18	2	80	0.0250000
NODE_61676_length_434_cov_1.220896	118	198	107	1	80	0.0125000
NODE_61676_length_434_cov_1.220896	118	198	108	4	80	0.0500000
NODE_61676_length_434_cov_1.220896	118	198	112	1	80	0.0125000
NODE_61676_length_434_cov_1.220896	118	198	118	1	80	0.0125000
NODE_61676_length_434_cov_1.220896	118	198	120	1	80	0.0125000
NODE_61676_length_434_cov_1.220896	118	198	125	1	80	0.0125000
NODE_61676_length_434_cov_1.220896	118	198	129	1	80	0.0125000
NODE_61676_length_434_cov_1.220896	118	198	130	4	80	0.0500000
NODE_61676_length_434_cov_1.220896	118	198	134	3	80	0.0375000
NODE_61676_length_434_cov_1.220896	118	198	138	3	80	0.0375000
NODE_61676_length_434_cov_1.220896	118	198	143	1	80	0.0125000
NODE_61676_length_434_cov_1.220896	118	198	144	2	80	0.0250000
NODE_61676_length_434_cov_1.220896	118	198	148	5	80	0.0625000
NODE_61676_length_434_cov_1.220896	118	198	150	2	80	0.0250000
NODE_61676_length_434_cov_1.220896	118	198	151	1	80	0.0125000
NODE_61676_length_434_cov_1.220896	118	198	152	9	80	0.1125000
NODE_61676_length_434_cov_1.220896	118	198	153	5	80	0.0625000
NODE_61676_length_434_cov_1.220896	118	198	154	7	80	0.0875000
NODE_61676_length_434_cov_1.220896	118	198	155	3	80	0.0375000
NODE_61676_length_434_cov_1.220896	118	198	156	6	80	0.0750000
NODE_61676_length_434_cov_1.220896	118	198	157	1	80	0.0125000
NODE_61676_length_434_cov_1.220896	118	198	158	2	80	0.0250000
NODE_61676_length_434_cov_1.220896	118	198	159	1	80	0.0125000
NODE_61676_length_434_cov_1.220896	118	198	160	3	80	0.0375000
NODE_61676_length_434_cov_1.220896	118	198	161	1	80	0.0125000
NODE_61676_length_434_cov_1.220896	118	198	162	5	80	0.0625000
NODE_61676_length_434_cov_1.220896	118	198	164	6	80	0.0750000
NODE_61727_length_434_cov_1.002985	245	286	9	39	41	0.9512195
NODE_61727_length_434_cov_1.002985	245	286	11	2	41	0.0487805
NODE_61727_length_434_cov_1.002985	258	339	2	27	81	0.3333333
NODE_61727_length_434_cov_1.002985	258	339	4	3	81	0.0370370
NODE_61727_length_434_cov_1.002985	258	339	5	3	81	0.0370370
NODE_61727_length_434_cov_1.002985	258	339	7	14	81	0.1728395
NODE_61727_length_434_cov_1.002985	258	339	9	34	81	0.4197531
NODE_61826_length_433_cov_51.392216	2	82	0	80	80	1.0000000
NODE_61826_length_433_cov_51.392216	55	135	0	80	80	1.0000000
NODE_61826_length_433_cov_51.392216	131	213	0	82	82	1.0000000
NODE_61826_length_433_cov_51.392216	189	266	0	77	77	1.0000000
NODE_61827_length_433_cov_46.344311	248	328	0	80	80	1.0000000
NODE_61827_length_433_cov_46.344311	301	381	0	80	80	1.0000000
NODE_61828_length_433_cov_41.808383	92	172	0	80	80	1.0000000
NODE_61828_length_433_cov_41.808383	145	225	0	80	80	1.0000000
NODE_61835_length_433_cov_6.227545	157	237	0	80	80	1.0000000
NODE_61836_length_433_cov_6.080838	164	244	4	23	80	0.2875000
NODE_61836_length_433_cov_6.080838	164	244	6	54	80	0.6750000
NODE_61836_length_433_cov_6.080838	164	244	8	3	80	0.0375000
NODE_61838_length_433_cov_5.547904	10	80	2	19	70	0.2714286
NODE_61838_length_433_cov_5.547904	10	80	4	5	70	0.0714286
NODE_61838_length_433_cov_5.547904	10	80	8	46	70	0.6571429
NODE_61838_length_433_cov_5.547904	51	133	8	81	82	0.9878049
NODE_61838_length_433_cov_5.547904	51	133	10	1	82	0.0121951
NODE_61839_length_433_cov_5.476048	81	141	0	60	60	1.0000000
NODE_61855_length_433_cov_3.907186	77	107	0	30	30	1.0000000
NODE_61862_length_433_cov_3.595808	231	316	4	9	85	0.1058824
NODE_61862_length_433_cov_3.595808	231	316	8	2	85	0.0235294
NODE_61862_length_433_cov_3.595808	231	316	10	4	85	0.0470588
NODE_61862_length_433_cov_3.595808	231	316	12	44	85	0.5176471
NODE_61862_length_433_cov_3.595808	231	316	14	19	85	0.2235294
NODE_61862_length_433_cov_3.595808	231	316	16	7	85	0.0823529
NODE_61864_length_433_cov_3.526946	107	178	0	7	71	0.0985916
NODE_61864_length_433_cov_3.526946	107	178	2	64	71	0.9014084
NODE_61931_length_433_cov_2.137725	123	203	0	24	80	0.3000000
NODE_61931_length_433_cov_2.137725	123	203	4	56	80	0.7000000
NODE_62258_length_432_cov_17.540541	150	230	0	80	80	1.0000000
NODE_62258_length_432_cov_17.540541	203	288	0	85	85	1.0000000
NODE_62264_length_432_cov_6.555556	52	82	2	30	30	1.0000000
NODE_62268_length_432_cov_5.720721	77	157	0	80	80	1.0000000
NODE_62268_length_432_cov_5.720721	130	202	0	72	72	1.0000000
NODE_62269_length_432_cov_5.387387	65	95	0	30	30	1.0000000
NODE_62270_length_432_cov_5.345345	271	324	0	53	53	1.0000000
NODE_62293_length_432_cov_3.678679	78	121	0	43	43	1.0000000
NODE_62304_length_432_cov_3.246246	87	128	8	7	41	0.1707317
NODE_62304_length_432_cov_3.246246	87	128	10	8	41	0.1951219
NODE_62304_length_432_cov_3.246246	87	128	12	3	41	0.0731707
NODE_62304_length_432_cov_3.246246	87	128	14	1	41	0.0243902
NODE_62304_length_432_cov_3.246246	87	128	16	4	41	0.0975610
NODE_62304_length_432_cov_3.246246	87	128	18	1	41	0.0243902
NODE_62304_length_432_cov_3.246246	87	128	22	1	41	0.0243902
NODE_62304_length_432_cov_3.246246	87	128	24	2	41	0.0487805
NODE_62304_length_432_cov_3.246246	87	128	26	2	41	0.0487805
NODE_62304_length_432_cov_3.246246	87	128	28	8	41	0.1951219
NODE_62304_length_432_cov_3.246246	87	128	30	3	41	0.0731707
NODE_62304_length_432_cov_3.246246	87	128	31	1	41	0.0243902
NODE_62304_length_432_cov_3.246246	101	167	10	1	66	0.0151515
NODE_62304_length_432_cov_3.246246	101	167	12	3	66	0.0454545
NODE_62304_length_432_cov_3.246246	101	167	14	1	66	0.0151515
NODE_62304_length_432_cov_3.246246	101	167	16	4	66	0.0606061
NODE_62304_length_432_cov_3.246246	101	167	18	1	66	0.0151515
NODE_62304_length_432_cov_3.246246	101	167	22	1	66	0.0151515
NODE_62304_length_432_cov_3.246246	101	167	24	2	66	0.0303030
NODE_62304_length_432_cov_3.246246	101	167	26	2	66	0.0303030
NODE_62304_length_432_cov_3.246246	101	167	28	8	66	0.1212121
NODE_62304_length_432_cov_3.246246	101	167	30	6	66	0.0909091
NODE_62304_length_432_cov_3.246246	101	167	31	1	66	0.0151515
NODE_62304_length_432_cov_3.246246	101	167	32	5	66	0.0757576
NODE_62304_length_432_cov_3.246246	101	167	34	4	66	0.0606061
NODE_62304_length_432_cov_3.246246	101	167	38	5	66	0.0757576
NODE_62304_length_432_cov_3.246246	101	167	40	20	66	0.3030303
NODE_62304_length_432_cov_3.246246	101	167	42	2	66	0.0303030
NODE_62396_length_432_cov_1.762763	4	71	0	23	67	0.3432836
NODE_62396_length_432_cov_1.762763	4	71	2	34	67	0.5074627
NODE_62396_length_432_cov_1.762763	4	71	4	10	67	0.1492537
NODE_62544_length_432_cov_1.027027	44	68	0	24	24	1.0000000
NODE_62650_length_431_cov_35.355422	202	284	0	82	82	1.0000000
NODE_62650_length_431_cov_35.355422	257	333	0	76	76	1.0000000
NODE_62652_length_431_cov_11.207831	185	265	0	80	80	1.0000000
NODE_62652_length_431_cov_11.207831	238	318	0	80	80	1.0000000
NODE_62657_length_431_cov_7.018072	110	190	0	80	80	1.0000000
NODE_62657_length_431_cov_7.018072	163	243	0	68	80	0.8500000
NODE_62657_length_431_cov_7.018072	163	243	2	12	80	0.1500000
NODE_62661_length_431_cov_6.292169	123	203	0	80	80	1.0000000
NODE_62668_length_431_cov_5.608434	170	241	0	5	71	0.0704225
NODE_62668_length_431_cov_5.608434	170	241	2	66	71	0.9295775
NODE_62681_length_431_cov_4.250000	146	216	2	11	70	0.1571429
NODE_62681_length_431_cov_4.250000	146	216	8	43	70	0.6142857
NODE_62681_length_431_cov_4.250000	146	216	10	16	70	0.2285714
NODE_62684_length_431_cov_3.993976	210	290	4	32	80	0.4000000
NODE_62684_length_431_cov_3.993976	210	290	6	24	80	0.3000000
NODE_62684_length_431_cov_3.993976	210	290	8	23	80	0.2875000
NODE_62684_length_431_cov_3.993976	210	290	10	1	80	0.0125000
NODE_62794_length_431_cov_1.695783	76	156	10	7	80	0.0875000
NODE_62794_length_431_cov_1.695783	76	156	12	23	80	0.2875000
NODE_62794_length_431_cov_1.695783	76	156	13	2	80	0.0250000
NODE_62794_length_431_cov_1.695783	76	156	14	17	80	0.2125000
NODE_62794_length_431_cov_1.695783	76	156	15	11	80	0.1375000
NODE_62794_length_431_cov_1.695783	76	156	16	2	80	0.0250000
NODE_62794_length_431_cov_1.695783	76	156	17	16	80	0.2000000
NODE_62794_length_431_cov_1.695783	76	156	18	1	80	0.0125000
NODE_62794_length_431_cov_1.695783	76	156	19	1	80	0.0125000
NODE_62794_length_431_cov_1.695783	129	199	12	13	70	0.1857143
NODE_62794_length_431_cov_1.695783	129	199	14	16	70	0.2285714
NODE_62794_length_431_cov_1.695783	129	199	16	6	70	0.0857143
NODE_62794_length_431_cov_1.695783	129	199	20	8	70	0.1142857
NODE_62794_length_431_cov_1.695783	129	199	21	5	70	0.0714286
NODE_62794_length_431_cov_1.695783	129	199	22	10	70	0.1428571
NODE_62794_length_431_cov_1.695783	129	199	23	11	70	0.1571429
NODE_62794_length_431_cov_1.695783	129	199	24	1	70	0.0142857
NODE_63043_length_430_cov_49.791541	319	399	58	1	80	0.0125000
NODE_63043_length_430_cov_49.791541	319	399	60	1	80	0.0125000
NODE_63043_length_430_cov_49.791541	319	399	62	3	80	0.0375000
NODE_63043_length_430_cov_49.791541	319	399	64	4	80	0.0500000
NODE_63043_length_430_cov_49.791541	319	399	68	2	80	0.0250000
NODE_63043_length_430_cov_49.791541	319	399	70	3	80	0.0375000
NODE_63043_length_430_cov_49.791541	319	399	74	1	80	0.0125000
NODE_63043_length_430_cov_49.791541	319	399	76	2	80	0.0250000
NODE_63043_length_430_cov_49.791541	319	399	80	1	80	0.0125000
NODE_63043_length_430_cov_49.791541	319	399	86	4	80	0.0500000
NODE_63043_length_430_cov_49.791541	319	399	88	1	80	0.0125000
NODE_63043_length_430_cov_49.791541	319	399	90	4	80	0.0500000
NODE_63043_length_430_cov_49.791541	319	399	92	2	80	0.0250000
NODE_63043_length_430_cov_49.791541	319	399	100	2	80	0.0250000
NODE_63043_length_430_cov_49.791541	319	399	106	3	80	0.0375000
NODE_63043_length_430_cov_49.791541	319	399	107	3	80	0.0375000
NODE_63043_length_430_cov_49.791541	319	399	109	2	80	0.0250000
NODE_63043_length_430_cov_49.791541	319	399	111	2	80	0.0250000
NODE_63043_length_430_cov_49.791541	319	399	113	5	80	0.0625000
NODE_63043_length_430_cov_49.791541	319	399	116	2	80	0.0250000
NODE_63043_length_430_cov_49.791541	319	399	118	1	80	0.0125000
NODE_63043_length_430_cov_49.791541	319	399	120	5	80	0.0625000
NODE_63043_length_430_cov_49.791541	319	399	122	3	80	0.0375000
NODE_63043_length_430_cov_49.791541	319	399	124	2	80	0.0250000
NODE_63043_length_430_cov_49.791541	319	399	134	3	80	0.0375000
NODE_63043_length_430_cov_49.791541	319	399	138	8	80	0.1000000
NODE_63043_length_430_cov_49.791541	319	399	140	5	80	0.0625000
NODE_63043_length_430_cov_49.791541	319	399	142	5	80	0.0625000
NODE_63043_length_430_cov_49.791541	372	430	9	1	58	0.0172414
NODE_63043_length_430_cov_49.791541	372	430	14	1	58	0.0172414
NODE_63043_length_430_cov_49.791541	372	430	19	2	58	0.0344828
NODE_63043_length_430_cov_49.791541	372	430	21	4	58	0.0689655
NODE_63043_length_430_cov_49.791541	372	430	23	6	58	0.1034483
NODE_63043_length_430_cov_49.791541	372	430	31	2	58	0.0344828
NODE_63043_length_430_cov_49.791541	372	430	33	4	58	0.0689655
NODE_63043_length_430_cov_49.791541	372	430	35	2	58	0.0344828
NODE_63043_length_430_cov_49.791541	372	430	47	1	58	0.0172414
NODE_63043_length_430_cov_49.791541	372	430	48	1	58	0.0172414
NODE_63043_length_430_cov_49.791541	372	430	50	1	58	0.0172414
NODE_63043_length_430_cov_49.791541	372	430	51	2	58	0.0344828
NODE_63043_length_430_cov_49.791541	372	430	53	1	58	0.0172414
NODE_63043_length_430_cov_49.791541	372	430	58	4	58	0.0689655
NODE_63043_length_430_cov_49.791541	372	430	60	1	58	0.0172414
NODE_63043_length_430_cov_49.791541	372	430	62	3	58	0.0517241
NODE_63043_length_430_cov_49.791541	372	430	64	4	58	0.0689655
NODE_63043_length_430_cov_49.791541	372	430	68	2	58	0.0344828
NODE_63043_length_430_cov_49.791541	372	430	70	3	58	0.0517241
NODE_63043_length_430_cov_49.791541	372	430	74	1	58	0.0172414
NODE_63043_length_430_cov_49.791541	372	430	76	2	58	0.0344828
NODE_63043_length_430_cov_49.791541	372	430	80	1	58	0.0172414
NODE_63043_length_430_cov_49.791541	372	430	86	4	58	0.0689655
NODE_63043_length_430_cov_49.791541	372	430	88	1	58	0.0172414
NODE_63043_length_430_cov_49.791541	372	430	90	4	58	0.0689655
NODE_63044_length_430_cov_44.365559	109	189	0	80	80	1.0000000
NODE_63044_length_430_cov_44.365559	162	242	0	80	80	1.0000000
NODE_63045_length_430_cov_16.746224	92	172	1	6	80	0.0750000
NODE_63045_length_430_cov_16.746224	92	172	3	4	80	0.0500000
NODE_63045_length_430_cov_16.746224	92	172	7	70	80	0.8750000
NODE_63045_length_430_cov_16.746224	145	225	1	7	80	0.0875000
NODE_63045_length_430_cov_16.746224	145	225	5	23	80	0.2875000
NODE_63045_length_430_cov_16.746224	145	225	7	50	80	0.6250000
NODE_63048_length_430_cov_7.737160	180	263	2	83	83	1.0000000
NODE_63050_length_430_cov_6.163142	135	197	0	62	62	1.0000000
NODE_63051_length_430_cov_5.873112	7	90	0	69	83	0.8313253
NODE_63051_length_430_cov_5.873112	7	90	1	4	83	0.0481928
NODE_63051_length_430_cov_5.873112	7	90	2	3	83	0.0361446
NODE_63051_length_430_cov_5.873112	7	90	6	7	83	0.0843373
NODE_63051_length_430_cov_5.873112	60	126	0	16	66	0.2424242
NODE_63051_length_430_cov_5.873112	60	126	1	4	66	0.0606061
NODE_63051_length_430_cov_5.873112	60	126	2	3	66	0.0454545
NODE_63051_length_430_cov_5.873112	60	126	6	10	66	0.1515152
NODE_63051_length_430_cov_5.873112	60	126	8	33	66	0.5000000
NODE_63066_length_430_cov_4.323263	18	90	0	72	72	1.0000000
NODE_63161_length_430_cov_1.945619	153	233	0	4	80	0.0500000
NODE_63161_length_430_cov_1.945619	153	233	2	76	80	0.9500000
NODE_63401_length_430_cov_0.664653	391	430	0	39	39	1.0000000
NODE_63437_length_429_cov_10.424242	78	158	0	80	80	1.0000000
NODE_63437_length_429_cov_10.424242	207	287	2	80	80	1.0000000
NODE_63437_length_429_cov_10.424242	260	340	0	37	80	0.4625000
NODE_63437_length_429_cov_10.424242	260	340	2	43	80	0.5375000
NODE_63439_length_429_cov_8.957576	213	293	0	17	80	0.2125000
NODE_63439_length_429_cov_8.957576	213	293	2	63	80	0.7875000
NODE_63439_length_429_cov_8.957576	266	346	0	36	80	0.4500000
NODE_63439_length_429_cov_8.957576	266	346	2	44	80	0.5500000
NODE_63441_length_429_cov_6.772727	337	366	0	29	29	1.0000000
NODE_63485_length_429_cov_3.003030	173	251	0	78	78	1.0000000
NODE_63516_length_429_cov_2.433333	220	300	2	16	80	0.2000000
NODE_63516_length_429_cov_2.433333	220	300	4	64	80	0.8000000
NODE_63519_length_429_cov_2.360606	24	85	0	61	61	1.0000000
NODE_63527_length_429_cov_2.224242	115	195	0	80	80	1.0000000
NODE_63547_length_429_cov_2.051515	114	143	4	14	29	0.4827586
NODE_63547_length_429_cov_2.051515	114	143	5	15	29	0.5172414
NODE_63547_length_429_cov_2.051515	286	348	0	51	62	0.8225806
NODE_63547_length_429_cov_2.051515	286	348	1	11	62	0.1774193
NODE_63864_length_428_cov_40.449848	217	297	0	80	80	1.0000000
NODE_63864_length_428_cov_40.449848	270	350	0	80	80	1.0000000
NODE_63864_length_428_cov_40.449848	346	426	0	80	80	1.0000000
NODE_63865_length_428_cov_31.066869	249	325	0	23	76	0.3026316
NODE_63865_length_428_cov_31.066869	249	325	2	29	76	0.3815790
NODE_63865_length_428_cov_31.066869	249	325	4	2	76	0.0263158
NODE_63865_length_428_cov_31.066869	249	325	6	22	76	0.2894737
NODE_63865_length_428_cov_31.066869	297	378	0	76	81	0.9382716
NODE_63865_length_428_cov_31.066869	297	378	2	5	81	0.0617284
NODE_63866_length_428_cov_11.799392	62	142	0	80	80	1.0000000
NODE_63866_length_428_cov_11.799392	115	195	0	80	80	1.0000000
NODE_63867_length_428_cov_10.595745	227	307	0	80	80	1.0000000
NODE_63870_length_428_cov_6.784195	344	374	0	30	30	1.0000000
NODE_63871_length_428_cov_6.768997	131	194	10	2	63	0.0317460
NODE_63871_length_428_cov_6.768997	131	194	12	6	63	0.0952381
NODE_63871_length_428_cov_6.768997	131	194	14	4	63	0.0634921
NODE_63871_length_428_cov_6.768997	131	194	18	51	63	0.8095238
NODE_63895_length_428_cov_4.206687	224	304	0	40	80	0.5000000
NODE_63895_length_428_cov_4.206687	224	304	2	37	80	0.4625000
NODE_63895_length_428_cov_4.206687	224	304	4	3	80	0.0375000
NODE_63905_length_428_cov_3.525836	168	236	0	68	68	1.0000000
NODE_63905_length_428_cov_3.525836	209	244	0	35	35	1.0000000
NODE_63959_length_428_cov_2.322188	1	42	0	41	41	1.0000000
NODE_63977_length_428_cov_2.124620	228	308	0	56	80	0.7000000
NODE_63977_length_428_cov_2.124620	228	308	2	24	80	0.3000000
NODE_64011_length_428_cov_1.848024	178	260	0	1	82	0.0121951
NODE_64011_length_428_cov_1.848024	178	260	4	12	82	0.1463415
NODE_64011_length_428_cov_1.848024	178	260	6	69	82	0.8414634
NODE_64027_length_428_cov_1.772036	187	255	0	11	68	0.1617647
NODE_64027_length_428_cov_1.772036	187	255	2	57	68	0.8382353
NODE_64245_length_428_cov_0.790274	275	308	0	33	33	1.0000000
NODE_64245_length_428_cov_0.790274	276	302	0	26	26	1.0000000
NODE_64310_length_427_cov_29.628049	312	392	0	3	80	0.0375000
NODE_64310_length_427_cov_29.628049	312	392	1	38	80	0.4750000
NODE_64310_length_427_cov_29.628049	312	392	3	4	80	0.0500000
NODE_64310_length_427_cov_29.628049	312	392	5	35	80	0.4375000
NODE_64310_length_427_cov_29.628049	365	427	0	38	62	0.6129032
NODE_64310_length_427_cov_29.628049	365	427	1	24	62	0.3870968
NODE_64310_length_427_cov_29.628049	365	427	0	38	62	0.6129032
NODE_64310_length_427_cov_29.628049	365	427	1	24	62	0.3870968
NODE_64312_length_427_cov_9.371951	184	239	0	12	55	0.2181818
NODE_64312_length_427_cov_9.371951	184	239	2	2	55	0.0363636
NODE_64312_length_427_cov_9.371951	184	239	6	41	55	0.7454545
NODE_64313_length_427_cov_9.359756	11	82	0	71	71	1.0000000
NODE_64313_length_427_cov_9.359756	70	149	0	79	79	1.0000000
NODE_64313_length_427_cov_9.359756	145	225	0	80	80	1.0000000
NODE_64313_length_427_cov_9.359756	198	278	0	80	80	1.0000000
NODE_64321_length_427_cov_5.929878	405	424	0	19	19	1.0000000
NODE_64324_length_427_cov_5.088415	257	332	0	75	75	1.0000000
NODE_64345_length_427_cov_3.884146	212	260	0	48	48	1.0000000
NODE_64383_length_427_cov_2.765244	312	363	0	51	51	1.0000000
NODE_64409_length_427_cov_2.362805	142	177	0	35	35	1.0000000
NODE_64537_length_427_cov_1.359756	56	139	0	34	83	0.4096386
NODE_64537_length_427_cov_1.359756	56	139	2	49	83	0.5903614
NODE_64728_length_426_cov_21.837920	178	258	0	80	80	1.0000000
NODE_64729_length_426_cov_16.850153	76	156	0	80	80	1.0000000
NODE_64729_length_426_cov_16.850153	129	209	0	80	80	1.0000000
NODE_64731_length_426_cov_9.033639	152	232	0	80	80	1.0000000
NODE_64731_length_426_cov_9.033639	205	285	0	80	80	1.0000000
NODE_64734_length_426_cov_8.314985	133	213	0	80	80	1.0000000
NODE_64734_length_426_cov_8.314985	186	266	0	80	80	1.0000000
NODE_64735_length_426_cov_8.278287	132	212	0	1	80	0.0125000
NODE_64735_length_426_cov_8.278287	132	212	2	79	80	0.9875000
NODE_64735_length_426_cov_8.278287	185	265	0	54	80	0.6750000
NODE_64735_length_426_cov_8.278287	185	265	2	26	80	0.3250000
NODE_64752_length_426_cov_4.926606	116	196	0	80	80	1.0000000
NODE_64754_length_426_cov_4.743119	119	199	0	80	80	1.0000000
NODE_64754_length_426_cov_4.743119	172	252	0	80	80	1.0000000
NODE_64833_length_426_cov_2.278287	92	132	0	36	40	0.9000000
NODE_64833_length_426_cov_2.278287	92	132	2	4	40	0.1000000
NODE_64833_length_426_cov_2.278287	139	205	0	66	66	1.0000000
NODE_64865_length_426_cov_1.896024	80	154	0	25	74	0.3378378
NODE_64865_length_426_cov_1.896024	80	154	1	1	74	0.0135135
NODE_64865_length_426_cov_1.896024	80	154	2	48	74	0.6486486
NODE_64948_length_426_cov_1.397554	240	290	0	50	50	1.0000000
NODE_65135_length_426_cov_0.602446	127	158	0	31	31	1.0000000
NODE_65152_length_425_cov_63.938650	0	61	0	61	61	1.0000000
NODE_65152_length_425_cov_63.938650	34	114	0	80	80	1.0000000
NODE_65164_length_425_cov_4.877301	171	229	23	18	58	0.3103448
NODE_65164_length_425_cov_4.877301	171	229	25	1	58	0.0172414
NODE_65164_length_425_cov_4.877301	171	229	26	4	58	0.0689655
NODE_65164_length_425_cov_4.877301	171	229	30	5	58	0.0862069
NODE_65164_length_425_cov_4.877301	171	229	32	1	58	0.0172414
NODE_65164_length_425_cov_4.877301	171	229	33	3	58	0.0517241
NODE_65164_length_425_cov_4.877301	171	229	34	3	58	0.0517241
NODE_65164_length_425_cov_4.877301	171	229	35	4	58	0.0689655
NODE_65164_length_425_cov_4.877301	171	229	38	2	58	0.0344828
NODE_65164_length_425_cov_4.877301	171	229	40	5	58	0.0862069
NODE_65164_length_425_cov_4.877301	171	229	41	12	58	0.2068966
NODE_65165_length_425_cov_4.822086	295	377	0	31	82	0.3780488
NODE_65165_length_425_cov_4.822086	295	377	8	8	82	0.0975610
NODE_65165_length_425_cov_4.822086	295	377	12	22	82	0.2682927
NODE_65165_length_425_cov_4.822086	295	377	14	21	82	0.2560976
NODE_65218_length_425_cov_2.809816	38	118	2	5	80	0.0625000
NODE_65218_length_425_cov_2.809816	38	118	6	75	80	0.9375000
NODE_65278_length_425_cov_1.935583	93	138	6	40	45	0.8888889
NODE_65278_length_425_cov_1.935583	93	138	10	5	45	0.1111111
NODE_65278_length_425_cov_1.935583	170	225	0	7	55	0.1272727
NODE_65278_length_425_cov_1.935583	170	225	2	3	55	0.0545455
NODE_65278_length_425_cov_1.935583	170	225	3	1	55	0.0181818
NODE_65278_length_425_cov_1.935583	170	225	4	19	55	0.3454545
NODE_65278_length_425_cov_1.935583	170	225	6	9	55	0.1636364
NODE_65278_length_425_cov_1.935583	170	225	8	16	55	0.2909091
NODE_65278_length_425_cov_1.935583	312	355	6	2	43	0.0465116
NODE_65278_length_425_cov_1.935583	312	355	8	1	43	0.0232558
NODE_65278_length_425_cov_1.935583	312	355	10	21	43	0.4883721
NODE_65278_length_425_cov_1.935583	312	355	12	5	43	0.1162791
NODE_65278_length_425_cov_1.935583	312	355	14	14	43	0.3255814
NODE_65565_length_425_cov_0.628834	104	131	0	27	27	1.0000000
NODE_65602_length_424_cov_5.295385	224	270	7	7	46	0.1521739
NODE_65602_length_424_cov_5.295385	224	270	8	31	46	0.6739131
NODE_65602_length_424_cov_5.295385	224	270	10	4	46	0.0869565
NODE_65602_length_424_cov_5.295385	224	270	12	4	46	0.0869565
NODE_65634_length_424_cov_3.255385	266	329	0	58	63	0.9206349
NODE_65634_length_424_cov_3.255385	266	329	2	5	63	0.0793651
NODE_65669_length_424_cov_2.578462	403	422	0	19	19	1.0000000
NODE_65670_length_424_cov_2.578462	122	144	0	22	22	1.0000000
NODE_66111_length_423_cov_2.728395	150	229	0	30	79	0.3797468
NODE_66111_length_423_cov_2.728395	150	229	3	5	79	0.0632911
NODE_66111_length_423_cov_2.728395	150	229	4	1	79	0.0126582
NODE_66111_length_423_cov_2.728395	150	229	5	21	79	0.2658228
NODE_66111_length_423_cov_2.728395	150	229	7	17	79	0.2151899
NODE_66111_length_423_cov_2.728395	150	229	8	5	79	0.0632911
NODE_66181_length_423_cov_1.879630	94	142	0	48	48	1.0000000
NODE_66222_length_423_cov_1.580247	128	208	0	80	80	1.0000000
NODE_66258_length_423_cov_1.410494	206	286	0	80	80	1.0000000
NODE_66459_length_422_cov_12.021672	201	236	0	13	35	0.3714286
NODE_66459_length_422_cov_12.021672	201	236	2	10	35	0.2857143
NODE_66459_length_422_cov_12.021672	201	236	6	12	35	0.3428572
NODE_66459_length_422_cov_12.021672	247	289	6	42	42	1.0000000
NODE_66460_length_422_cov_10.712074	62	140	0	78	78	1.0000000
NODE_66460_length_422_cov_10.712074	115	195	0	80	80	1.0000000
NODE_66468_length_422_cov_6.281734	37	117	0	49	80	0.6125000
NODE_66468_length_422_cov_6.281734	37	117	2	31	80	0.3875000
NODE_66468_length_422_cov_6.281734	90	170	2	80	80	1.0000000
NODE_66474_length_422_cov_5.266254	176	256	2	15	80	0.1875000
NODE_66474_length_422_cov_5.266254	176	256	4	42	80	0.5250000
NODE_66474_length_422_cov_5.266254	176	256	6	23	80	0.2875000
NODE_66485_length_422_cov_4.148607	159	224	0	65	65	1.0000000
NODE_66485_length_422_cov_4.148607	197	277	0	80	80	1.0000000
NODE_66488_length_422_cov_4.003096	146	226	0	5	80	0.0625000
NODE_66488_length_422_cov_4.003096	146	226	2	45	80	0.5625000
NODE_66488_length_422_cov_4.003096	146	226	4	30	80	0.3750000
NODE_66488_length_422_cov_4.003096	199	279	2	16	80	0.2000000
NODE_66488_length_422_cov_4.003096	199	279	4	26	80	0.3250000
NODE_66488_length_422_cov_4.003096	199	279	6	19	80	0.2375000
NODE_66488_length_422_cov_4.003096	199	279	8	10	80	0.1250000
NODE_66488_length_422_cov_4.003096	199	279	14	9	80	0.1125000
NODE_66512_length_422_cov_3.130031	93	173	11	9	80	0.1125000
NODE_66512_length_422_cov_3.130031	93	173	12	71	80	0.8875000
NODE_66512_length_422_cov_3.130031	146	226	0	35	80	0.4375000
NODE_66512_length_422_cov_3.130031	146	226	10	15	80	0.1875000
NODE_66512_length_422_cov_3.130031	146	226	12	30	80	0.3750000
NODE_66515_length_422_cov_3.077399	291	359	8	5	68	0.0735294
NODE_66515_length_422_cov_3.077399	291	359	10	3	68	0.0441176
NODE_66515_length_422_cov_3.077399	291	359	12	1	68	0.0147059
NODE_66515_length_422_cov_3.077399	291	359	14	1	68	0.0147059
NODE_66515_length_422_cov_3.077399	291	359	16	10	68	0.1470588
NODE_66515_length_422_cov_3.077399	291	359	18	2	68	0.0294118
NODE_66515_length_422_cov_3.077399	291	359	22	3	68	0.0441176
NODE_66515_length_422_cov_3.077399	291	359	26	8	68	0.1176471
NODE_66515_length_422_cov_3.077399	291	359	28	2	68	0.0294118
NODE_66515_length_422_cov_3.077399	291	359	30	24	68	0.3529412
NODE_66515_length_422_cov_3.077399	291	359	32	6	68	0.0882353
NODE_66515_length_422_cov_3.077399	291	359	34	3	68	0.0441176
NODE_66550_length_422_cov_2.191950	5	24	0	2	19	0.1052632
NODE_66550_length_422_cov_2.191950	5	24	2	17	19	0.8947368
NODE_66560_length_422_cov_2.108359	97	177	0	41	80	0.5125000
NODE_66560_length_422_cov_2.108359	97	177	2	23	80	0.2875000
NODE_66560_length_422_cov_2.108359	97	177	4	1	80	0.0125000
NODE_66560_length_422_cov_2.108359	97	177	6	7	80	0.0875000
NODE_66560_length_422_cov_2.108359	97	177	10	2	80	0.0250000
NODE_66560_length_422_cov_2.108359	97	177	12	6	80	0.0750000
NODE_66560_length_422_cov_2.108359	150	189	0	20	39	0.5128205
NODE_66560_length_422_cov_2.108359	150	189	2	19	39	0.4871795
NODE_66560_length_422_cov_2.108359	249	289	12	5	40	0.1250000
NODE_66560_length_422_cov_2.108359	249	289	16	14	40	0.3500000
NODE_66560_length_422_cov_2.108359	249	289	18	1	40	0.0250000
NODE_66560_length_422_cov_2.108359	249	289	20	7	40	0.1750000
NODE_66560_length_422_cov_2.108359	249	289	22	13	40	0.3250000
NODE_66806_length_422_cov_0.845201	2	76	0	74	74	1.0000000
NODE_66869_length_421_cov_10.664596	178	256	0	64	78	0.8205128
NODE_66869_length_421_cov_10.664596	178	256	2	14	78	0.1794872
NODE_66869_length_421_cov_10.664596	229	309	0	80	80	1.0000000
NODE_66874_length_421_cov_7.552795	325	407	0	79	82	0.9634146
NODE_66874_length_421_cov_7.552795	325	407	2	1	82	0.0121951
NODE_66874_length_421_cov_7.552795	325	407	6	1	82	0.0121951
NODE_66874_length_421_cov_7.552795	325	407	10	1	82	0.0121951
NODE_66874_length_421_cov_7.552795	380	421	0	41	41	1.0000000
NODE_66875_length_421_cov_7.431677	96	118	0	22	22	1.0000000
NODE_66883_length_421_cov_5.279503	245	310	0	27	65	0.4153846
NODE_66883_length_421_cov_5.279503	245	310	2	38	65	0.5846154
NODE_66884_length_421_cov_5.158385	68	145	0	77	77	1.0000000
NODE_66897_length_421_cov_4.114907	221	287	0	66	66	1.0000000
NODE_66898_length_421_cov_4.102484	202	277	0	75	75	1.0000000
NODE_66899_length_421_cov_4.040373	192	272	0	80	80	1.0000000
NODE_66899_length_421_cov_4.040373	245	314	0	69	69	1.0000000
NODE_66923_length_421_cov_3.319876	0	57	0	56	57	0.9824561
NODE_66923_length_421_cov_3.319876	0	57	2	1	57	0.0175439
NODE_66955_length_421_cov_2.708075	95	118	0	23	23	1.0000000
NODE_66955_length_421_cov_2.708075	109	189	0	48	80	0.6000000
NODE_66955_length_421_cov_2.708075	109	189	1	32	80	0.4000000
NODE_66955_length_421_cov_2.708075	248	300	2	9	52	0.1730769
NODE_66955_length_421_cov_2.708075	248	300	4	43	52	0.8269231
NODE_67073_length_421_cov_1.559006	240	309	2	30	69	0.4347826
NODE_67073_length_421_cov_1.559006	240	309	3	18	69	0.2608696
NODE_67073_length_421_cov_1.559006	240	309	4	21	69	0.3043478
NODE_67073_length_421_cov_1.559006	240	310	2	31	70	0.4428571
NODE_67073_length_421_cov_1.559006	240	310	3	18	70	0.2571429
NODE_67073_length_421_cov_1.559006	240	310	4	21	70	0.3000000
NODE_67077_length_421_cov_1.537267	305	383	0	19	78	0.2435897
NODE_67077_length_421_cov_1.537267	305	383	2	59	78	0.7564102
NODE_67098_length_421_cov_1.413043	254	303	0	49	49	1.0000000
NODE_67283_length_421_cov_0.633540	132	156	0	24	24	1.0000000
NODE_67317_length_420_cov_80.766355	90	170	0	80	80	1.0000000
NODE_67317_length_420_cov_80.766355	143	223	0	80	80	1.0000000
NODE_67319_length_420_cov_51.473520	171	250	0	79	79	1.0000000
NODE_67319_length_420_cov_51.473520	223	307	0	84	84	1.0000000
NODE_67319_length_420_cov_51.473520	303	383	0	80	80	1.0000000
NODE_67319_length_420_cov_51.473520	356	420	0	64	64	1.0000000
NODE_67330_length_420_cov_5.071651	230	310	0	80	80	1.0000000
NODE_67334_length_420_cov_4.775701	177	221	0	9	44	0.2045455
NODE_67334_length_420_cov_4.775701	177	221	2	35	44	0.7954546
NODE_67345_length_420_cov_4.037383	161	240	3	21	79	0.2658228
NODE_67345_length_420_cov_4.037383	161	240	5	3	79	0.0379747
NODE_67345_length_420_cov_4.037383	161	240	6	55	79	0.6962025
NODE_67358_length_420_cov_3.657321	291	373	0	75	82	0.9146342
NODE_67358_length_420_cov_3.657321	291	373	2	7	82	0.0853659
NODE_67398_length_420_cov_2.542056	96	176	0	80	80	1.0000000
NODE_67398_length_420_cov_2.542056	148	202	0	52	54	0.9629630
NODE_67398_length_420_cov_2.542056	148	202	2	2	54	0.0370370
NODE_67398_length_420_cov_2.542056	149	195	0	46	46	1.0000000
NODE_67414_length_420_cov_2.323988	89	108	2	19	19	1.0000000
NODE_67506_length_420_cov_1.641745	277	312	0	35	35	1.0000000
NODE_67547_length_420_cov_1.429907	15	68	0	12	53	0.2264151
NODE_67547_length_420_cov_1.429907	15	68	4	10	53	0.1886792
NODE_67547_length_420_cov_1.429907	15	68	6	31	53	0.5849057
NODE_67547_length_420_cov_1.429907	69	111	6	16	42	0.3809524
NODE_67547_length_420_cov_1.429907	69	111	10	5	42	0.1190476
NODE_67547_length_420_cov_1.429907	69	111	16	21	42	0.5000000
NODE_67770_length_419_cov_491.015625	0	67	6	6	67	0.0895522
NODE_67770_length_419_cov_491.015625	0	67	8	6	67	0.0895522
NODE_67770_length_419_cov_491.015625	0	67	12	14	67	0.2089552
NODE_67770_length_419_cov_491.015625	0	67	18	3	67	0.0447761
NODE_67770_length_419_cov_491.015625	0	67	22	10	67	0.1492537
NODE_67770_length_419_cov_491.015625	0	67	24	2	67	0.0298507
NODE_67770_length_419_cov_491.015625	0	67	32	7	67	0.1044776
NODE_67770_length_419_cov_491.015625	0	67	34	19	67	0.2835821
NODE_67770_length_419_cov_491.015625	0	67	6	6	67	0.0895522
NODE_67770_length_419_cov_491.015625	0	67	8	6	67	0.0895522
NODE_67770_length_419_cov_491.015625	0	67	12	14	67	0.2089552
NODE_67770_length_419_cov_491.015625	0	67	18	3	67	0.0447761
NODE_67770_length_419_cov_491.015625	0	67	22	10	67	0.1492537
NODE_67770_length_419_cov_491.015625	0	67	24	2	67	0.0298507
NODE_67770_length_419_cov_491.015625	0	67	32	7	67	0.1044776
NODE_67770_length_419_cov_491.015625	0	67	34	19	67	0.2835821
NODE_67770_length_419_cov_491.015625	0	67	6	6	67	0.0895522
NODE_67770_length_419_cov_491.015625	0	67	8	6	67	0.0895522
NODE_67770_length_419_cov_491.015625	0	67	12	14	67	0.2089552
NODE_67770_length_419_cov_491.015625	0	67	18	3	67	0.0447761
NODE_67770_length_419_cov_491.015625	0	67	22	10	67	0.1492537
NODE_67770_length_419_cov_491.015625	0	67	24	2	67	0.0298507
NODE_67770_length_419_cov_491.015625	0	67	32	7	67	0.1044776
NODE_67770_length_419_cov_491.015625	0	67	34	19	67	0.2835821
NODE_67770_length_419_cov_491.015625	0	67	6	6	67	0.0895522
NODE_67770_length_419_cov_491.015625	0	67	8	6	67	0.0895522
NODE_67770_length_419_cov_491.015625	0	67	12	14	67	0.2089552
NODE_67770_length_419_cov_491.015625	0	67	18	3	67	0.0447761
NODE_67770_length_419_cov_491.015625	0	67	22	10	67	0.1492537
NODE_67770_length_419_cov_491.015625	0	67	24	2	67	0.0298507
NODE_67770_length_419_cov_491.015625	0	67	32	7	67	0.1044776
NODE_67770_length_419_cov_491.015625	0	67	34	19	67	0.2835821
NODE_67770_length_419_cov_491.015625	63	143	34	6	80	0.0750000
NODE_67770_length_419_cov_491.015625	63	143	36	22	80	0.2750000
NODE_67770_length_419_cov_491.015625	63	143	38	4	80	0.0500000
NODE_67770_length_419_cov_491.015625	63	143	40	5	80	0.0625000
NODE_67770_length_419_cov_491.015625	63	143	41	2	80	0.0250000
NODE_67770_length_419_cov_491.015625	63	143	42	22	80	0.2750000
NODE_67770_length_419_cov_491.015625	63	143	46	9	80	0.1125000
NODE_67770_length_419_cov_491.015625	63	143	48	9	80	0.1125000
NODE_67770_length_419_cov_491.015625	63	143	49	1	80	0.0125000
NODE_67770_length_419_cov_491.015625	63	143	34	6	80	0.0750000
NODE_67770_length_419_cov_491.015625	63	143	36	22	80	0.2750000
NODE_67770_length_419_cov_491.015625	63	143	38	4	80	0.0500000
NODE_67770_length_419_cov_491.015625	63	143	40	5	80	0.0625000
NODE_67770_length_419_cov_491.015625	63	143	41	2	80	0.0250000
NODE_67770_length_419_cov_491.015625	63	143	42	22	80	0.2750000
NODE_67770_length_419_cov_491.015625	63	143	46	9	80	0.1125000
NODE_67770_length_419_cov_491.015625	63	143	48	9	80	0.1125000
NODE_67770_length_419_cov_491.015625	63	143	49	1	80	0.0125000
NODE_67770_length_419_cov_491.015625	63	143	34	6	80	0.0750000
NODE_67770_length_419_cov_491.015625	63	143	36	22	80	0.2750000
NODE_67770_length_419_cov_491.015625	63	143	38	4	80	0.0500000
NODE_67770_length_419_cov_491.015625	63	143	40	5	80	0.0625000
NODE_67770_length_419_cov_491.015625	63	143	41	2	80	0.0250000
NODE_67770_length_419_cov_491.015625	63	143	42	22	80	0.2750000
NODE_67770_length_419_cov_491.015625	63	143	46	9	80	0.1125000
NODE_67770_length_419_cov_491.015625	63	143	48	9	80	0.1125000
NODE_67770_length_419_cov_491.015625	63	143	49	1	80	0.0125000
NODE_67770_length_419_cov_491.015625	116	196	25	3	80	0.0375000
NODE_67770_length_419_cov_491.015625	116	196	26	13	80	0.1625000
NODE_67770_length_419_cov_491.015625	116	196	27	1	80	0.0125000
NODE_67770_length_419_cov_491.015625	116	196	28	2	80	0.0250000
NODE_67770_length_419_cov_491.015625	116	196	29	1	80	0.0125000
NODE_67770_length_419_cov_491.015625	116	196	30	1	80	0.0125000
NODE_67770_length_419_cov_491.015625	116	196	31	3	80	0.0375000
NODE_67770_length_419_cov_491.015625	116	196	34	5	80	0.0625000
NODE_67770_length_419_cov_491.015625	116	196	36	11	80	0.1375000
NODE_67770_length_419_cov_491.015625	116	196	38	16	80	0.2000000
NODE_67770_length_419_cov_491.015625	116	196	42	5	80	0.0625000
NODE_67770_length_419_cov_491.015625	116	196	46	9	80	0.1125000
NODE_67770_length_419_cov_491.015625	116	196	48	9	80	0.1125000
NODE_67770_length_419_cov_491.015625	116	196	49	1	80	0.0125000
NODE_67770_length_419_cov_491.015625	116	196	25	3	80	0.0375000
NODE_67770_length_419_cov_491.015625	116	196	26	13	80	0.1625000
NODE_67770_length_419_cov_491.015625	116	196	27	1	80	0.0125000
NODE_67770_length_419_cov_491.015625	116	196	28	2	80	0.0250000
NODE_67770_length_419_cov_491.015625	116	196	29	1	80	0.0125000
NODE_67770_length_419_cov_491.015625	116	196	30	1	80	0.0125000
NODE_67770_length_419_cov_491.015625	116	196	31	3	80	0.0375000
NODE_67770_length_419_cov_491.015625	116	196	34	5	80	0.0625000
NODE_67770_length_419_cov_491.015625	116	196	36	11	80	0.1375000
NODE_67770_length_419_cov_491.015625	116	196	38	16	80	0.2000000
NODE_67770_length_419_cov_491.015625	116	196	42	5	80	0.0625000
NODE_67770_length_419_cov_491.015625	116	196	46	9	80	0.1125000
NODE_67770_length_419_cov_491.015625	116	196	48	9	80	0.1125000
NODE_67770_length_419_cov_491.015625	116	196	49	1	80	0.0125000
NODE_67770_length_419_cov_491.015625	116	196	25	3	80	0.0375000
NODE_67770_length_419_cov_491.015625	116	196	26	13	80	0.1625000
NODE_67770_length_419_cov_491.015625	116	196	27	1	80	0.0125000
NODE_67770_length_419_cov_491.015625	116	196	28	2	80	0.0250000
NODE_67770_length_419_cov_491.015625	116	196	29	1	80	0.0125000
NODE_67770_length_419_cov_491.015625	116	196	30	1	80	0.0125000
NODE_67770_length_419_cov_491.015625	116	196	31	3	80	0.0375000
NODE_67770_length_419_cov_491.015625	116	196	34	5	80	0.0625000
NODE_67770_length_419_cov_491.015625	116	196	36	11	80	0.1375000
NODE_67770_length_419_cov_491.015625	116	196	38	16	80	0.2000000
NODE_67770_length_419_cov_491.015625	116	196	42	5	80	0.0625000
NODE_67770_length_419_cov_491.015625	116	196	46	9	80	0.1125000
NODE_67770_length_419_cov_491.015625	116	196	48	9	80	0.1125000
NODE_67770_length_419_cov_491.015625	116	196	49	1	80	0.0125000
NODE_67770_length_419_cov_491.015625	116	196	25	3	80	0.0375000
NODE_67770_length_419_cov_491.015625	116	196	26	13	80	0.1625000
NODE_67770_length_419_cov_491.015625	116	196	27	1	80	0.0125000
NODE_67770_length_419_cov_491.015625	116	196	28	2	80	0.0250000
NODE_67770_length_419_cov_491.015625	116	196	29	1	80	0.0125000
NODE_67770_length_419_cov_491.015625	116	196	30	1	80	0.0125000
NODE_67770_length_419_cov_491.015625	116	196	31	3	80	0.0375000
NODE_67770_length_419_cov_491.015625	116	196	34	5	80	0.0625000
NODE_67770_length_419_cov_491.015625	116	196	36	11	80	0.1375000
NODE_67770_length_419_cov_491.015625	116	196	38	16	80	0.2000000
NODE_67770_length_419_cov_491.015625	116	196	42	5	80	0.0625000
NODE_67770_length_419_cov_491.015625	116	196	46	9	80	0.1125000
NODE_67770_length_419_cov_491.015625	116	196	48	9	80	0.1125000
NODE_67770_length_419_cov_491.015625	116	196	49	1	80	0.0125000
NODE_67770_length_419_cov_491.015625	116	196	25	3	80	0.0375000
NODE_67770_length_419_cov_491.015625	116	196	26	13	80	0.1625000
NODE_67770_length_419_cov_491.015625	116	196	27	1	80	0.0125000
NODE_67770_length_419_cov_491.015625	116	196	28	2	80	0.0250000
NODE_67770_length_419_cov_491.015625	116	196	29	1	80	0.0125000
NODE_67770_length_419_cov_491.015625	116	196	30	1	80	0.0125000
NODE_67770_length_419_cov_491.015625	116	196	31	3	80	0.0375000
NODE_67770_length_419_cov_491.015625	116	196	34	5	80	0.0625000
NODE_67770_length_419_cov_491.015625	116	196	36	11	80	0.1375000
NODE_67770_length_419_cov_491.015625	116	196	38	16	80	0.2000000
NODE_67770_length_419_cov_491.015625	116	196	42	5	80	0.0625000
NODE_67770_length_419_cov_491.015625	116	196	46	9	80	0.1125000
NODE_67770_length_419_cov_491.015625	116	196	48	9	80	0.1125000
NODE_67770_length_419_cov_491.015625	116	196	49	1	80	0.0125000
NODE_67772_length_419_cov_31.725000	12	92	0	80	80	1.0000000
NODE_67772_length_419_cov_31.725000	65	145	0	80	80	1.0000000
NODE_67789_length_419_cov_4.862500	47	103	0	56	56	1.0000000
NODE_67789_length_419_cov_4.862500	258	327	2	3	69	0.0434783
NODE_67789_length_419_cov_4.862500	258	327	4	7	69	0.1014493
NODE_67789_length_419_cov_4.862500	258	327	6	59	69	0.8550724
NODE_67789_length_419_cov_4.862500	284	328	2	4	44	0.0909091
NODE_67789_length_419_cov_4.862500	284	328	4	7	44	0.1590909
NODE_67789_length_419_cov_4.862500	284	328	6	33	44	0.7500000
NODE_67803_length_419_cov_4.193750	215	262	0	47	47	1.0000000
NODE_67803_length_419_cov_4.193750	235	275	0	40	40	1.0000000
NODE_67817_length_419_cov_3.696875	165	215	0	50	50	1.0000000
NODE_67854_length_419_cov_2.628125	234	314	0	4	80	0.0500000
NODE_67854_length_419_cov_2.628125	234	314	4	41	80	0.5125000
NODE_67854_length_419_cov_2.628125	234	314	7	3	80	0.0375000
NODE_67854_length_419_cov_2.628125	234	314	8	32	80	0.4000000
NODE_67856_length_419_cov_2.603125	154	196	0	42	42	1.0000000
NODE_67878_length_419_cov_2.350000	156	220	26	14	64	0.2187500
NODE_67878_length_419_cov_2.350000	156	220	28	12	64	0.1875000
NODE_67878_length_419_cov_2.350000	156	220	30	4	64	0.0625000
NODE_67878_length_419_cov_2.350000	156	220	32	10	64	0.1562500
NODE_67878_length_419_cov_2.350000	156	220	34	16	64	0.2500000
NODE_67878_length_419_cov_2.350000	156	220	36	8	64	0.1250000
NODE_67961_length_419_cov_1.593750	339	358	0	19	19	1.0000000
NODE_68250_length_418_cov_63.059561	105	186	0	81	81	1.0000000
NODE_68250_length_418_cov_63.059561	159	239	0	80	80	1.0000000
NODE_68251_length_418_cov_49.796238	325	405	7	2	80	0.0250000
NODE_68251_length_418_cov_49.796238	325	405	9	11	80	0.1375000
NODE_68251_length_418_cov_49.796238	325	405	12	2	80	0.0250000
NODE_68251_length_418_cov_49.796238	325	405	13	6	80	0.0750000
NODE_68251_length_418_cov_49.796238	325	405	15	1	80	0.0125000
NODE_68251_length_418_cov_49.796238	325	405	19	2	80	0.0250000
NODE_68251_length_418_cov_49.796238	325	405	22	1	80	0.0125000
NODE_68251_length_418_cov_49.796238	325	405	26	1	80	0.0125000
NODE_68251_length_418_cov_49.796238	325	405	36	2	80	0.0250000
NODE_68251_length_418_cov_49.796238	325	405	38	3	80	0.0375000
NODE_68251_length_418_cov_49.796238	325	405	39	2	80	0.0250000
NODE_68251_length_418_cov_49.796238	325	405	40	1	80	0.0125000
NODE_68251_length_418_cov_49.796238	325	405	44	6	80	0.0750000
NODE_68251_length_418_cov_49.796238	325	405	46	1	80	0.0125000
NODE_68251_length_418_cov_49.796238	325	405	48	11	80	0.1375000
NODE_68251_length_418_cov_49.796238	325	405	49	1	80	0.0125000
NODE_68251_length_418_cov_49.796238	325	405	53	1	80	0.0125000
NODE_68251_length_418_cov_49.796238	325	405	57	2	80	0.0250000
NODE_68251_length_418_cov_49.796238	325	405	61	1	80	0.0125000
NODE_68251_length_418_cov_49.796238	325	405	65	1	80	0.0125000
NODE_68251_length_418_cov_49.796238	325	405	67	1	80	0.0125000
NODE_68251_length_418_cov_49.796238	325	405	69	6	80	0.0750000
NODE_68251_length_418_cov_49.796238	325	405	71	4	80	0.0500000
NODE_68251_length_418_cov_49.796238	325	405	75	1	80	0.0125000
NODE_68251_length_418_cov_49.796238	325	405	77	4	80	0.0500000
NODE_68251_length_418_cov_49.796238	325	405	79	2	80	0.0250000
NODE_68251_length_418_cov_49.796238	325	405	80	1	80	0.0125000
NODE_68251_length_418_cov_49.796238	325	405	81	1	80	0.0125000
NODE_68251_length_418_cov_49.796238	325	405	85	1	80	0.0125000
NODE_68251_length_418_cov_49.796238	325	405	86	1	80	0.0125000
NODE_68251_length_418_cov_49.796238	378	415	0	8	37	0.2162162
NODE_68251_length_418_cov_49.796238	378	415	1	2	37	0.0540541
NODE_68251_length_418_cov_49.796238	378	415	7	2	37	0.0540541
NODE_68251_length_418_cov_49.796238	378	415	9	11	37	0.2972973
NODE_68251_length_418_cov_49.796238	378	415	12	2	37	0.0540541
NODE_68251_length_418_cov_49.796238	378	415	13	6	37	0.1621622
NODE_68251_length_418_cov_49.796238	378	415	15	1	37	0.0270270
NODE_68251_length_418_cov_49.796238	378	415	19	2	37	0.0540541
NODE_68251_length_418_cov_49.796238	378	415	22	1	37	0.0270270
NODE_68251_length_418_cov_49.796238	378	415	26	1	37	0.0270270
NODE_68251_length_418_cov_49.796238	378	415	36	1	37	0.0270270
NODE_68252_length_418_cov_42.764890	119	196	0	77	77	1.0000000
NODE_68252_length_418_cov_42.764890	172	250	0	78	78	1.0000000
NODE_68253_length_418_cov_23.830721	73	153	0	80	80	1.0000000
NODE_68253_length_418_cov_23.830721	126	200	0	74	74	1.0000000
NODE_68255_length_418_cov_7.216301	211	291	2	29	80	0.3625000
NODE_68255_length_418_cov_7.216301	211	291	4	29	80	0.3625000
NODE_68255_length_418_cov_7.216301	211	291	6	2	80	0.0250000
NODE_68255_length_418_cov_7.216301	211	291	8	20	80	0.2500000
NODE_68265_length_418_cov_5.382445	134	215	0	81	81	1.0000000
NODE_68265_length_418_cov_5.382445	187	268	0	44	81	0.5432099
NODE_68265_length_418_cov_5.382445	187	268	4	37	81	0.4567901
NODE_68275_length_418_cov_4.463950	191	272	2	8	81	0.0987654
NODE_68275_length_418_cov_4.463950	191	272	4	18	81	0.2222222
NODE_68275_length_418_cov_4.463950	191	272	6	5	81	0.0617284
NODE_68275_length_418_cov_4.463950	191	272	10	33	81	0.4074074
NODE_68275_length_418_cov_4.463950	191	272	12	17	81	0.2098765
NODE_68280_length_418_cov_4.216301	148	230	2	13	82	0.1585366
NODE_68280_length_418_cov_4.216301	148	230	3	3	82	0.0365854
NODE_68280_length_418_cov_4.216301	148	230	4	8	82	0.0975610
NODE_68280_length_418_cov_4.216301	148	230	5	57	82	0.6951219
NODE_68280_length_418_cov_4.216301	148	230	7	1	82	0.0121951
NODE_68281_length_418_cov_4.065831	211	280	0	18	69	0.2608696
NODE_68281_length_418_cov_4.065831	211	280	4	51	69	0.7391304
NODE_68284_length_418_cov_3.909091	95	175	3	3	80	0.0375000
NODE_68284_length_418_cov_3.909091	95	175	4	8	80	0.1000000
NODE_68284_length_418_cov_3.909091	95	175	5	16	80	0.2000000
NODE_68284_length_418_cov_3.909091	95	175	6	1	80	0.0125000
NODE_68284_length_418_cov_3.909091	95	175	7	4	80	0.0500000
NODE_68284_length_418_cov_3.909091	95	175	8	1	80	0.0125000
NODE_68284_length_418_cov_3.909091	95	175	11	2	80	0.0250000
NODE_68284_length_418_cov_3.909091	95	175	17	2	80	0.0250000
NODE_68284_length_418_cov_3.909091	95	175	19	5	80	0.0625000
NODE_68284_length_418_cov_3.909091	95	175	21	2	80	0.0250000
NODE_68284_length_418_cov_3.909091	95	175	22	4	80	0.0500000
NODE_68284_length_418_cov_3.909091	95	175	24	3	80	0.0375000
NODE_68284_length_418_cov_3.909091	95	175	26	29	80	0.3625000
NODE_68284_length_418_cov_3.909091	148	224	3	3	76	0.0394737
NODE_68284_length_418_cov_3.909091	148	224	4	8	76	0.1052632
NODE_68284_length_418_cov_3.909091	148	224	5	16	76	0.2105263
NODE_68284_length_418_cov_3.909091	148	224	6	3	76	0.0394737
NODE_68284_length_418_cov_3.909091	148	224	7	6	76	0.0789474
NODE_68284_length_418_cov_3.909091	148	224	8	23	76	0.3026316
NODE_68284_length_418_cov_3.909091	148	224	10	2	76	0.0263158
NODE_68284_length_418_cov_3.909091	148	224	12	5	76	0.0657895
NODE_68284_length_418_cov_3.909091	148	224	14	4	76	0.0526316
NODE_68284_length_418_cov_3.909091	148	224	18	4	76	0.0526316
NODE_68284_length_418_cov_3.909091	148	224	20	2	76	0.0263158
NODE_68288_length_418_cov_3.749216	181	247	2	37	66	0.5606061
NODE_68288_length_418_cov_3.749216	181	247	4	29	66	0.4393939
NODE_68289_length_418_cov_3.711599	249	313	0	4	64	0.0625000
NODE_68289_length_418_cov_3.711599	249	313	3	23	64	0.3593750
NODE_68289_length_418_cov_3.711599	249	313	5	16	64	0.2500000
NODE_68289_length_418_cov_3.711599	249	313	7	21	64	0.3281250
NODE_68307_length_418_cov_3.012539	101	181	0	44	80	0.5500000
NODE_68307_length_418_cov_3.012539	101	181	2	36	80	0.4500000
NODE_68354_length_418_cov_2.376176	95	115	0	20	20	1.0000000
NODE_68436_length_418_cov_1.623824	47	128	2	81	81	1.0000000
NODE_68436_length_418_cov_1.623824	239	268	10	16	29	0.5517241
NODE_68436_length_418_cov_1.623824	239	268	14	5	29	0.1724138
NODE_68436_length_418_cov_1.623824	239	268	15	1	29	0.0344828
NODE_68436_length_418_cov_1.623824	239	268	16	7	29	0.2413793
NODE_68682_length_418_cov_0.626959	255	299	0	44	44	1.0000000
NODE_68708_length_417_cov_45.267296	212	292	0	80	80	1.0000000
NODE_68708_length_417_cov_45.267296	265	345	0	80	80	1.0000000
NODE_68708_length_417_cov_45.267296	341	417	0	76	76	1.0000000
NODE_68709_length_417_cov_36.006289	159	239	10	12	80	0.1500000
NODE_68709_length_417_cov_36.006289	159	239	12	8	80	0.1000000
NODE_68709_length_417_cov_36.006289	159	239	21	2	80	0.0250000
NODE_68709_length_417_cov_36.006289	159	239	22	58	80	0.7250000
NODE_68711_length_417_cov_12.886792	193	273	0	80	80	1.0000000
NODE_68711_length_417_cov_12.886792	246	326	0	49	80	0.6125000
NODE_68711_length_417_cov_12.886792	246	326	2	31	80	0.3875000
NODE_68717_length_417_cov_7.056604	210	271	4	8	61	0.1311475
NODE_68717_length_417_cov_7.056604	210	271	6	53	61	0.8688524
NODE_68717_length_417_cov_7.056604	263	315	2	13	52	0.2500000
NODE_68717_length_417_cov_7.056604	263	315	4	17	52	0.3269231
NODE_68717_length_417_cov_7.056604	263	315	6	22	52	0.4230769
NODE_68718_length_417_cov_6.669811	194	264	12	15	70	0.2142857
NODE_68718_length_417_cov_6.669811	194	264	14	55	70	0.7857143
NODE_68779_length_417_cov_2.795597	20	91	0	71	71	1.0000000
NODE_69163_length_416_cov_115.782334	174	259	12	10	85	0.1176471
NODE_69163_length_416_cov_115.782334	174	259	18	1	85	0.0117647
NODE_69163_length_416_cov_115.782334	174	259	22	8	85	0.0941176
NODE_69163_length_416_cov_115.782334	174	259	26	2	85	0.0235294
NODE_69163_length_416_cov_115.782334	174	259	27	4	85	0.0470588
NODE_69163_length_416_cov_115.782334	174	259	33	1	85	0.0117647
NODE_69163_length_416_cov_115.782334	174	259	35	3	85	0.0352941
NODE_69163_length_416_cov_115.782334	174	259	39	19	85	0.2235294
NODE_69163_length_416_cov_115.782334	174	259	44	2	85	0.0235294
NODE_69163_length_416_cov_115.782334	174	259	49	12	85	0.1411765
NODE_69163_length_416_cov_115.782334	174	259	53	6	85	0.0705882
NODE_69163_length_416_cov_115.782334	174	259	56	14	85	0.1647059
NODE_69163_length_416_cov_115.782334	174	259	57	1	85	0.0117647
NODE_69163_length_416_cov_115.782334	174	259	60	1	85	0.0117647
NODE_69163_length_416_cov_115.782334	174	259	62	1	85	0.0117647
NODE_69164_length_416_cov_70.678233	180	244	11	1	64	0.0156250
NODE_69164_length_416_cov_70.678233	180	244	15	1	64	0.0156250
NODE_69164_length_416_cov_70.678233	180	244	18	1	64	0.0156250
NODE_69164_length_416_cov_70.678233	180	244	22	2	64	0.0312500
NODE_69164_length_416_cov_70.678233	180	244	26	4	64	0.0625000
NODE_69164_length_416_cov_70.678233	180	244	30	6	64	0.0937500
NODE_69164_length_416_cov_70.678233	180	244	32	1	64	0.0156250
NODE_69164_length_416_cov_70.678233	180	244	33	1	64	0.0156250
NODE_69164_length_416_cov_70.678233	180	244	34	8	64	0.1250000
NODE_69164_length_416_cov_70.678233	180	244	35	1	64	0.0156250
NODE_69164_length_416_cov_70.678233	180	244	36	4	64	0.0625000
NODE_69164_length_416_cov_70.678233	180	244	38	2	64	0.0312500
NODE_69164_length_416_cov_70.678233	180	244	40	9	64	0.1406250
NODE_69164_length_416_cov_70.678233	180	244	47	3	64	0.0468750
NODE_69164_length_416_cov_70.678233	180	244	51	6	64	0.0937500
NODE_69164_length_416_cov_70.678233	180	244	54	1	64	0.0156250
NODE_69164_length_416_cov_70.678233	180	244	55	13	64	0.2031250
NODE_69166_length_416_cov_39.933754	288	368	0	21	80	0.2625000
NODE_69166_length_416_cov_39.933754	288	368	2	59	80	0.7375000
NODE_69166_length_416_cov_39.933754	341	416	0	40	75	0.5333334
NODE_69166_length_416_cov_39.933754	341	416	2	35	75	0.4666667
NODE_69167_length_416_cov_37.334385	158	238	0	48	80	0.6000000
NODE_69167_length_416_cov_37.334385	158	238	2	23	80	0.2875000
NODE_69167_length_416_cov_37.334385	158	238	4	9	80	0.1125000
NODE_69167_length_416_cov_37.334385	211	291	0	80	80	1.0000000
NODE_69167_length_416_cov_37.334385	287	367	0	80	80	1.0000000
NODE_69167_length_416_cov_37.334385	340	416	0	76	76	1.0000000
NODE_69179_length_416_cov_5.242902	89	169	0	80	80	1.0000000
NODE_69179_length_416_cov_5.242902	142	222	0	80	80	1.0000000
NODE_69184_length_416_cov_4.892744	79	145	0	66	66	1.0000000
NODE_69184_length_416_cov_4.892744	194	272	0	78	78	1.0000000
NODE_69184_length_416_cov_4.892744	247	272	0	25	25	1.0000000
NODE_69204_length_416_cov_3.886435	79	136	6	27	57	0.4736842
NODE_69204_length_416_cov_3.886435	79	136	8	30	57	0.5263158
NODE_69279_length_416_cov_2.230284	10	90	2	9	80	0.1125000
NODE_69279_length_416_cov_2.230284	10	90	4	71	80	0.8875000
NODE_69399_length_416_cov_1.520505	198	244	0	8	46	0.1739130
NODE_69399_length_416_cov_1.520505	198	244	2	13	46	0.2826087
NODE_69399_length_416_cov_1.520505	198	244	4	14	46	0.3043478
NODE_69399_length_416_cov_1.520505	198	244	6	11	46	0.2391304
NODE_69399_length_416_cov_1.520505	261	328	11	9	67	0.1343284
NODE_69399_length_416_cov_1.520505	261	328	12	13	67	0.1940299
NODE_69399_length_416_cov_1.520505	261	328	14	2	67	0.0298507
NODE_69399_length_416_cov_1.520505	261	328	16	2	67	0.0298507
NODE_69399_length_416_cov_1.520505	261	328	18	1	67	0.0149254
NODE_69399_length_416_cov_1.520505	261	328	20	6	67	0.0895522
NODE_69399_length_416_cov_1.520505	261	328	22	21	67	0.3134328
NODE_69399_length_416_cov_1.520505	261	328	24	13	67	0.1940299
NODE_69673_length_415_cov_35.924051	260	339	0	34	79	0.4303797
NODE_69673_length_415_cov_35.924051	260	339	2	45	79	0.5696203
NODE_69673_length_415_cov_35.924051	316	392	0	76	76	1.0000000
NODE_69679_length_415_cov_6.376582	117	197	0	80	80	1.0000000
NODE_69679_length_415_cov_6.376582	254	334	2	80	80	1.0000000
NODE_69774_length_415_cov_2.224684	144	224	2	14	80	0.1750000
NODE_69774_length_415_cov_2.224684	144	224	4	11	80	0.1375000
NODE_69774_length_415_cov_2.224684	144	224	6	46	80	0.5750000
NODE_69774_length_415_cov_2.224684	144	224	8	9	80	0.1125000
NODE_69795_length_415_cov_2.069620	207	273	0	57	66	0.8636364
NODE_69795_length_415_cov_2.069620	207	273	2	9	66	0.1363636
NODE_69817_length_415_cov_1.832278	225	283	4	18	58	0.3103448
NODE_69817_length_415_cov_1.832278	225	283	6	4	58	0.0689655
NODE_69817_length_415_cov_1.832278	225	283	8	13	58	0.2241379
NODE_69817_length_415_cov_1.832278	225	283	10	5	58	0.0862069
NODE_69817_length_415_cov_1.832278	225	283	12	18	58	0.3103448
NODE_69845_length_415_cov_1.610759	90	170	52	2	80	0.0250000
NODE_69845_length_415_cov_1.610759	90	170	54	1	80	0.0125000
NODE_69845_length_415_cov_1.610759	90	170	58	7	80	0.0875000
NODE_69845_length_415_cov_1.610759	90	170	60	2	80	0.0250000
NODE_69845_length_415_cov_1.610759	90	170	62	2	80	0.0250000
NODE_69845_length_415_cov_1.610759	90	170	64	3	80	0.0375000
NODE_69845_length_415_cov_1.610759	90	170	66	3	80	0.0375000
NODE_69845_length_415_cov_1.610759	90	170	68	1	80	0.0125000
NODE_69845_length_415_cov_1.610759	90	170	70	2	80	0.0250000
NODE_69845_length_415_cov_1.610759	90	170	76	2	80	0.0250000
NODE_69845_length_415_cov_1.610759	90	170	84	2	80	0.0250000
NODE_69845_length_415_cov_1.610759	90	170	88	7	80	0.0875000
NODE_69845_length_415_cov_1.610759	90	170	90	1	80	0.0125000
NODE_69845_length_415_cov_1.610759	90	170	92	3	80	0.0375000
NODE_69845_length_415_cov_1.610759	90	170	94	1	80	0.0125000
NODE_69845_length_415_cov_1.610759	90	170	96	3	80	0.0375000
NODE_69845_length_415_cov_1.610759	90	170	98	3	80	0.0375000
NODE_69845_length_415_cov_1.610759	90	170	100	1	80	0.0125000
NODE_69845_length_415_cov_1.610759	90	170	102	3	80	0.0375000
NODE_69845_length_415_cov_1.610759	90	170	104	2	80	0.0250000
NODE_69845_length_415_cov_1.610759	90	170	106	7	80	0.0875000
NODE_69845_length_415_cov_1.610759	90	170	108	22	80	0.2750000
NODE_69845_length_415_cov_1.610759	335	376	0	41	41	1.0000000
NODE_70175_length_414_cov_46.263492	0	49	0	49	49	1.0000000
NODE_70175_length_414_cov_46.263492	22	102	0	80	80	1.0000000
NODE_70183_length_414_cov_7.460317	167	247	0	36	80	0.4500000
NODE_70183_length_414_cov_7.460317	167	247	1	1	80	0.0125000
NODE_70183_length_414_cov_7.460317	167	247	2	43	80	0.5375000
NODE_70183_length_414_cov_7.460317	220	300	0	32	80	0.4000000
NODE_70183_length_414_cov_7.460317	220	300	1	1	80	0.0125000
NODE_70183_length_414_cov_7.460317	220	300	2	47	80	0.5875000
NODE_70192_length_414_cov_5.676190	54	134	2	80	80	1.0000000
NODE_70192_length_414_cov_5.676190	107	187	0	48	80	0.6000000
NODE_70192_length_414_cov_5.676190	107	187	2	32	80	0.4000000
NODE_70222_length_414_cov_4.130159	257	303	6	44	46	0.9565217
NODE_70222_length_414_cov_4.130159	257	303	8	2	46	0.0434783
NODE_70222_length_414_cov_4.130159	276	356	0	9	80	0.1125000
NODE_70222_length_414_cov_4.130159	276	356	2	8	80	0.1000000
NODE_70222_length_414_cov_4.130159	276	356	6	63	80	0.7875000
NODE_70254_length_414_cov_2.996825	75	135	14	28	60	0.4666667
NODE_70254_length_414_cov_2.996825	75	135	16	32	60	0.5333334
NODE_70271_length_414_cov_2.631746	68	145	2	77	77	1.0000000
NODE_70284_length_414_cov_2.473016	164	197	0	33	33	1.0000000
NODE_70284_length_414_cov_2.473016	170	255	0	85	85	1.0000000
NODE_70305_length_414_cov_2.222222	185	260	0	13	75	0.1733333
NODE_70305_length_414_cov_2.222222	185	260	2	2	75	0.0266667
NODE_70305_length_414_cov_2.222222	185	260	4	60	75	0.8000000
NODE_70305_length_414_cov_2.222222	233	304	0	13	71	0.1830986
NODE_70305_length_414_cov_2.222222	233	304	2	13	71	0.1830986
NODE_70305_length_414_cov_2.222222	233	304	4	45	71	0.6338028
NODE_70307_length_414_cov_2.206349	88	163	0	75	75	1.0000000
NODE_70326_length_414_cov_2.047619	298	349	0	6	51	0.1176471
NODE_70326_length_414_cov_2.047619	298	349	2	45	51	0.8823529
NODE_70486_length_414_cov_1.177778	106	190	0	84	84	1.0000000
NODE_70494_length_414_cov_1.155556	0	23	0	23	23	1.0000000
NODE_70690_length_413_cov_41.471338	35	115	0	80	80	1.0000000
NODE_70690_length_413_cov_41.471338	35	115	0	80	80	1.0000000
NODE_70690_length_413_cov_41.471338	88	168	0	80	80	1.0000000
NODE_70690_length_413_cov_41.471338	88	168	0	80	80	1.0000000
NODE_70691_length_413_cov_16.687898	222	302	0	3	80	0.0375000
NODE_70691_length_413_cov_16.687898	222	302	8	77	80	0.9625000
NODE_70691_length_413_cov_16.687898	275	355	0	4	80	0.0500000
NODE_70691_length_413_cov_16.687898	275	355	8	76	80	0.9500000
NODE_70699_length_413_cov_7.057325	170	250	0	3	80	0.0375000
NODE_70699_length_413_cov_7.057325	170	250	4	9	80	0.1125000
NODE_70699_length_413_cov_7.057325	170	250	8	5	80	0.0625000
NODE_70699_length_413_cov_7.057325	170	250	10	6	80	0.0750000
NODE_70699_length_413_cov_7.057325	170	250	12	12	80	0.1500000
NODE_70699_length_413_cov_7.057325	170	250	14	8	80	0.1000000
NODE_70699_length_413_cov_7.057325	170	250	16	5	80	0.0625000
NODE_70699_length_413_cov_7.057325	170	250	18	32	80	0.4000000
NODE_70699_length_413_cov_7.057325	223	300	8	18	77	0.2337662
NODE_70699_length_413_cov_7.057325	223	300	10	5	77	0.0649351
NODE_70699_length_413_cov_7.057325	223	300	12	6	77	0.0779221
NODE_70699_length_413_cov_7.057325	223	300	14	7	77	0.0909091
NODE_70699_length_413_cov_7.057325	223	300	18	41	77	0.5324675
NODE_70703_length_413_cov_5.665605	125	182	2	57	57	1.0000000
NODE_70712_length_413_cov_4.754777	140	184	0	44	44	1.0000000
NODE_70743_length_413_cov_3.506369	113	193	0	80	80	1.0000000
NODE_70749_length_413_cov_3.235669	251	331	0	80	80	1.0000000
NODE_70749_length_413_cov_3.235669	304	356	0	52	52	1.0000000
NODE_70792_length_413_cov_2.484076	209	257	0	48	48	1.0000000
NODE_70835_length_413_cov_1.949045	224	296	0	72	72	1.0000000
NODE_71196_length_412_cov_9.996805	172	244	0	72	72	1.0000000
NODE_71218_length_412_cov_4.686901	112	167	0	55	55	1.0000000
NODE_71253_length_412_cov_3.204473	44	124	0	80	80	1.0000000
NODE_71276_length_412_cov_2.824281	225	305	0	80	80	1.0000000
NODE_71371_length_412_cov_1.782748	262	342	0	25	80	0.3125000
NODE_71371_length_412_cov_1.782748	262	342	2	55	80	0.6875000
NODE_71398_length_412_cov_1.603834	143	182	0	10	39	0.2564103
NODE_71398_length_412_cov_1.603834	143	182	6	6	39	0.1538462
NODE_71398_length_412_cov_1.603834	143	182	8	8	39	0.2051282
NODE_71398_length_412_cov_1.603834	143	182	14	5	39	0.1282051
NODE_71398_length_412_cov_1.603834	143	182	16	2	39	0.0512821
NODE_71398_length_412_cov_1.603834	143	182	24	2	39	0.0512821
NODE_71398_length_412_cov_1.603834	143	182	26	1	39	0.0256410
NODE_71398_length_412_cov_1.603834	143	182	28	1	39	0.0256410
NODE_71398_length_412_cov_1.603834	143	182	30	2	39	0.0512821
NODE_71398_length_412_cov_1.603834	143	182	32	2	39	0.0512821
NODE_71665_length_411_cov_44.701923	4	72	0	25	68	0.3676471
NODE_71665_length_411_cov_44.701923	4	72	2	43	68	0.6323529
NODE_71665_length_411_cov_44.701923	35	116	2	81	81	1.0000000
NODE_71665_length_411_cov_44.701923	161	242	0	81	81	1.0000000
NODE_71665_length_411_cov_44.701923	293	374	0	81	81	1.0000000
NODE_71665_length_411_cov_44.701923	337	411	0	74	74	1.0000000
NODE_71666_length_411_cov_43.144231	102	183	0	56	81	0.6913580
NODE_71666_length_411_cov_43.144231	102	183	2	25	81	0.3086420
NODE_71666_length_411_cov_43.144231	156	236	0	80	80	1.0000000
NODE_71666_length_411_cov_43.144231	232	312	0	80	80	1.0000000
NODE_71666_length_411_cov_43.144231	285	365	0	80	80	1.0000000
NODE_71672_length_411_cov_8.471154	133	213	0	80	80	1.0000000
NODE_71672_length_411_cov_8.471154	186	266	0	80	80	1.0000000
NODE_71673_length_411_cov_8.407051	133	220	0	87	87	1.0000000
NODE_71675_length_411_cov_6.455128	249	316	0	66	67	0.9850746
NODE_71675_length_411_cov_6.455128	249	316	2	1	67	0.0149254
NODE_71675_length_411_cov_6.455128	292	344	0	23	52	0.4423077
NODE_71675_length_411_cov_6.455128	292	344	2	29	52	0.5576923
NODE_71687_length_411_cov_4.782051	98	178	0	80	80	1.0000000
NODE_71687_length_411_cov_4.782051	151	228	0	77	77	1.0000000
NODE_71705_length_411_cov_3.698718	282	347	0	65	65	1.0000000
NODE_71713_length_411_cov_3.378205	88	148	18	6	60	0.1000000
NODE_71713_length_411_cov_3.378205	88	148	20	9	60	0.1500000
NODE_71713_length_411_cov_3.378205	88	148	22	11	60	0.1833333
NODE_71713_length_411_cov_3.378205	88	148	24	21	60	0.3500000
NODE_71713_length_411_cov_3.378205	88	148	26	13	60	0.2166667
NODE_71714_length_411_cov_3.371795	145	225	2	1	80	0.0125000
NODE_71714_length_411_cov_3.371795	145	225	4	79	80	0.9875000
NODE_71714_length_411_cov_3.371795	198	274	4	76	76	1.0000000
NODE_72163_length_410_cov_49.331190	320	400	0	5	80	0.0625000
NODE_72163_length_410_cov_49.331190	320	400	4	23	80	0.2875000
NODE_72163_length_410_cov_49.331190	320	400	6	2	80	0.0250000
NODE_72163_length_410_cov_49.331190	320	400	10	8	80	0.1000000
NODE_72163_length_410_cov_49.331190	320	400	11	42	80	0.5250000
NODE_72163_length_410_cov_49.331190	320	400	0	5	80	0.0625000
NODE_72163_length_410_cov_49.331190	320	400	4	23	80	0.2875000
NODE_72163_length_410_cov_49.331190	320	400	6	2	80	0.0250000
NODE_72163_length_410_cov_49.331190	320	400	10	8	80	0.1000000
NODE_72163_length_410_cov_49.331190	320	400	11	42	80	0.5250000
NODE_72163_length_410_cov_49.331190	320	400	0	5	80	0.0625000
NODE_72163_length_410_cov_49.331190	320	400	4	23	80	0.2875000
NODE_72163_length_410_cov_49.331190	320	400	6	2	80	0.0250000
NODE_72163_length_410_cov_49.331190	320	400	10	8	80	0.1000000
NODE_72163_length_410_cov_49.331190	320	400	11	42	80	0.5250000
NODE_72163_length_410_cov_49.331190	320	400	0	5	80	0.0625000
NODE_72163_length_410_cov_49.331190	320	400	4	23	80	0.2875000
NODE_72163_length_410_cov_49.331190	320	400	6	2	80	0.0250000
NODE_72163_length_410_cov_49.331190	320	400	10	8	80	0.1000000
NODE_72163_length_410_cov_49.331190	320	400	11	42	80	0.5250000
NODE_72163_length_410_cov_49.331190	320	400	0	5	80	0.0625000
NODE_72163_length_410_cov_49.331190	320	400	4	23	80	0.2875000
NODE_72163_length_410_cov_49.331190	320	400	6	2	80	0.0250000
NODE_72163_length_410_cov_49.331190	320	400	10	8	80	0.1000000
NODE_72163_length_410_cov_49.331190	320	400	11	42	80	0.5250000
NODE_72163_length_410_cov_49.331190	329	400	0	5	71	0.0704225
NODE_72163_length_410_cov_49.331190	329	400	4	23	71	0.3239437
NODE_72163_length_410_cov_49.331190	329	400	6	2	71	0.0281690
NODE_72163_length_410_cov_49.331190	329	400	10	8	71	0.1126761
NODE_72163_length_410_cov_49.331190	329	400	11	33	71	0.4647887
NODE_72169_length_410_cov_6.797428	179	259	0	80	80	1.0000000
NODE_72169_length_410_cov_6.797428	232	312	0	80	80	1.0000000
NODE_72184_length_410_cov_5.102894	153	222	0	3	69	0.0434783
NODE_72184_length_410_cov_5.102894	153	222	2	28	69	0.4057971
NODE_72184_length_410_cov_5.102894	153	222	4	38	69	0.5507246
NODE_72186_length_410_cov_4.884244	101	179	4	78	78	1.0000000
NODE_72187_length_410_cov_4.787781	287	344	4	32	57	0.5614035
NODE_72187_length_410_cov_4.787781	287	344	6	25	57	0.4385965
NODE_72187_length_410_cov_4.787781	340	397	2	49	57	0.8596491
NODE_72187_length_410_cov_4.787781	340	397	4	1	57	0.0175439
NODE_72187_length_410_cov_4.787781	340	397	6	7	57	0.1228070
NODE_72194_length_410_cov_4.591640	245	303	8	1	58	0.0172414
NODE_72194_length_410_cov_4.591640	245	303	10	3	58	0.0517241
NODE_72194_length_410_cov_4.591640	245	303	12	1	58	0.0172414
NODE_72194_length_410_cov_4.591640	245	303	15	1	58	0.0172414
NODE_72194_length_410_cov_4.591640	245	303	23	2	58	0.0344828
NODE_72194_length_410_cov_4.591640	245	303	29	2	58	0.0344828
NODE_72194_length_410_cov_4.591640	245	303	33	2	58	0.0344828
NODE_72194_length_410_cov_4.591640	245	303	35	2	58	0.0344828
NODE_72194_length_410_cov_4.591640	245	303	39	1	58	0.0172414
NODE_72194_length_410_cov_4.591640	245	303	41	4	58	0.0689655
NODE_72194_length_410_cov_4.591640	245	303	45	1	58	0.0172414
NODE_72194_length_410_cov_4.591640	245	303	46	2	58	0.0344828
NODE_72194_length_410_cov_4.591640	245	303	48	1	58	0.0172414
NODE_72194_length_410_cov_4.591640	245	303	49	7	58	0.1206897
NODE_72194_length_410_cov_4.591640	245	303	53	5	58	0.0862069
NODE_72194_length_410_cov_4.591640	245	303	55	21	58	0.3620690
NODE_72194_length_410_cov_4.591640	245	303	56	2	58	0.0344828
NODE_72194_length_410_cov_4.591640	298	356	44	9	58	0.1551724
NODE_72194_length_410_cov_4.591640	298	356	46	6	58	0.1034483
NODE_72194_length_410_cov_4.591640	298	356	50	8	58	0.1379310
NODE_72194_length_410_cov_4.591640	298	356	52	10	58	0.1724138
NODE_72194_length_410_cov_4.591640	298	356	54	1	58	0.0172414
NODE_72194_length_410_cov_4.591640	298	356	55	3	58	0.0517241
NODE_72194_length_410_cov_4.591640	298	356	56	21	58	0.3620690
NODE_72230_length_410_cov_3.215434	32	112	0	34	80	0.4250000
NODE_72230_length_410_cov_3.215434	32	112	2	46	80	0.5750000
NODE_72230_length_410_cov_3.215434	85	165	0	12	80	0.1500000
NODE_72230_length_410_cov_3.215434	85	165	2	68	80	0.8500000
NODE_72327_length_410_cov_1.913183	227	285	0	34	58	0.5862069
NODE_72327_length_410_cov_1.913183	227	285	2	24	58	0.4137931
NODE_72526_length_410_cov_1.038585	272	316	0	20	44	0.4545455
NODE_72526_length_410_cov_1.038585	272	316	2	24	44	0.5454546
NODE_72688_length_409_cov_11.506452	56	136	0	40	80	0.5000000
NODE_72688_length_409_cov_11.506452	56	136	2	40	80	0.5000000
NODE_72688_length_409_cov_11.506452	109	189	2	80	80	1.0000000
NODE_72689_length_409_cov_10.329032	131	186	0	55	55	1.0000000
NODE_72690_length_409_cov_9.625806	62	142	0	80	80	1.0000000
NODE_72690_length_409_cov_9.625806	115	195	0	80	80	1.0000000
NODE_72697_length_409_cov_6.867742	41	71	0	30	30	1.0000000
NODE_72730_length_409_cov_3.822581	103	158	0	55	55	1.0000000
NODE_72730_length_409_cov_3.822581	151	232	0	81	81	1.0000000
NODE_72754_length_409_cov_2.987097	240	287	0	47	47	1.0000000
NODE_72951_length_409_cov_1.319355	49	131	0	20	82	0.2439024
NODE_72951_length_409_cov_1.319355	49	131	2	44	82	0.5365854
NODE_72951_length_409_cov_1.319355	49	131	6	18	82	0.2195122
NODE_72951_length_409_cov_1.319355	104	161	2	9	57	0.1578947
NODE_72951_length_409_cov_1.319355	104	161	6	48	57	0.8421053
NODE_73196_length_408_cov_8.585761	57	137	0	70	80	0.8750000
NODE_73196_length_408_cov_8.585761	57	137	2	10	80	0.1250000
NODE_73196_length_408_cov_8.585761	110	190	0	17	80	0.2125000
NODE_73196_length_408_cov_8.585761	110	190	2	14	80	0.1750000
NODE_73196_length_408_cov_8.585761	110	190	4	49	80	0.6125000
NODE_73198_length_408_cov_6.948220	71	151	0	23	80	0.2875000
NODE_73198_length_408_cov_6.948220	71	151	2	24	80	0.3000000
NODE_73198_length_408_cov_6.948220	71	151	4	33	80	0.4125000
NODE_73198_length_408_cov_6.948220	124	204	0	7	80	0.0875000
NODE_73198_length_408_cov_6.948220	124	204	2	2	80	0.0250000
NODE_73198_length_408_cov_6.948220	124	204	4	71	80	0.8875000
NODE_73219_length_408_cov_3.957929	83	132	2	46	49	0.9387755
NODE_73219_length_408_cov_3.957929	83	132	4	3	49	0.0612245
NODE_73226_length_408_cov_3.511327	40	97	0	57	57	1.0000000
NODE_73226_length_408_cov_3.511327	357	398	0	41	41	1.0000000
NODE_73262_length_408_cov_2.724919	128	180	2	52	52	1.0000000
NODE_73269_length_408_cov_2.563107	164	241	2	72	77	0.9350649
NODE_73269_length_408_cov_2.563107	164	241	6	1	77	0.0129870
NODE_73269_length_408_cov_2.563107	164	241	12	4	77	0.0519481
NODE_73271_length_408_cov_2.456311	314	379	0	65	65	1.0000000
NODE_73271_length_408_cov_2.456311	352	408	0	56	56	1.0000000
NODE_73690_length_407_cov_6.191558	144	208	0	46	64	0.7187500
NODE_73690_length_407_cov_6.191558	144	208	2	18	64	0.2812500
NODE_73698_length_407_cov_4.961039	212	291	0	61	79	0.7721519
NODE_73698_length_407_cov_4.961039	212	291	2	18	79	0.2278481
NODE_73719_length_407_cov_3.681818	314	375	0	57	61	0.9344262
NODE_73719_length_407_cov_3.681818	314	375	2	4	61	0.0655738
NODE_73732_length_407_cov_3.344156	199	247	2	5	48	0.1041667
NODE_73732_length_407_cov_3.344156	199	247	5	14	48	0.2916667
NODE_73732_length_407_cov_3.344156	199	247	8	29	48	0.6041667
NODE_73736_length_407_cov_3.250000	142	223	2	3	81	0.0370370
NODE_73736_length_407_cov_3.250000	142	223	6	2	81	0.0246914
NODE_73736_length_407_cov_3.250000	142	223	8	6	81	0.0740741
NODE_73736_length_407_cov_3.250000	142	223	10	6	81	0.0740741
NODE_73736_length_407_cov_3.250000	142	223	12	64	81	0.7901235
NODE_73762_length_407_cov_2.594156	194	257	0	31	63	0.4920635
NODE_73762_length_407_cov_2.594156	194	257	2	32	63	0.5079365
NODE_73769_length_407_cov_2.538961	34	114	0	7	80	0.0875000
NODE_73769_length_407_cov_2.538961	34	114	2	8	80	0.1000000
NODE_73769_length_407_cov_2.538961	34	114	6	65	80	0.8125000
NODE_73853_length_407_cov_1.737013	208	264	0	47	56	0.8392857
NODE_73853_length_407_cov_1.737013	208	264	2	9	56	0.1607143
NODE_74200_length_406_cov_176.856678	200	271	197	3	71	0.0422535
NODE_74200_length_406_cov_176.856678	200	271	210	1	71	0.0140845
NODE_74200_length_406_cov_176.856678	200	271	213	1	71	0.0140845
NODE_74200_length_406_cov_176.856678	200	271	214	8	71	0.1126761
NODE_74200_length_406_cov_176.856678	200	271	216	1	71	0.0140845
NODE_74200_length_406_cov_176.856678	200	271	217	1	71	0.0140845
NODE_74200_length_406_cov_176.856678	200	271	218	2	71	0.0281690
NODE_74200_length_406_cov_176.856678	200	271	219	1	71	0.0140845
NODE_74200_length_406_cov_176.856678	200	271	220	1	71	0.0140845
NODE_74200_length_406_cov_176.856678	200	271	221	1	71	0.0140845
NODE_74200_length_406_cov_176.856678	200	271	222	1	71	0.0140845
NODE_74200_length_406_cov_176.856678	200	271	224	2	71	0.0281690
NODE_74200_length_406_cov_176.856678	200	271	226	2	71	0.0281690
NODE_74200_length_406_cov_176.856678	200	271	228	4	71	0.0563380
NODE_74200_length_406_cov_176.856678	200	271	232	3	71	0.0422535
NODE_74200_length_406_cov_176.856678	200	271	234	1	71	0.0140845
NODE_74200_length_406_cov_176.856678	200	271	236	1	71	0.0140845
NODE_74200_length_406_cov_176.856678	200	271	238	2	71	0.0281690
NODE_74200_length_406_cov_176.856678	200	271	242	1	71	0.0140845
NODE_74200_length_406_cov_176.856678	200	271	243	3	71	0.0422535
NODE_74200_length_406_cov_176.856678	200	271	248	4	71	0.0563380
NODE_74200_length_406_cov_176.856678	200	271	250	4	71	0.0563380
NODE_74200_length_406_cov_176.856678	200	271	251	1	71	0.0140845
NODE_74200_length_406_cov_176.856678	200	271	252	1	71	0.0140845
NODE_74200_length_406_cov_176.856678	200	271	253	1	71	0.0140845
NODE_74200_length_406_cov_176.856678	200	271	254	2	71	0.0281690
NODE_74200_length_406_cov_176.856678	200	271	255	4	71	0.0563380
NODE_74200_length_406_cov_176.856678	200	271	256	1	71	0.0140845
NODE_74200_length_406_cov_176.856678	200	271	257	5	71	0.0704225
NODE_74200_length_406_cov_176.856678	200	271	259	2	71	0.0281690
NODE_74200_length_406_cov_176.856678	200	271	262	1	71	0.0140845
NODE_74200_length_406_cov_176.856678	200	271	264	1	71	0.0140845
NODE_74200_length_406_cov_176.856678	200	271	266	2	71	0.0281690
NODE_74200_length_406_cov_176.856678	200	271	267	1	71	0.0140845
NODE_74200_length_406_cov_176.856678	200	271	268	1	71	0.0140845
NODE_74200_length_406_cov_176.856678	244	321	193	2	77	0.0259740
NODE_74200_length_406_cov_176.856678	244	321	196	1	77	0.0129870
NODE_74200_length_406_cov_176.856678	244	321	202	4	77	0.0519481
NODE_74200_length_406_cov_176.856678	244	321	203	1	77	0.0129870
NODE_74200_length_406_cov_176.856678	244	321	205	4	77	0.0519481
NODE_74200_length_406_cov_176.856678	244	321	214	1	77	0.0129870
NODE_74200_length_406_cov_176.856678	244	321	220	3	77	0.0389610
NODE_74200_length_406_cov_176.856678	244	321	224	4	77	0.0519481
NODE_74200_length_406_cov_176.856678	244	321	226	3	77	0.0389610
NODE_74200_length_406_cov_176.856678	244	321	228	7	77	0.0909091
NODE_74200_length_406_cov_176.856678	244	321	231	2	77	0.0259740
NODE_74200_length_406_cov_176.856678	244	321	232	5	77	0.0649351
NODE_74200_length_406_cov_176.856678	244	321	234	6	77	0.0779221
NODE_74200_length_406_cov_176.856678	244	321	235	5	77	0.0649351
NODE_74200_length_406_cov_176.856678	244	321	236	2	77	0.0259740
NODE_74200_length_406_cov_176.856678	244	321	237	4	77	0.0519481
NODE_74200_length_406_cov_176.856678	244	321	238	8	77	0.1038961
NODE_74200_length_406_cov_176.856678	244	321	242	1	77	0.0129870
NODE_74200_length_406_cov_176.856678	244	321	248	1	77	0.0129870
NODE_74200_length_406_cov_176.856678	244	321	250	3	77	0.0389610
NODE_74200_length_406_cov_176.856678	244	321	253	1	77	0.0129870
NODE_74200_length_406_cov_176.856678	244	321	257	2	77	0.0259740
NODE_74200_length_406_cov_176.856678	244	321	259	1	77	0.0129870
NODE_74200_length_406_cov_176.856678	244	321	262	1	77	0.0129870
NODE_74200_length_406_cov_176.856678	244	321	264	1	77	0.0129870
NODE_74200_length_406_cov_176.856678	244	321	266	2	77	0.0259740
NODE_74200_length_406_cov_176.856678	244	321	267	1	77	0.0129870
NODE_74200_length_406_cov_176.856678	244	321	268	1	77	0.0129870
NODE_74203_length_406_cov_37.723127	15	95	0	6	80	0.0750000
NODE_74203_length_406_cov_37.723127	15	95	2	16	80	0.2000000
NODE_74203_length_406_cov_37.723127	15	95	4	9	80	0.1125000
NODE_74203_length_406_cov_37.723127	15	95	6	25	80	0.3125000
NODE_74203_length_406_cov_37.723127	15	95	14	15	80	0.1875000
NODE_74203_length_406_cov_37.723127	15	95	16	5	80	0.0625000
NODE_74203_length_406_cov_37.723127	15	95	20	1	80	0.0125000
NODE_74203_length_406_cov_37.723127	15	95	22	1	80	0.0125000
NODE_74203_length_406_cov_37.723127	15	95	31	1	80	0.0125000
NODE_74203_length_406_cov_37.723127	15	95	42	1	80	0.0125000
NODE_74219_length_406_cov_4.960912	268	327	0	35	59	0.5932204
NODE_74219_length_406_cov_4.960912	268	327	2	24	59	0.4067796
NODE_74253_length_406_cov_3.087948	261	302	0	41	41	1.0000000
NODE_74284_length_406_cov_2.475570	220	270	0	50	50	1.0000000
NODE_74332_length_406_cov_1.986971	238	276	0	38	38	1.0000000
NODE_74368_length_406_cov_1.778502	159	195	4	1	36	0.0277778
NODE_74368_length_406_cov_1.778502	159	195	6	4	36	0.1111111
NODE_74368_length_406_cov_1.778502	159	195	8	31	36	0.8611111
NODE_74368_length_406_cov_1.778502	234	294	18	5	60	0.0833333
NODE_74368_length_406_cov_1.778502	234	294	20	6	60	0.1000000
NODE_74368_length_406_cov_1.778502	234	294	22	12	60	0.2000000
NODE_74368_length_406_cov_1.778502	234	294	24	13	60	0.2166667
NODE_74368_length_406_cov_1.778502	234	294	26	24	60	0.4000000
NODE_74368_length_406_cov_1.778502	267	347	0	26	80	0.3250000
NODE_74368_length_406_cov_1.778502	267	347	4	2	80	0.0250000
NODE_74368_length_406_cov_1.778502	267	347	6	4	80	0.0500000
NODE_74368_length_406_cov_1.778502	267	347	12	1	80	0.0125000
NODE_74368_length_406_cov_1.778502	267	347	14	1	80	0.0125000
NODE_74368_length_406_cov_1.778502	267	347	18	22	80	0.2750000
NODE_74368_length_406_cov_1.778502	267	347	20	1	80	0.0125000
NODE_74368_length_406_cov_1.778502	267	347	22	4	80	0.0500000
NODE_74368_length_406_cov_1.778502	267	347	26	19	80	0.2375000
NODE_74427_length_406_cov_1.495114	173	212	0	3	39	0.0769231
NODE_74427_length_406_cov_1.495114	173	212	2	17	39	0.4358974
NODE_74427_length_406_cov_1.495114	173	212	4	2	39	0.0512821
NODE_74427_length_406_cov_1.495114	173	212	6	17	39	0.4358974
NODE_74476_length_406_cov_1.325733	367	398	0	31	31	1.0000000
NODE_74588_length_406_cov_0.934853	1	32	0	31	31	1.0000000
NODE_74588_length_406_cov_0.934853	5	85	0	70	80	0.8750000
NODE_74588_length_406_cov_0.934853	5	85	2	10	80	0.1250000
NODE_74696_length_405_cov_5.107843	332	380	0	48	48	1.0000000
NODE_74697_length_405_cov_4.915033	15	46	0	31	31	1.0000000
NODE_74727_length_405_cov_3.346405	195	240	0	2	45	0.0444444
NODE_74727_length_405_cov_3.346405	195	240	2	2	45	0.0444444
NODE_74727_length_405_cov_3.346405	195	240	4	18	45	0.4000000
NODE_74727_length_405_cov_3.346405	195	240	6	23	45	0.5111111
NODE_74727_length_405_cov_3.346405	274	329	0	29	55	0.5272727
NODE_74727_length_405_cov_3.346405	274	329	2	26	55	0.4727273
NODE_74737_length_405_cov_3.124183	210	260	0	12	50	0.2400000
NODE_74737_length_405_cov_3.124183	210	260	2	6	50	0.1200000
NODE_74737_length_405_cov_3.124183	210	260	4	32	50	0.6400000
NODE_74737_length_405_cov_3.124183	240	286	0	12	46	0.2608696
NODE_74737_length_405_cov_3.124183	240	286	2	32	46	0.6956522
NODE_74737_length_405_cov_3.124183	240	286	4	2	46	0.0434783
NODE_74737_length_405_cov_3.124183	260	339	2	41	79	0.5189874
NODE_74737_length_405_cov_3.124183	260	339	3	1	79	0.0126582
NODE_74737_length_405_cov_3.124183	260	339	4	37	79	0.4683544
NODE_74737_length_405_cov_3.124183	272	339	2	29	67	0.4328358
NODE_74737_length_405_cov_3.124183	272	339	3	1	67	0.0149254
NODE_74737_length_405_cov_3.124183	272	339	4	37	67	0.5522388
NODE_74780_length_405_cov_2.503268	352	399	4	47	47	1.0000000
NODE_74787_length_405_cov_2.460784	0	73	0	11	73	0.1506849
NODE_74787_length_405_cov_2.460784	0	73	2	62	73	0.8493150
NODE_75145_length_405_cov_0.666667	207	268	0	61	61	1.0000000
NODE_75196_length_404_cov_40.937705	40	120	0	80	80	1.0000000
NODE_75196_length_404_cov_40.937705	93	173	0	80	80	1.0000000
NODE_75197_length_404_cov_32.940984	46	126	0	80	80	1.0000000
NODE_75197_length_404_cov_32.940984	99	179	0	29	80	0.3625000
NODE_75197_length_404_cov_32.940984	99	179	18	41	80	0.5125000
NODE_75197_length_404_cov_32.940984	99	179	22	10	80	0.1250000
NODE_75197_length_404_cov_32.940984	175	255	0	3	80	0.0375000
NODE_75197_length_404_cov_32.940984	175	255	2	4	80	0.0500000
NODE_75197_length_404_cov_32.940984	175	255	6	39	80	0.4875000
NODE_75197_length_404_cov_32.940984	175	255	22	17	80	0.2125000
NODE_75197_length_404_cov_32.940984	175	255	24	17	80	0.2125000
NODE_75197_length_404_cov_32.940984	228	308	0	38	80	0.4750000
NODE_75197_length_404_cov_32.940984	228	308	2	22	80	0.2750000
NODE_75197_length_404_cov_32.940984	228	308	6	20	80	0.2500000
NODE_75198_length_404_cov_11.731148	130	210	10	9	80	0.1125000
NODE_75198_length_404_cov_11.731148	130	210	12	52	80	0.6500000
NODE_75198_length_404_cov_11.731148	130	210	13	6	80	0.0750000
NODE_75198_length_404_cov_11.731148	130	210	14	3	80	0.0375000
NODE_75198_length_404_cov_11.731148	130	210	15	10	80	0.1250000
NODE_75198_length_404_cov_11.731148	183	263	0	29	80	0.3625000
NODE_75198_length_404_cov_11.731148	183	263	6	17	80	0.2125000
NODE_75198_length_404_cov_11.731148	183	263	12	34	80	0.4250000
NODE_75200_length_404_cov_9.170492	201	257	0	56	56	1.0000000
NODE_75236_length_404_cov_3.613115	323	385	0	3	62	0.0483871
NODE_75236_length_404_cov_3.613115	323	385	2	59	62	0.9516129
NODE_75259_length_404_cov_2.914754	181	261	0	80	80	1.0000000
NODE_75345_length_404_cov_2.085246	245	325	0	80	80	1.0000000
NODE_75357_length_404_cov_1.993443	95	148	0	53	53	1.0000000
NODE_75399_length_404_cov_1.672131	32	106	0	74	74	1.0000000
NODE_75440_length_404_cov_1.498361	94	174	0	2	80	0.0250000
NODE_75440_length_404_cov_1.498361	94	174	1	6	80	0.0750000
NODE_75440_length_404_cov_1.498361	94	174	2	27	80	0.3375000
NODE_75440_length_404_cov_1.498361	94	174	4	8	80	0.1000000
NODE_75440_length_404_cov_1.498361	94	174	6	6	80	0.0750000
NODE_75440_length_404_cov_1.498361	94	174	8	31	80	0.3875000
NODE_75446_length_404_cov_1.485246	234	282	4	5	48	0.1041667
NODE_75446_length_404_cov_1.485246	234	282	6	43	48	0.8958333
NODE_75545_length_404_cov_1.121311	114	194	0	44	80	0.5500000
NODE_75545_length_404_cov_1.121311	114	194	2	36	80	0.4500000
NODE_75750_length_403_cov_7.325658	80	146	0	66	66	1.0000000
NODE_75750_length_403_cov_7.325658	165	234	0	69	69	1.0000000
NODE_75750_length_403_cov_7.325658	215	255	0	32	40	0.8000000
NODE_75750_length_403_cov_7.325658	215	255	2	8	40	0.2000000
NODE_75751_length_403_cov_7.217105	207	284	0	77	77	1.0000000
NODE_75751_length_403_cov_7.217105	257	334	0	77	77	1.0000000
NODE_75752_length_403_cov_6.776316	192	250	4	16	58	0.2758621
NODE_75752_length_403_cov_6.776316	192	250	6	42	58	0.7241379
NODE_75788_length_403_cov_3.710526	327	373	0	46	46	1.0000000
NODE_75788_length_403_cov_3.710526	346	403	0	57	57	1.0000000
NODE_75793_length_403_cov_3.611842	283	363	8	35	80	0.4375000
NODE_75793_length_403_cov_3.611842	283	363	9	43	80	0.5375000
NODE_75793_length_403_cov_3.611842	283	363	10	2	80	0.0250000
NODE_75824_length_403_cov_2.822368	201	282	10	12	81	0.1481481
NODE_75824_length_403_cov_2.822368	201	282	12	51	81	0.6296296
NODE_75824_length_403_cov_2.822368	201	282	14	6	81	0.0740741
NODE_75824_length_403_cov_2.822368	201	282	16	12	81	0.1481481
NODE_75871_length_403_cov_2.082237	102	145	0	43	43	1.0000000
NODE_75908_length_403_cov_1.871711	130	166	0	36	36	1.0000000
NODE_75993_length_403_cov_1.398026	79	116	0	37	37	1.0000000
NODE_76029_length_403_cov_1.269737	82	111	0	29	29	1.0000000
NODE_76239_length_402_cov_6.293729	217	297	2	5	80	0.0625000
NODE_76239_length_402_cov_6.293729	217	297	4	32	80	0.4000000
NODE_76239_length_402_cov_6.293729	217	297	6	43	80	0.5375000
NODE_76239_length_402_cov_6.293729	270	350	2	58	80	0.7250000
NODE_76239_length_402_cov_6.293729	270	350	6	22	80	0.2750000
NODE_76246_length_402_cov_5.227723	176	236	26	7	60	0.1166667
NODE_76246_length_402_cov_5.227723	176	236	28	33	60	0.5500000
NODE_76246_length_402_cov_5.227723	176	236	30	8	60	0.1333333
NODE_76246_length_402_cov_5.227723	176	236	32	4	60	0.0666667
NODE_76246_length_402_cov_5.227723	176	236	34	8	60	0.1333333
NODE_76261_length_402_cov_4.356436	44	123	0	79	79	1.0000000
NODE_76261_length_402_cov_4.356436	119	199	0	45	80	0.5625000
NODE_76261_length_402_cov_4.356436	119	199	2	35	80	0.4375000
NODE_76261_length_402_cov_4.356436	172	252	2	42	80	0.5250000
NODE_76261_length_402_cov_4.356436	172	252	3	4	80	0.0500000
NODE_76261_length_402_cov_4.356436	172	252	7	18	80	0.2250000
NODE_76261_length_402_cov_4.356436	172	252	8	16	80	0.2000000
NODE_76276_length_402_cov_3.564356	197	257	0	19	60	0.3166667
NODE_76276_length_402_cov_3.564356	197	257	2	10	60	0.1666667
NODE_76276_length_402_cov_3.564356	197	257	3	31	60	0.5166667
NODE_76276_length_402_cov_3.564356	230	310	3	37	80	0.4625000
NODE_76276_length_402_cov_3.564356	230	310	4	2	80	0.0250000
NODE_76276_length_402_cov_3.564356	230	310	6	41	80	0.5125000
NODE_76328_length_402_cov_2.633663	335	402	0	20	67	0.2985075
NODE_76328_length_402_cov_2.633663	335	402	4	47	67	0.7014925
NODE_76336_length_402_cov_2.514851	82	162	6	9	80	0.1125000
NODE_76336_length_402_cov_2.514851	82	162	8	9	80	0.1125000
NODE_76336_length_402_cov_2.514851	82	162	12	12	80	0.1500000
NODE_76336_length_402_cov_2.514851	82	162	14	16	80	0.2000000
NODE_76336_length_402_cov_2.514851	82	162	16	34	80	0.4250000
NODE_76336_length_402_cov_2.514851	135	200	0	22	65	0.3384615
NODE_76336_length_402_cov_2.514851	135	200	2	13	65	0.2000000
NODE_76336_length_402_cov_2.514851	135	200	6	12	65	0.1846154
NODE_76336_length_402_cov_2.514851	135	200	8	9	65	0.1384615
NODE_76336_length_402_cov_2.514851	135	200	12	9	65	0.1384615
NODE_76380_length_402_cov_2.102310	114	165	0	51	51	1.0000000
NODE_76380_length_402_cov_2.102310	138	195	0	57	57	1.0000000
NODE_76560_length_402_cov_1.214521	0	33	0	31	33	0.9393939
NODE_76560_length_402_cov_1.214521	0	33	4	2	33	0.0606061
NODE_76646_length_402_cov_1.000000	119	188	0	51	69	0.7391304
NODE_76646_length_402_cov_1.000000	119	188	4	1	69	0.0144928
NODE_76646_length_402_cov_1.000000	119	188	5	17	69	0.2463768
NODE_76752_length_402_cov_0.663366	0	46	0	25	46	0.5434783
NODE_76752_length_402_cov_0.663366	0	46	2	4	46	0.0869565
NODE_76752_length_402_cov_0.663366	0	46	4	17	46	0.3695652
NODE_76780_length_401_cov_43.675497	285	343	0	11	58	0.1896552
NODE_76780_length_401_cov_43.675497	285	343	2	47	58	0.8103448
NODE_76801_length_401_cov_4.377483	309	389	0	80	80	1.0000000
NODE_76804_length_401_cov_4.241722	125	180	0	35	55	0.6363636
NODE_76804_length_401_cov_4.241722	125	180	2	20	55	0.3636364
NODE_76808_length_401_cov_4.132450	195	275	1	1	80	0.0125000
NODE_76808_length_401_cov_4.132450	195	275	3	22	80	0.2750000
NODE_76808_length_401_cov_4.132450	195	275	4	57	80	0.7125000
NODE_76811_length_401_cov_3.973510	138	181	2	3	43	0.0697674
NODE_76811_length_401_cov_3.973510	138	181	4	1	43	0.0232558
NODE_76811_length_401_cov_3.973510	138	181	6	39	43	0.9069768
NODE_76828_length_401_cov_3.370861	141	221	0	80	80	1.0000000
NODE_76828_length_401_cov_3.370861	194	273	0	79	79	1.0000000
NODE_76830_length_401_cov_3.317881	67	147	0	38	80	0.4750000
NODE_76830_length_401_cov_3.317881	67	147	2	18	80	0.2250000
NODE_76830_length_401_cov_3.317881	67	147	4	24	80	0.3000000
NODE_76918_length_401_cov_1.937086	160	239	0	79	79	1.0000000
NODE_76978_length_401_cov_1.615894	205	269	6	1	64	0.0156250
NODE_76978_length_401_cov_1.615894	205	269	9	1	64	0.0156250
NODE_76978_length_401_cov_1.615894	205	269	10	1	64	0.0156250
NODE_76978_length_401_cov_1.615894	205	269	12	4	64	0.0625000
NODE_76978_length_401_cov_1.615894	205	269	14	1	64	0.0156250
NODE_76978_length_401_cov_1.615894	205	269	18	4	64	0.0625000
NODE_76978_length_401_cov_1.615894	205	269	24	6	64	0.0937500
NODE_76978_length_401_cov_1.615894	205	269	30	1	64	0.0156250
NODE_76978_length_401_cov_1.615894	205	269	35	1	64	0.0156250
NODE_76978_length_401_cov_1.615894	205	269	37	1	64	0.0156250
NODE_76978_length_401_cov_1.615894	205	269	47	1	64	0.0156250
NODE_76978_length_401_cov_1.615894	205	269	49	2	64	0.0312500
NODE_76978_length_401_cov_1.615894	205	269	55	1	64	0.0156250
NODE_76978_length_401_cov_1.615894	205	269	59	1	64	0.0156250
NODE_76978_length_401_cov_1.615894	205	269	62	1	64	0.0156250
NODE_76978_length_401_cov_1.615894	205	269	63	2	64	0.0312500
NODE_76978_length_401_cov_1.615894	205	269	64	2	64	0.0312500
NODE_76978_length_401_cov_1.615894	205	269	74	1	64	0.0156250
NODE_76978_length_401_cov_1.615894	205	269	76	1	64	0.0156250
NODE_76978_length_401_cov_1.615894	205	269	78	3	64	0.0468750
NODE_76978_length_401_cov_1.615894	205	269	84	1	64	0.0156250
NODE_76978_length_401_cov_1.615894	205	269	85	4	64	0.0625000
NODE_76978_length_401_cov_1.615894	205	269	87	4	64	0.0625000
NODE_76978_length_401_cov_1.615894	205	269	89	1	64	0.0156250
NODE_76978_length_401_cov_1.615894	205	269	93	4	64	0.0625000
NODE_76978_length_401_cov_1.615894	205	269	97	3	64	0.0468750
NODE_76978_length_401_cov_1.615894	205	269	99	1	64	0.0156250
NODE_76978_length_401_cov_1.615894	205	269	100	2	64	0.0312500
NODE_76978_length_401_cov_1.615894	205	269	106	6	64	0.0937500
NODE_76978_length_401_cov_1.615894	205	269	108	2	64	0.0312500
NODE_77017_length_401_cov_1.407285	23	92	0	69	69	1.0000000
NODE_77017_length_401_cov_1.407285	76	122	0	46	46	1.0000000
NODE_77236_length_401_cov_0.675497	292	372	0	80	80	1.0000000
NODE_77236_length_401_cov_0.675497	345	401	0	56	56	1.0000000
NODE_77284_length_400_cov_40.584718	205	281	0	76	76	1.0000000
NODE_77284_length_400_cov_40.584718	254	334	0	80	80	1.0000000
NODE_77289_length_400_cov_8.631229	307	372	4	65	65	1.0000000
NODE_77292_length_400_cov_6.850498	281	329	0	48	48	1.0000000
NODE_77322_length_400_cov_4.000000	82	140	6	10	58	0.1724138
NODE_77322_length_400_cov_4.000000	82	140	8	7	58	0.1206897
NODE_77322_length_400_cov_4.000000	82	140	10	34	58	0.5862069
NODE_77322_length_400_cov_4.000000	82	140	12	7	58	0.1206897
NODE_77358_length_400_cov_3.029900	204	284	0	80	80	1.0000000
NODE_77358_length_400_cov_3.029900	205	231	0	26	26	1.0000000
NODE_77362_length_400_cov_3.009967	146	220	2	7	74	0.0945946
NODE_77362_length_400_cov_3.009967	146	220	4	20	74	0.2702703
NODE_77362_length_400_cov_3.009967	146	220	6	15	74	0.2027027
NODE_77362_length_400_cov_3.009967	146	220	10	6	74	0.0810811
NODE_77362_length_400_cov_3.009967	146	220	12	1	74	0.0135135
NODE_77362_length_400_cov_3.009967	146	220	14	20	74	0.2702703
NODE_77362_length_400_cov_3.009967	146	220	15	1	74	0.0135135
NODE_77362_length_400_cov_3.009967	146	220	16	4	74	0.0540541
NODE_77362_length_400_cov_3.009967	195	261	14	20	66	0.3030303
NODE_77362_length_400_cov_3.009967	195	261	15	1	66	0.0151515
NODE_77362_length_400_cov_3.009967	195	261	16	27	66	0.4090909
NODE_77362_length_400_cov_3.009967	195	261	17	6	66	0.0909091
NODE_77362_length_400_cov_3.009967	195	261	18	10	66	0.1515152
NODE_77362_length_400_cov_3.009967	195	261	20	2	66	0.0303030
NODE_77363_length_400_cov_2.990033	253	332	38	9	79	0.1139240
NODE_77363_length_400_cov_2.990033	253	332	41	1	79	0.0126582
NODE_77363_length_400_cov_2.990033	253	332	42	19	79	0.2405063
NODE_77363_length_400_cov_2.990033	253	332	43	1	79	0.0126582
NODE_77363_length_400_cov_2.990033	253	332	44	3	79	0.0379747
NODE_77363_length_400_cov_2.990033	253	332	45	2	79	0.0253165
NODE_77363_length_400_cov_2.990033	253	332	49	2	79	0.0253165
NODE_77363_length_400_cov_2.990033	253	332	53	4	79	0.0506329
NODE_77363_length_400_cov_2.990033	253	332	59	2	79	0.0253165
NODE_77363_length_400_cov_2.990033	253	332	60	1	79	0.0126582
NODE_77363_length_400_cov_2.990033	253	332	63	1	79	0.0126582
NODE_77363_length_400_cov_2.990033	253	332	65	1	79	0.0126582
NODE_77363_length_400_cov_2.990033	253	332	66	3	79	0.0379747
NODE_77363_length_400_cov_2.990033	253	332	68	4	79	0.0506329
NODE_77363_length_400_cov_2.990033	253	332	72	1	79	0.0126582
NODE_77363_length_400_cov_2.990033	253	332	76	1	79	0.0126582
NODE_77363_length_400_cov_2.990033	253	332	80	2	79	0.0253165
NODE_77363_length_400_cov_2.990033	253	332	86	4	79	0.0506329
NODE_77363_length_400_cov_2.990033	253	332	88	3	79	0.0379747
NODE_77363_length_400_cov_2.990033	253	332	90	6	79	0.0759494
NODE_77363_length_400_cov_2.990033	253	332	92	8	79	0.1012658
NODE_77363_length_400_cov_2.990033	253	332	94	1	79	0.0126582
NODE_77363_length_400_cov_2.990033	306	385	72	1	79	0.0126582
NODE_77363_length_400_cov_2.990033	306	385	76	33	79	0.4177215
NODE_77363_length_400_cov_2.990033	306	385	77	3	79	0.0379747
NODE_77363_length_400_cov_2.990033	306	385	78	6	79	0.0759494
NODE_77363_length_400_cov_2.990033	306	385	80	2	79	0.0253165
NODE_77363_length_400_cov_2.990033	306	385	81	4	79	0.0506329
NODE_77363_length_400_cov_2.990033	306	385	86	12	79	0.1518987
NODE_77363_length_400_cov_2.990033	306	385	88	3	79	0.0379747
NODE_77363_length_400_cov_2.990033	306	385	90	6	79	0.0759494
NODE_77363_length_400_cov_2.990033	306	385	92	8	79	0.1012658
NODE_77363_length_400_cov_2.990033	306	385	94	1	79	0.0126582
NODE_77368_length_400_cov_2.860465	365	400	0	35	35	1.0000000
NODE_77371_length_400_cov_2.797342	324	372	0	48	48	1.0000000
NODE_77380_length_400_cov_2.581395	192	254	0	62	62	1.0000000
NODE_77460_length_400_cov_1.940199	225	268	2	2	43	0.0465116
NODE_77460_length_400_cov_1.940199	225	268	4	41	43	0.9534883
NODE_77460_length_400_cov_1.940199	293	374	0	78	81	0.9629630
NODE_77460_length_400_cov_1.940199	293	374	2	3	81	0.0370370
NODE_77821_length_399_cov_71.493333	215	295	0	80	80	1.0000000
NODE_77821_length_399_cov_71.493333	268	348	0	80	80	1.0000000
NODE_77823_length_399_cov_7.510000	229	309	0	80	80	1.0000000
NODE_77823_length_399_cov_7.510000	282	362	0	80	80	1.0000000
NODE_77825_length_399_cov_7.310000	125	187	0	44	62	0.7096774
NODE_77825_length_399_cov_7.310000	125	187	2	18	62	0.2903226
NODE_77854_length_399_cov_4.293333	86	164	4	12	78	0.1538462
NODE_77854_length_399_cov_4.293333	86	164	6	66	78	0.8461539
NODE_77877_length_399_cov_3.406667	51	124	0	39	73	0.5342466
NODE_77877_length_399_cov_3.406667	51	124	2	34	73	0.4657534
NODE_77933_length_399_cov_2.286667	310	390	0	80	80	1.0000000
NODE_77966_length_399_cov_1.916667	76	136	6	29	60	0.4833333
NODE_77966_length_399_cov_1.916667	76	136	8	26	60	0.4333333
NODE_77966_length_399_cov_1.916667	76	136	10	5	60	0.0833333
NODE_77966_length_399_cov_1.916667	123	189	8	26	66	0.3939394
NODE_77966_length_399_cov_1.916667	123	189	10	40	66	0.6060606
NODE_78276_length_399_cov_0.710000	313	392	2	77	79	0.9746835
NODE_78276_length_399_cov_0.710000	313	392	4	2	79	0.0253165
NODE_78354_length_398_cov_9.688963	1	81	0	80	80	1.0000000
NODE_78354_length_398_cov_9.688963	247	327	0	16	80	0.2000000
NODE_78354_length_398_cov_9.688963	247	327	2	64	80	0.8000000
NODE_78354_length_398_cov_9.688963	300	380	0	39	80	0.4875000
NODE_78354_length_398_cov_9.688963	300	380	2	41	80	0.5125000
NODE_78360_length_398_cov_6.488294	130	210	0	37	80	0.4625000
NODE_78360_length_398_cov_6.488294	130	210	5	1	80	0.0125000
NODE_78360_length_398_cov_6.488294	130	210	6	1	80	0.0125000
NODE_78360_length_398_cov_6.488294	130	210	12	41	80	0.5125000
NODE_78364_length_398_cov_5.765886	253	333	4	1	80	0.0125000
NODE_78364_length_398_cov_5.765886	253	333	5	14	80	0.1750000
NODE_78364_length_398_cov_5.765886	253	333	7	2	80	0.0250000
NODE_78364_length_398_cov_5.765886	253	333	8	16	80	0.2000000
NODE_78364_length_398_cov_5.765886	253	333	9	1	80	0.0125000
NODE_78364_length_398_cov_5.765886	253	333	10	9	80	0.1125000
NODE_78364_length_398_cov_5.765886	253	333	12	37	80	0.4625000
NODE_78372_length_398_cov_5.244147	248	312	2	7	64	0.1093750
NODE_78372_length_398_cov_5.244147	248	312	4	2	64	0.0312500
NODE_78372_length_398_cov_5.244147	248	312	6	55	64	0.8593750
NODE_78376_length_398_cov_5.006689	116	196	0	80	80	1.0000000
NODE_78376_length_398_cov_5.006689	169	251	0	82	82	1.0000000
NODE_78383_length_398_cov_4.284281	63	117	0	54	54	1.0000000
NODE_78383_length_398_cov_4.284281	135	160	0	25	25	1.0000000
NODE_78420_length_398_cov_2.993311	229	309	0	80	80	1.0000000
NODE_78429_length_398_cov_2.822742	236	271	0	35	35	1.0000000
NODE_78891_length_397_cov_52.855705	124	204	1	9	80	0.1125000
NODE_78891_length_397_cov_52.855705	124	204	2	53	80	0.6625000
NODE_78891_length_397_cov_52.855705	124	204	3	18	80	0.2250000
NODE_78891_length_397_cov_52.855705	177	257	2	69	80	0.8625000
NODE_78891_length_397_cov_52.855705	177	257	3	11	80	0.1375000
NODE_78894_length_397_cov_35.036913	173	253	2	9	80	0.1125000
NODE_78894_length_397_cov_35.036913	173	253	6	9	80	0.1125000
NODE_78894_length_397_cov_35.036913	173	253	8	8	80	0.1000000
NODE_78894_length_397_cov_35.036913	173	253	10	54	80	0.6750000
NODE_78895_length_397_cov_13.667785	94	174	0	80	80	1.0000000
NODE_78895_length_397_cov_13.667785	147	227	0	80	80	1.0000000
NODE_78897_length_397_cov_7.496644	192	272	0	80	80	1.0000000
NODE_78897_length_397_cov_7.496644	245	325	0	80	80	1.0000000
NODE_78898_length_397_cov_6.828859	127	173	0	14	46	0.3043478
NODE_78898_length_397_cov_6.828859	127	173	4	32	46	0.6956522
NODE_78913_length_397_cov_4.902685	293	364	0	14	71	0.1971831
NODE_78913_length_397_cov_4.902685	293	364	2	57	71	0.8028169
NODE_78933_length_397_cov_3.765101	164	244	0	80	80	1.0000000
NODE_78951_length_397_cov_3.325503	107	187	0	7	80	0.0875000
NODE_78951_length_397_cov_3.325503	107	187	2	73	80	0.9125000
NODE_78951_length_397_cov_3.325503	163	236	0	39	73	0.5342466
NODE_78951_length_397_cov_3.325503	163	236	2	34	73	0.4657534
NODE_78999_length_397_cov_2.530201	269	312	0	43	43	1.0000000
NODE_79047_length_397_cov_1.959732	154	193	0	39	39	1.0000000
NODE_79072_length_397_cov_1.791946	218	283	0	25	65	0.3846154
NODE_79072_length_397_cov_1.791946	218	283	2	3	65	0.0461538
NODE_79072_length_397_cov_1.791946	218	283	4	9	65	0.1384615
NODE_79072_length_397_cov_1.791946	218	283	6	28	65	0.4307692
NODE_79127_length_397_cov_1.560403	183	240	0	57	57	1.0000000
NODE_79456_length_396_cov_11.632997	162	242	0	80	80	1.0000000
NODE_79456_length_396_cov_11.632997	215	295	0	40	80	0.5000000
NODE_79456_length_396_cov_11.632997	215	295	2	40	80	0.5000000
NODE_79460_length_396_cov_7.053872	71	101	0	30	30	1.0000000
NODE_79464_length_396_cov_6.097643	229	309	0	80	80	1.0000000
NODE_79464_length_396_cov_6.097643	282	362	0	80	80	1.0000000
NODE_79471_length_396_cov_5.484848	125	205	0	3	80	0.0375000
NODE_79471_length_396_cov_5.484848	125	205	2	13	80	0.1625000
NODE_79471_length_396_cov_5.484848	125	205	4	3	80	0.0375000
NODE_79471_length_396_cov_5.484848	125	205	6	2	80	0.0250000
NODE_79471_length_396_cov_5.484848	125	205	8	8	80	0.1000000
NODE_79471_length_396_cov_5.484848	125	205	10	12	80	0.1500000
NODE_79471_length_396_cov_5.484848	125	205	12	10	80	0.1250000
NODE_79471_length_396_cov_5.484848	125	205	14	2	80	0.0250000
NODE_79471_length_396_cov_5.484848	125	205	16	27	80	0.3375000
NODE_79471_length_396_cov_5.484848	178	259	4	9	81	0.1111111
NODE_79471_length_396_cov_5.484848	178	259	6	6	81	0.0740741
NODE_79471_length_396_cov_5.484848	178	259	8	3	81	0.0370370
NODE_79471_length_396_cov_5.484848	178	259	10	16	81	0.1975309
NODE_79471_length_396_cov_5.484848	178	259	12	4	81	0.0493827
NODE_79471_length_396_cov_5.484848	178	259	14	18	81	0.2222222
NODE_79471_length_396_cov_5.484848	178	259	16	25	81	0.3086420
NODE_79473_length_396_cov_5.434343	224	275	0	12	51	0.2352941
NODE_79473_length_396_cov_5.434343	224	275	1	3	51	0.0588235
NODE_79473_length_396_cov_5.434343	224	275	2	36	51	0.7058824
NODE_79473_length_396_cov_5.434343	272	331	0	8	59	0.1355932
NODE_79473_length_396_cov_5.434343	272	331	2	2	59	0.0338983
NODE_79473_length_396_cov_5.434343	272	331	4	49	59	0.8305085
NODE_79483_length_396_cov_4.414141	189	264	0	75	75	1.0000000
NODE_79483_length_396_cov_4.414141	241	317	0	76	76	1.0000000
NODE_79493_length_396_cov_4.010101	163	205	2	42	42	1.0000000
NODE_79522_length_396_cov_3.080808	95	161	0	66	66	1.0000000
NODE_79524_length_396_cov_3.067340	252	316	6	64	64	1.0000000
NODE_79535_length_396_cov_2.892256	136	217	2	18	81	0.2222222
NODE_79535_length_396_cov_2.892256	136	217	6	63	81	0.7777778
NODE_79557_length_396_cov_2.710438	88	168	4	6	80	0.0750000
NODE_79557_length_396_cov_2.710438	88	168	6	9	80	0.1125000
NODE_79557_length_396_cov_2.710438	88	168	8	8	80	0.1000000
NODE_79557_length_396_cov_2.710438	88	168	10	9	80	0.1125000
NODE_79557_length_396_cov_2.710438	88	168	12	5	80	0.0625000
NODE_79557_length_396_cov_2.710438	88	168	14	4	80	0.0500000
NODE_79557_length_396_cov_2.710438	88	168	16	3	80	0.0375000
NODE_79557_length_396_cov_2.710438	88	168	18	2	80	0.0250000
NODE_79557_length_396_cov_2.710438	88	168	20	7	80	0.0875000
NODE_79557_length_396_cov_2.710438	88	168	22	10	80	0.1250000
NODE_79557_length_396_cov_2.710438	88	168	24	17	80	0.2125000
NODE_79561_length_396_cov_2.680135	297	335	0	38	38	1.0000000
NODE_79562_length_396_cov_2.659933	68	148	0	57	80	0.7125000
NODE_79562_length_396_cov_2.659933	68	148	2	23	80	0.2875000
NODE_79562_length_396_cov_2.659933	121	168	0	47	47	1.0000000
NODE_79616_length_396_cov_2.060606	308	388	0	80	80	1.0000000
NODE_79643_length_396_cov_1.939394	63	142	4	18	79	0.2278481
NODE_79643_length_396_cov_1.939394	63	142	6	11	79	0.1392405
NODE_79643_length_396_cov_1.939394	63	142	8	50	79	0.6329114
NODE_79643_length_396_cov_1.939394	115	164	2	1	49	0.0204082
NODE_79643_length_396_cov_1.939394	115	164	4	4	49	0.0816327
NODE_79643_length_396_cov_1.939394	115	164	6	10	49	0.2040816
NODE_79643_length_396_cov_1.939394	115	164	8	34	49	0.6938776
NODE_79683_length_396_cov_1.811448	82	162	0	80	80	1.0000000
NODE_79692_length_396_cov_1.734007	88	119	0	31	31	1.0000000
NODE_79930_length_396_cov_0.905724	101	151	22	16	50	0.3200000
NODE_79930_length_396_cov_0.905724	101	151	24	14	50	0.2800000
NODE_79930_length_396_cov_0.905724	101	151	26	7	50	0.1400000
NODE_79930_length_396_cov_0.905724	101	151	28	13	50	0.2600000
NODE_80057_length_395_cov_449.327703	0	79	45	1	79	0.0126582
NODE_80057_length_395_cov_449.327703	0	79	51	1	79	0.0126582
NODE_80057_length_395_cov_449.327703	0	79	57	1	79	0.0126582
NODE_80057_length_395_cov_449.327703	0	79	67	1	79	0.0126582
NODE_80057_length_395_cov_449.327703	0	79	70	1	79	0.0126582
NODE_80057_length_395_cov_449.327703	0	79	86	1	79	0.0126582
NODE_80057_length_395_cov_449.327703	0	79	87	3	79	0.0379747
NODE_80057_length_395_cov_449.327703	0	79	89	1	79	0.0126582
NODE_80057_length_395_cov_449.327703	0	79	101	2	79	0.0253165
NODE_80057_length_395_cov_449.327703	0	79	103	1	79	0.0126582
NODE_80057_length_395_cov_449.327703	0	79	105	1	79	0.0126582
NODE_80057_length_395_cov_449.327703	0	79	107	1	79	0.0126582
NODE_80057_length_395_cov_449.327703	0	79	114	1	79	0.0126582
NODE_80057_length_395_cov_449.327703	0	79	124	1	79	0.0126582
NODE_80057_length_395_cov_449.327703	0	79	126	2	79	0.0253165
NODE_80057_length_395_cov_449.327703	0	79	132	1	79	0.0126582
NODE_80057_length_395_cov_449.327703	0	79	134	1	79	0.0126582
NODE_80057_length_395_cov_449.327703	0	79	144	1	79	0.0126582
NODE_80057_length_395_cov_449.327703	0	79	146	1	79	0.0126582
NODE_80057_length_395_cov_449.327703	0	79	154	1	79	0.0126582
NODE_80057_length_395_cov_449.327703	0	79	158	1	79	0.0126582
NODE_80057_length_395_cov_449.327703	0	79	169	1	79	0.0126582
NODE_80057_length_395_cov_449.327703	0	79	183	1	79	0.0126582
NODE_80057_length_395_cov_449.327703	0	79	189	1	79	0.0126582
NODE_80057_length_395_cov_449.327703	0	79	195	1	79	0.0126582
NODE_80057_length_395_cov_449.327703	0	79	203	1	79	0.0126582
NODE_80057_length_395_cov_449.327703	0	79	208	1	79	0.0126582
NODE_80057_length_395_cov_449.327703	0	79	215	1	79	0.0126582
NODE_80057_length_395_cov_449.327703	0	79	217	1	79	0.0126582
NODE_80057_length_395_cov_449.327703	0	79	231	4	79	0.0506329
NODE_80057_length_395_cov_449.327703	0	79	234	2	79	0.0253165
NODE_80057_length_395_cov_449.327703	0	79	240	1	79	0.0126582
NODE_80057_length_395_cov_449.327703	0	79	241	1	79	0.0126582
NODE_80057_length_395_cov_449.327703	0	79	254	1	79	0.0126582
NODE_80057_length_395_cov_449.327703	0	79	261	1	79	0.0126582
NODE_80057_length_395_cov_449.327703	0	79	279	1	79	0.0126582
NODE_80057_length_395_cov_449.327703	0	79	281	1	79	0.0126582
NODE_80057_length_395_cov_449.327703	0	79	285	2	79	0.0253165
NODE_80057_length_395_cov_449.327703	0	79	291	1	79	0.0126582
NODE_80057_length_395_cov_449.327703	0	79	293	1	79	0.0126582
NODE_80057_length_395_cov_449.327703	0	79	297	3	79	0.0379747
NODE_80057_length_395_cov_449.327703	0	79	300	1	79	0.0126582
NODE_80057_length_395_cov_449.327703	0	79	301	1	79	0.0126582
NODE_80057_length_395_cov_449.327703	0	79	306	1	79	0.0126582
NODE_80057_length_395_cov_449.327703	0	79	311	1	79	0.0126582
NODE_80057_length_395_cov_449.327703	0	79	314	1	79	0.0126582
NODE_80057_length_395_cov_449.327703	0	79	315	1	79	0.0126582
NODE_80057_length_395_cov_449.327703	0	79	320	1	79	0.0126582
NODE_80057_length_395_cov_449.327703	0	79	322	1	79	0.0126582
NODE_80057_length_395_cov_449.327703	0	79	335	1	79	0.0126582
NODE_80057_length_395_cov_449.327703	0	79	343	2	79	0.0253165
NODE_80057_length_395_cov_449.327703	0	79	344	1	79	0.0126582
NODE_80057_length_395_cov_449.327703	0	79	346	1	79	0.0126582
NODE_80057_length_395_cov_449.327703	0	79	356	1	79	0.0126582
NODE_80057_length_395_cov_449.327703	0	79	358	1	79	0.0126582
NODE_80057_length_395_cov_449.327703	0	79	359	1	79	0.0126582
NODE_80057_length_395_cov_449.327703	0	79	365	1	79	0.0126582
NODE_80057_length_395_cov_449.327703	0	79	373	2	79	0.0253165
NODE_80057_length_395_cov_449.327703	0	79	375	2	79	0.0253165
NODE_80057_length_395_cov_449.327703	0	79	378	1	79	0.0126582
NODE_80057_length_395_cov_449.327703	0	79	388	1	79	0.0126582
NODE_80057_length_395_cov_449.327703	0	79	396	1	79	0.0126582
NODE_80057_length_395_cov_449.327703	0	79	399	1	79	0.0126582
NODE_80057_length_395_cov_449.327703	0	79	404	1	79	0.0126582
NODE_80057_length_395_cov_449.327703	0	79	411	1	79	0.0126582
NODE_80058_length_395_cov_13.695946	113	193	0	80	80	1.0000000
NODE_80058_length_395_cov_13.695946	166	246	0	80	80	1.0000000
NODE_80086_length_395_cov_4.179054	152	232	0	21	80	0.2625000
NODE_80086_length_395_cov_4.179054	152	232	2	7	80	0.0875000
NODE_80086_length_395_cov_4.179054	152	232	3	1	80	0.0125000
NODE_80086_length_395_cov_4.179054	152	232	4	51	80	0.6375000
NODE_80116_length_395_cov_2.962838	118	198	2	7	80	0.0875000
NODE_80116_length_395_cov_2.962838	118	198	4	73	80	0.9125000
NODE_80116_length_395_cov_2.962838	171	237	0	33	66	0.5000000
NODE_80116_length_395_cov_2.962838	171	237	2	1	66	0.0151515
NODE_80116_length_395_cov_2.962838	171	237	4	32	66	0.4848485
NODE_80121_length_395_cov_2.878378	261	301	0	40	40	1.0000000
NODE_80139_length_395_cov_2.587838	111	188	0	54	77	0.7012987
NODE_80139_length_395_cov_2.587838	111	188	2	23	77	0.2987013
NODE_80139_length_395_cov_2.587838	232	301	0	33	69	0.4782609
NODE_80139_length_395_cov_2.587838	232	301	2	36	69	0.5217391
NODE_80139_length_395_cov_2.587838	258	302	0	34	44	0.7727273
NODE_80139_length_395_cov_2.587838	258	302	2	10	44	0.2272727
NODE_80141_length_395_cov_2.560811	123	187	0	15	64	0.2343750
NODE_80141_length_395_cov_2.560811	123	187	2	49	64	0.7656250
NODE_80146_length_395_cov_2.527027	194	274	0	80	80	1.0000000
NODE_80146_length_395_cov_2.527027	247	327	0	80	80	1.0000000
NODE_80439_length_395_cov_1.033784	103	151	2	48	48	1.0000000
NODE_80448_length_395_cov_1.010135	85	105	0	20	20	1.0000000
NODE_80639_length_394_cov_9.464407	211	291	2	80	80	1.0000000
NODE_80639_length_394_cov_9.464407	264	344	0	36	80	0.4500000
NODE_80639_length_394_cov_9.464407	264	344	2	44	80	0.5500000
NODE_80643_length_394_cov_7.437288	221	301	8	11	80	0.1375000
NODE_80643_length_394_cov_7.437288	221	301	10	22	80	0.2750000
NODE_80643_length_394_cov_7.437288	221	301	14	12	80	0.1500000
NODE_80643_length_394_cov_7.437288	221	301	16	35	80	0.4375000
NODE_80643_length_394_cov_7.437288	274	331	2	5	57	0.0877193
NODE_80643_length_394_cov_7.437288	274	331	6	5	57	0.0877193
NODE_80643_length_394_cov_7.437288	274	331	8	5	57	0.0877193
NODE_80643_length_394_cov_7.437288	274	331	12	7	57	0.1228070
NODE_80643_length_394_cov_7.437288	274	331	14	11	57	0.1929825
NODE_80643_length_394_cov_7.437288	274	331	16	24	57	0.4210526
NODE_80647_length_394_cov_6.444068	187	267	0	80	80	1.0000000
NODE_80647_length_394_cov_6.444068	240	320	0	80	80	1.0000000
NODE_80709_length_394_cov_2.932203	119	140	0	21	21	1.0000000
NODE_80710_length_394_cov_2.894915	79	135	2	5	56	0.0892857
NODE_80710_length_394_cov_2.894915	79	135	4	4	56	0.0714286
NODE_80710_length_394_cov_2.894915	79	135	6	47	56	0.8392857
NODE_80710_length_394_cov_2.894915	166	202	2	26	36	0.7222222
NODE_80710_length_394_cov_2.894915	166	202	4	8	36	0.2222222
NODE_80710_length_394_cov_2.894915	166	202	6	2	36	0.0555556
NODE_81216_length_393_cov_4.261905	201	267	2	18	66	0.2727273
NODE_81216_length_393_cov_4.261905	201	267	4	48	66	0.7272727
NODE_81216_length_393_cov_4.261905	240	282	0	5	42	0.1190476
NODE_81216_length_393_cov_4.261905	240	282	2	28	42	0.6666667
NODE_81216_length_393_cov_4.261905	240	282	4	9	42	0.2142857
NODE_81240_length_393_cov_3.503401	121	201	0	80	80	1.0000000
NODE_81240_length_393_cov_3.503401	174	246	0	72	72	1.0000000
NODE_81277_length_393_cov_2.704082	198	271	0	73	73	1.0000000
NODE_81289_length_393_cov_2.493197	136	216	0	80	80	1.0000000
NODE_81289_length_393_cov_2.493197	189	269	0	80	80	1.0000000
NODE_81296_length_393_cov_2.360544	195	252	0	57	57	1.0000000
NODE_81416_length_393_cov_1.608844	207	270	0	63	63	1.0000000
NODE_81778_length_392_cov_7.873720	161	241	0	80	80	1.0000000
NODE_81778_length_392_cov_7.873720	214	294	0	80	80	1.0000000
NODE_81790_length_392_cov_5.262799	218	248	0	30	30	1.0000000
NODE_81805_length_392_cov_3.655290	109	157	0	48	48	1.0000000
NODE_81805_length_392_cov_3.655290	306	386	0	73	80	0.9125000
NODE_81805_length_392_cov_3.655290	306	386	2	7	80	0.0875000
NODE_81823_length_392_cov_3.197952	102	171	0	29	69	0.4202898
NODE_81823_length_392_cov_3.197952	102	171	2	28	69	0.4057971
NODE_81823_length_392_cov_3.197952	102	171	4	4	69	0.0579710
NODE_81823_length_392_cov_3.197952	102	171	6	8	69	0.1159420
NODE_81823_length_392_cov_3.197952	233	314	0	81	81	1.0000000
NODE_81857_length_392_cov_2.511945	67	133	34	2	66	0.0303030
NODE_81857_length_392_cov_2.511945	67	133	36	2	66	0.0303030
NODE_81857_length_392_cov_2.511945	67	133	46	2	66	0.0303030
NODE_81857_length_392_cov_2.511945	67	133	48	1	66	0.0151515
NODE_81857_length_392_cov_2.511945	67	133	50	4	66	0.0606061
NODE_81857_length_392_cov_2.511945	67	133	52	3	66	0.0454545
NODE_81857_length_392_cov_2.511945	67	133	53	2	66	0.0303030
NODE_81857_length_392_cov_2.511945	67	133	59	4	66	0.0606061
NODE_81857_length_392_cov_2.511945	67	133	63	1	66	0.0151515
NODE_81857_length_392_cov_2.511945	67	133	67	1	66	0.0151515
NODE_81857_length_392_cov_2.511945	67	133	73	2	66	0.0303030
NODE_81857_length_392_cov_2.511945	67	133	75	1	66	0.0151515
NODE_81857_length_392_cov_2.511945	67	133	79	3	66	0.0454545
NODE_81857_length_392_cov_2.511945	67	133	85	1	66	0.0151515
NODE_81857_length_392_cov_2.511945	67	133	93	3	66	0.0454545
NODE_81857_length_392_cov_2.511945	67	133	97	1	66	0.0151515
NODE_81857_length_392_cov_2.511945	67	133	100	4	66	0.0606061
NODE_81857_length_392_cov_2.511945	67	133	101	5	66	0.0757576
NODE_81857_length_392_cov_2.511945	67	133	102	16	66	0.2424242
NODE_81857_length_392_cov_2.511945	67	133	104	4	66	0.0606061
NODE_81857_length_392_cov_2.511945	67	133	106	1	66	0.0151515
NODE_81857_length_392_cov_2.511945	67	133	108	1	66	0.0151515
NODE_81857_length_392_cov_2.511945	67	133	114	2	66	0.0303030
NODE_81857_length_392_cov_2.511945	120	206	79	6	86	0.0697674
NODE_81857_length_392_cov_2.511945	120	206	81	1	86	0.0116279
NODE_81857_length_392_cov_2.511945	120	206	85	1	86	0.0116279
NODE_81857_length_392_cov_2.511945	120	206	89	4	86	0.0465116
NODE_81857_length_392_cov_2.511945	120	206	91	1	86	0.0116279
NODE_81857_length_392_cov_2.511945	120	206	93	1	86	0.0116279
NODE_81857_length_392_cov_2.511945	120	206	97	4	86	0.0465116
NODE_81857_length_392_cov_2.511945	120	206	100	4	86	0.0465116
NODE_81857_length_392_cov_2.511945	120	206	101	1	86	0.0116279
NODE_81857_length_392_cov_2.511945	120	206	102	1	86	0.0116279
NODE_81857_length_392_cov_2.511945	120	206	103	5	86	0.0581395
NODE_81857_length_392_cov_2.511945	120	206	104	4	86	0.0465116
NODE_81857_length_392_cov_2.511945	120	206	106	1	86	0.0116279
NODE_81857_length_392_cov_2.511945	120	206	108	1	86	0.0116279
NODE_81857_length_392_cov_2.511945	120	206	111	1	86	0.0116279
NODE_81857_length_392_cov_2.511945	120	206	113	3	86	0.0348837
NODE_81857_length_392_cov_2.511945	120	206	114	2	86	0.0232558
NODE_81857_length_392_cov_2.511945	120	206	115	2	86	0.0232558
NODE_81857_length_392_cov_2.511945	120	206	116	2	86	0.0232558
NODE_81857_length_392_cov_2.511945	120	206	118	3	86	0.0348837
NODE_81857_length_392_cov_2.511945	120	206	119	5	86	0.0581395
NODE_81857_length_392_cov_2.511945	120	206	121	5	86	0.0581395
NODE_81857_length_392_cov_2.511945	120	206	123	6	86	0.0697674
NODE_81857_length_392_cov_2.511945	120	206	124	1	86	0.0116279
NODE_81857_length_392_cov_2.511945	120	206	125	6	86	0.0697674
NODE_81857_length_392_cov_2.511945	120	206	126	4	86	0.0465116
NODE_81857_length_392_cov_2.511945	120	206	128	8	86	0.0930233
NODE_81857_length_392_cov_2.511945	120	206	132	3	86	0.0348837
NODE_81914_length_392_cov_2.075085	268	349	4	36	81	0.4444444
NODE_81914_length_392_cov_2.075085	268	349	6	45	81	0.5555556
NODE_81914_length_392_cov_2.075085	322	387	2	8	65	0.1230769
NODE_81914_length_392_cov_2.075085	322	387	4	15	65	0.2307692
NODE_81914_length_392_cov_2.075085	322	387	6	42	65	0.6461539
NODE_81928_length_392_cov_1.955631	11	56	0	45	45	1.0000000
NODE_81929_length_392_cov_1.952218	40	59	0	19	19	1.0000000
NODE_81940_length_392_cov_1.911263	238	315	2	20	77	0.2597403
NODE_81940_length_392_cov_1.911263	238	315	4	57	77	0.7402598
NODE_81994_length_392_cov_1.631399	114	139	10	1	25	0.0400000
NODE_81994_length_392_cov_1.631399	114	139	12	3	25	0.1200000
NODE_81994_length_392_cov_1.631399	114	139	16	3	25	0.1200000
NODE_81994_length_392_cov_1.631399	114	139	18	4	25	0.1600000
NODE_81994_length_392_cov_1.631399	114	139	22	3	25	0.1200000
NODE_81994_length_392_cov_1.631399	114	139	24	7	25	0.2800000
NODE_81994_length_392_cov_1.631399	114	139	28	4	25	0.1600000
NODE_82008_length_392_cov_1.559727	83	163	8	5	80	0.0625000
NODE_82008_length_392_cov_1.559727	83	163	10	16	80	0.2000000
NODE_82008_length_392_cov_1.559727	83	163	12	45	80	0.5625000
NODE_82008_length_392_cov_1.559727	83	163	14	14	80	0.1750000
NODE_82015_length_392_cov_1.552901	32	52	0	20	20	1.0000000
NODE_82390_length_391_cov_69.510274	9	89	80	1	80	0.0125000
NODE_82390_length_391_cov_69.510274	9	89	84	1	80	0.0125000
NODE_82390_length_391_cov_69.510274	9	89	88	1	80	0.0125000
NODE_82390_length_391_cov_69.510274	9	89	90	1	80	0.0125000
NODE_82390_length_391_cov_69.510274	9	89	91	1	80	0.0125000
NODE_82390_length_391_cov_69.510274	9	89	93	1	80	0.0125000
NODE_82390_length_391_cov_69.510274	9	89	102	1	80	0.0125000
NODE_82390_length_391_cov_69.510274	9	89	103	2	80	0.0250000
NODE_82390_length_391_cov_69.510274	9	89	104	1	80	0.0125000
NODE_82390_length_391_cov_69.510274	9	89	108	1	80	0.0125000
NODE_82390_length_391_cov_69.510274	9	89	110	1	80	0.0125000
NODE_82390_length_391_cov_69.510274	9	89	114	1	80	0.0125000
NODE_82390_length_391_cov_69.510274	9	89	124	2	80	0.0250000
NODE_82390_length_391_cov_69.510274	9	89	126	1	80	0.0125000
NODE_82390_length_391_cov_69.510274	9	89	128	1	80	0.0125000
NODE_82390_length_391_cov_69.510274	9	89	130	1	80	0.0125000
NODE_82390_length_391_cov_69.510274	9	89	131	1	80	0.0125000
NODE_82390_length_391_cov_69.510274	9	89	133	1	80	0.0125000
NODE_82390_length_391_cov_69.510274	9	89	147	1	80	0.0125000
NODE_82390_length_391_cov_69.510274	9	89	151	1	80	0.0125000
NODE_82390_length_391_cov_69.510274	9	89	159	1	80	0.0125000
NODE_82390_length_391_cov_69.510274	9	89	162	1	80	0.0125000
NODE_82390_length_391_cov_69.510274	9	89	164	1	80	0.0125000
NODE_82390_length_391_cov_69.510274	9	89	170	1	80	0.0125000
NODE_82390_length_391_cov_69.510274	9	89	172	2	80	0.0250000
NODE_82390_length_391_cov_69.510274	9	89	178	1	80	0.0125000
NODE_82390_length_391_cov_69.510274	9	89	180	1	80	0.0125000
NODE_82390_length_391_cov_69.510274	9	89	188	1	80	0.0125000
NODE_82390_length_391_cov_69.510274	9	89	190	1	80	0.0125000
NODE_82390_length_391_cov_69.510274	9	89	196	1	80	0.0125000
NODE_82390_length_391_cov_69.510274	9	89	202	1	80	0.0125000
NODE_82390_length_391_cov_69.510274	9	89	206	1	80	0.0125000
NODE_82390_length_391_cov_69.510274	9	89	214	1	80	0.0125000
NODE_82390_length_391_cov_69.510274	9	89	215	1	80	0.0125000
NODE_82390_length_391_cov_69.510274	9	89	217	1	80	0.0125000
NODE_82390_length_391_cov_69.510274	9	89	218	1	80	0.0125000
NODE_82390_length_391_cov_69.510274	9	89	220	1	80	0.0125000
NODE_82390_length_391_cov_69.510274	9	89	228	2	80	0.0250000
NODE_82390_length_391_cov_69.510274	9	89	234	2	80	0.0250000
NODE_82390_length_391_cov_69.510274	9	89	238	2	80	0.0250000
NODE_82390_length_391_cov_69.510274	9	89	240	2	80	0.0250000
NODE_82390_length_391_cov_69.510274	9	89	242	1	80	0.0125000
NODE_82390_length_391_cov_69.510274	9	89	244	3	80	0.0375000
NODE_82390_length_391_cov_69.510274	9	89	246	2	80	0.0250000
NODE_82390_length_391_cov_69.510274	9	89	253	1	80	0.0125000
NODE_82390_length_391_cov_69.510274	9	89	255	1	80	0.0125000
NODE_82390_length_391_cov_69.510274	9	89	263	2	80	0.0250000
NODE_82390_length_391_cov_69.510274	9	89	267	3	80	0.0375000
NODE_82390_length_391_cov_69.510274	9	89	271	3	80	0.0375000
NODE_82390_length_391_cov_69.510274	9	89	278	1	80	0.0125000
NODE_82390_length_391_cov_69.510274	9	89	280	3	80	0.0375000
NODE_82390_length_391_cov_69.510274	9	89	284	2	80	0.0250000
NODE_82390_length_391_cov_69.510274	9	89	286	1	80	0.0125000
NODE_82390_length_391_cov_69.510274	9	89	288	1	80	0.0125000
NODE_82390_length_391_cov_69.510274	9	89	290	4	80	0.0500000
NODE_82390_length_391_cov_69.510274	9	89	292	1	80	0.0125000
NODE_82390_length_391_cov_69.510274	9	89	294	1	80	0.0125000
NODE_82390_length_391_cov_69.510274	9	89	296	2	80	0.0250000
NODE_82391_length_391_cov_39.414384	0	66	0	6	66	0.0909091
NODE_82391_length_391_cov_39.414384	0	66	6	3	66	0.0454545
NODE_82391_length_391_cov_39.414384	0	66	10	3	66	0.0454545
NODE_82391_length_391_cov_39.414384	0	66	16	14	66	0.2121212
NODE_82391_length_391_cov_39.414384	0	66	18	2	66	0.0303030
NODE_82391_length_391_cov_39.414384	0	66	20	1	66	0.0151515
NODE_82391_length_391_cov_39.414384	0	66	26	26	66	0.3939394
NODE_82391_length_391_cov_39.414384	0	66	28	10	66	0.1515152
NODE_82391_length_391_cov_39.414384	0	66	30	1	66	0.0151515
NODE_82391_length_391_cov_39.414384	0	71	0	6	71	0.0845070
NODE_82391_length_391_cov_39.414384	0	71	6	3	71	0.0422535
NODE_82391_length_391_cov_39.414384	0	71	10	3	71	0.0422535
NODE_82391_length_391_cov_39.414384	0	71	16	14	71	0.1971831
NODE_82391_length_391_cov_39.414384	0	71	18	2	71	0.0281690
NODE_82391_length_391_cov_39.414384	0	71	20	1	71	0.0140845
NODE_82391_length_391_cov_39.414384	0	71	26	26	71	0.3661972
NODE_82391_length_391_cov_39.414384	0	71	28	10	71	0.1408451
NODE_82391_length_391_cov_39.414384	0	71	30	6	71	0.0845070
NODE_82391_length_391_cov_39.414384	44	124	8	6	80	0.0750000
NODE_82391_length_391_cov_39.414384	44	124	10	5	80	0.0625000
NODE_82391_length_391_cov_39.414384	44	124	14	5	80	0.0625000
NODE_82391_length_391_cov_39.414384	44	124	16	3	80	0.0375000
NODE_82391_length_391_cov_39.414384	44	124	18	1	80	0.0125000
NODE_82391_length_391_cov_39.414384	44	124	20	1	80	0.0125000
NODE_82391_length_391_cov_39.414384	44	124	26	11	80	0.1375000
NODE_82391_length_391_cov_39.414384	44	124	28	10	80	0.1250000
NODE_82391_length_391_cov_39.414384	44	124	30	38	80	0.4750000
NODE_82394_length_391_cov_10.352740	156	235	0	79	79	1.0000000
NODE_82415_length_391_cov_5.030822	85	166	8	3	81	0.0370370
NODE_82415_length_391_cov_5.030822	85	166	11	3	81	0.0370370
NODE_82415_length_391_cov_5.030822	85	166	12	3	81	0.0370370
NODE_82415_length_391_cov_5.030822	85	166	15	20	81	0.2469136
NODE_82415_length_391_cov_5.030822	85	166	18	18	81	0.2222222
NODE_82415_length_391_cov_5.030822	85	166	20	1	81	0.0123457
NODE_82415_length_391_cov_5.030822	85	166	22	4	81	0.0493827
NODE_82415_length_391_cov_5.030822	85	166	24	26	81	0.3209876
NODE_82415_length_391_cov_5.030822	85	166	25	1	81	0.0123457
NODE_82415_length_391_cov_5.030822	85	166	26	2	81	0.0246914
NODE_82498_length_391_cov_2.660959	267	343	8	33	76	0.4342105
NODE_82498_length_391_cov_2.660959	267	343	10	43	76	0.5657895
NODE_82552_length_391_cov_2.089041	176	256	8	80	80	1.0000000
NODE_82552_length_391_cov_2.089041	229	280	8	30	51	0.5882353
NODE_82552_length_391_cov_2.089041	229	280	9	21	51	0.4117647
NODE_82574_length_391_cov_1.907534	200	257	0	57	57	1.0000000
NODE_82597_length_391_cov_1.773973	160	190	0	17	30	0.5666667
NODE_82597_length_391_cov_1.773973	160	190	2	13	30	0.4333333
NODE_82632_length_391_cov_1.647260	298	378	0	80	80	1.0000000
NODE_82662_length_391_cov_1.561644	241	261	0	20	20	1.0000000
NODE_83015_length_390_cov_29.030928	86	166	0	2	80	0.0250000
NODE_83015_length_390_cov_29.030928	86	166	3	3	80	0.0375000
NODE_83015_length_390_cov_29.030928	86	166	6	1	80	0.0125000
NODE_83015_length_390_cov_29.030928	86	166	7	21	80	0.2625000
NODE_83015_length_390_cov_29.030928	86	166	8	9	80	0.1125000
NODE_83015_length_390_cov_29.030928	86	166	9	20	80	0.2500000
NODE_83015_length_390_cov_29.030928	86	166	10	24	80	0.3000000
NODE_83015_length_390_cov_29.030928	139	219	6	10	80	0.1250000
NODE_83015_length_390_cov_29.030928	139	219	8	3	80	0.0375000
NODE_83015_length_390_cov_29.030928	139	219	10	51	80	0.6375000
NODE_83015_length_390_cov_29.030928	139	219	12	16	80	0.2000000
NODE_83016_length_390_cov_22.319588	118	198	3	60	80	0.7500000
NODE_83016_length_390_cov_22.319588	118	198	4	20	80	0.2500000
NODE_83016_length_390_cov_22.319588	171	251	0	19	80	0.2375000
NODE_83016_length_390_cov_22.319588	171	251	3	8	80	0.1000000
NODE_83016_length_390_cov_22.319588	171	251	4	53	80	0.6625000
NODE_83044_length_390_cov_4.481100	208	277	0	68	69	0.9855072
NODE_83044_length_390_cov_4.481100	208	277	2	1	69	0.0144928
NODE_83044_length_390_cov_4.481100	286	327	0	5	41	0.1219512
NODE_83044_length_390_cov_4.481100	286	327	2	36	41	0.8780488
NODE_83045_length_390_cov_4.481100	93	171	2	78	78	1.0000000
NODE_83045_length_390_cov_4.481100	144	210	0	11	66	0.1666667
NODE_83045_length_390_cov_4.481100	144	210	2	55	66	0.8333333
NODE_83060_length_390_cov_3.814433	66	99	0	33	33	1.0000000
NODE_83061_length_390_cov_3.783505	188	268	0	80	80	1.0000000
NODE_83061_length_390_cov_3.783505	241	321	0	80	80	1.0000000
NODE_83066_length_390_cov_3.560137	304	367	2	22	63	0.3492064
NODE_83066_length_390_cov_3.560137	304	367	4	41	63	0.6507937
NODE_83066_length_390_cov_3.560137	340	381	2	36	41	0.8780488
NODE_83066_length_390_cov_3.560137	340	381	4	5	41	0.1219512
NODE_83169_length_390_cov_2.127148	242	322	2	15	80	0.1875000
NODE_83169_length_390_cov_2.127148	242	322	4	65	80	0.8125000
NODE_83171_length_390_cov_2.123711	133	177	0	2	44	0.0454545
NODE_83171_length_390_cov_2.123711	133	177	2	2	44	0.0454545
NODE_83171_length_390_cov_2.123711	133	177	10	11	44	0.2500000
NODE_83171_length_390_cov_2.123711	133	177	11	2	44	0.0454545
NODE_83171_length_390_cov_2.123711	133	177	12	4	44	0.0909091
NODE_83171_length_390_cov_2.123711	133	177	14	1	44	0.0227273
NODE_83171_length_390_cov_2.123711	133	177	18	1	44	0.0227273
NODE_83171_length_390_cov_2.123711	133	177	20	1	44	0.0227273
NODE_83171_length_390_cov_2.123711	133	177	21	17	44	0.3863636
NODE_83171_length_390_cov_2.123711	133	177	23	3	44	0.0681818
NODE_83171_length_390_cov_2.123711	157	237	21	17	80	0.2125000
NODE_83171_length_390_cov_2.123711	157	237	23	3	80	0.0375000
NODE_83171_length_390_cov_2.123711	157	237	25	3	80	0.0375000
NODE_83171_length_390_cov_2.123711	157	237	27	3	80	0.0375000
NODE_83171_length_390_cov_2.123711	157	237	29	4	80	0.0500000
NODE_83171_length_390_cov_2.123711	157	237	34	1	80	0.0125000
NODE_83171_length_390_cov_2.123711	157	237	35	2	80	0.0250000
NODE_83171_length_390_cov_2.123711	157	237	36	47	80	0.5875000
NODE_83288_length_390_cov_1.536082	223	276	0	53	53	1.0000000
NODE_83338_length_390_cov_1.398625	49	110	70	1	61	0.0163934
NODE_83338_length_390_cov_1.398625	49	110	74	1	61	0.0163934
NODE_83338_length_390_cov_1.398625	49	110	80	1	61	0.0163934
NODE_83338_length_390_cov_1.398625	49	110	82	3	61	0.0491803
NODE_83338_length_390_cov_1.398625	49	110	84	1	61	0.0163934
NODE_83338_length_390_cov_1.398625	49	110	86	1	61	0.0163934
NODE_83338_length_390_cov_1.398625	49	110	88	1	61	0.0163934
NODE_83338_length_390_cov_1.398625	49	110	91	1	61	0.0163934
NODE_83338_length_390_cov_1.398625	49	110	101	1	61	0.0163934
NODE_83338_length_390_cov_1.398625	49	110	103	3	61	0.0491803
NODE_83338_length_390_cov_1.398625	49	110	105	1	61	0.0163934
NODE_83338_length_390_cov_1.398625	49	110	107	1	61	0.0163934
NODE_83338_length_390_cov_1.398625	49	110	109	3	61	0.0491803
NODE_83338_length_390_cov_1.398625	49	110	111	1	61	0.0163934
NODE_83338_length_390_cov_1.398625	49	110	113	4	61	0.0655738
NODE_83338_length_390_cov_1.398625	49	110	115	1	61	0.0163934
NODE_83338_length_390_cov_1.398625	49	110	119	1	61	0.0163934
NODE_83338_length_390_cov_1.398625	49	110	121	1	61	0.0163934
NODE_83338_length_390_cov_1.398625	49	110	123	13	61	0.2131148
NODE_83338_length_390_cov_1.398625	49	110	125	1	61	0.0163934
NODE_83338_length_390_cov_1.398625	49	110	127	3	61	0.0491803
NODE_83338_length_390_cov_1.398625	49	110	129	11	61	0.1803279
NODE_83338_length_390_cov_1.398625	49	110	131	6	61	0.0983607
NODE_83463_length_390_cov_1.034364	78	158	0	80	80	1.0000000
NODE_83633_length_389_cov_63.710345	32	112	0	80	80	1.0000000
NODE_83633_length_389_cov_63.710345	85	165	0	80	80	1.0000000
NODE_83633_length_389_cov_63.710345	161	241	0	80	80	1.0000000
NODE_83633_length_389_cov_63.710345	214	294	0	80	80	1.0000000
NODE_83650_length_389_cov_5.382759	154	234	0	80	80	1.0000000
NODE_83662_length_389_cov_4.468966	199	269	4	70	70	1.0000000
NODE_83663_length_389_cov_4.424138	68	148	46	8	80	0.1000000
NODE_83663_length_389_cov_4.424138	68	148	48	3	80	0.0375000
NODE_83663_length_389_cov_4.424138	68	148	52	13	80	0.1625000
NODE_83663_length_389_cov_4.424138	68	148	58	2	80	0.0250000
NODE_83663_length_389_cov_4.424138	68	148	60	5	80	0.0625000
NODE_83663_length_389_cov_4.424138	68	148	62	6	80	0.0750000
NODE_83663_length_389_cov_4.424138	68	148	64	12	80	0.1500000
NODE_83663_length_389_cov_4.424138	68	148	66	16	80	0.2000000
NODE_83663_length_389_cov_4.424138	68	148	68	8	80	0.1000000
NODE_83663_length_389_cov_4.424138	68	148	71	1	80	0.0125000
NODE_83663_length_389_cov_4.424138	68	148	72	6	80	0.0750000
NODE_83685_length_389_cov_3.782759	194	225	0	31	31	1.0000000
NODE_83689_length_389_cov_3.555172	107	153	0	40	46	0.8695652
NODE_83689_length_389_cov_3.555172	107	153	2	4	46	0.0869565
NODE_83689_length_389_cov_3.555172	107	153	6	2	46	0.0434783
NODE_83695_length_389_cov_3.251724	120	163	13	14	43	0.3255814
NODE_83695_length_389_cov_3.251724	120	163	15	11	43	0.2558140
NODE_83695_length_389_cov_3.251724	120	163	17	18	43	0.4186046
NODE_83695_length_389_cov_3.251724	136	206	11	22	70	0.3142857
NODE_83695_length_389_cov_3.251724	136	206	13	9	70	0.1285714
NODE_83695_length_389_cov_3.251724	136	206	15	7	70	0.1000000
NODE_83695_length_389_cov_3.251724	136	206	17	32	70	0.4571429
NODE_83816_length_389_cov_1.951724	68	148	0	80	80	1.0000000
NODE_83819_length_389_cov_1.937931	53	82	2	29	29	1.0000000
NODE_83819_length_389_cov_1.937931	153	233	22	14	80	0.1750000
NODE_83819_length_389_cov_1.937931	153	233	24	10	80	0.1250000
NODE_83819_length_389_cov_1.937931	153	233	26	38	80	0.4750000
NODE_83819_length_389_cov_1.937931	153	233	28	7	80	0.0875000
NODE_83819_length_389_cov_1.937931	153	233	30	6	80	0.0750000
NODE_83819_length_389_cov_1.937931	153	233	32	5	80	0.0625000
NODE_83829_length_389_cov_1.920690	296	365	0	56	69	0.8115942
NODE_83829_length_389_cov_1.920690	296	365	2	13	69	0.1884058
NODE_84182_length_389_cov_0.720690	294	374	0	80	80	1.0000000
NODE_84267_length_388_cov_9.179931	47	127	0	80	80	1.0000000
NODE_84267_length_388_cov_9.179931	100	180	0	80	80	1.0000000
NODE_84270_length_388_cov_7.249135	171	251	0	80	80	1.0000000
NODE_84270_length_388_cov_7.249135	224	304	0	80	80	1.0000000
NODE_84305_length_388_cov_3.913495	151	231	0	50	80	0.6250000
NODE_84305_length_388_cov_3.913495	151	231	2	30	80	0.3750000
NODE_84308_length_388_cov_3.809689	233	277	0	44	44	1.0000000
NODE_84332_length_388_cov_3.103806	101	166	0	65	65	1.0000000
NODE_84332_length_388_cov_3.103806	147	227	0	80	80	1.0000000
NODE_84334_length_388_cov_3.041522	48	128	0	80	80	1.0000000
NODE_84410_length_388_cov_2.114187	82	141	0	13	59	0.2203390
NODE_84410_length_388_cov_2.114187	82	141	2	46	59	0.7796610
NODE_84410_length_388_cov_2.114187	135	194	0	59	59	1.0000000
NODE_84423_length_388_cov_2.017301	99	151	0	8	52	0.1538462
NODE_84423_length_388_cov_2.017301	99	151	2	44	52	0.8461539
NODE_84427_length_388_cov_1.989619	0	76	0	76	76	1.0000000
NODE_84427_length_388_cov_1.989619	49	114	0	65	65	1.0000000
NODE_84587_length_388_cov_1.352941	172	247	0	33	75	0.4400000
NODE_84587_length_388_cov_1.352941	172	247	2	42	75	0.5600000
NODE_84631_length_388_cov_1.228374	308	339	2	31	31	1.0000000
NODE_84885_length_387_cov_33.052083	194	274	4	80	80	1.0000000
NODE_84885_length_387_cov_33.052083	247	327	0	46	80	0.5750000
NODE_84885_length_387_cov_33.052083	247	327	4	34	80	0.4250000
NODE_84890_length_387_cov_6.871528	26	106	0	80	80	1.0000000
NODE_84890_length_387_cov_6.871528	79	159	0	80	80	1.0000000
NODE_84902_length_387_cov_5.420139	286	341	0	55	55	1.0000000
NODE_84946_length_387_cov_3.364583	287	367	0	21	80	0.2625000
NODE_84946_length_387_cov_3.364583	287	367	2	52	80	0.6500000
NODE_84946_length_387_cov_3.364583	287	367	6	7	80	0.0875000
NODE_85007_length_387_cov_2.260417	140	210	2	70	70	1.0000000
NODE_85019_length_387_cov_2.128472	220	286	0	66	66	1.0000000
NODE_85019_length_387_cov_2.128472	273	329	0	56	56	1.0000000
NODE_85032_length_387_cov_2.090278	318	352	0	34	34	1.0000000
NODE_85037_length_387_cov_2.055556	23	45	0	22	22	1.0000000
NODE_85047_length_387_cov_1.979167	259	316	0	48	57	0.8421053
NODE_85047_length_387_cov_1.979167	259	316	2	9	57	0.1578947
NODE_85047_length_387_cov_1.979167	312	369	0	57	57	1.0000000
NODE_85091_length_387_cov_1.770833	315	361	0	16	46	0.3478261
NODE_85091_length_387_cov_1.770833	315	361	4	1	46	0.0217391
NODE_85091_length_387_cov_1.770833	315	361	6	8	46	0.1739130
NODE_85091_length_387_cov_1.770833	315	361	12	3	46	0.0652174
NODE_85091_length_387_cov_1.770833	315	361	14	1	46	0.0217391
NODE_85091_length_387_cov_1.770833	315	361	18	17	46	0.3695652
NODE_85528_length_386_cov_9.979094	38	118	0	80	80	1.0000000
NODE_85528_length_386_cov_9.979094	91	174	0	31	83	0.3734940
NODE_85528_length_386_cov_9.979094	91	174	4	52	83	0.6265060
NODE_85546_length_386_cov_4.428571	197	249	0	21	52	0.4038461
NODE_85546_length_386_cov_4.428571	197	249	2	31	52	0.5961539
NODE_85570_length_386_cov_3.355401	151	231	0	80	80	1.0000000
NODE_85570_length_386_cov_3.355401	204	265	0	61	61	1.0000000
NODE_85602_length_386_cov_2.686411	293	325	0	32	32	1.0000000
NODE_85602_length_386_cov_2.686411	349	379	0	30	30	1.0000000
NODE_85629_length_386_cov_2.442509	55	135	4	57	80	0.7125000
NODE_85629_length_386_cov_2.442509	55	135	5	7	80	0.0875000
NODE_85629_length_386_cov_2.442509	55	135	6	16	80	0.2000000
NODE_85629_length_386_cov_2.442509	108	164	4	4	56	0.0714286
NODE_85629_length_386_cov_2.442509	108	164	5	36	56	0.6428571
NODE_85629_length_386_cov_2.442509	108	164	6	16	56	0.2857143
NODE_85793_length_386_cov_1.494774	79	121	3	11	42	0.2619048
NODE_85793_length_386_cov_1.494774	79	121	4	31	42	0.7380952
NODE_85793_length_386_cov_1.494774	93	156	2	30	63	0.4761905
NODE_85793_length_386_cov_1.494774	93	156	3	16	63	0.2539683
NODE_85793_length_386_cov_1.494774	93	156	4	17	63	0.2698413
NODE_85816_length_386_cov_1.421603	160	236	0	76	76	1.0000000
NODE_85845_length_386_cov_1.372822	62	142	0	68	80	0.8500000
NODE_85845_length_386_cov_1.372822	62	142	2	12	80	0.1500000
NODE_85845_length_386_cov_1.372822	115	195	0	15	80	0.1875000
NODE_85845_length_386_cov_1.372822	115	195	2	16	80	0.2000000
NODE_85845_length_386_cov_1.372822	115	195	4	6	80	0.0750000
NODE_85845_length_386_cov_1.372822	115	195	6	43	80	0.5375000
NODE_85858_length_386_cov_1.317073	124	161	8	30	37	0.8108108
NODE_85858_length_386_cov_1.317073	124	161	10	6	37	0.1621622
NODE_85858_length_386_cov_1.317073	124	161	12	1	37	0.0270270
NODE_85902_length_386_cov_1.170732	260	308	2	1	48	0.0208333
NODE_85902_length_386_cov_1.170732	260	308	4	2	48	0.0416667
NODE_85902_length_386_cov_1.170732	260	308	8	18	48	0.3750000
NODE_85902_length_386_cov_1.170732	260	308	10	20	48	0.4166667
NODE_85902_length_386_cov_1.170732	260	308	12	7	48	0.1458333
NODE_86143_length_385_cov_167.877622	103	164	191	1	61	0.0163934
NODE_86143_length_385_cov_167.877622	103	164	201	1	61	0.0163934
NODE_86143_length_385_cov_167.877622	103	164	204	1	61	0.0163934
NODE_86143_length_385_cov_167.877622	103	164	216	2	61	0.0327869
NODE_86143_length_385_cov_167.877622	103	164	218	2	61	0.0327869
NODE_86143_length_385_cov_167.877622	103	164	219	1	61	0.0163934
NODE_86143_length_385_cov_167.877622	103	164	220	2	61	0.0327869
NODE_86143_length_385_cov_167.877622	103	164	222	2	61	0.0327869
NODE_86143_length_385_cov_167.877622	103	164	223	1	61	0.0163934
NODE_86143_length_385_cov_167.877622	103	164	224	5	61	0.0819672
NODE_86143_length_385_cov_167.877622	103	164	225	1	61	0.0163934
NODE_86143_length_385_cov_167.877622	103	164	226	1	61	0.0163934
NODE_86143_length_385_cov_167.877622	103	164	227	1	61	0.0163934
NODE_86143_length_385_cov_167.877622	103	164	229	1	61	0.0163934
NODE_86143_length_385_cov_167.877622	103	164	230	3	61	0.0491803
NODE_86143_length_385_cov_167.877622	103	164	236	2	61	0.0327869
NODE_86143_length_385_cov_167.877622	103	164	237	1	61	0.0163934
NODE_86143_length_385_cov_167.877622	103	164	238	2	61	0.0327869
NODE_86143_length_385_cov_167.877622	103	164	240	1	61	0.0163934
NODE_86143_length_385_cov_167.877622	103	164	242	1	61	0.0163934
NODE_86143_length_385_cov_167.877622	103	164	243	2	61	0.0327869
NODE_86143_length_385_cov_167.877622	103	164	244	5	61	0.0819672
NODE_86143_length_385_cov_167.877622	103	164	245	2	61	0.0327869
NODE_86143_length_385_cov_167.877622	103	164	246	5	61	0.0819672
NODE_86143_length_385_cov_167.877622	103	164	247	1	61	0.0163934
NODE_86143_length_385_cov_167.877622	103	164	248	5	61	0.0819672
NODE_86143_length_385_cov_167.877622	103	164	252	8	61	0.1311475
NODE_86143_length_385_cov_167.877622	103	164	254	1	61	0.0163934
NODE_86144_length_385_cov_38.695804	164	244	0	80	80	1.0000000
NODE_86144_length_385_cov_38.695804	217	297	0	80	80	1.0000000
NODE_86169_length_385_cov_4.335664	173	250	0	74	77	0.9610389
NODE_86169_length_385_cov_4.335664	173	250	2	3	77	0.0389610
NODE_86185_length_385_cov_3.793706	215	297	0	18	82	0.2195122
NODE_86185_length_385_cov_3.793706	215	297	1	34	82	0.4146341
NODE_86185_length_385_cov_3.793706	215	297	2	24	82	0.2926829
NODE_86185_length_385_cov_3.793706	215	297	4	6	82	0.0731707
NODE_86230_length_385_cov_2.786713	99	179	2	1	80	0.0125000
NODE_86230_length_385_cov_2.786713	99	179	4	75	80	0.9375000
NODE_86230_length_385_cov_2.786713	99	179	6	4	80	0.0500000
NODE_86230_length_385_cov_2.786713	152	232	0	2	80	0.0250000
NODE_86230_length_385_cov_2.786713	152	232	2	25	80	0.3125000
NODE_86230_length_385_cov_2.786713	152	232	4	53	80	0.6625000
NODE_86230_length_385_cov_2.786713	281	362	0	81	81	1.0000000
NODE_86448_length_385_cov_1.381119	71	145	0	19	74	0.2567568
NODE_86448_length_385_cov_1.381119	71	145	2	20	74	0.2702703
NODE_86448_length_385_cov_1.381119	71	145	4	4	74	0.0540541
NODE_86448_length_385_cov_1.381119	71	145	6	7	74	0.0945946
NODE_86448_length_385_cov_1.381119	71	145	8	13	74	0.1756757
NODE_86448_length_385_cov_1.381119	71	145	10	2	74	0.0270270
NODE_86448_length_385_cov_1.381119	71	145	12	2	74	0.0270270
NODE_86448_length_385_cov_1.381119	71	145	14	7	74	0.0945946
NODE_86448_length_385_cov_1.381119	118	198	6	3	80	0.0375000
NODE_86448_length_385_cov_1.381119	118	198	8	13	80	0.1625000
NODE_86448_length_385_cov_1.381119	118	198	10	2	80	0.0250000
NODE_86448_length_385_cov_1.381119	118	198	12	2	80	0.0250000
NODE_86448_length_385_cov_1.381119	118	198	13	14	80	0.1750000
NODE_86448_length_385_cov_1.381119	118	198	14	19	80	0.2375000
NODE_86448_length_385_cov_1.381119	118	198	15	3	80	0.0375000
NODE_86448_length_385_cov_1.381119	118	198	16	1	80	0.0125000
NODE_86448_length_385_cov_1.381119	118	198	17	17	80	0.2125000
NODE_86448_length_385_cov_1.381119	118	198	19	6	80	0.0750000
NODE_86798_length_384_cov_3.996491	135	217	4	9	82	0.1097561
NODE_86798_length_384_cov_3.996491	135	217	6	3	82	0.0365854
NODE_86798_length_384_cov_3.996491	135	217	8	47	82	0.5731707
NODE_86798_length_384_cov_3.996491	135	217	10	23	82	0.2804878
NODE_86809_length_384_cov_3.729825	181	228	0	47	47	1.0000000
NODE_86812_length_384_cov_3.715789	145	221	0	4	76	0.0526316
NODE_86812_length_384_cov_3.715789	145	221	2	58	76	0.7631579
NODE_86812_length_384_cov_3.715789	145	221	4	5	76	0.0657895
NODE_86812_length_384_cov_3.715789	145	221	6	1	76	0.0131579
NODE_86812_length_384_cov_3.715789	145	221	8	1	76	0.0131579
NODE_86812_length_384_cov_3.715789	145	221	10	1	76	0.0131579
NODE_86812_length_384_cov_3.715789	145	221	14	6	76	0.0789474
NODE_86841_length_384_cov_2.996491	147	227	4	3	80	0.0375000
NODE_86841_length_384_cov_2.996491	147	227	6	2	80	0.0250000
NODE_86841_length_384_cov_2.996491	147	227	8	1	80	0.0125000
NODE_86841_length_384_cov_2.996491	147	227	10	16	80	0.2000000
NODE_86841_length_384_cov_2.996491	147	227	12	10	80	0.1250000
NODE_86841_length_384_cov_2.996491	147	227	14	11	80	0.1375000
NODE_86841_length_384_cov_2.996491	147	227	16	23	80	0.2875000
NODE_86841_length_384_cov_2.996491	147	227	18	14	80	0.1750000
NODE_86847_length_384_cov_2.835088	65	145	2	7	80	0.0875000
NODE_86847_length_384_cov_2.835088	65	145	4	8	80	0.1000000
NODE_86847_length_384_cov_2.835088	65	145	8	9	80	0.1125000
NODE_86847_length_384_cov_2.835088	65	145	10	1	80	0.0125000
NODE_86847_length_384_cov_2.835088	65	145	12	5	80	0.0625000
NODE_86847_length_384_cov_2.835088	65	145	14	19	80	0.2375000
NODE_86847_length_384_cov_2.835088	65	145	16	31	80	0.3875000
NODE_86866_length_384_cov_2.575439	151	224	8	10	73	0.1369863
NODE_86866_length_384_cov_2.575439	151	224	10	3	73	0.0410959
NODE_86866_length_384_cov_2.575439	151	224	12	6	73	0.0821918
NODE_86866_length_384_cov_2.575439	151	224	14	53	73	0.7260274
NODE_86866_length_384_cov_2.575439	151	224	16	1	73	0.0136986
NODE_86866_length_384_cov_2.575439	197	281	2	49	84	0.5833333
NODE_86866_length_384_cov_2.575439	197	281	4	7	84	0.0833333
NODE_86866_length_384_cov_2.575439	197	281	8	11	84	0.1309524
NODE_86866_length_384_cov_2.575439	197	281	10	3	84	0.0357143
NODE_86866_length_384_cov_2.575439	197	281	12	2	84	0.0238095
NODE_86866_length_384_cov_2.575439	197	281	14	11	84	0.1309524
NODE_86866_length_384_cov_2.575439	197	281	16	1	84	0.0119048
NODE_86907_length_384_cov_2.231579	78	153	0	75	75	1.0000000
NODE_86942_length_384_cov_1.940351	73	153	0	80	80	1.0000000
NODE_87431_length_383_cov_4.869718	117	197	0	57	80	0.7125000
NODE_87431_length_383_cov_4.869718	117	197	2	23	80	0.2875000
NODE_87431_length_383_cov_4.869718	170	250	0	4	80	0.0500000
NODE_87431_length_383_cov_4.869718	170	250	2	76	80	0.9500000
NODE_87432_length_383_cov_4.841549	121	180	0	59	59	1.0000000
NODE_87438_length_383_cov_4.559859	33	109	0	76	76	1.0000000
NODE_87487_length_383_cov_2.940141	185	265	0	33	80	0.4125000
NODE_87487_length_383_cov_2.940141	185	265	2	22	80	0.2750000
NODE_87487_length_383_cov_2.940141	185	265	3	1	80	0.0125000
NODE_87487_length_383_cov_2.940141	185	265	4	24	80	0.3000000
NODE_87495_length_383_cov_2.760563	123	203	151	1	80	0.0125000
NODE_87495_length_383_cov_2.760563	123	203	153	1	80	0.0125000
NODE_87495_length_383_cov_2.760563	123	203	157	1	80	0.0125000
NODE_87495_length_383_cov_2.760563	123	203	161	1	80	0.0125000
NODE_87495_length_383_cov_2.760563	123	203	162	1	80	0.0125000
NODE_87495_length_383_cov_2.760563	123	203	166	2	80	0.0250000
NODE_87495_length_383_cov_2.760563	123	203	170	1	80	0.0125000
NODE_87495_length_383_cov_2.760563	123	203	171	6	80	0.0750000
NODE_87495_length_383_cov_2.760563	123	203	175	1	80	0.0125000
NODE_87495_length_383_cov_2.760563	123	203	179	2	80	0.0250000
NODE_87495_length_383_cov_2.760563	123	203	181	1	80	0.0125000
NODE_87495_length_383_cov_2.760563	123	203	183	1	80	0.0125000
NODE_87495_length_383_cov_2.760563	123	203	185	1	80	0.0125000
NODE_87495_length_383_cov_2.760563	123	203	187	1	80	0.0125000
NODE_87495_length_383_cov_2.760563	123	203	198	1	80	0.0125000
NODE_87495_length_383_cov_2.760563	123	203	199	1	80	0.0125000
NODE_87495_length_383_cov_2.760563	123	203	203	1	80	0.0125000
NODE_87495_length_383_cov_2.760563	123	203	206	1	80	0.0125000
NODE_87495_length_383_cov_2.760563	123	203	214	1	80	0.0125000
NODE_87495_length_383_cov_2.760563	123	203	215	1	80	0.0125000
NODE_87495_length_383_cov_2.760563	123	203	216	1	80	0.0125000
NODE_87495_length_383_cov_2.760563	123	203	217	1	80	0.0125000
NODE_87495_length_383_cov_2.760563	123	203	218	2	80	0.0250000
NODE_87495_length_383_cov_2.760563	123	203	220	2	80	0.0250000
NODE_87495_length_383_cov_2.760563	123	203	223	1	80	0.0125000
NODE_87495_length_383_cov_2.760563	123	203	224	2	80	0.0250000
NODE_87495_length_383_cov_2.760563	123	203	228	2	80	0.0250000
NODE_87495_length_383_cov_2.760563	123	203	230	3	80	0.0375000
NODE_87495_length_383_cov_2.760563	123	203	232	1	80	0.0125000
NODE_87495_length_383_cov_2.760563	123	203	235	3	80	0.0375000
NODE_87495_length_383_cov_2.760563	123	203	237	4	80	0.0500000
NODE_87495_length_383_cov_2.760563	123	203	238	1	80	0.0125000
NODE_87495_length_383_cov_2.760563	123	203	239	1	80	0.0125000
NODE_87495_length_383_cov_2.760563	123	203	240	3	80	0.0375000
NODE_87495_length_383_cov_2.760563	123	203	241	1	80	0.0125000
NODE_87495_length_383_cov_2.760563	123	203	242	1	80	0.0125000
NODE_87495_length_383_cov_2.760563	123	203	243	2	80	0.0250000
NODE_87495_length_383_cov_2.760563	123	203	245	2	80	0.0250000
NODE_87495_length_383_cov_2.760563	123	203	246	3	80	0.0375000
NODE_87495_length_383_cov_2.760563	123	203	247	3	80	0.0375000
NODE_87495_length_383_cov_2.760563	123	203	248	4	80	0.0500000
NODE_87495_length_383_cov_2.760563	123	203	249	3	80	0.0375000
NODE_87495_length_383_cov_2.760563	123	203	250	2	80	0.0250000
NODE_87495_length_383_cov_2.760563	123	203	252	3	80	0.0375000
NODE_87495_length_383_cov_2.760563	123	203	255	2	80	0.0250000
NODE_87495_length_383_cov_2.760563	169	249	61	1	80	0.0125000
NODE_87495_length_383_cov_2.760563	169	249	63	2	80	0.0250000
NODE_87495_length_383_cov_2.760563	169	249	73	1	80	0.0125000
NODE_87495_length_383_cov_2.760563	169	249	83	1	80	0.0125000
NODE_87495_length_383_cov_2.760563	169	249	85	1	80	0.0125000
NODE_87495_length_383_cov_2.760563	169	249	89	3	80	0.0375000
NODE_87495_length_383_cov_2.760563	169	249	91	1	80	0.0125000
NODE_87495_length_383_cov_2.760563	169	249	95	1	80	0.0125000
NODE_87495_length_383_cov_2.760563	169	249	97	2	80	0.0250000
NODE_87495_length_383_cov_2.760563	169	249	98	1	80	0.0125000
NODE_87495_length_383_cov_2.760563	169	249	106	4	80	0.0500000
NODE_87495_length_383_cov_2.760563	169	249	111	1	80	0.0125000
NODE_87495_length_383_cov_2.760563	169	249	114	2	80	0.0250000
NODE_87495_length_383_cov_2.760563	169	249	116	3	80	0.0375000
NODE_87495_length_383_cov_2.760563	169	249	118	9	80	0.1125000
NODE_87495_length_383_cov_2.760563	169	249	122	4	80	0.0500000
NODE_87495_length_383_cov_2.760563	169	249	124	1	80	0.0125000
NODE_87495_length_383_cov_2.760563	169	249	126	2	80	0.0250000
NODE_87495_length_383_cov_2.760563	169	249	128	3	80	0.0375000
NODE_87495_length_383_cov_2.760563	169	249	132	1	80	0.0125000
NODE_87495_length_383_cov_2.760563	169	249	147	2	80	0.0250000
NODE_87495_length_383_cov_2.760563	169	249	151	1	80	0.0125000
NODE_87495_length_383_cov_2.760563	169	249	153	1	80	0.0125000
NODE_87495_length_383_cov_2.760563	169	249	157	1	80	0.0125000
NODE_87495_length_383_cov_2.760563	169	249	161	1	80	0.0125000
NODE_87495_length_383_cov_2.760563	169	249	162	1	80	0.0125000
NODE_87495_length_383_cov_2.760563	169	249	166	2	80	0.0250000
NODE_87495_length_383_cov_2.760563	169	249	170	1	80	0.0125000
NODE_87495_length_383_cov_2.760563	169	249	171	6	80	0.0750000
NODE_87495_length_383_cov_2.760563	169	249	175	1	80	0.0125000
NODE_87495_length_383_cov_2.760563	169	249	179	2	80	0.0250000
NODE_87495_length_383_cov_2.760563	169	249	181	1	80	0.0125000
NODE_87495_length_383_cov_2.760563	169	249	183	1	80	0.0125000
NODE_87495_length_383_cov_2.760563	169	249	185	1	80	0.0125000
NODE_87495_length_383_cov_2.760563	169	249	187	1	80	0.0125000
NODE_87495_length_383_cov_2.760563	169	249	198	1	80	0.0125000
NODE_87495_length_383_cov_2.760563	169	249	199	1	80	0.0125000
NODE_87495_length_383_cov_2.760563	169	249	203	1	80	0.0125000
NODE_87495_length_383_cov_2.760563	169	249	206	1	80	0.0125000
NODE_87495_length_383_cov_2.760563	169	249	214	1	80	0.0125000
NODE_87495_length_383_cov_2.760563	169	249	218	1	80	0.0125000
NODE_87495_length_383_cov_2.760563	169	249	220	1	80	0.0125000
NODE_87495_length_383_cov_2.760563	169	249	224	2	80	0.0250000
NODE_87495_length_383_cov_2.760563	169	249	228	1	80	0.0125000
NODE_87495_length_383_cov_2.760563	169	249	230	1	80	0.0125000
NODE_87495_length_383_cov_2.760563	169	249	232	1	80	0.0125000
NODE_87495_length_383_cov_2.760563	169	249	240	1	80	0.0125000
NODE_87495_length_383_cov_2.760563	222	302	0	2	80	0.0250000
NODE_87495_length_383_cov_2.760563	222	302	1	21	80	0.2625000
NODE_87495_length_383_cov_2.760563	222	302	5	6	80	0.0750000
NODE_87495_length_383_cov_2.760563	222	302	7	1	80	0.0125000
NODE_87495_length_383_cov_2.760563	222	302	9	3	80	0.0375000
NODE_87495_length_383_cov_2.760563	222	302	15	7	80	0.0875000
NODE_87495_length_383_cov_2.760563	222	302	41	1	80	0.0125000
NODE_87495_length_383_cov_2.760563	222	302	43	2	80	0.0250000
NODE_87495_length_383_cov_2.760563	222	302	44	1	80	0.0125000
NODE_87495_length_383_cov_2.760563	222	302	45	1	80	0.0125000
NODE_87495_length_383_cov_2.760563	222	302	53	3	80	0.0375000
NODE_87495_length_383_cov_2.760563	222	302	55	2	80	0.0250000
NODE_87495_length_383_cov_2.760563	222	302	57	1	80	0.0125000
NODE_87495_length_383_cov_2.760563	222	302	59	2	80	0.0250000
NODE_87495_length_383_cov_2.760563	222	302	61	1	80	0.0125000
NODE_87495_length_383_cov_2.760563	222	302	63	2	80	0.0250000
NODE_87495_length_383_cov_2.760563	222	302	73	1	80	0.0125000
NODE_87495_length_383_cov_2.760563	222	302	83	1	80	0.0125000
NODE_87495_length_383_cov_2.760563	222	302	85	1	80	0.0125000
NODE_87495_length_383_cov_2.760563	222	302	89	3	80	0.0375000
NODE_87495_length_383_cov_2.760563	222	302	91	1	80	0.0125000
NODE_87495_length_383_cov_2.760563	222	302	95	1	80	0.0125000
NODE_87495_length_383_cov_2.760563	222	302	97	2	80	0.0250000
NODE_87495_length_383_cov_2.760563	222	302	98	1	80	0.0125000
NODE_87495_length_383_cov_2.760563	222	302	106	4	80	0.0500000
NODE_87495_length_383_cov_2.760563	222	302	111	1	80	0.0125000
NODE_87495_length_383_cov_2.760563	222	302	114	2	80	0.0250000
NODE_87495_length_383_cov_2.760563	222	302	116	3	80	0.0375000
NODE_87495_length_383_cov_2.760563	222	302	118	3	80	0.0375000
NODE_87566_length_383_cov_2.123239	29	94	2	65	65	1.0000000
NODE_87566_length_383_cov_2.123239	93	173	0	79	80	0.9875000
NODE_87566_length_383_cov_2.123239	93	173	2	1	80	0.0125000
NODE_87566_length_383_cov_2.123239	146	193	0	47	47	1.0000000
NODE_87634_length_383_cov_1.728873	196	257	18	5	61	0.0819672
NODE_87634_length_383_cov_1.728873	196	257	24	1	61	0.0163934
NODE_87634_length_383_cov_1.728873	196	257	30	1	61	0.0163934
NODE_87634_length_383_cov_1.728873	196	257	32	1	61	0.0163934
NODE_87634_length_383_cov_1.728873	196	257	36	3	61	0.0491803
NODE_87634_length_383_cov_1.728873	196	257	38	50	61	0.8196721
NODE_87634_length_383_cov_1.728873	239	310	10	16	71	0.2253521
NODE_87634_length_383_cov_1.728873	239	310	12	9	71	0.1267606
NODE_87634_length_383_cov_1.728873	239	310	14	3	71	0.0422535
NODE_87634_length_383_cov_1.728873	239	310	16	1	71	0.0140845
NODE_87634_length_383_cov_1.728873	239	310	20	9	71	0.1267606
NODE_87634_length_383_cov_1.728873	239	310	24	1	71	0.0140845
NODE_87634_length_383_cov_1.728873	239	310	28	1	71	0.0140845
NODE_87634_length_383_cov_1.728873	239	310	30	3	71	0.0422535
NODE_87634_length_383_cov_1.728873	239	310	32	1	71	0.0140845
NODE_87634_length_383_cov_1.728873	239	310	38	27	71	0.3802817
NODE_88039_length_382_cov_43.724382	245	325	0	80	80	1.0000000
NODE_88039_length_382_cov_43.724382	298	378	0	80	80	1.0000000
NODE_88040_length_382_cov_35.908127	163	243	0	80	80	1.0000000
NODE_88040_length_382_cov_35.908127	216	296	0	80	80	1.0000000
NODE_88040_length_382_cov_35.908127	292	372	0	80	80	1.0000000
NODE_88041_length_382_cov_26.240283	57	137	0	71	80	0.8875000
NODE_88041_length_382_cov_26.240283	57	137	4	9	80	0.1125000
NODE_88041_length_382_cov_26.240283	110	190	0	18	80	0.2250000
NODE_88041_length_382_cov_26.240283	110	190	4	62	80	0.7750000
NODE_88054_length_382_cov_5.583039	63	143	0	80	80	1.0000000
NODE_88054_length_382_cov_5.583039	116	196	0	80	80	1.0000000
NODE_88063_length_382_cov_4.837456	19	78	0	59	59	1.0000000
NODE_88067_length_382_cov_4.618375	0	55	0	55	55	1.0000000
NODE_88067_length_382_cov_4.618375	104	184	13	2	80	0.0250000
NODE_88067_length_382_cov_4.618375	104	184	14	39	80	0.4875000
NODE_88067_length_382_cov_4.618375	104	184	16	28	80	0.3500000
NODE_88067_length_382_cov_4.618375	104	184	17	6	80	0.0750000
NODE_88067_length_382_cov_4.618375	104	184	18	5	80	0.0625000
NODE_88067_length_382_cov_4.618375	157	237	10	16	80	0.2000000
NODE_88067_length_382_cov_4.618375	157	237	11	1	80	0.0125000
NODE_88067_length_382_cov_4.618375	157	237	12	15	80	0.1875000
NODE_88067_length_382_cov_4.618375	157	237	14	3	80	0.0375000
NODE_88067_length_382_cov_4.618375	157	237	16	13	80	0.1625000
NODE_88067_length_382_cov_4.618375	157	237	17	6	80	0.0750000
NODE_88067_length_382_cov_4.618375	157	237	18	14	80	0.1750000
NODE_88067_length_382_cov_4.618375	157	237	22	12	80	0.1500000
NODE_88075_length_382_cov_4.268551	71	152	0	81	81	1.0000000
NODE_88075_length_382_cov_4.268551	124	205	0	81	81	1.0000000
NODE_88080_length_382_cov_4.091873	30	92	0	62	62	1.0000000
NODE_88121_length_382_cov_3.031802	173	253	0	17	80	0.2125000
NODE_88121_length_382_cov_3.031802	173	253	6	35	80	0.4375000
NODE_88121_length_382_cov_3.031802	173	253	8	28	80	0.3500000
NODE_88121_length_382_cov_3.031802	226	295	8	69	69	1.0000000
NODE_88135_length_382_cov_2.798587	231	293	0	62	62	1.0000000
NODE_88136_length_382_cov_2.791519	195	244	4	49	49	1.0000000
NODE_88136_length_382_cov_2.791519	217	297	0	18	80	0.2250000
NODE_88136_length_382_cov_2.791519	217	297	4	62	80	0.7750000
NODE_88164_length_382_cov_2.611307	301	368	0	67	67	1.0000000
NODE_88276_length_382_cov_1.802120	0	60	0	21	60	0.3500000
NODE_88276_length_382_cov_1.802120	0	60	4	39	60	0.6500000
NODE_88660_length_382_cov_0.738516	48	95	12	1	47	0.0212766
NODE_88660_length_382_cov_0.738516	48	95	16	7	47	0.1489362
NODE_88660_length_382_cov_0.738516	48	95	19	18	47	0.3829787
NODE_88660_length_382_cov_0.738516	48	95	22	21	47	0.4468085
NODE_88660_length_382_cov_0.738516	68	148	19	6	80	0.0750000
NODE_88660_length_382_cov_0.738516	68	148	21	17	80	0.2125000
NODE_88660_length_382_cov_0.738516	68	148	22	57	80	0.7125000
NODE_88758_length_381_cov_12.010638	195	274	0	3	79	0.0379747
NODE_88758_length_381_cov_12.010638	195	274	2	9	79	0.1139240
NODE_88758_length_381_cov_12.010638	195	274	4	2	79	0.0253165
NODE_88758_length_381_cov_12.010638	195	274	6	4	79	0.0506329
NODE_88758_length_381_cov_12.010638	195	274	8	2	79	0.0253165
NODE_88758_length_381_cov_12.010638	195	274	12	59	79	0.7468355
NODE_88865_length_381_cov_2.606383	68	98	0	30	30	1.0000000
NODE_88867_length_381_cov_2.570922	115	175	0	59	60	0.9833333
NODE_88867_length_381_cov_2.570922	115	175	2	1	60	0.0166667
NODE_88872_length_381_cov_2.514184	225	307	0	14	82	0.1707317
NODE_88872_length_381_cov_2.514184	225	307	2	6	82	0.0731707
NODE_88872_length_381_cov_2.514184	225	307	4	41	82	0.5000000
NODE_88872_length_381_cov_2.514184	225	307	6	21	82	0.2560976
NODE_88900_length_381_cov_2.198582	193	276	0	2	83	0.0240964
NODE_88900_length_381_cov_2.198582	193	276	2	6	83	0.0722892
NODE_88900_length_381_cov_2.198582	193	276	4	32	83	0.3855422
NODE_88900_length_381_cov_2.198582	193	276	6	5	83	0.0602410
NODE_88900_length_381_cov_2.198582	193	276	8	18	83	0.2168675
NODE_88900_length_381_cov_2.198582	193	276	10	20	83	0.2409639
NODE_88935_length_381_cov_1.989362	279	325	0	46	46	1.0000000
NODE_89009_length_381_cov_1.663121	51	128	6	53	77	0.6883117
NODE_89009_length_381_cov_1.663121	51	128	8	8	77	0.1038961
NODE_89009_length_381_cov_1.663121	51	128	10	16	77	0.2077922
NODE_89009_length_381_cov_1.663121	101	181	4	15	80	0.1875000
NODE_89009_length_381_cov_1.663121	101	181	6	18	80	0.2250000
NODE_89009_length_381_cov_1.663121	101	181	8	31	80	0.3875000
NODE_89009_length_381_cov_1.663121	101	181	10	16	80	0.2000000
NODE_89090_length_381_cov_1.400709	254	334	0	12	80	0.1500000
NODE_89090_length_381_cov_1.400709	254	334	2	68	80	0.8500000
NODE_89090_length_381_cov_1.400709	254	334	0	12	80	0.1500000
NODE_89090_length_381_cov_1.400709	254	334	2	68	80	0.8500000
NODE_89090_length_381_cov_1.400709	309	373	0	42	64	0.6562500
NODE_89090_length_381_cov_1.400709	309	373	2	22	64	0.3437500
NODE_89482_length_380_cov_57.604982	196	276	4	11	80	0.1375000
NODE_89482_length_380_cov_57.604982	196	276	10	50	80	0.6250000
NODE_89482_length_380_cov_57.604982	196	276	11	1	80	0.0125000
NODE_89482_length_380_cov_57.604982	196	276	12	18	80	0.2250000
NODE_89482_length_380_cov_57.604982	249	329	2	44	80	0.5500000
NODE_89482_length_380_cov_57.604982	249	329	4	20	80	0.2500000
NODE_89482_length_380_cov_57.604982	249	329	11	1	80	0.0125000
NODE_89482_length_380_cov_57.604982	249	329	12	15	80	0.1875000
NODE_89482_length_380_cov_57.604982	325	359	0	15	34	0.4411765
NODE_89482_length_380_cov_57.604982	325	359	2	19	34	0.5588235
NODE_89483_length_380_cov_11.185053	79	161	1	13	82	0.1585366
NODE_89483_length_380_cov_11.185053	79	161	2	69	82	0.8414634
NODE_89483_length_380_cov_11.185053	134	214	0	40	80	0.5000000
NODE_89483_length_380_cov_11.185053	134	214	1	26	80	0.3250000
NODE_89483_length_380_cov_11.185053	134	214	2	14	80	0.1750000
NODE_89491_length_380_cov_5.811388	100	156	2	56	56	1.0000000
NODE_89491_length_380_cov_5.811388	177	213	0	29	36	0.8055556
NODE_89491_length_380_cov_5.811388	177	213	2	7	36	0.1944444
NODE_89495_length_380_cov_5.377224	242	271	48	3	29	0.1034483
NODE_89495_length_380_cov_5.377224	242	271	50	7	29	0.2413793
NODE_89495_length_380_cov_5.377224	242	271	52	7	29	0.2413793
NODE_89495_length_380_cov_5.377224	242	271	54	12	29	0.4137931
NODE_89508_length_380_cov_4.185053	158	230	0	9	72	0.1250000
NODE_89508_length_380_cov_4.185053	158	230	6	63	72	0.8750000
NODE_89508_length_380_cov_4.185053	159	229	0	8	70	0.1142857
NODE_89508_length_380_cov_4.185053	159	229	6	62	70	0.8857143
NODE_89508_length_380_cov_4.185053	203	283	0	13	80	0.1625000
NODE_89508_length_380_cov_4.185053	203	283	4	7	80	0.0875000
NODE_89508_length_380_cov_4.185053	203	283	6	60	80	0.7500000
NODE_89508_length_380_cov_4.185053	203	283	0	13	80	0.1625000
NODE_89508_length_380_cov_4.185053	203	283	4	7	80	0.0875000
NODE_89508_length_380_cov_4.185053	203	283	6	60	80	0.7500000
NODE_89527_length_380_cov_3.423488	164	233	9	8	69	0.1159420
NODE_89527_length_380_cov_3.423488	164	233	10	15	69	0.2173913
NODE_89527_length_380_cov_3.423488	164	233	12	36	69	0.5217391
NODE_89527_length_380_cov_3.423488	164	233	14	10	69	0.1449275
NODE_89540_length_380_cov_3.153025	188	260	6	22	72	0.3055556
NODE_89540_length_380_cov_3.153025	188	260	8	1	72	0.0138889
NODE_89540_length_380_cov_3.153025	188	260	10	15	72	0.2083333
NODE_89540_length_380_cov_3.153025	188	260	12	34	72	0.4722222
NODE_89568_length_380_cov_2.718861	51	131	0	1	80	0.0125000
NODE_89568_length_380_cov_2.718861	51	131	2	45	80	0.5625000
NODE_89568_length_380_cov_2.718861	51	131	4	34	80	0.4250000
NODE_89568_length_380_cov_2.718861	104	184	0	7	80	0.0875000
NODE_89568_length_380_cov_2.718861	104	184	2	73	80	0.9125000
NODE_89658_length_380_cov_1.943060	22	56	2	5	34	0.1470588
NODE_89658_length_380_cov_1.943060	22	56	4	29	34	0.8529412
NODE_89750_length_380_cov_1.601423	292	332	51	2	40	0.0500000
NODE_89750_length_380_cov_1.601423	292	332	53	1	40	0.0250000
NODE_89750_length_380_cov_1.601423	292	332	55	2	40	0.0500000
NODE_89750_length_380_cov_1.601423	292	332	58	1	40	0.0250000
NODE_89750_length_380_cov_1.601423	292	332	59	4	40	0.1000000
NODE_89750_length_380_cov_1.601423	292	332	63	5	40	0.1250000
NODE_89750_length_380_cov_1.601423	292	332	65	2	40	0.0500000
NODE_89750_length_380_cov_1.601423	292	332	67	4	40	0.1000000
NODE_89750_length_380_cov_1.601423	292	332	71	1	40	0.0250000
NODE_89750_length_380_cov_1.601423	292	332	72	1	40	0.0250000
NODE_89750_length_380_cov_1.601423	292	332	75	1	40	0.0250000
NODE_89750_length_380_cov_1.601423	292	332	76	1	40	0.0250000
NODE_89750_length_380_cov_1.601423	292	332	78	1	40	0.0250000
NODE_89750_length_380_cov_1.601423	292	332	82	2	40	0.0500000
NODE_89750_length_380_cov_1.601423	292	332	84	2	40	0.0500000
NODE_89750_length_380_cov_1.601423	292	332	85	1	40	0.0250000
NODE_89750_length_380_cov_1.601423	292	332	87	2	40	0.0500000
NODE_89750_length_380_cov_1.601423	292	332	91	1	40	0.0250000
NODE_89750_length_380_cov_1.601423	292	332	92	4	40	0.1000000
NODE_89750_length_380_cov_1.601423	292	332	95	2	40	0.0500000
NODE_89911_length_380_cov_1.088968	312	353	0	41	41	1.0000000
NODE_89911_length_380_cov_1.088968	326	380	0	54	54	1.0000000
NODE_90152_length_379_cov_42.339286	10	90	0	80	80	1.0000000
NODE_90152_length_379_cov_42.339286	86	166	0	15	80	0.1875000
NODE_90152_length_379_cov_42.339286	86	166	2	15	80	0.1875000
NODE_90152_length_379_cov_42.339286	86	166	4	50	80	0.6250000
NODE_90152_length_379_cov_42.339286	139	219	2	30	80	0.3750000
NODE_90152_length_379_cov_42.339286	139	219	4	50	80	0.6250000
NODE_90153_length_379_cov_32.075000	0	62	0	62	62	1.0000000
NODE_90165_length_379_cov_5.607143	279	338	0	59	59	1.0000000
NODE_90180_length_379_cov_4.432143	219	243	2	24	24	1.0000000
NODE_90193_length_379_cov_3.778571	271	300	0	29	29	1.0000000
NODE_90198_length_379_cov_3.585714	128	152	0	24	24	1.0000000
NODE_90198_length_379_cov_3.585714	169	249	0	80	80	1.0000000
NODE_90203_length_379_cov_3.375000	19	43	0	24	24	1.0000000
NODE_90247_length_379_cov_2.692857	121	201	1	80	80	1.0000000
NODE_90247_length_379_cov_2.692857	174	221	1	47	47	1.0000000
NODE_90789_length_378_cov_53.039427	147	227	0	80	80	1.0000000
NODE_90789_length_378_cov_53.039427	200	280	0	80	80	1.0000000
NODE_90789_length_378_cov_53.039427	276	356	0	80	80	1.0000000
NODE_90789_length_378_cov_53.039427	329	378	0	49	49	1.0000000
NODE_90794_length_378_cov_6.569892	223	304	8	44	81	0.5432099
NODE_90794_length_378_cov_6.569892	223	304	10	37	81	0.4567901
NODE_90795_length_378_cov_6.444444	217	297	0	80	80	1.0000000
NODE_90795_length_378_cov_6.444444	270	350	0	80	80	1.0000000
NODE_90808_length_378_cov_4.899642	135	191	10	4	56	0.0714286
NODE_90808_length_378_cov_4.899642	135	191	12	14	56	0.2500000
NODE_90808_length_378_cov_4.899642	135	191	14	31	56	0.5535714
NODE_90808_length_378_cov_4.899642	135	191	16	7	56	0.1250000
NODE_90855_length_378_cov_3.236559	143	212	14	1	69	0.0144928
NODE_90855_length_378_cov_3.236559	143	212	18	3	69	0.0434783
NODE_90855_length_378_cov_3.236559	143	212	22	65	69	0.9420290
NODE_90859_length_378_cov_3.132616	238	280	0	42	42	1.0000000
NODE_90898_length_378_cov_2.534050	203	243	0	22	40	0.5500000
NODE_90898_length_378_cov_2.534050	203	243	2	18	40	0.4500000
NODE_90898_length_378_cov_2.534050	271	347	0	47	76	0.6184211
NODE_90898_length_378_cov_2.534050	271	347	2	29	76	0.3815790
NODE_90898_length_378_cov_2.534050	331	360	2	29	29	1.0000000
NODE_90948_length_378_cov_2.093190	179	250	0	71	71	1.0000000
NODE_90948_length_378_cov_2.093190	183	219	0	36	36	1.0000000
NODE_91002_length_378_cov_1.813620	36	89	0	53	53	1.0000000
NODE_91475_length_377_cov_71.723022	19	99	16	80	80	1.0000000
NODE_91475_length_377_cov_71.723022	72	152	0	38	80	0.4750000
NODE_91475_length_377_cov_71.723022	72	152	4	5	80	0.0625000
NODE_91475_length_377_cov_71.723022	72	152	16	37	80	0.4625000
NODE_91475_length_377_cov_71.723022	148	228	0	36	80	0.4500000
NODE_91475_length_377_cov_71.723022	148	228	6	18	80	0.2250000
NODE_91475_length_377_cov_71.723022	148	228	8	17	80	0.2125000
NODE_91475_length_377_cov_71.723022	148	228	10	9	80	0.1125000
NODE_91475_length_377_cov_71.723022	201	281	6	1	80	0.0125000
NODE_91475_length_377_cov_71.723022	201	281	8	17	80	0.2125000
NODE_91475_length_377_cov_71.723022	201	281	10	13	80	0.1625000
NODE_91475_length_377_cov_71.723022	201	281	12	7	80	0.0875000
NODE_91475_length_377_cov_71.723022	201	281	14	11	80	0.1375000
NODE_91475_length_377_cov_71.723022	201	281	16	31	80	0.3875000
NODE_91477_length_377_cov_41.787770	210	290	0	13	80	0.1625000
NODE_91477_length_377_cov_41.787770	210	290	2	24	80	0.3000000
NODE_91477_length_377_cov_41.787770	210	290	4	43	80	0.5375000
NODE_91477_length_377_cov_41.787770	263	343	0	23	80	0.2875000
NODE_91477_length_377_cov_41.787770	263	343	2	42	80	0.5250000
NODE_91477_length_377_cov_41.787770	263	343	4	15	80	0.1875000
NODE_91478_length_377_cov_9.982014	32	83	0	18	51	0.3529412
NODE_91478_length_377_cov_9.982014	32	83	2	33	51	0.6470588
NODE_91486_length_377_cov_6.244604	101	177	0	19	76	0.2500000
NODE_91486_length_377_cov_6.244604	101	177	2	57	76	0.7500000
NODE_91494_length_377_cov_5.183453	169	224	0	55	55	1.0000000
NODE_91499_length_377_cov_4.586331	186	266	0	80	80	1.0000000
NODE_91499_length_377_cov_4.586331	239	319	0	80	80	1.0000000
NODE_91500_length_377_cov_4.431655	139	216	0	77	77	1.0000000
NODE_91502_length_377_cov_4.330935	134	214	0	80	80	1.0000000
NODE_91502_length_377_cov_4.330935	187	267	0	80	80	1.0000000
NODE_91506_length_377_cov_4.032374	124	181	2	6	57	0.1052632
NODE_91506_length_377_cov_4.032374	124	181	4	39	57	0.6842105
NODE_91506_length_377_cov_4.032374	124	181	6	12	57	0.2105263
NODE_91506_length_377_cov_4.032374	154	201	0	8	47	0.1702128
NODE_91506_length_377_cov_4.032374	154	201	2	18	47	0.3829787
NODE_91506_length_377_cov_4.032374	154	201	4	21	47	0.4468085
NODE_91526_length_377_cov_3.615108	82	140	0	58	58	1.0000000
NODE_91526_length_377_cov_3.615108	82	140	0	58	58	1.0000000
NODE_91526_length_377_cov_3.615108	113	193	0	80	80	1.0000000
NODE_91526_length_377_cov_3.615108	113	193	0	80	80	1.0000000
NODE_91526_length_377_cov_3.615108	189	258	0	69	69	1.0000000
NODE_91526_length_377_cov_3.615108	243	313	0	70	70	1.0000000
NODE_91553_length_377_cov_2.913669	38	61	4	23	23	1.0000000
NODE_91553_length_377_cov_2.913669	167	228	0	61	61	1.0000000
NODE_91619_length_377_cov_2.104317	137	188	0	51	51	1.0000000
NODE_91619_length_377_cov_2.104317	168	211	0	43	43	1.0000000
NODE_91619_length_377_cov_2.104317	190	241	0	51	51	1.0000000
NODE_91727_length_377_cov_1.622302	123	181	12	12	58	0.2068966
NODE_91727_length_377_cov_1.622302	123	181	18	46	58	0.7931035
NODE_91727_length_377_cov_1.622302	176	234	0	2	58	0.0344828
NODE_91727_length_377_cov_1.622302	176	234	2	4	58	0.0689655
NODE_91727_length_377_cov_1.622302	176	234	7	1	58	0.0172414
NODE_91727_length_377_cov_1.622302	176	234	8	8	58	0.1379310
NODE_91727_length_377_cov_1.622302	176	234	14	20	58	0.3448276
NODE_91727_length_377_cov_1.622302	176	234	18	23	58	0.3965517
NODE_91749_length_377_cov_1.539568	230	310	2	14	80	0.1750000
NODE_91749_length_377_cov_1.539568	230	310	4	45	80	0.5625000
NODE_91749_length_377_cov_1.539568	230	310	8	12	80	0.1500000
NODE_91749_length_377_cov_1.539568	230	310	10	9	80	0.1125000
NODE_91749_length_377_cov_1.539568	230	310	2	14	80	0.1750000
NODE_91749_length_377_cov_1.539568	230	310	4	45	80	0.5625000
NODE_91749_length_377_cov_1.539568	230	310	8	12	80	0.1500000
NODE_91749_length_377_cov_1.539568	230	310	10	9	80	0.1125000
NODE_91749_length_377_cov_1.539568	306	377	0	63	71	0.8873239
NODE_91749_length_377_cov_1.539568	306	377	2	8	71	0.1126761
NODE_91749_length_377_cov_1.539568	327	351	0	24	24	1.0000000
NODE_91765_length_377_cov_1.471223	118	198	0	13	80	0.1625000
NODE_91765_length_377_cov_1.471223	118	198	2	12	80	0.1500000
NODE_91765_length_377_cov_1.471223	118	198	4	55	80	0.6875000
NODE_91790_length_377_cov_1.456835	177	257	0	4	80	0.0500000
NODE_91790_length_377_cov_1.456835	177	257	3	1	80	0.0125000
NODE_91790_length_377_cov_1.456835	177	257	4	75	80	0.9375000
NODE_91790_length_377_cov_1.456835	230	310	2	9	80	0.1125000
NODE_91790_length_377_cov_1.456835	230	310	4	46	80	0.5750000
NODE_91790_length_377_cov_1.456835	230	310	6	25	80	0.3125000
NODE_91817_length_377_cov_1.330935	0	44	0	44	44	1.0000000
NODE_91817_length_377_cov_1.330935	45	117	0	72	72	1.0000000
NODE_92046_length_377_cov_0.762590	299	330	0	31	31	1.0000000
NODE_92166_length_376_cov_6.938628	0	63	6	1	63	0.0158730
NODE_92166_length_376_cov_6.938628	0	63	8	4	63	0.0634921
NODE_92166_length_376_cov_6.938628	0	63	10	2	63	0.0317460
NODE_92166_length_376_cov_6.938628	0	63	14	4	63	0.0634921
NODE_92166_length_376_cov_6.938628	0	63	16	2	63	0.0317460
NODE_92166_length_376_cov_6.938628	0	63	18	2	63	0.0317460
NODE_92166_length_376_cov_6.938628	0	63	20	5	63	0.0793651
NODE_92166_length_376_cov_6.938628	0	63	22	14	63	0.2222222
NODE_92166_length_376_cov_6.938628	0	63	24	3	63	0.0476190
NODE_92166_length_376_cov_6.938628	0	63	26	6	63	0.0952381
NODE_92166_length_376_cov_6.938628	0	63	28	4	63	0.0634921
NODE_92166_length_376_cov_6.938628	0	63	38	7	63	0.1111111
NODE_92166_length_376_cov_6.938628	0	63	40	3	63	0.0476190
NODE_92166_length_376_cov_6.938628	0	63	44	1	63	0.0158730
NODE_92166_length_376_cov_6.938628	0	63	46	2	63	0.0317460
NODE_92166_length_376_cov_6.938628	0	63	48	3	63	0.0476190
NODE_92166_length_376_cov_6.938628	269	340	14	11	71	0.1549296
NODE_92166_length_376_cov_6.938628	269	340	15	4	71	0.0563380
NODE_92166_length_376_cov_6.938628	269	340	17	2	71	0.0281690
NODE_92166_length_376_cov_6.938628	269	340	18	5	71	0.0704225
NODE_92166_length_376_cov_6.938628	269	340	19	4	71	0.0563380
NODE_92166_length_376_cov_6.938628	269	340	21	14	71	0.1971831
NODE_92166_length_376_cov_6.938628	269	340	23	4	71	0.0563380
NODE_92166_length_376_cov_6.938628	269	340	25	3	71	0.0422535
NODE_92166_length_376_cov_6.938628	269	340	27	3	71	0.0422535
NODE_92166_length_376_cov_6.938628	269	340	28	11	71	0.1549296
NODE_92166_length_376_cov_6.938628	269	340	29	10	71	0.1408451
NODE_92168_length_376_cov_6.415162	177	257	0	80	80	1.0000000
NODE_92168_length_376_cov_6.415162	230	310	0	80	80	1.0000000
NODE_92173_length_376_cov_5.722022	100	171	0	1	71	0.0140845
NODE_92173_length_376_cov_5.722022	100	171	2	70	71	0.9859155
NODE_92173_length_376_cov_5.722022	155	192	0	12	37	0.3243243
NODE_92173_length_376_cov_5.722022	155	192	2	25	37	0.6756757
NODE_92191_length_376_cov_4.148014	300	330	0	24	30	0.8000000
NODE_92191_length_376_cov_4.148014	300	330	2	6	30	0.2000000
NODE_92196_length_376_cov_3.859206	168	236	6	41	68	0.6029412
NODE_92196_length_376_cov_3.859206	168	236	7	3	68	0.0441176
NODE_92196_length_376_cov_3.859206	168	236	8	18	68	0.2647059
NODE_92196_length_376_cov_3.859206	168	236	9	6	68	0.0882353
NODE_92219_length_376_cov_3.140794	122	188	0	37	66	0.5606061
NODE_92219_length_376_cov_3.140794	122	188	6	29	66	0.4393939
NODE_92442_length_376_cov_1.516245	57	106	14	17	49	0.3469388
NODE_92442_length_376_cov_1.516245	57	106	16	4	49	0.0816327
NODE_92442_length_376_cov_1.516245	57	106	18	28	49	0.5714286
NODE_92879_length_375_cov_4.217391	321	350	0	19	29	0.6551724
NODE_92879_length_375_cov_4.217391	321	350	2	10	29	0.3448276
NODE_92897_length_375_cov_3.699275	287	367	0	80	80	1.0000000
NODE_92911_length_375_cov_3.376812	70	136	4	2	66	0.0303030
NODE_92911_length_375_cov_3.376812	70	136	6	38	66	0.5757576
NODE_92911_length_375_cov_3.376812	70	136	8	26	66	0.3939394
NODE_93031_length_375_cov_2.032609	162	224	2	5	62	0.0806452
NODE_93031_length_375_cov_2.032609	162	224	7	1	62	0.0161290
NODE_93031_length_375_cov_2.032609	162	224	8	29	62	0.4677419
NODE_93031_length_375_cov_2.032609	162	224	10	4	62	0.0645161
NODE_93031_length_375_cov_2.032609	162	224	12	8	62	0.1290323
NODE_93031_length_375_cov_2.032609	162	224	16	2	62	0.0322581
NODE_93031_length_375_cov_2.032609	162	224	21	9	62	0.1451613
NODE_93031_length_375_cov_2.032609	162	224	23	4	62	0.0645161
NODE_93031_length_375_cov_2.032609	215	272	21	5	57	0.0877193
NODE_93031_length_375_cov_2.032609	215	272	23	6	57	0.1052632
NODE_93031_length_375_cov_2.032609	215	272	28	17	57	0.2982456
NODE_93031_length_375_cov_2.032609	215	272	30	8	57	0.1403509
NODE_93031_length_375_cov_2.032609	215	272	32	5	57	0.0877193
NODE_93031_length_375_cov_2.032609	215	272	34	16	57	0.2807018
NODE_93050_length_375_cov_1.967391	131	190	0	59	59	1.0000000
NODE_93050_length_375_cov_1.967391	184	235	0	51	51	1.0000000
NODE_93081_length_375_cov_1.840580	195	276	4	80	81	0.9876543
NODE_93081_length_375_cov_1.840580	195	276	6	1	81	0.0123457
NODE_93386_length_375_cov_1.000000	320	375	0	55	55	1.0000000
NODE_93609_length_374_cov_4.563636	93	160	2	59	67	0.8805970
NODE_93609_length_374_cov_4.563636	93	160	4	2	67	0.0298507
NODE_93609_length_374_cov_4.563636	93	160	6	6	67	0.0895522
NODE_93609_length_374_cov_4.563636	146	213	0	43	67	0.6417910
NODE_93609_length_374_cov_4.563636	146	213	2	24	67	0.3582090
NODE_93612_length_374_cov_4.523636	23	101	0	78	78	1.0000000
NODE_93612_length_374_cov_4.523636	81	154	0	73	73	1.0000000
NODE_93628_length_374_cov_3.810909	130	189	5	1	59	0.0169492
NODE_93628_length_374_cov_3.810909	130	189	7	2	59	0.0338983
NODE_93628_length_374_cov_3.810909	130	189	11	3	59	0.0508475
NODE_93628_length_374_cov_3.810909	130	189	13	9	59	0.1525424
NODE_93628_length_374_cov_3.810909	130	189	15	6	59	0.1016949
NODE_93628_length_374_cov_3.810909	130	189	18	29	59	0.4915254
NODE_93628_length_374_cov_3.810909	130	189	19	9	59	0.1525424
NODE_93628_length_374_cov_3.810909	162	242	4	7	80	0.0875000
NODE_93628_length_374_cov_3.810909	162	242	6	3	80	0.0375000
NODE_93628_length_374_cov_3.810909	162	242	8	13	80	0.1625000
NODE_93628_length_374_cov_3.810909	162	242	10	3	80	0.0375000
NODE_93628_length_374_cov_3.810909	162	242	14	6	80	0.0750000
NODE_93628_length_374_cov_3.810909	162	242	17	1	80	0.0125000
NODE_93628_length_374_cov_3.810909	162	242	18	47	80	0.5875000
NODE_93630_length_374_cov_3.789091	236	271	0	35	35	1.0000000
NODE_93630_length_374_cov_3.789091	238	280	0	42	42	1.0000000
NODE_93637_length_374_cov_3.458182	190	248	0	6	58	0.1034483
NODE_93637_length_374_cov_3.458182	190	248	2	13	58	0.2241379
NODE_93637_length_374_cov_3.458182	190	248	4	35	58	0.6034483
NODE_93637_length_374_cov_3.458182	190	248	6	4	58	0.0689655
NODE_93688_length_374_cov_2.600000	142	217	0	50	75	0.6666667
NODE_93688_length_374_cov_2.600000	142	217	2	12	75	0.1600000
NODE_93688_length_374_cov_2.600000	142	217	4	13	75	0.1733333
NODE_93688_length_374_cov_2.600000	190	270	0	2	80	0.0250000
NODE_93688_length_374_cov_2.600000	190	270	2	12	80	0.1500000
NODE_93688_length_374_cov_2.600000	190	270	4	44	80	0.5500000
NODE_93688_length_374_cov_2.600000	190	270	6	22	80	0.2750000
NODE_93718_length_374_cov_2.330909	40	120	0	7	80	0.0875000
NODE_93718_length_374_cov_2.330909	40	120	2	73	80	0.9125000
NODE_93769_length_374_cov_2.010909	40	105	4	5	65	0.0769231
NODE_93769_length_374_cov_2.010909	40	105	6	21	65	0.3230769
NODE_93769_length_374_cov_2.010909	40	105	8	39	65	0.6000000
NODE_93821_length_374_cov_1.796364	254	288	4	28	34	0.8235294
NODE_93821_length_374_cov_1.796364	254	288	6	6	34	0.1764706
NODE_93852_length_374_cov_1.661818	95	157	4	20	62	0.3225806
NODE_93852_length_374_cov_1.661818	95	157	6	2	62	0.0322581
NODE_93852_length_374_cov_1.661818	95	157	8	40	62	0.6451613
NODE_93859_length_374_cov_1.621818	202	254	4	52	52	1.0000000
NODE_93936_length_374_cov_1.360000	211	291	4	56	80	0.7000000
NODE_93936_length_374_cov_1.360000	211	291	6	7	80	0.0875000
NODE_93936_length_374_cov_1.360000	211	291	8	7	80	0.0875000
NODE_93936_length_374_cov_1.360000	211	291	10	10	80	0.1250000
NODE_93981_length_374_cov_1.236364	263	336	0	30	73	0.4109589
NODE_93981_length_374_cov_1.236364	263	336	2	43	73	0.5890411
NODE_94321_length_373_cov_31.302920	0	53	0	4	53	0.0754717
NODE_94321_length_373_cov_31.302920	0	53	2	1	53	0.0188679
NODE_94321_length_373_cov_31.302920	0	53	20	24	53	0.4528302
NODE_94321_length_373_cov_31.302920	0	53	25	2	53	0.0377358
NODE_94321_length_373_cov_31.302920	0	53	28	11	53	0.2075472
NODE_94321_length_373_cov_31.302920	0	53	30	5	53	0.0943396
NODE_94321_length_373_cov_31.302920	0	53	32	6	53	0.1132075
NODE_94321_length_373_cov_31.302920	0	53	0	4	53	0.0754717
NODE_94321_length_373_cov_31.302920	0	53	2	1	53	0.0188679
NODE_94321_length_373_cov_31.302920	0	53	20	24	53	0.4528302
NODE_94321_length_373_cov_31.302920	0	53	25	2	53	0.0377358
NODE_94321_length_373_cov_31.302920	0	53	28	11	53	0.2075472
NODE_94321_length_373_cov_31.302920	0	53	30	5	53	0.0943396
NODE_94321_length_373_cov_31.302920	0	53	32	6	53	0.1132075
NODE_94321_length_373_cov_31.302920	0	53	0	4	53	0.0754717
NODE_94321_length_373_cov_31.302920	0	53	2	1	53	0.0188679
NODE_94321_length_373_cov_31.302920	0	53	20	24	53	0.4528302
NODE_94321_length_373_cov_31.302920	0	53	25	2	53	0.0377358
NODE_94321_length_373_cov_31.302920	0	53	28	11	53	0.2075472
NODE_94321_length_373_cov_31.302920	0	53	30	5	53	0.0943396
NODE_94321_length_373_cov_31.302920	0	53	32	6	53	0.1132075
NODE_94321_length_373_cov_31.302920	26	106	20	3	80	0.0375000
NODE_94321_length_373_cov_31.302920	26	106	25	2	80	0.0250000
NODE_94321_length_373_cov_31.302920	26	106	28	11	80	0.1375000
NODE_94321_length_373_cov_31.302920	26	106	30	5	80	0.0625000
NODE_94321_length_373_cov_31.302920	26	106	32	12	80	0.1500000
NODE_94321_length_373_cov_31.302920	26	106	34	47	80	0.5875000
NODE_94340_length_373_cov_4.671533	76	142	6	66	66	1.0000000
NODE_94340_length_373_cov_4.671533	115	195	0	14	80	0.1750000
NODE_94340_length_373_cov_4.671533	115	195	2	5	80	0.0625000
NODE_94340_length_373_cov_4.671533	115	195	4	24	80	0.3000000
NODE_94340_length_373_cov_4.671533	115	195	6	37	80	0.4625000
NODE_94340_length_373_cov_4.671533	115	195	0	14	80	0.1750000
NODE_94340_length_373_cov_4.671533	115	195	2	5	80	0.0625000
NODE_94340_length_373_cov_4.671533	115	195	4	24	80	0.3000000
NODE_94340_length_373_cov_4.671533	115	195	6	37	80	0.4625000
NODE_94340_length_373_cov_4.671533	288	368	0	40	80	0.5000000
NODE_94340_length_373_cov_4.671533	288	368	4	14	80	0.1750000
NODE_94340_length_373_cov_4.671533	288	368	6	26	80	0.3250000
NODE_94352_length_373_cov_4.080292	109	189	0	11	80	0.1375000
NODE_94352_length_373_cov_4.080292	109	189	2	69	80	0.8625000
NODE_94352_length_373_cov_4.080292	162	220	0	42	58	0.7241379
NODE_94352_length_373_cov_4.080292	162	220	2	16	58	0.2758621
NODE_94380_length_373_cov_3.167883	131	210	0	79	79	1.0000000
NODE_94414_length_373_cov_2.751825	80	151	0	52	71	0.7323943
NODE_94414_length_373_cov_2.751825	80	151	2	19	71	0.2676056
NODE_94414_length_373_cov_2.751825	124	162	0	8	38	0.2105263
NODE_94414_length_373_cov_2.751825	124	162	2	22	38	0.5789474
NODE_94414_length_373_cov_2.751825	124	162	4	7	38	0.1842105
NODE_94414_length_373_cov_2.751825	124	162	8	1	38	0.0263158
NODE_94493_length_373_cov_2.036496	248	326	0	61	78	0.7820513
NODE_94493_length_373_cov_2.036496	248	326	2	2	78	0.0256410
NODE_94493_length_373_cov_2.036496	248	326	4	1	78	0.0128205
NODE_94493_length_373_cov_2.036496	248	326	7	14	78	0.1794872
NODE_94493_length_373_cov_2.036496	299	359	0	60	60	1.0000000
NODE_94500_length_373_cov_2.003650	150	194	0	44	44	1.0000000
NODE_94937_length_373_cov_0.759124	62	114	0	52	52	1.0000000
NODE_95051_length_372_cov_30.135531	111	191	0	80	80	1.0000000
NODE_95051_length_372_cov_30.135531	159	222	0	63	63	1.0000000
NODE_95051_length_372_cov_30.135531	164	239	0	75	75	1.0000000
NODE_95051_length_372_cov_30.135531	182	253	0	71	71	1.0000000
NODE_95051_length_372_cov_30.135531	195	275	0	80	80	1.0000000
NODE_95051_length_372_cov_30.135531	213	276	0	63	63	1.0000000
NODE_95053_length_372_cov_9.091575	150	230	0	80	80	1.0000000
NODE_95053_length_372_cov_9.091575	203	283	0	80	80	1.0000000
NODE_95063_length_372_cov_5.706960	168	208	0	40	40	1.0000000
NODE_95067_length_372_cov_5.124542	146	211	0	7	65	0.1076923
NODE_95067_length_372_cov_5.124542	146	211	2	12	65	0.1846154
NODE_95067_length_372_cov_5.124542	146	211	4	46	65	0.7076923
NODE_95067_length_372_cov_5.124542	189	264	4	75	75	1.0000000
NODE_95090_length_372_cov_3.761905	177	221	0	44	44	1.0000000
NODE_95109_length_372_cov_3.186813	137	218	0	29	81	0.3580247
NODE_95109_length_372_cov_3.186813	137	218	2	52	81	0.6419753
NODE_95159_length_372_cov_2.582418	167	239	18	2	72	0.0277778
NODE_95159_length_372_cov_2.582418	167	239	20	1	72	0.0138889
NODE_95159_length_372_cov_2.582418	167	239	24	3	72	0.0416667
NODE_95159_length_372_cov_2.582418	167	239	28	2	72	0.0277778
NODE_95159_length_372_cov_2.582418	167	239	32	1	72	0.0138889
NODE_95159_length_372_cov_2.582418	167	239	38	2	72	0.0277778
NODE_95159_length_372_cov_2.582418	167	239	40	1	72	0.0138889
NODE_95159_length_372_cov_2.582418	167	239	42	12	72	0.1666667
NODE_95159_length_372_cov_2.582418	167	239	44	41	72	0.5694444
NODE_95159_length_372_cov_2.582418	167	239	46	7	72	0.0972222
NODE_95159_length_372_cov_2.582418	212	292	4	11	80	0.1375000
NODE_95159_length_372_cov_2.582418	212	292	6	4	80	0.0500000
NODE_95159_length_372_cov_2.582418	212	292	10	1	80	0.0125000
NODE_95159_length_372_cov_2.582418	212	292	16	1	80	0.0125000
NODE_95159_length_372_cov_2.582418	212	292	20	1	80	0.0125000
NODE_95159_length_372_cov_2.582418	212	292	22	1	80	0.0125000
NODE_95159_length_372_cov_2.582418	212	292	26	2	80	0.0250000
NODE_95159_length_372_cov_2.582418	212	292	30	1	80	0.0125000
NODE_95159_length_372_cov_2.582418	212	292	32	2	80	0.0250000
NODE_95159_length_372_cov_2.582418	212	292	36	2	80	0.0250000
NODE_95159_length_372_cov_2.582418	212	292	38	4	80	0.0500000
NODE_95159_length_372_cov_2.582418	212	292	42	1	80	0.0125000
NODE_95159_length_372_cov_2.582418	212	292	44	29	80	0.3625000
NODE_95159_length_372_cov_2.582418	212	292	46	17	80	0.2125000
NODE_95159_length_372_cov_2.582418	212	292	48	3	80	0.0375000
NODE_95183_length_372_cov_2.347985	97	141	0	17	44	0.3863636
NODE_95183_length_372_cov_2.347985	97	141	2	27	44	0.6136364
NODE_95183_length_372_cov_2.347985	98	133	0	9	35	0.2571429
NODE_95183_length_372_cov_2.347985	98	133	2	26	35	0.7428572
NODE_95183_length_372_cov_2.347985	178	243	2	19	65	0.2923077
NODE_95183_length_372_cov_2.347985	178	243	4	46	65	0.7076923
NODE_95303_length_372_cov_1.699634	195	276	8	16	81	0.1975309
NODE_95303_length_372_cov_1.699634	195	276	10	9	81	0.1111111
NODE_95303_length_372_cov_1.699634	195	276	14	9	81	0.1111111
NODE_95303_length_372_cov_1.699634	195	276	16	17	81	0.2098765
NODE_95303_length_372_cov_1.699634	195	276	18	30	81	0.3703704
NODE_95453_length_372_cov_1.223443	264	334	0	70	70	1.0000000
NODE_95784_length_371_cov_52.040441	104	184	0	56	80	0.7000000
NODE_95784_length_371_cov_52.040441	104	184	4	24	80	0.3000000
NODE_95784_length_371_cov_52.040441	157	237	0	3	80	0.0375000
NODE_95784_length_371_cov_52.040441	157	237	4	28	80	0.3500000
NODE_95784_length_371_cov_52.040441	157	237	8	23	80	0.2875000
NODE_95784_length_371_cov_52.040441	157	237	10	7	80	0.0875000
NODE_95784_length_371_cov_52.040441	157	237	14	19	80	0.2375000
NODE_95784_length_371_cov_52.040441	180	232	4	8	52	0.1538462
NODE_95784_length_371_cov_52.040441	180	232	8	23	52	0.4423077
NODE_95784_length_371_cov_52.040441	180	232	10	7	52	0.1346154
NODE_95784_length_371_cov_52.040441	180	232	14	14	52	0.2692308
NODE_95785_length_371_cov_24.878676	91	171	2	6	80	0.0750000
NODE_95785_length_371_cov_24.878676	91	171	4	10	80	0.1250000
NODE_95785_length_371_cov_24.878676	91	171	6	64	80	0.8000000
NODE_95785_length_371_cov_24.878676	144	224	0	38	80	0.4750000
NODE_95785_length_371_cov_24.878676	144	224	2	2	80	0.0250000
NODE_95785_length_371_cov_24.878676	144	224	4	17	80	0.2125000
NODE_95785_length_371_cov_24.878676	144	224	6	23	80	0.2875000
NODE_95797_length_371_cov_5.738971	170	245	2	2	75	0.0266667
NODE_95797_length_371_cov_5.738971	170	245	4	7	75	0.0933333
NODE_95797_length_371_cov_5.738971	170	245	7	16	75	0.2133333
NODE_95797_length_371_cov_5.738971	170	245	8	4	75	0.0533333
NODE_95797_length_371_cov_5.738971	170	245	9	12	75	0.1600000
NODE_95797_length_371_cov_5.738971	170	245	10	13	75	0.1733333
NODE_95797_length_371_cov_5.738971	170	245	12	3	75	0.0400000
NODE_95797_length_371_cov_5.738971	170	245	14	15	75	0.2000000
NODE_95797_length_371_cov_5.738971	170	245	16	3	75	0.0400000
NODE_95797_length_371_cov_5.738971	218	298	10	6	80	0.0750000
NODE_95797_length_371_cov_5.738971	218	298	12	3	80	0.0375000
NODE_95797_length_371_cov_5.738971	218	298	14	15	80	0.1875000
NODE_95797_length_371_cov_5.738971	218	298	16	5	80	0.0625000
NODE_95797_length_371_cov_5.738971	218	298	18	2	80	0.0250000
NODE_95797_length_371_cov_5.738971	218	298	20	4	80	0.0500000
NODE_95797_length_371_cov_5.738971	218	298	21	21	80	0.2625000
NODE_95797_length_371_cov_5.738971	218	298	22	24	80	0.3000000
NODE_95807_length_371_cov_4.452206	65	145	0	80	80	1.0000000
NODE_95807_length_371_cov_4.452206	118	198	0	80	80	1.0000000
NODE_95863_length_371_cov_2.841912	288	350	0	58	62	0.9354839
NODE_95863_length_371_cov_2.841912	288	350	2	2	62	0.0322581
NODE_95863_length_371_cov_2.841912	288	350	25	2	62	0.0322581
NODE_96013_length_371_cov_1.790441	188	235	0	31	47	0.6595744
NODE_96013_length_371_cov_1.790441	188	235	1	1	47	0.0212766
NODE_96013_length_371_cov_1.790441	188	235	3	14	47	0.2978723
NODE_96013_length_371_cov_1.790441	188	235	4	1	47	0.0212766
NODE_96105_length_371_cov_1.422794	199	287	4	32	88	0.3636364
NODE_96105_length_371_cov_1.422794	199	287	5	1	88	0.0113636
NODE_96105_length_371_cov_1.422794	199	287	6	14	88	0.1590909
NODE_96105_length_371_cov_1.422794	199	287	9	17	88	0.1931818
NODE_96105_length_371_cov_1.422794	199	287	11	24	88	0.2727273
NODE_96500_length_370_cov_50.380074	144	224	0	80	80	1.0000000
NODE_96500_length_370_cov_50.380074	197	277	0	80	80	1.0000000
NODE_96504_length_370_cov_7.553506	105	162	4	57	57	1.0000000
NODE_96510_length_370_cov_5.811808	153	221	0	68	68	1.0000000
NODE_96510_length_370_cov_5.811808	206	286	0	80	80	1.0000000
NODE_96522_length_370_cov_4.915129	157	207	14	50	50	1.0000000
NODE_96528_length_370_cov_4.535055	141	221	2	41	80	0.5125000
NODE_96528_length_370_cov_4.535055	141	221	4	39	80	0.4875000
NODE_96528_length_370_cov_4.535055	194	274	0	8	80	0.1000000
NODE_96528_length_370_cov_4.535055	194	274	2	36	80	0.4500000
NODE_96528_length_370_cov_4.535055	194	274	4	36	80	0.4500000
NODE_96532_length_370_cov_4.199262	230	275	0	45	45	1.0000000
NODE_96533_length_370_cov_4.151292	142	209	9	23	67	0.3432836
NODE_96533_length_370_cov_4.151292	142	209	11	11	67	0.1641791
NODE_96533_length_370_cov_4.151292	142	209	13	10	67	0.1492537
NODE_96533_length_370_cov_4.151292	142	209	15	23	67	0.3432836
NODE_96542_length_370_cov_3.719557	214	251	31	12	37	0.3243243
NODE_96542_length_370_cov_3.719557	214	251	33	18	37	0.4864865
NODE_96542_length_370_cov_3.719557	214	251	35	3	37	0.0810811
NODE_96542_length_370_cov_3.719557	214	251	36	2	37	0.0540541
NODE_96542_length_370_cov_3.719557	214	251	37	1	37	0.0270270
NODE_96542_length_370_cov_3.719557	214	251	39	1	37	0.0270270
NODE_96581_length_370_cov_2.822878	126	173	0	47	47	1.0000000
NODE_96668_length_370_cov_2.081181	0	52	2	2	52	0.0384615
NODE_96668_length_370_cov_2.081181	0	52	6	1	52	0.0192308
NODE_96668_length_370_cov_2.081181	0	52	8	1	52	0.0192308
NODE_96668_length_370_cov_2.081181	0	52	10	1	52	0.0192308
NODE_96668_length_370_cov_2.081181	0	52	12	10	52	0.1923077
NODE_96668_length_370_cov_2.081181	0	52	16	4	52	0.0769231
NODE_96668_length_370_cov_2.081181	0	52	20	11	52	0.2115385
NODE_96668_length_370_cov_2.081181	0	52	22	5	52	0.0961538
NODE_96668_length_370_cov_2.081181	0	52	24	1	52	0.0192308
NODE_96668_length_370_cov_2.081181	0	52	26	16	52	0.3076923
NODE_97207_length_369_cov_36.811111	273	358	0	14	85	0.1647059
NODE_97207_length_369_cov_36.811111	273	358	6	7	85	0.0823529
NODE_97207_length_369_cov_36.811111	273	358	10	5	85	0.0588235
NODE_97207_length_369_cov_36.811111	273	358	11	1	85	0.0117647
NODE_97207_length_369_cov_36.811111	273	358	12	14	85	0.1647059
NODE_97207_length_369_cov_36.811111	273	358	14	44	85	0.5176471
NODE_97207_length_369_cov_36.811111	273	358	0	14	85	0.1647059
NODE_97207_length_369_cov_36.811111	273	358	6	7	85	0.0823529
NODE_97207_length_369_cov_36.811111	273	358	10	5	85	0.0588235
NODE_97207_length_369_cov_36.811111	273	358	11	1	85	0.0117647
NODE_97207_length_369_cov_36.811111	273	358	12	14	85	0.1647059
NODE_97207_length_369_cov_36.811111	273	358	14	44	85	0.5176471
NODE_97207_length_369_cov_36.811111	273	358	0	14	85	0.1647059
NODE_97207_length_369_cov_36.811111	273	358	6	7	85	0.0823529
NODE_97207_length_369_cov_36.811111	273	358	10	5	85	0.0588235
NODE_97207_length_369_cov_36.811111	273	358	11	1	85	0.0117647
NODE_97207_length_369_cov_36.811111	273	358	12	14	85	0.1647059
NODE_97207_length_369_cov_36.811111	273	358	14	44	85	0.5176471
NODE_97211_length_369_cov_8.751852	107	187	0	8	80	0.1000000
NODE_97211_length_369_cov_8.751852	107	187	2	29	80	0.3625000
NODE_97211_length_369_cov_8.751852	107	187	4	43	80	0.5375000
NODE_97226_length_369_cov_6.677778	189	269	2	9	80	0.1125000
NODE_97226_length_369_cov_6.677778	189	269	4	51	80	0.6375000
NODE_97226_length_369_cov_6.677778	189	269	6	20	80	0.2500000
NODE_97226_length_369_cov_6.677778	242	323	2	63	81	0.7777778
NODE_97226_length_369_cov_6.677778	242	323	6	18	81	0.2222222
NODE_97236_length_369_cov_5.337037	199	264	0	65	65	1.0000000
NODE_97249_length_369_cov_4.459259	89	157	0	68	68	1.0000000
NODE_97249_length_369_cov_4.459259	130	210	0	80	80	1.0000000
NODE_97255_length_369_cov_4.111111	216	279	0	63	63	1.0000000
NODE_97265_length_369_cov_3.837037	205	238	0	33	33	1.0000000
NODE_97265_length_369_cov_3.837037	211	291	0	80	80	1.0000000
NODE_97265_length_369_cov_3.837037	287	316	0	29	29	1.0000000
NODE_97346_length_369_cov_2.355556	62	142	0	39	80	0.4875000
NODE_97346_length_369_cov_2.355556	62	142	1	41	80	0.5125000
NODE_97346_length_369_cov_2.355556	114	195	1	34	81	0.4197531
NODE_97346_length_369_cov_2.355556	114	195	2	47	81	0.5802469
NODE_97440_length_369_cov_1.803704	170	235	0	65	65	1.0000000
NODE_97936_length_368_cov_42.208178	231	311	2	1	80	0.0125000
NODE_97936_length_368_cov_42.208178	231	311	4	26	80	0.3250000
NODE_97936_length_368_cov_42.208178	231	311	5	1	80	0.0125000
NODE_97936_length_368_cov_42.208178	231	311	6	52	80	0.6500000
NODE_97936_length_368_cov_42.208178	284	364	0	27	80	0.3375000
NODE_97936_length_368_cov_42.208178	284	364	4	52	80	0.6500000
NODE_97936_length_368_cov_42.208178	284	364	5	1	80	0.0125000
NODE_97939_length_368_cov_11.988848	47	127	0	32	80	0.4000000
NODE_97939_length_368_cov_11.988848	47	127	13	1	80	0.0125000
NODE_97939_length_368_cov_11.988848	47	127	14	14	80	0.1750000
NODE_97939_length_368_cov_11.988848	47	127	16	33	80	0.4125000
NODE_97939_length_368_cov_11.988848	100	180	14	6	80	0.0750000
NODE_97939_length_368_cov_11.988848	100	180	16	74	80	0.9250000
NODE_97945_length_368_cov_6.267658	133	213	0	80	80	1.0000000
NODE_97945_length_368_cov_6.267658	186	266	0	80	80	1.0000000
NODE_97997_length_368_cov_3.486989	127	207	4	14	80	0.1750000
NODE_97997_length_368_cov_3.486989	127	207	6	23	80	0.2875000
NODE_97997_length_368_cov_3.486989	127	207	8	43	80	0.5375000
NODE_98008_length_368_cov_3.282528	182	255	2	11	73	0.1506849
NODE_98008_length_368_cov_3.282528	182	255	4	62	73	0.8493150
NODE_98058_length_368_cov_2.605948	192	246	0	54	54	1.0000000
NODE_98123_length_368_cov_2.182156	85	145	2	60	60	1.0000000
NODE_98129_length_368_cov_2.137546	66	107	4	1	41	0.0243902
NODE_98129_length_368_cov_2.137546	66	107	6	3	41	0.0731707
NODE_98129_length_368_cov_2.137546	66	107	8	1	41	0.0243902
NODE_98129_length_368_cov_2.137546	66	107	12	2	41	0.0487805
NODE_98129_length_368_cov_2.137546	66	107	14	2	41	0.0487805
NODE_98129_length_368_cov_2.137546	66	107	16	32	41	0.7804878
NODE_98157_length_368_cov_1.944238	192	272	6	49	80	0.6125000
NODE_98157_length_368_cov_1.944238	192	272	8	5	80	0.0625000
NODE_98157_length_368_cov_1.944238	192	272	10	6	80	0.0750000
NODE_98157_length_368_cov_1.944238	192	272	12	20	80	0.2500000
NODE_98723_length_367_cov_7.156716	174	254	2	9	80	0.1125000
NODE_98723_length_367_cov_7.156716	174	254	4	40	80	0.5000000
NODE_98723_length_367_cov_7.156716	174	254	6	19	80	0.2375000
NODE_98723_length_367_cov_7.156716	174	254	8	12	80	0.1500000
NODE_98723_length_367_cov_7.156716	227	307	0	41	80	0.5125000
NODE_98723_length_367_cov_7.156716	227	307	2	21	80	0.2625000
NODE_98723_length_367_cov_7.156716	227	307	4	18	80	0.2250000
NODE_98734_length_367_cov_5.313433	148	206	0	14	58	0.2413793
NODE_98734_length_367_cov_5.313433	148	206	2	17	58	0.2931035
NODE_98734_length_367_cov_5.313433	148	206	8	27	58	0.4655173
NODE_98737_length_367_cov_5.138060	58	138	0	28	80	0.3500000
NODE_98737_length_367_cov_5.138060	58	138	2	52	80	0.6500000
NODE_98737_length_367_cov_5.138060	111	191	0	80	80	1.0000000
NODE_98796_length_367_cov_3.059701	110	154	4	44	44	1.0000000
NODE_98796_length_367_cov_3.059701	111	146	4	35	35	1.0000000
NODE_98843_length_367_cov_2.384328	246	326	0	80	80	1.0000000
NODE_98843_length_367_cov_2.384328	299	367	0	68	68	1.0000000
NODE_98849_length_367_cov_2.332090	127	207	0	19	80	0.2375000
NODE_98849_length_367_cov_2.332090	127	207	2	16	80	0.2000000
NODE_98849_length_367_cov_2.332090	127	207	4	45	80	0.5625000
NODE_98909_length_367_cov_1.944030	91	156	0	65	65	1.0000000
NODE_98980_length_367_cov_1.679104	173	252	6	4	79	0.0506329
NODE_98980_length_367_cov_1.679104	173	252	8	36	79	0.4556962
NODE_98980_length_367_cov_1.679104	173	252	10	13	79	0.1645570
NODE_98980_length_367_cov_1.679104	173	252	12	11	79	0.1392405
NODE_98980_length_367_cov_1.679104	173	252	14	15	79	0.1898734
NODE_99005_length_367_cov_1.552239	148	200	0	5	52	0.0961538
NODE_99005_length_367_cov_1.552239	148	200	2	47	52	0.9038461
NODE_99138_length_367_cov_1.201493	79	159	0	80	80	1.0000000
NODE_99138_length_367_cov_1.201493	136	179	0	43	43	1.0000000
NODE_99318_length_367_cov_0.761194	288	357	0	69	69	1.0000000
NODE_99451_length_366_cov_5.239700	193	253	2	60	60	1.0000000
NODE_99472_length_366_cov_4.168539	302	355	0	51	53	0.9622642
NODE_99472_length_366_cov_4.168539	302	355	2	2	53	0.0377358
NODE_99478_length_366_cov_3.913858	183	229	2	46	46	1.0000000
NODE_99478_length_366_cov_3.913858	203	282	0	12	79	0.1518987
NODE_99478_length_366_cov_3.913858	203	282	2	67	79	0.8481013
NODE_99496_length_366_cov_3.168539	88	160	11	5	72	0.0694444
NODE_99496_length_366_cov_3.168539	88	160	15	67	72	0.9305556
NODE_99496_length_366_cov_3.168539	133	193	4	3	60	0.0500000
NODE_99496_length_366_cov_3.168539	133	193	9	3	60	0.0500000
NODE_99496_length_366_cov_3.168539	133	193	11	5	60	0.0833333
NODE_99496_length_366_cov_3.168539	133	193	15	49	60	0.8166667
NODE_100137_length_365_cov_140.101504	40	107	84	1	67	0.0149254
NODE_100137_length_365_cov_140.101504	40	107	94	1	67	0.0149254
NODE_100137_length_365_cov_140.101504	40	107	102	2	67	0.0298507
NODE_100137_length_365_cov_140.101504	40	107	106	1	67	0.0149254
NODE_100137_length_365_cov_140.101504	40	107	108	2	67	0.0298507
NODE_100137_length_365_cov_140.101504	40	107	112	5	67	0.0746269
NODE_100137_length_365_cov_140.101504	40	107	114	2	67	0.0298507
NODE_100137_length_365_cov_140.101504	40	107	118	2	67	0.0298507
NODE_100137_length_365_cov_140.101504	40	107	124	1	67	0.0149254
NODE_100137_length_365_cov_140.101504	40	107	126	2	67	0.0298507
NODE_100137_length_365_cov_140.101504	40	107	130	1	67	0.0149254
NODE_100137_length_365_cov_140.101504	40	107	138	2	67	0.0298507
NODE_100137_length_365_cov_140.101504	40	107	140	5	67	0.0746269
NODE_100137_length_365_cov_140.101504	40	107	145	1	67	0.0149254
NODE_100137_length_365_cov_140.101504	40	107	147	1	67	0.0149254
NODE_100137_length_365_cov_140.101504	40	107	163	1	67	0.0149254
NODE_100137_length_365_cov_140.101504	40	107	168	1	67	0.0149254
NODE_100137_length_365_cov_140.101504	40	107	172	1	67	0.0149254
NODE_100137_length_365_cov_140.101504	40	107	175	1	67	0.0149254
NODE_100137_length_365_cov_140.101504	40	107	177	1	67	0.0149254
NODE_100137_length_365_cov_140.101504	40	107	181	1	67	0.0149254
NODE_100137_length_365_cov_140.101504	40	107	185	1	67	0.0149254
NODE_100137_length_365_cov_140.101504	40	107	187	5	67	0.0746269
NODE_100137_length_365_cov_140.101504	40	107	189	1	67	0.0149254
NODE_100137_length_365_cov_140.101504	40	107	191	5	67	0.0746269
NODE_100137_length_365_cov_140.101504	40	107	193	2	67	0.0298507
NODE_100137_length_365_cov_140.101504	40	107	195	3	67	0.0447761
NODE_100137_length_365_cov_140.101504	40	107	199	1	67	0.0149254
NODE_100137_length_365_cov_140.101504	40	107	201	2	67	0.0298507
NODE_100137_length_365_cov_140.101504	40	107	203	3	67	0.0447761
NODE_100137_length_365_cov_140.101504	40	107	204	9	67	0.1343284
NODE_100138_length_365_cov_45.815789	0	38	0	38	38	1.0000000
NODE_100138_length_365_cov_45.815789	11	91	0	80	80	1.0000000
NODE_100140_length_365_cov_8.169173	191	244	4	12	53	0.2264151
NODE_100140_length_365_cov_8.169173	191	244	6	23	53	0.4339623
NODE_100140_length_365_cov_8.169173	191	244	8	18	53	0.3396226
NODE_100140_length_365_cov_8.169173	217	297	6	32	80	0.4000000
NODE_100140_length_365_cov_8.169173	217	297	8	24	80	0.3000000
NODE_100140_length_365_cov_8.169173	217	297	10	24	80	0.3000000
NODE_100145_length_365_cov_5.954887	136	216	0	19	80	0.2375000
NODE_100145_length_365_cov_5.954887	136	216	2	61	80	0.7625000
NODE_100145_length_365_cov_5.954887	189	269	0	25	80	0.3125000
NODE_100145_length_365_cov_5.954887	189	269	2	55	80	0.6875000
NODE_100147_length_365_cov_5.721805	37	78	0	41	41	1.0000000
NODE_100168_length_365_cov_4.195489	269	329	5	2	60	0.0333333
NODE_100168_length_365_cov_4.195489	269	329	6	1	60	0.0166667
NODE_100168_length_365_cov_4.195489	269	329	7	6	60	0.1000000
NODE_100168_length_365_cov_4.195489	269	329	9	5	60	0.0833333
NODE_100168_length_365_cov_4.195489	269	329	11	6	60	0.1000000
NODE_100168_length_365_cov_4.195489	269	329	13	28	60	0.4666667
NODE_100168_length_365_cov_4.195489	269	329	14	12	60	0.2000000
NODE_100172_length_365_cov_4.071429	106	186	0	80	80	1.0000000
NODE_100172_length_365_cov_4.071429	159	239	0	80	80	1.0000000
NODE_100180_length_365_cov_3.879699	131	187	6	36	56	0.6428571
NODE_100180_length_365_cov_3.879699	131	187	8	20	56	0.3571429
NODE_100206_length_365_cov_3.270677	211	280	2	44	69	0.6376812
NODE_100206_length_365_cov_3.270677	211	280	4	17	69	0.2463768
NODE_100206_length_365_cov_3.270677	211	280	6	8	69	0.1159420
NODE_100253_length_365_cov_2.601504	189	265	4	76	76	1.0000000
NODE_100293_length_365_cov_2.289474	169	249	0	46	80	0.5750000
NODE_100293_length_365_cov_2.289474	169	249	2	34	80	0.4250000
NODE_100407_length_365_cov_1.635338	156	235	2	9	79	0.1139240
NODE_100407_length_365_cov_1.635338	156	235	4	1	79	0.0126582
NODE_100407_length_365_cov_1.635338	156	235	6	2	79	0.0253165
NODE_100407_length_365_cov_1.635338	156	235	10	3	79	0.0379747
NODE_100407_length_365_cov_1.635338	156	235	12	1	79	0.0126582
NODE_100407_length_365_cov_1.635338	156	235	14	9	79	0.1139240
NODE_100407_length_365_cov_1.635338	156	235	15	8	79	0.1012658
NODE_100407_length_365_cov_1.635338	156	235	21	2	79	0.0253165
NODE_100407_length_365_cov_1.635338	156	235	23	10	79	0.1265823
NODE_100407_length_365_cov_1.635338	156	235	25	2	79	0.0253165
NODE_100407_length_365_cov_1.635338	156	235	29	3	79	0.0379747
NODE_100407_length_365_cov_1.635338	156	235	31	10	79	0.1265823
NODE_100407_length_365_cov_1.635338	156	235	33	19	79	0.2405063
NODE_100485_length_365_cov_1.421053	228	309	0	81	81	1.0000000
NODE_100570_length_365_cov_1.169173	57	137	0	80	80	1.0000000
NODE_100570_length_365_cov_1.169173	65	145	0	80	80	1.0000000
NODE_100570_length_365_cov_1.169173	194	274	6	6	80	0.0750000
NODE_100570_length_365_cov_1.169173	194	274	8	1	80	0.0125000
NODE_100570_length_365_cov_1.169173	194	274	9	2	80	0.0250000
NODE_100570_length_365_cov_1.169173	194	274	10	17	80	0.2125000
NODE_100570_length_365_cov_1.169173	194	274	12	6	80	0.0750000
NODE_100570_length_365_cov_1.169173	194	274	14	7	80	0.0875000
NODE_100570_length_365_cov_1.169173	194	274	16	41	80	0.5125000
NODE_100893_length_364_cov_24.600000	101	181	0	80	80	1.0000000
NODE_100893_length_364_cov_24.600000	154	234	0	80	80	1.0000000
NODE_100896_length_364_cov_7.377358	0	50	0	50	50	1.0000000
NODE_100933_length_364_cov_3.988679	122	168	0	46	46	1.0000000
NODE_100935_length_364_cov_3.913208	151	208	8	25	57	0.4385965
NODE_100935_length_364_cov_3.913208	151	208	11	11	57	0.1929825
NODE_100935_length_364_cov_3.913208	151	208	13	17	57	0.2982456
NODE_100935_length_364_cov_3.913208	151	208	14	4	57	0.0701754
NODE_100959_length_364_cov_3.305660	296	358	0	14	62	0.2258064
NODE_100959_length_364_cov_3.305660	296	358	2	48	62	0.7741935
NODE_100966_length_364_cov_3.181132	78	138	0	60	60	1.0000000
NODE_100975_length_364_cov_3.041509	264	321	0	57	57	1.0000000
NODE_100975_length_364_cov_3.041509	294	359	0	65	65	1.0000000
NODE_100978_length_364_cov_3.015094	238	274	0	22	36	0.6111111
NODE_100978_length_364_cov_3.015094	238	274	2	14	36	0.3888889
NODE_101087_length_364_cov_1.977358	126	201	0	54	75	0.7200000
NODE_101087_length_364_cov_1.977358	126	201	2	21	75	0.2800000
NODE_101141_length_364_cov_1.811321	209	256	0	47	47	1.0000000
NODE_101148_length_364_cov_1.781132	130	203	11	5	73	0.0684932
NODE_101148_length_364_cov_1.781132	130	203	12	7	73	0.0958904
NODE_101148_length_364_cov_1.781132	130	203	13	9	73	0.1232877
NODE_101148_length_364_cov_1.781132	130	203	15	22	73	0.3013699
NODE_101148_length_364_cov_1.781132	130	203	19	2	73	0.0273973
NODE_101148_length_364_cov_1.781132	130	203	21	21	73	0.2876712
NODE_101148_length_364_cov_1.781132	130	203	23	7	73	0.0958904
NODE_101148_length_364_cov_1.781132	183	203	11	5	20	0.2500000
NODE_101148_length_364_cov_1.781132	183	203	13	9	20	0.4500000
NODE_101148_length_364_cov_1.781132	183	203	15	6	20	0.3000000
NODE_101720_length_363_cov_7.791667	121	200	0	11	79	0.1392405
NODE_101720_length_363_cov_7.791667	121	200	1	10	79	0.1265823
NODE_101720_length_363_cov_7.791667	121	200	9	48	79	0.6075949
NODE_101720_length_363_cov_7.791667	121	200	10	10	79	0.1265823
NODE_101725_length_363_cov_6.484848	33	90	7	1	57	0.0175439
NODE_101725_length_363_cov_6.484848	33	90	15	5	57	0.0877193
NODE_101725_length_363_cov_6.484848	33	90	17	4	57	0.0701754
NODE_101725_length_363_cov_6.484848	33	90	18	4	57	0.0701754
NODE_101725_length_363_cov_6.484848	33	90	20	4	57	0.0701754
NODE_101725_length_363_cov_6.484848	33	90	21	6	57	0.1052632
NODE_101725_length_363_cov_6.484848	33	90	22	33	57	0.5789474
NODE_101725_length_363_cov_6.484848	93	146	14	4	53	0.0754717
NODE_101725_length_363_cov_6.484848	93	146	15	1	53	0.0188679
NODE_101725_length_363_cov_6.484848	93	146	16	4	53	0.0754717
NODE_101725_length_363_cov_6.484848	93	146	20	19	53	0.3584906
NODE_101725_length_363_cov_6.484848	93	146	22	25	53	0.4716981
NODE_101734_length_363_cov_4.825758	154	215	5	2	61	0.0327869
NODE_101734_length_363_cov_4.825758	154	215	6	59	61	0.9672131
NODE_101760_length_363_cov_3.950758	112	183	6	49	71	0.6901408
NODE_101760_length_363_cov_3.950758	112	183	8	22	71	0.3098592
NODE_101760_length_363_cov_3.950758	156	236	0	4	80	0.0500000
NODE_101760_length_363_cov_3.950758	156	236	6	76	80	0.9500000
NODE_101769_length_363_cov_3.617424	16	79	4	1	63	0.0158730
NODE_101769_length_363_cov_3.617424	16	79	5	14	63	0.2222222
NODE_101769_length_363_cov_3.617424	16	79	6	48	63	0.7619048
NODE_101774_length_363_cov_3.409091	241	267	0	26	26	1.0000000
NODE_101791_length_363_cov_3.087121	228	308	6	1	80	0.0125000
NODE_101791_length_363_cov_3.087121	228	308	7	7	80	0.0875000
NODE_101791_length_363_cov_3.087121	228	308	8	6	80	0.0750000
NODE_101791_length_363_cov_3.087121	228	308	9	1	80	0.0125000
NODE_101791_length_363_cov_3.087121	228	308	10	25	80	0.3125000
NODE_101791_length_363_cov_3.087121	228	308	12	15	80	0.1875000
NODE_101791_length_363_cov_3.087121	228	308	14	25	80	0.3125000
NODE_101809_length_363_cov_2.795455	240	320	12	1	80	0.0125000
NODE_101809_length_363_cov_2.795455	240	320	14	2	80	0.0250000
NODE_101809_length_363_cov_2.795455	240	320	16	7	80	0.0875000
NODE_101809_length_363_cov_2.795455	240	320	20	1	80	0.0125000
NODE_101809_length_363_cov_2.795455	240	320	21	1	80	0.0125000
NODE_101809_length_363_cov_2.795455	240	320	22	3	80	0.0375000
NODE_101809_length_363_cov_2.795455	240	320	24	1	80	0.0125000
NODE_101809_length_363_cov_2.795455	240	320	26	1	80	0.0125000
NODE_101809_length_363_cov_2.795455	240	320	30	9	80	0.1125000
NODE_101809_length_363_cov_2.795455	240	320	32	14	80	0.1750000
NODE_101809_length_363_cov_2.795455	240	320	34	3	80	0.0375000
NODE_101809_length_363_cov_2.795455	240	320	36	3	80	0.0375000
NODE_101809_length_363_cov_2.795455	240	320	40	19	80	0.2375000
NODE_101809_length_363_cov_2.795455	240	320	42	2	80	0.0250000
NODE_101809_length_363_cov_2.795455	240	320	46	6	80	0.0750000
NODE_101809_length_363_cov_2.795455	240	320	48	5	80	0.0625000
NODE_101809_length_363_cov_2.795455	240	320	53	1	80	0.0125000
NODE_101809_length_363_cov_2.795455	240	320	56	1	80	0.0125000
NODE_101822_length_363_cov_2.481061	86	166	2	44	80	0.5500000
NODE_101822_length_363_cov_2.481061	86	166	4	36	80	0.4500000
NODE_101822_length_363_cov_2.481061	139	219	0	6	80	0.0750000
NODE_101822_length_363_cov_2.481061	139	219	2	70	80	0.8750000
NODE_101822_length_363_cov_2.481061	139	219	4	4	80	0.0500000
NODE_101879_length_363_cov_2.034091	46	126	0	80	80	1.0000000
NODE_101879_length_363_cov_2.034091	99	153	0	54	54	1.0000000
NODE_101992_length_363_cov_1.541667	235	315	0	21	80	0.2625000
NODE_101992_length_363_cov_1.541667	235	315	1	29	80	0.3625000
NODE_101992_length_363_cov_1.541667	235	315	2	30	80	0.3750000
NODE_102022_length_363_cov_1.477273	141	202	0	3	61	0.0491803
NODE_102022_length_363_cov_1.477273	141	202	2	2	61	0.0327869
NODE_102022_length_363_cov_1.477273	141	202	4	3	61	0.0491803
NODE_102022_length_363_cov_1.477273	141	202	6	53	61	0.8688524
NODE_102022_length_363_cov_1.477273	153	210	6	57	57	1.0000000
NODE_102187_length_363_cov_1.113636	245	316	7	12	71	0.1690141
NODE_102187_length_363_cov_1.113636	245	316	9	3	71	0.0422535
NODE_102187_length_363_cov_1.113636	245	316	10	56	71	0.7887324
NODE_102464_length_362_cov_54.927757	52	116	0	64	64	1.0000000
NODE_102465_length_362_cov_29.273764	86	166	0	14	80	0.1750000
NODE_102465_length_362_cov_29.273764	86	166	2	66	80	0.8250000
NODE_102465_length_362_cov_29.273764	139	219	0	67	80	0.8375000
NODE_102465_length_362_cov_29.273764	139	219	2	13	80	0.1625000
NODE_102467_length_362_cov_14.847909	130	210	0	12	80	0.1500000
NODE_102467_length_362_cov_14.847909	130	210	2	68	80	0.8500000
NODE_102467_length_362_cov_14.847909	183	263	0	65	80	0.8125000
NODE_102467_length_362_cov_14.847909	183	263	2	15	80	0.1875000
NODE_102633_length_362_cov_2.159696	133	216	0	83	83	1.0000000
NODE_103259_length_361_cov_4.641221	249	312	4	17	63	0.2698413
NODE_103259_length_361_cov_4.641221	249	312	6	46	63	0.7301587
NODE_103280_length_361_cov_3.717557	185	265	0	8	80	0.1000000
NODE_103280_length_361_cov_3.717557	185	265	2	72	80	0.9000000
NODE_103280_length_361_cov_3.717557	238	265	0	8	27	0.2962963
NODE_103280_length_361_cov_3.717557	238	265	2	19	27	0.7037037
NODE_103314_length_361_cov_2.988550	121	201	6	4	80	0.0500000
NODE_103314_length_361_cov_2.988550	121	201	9	1	80	0.0125000
NODE_103314_length_361_cov_2.988550	121	201	10	22	80	0.2750000
NODE_103314_length_361_cov_2.988550	121	201	11	23	80	0.2875000
NODE_103314_length_361_cov_2.988550	121	201	12	30	80	0.3750000
NODE_103314_length_361_cov_2.988550	174	216	8	1	42	0.0238095
NODE_103314_length_361_cov_2.988550	174	216	10	13	42	0.3095238
NODE_103314_length_361_cov_2.988550	174	216	12	28	42	0.6666667
NODE_103338_length_361_cov_2.641221	4	33	4	29	29	1.0000000
NODE_103338_length_361_cov_2.641221	101	182	0	71	81	0.8765432
NODE_103338_length_361_cov_2.641221	101	182	2	10	81	0.1234568
NODE_103391_length_361_cov_2.137405	138	194	0	56	56	1.0000000
NODE_103396_length_361_cov_2.106870	192	256	0	64	64	1.0000000
NODE_103418_length_361_cov_1.969466	137	198	8	30	61	0.4918033
NODE_103418_length_361_cov_1.969466	137	198	10	28	61	0.4590164
NODE_103418_length_361_cov_1.969466	137	198	12	3	61	0.0491803
NODE_103632_length_361_cov_1.343511	171	250	0	79	79	1.0000000
NODE_103802_length_361_cov_1.000000	60	123	0	63	63	1.0000000
NODE_104057_length_360_cov_8.191571	171	242	0	13	71	0.1830986
NODE_104057_length_360_cov_8.191571	171	242	9	5	71	0.0704225
NODE_104057_length_360_cov_8.191571	171	242	11	2	71	0.0281690
NODE_104057_length_360_cov_8.191571	171	242	13	6	71	0.0845070
NODE_104057_length_360_cov_8.191571	171	242	18	3	71	0.0422535
NODE_104057_length_360_cov_8.191571	171	242	19	1	71	0.0140845
NODE_104057_length_360_cov_8.191571	171	242	21	21	71	0.2957746
NODE_104057_length_360_cov_8.191571	171	242	22	6	71	0.0845070
NODE_104057_length_360_cov_8.191571	171	242	23	3	71	0.0422535
NODE_104057_length_360_cov_8.191571	171	242	24	11	71	0.1549296
NODE_104057_length_360_cov_8.191571	176	242	0	8	66	0.1212121
NODE_104057_length_360_cov_8.191571	176	242	9	5	66	0.0757576
NODE_104057_length_360_cov_8.191571	176	242	11	2	66	0.0303030
NODE_104057_length_360_cov_8.191571	176	242	13	6	66	0.0909091
NODE_104057_length_360_cov_8.191571	176	242	18	3	66	0.0454545
NODE_104057_length_360_cov_8.191571	176	242	19	1	66	0.0151515
NODE_104057_length_360_cov_8.191571	176	242	21	21	66	0.3181818
NODE_104057_length_360_cov_8.191571	176	242	22	6	66	0.0909091
NODE_104057_length_360_cov_8.191571	176	242	23	3	66	0.0454545
NODE_104057_length_360_cov_8.191571	176	242	24	11	66	0.1666667
NODE_104057_length_360_cov_8.191571	215	279	21	7	64	0.1093750
NODE_104057_length_360_cov_8.191571	215	279	22	17	64	0.2656250
NODE_104057_length_360_cov_8.191571	215	279	23	3	64	0.0468750
NODE_104057_length_360_cov_8.191571	215	279	24	37	64	0.5781250
NODE_104057_length_360_cov_8.191571	215	279	21	7	64	0.1093750
NODE_104057_length_360_cov_8.191571	215	279	22	17	64	0.2656250
NODE_104057_length_360_cov_8.191571	215	279	23	3	64	0.0468750
NODE_104057_length_360_cov_8.191571	215	279	24	37	64	0.5781250
NODE_104079_length_360_cov_5.003831	86	166	0	80	80	1.0000000
NODE_104091_length_360_cov_4.111111	158	238	60	2	80	0.0250000
NODE_104091_length_360_cov_4.111111	158	238	62	1	80	0.0125000
NODE_104091_length_360_cov_4.111111	158	238	64	1	80	0.0125000
NODE_104091_length_360_cov_4.111111	158	238	69	2	80	0.0250000
NODE_104091_length_360_cov_4.111111	158	238	73	3	80	0.0375000
NODE_104091_length_360_cov_4.111111	158	238	75	4	80	0.0500000
NODE_104091_length_360_cov_4.111111	158	238	78	1	80	0.0125000
NODE_104091_length_360_cov_4.111111	158	238	79	2	80	0.0250000
NODE_104091_length_360_cov_4.111111	158	238	81	2	80	0.0250000
NODE_104091_length_360_cov_4.111111	158	238	82	1	80	0.0125000
NODE_104091_length_360_cov_4.111111	158	238	84	3	80	0.0375000
NODE_104091_length_360_cov_4.111111	158	238	86	3	80	0.0375000
NODE_104091_length_360_cov_4.111111	158	238	88	13	80	0.1625000
NODE_104091_length_360_cov_4.111111	158	238	90	2	80	0.0250000
NODE_104091_length_360_cov_4.111111	158	238	92	3	80	0.0375000
NODE_104091_length_360_cov_4.111111	158	238	94	13	80	0.1625000
NODE_104091_length_360_cov_4.111111	158	238	96	16	80	0.2000000
NODE_104091_length_360_cov_4.111111	158	238	98	8	80	0.1000000
NODE_104102_length_360_cov_3.613027	123	203	0	80	80	1.0000000
NODE_104102_length_360_cov_3.613027	176	256	0	80	80	1.0000000
NODE_104129_length_360_cov_3.080460	48	70	5	6	22	0.2727273
NODE_104129_length_360_cov_3.080460	48	70	6	16	22	0.7272727
NODE_104162_length_360_cov_2.689655	118	198	4	10	80	0.1250000
NODE_104162_length_360_cov_2.689655	118	198	5	4	80	0.0500000
NODE_104162_length_360_cov_2.689655	118	198	6	2	80	0.0250000
NODE_104162_length_360_cov_2.689655	118	198	8	26	80	0.3250000
NODE_104162_length_360_cov_2.689655	118	198	10	38	80	0.4750000
NODE_104261_length_360_cov_1.977011	235	286	6	7	51	0.1372549
NODE_104261_length_360_cov_1.977011	235	286	8	21	51	0.4117647
NODE_104261_length_360_cov_1.977011	235	286	10	23	51	0.4509804
NODE_104572_length_360_cov_1.149425	273	353	2	80	80	1.0000000
NODE_104669_length_360_cov_0.965517	119	175	4	13	56	0.2321429
NODE_104669_length_360_cov_0.965517	119	175	6	43	56	0.7678571
NODE_104671_length_360_cov_0.957854	140	186	0	46	46	1.0000000
NODE_104858_length_359_cov_45.519231	140	220	0	2	80	0.0250000
NODE_104858_length_359_cov_45.519231	140	220	2	78	80	0.9750000
NODE_104858_length_359_cov_45.519231	193	273	0	24	80	0.3000000
NODE_104858_length_359_cov_45.519231	193	273	2	56	80	0.7000000
NODE_104932_length_359_cov_3.296154	67	147	2	41	80	0.5125000
NODE_104932_length_359_cov_3.296154	67	147	4	17	80	0.2125000
NODE_104932_length_359_cov_3.296154	67	147	6	6	80	0.0750000
NODE_104932_length_359_cov_3.296154	67	147	8	16	80	0.2000000
NODE_104932_length_359_cov_3.296154	120	177	4	5	57	0.0877193
NODE_104932_length_359_cov_3.296154	120	177	6	6	57	0.1052632
NODE_104932_length_359_cov_3.296154	120	177	8	37	57	0.6491228
NODE_104932_length_359_cov_3.296154	120	177	9	3	57	0.0526316
NODE_104932_length_359_cov_3.296154	120	177	10	6	57	0.1052632
NODE_104932_length_359_cov_3.296154	201	256	4	16	55	0.2909091
NODE_104932_length_359_cov_3.296154	201	256	6	24	55	0.4363636
NODE_104932_length_359_cov_3.296154	201	256	8	2	55	0.0363636
NODE_104932_length_359_cov_3.296154	201	256	9	4	55	0.0727273
NODE_104932_length_359_cov_3.296154	201	256	10	7	55	0.1272727
NODE_104932_length_359_cov_3.296154	201	256	11	2	55	0.0363636
NODE_104936_length_359_cov_3.276923	5	95	0	90	90	1.0000000
NODE_104954_length_359_cov_3.007692	156	212	7	11	56	0.1964286
NODE_104954_length_359_cov_3.007692	156	212	8	18	56	0.3214286
NODE_104954_length_359_cov_3.007692	156	212	10	25	56	0.4464286
NODE_104954_length_359_cov_3.007692	156	212	11	2	56	0.0357143
NODE_104998_length_359_cov_2.523077	148	228	0	39	80	0.4875000
NODE_104998_length_359_cov_2.523077	148	228	1	17	80	0.2125000
NODE_104998_length_359_cov_2.523077	148	228	3	22	80	0.2750000
NODE_104998_length_359_cov_2.523077	148	228	4	2	80	0.0250000
NODE_104998_length_359_cov_2.523077	201	278	1	3	77	0.0389610
NODE_104998_length_359_cov_2.523077	201	278	3	22	77	0.2857143
NODE_104998_length_359_cov_2.523077	201	278	4	52	77	0.6753247
NODE_105002_length_359_cov_2.419231	106	186	0	80	80	1.0000000
NODE_105002_length_359_cov_2.419231	159	211	0	50	52	0.9615384
NODE_105002_length_359_cov_2.419231	159	211	8	1	52	0.0192308
NODE_105002_length_359_cov_2.419231	159	211	10	1	52	0.0192308
NODE_105006_length_359_cov_2.353846	172	243	7	11	71	0.1549296
NODE_105006_length_359_cov_2.353846	172	243	9	1	71	0.0140845
NODE_105006_length_359_cov_2.353846	172	243	13	1	71	0.0140845
NODE_105006_length_359_cov_2.353846	172	243	14	6	71	0.0845070
NODE_105006_length_359_cov_2.353846	172	243	15	16	71	0.2253521
NODE_105006_length_359_cov_2.353846	172	243	16	36	71	0.5070422
NODE_105006_length_359_cov_2.353846	216	296	8	4	80	0.0500000
NODE_105006_length_359_cov_2.353846	216	296	12	18	80	0.2250000
NODE_105006_length_359_cov_2.353846	216	296	14	4	80	0.0500000
NODE_105006_length_359_cov_2.353846	216	296	16	52	80	0.6500000
NODE_105006_length_359_cov_2.353846	216	296	17	1	80	0.0125000
NODE_105006_length_359_cov_2.353846	216	296	18	1	80	0.0125000
NODE_105026_length_359_cov_2.257692	211	270	0	59	59	1.0000000
NODE_105063_length_359_cov_2.003846	8	88	0	80	80	1.0000000
NODE_105063_length_359_cov_2.003846	61	139	0	78	78	1.0000000
NODE_105106_length_359_cov_1.815385	126	207	0	81	81	1.0000000
NODE_105106_length_359_cov_1.815385	180	227	0	47	47	1.0000000
NODE_105142_length_359_cov_1.692308	88	116	0	28	28	1.0000000
NODE_105373_length_359_cov_1.096154	64	89	0	25	25	1.0000000
NODE_105599_length_359_cov_0.711538	222	248	0	26	26	1.0000000
NODE_105600_length_359_cov_0.707692	10	90	0	75	80	0.9375000
NODE_105600_length_359_cov_0.707692	10	90	2	5	80	0.0625000
NODE_105600_length_359_cov_0.707692	10	90	0	75	80	0.9375000
NODE_105600_length_359_cov_0.707692	10	90	2	5	80	0.0625000
NODE_105600_length_359_cov_0.707692	63	143	0	22	80	0.2750000
NODE_105600_length_359_cov_0.707692	63	143	2	14	80	0.1750000
NODE_105600_length_359_cov_0.707692	63	143	4	28	80	0.3500000
NODE_105600_length_359_cov_0.707692	63	143	5	2	80	0.0250000
NODE_105600_length_359_cov_0.707692	63	143	6	14	80	0.1750000
NODE_105678_length_358_cov_19.760618	213	293	0	80	80	1.0000000
NODE_105678_length_358_cov_19.760618	266	346	0	80	80	1.0000000
NODE_105679_length_358_cov_18.455598	303	358	0	1	55	0.0181818
NODE_105679_length_358_cov_18.455598	303	358	2	8	55	0.1454545
NODE_105679_length_358_cov_18.455598	303	358	3	6	55	0.1090909
NODE_105679_length_358_cov_18.455598	303	358	5	21	55	0.3818182
NODE_105679_length_358_cov_18.455598	303	358	6	9	55	0.1636364
NODE_105679_length_358_cov_18.455598	303	358	13	10	55	0.1818182
NODE_105680_length_358_cov_17.023166	0	63	17	1	63	0.0158730
NODE_105680_length_358_cov_17.023166	0	63	19	9	63	0.1428571
NODE_105680_length_358_cov_17.023166	0	63	30	1	63	0.0158730
NODE_105680_length_358_cov_17.023166	0	63	32	35	63	0.5555556
NODE_105680_length_358_cov_17.023166	0	63	33	6	63	0.0952381
NODE_105680_length_358_cov_17.023166	0	63	39	7	63	0.1111111
NODE_105680_length_358_cov_17.023166	0	63	40	3	63	0.0476190
NODE_105680_length_358_cov_17.023166	0	63	42	1	63	0.0158730
NODE_105680_length_358_cov_17.023166	0	63	17	1	63	0.0158730
NODE_105680_length_358_cov_17.023166	0	63	19	9	63	0.1428571
NODE_105680_length_358_cov_17.023166	0	63	30	1	63	0.0158730
NODE_105680_length_358_cov_17.023166	0	63	32	35	63	0.5555556
NODE_105680_length_358_cov_17.023166	0	63	33	6	63	0.0952381
NODE_105680_length_358_cov_17.023166	0	63	39	7	63	0.1111111
NODE_105680_length_358_cov_17.023166	0	63	40	3	63	0.0476190
NODE_105680_length_358_cov_17.023166	0	63	42	1	63	0.0158730
NODE_105680_length_358_cov_17.023166	0	63	17	1	63	0.0158730
NODE_105680_length_358_cov_17.023166	0	63	19	9	63	0.1428571
NODE_105680_length_358_cov_17.023166	0	63	30	1	63	0.0158730
NODE_105680_length_358_cov_17.023166	0	63	32	35	63	0.5555556
NODE_105680_length_358_cov_17.023166	0	63	33	6	63	0.0952381
NODE_105680_length_358_cov_17.023166	0	63	39	7	63	0.1111111
NODE_105680_length_358_cov_17.023166	0	63	40	3	63	0.0476190
NODE_105680_length_358_cov_17.023166	0	63	42	1	63	0.0158730
NODE_105680_length_358_cov_17.023166	36	116	32	10	80	0.1250000
NODE_105680_length_358_cov_17.023166	36	116	33	6	80	0.0750000
NODE_105680_length_358_cov_17.023166	36	116	39	7	80	0.0875000
NODE_105680_length_358_cov_17.023166	36	116	40	3	80	0.0375000
NODE_105680_length_358_cov_17.023166	36	116	42	2	80	0.0250000
NODE_105680_length_358_cov_17.023166	36	116	44	52	80	0.6500000
NODE_105680_length_358_cov_17.023166	53	115	39	6	62	0.0967742
NODE_105680_length_358_cov_17.023166	53	115	40	3	62	0.0483871
NODE_105680_length_358_cov_17.023166	53	115	42	2	62	0.0322581
NODE_105680_length_358_cov_17.023166	53	115	44	51	62	0.8225806
NODE_105686_length_358_cov_6.509653	109	155	0	46	46	1.0000000
NODE_105710_length_358_cov_4.239382	114	143	16	8	29	0.2758621
NODE_105710_length_358_cov_4.239382	114	143	18	21	29	0.7241379
NODE_105710_length_358_cov_4.239382	180	245	14	5	65	0.0769231
NODE_105710_length_358_cov_4.239382	180	245	17	1	65	0.0153846
NODE_105710_length_358_cov_4.239382	180	245	18	3	65	0.0461538
NODE_105710_length_358_cov_4.239382	180	245	20	30	65	0.4615385
NODE_105710_length_358_cov_4.239382	180	245	22	26	65	0.4000000
NODE_105710_length_358_cov_4.239382	218	298	10	22	80	0.2750000
NODE_105710_length_358_cov_4.239382	218	298	11	1	80	0.0125000
NODE_105710_length_358_cov_4.239382	218	298	12	7	80	0.0875000
NODE_105710_length_358_cov_4.239382	218	298	14	4	80	0.0500000
NODE_105710_length_358_cov_4.239382	218	298	16	7	80	0.0875000
NODE_105710_length_358_cov_4.239382	218	298	18	14	80	0.1750000
NODE_105710_length_358_cov_4.239382	218	298	20	25	80	0.3125000
NODE_105846_length_358_cov_2.162162	229	305	0	67	76	0.8815789
NODE_105846_length_358_cov_2.162162	229	305	1	9	76	0.1184211
NODE_105902_length_358_cov_1.926641	290	358	2	2	68	0.0294118
NODE_105902_length_358_cov_1.926641	290	358	4	5	68	0.0735294
NODE_105902_length_358_cov_1.926641	290	358	6	61	68	0.8970588
NODE_105910_length_358_cov_1.884170	250	317	0	7	67	0.1044776
NODE_105910_length_358_cov_1.884170	250	317	2	60	67	0.8955224
NODE_105923_length_358_cov_1.841699	189	269	18	2	80	0.0250000
NODE_105923_length_358_cov_1.841699	189	269	21	2	80	0.0250000
NODE_105923_length_358_cov_1.841699	189	269	25	1	80	0.0125000
NODE_105923_length_358_cov_1.841699	189	269	27	3	80	0.0375000
NODE_105923_length_358_cov_1.841699	189	269	29	2	80	0.0250000
NODE_105923_length_358_cov_1.841699	189	269	30	2	80	0.0250000
NODE_105923_length_358_cov_1.841699	189	269	31	9	80	0.1125000
NODE_105923_length_358_cov_1.841699	189	269	32	27	80	0.3375000
NODE_105923_length_358_cov_1.841699	189	269	33	1	80	0.0125000
NODE_105923_length_358_cov_1.841699	189	269	34	27	80	0.3375000
NODE_105923_length_358_cov_1.841699	189	269	36	4	80	0.0500000
NODE_106096_length_358_cov_1.235521	99	179	22	1	80	0.0125000
NODE_106096_length_358_cov_1.235521	99	179	24	39	80	0.4875000
NODE_106096_length_358_cov_1.235521	99	179	26	2	80	0.0250000
NODE_106096_length_358_cov_1.235521	99	179	28	7	80	0.0875000
NODE_106096_length_358_cov_1.235521	99	179	30	11	80	0.1375000
NODE_106096_length_358_cov_1.235521	99	179	32	20	80	0.2500000
NODE_106096_length_358_cov_1.235521	152	222	8	20	70	0.2857143
NODE_106096_length_358_cov_1.235521	152	222	10	3	70	0.0428571
NODE_106096_length_358_cov_1.235521	152	222	13	2	70	0.0285714
NODE_106096_length_358_cov_1.235521	152	222	15	1	70	0.0142857
NODE_106096_length_358_cov_1.235521	152	222	16	4	70	0.0571429
NODE_106096_length_358_cov_1.235521	152	222	17	1	70	0.0142857
NODE_106096_length_358_cov_1.235521	152	222	20	6	70	0.0857143
NODE_106096_length_358_cov_1.235521	152	222	22	7	70	0.1000000
NODE_106096_length_358_cov_1.235521	152	222	24	26	70	0.3714286
NODE_106189_length_358_cov_1.096525	148	228	0	80	80	1.0000000
NODE_106233_length_358_cov_0.984556	193	265	0	72	72	1.0000000
NODE_106489_length_357_cov_381.833333	244	324	189	4	80	0.0500000
NODE_106489_length_357_cov_381.833333	244	324	192	2	80	0.0250000
NODE_106489_length_357_cov_381.833333	244	324	196	1	80	0.0125000
NODE_106489_length_357_cov_381.833333	244	324	203	2	80	0.0250000
NODE_106489_length_357_cov_381.833333	244	324	208	1	80	0.0125000
NODE_106489_length_357_cov_381.833333	244	324	210	1	80	0.0125000
NODE_106489_length_357_cov_381.833333	244	324	212	1	80	0.0125000
NODE_106489_length_357_cov_381.833333	244	324	214	1	80	0.0125000
NODE_106489_length_357_cov_381.833333	244	324	218	1	80	0.0125000
NODE_106489_length_357_cov_381.833333	244	324	219	1	80	0.0125000
NODE_106489_length_357_cov_381.833333	244	324	220	1	80	0.0125000
NODE_106489_length_357_cov_381.833333	244	324	229	1	80	0.0125000
NODE_106489_length_357_cov_381.833333	244	324	230	2	80	0.0250000
NODE_106489_length_357_cov_381.833333	244	324	234	4	80	0.0500000
NODE_106489_length_357_cov_381.833333	244	324	236	5	80	0.0625000
NODE_106489_length_357_cov_381.833333	244	324	238	12	80	0.1500000
NODE_106489_length_357_cov_381.833333	244	324	239	2	80	0.0250000
NODE_106489_length_357_cov_381.833333	244	324	240	15	80	0.1875000
NODE_106489_length_357_cov_381.833333	244	324	241	23	80	0.2875000
NODE_106493_length_357_cov_7.643411	45	125	0	80	80	1.0000000
NODE_106493_length_357_cov_7.643411	98	178	0	80	80	1.0000000
NODE_106495_length_357_cov_7.027132	157	237	0	80	80	1.0000000
NODE_106495_length_357_cov_7.027132	210	252	0	42	42	1.0000000
NODE_106496_length_357_cov_6.732558	183	263	6	15	80	0.1875000
NODE_106496_length_357_cov_6.732558	183	263	10	5	80	0.0625000
NODE_106496_length_357_cov_6.732558	183	263	12	6	80	0.0750000
NODE_106496_length_357_cov_6.732558	183	263	14	53	80	0.6625000
NODE_106496_length_357_cov_6.732558	183	263	16	1	80	0.0125000
NODE_106529_length_357_cov_4.081395	145	225	0	61	80	0.7625000
NODE_106529_length_357_cov_4.081395	145	225	2	19	80	0.2375000
NODE_106529_length_357_cov_4.081395	198	271	0	25	73	0.3424658
NODE_106529_length_357_cov_4.081395	198	271	2	48	73	0.6575342
NODE_106542_length_357_cov_3.724806	192	265	0	73	73	1.0000000
NODE_106558_length_357_cov_3.341085	205	285	0	80	80	1.0000000
NODE_106558_length_357_cov_3.341085	258	338	0	80	80	1.0000000
NODE_106625_length_357_cov_2.414729	245	302	0	57	57	1.0000000
NODE_106625_length_357_cov_2.414729	275	355	0	80	80	1.0000000
NODE_106661_length_357_cov_2.174419	250	330	0	80	80	1.0000000
NODE_106666_length_357_cov_2.166667	103	133	0	30	30	1.0000000
NODE_106666_length_357_cov_2.166667	112	133	0	21	21	1.0000000
NODE_106702_length_357_cov_1.961240	150	169	2	19	19	1.0000000
NODE_106708_length_357_cov_1.918605	173	253	20	28	80	0.3500000
NODE_106708_length_357_cov_1.918605	173	253	22	42	80	0.5250000
NODE_106708_length_357_cov_1.918605	173	253	24	10	80	0.1250000
NODE_106737_length_357_cov_1.782946	73	142	0	69	69	1.0000000
NODE_106737_length_357_cov_1.782946	115	195	0	62	80	0.7750000
NODE_106737_length_357_cov_1.782946	115	195	2	18	80	0.2250000
NODE_107002_length_357_cov_1.127907	98	129	1	31	31	1.0000000
NODE_107306_length_356_cov_5.299611	140	200	12	22	60	0.3666667
NODE_107306_length_356_cov_5.299611	140	200	14	31	60	0.5166667
NODE_107306_length_356_cov_5.299611	140	200	16	7	60	0.1166667
NODE_107347_length_356_cov_3.400778	255	317	6	2	62	0.0322581
NODE_107347_length_356_cov_3.400778	255	317	10	9	62	0.1451613
NODE_107347_length_356_cov_3.400778	255	317	12	51	62	0.8225806
NODE_107347_length_356_cov_3.400778	308	353	0	17	45	0.3777778
NODE_107347_length_356_cov_3.400778	308	353	4	15	45	0.3333333
NODE_107347_length_356_cov_3.400778	308	353	6	6	45	0.1333333
NODE_107347_length_356_cov_3.400778	308	353	10	7	45	0.1555556
NODE_107402_length_356_cov_2.657588	256	298	48	7	42	0.1666667
NODE_107402_length_356_cov_2.657588	256	298	50	4	42	0.0952381
NODE_107402_length_356_cov_2.657588	256	298	52	18	42	0.4285714
NODE_107402_length_356_cov_2.657588	256	298	54	12	42	0.2857143
NODE_107402_length_356_cov_2.657588	256	298	56	1	42	0.0238095
NODE_107402_length_356_cov_2.657588	265	338	12	1	73	0.0136986
NODE_107402_length_356_cov_2.657588	265	338	15	2	73	0.0273973
NODE_107402_length_356_cov_2.657588	265	338	18	1	73	0.0136986
NODE_107402_length_356_cov_2.657588	265	338	20	1	73	0.0136986
NODE_107402_length_356_cov_2.657588	265	338	22	3	73	0.0410959
NODE_107402_length_356_cov_2.657588	265	338	24	5	73	0.0684932
NODE_107402_length_356_cov_2.657588	265	338	26	1	73	0.0136986
NODE_107402_length_356_cov_2.657588	265	338	30	3	73	0.0410959
NODE_107402_length_356_cov_2.657588	265	338	32	1	73	0.0136986
NODE_107402_length_356_cov_2.657588	265	338	34	1	73	0.0136986
NODE_107402_length_356_cov_2.657588	265	338	36	1	73	0.0136986
NODE_107402_length_356_cov_2.657588	265	338	42	3	73	0.0410959
NODE_107402_length_356_cov_2.657588	265	338	44	4	73	0.0547945
NODE_107402_length_356_cov_2.657588	265	338	46	12	73	0.1643836
NODE_107402_length_356_cov_2.657588	265	338	48	8	73	0.1095890
NODE_107402_length_356_cov_2.657588	265	338	50	4	73	0.0547945
NODE_107402_length_356_cov_2.657588	265	338	52	18	73	0.2465753
NODE_107402_length_356_cov_2.657588	265	338	54	4	73	0.0547945
NODE_107402_length_356_cov_2.657588	299	351	0	4	52	0.0769231
NODE_107402_length_356_cov_2.657588	299	351	2	3	52	0.0576923
NODE_107402_length_356_cov_2.657588	299	351	3	1	52	0.0192308
NODE_107402_length_356_cov_2.657588	299	351	5	5	52	0.0961538
NODE_107402_length_356_cov_2.657588	299	351	12	1	52	0.0192308
NODE_107402_length_356_cov_2.657588	299	351	15	2	52	0.0384615
NODE_107402_length_356_cov_2.657588	299	351	18	1	52	0.0192308
NODE_107402_length_356_cov_2.657588	299	351	20	1	52	0.0192308
NODE_107402_length_356_cov_2.657588	299	351	22	3	52	0.0576923
NODE_107402_length_356_cov_2.657588	299	351	24	5	52	0.0961538
NODE_107402_length_356_cov_2.657588	299	351	26	1	52	0.0192308
NODE_107402_length_356_cov_2.657588	299	351	30	3	52	0.0576923
NODE_107402_length_356_cov_2.657588	299	351	32	1	52	0.0192308
NODE_107402_length_356_cov_2.657588	299	351	34	1	52	0.0192308
NODE_107402_length_356_cov_2.657588	299	351	36	1	52	0.0192308
NODE_107402_length_356_cov_2.657588	299	351	42	3	52	0.0576923
NODE_107402_length_356_cov_2.657588	299	351	44	4	52	0.0769231
NODE_107402_length_356_cov_2.657588	299	351	46	12	52	0.2307692
NODE_107452_length_356_cov_2.237354	90	135	0	45	45	1.0000000
NODE_107475_length_356_cov_1.996109	127	194	6	67	67	1.0000000
NODE_107521_length_356_cov_1.813230	296	341	0	45	45	1.0000000
NODE_107606_length_356_cov_1.560311	192	272	0	80	80	1.0000000
NODE_107606_length_356_cov_1.560311	245	319	0	74	74	1.0000000
NODE_108122_length_355_cov_6.796875	127	173	0	5	46	0.1086956
NODE_108122_length_355_cov_6.796875	127	173	2	41	46	0.8913044
NODE_108210_length_355_cov_2.734375	111	162	2	51	51	1.0000000
NODE_108210_length_355_cov_2.734375	142	222	0	43	80	0.5375000
NODE_108210_length_355_cov_2.734375	142	222	1	9	80	0.1125000
NODE_108210_length_355_cov_2.734375	142	222	2	28	80	0.3500000
NODE_108215_length_355_cov_2.707031	277	314	0	37	37	1.0000000
NODE_108215_length_355_cov_2.707031	287	353	0	66	66	1.0000000
NODE_108239_length_355_cov_2.500000	38	82	2	34	44	0.7727273
NODE_108239_length_355_cov_2.500000	38	82	4	10	44	0.2272727
NODE_108278_length_355_cov_2.207031	258	308	0	50	50	1.0000000
NODE_108284_length_355_cov_2.179688	153	233	2	12	80	0.1500000
NODE_108284_length_355_cov_2.179688	153	233	6	2	80	0.0250000
NODE_108284_length_355_cov_2.179688	153	233	10	4	80	0.0500000
NODE_108284_length_355_cov_2.179688	153	233	15	1	80	0.0125000
NODE_108284_length_355_cov_2.179688	153	233	16	12	80	0.1500000
NODE_108284_length_355_cov_2.179688	153	233	18	49	80	0.6125000
NODE_108284_length_355_cov_2.179688	206	286	1	26	80	0.3250000
NODE_108284_length_355_cov_2.179688	206	286	6	6	80	0.0750000
NODE_108284_length_355_cov_2.179688	206	286	8	1	80	0.0125000
NODE_108284_length_355_cov_2.179688	206	286	12	4	80	0.0500000
NODE_108284_length_355_cov_2.179688	206	286	14	3	80	0.0375000
NODE_108284_length_355_cov_2.179688	206	286	16	18	80	0.2250000
NODE_108284_length_355_cov_2.179688	206	286	18	22	80	0.2750000
NODE_108291_length_355_cov_2.132812	261	334	0	73	73	1.0000000
NODE_108291_length_355_cov_2.132812	301	342	0	41	41	1.0000000
NODE_108315_length_355_cov_2.007812	281	347	0	66	66	1.0000000
NODE_108395_length_355_cov_1.765625	186	247	5	1	61	0.0163934
NODE_108395_length_355_cov_1.765625	186	247	6	4	61	0.0655738
NODE_108395_length_355_cov_1.765625	186	247	8	24	61	0.3934426
NODE_108395_length_355_cov_1.765625	186	247	10	22	61	0.3606557
NODE_108395_length_355_cov_1.765625	186	247	12	10	61	0.1639344
NODE_108395_length_355_cov_1.765625	220	300	8	1	80	0.0125000
NODE_108395_length_355_cov_1.765625	220	300	10	38	80	0.4750000
NODE_108395_length_355_cov_1.765625	220	300	11	11	80	0.1375000
NODE_108395_length_355_cov_1.765625	220	300	12	24	80	0.3000000
NODE_108395_length_355_cov_1.765625	220	300	13	6	80	0.0750000
NODE_109015_length_354_cov_6.843137	53	132	0	79	79	1.0000000
NODE_109015_length_354_cov_6.843137	53	132	0	79	79	1.0000000
NODE_109015_length_354_cov_6.843137	105	185	0	80	80	1.0000000
NODE_109015_length_354_cov_6.843137	105	185	0	80	80	1.0000000
NODE_109033_length_354_cov_4.823529	208	255	0	35	47	0.7446808
NODE_109033_length_354_cov_4.823529	208	255	2	12	47	0.2553191
NODE_109054_length_354_cov_3.956863	145	208	0	63	63	1.0000000
NODE_109054_length_354_cov_3.956863	181	261	0	80	80	1.0000000
NODE_109057_length_354_cov_3.878431	198	244	0	34	46	0.7391304
NODE_109057_length_354_cov_3.878431	198	244	2	12	46	0.2608696
NODE_109089_length_354_cov_3.207843	130	199	0	69	69	1.0000000
NODE_109126_length_354_cov_2.725490	179	259	0	58	80	0.7250000
NODE_109126_length_354_cov_2.725490	179	259	2	22	80	0.2750000
NODE_109126_length_354_cov_2.725490	235	312	0	2	77	0.0259740
NODE_109126_length_354_cov_2.725490	235	312	2	75	77	0.9740260
NODE_109128_length_354_cov_2.713725	16	76	0	60	60	1.0000000
NODE_109128_length_354_cov_2.713725	90	149	0	59	59	1.0000000
NODE_109140_length_354_cov_2.580392	176	234	0	37	58	0.6379310
NODE_109140_length_354_cov_2.580392	176	234	2	21	58	0.3620690
NODE_109140_length_354_cov_2.580392	207	251	0	6	44	0.1363636
NODE_109140_length_354_cov_2.580392	207	251	2	38	44	0.8636364
NODE_109237_length_354_cov_1.996078	79	145	0	66	66	1.0000000
NODE_109237_length_354_cov_1.996078	118	200	0	82	82	1.0000000
NODE_109244_length_354_cov_1.988235	7	77	0	19	70	0.2714286
NODE_109244_length_354_cov_1.988235	7	77	2	7	70	0.1000000
NODE_109244_length_354_cov_1.988235	7	77	4	44	70	0.6285715
NODE_109244_length_354_cov_1.988235	64	130	0	5	66	0.0757576
NODE_109244_length_354_cov_1.988235	64	130	2	35	66	0.5303030
NODE_109244_length_354_cov_1.988235	64	130	4	26	66	0.3939394
NODE_109321_length_354_cov_1.682353	99	171	0	72	72	1.0000000
NODE_109321_length_354_cov_1.682353	144	224	0	80	80	1.0000000
NODE_109852_length_353_cov_11.169291	14	90	0	76	76	1.0000000
NODE_109852_length_353_cov_11.169291	67	143	0	76	76	1.0000000
NODE_109911_length_353_cov_3.874016	220	256	0	36	36	1.0000000
NODE_109911_length_353_cov_3.874016	265	334	0	69	69	1.0000000
NODE_109928_length_353_cov_3.488189	200	282	6	8	82	0.0975610
NODE_109928_length_353_cov_3.488189	200	282	8	33	82	0.4024390
NODE_109928_length_353_cov_3.488189	200	282	10	3	82	0.0365854
NODE_109928_length_353_cov_3.488189	200	282	12	38	82	0.4634146
NODE_109976_length_353_cov_2.826772	8	88	0	20	80	0.2500000
NODE_109976_length_353_cov_2.826772	8	88	4	5	80	0.0625000
NODE_109976_length_353_cov_2.826772	8	88	6	11	80	0.1375000
NODE_109976_length_353_cov_2.826772	8	88	10	1	80	0.0125000
NODE_109976_length_353_cov_2.826772	8	88	14	43	80	0.5375000
NODE_109976_length_353_cov_2.826772	61	120	14	59	59	1.0000000
NODE_110022_length_353_cov_2.417323	260	336	0	29	76	0.3815790
NODE_110022_length_353_cov_2.417323	260	336	2	47	76	0.6184211
NODE_110610_length_353_cov_0.744094	299	318	0	19	19	1.0000000
NODE_110708_length_352_cov_34.691700	110	203	6	13	93	0.1397849
NODE_110708_length_352_cov_34.691700	110	203	7	1	93	0.0107527
NODE_110708_length_352_cov_34.691700	110	203	8	10	93	0.1075269
NODE_110708_length_352_cov_34.691700	110	203	12	43	93	0.4623656
NODE_110708_length_352_cov_34.691700	110	203	13	18	93	0.1935484
NODE_110708_length_352_cov_34.691700	110	203	14	6	93	0.0645161
NODE_110708_length_352_cov_34.691700	110	203	21	1	93	0.0107527
NODE_110708_length_352_cov_34.691700	110	203	27	1	93	0.0107527
NODE_110710_length_352_cov_17.944664	20	100	0	80	80	1.0000000
NODE_110710_length_352_cov_17.944664	73	153	0	80	80	1.0000000
NODE_110710_length_352_cov_17.944664	273	352	0	28	79	0.3544304
NODE_110710_length_352_cov_17.944664	273	352	2	51	79	0.6455696
NODE_110735_length_352_cov_4.707510	157	237	0	9	80	0.1125000
NODE_110735_length_352_cov_4.707510	157	237	2	40	80	0.5000000
NODE_110735_length_352_cov_4.707510	157	237	6	31	80	0.3875000
NODE_110749_length_352_cov_4.221344	144	205	6	31	61	0.5081967
NODE_110749_length_352_cov_4.221344	144	205	8	30	61	0.4918033
NODE_110749_length_352_cov_4.221344	178	259	0	8	81	0.0987654
NODE_110749_length_352_cov_4.221344	178	259	2	19	81	0.2345679
NODE_110749_length_352_cov_4.221344	178	259	4	20	81	0.2469136
NODE_110749_length_352_cov_4.221344	178	259	6	34	81	0.4197531
NODE_110754_length_352_cov_4.011858	98	143	0	4	45	0.0888889
NODE_110754_length_352_cov_4.011858	98	143	2	41	45	0.9111111
NODE_110754_length_352_cov_4.011858	151	228	0	3	77	0.0389610
NODE_110754_length_352_cov_4.011858	151	228	2	68	77	0.8831169
NODE_110754_length_352_cov_4.011858	151	228	4	6	77	0.0779221
NODE_110798_length_352_cov_2.849802	74	154	0	80	80	1.0000000
NODE_110798_length_352_cov_2.849802	127	198	0	71	71	1.0000000
NODE_110820_length_352_cov_2.683794	0	77	2	34	77	0.4415585
NODE_110820_length_352_cov_2.683794	0	77	4	2	77	0.0259740
NODE_110820_length_352_cov_2.683794	0	77	6	22	77	0.2857143
NODE_110820_length_352_cov_2.683794	0	77	7	19	77	0.2467532
NODE_110820_length_352_cov_2.683794	50	130	4	2	80	0.0250000
NODE_110820_length_352_cov_2.683794	50	130	6	20	80	0.2500000
NODE_110820_length_352_cov_2.683794	50	130	7	35	80	0.4375000
NODE_110820_length_352_cov_2.683794	50	130	8	23	80	0.2875000
NODE_110832_length_352_cov_2.608696	90	136	0	46	46	1.0000000
NODE_110832_length_352_cov_2.608696	144	189	0	45	45	1.0000000
NODE_110838_length_352_cov_2.577075	111	191	0	74	80	0.9250000
NODE_110838_length_352_cov_2.577075	111	191	2	1	80	0.0125000
NODE_110838_length_352_cov_2.577075	111	191	4	3	80	0.0375000
NODE_110838_length_352_cov_2.577075	111	191	6	2	80	0.0250000
NODE_110876_length_352_cov_2.264822	171	251	0	49	80	0.6125000
NODE_110876_length_352_cov_2.264822	171	251	2	31	80	0.3875000
NODE_110938_length_352_cov_2.007905	277	326	2	27	49	0.5510204
NODE_110938_length_352_cov_2.007905	277	326	4	22	49	0.4489796
NODE_111439_length_352_cov_0.806324	165	238	25	1	73	0.0136986
NODE_111439_length_352_cov_0.806324	165	238	27	1	73	0.0136986
NODE_111439_length_352_cov_0.806324	165	238	28	1	73	0.0136986
NODE_111439_length_352_cov_0.806324	165	238	34	1	73	0.0136986
NODE_111439_length_352_cov_0.806324	165	238	38	1	73	0.0136986
NODE_111439_length_352_cov_0.806324	165	238	51	1	73	0.0136986
NODE_111439_length_352_cov_0.806324	165	238	53	1	73	0.0136986
NODE_111439_length_352_cov_0.806324	165	238	59	1	73	0.0136986
NODE_111439_length_352_cov_0.806324	165	238	69	1	73	0.0136986
NODE_111439_length_352_cov_0.806324	165	238	73	3	73	0.0410959
NODE_111439_length_352_cov_0.806324	165	238	79	1	73	0.0136986
NODE_111439_length_352_cov_0.806324	165	238	80	1	73	0.0136986
NODE_111439_length_352_cov_0.806324	165	238	81	1	73	0.0136986
NODE_111439_length_352_cov_0.806324	165	238	83	1	73	0.0136986
NODE_111439_length_352_cov_0.806324	165	238	86	2	73	0.0273973
NODE_111439_length_352_cov_0.806324	165	238	88	3	73	0.0410959
NODE_111439_length_352_cov_0.806324	165	238	90	3	73	0.0410959
NODE_111439_length_352_cov_0.806324	165	238	96	4	73	0.0547945
NODE_111439_length_352_cov_0.806324	165	238	99	1	73	0.0136986
NODE_111439_length_352_cov_0.806324	165	238	111	2	73	0.0273973
NODE_111439_length_352_cov_0.806324	165	238	113	2	73	0.0273973
NODE_111439_length_352_cov_0.806324	165	238	118	1	73	0.0136986
NODE_111439_length_352_cov_0.806324	165	238	122	4	73	0.0547945
NODE_111439_length_352_cov_0.806324	165	238	123	4	73	0.0547945
NODE_111439_length_352_cov_0.806324	165	238	125	2	73	0.0273973
NODE_111439_length_352_cov_0.806324	165	238	129	2	73	0.0273973
NODE_111439_length_352_cov_0.806324	165	238	131	1	73	0.0136986
NODE_111439_length_352_cov_0.806324	165	238	133	1	73	0.0136986
NODE_111439_length_352_cov_0.806324	165	238	137	8	73	0.1095890
NODE_111439_length_352_cov_0.806324	165	238	139	1	73	0.0136986
NODE_111439_length_352_cov_0.806324	165	238	141	4	73	0.0547945
NODE_111439_length_352_cov_0.806324	165	238	143	1	73	0.0136986
NODE_111439_length_352_cov_0.806324	165	238	145	7	73	0.0958904
NODE_111439_length_352_cov_0.806324	165	238	149	2	73	0.0273973
NODE_111439_length_352_cov_0.806324	165	238	151	2	73	0.0273973
NODE_111593_length_351_cov_5.003968	115	195	0	80	80	1.0000000
NODE_111662_length_351_cov_2.900794	289	320	0	31	31	1.0000000
NODE_111738_length_351_cov_2.376984	79	159	2	51	80	0.6375000
NODE_111738_length_351_cov_2.376984	79	159	6	5	80	0.0625000
NODE_111738_length_351_cov_2.376984	79	159	8	20	80	0.2500000
NODE_111738_length_351_cov_2.376984	79	159	10	4	80	0.0500000
NODE_111759_length_351_cov_2.226190	116	170	23	2	54	0.0370370
NODE_111759_length_351_cov_2.226190	116	170	25	50	54	0.9259259
NODE_111759_length_351_cov_2.226190	116	170	27	2	54	0.0370370
NODE_111769_length_351_cov_2.186508	198	277	2	79	79	1.0000000
NODE_111861_length_351_cov_1.809524	276	309	2	33	33	1.0000000
NODE_111969_length_351_cov_1.515873	228	299	0	45	71	0.6338028
NODE_111969_length_351_cov_1.515873	228	299	2	26	71	0.3661972
NODE_112493_length_350_cov_232.529880	25	92	78	2	67	0.0298507
NODE_112493_length_350_cov_232.529880	25	92	82	1	67	0.0149254
NODE_112493_length_350_cov_232.529880	25	92	83	1	67	0.0149254
NODE_112493_length_350_cov_232.529880	25	92	85	3	67	0.0447761
NODE_112493_length_350_cov_232.529880	25	92	91	2	67	0.0298507
NODE_112493_length_350_cov_232.529880	25	92	92	4	67	0.0597015
NODE_112493_length_350_cov_232.529880	25	92	96	3	67	0.0447761
NODE_112493_length_350_cov_232.529880	25	92	104	1	67	0.0149254
NODE_112493_length_350_cov_232.529880	25	92	106	1	67	0.0149254
NODE_112493_length_350_cov_232.529880	25	92	108	1	67	0.0149254
NODE_112493_length_350_cov_232.529880	25	92	115	1	67	0.0149254
NODE_112493_length_350_cov_232.529880	25	92	117	2	67	0.0298507
NODE_112493_length_350_cov_232.529880	25	92	120	1	67	0.0149254
NODE_112493_length_350_cov_232.529880	25	92	124	1	67	0.0149254
NODE_112493_length_350_cov_232.529880	25	92	128	2	67	0.0298507
NODE_112493_length_350_cov_232.529880	25	92	130	2	67	0.0298507
NODE_112493_length_350_cov_232.529880	25	92	132	1	67	0.0149254
NODE_112493_length_350_cov_232.529880	25	92	138	2	67	0.0298507
NODE_112493_length_350_cov_232.529880	25	92	139	7	67	0.1044776
NODE_112493_length_350_cov_232.529880	25	92	141	6	67	0.0895522
NODE_112493_length_350_cov_232.529880	25	92	143	4	67	0.0597015
NODE_112493_length_350_cov_232.529880	25	92	144	14	67	0.2089552
NODE_112493_length_350_cov_232.529880	25	92	146	3	67	0.0447761
NODE_112493_length_350_cov_232.529880	25	92	148	2	67	0.0298507
NODE_112494_length_350_cov_40.677291	181	246	159	1	65	0.0153846
NODE_112494_length_350_cov_40.677291	181	246	160	1	65	0.0153846
NODE_112494_length_350_cov_40.677291	181	246	161	1	65	0.0153846
NODE_112494_length_350_cov_40.677291	181	246	162	1	65	0.0153846
NODE_112494_length_350_cov_40.677291	181	246	163	2	65	0.0307692
NODE_112494_length_350_cov_40.677291	181	246	164	1	65	0.0153846
NODE_112494_length_350_cov_40.677291	181	246	166	1	65	0.0153846
NODE_112494_length_350_cov_40.677291	181	246	172	2	65	0.0307692
NODE_112494_length_350_cov_40.677291	181	246	174	1	65	0.0153846
NODE_112494_length_350_cov_40.677291	181	246	178	2	65	0.0307692
NODE_112494_length_350_cov_40.677291	181	246	179	1	65	0.0153846
NODE_112494_length_350_cov_40.677291	181	246	185	2	65	0.0307692
NODE_112494_length_350_cov_40.677291	181	246	187	2	65	0.0307692
NODE_112494_length_350_cov_40.677291	181	246	190	2	65	0.0307692
NODE_112494_length_350_cov_40.677291	181	246	191	2	65	0.0307692
NODE_112494_length_350_cov_40.677291	181	246	193	1	65	0.0153846
NODE_112494_length_350_cov_40.677291	181	246	194	3	65	0.0461538
NODE_112494_length_350_cov_40.677291	181	246	195	4	65	0.0615385
NODE_112494_length_350_cov_40.677291	181	246	196	6	65	0.0923077
NODE_112494_length_350_cov_40.677291	181	246	197	1	65	0.0153846
NODE_112494_length_350_cov_40.677291	181	246	198	2	65	0.0307692
NODE_112494_length_350_cov_40.677291	181	246	199	2	65	0.0307692
NODE_112494_length_350_cov_40.677291	181	246	200	2	65	0.0307692
NODE_112494_length_350_cov_40.677291	181	246	201	2	65	0.0307692
NODE_112494_length_350_cov_40.677291	181	246	202	2	65	0.0307692
NODE_112494_length_350_cov_40.677291	181	246	204	2	65	0.0307692
NODE_112494_length_350_cov_40.677291	181	246	205	5	65	0.0769231
NODE_112494_length_350_cov_40.677291	181	246	206	3	65	0.0461538
NODE_112494_length_350_cov_40.677291	181	246	207	4	65	0.0615385
NODE_112494_length_350_cov_40.677291	181	246	208	4	65	0.0615385
NODE_112535_length_350_cov_4.179283	114	194	2	23	80	0.2875000
NODE_112535_length_350_cov_4.179283	114	194	3	9	80	0.1125000
NODE_112535_length_350_cov_4.179283	114	194	4	38	80	0.4750000
NODE_112535_length_350_cov_4.179283	114	194	6	10	80	0.1250000
NODE_112535_length_350_cov_4.179283	167	244	3	2	77	0.0259740
NODE_112535_length_350_cov_4.179283	167	244	4	15	77	0.1948052
NODE_112535_length_350_cov_4.179283	167	244	6	50	77	0.6493506
NODE_112535_length_350_cov_4.179283	167	244	8	10	77	0.1298701
NODE_112554_length_350_cov_3.573705	128	202	13	2	74	0.0270270
NODE_112554_length_350_cov_3.573705	128	202	15	31	74	0.4189189
NODE_112554_length_350_cov_3.573705	128	202	39	3	74	0.0405405
NODE_112554_length_350_cov_3.573705	128	202	41	1	74	0.0135135
NODE_112554_length_350_cov_3.573705	128	202	43	2	74	0.0270270
NODE_112554_length_350_cov_3.573705	128	202	47	2	74	0.0270270
NODE_112554_length_350_cov_3.573705	128	202	49	2	74	0.0270270
NODE_112554_length_350_cov_3.573705	128	202	53	26	74	0.3513514
NODE_112554_length_350_cov_3.573705	128	202	55	5	74	0.0675676
NODE_112554_length_350_cov_3.573705	178	241	5	4	63	0.0634921
NODE_112554_length_350_cov_3.573705	178	241	6	2	63	0.0317460
NODE_112554_length_350_cov_3.573705	178	241	9	10	63	0.1587302
NODE_112554_length_350_cov_3.573705	178	241	10	4	63	0.0634921
NODE_112554_length_350_cov_3.573705	178	241	11	4	63	0.0634921
NODE_112554_length_350_cov_3.573705	178	241	12	15	63	0.2380952
NODE_112554_length_350_cov_3.573705	178	241	13	2	63	0.0317460
NODE_112554_length_350_cov_3.573705	178	241	15	22	63	0.3492064
NODE_112627_length_350_cov_2.478088	266	297	2	31	31	1.0000000
NODE_112647_length_350_cov_2.346614	97	148	110	1	51	0.0196078
NODE_112647_length_350_cov_2.346614	97	148	111	2	51	0.0392157
NODE_112647_length_350_cov_2.346614	97	148	113	1	51	0.0196078
NODE_112647_length_350_cov_2.346614	97	148	115	2	51	0.0392157
NODE_112647_length_350_cov_2.346614	97	148	117	3	51	0.0588235
NODE_112647_length_350_cov_2.346614	97	148	118	2	51	0.0392157
NODE_112647_length_350_cov_2.346614	97	148	119	4	51	0.0784314
NODE_112647_length_350_cov_2.346614	97	148	120	1	51	0.0196078
NODE_112647_length_350_cov_2.346614	97	148	121	3	51	0.0588235
NODE_112647_length_350_cov_2.346614	97	148	123	1	51	0.0196078
NODE_112647_length_350_cov_2.346614	97	148	125	2	51	0.0392157
NODE_112647_length_350_cov_2.346614	97	148	127	3	51	0.0588235
NODE_112647_length_350_cov_2.346614	97	148	129	2	51	0.0392157
NODE_112647_length_350_cov_2.346614	97	148	130	2	51	0.0392157
NODE_112647_length_350_cov_2.346614	97	148	131	2	51	0.0392157
NODE_112647_length_350_cov_2.346614	97	148	133	9	51	0.1764706
NODE_112647_length_350_cov_2.346614	97	148	134	3	51	0.0588235
NODE_112647_length_350_cov_2.346614	97	148	135	1	51	0.0196078
NODE_112647_length_350_cov_2.346614	97	148	136	1	51	0.0196078
NODE_112647_length_350_cov_2.346614	97	148	137	1	51	0.0196078
NODE_112647_length_350_cov_2.346614	97	148	138	2	51	0.0392157
NODE_112647_length_350_cov_2.346614	97	148	140	1	51	0.0196078
NODE_112647_length_350_cov_2.346614	97	148	142	1	51	0.0196078
NODE_112647_length_350_cov_2.346614	97	148	144	1	51	0.0196078
NODE_112714_length_350_cov_2.031873	181	238	25	2	57	0.0350877
NODE_112714_length_350_cov_2.031873	181	238	31	3	57	0.0526316
NODE_112714_length_350_cov_2.031873	181	238	32	3	57	0.0526316
NODE_112714_length_350_cov_2.031873	181	238	33	3	57	0.0526316
NODE_112714_length_350_cov_2.031873	181	238	38	1	57	0.0175439
NODE_112714_length_350_cov_2.031873	181	238	40	19	57	0.3333333
NODE_112714_length_350_cov_2.031873	181	238	42	8	57	0.1403509
NODE_112714_length_350_cov_2.031873	181	238	43	2	57	0.0350877
NODE_112714_length_350_cov_2.031873	181	238	44	8	57	0.1403509
NODE_112714_length_350_cov_2.031873	181	238	46	8	57	0.1403509
NODE_112997_length_350_cov_1.223108	202	275	0	42	73	0.5753425
NODE_112997_length_350_cov_1.223108	202	275	2	1	73	0.0136986
NODE_112997_length_350_cov_1.223108	202	275	4	1	73	0.0136986
NODE_112997_length_350_cov_1.223108	202	275	6	1	73	0.0136986
NODE_112997_length_350_cov_1.223108	202	275	8	8	73	0.1095890
NODE_112997_length_350_cov_1.223108	202	275	10	3	73	0.0410959
NODE_112997_length_350_cov_1.223108	202	275	12	4	73	0.0547945
NODE_112997_length_350_cov_1.223108	202	275	14	3	73	0.0410959
NODE_112997_length_350_cov_1.223108	202	275	18	3	73	0.0410959
NODE_112997_length_350_cov_1.223108	202	275	20	1	73	0.0136986
NODE_112997_length_350_cov_1.223108	202	275	22	1	73	0.0136986
NODE_112997_length_350_cov_1.223108	202	275	24	1	73	0.0136986
NODE_112997_length_350_cov_1.223108	202	275	26	2	73	0.0273973
NODE_112997_length_350_cov_1.223108	202	275	29	1	73	0.0136986
NODE_112997_length_350_cov_1.223108	202	275	32	1	73	0.0136986
NODE_113450_length_349_cov_4.268000	83	163	0	80	80	1.0000000
NODE_113450_length_349_cov_4.268000	83	163	0	80	80	1.0000000
NODE_113450_length_349_cov_4.268000	136	216	0	80	80	1.0000000
NODE_113450_length_349_cov_4.268000	145	180	0	35	35	1.0000000
NODE_113473_length_349_cov_3.648000	219	300	2	33	81	0.4074074
NODE_113473_length_349_cov_3.648000	219	300	4	48	81	0.5925926
NODE_113480_length_349_cov_3.484000	196	276	0	6	80	0.0750000
NODE_113480_length_349_cov_3.484000	196	276	2	28	80	0.3500000
NODE_113480_length_349_cov_3.484000	196	276	8	3	80	0.0375000
NODE_113480_length_349_cov_3.484000	196	276	10	22	80	0.2750000
NODE_113480_length_349_cov_3.484000	196	276	12	21	80	0.2625000
NODE_113486_length_349_cov_3.364000	219	284	0	65	65	1.0000000
NODE_113511_length_349_cov_2.916000	94	189	0	3	95	0.0315789
NODE_113511_length_349_cov_2.916000	94	189	2	23	95	0.2421053
NODE_113511_length_349_cov_2.916000	94	189	3	12	95	0.1263158
NODE_113511_length_349_cov_2.916000	94	189	4	57	95	0.6000000
NODE_113571_length_349_cov_2.420000	35	54	0	19	19	1.0000000
NODE_113647_length_349_cov_1.964000	32	63	0	31	31	1.0000000
NODE_113654_length_349_cov_1.928000	9	77	0	68	68	1.0000000
NODE_113654_length_349_cov_1.928000	62	115	0	53	53	1.0000000
NODE_113710_length_349_cov_1.684000	225	265	0	3	40	0.0750000
NODE_113710_length_349_cov_1.684000	225	265	1	2	40	0.0500000
NODE_113710_length_349_cov_1.684000	225	265	2	21	40	0.5250000
NODE_113710_length_349_cov_1.684000	225	265	4	12	40	0.3000000
NODE_113710_length_349_cov_1.684000	225	265	8	2	40	0.0500000
NODE_113825_length_349_cov_1.392000	32	95	0	63	63	1.0000000
NODE_113961_length_349_cov_1.056000	316	339	0	23	23	1.0000000
NODE_114002_length_349_cov_1.020000	177	257	2	80	80	1.0000000
NODE_114263_length_348_cov_34.867470	156	236	0	80	80	1.0000000
NODE_114263_length_348_cov_34.867470	209	289	0	80	80	1.0000000
NODE_114296_length_348_cov_4.180723	106	186	0	80	80	1.0000000
NODE_114296_length_348_cov_4.180723	159	239	0	80	80	1.0000000
NODE_114330_length_348_cov_3.277108	83	137	0	54	54	1.0000000
NODE_114330_length_348_cov_3.277108	145	197	0	52	52	1.0000000
NODE_114424_length_348_cov_2.305221	204	273	4	24	69	0.3478261
NODE_114424_length_348_cov_2.305221	204	273	5	21	69	0.3043478
NODE_114424_length_348_cov_2.305221	204	273	6	15	69	0.2173913
NODE_114424_length_348_cov_2.305221	204	273	8	9	69	0.1304348
NODE_114448_length_348_cov_2.216867	103	152	2	4	49	0.0816327
NODE_114448_length_348_cov_2.216867	103	152	4	41	49	0.8367347
NODE_114448_length_348_cov_2.216867	103	152	5	1	49	0.0204082
NODE_114448_length_348_cov_2.216867	103	152	8	3	49	0.0612245
NODE_114505_length_348_cov_1.995984	170	239	0	16	69	0.2318841
NODE_114505_length_348_cov_1.995984	170	239	2	53	69	0.7681159
NODE_114591_length_348_cov_1.638554	309	346	0	37	37	1.0000000
NODE_114643_length_348_cov_1.485944	9	60	0	51	51	1.0000000
NODE_115147_length_347_cov_15.100806	57	137	0	80	80	1.0000000
NODE_115147_length_347_cov_15.100806	110	152	0	42	42	1.0000000
NODE_115147_length_347_cov_15.100806	182	209	0	27	27	1.0000000
NODE_115147_length_347_cov_15.100806	290	317	0	27	27	1.0000000
NODE_115161_length_347_cov_5.967742	110	173	0	63	63	1.0000000
NODE_115195_length_347_cov_4.028226	260	329	0	69	69	1.0000000
NODE_115321_length_347_cov_2.463710	99	141	0	5	42	0.1190476
NODE_115321_length_347_cov_2.463710	99	141	2	37	42	0.8809524
NODE_115321_length_347_cov_2.463710	108	143	2	35	35	1.0000000
NODE_115331_length_347_cov_2.391129	35	70	8	35	35	1.0000000
NODE_115331_length_347_cov_2.391129	37	79	8	42	42	1.0000000
NODE_115331_length_347_cov_2.391129	77	105	8	28	28	1.0000000
NODE_115397_length_347_cov_2.048387	15	34	0	19	19	1.0000000
NODE_115417_length_347_cov_1.967742	205	268	0	63	63	1.0000000
NODE_115450_length_347_cov_1.818548	109	156	0	47	47	1.0000000
NODE_115771_length_347_cov_1.028226	230	255	0	25	25	1.0000000
NODE_116114_length_346_cov_74.433198	10	90	0	4	80	0.0500000
NODE_116114_length_346_cov_74.433198	10	90	11	1	80	0.0125000
NODE_116114_length_346_cov_74.433198	10	90	13	8	80	0.1000000
NODE_116114_length_346_cov_74.433198	10	90	17	14	80	0.1750000
NODE_116114_length_346_cov_74.433198	10	90	18	53	80	0.6625000
NODE_116114_length_346_cov_74.433198	19	90	13	4	71	0.0563380
NODE_116114_length_346_cov_74.433198	19	90	17	14	71	0.1971831
NODE_116114_length_346_cov_74.433198	19	90	18	53	71	0.7464789
NODE_116114_length_346_cov_74.433198	192	272	0	23	80	0.2875000
NODE_116114_length_346_cov_74.433198	192	272	2	57	80	0.7125000
NODE_116115_length_346_cov_67.834008	133	213	0	80	80	1.0000000
NODE_116115_length_346_cov_67.834008	186	266	0	80	80	1.0000000
NODE_116117_length_346_cov_10.299595	190	270	0	80	80	1.0000000
NODE_116117_length_346_cov_10.299595	243	323	0	80	80	1.0000000
NODE_116119_length_346_cov_9.566802	159	239	0	71	80	0.8875000
NODE_116119_length_346_cov_9.566802	159	239	2	9	80	0.1125000
NODE_116119_length_346_cov_9.566802	212	292	0	80	80	1.0000000
NODE_116134_length_346_cov_5.506073	157	238	2	3	81	0.0370370
NODE_116134_length_346_cov_5.506073	157	238	4	68	81	0.8395061
NODE_116134_length_346_cov_5.506073	157	238	6	3	81	0.0370370
NODE_116134_length_346_cov_5.506073	157	238	8	7	81	0.0864198
NODE_116155_length_346_cov_4.368421	205	264	0	59	59	1.0000000
NODE_116159_length_346_cov_4.032389	121	141	0	20	20	1.0000000
NODE_116184_length_346_cov_3.400810	194	253	0	59	59	1.0000000
NODE_116212_length_346_cov_3.008097	183	263	0	80	80	1.0000000
NODE_116257_length_346_cov_2.538462	47	102	0	55	55	1.0000000
NODE_116257_length_346_cov_2.538462	118	173	0	55	55	1.0000000
NODE_116439_length_346_cov_1.700405	71	107	0	36	36	1.0000000
NODE_117035_length_345_cov_47.699187	0	66	0	66	66	1.0000000
NODE_117035_length_345_cov_47.699187	39	119	0	80	80	1.0000000
NODE_117035_length_345_cov_47.699187	115	182	0	67	67	1.0000000
NODE_117035_length_345_cov_47.699187	246	311	6	65	65	1.0000000
NODE_117036_length_345_cov_13.439024	28	108	0	20	80	0.2500000
NODE_117036_length_345_cov_13.439024	28	108	2	12	80	0.1500000
NODE_117036_length_345_cov_13.439024	28	108	4	48	80	0.6000000
NODE_117036_length_345_cov_13.439024	81	161	2	39	80	0.4875000
NODE_117036_length_345_cov_13.439024	81	161	4	41	80	0.5125000
NODE_117037_length_345_cov_9.906504	224	283	0	59	59	1.0000000
NODE_117051_length_345_cov_5.475610	52	132	8	17	80	0.2125000
NODE_117051_length_345_cov_5.475610	52	132	10	8	80	0.1000000
NODE_117051_length_345_cov_5.475610	52	132	13	2	80	0.0250000
NODE_117051_length_345_cov_5.475610	52	132	15	7	80	0.0875000
NODE_117051_length_345_cov_5.475610	52	132	17	18	80	0.2250000
NODE_117051_length_345_cov_5.475610	52	132	19	26	80	0.3250000
NODE_117051_length_345_cov_5.475610	52	132	21	2	80	0.0250000
NODE_117051_length_345_cov_5.475610	105	185	8	18	80	0.2250000
NODE_117051_length_345_cov_5.475610	105	185	10	12	80	0.1500000
NODE_117051_length_345_cov_5.475610	105	185	13	2	80	0.0250000
NODE_117051_length_345_cov_5.475610	105	185	14	48	80	0.6000000
NODE_117055_length_345_cov_5.321138	104	152	0	48	48	1.0000000
NODE_117065_length_345_cov_4.524390	205	269	0	64	64	1.0000000
NODE_117075_length_345_cov_4.109756	95	157	0	13	62	0.2096774
NODE_117075_length_345_cov_4.109756	95	157	10	49	62	0.7903226
NODE_117075_length_345_cov_4.109756	162	204	10	42	42	1.0000000
NODE_117076_length_345_cov_4.073171	251	326	0	75	75	1.0000000
NODE_117084_length_345_cov_3.776423	199	273	0	3	74	0.0405405
NODE_117084_length_345_cov_3.776423	199	273	2	71	74	0.9594595
NODE_117084_length_345_cov_3.776423	246	326	0	56	80	0.7000000
NODE_117084_length_345_cov_3.776423	246	326	2	24	80	0.3000000
NODE_117148_length_345_cov_2.821138	61	141	0	80	80	1.0000000
NODE_117205_length_345_cov_2.333333	47	90	4	3	43	0.0697674
NODE_117205_length_345_cov_2.333333	47	90	8	1	43	0.0232558
NODE_117205_length_345_cov_2.333333	47	90	10	3	43	0.0697674
NODE_117205_length_345_cov_2.333333	47	90	12	4	43	0.0930233
NODE_117205_length_345_cov_2.333333	47	90	14	4	43	0.0930233
NODE_117205_length_345_cov_2.333333	47	90	16	1	43	0.0232558
NODE_117205_length_345_cov_2.333333	47	90	18	1	43	0.0232558
NODE_117205_length_345_cov_2.333333	47	90	20	3	43	0.0697674
NODE_117205_length_345_cov_2.333333	47	90	21	8	43	0.1860465
NODE_117205_length_345_cov_2.333333	47	90	23	1	43	0.0232558
NODE_117205_length_345_cov_2.333333	47	90	25	3	43	0.0697674
NODE_117205_length_345_cov_2.333333	47	90	27	6	43	0.1395349
NODE_117205_length_345_cov_2.333333	47	90	29	2	43	0.0465116
NODE_117205_length_345_cov_2.333333	47	90	31	3	43	0.0697674
NODE_117205_length_345_cov_2.333333	63	147	18	1	84	0.0119048
NODE_117205_length_345_cov_2.333333	63	147	20	3	84	0.0357143
NODE_117205_length_345_cov_2.333333	63	147	21	8	84	0.0952381
NODE_117205_length_345_cov_2.333333	63	147	23	1	84	0.0119048
NODE_117205_length_345_cov_2.333333	63	147	25	3	84	0.0357143
NODE_117205_length_345_cov_2.333333	63	147	26	2	84	0.0238095
NODE_117205_length_345_cov_2.333333	63	147	27	6	84	0.0714286
NODE_117205_length_345_cov_2.333333	63	147	28	2	84	0.0238095
NODE_117205_length_345_cov_2.333333	63	147	29	2	84	0.0238095
NODE_117205_length_345_cov_2.333333	63	147	30	14	84	0.1666667
NODE_117205_length_345_cov_2.333333	63	147	31	9	84	0.1071429
NODE_117205_length_345_cov_2.333333	63	147	32	33	84	0.3928571
NODE_117219_length_345_cov_2.239837	0	81	0	1	81	0.0123457
NODE_117219_length_345_cov_2.239837	0	81	3	2	81	0.0246914
NODE_117219_length_345_cov_2.239837	0	81	4	2	81	0.0246914
NODE_117219_length_345_cov_2.239837	0	81	7	2	81	0.0246914
NODE_117219_length_345_cov_2.239837	0	81	9	2	81	0.0246914
NODE_117219_length_345_cov_2.239837	0	81	10	6	81	0.0740741
NODE_117219_length_345_cov_2.239837	0	81	12	13	81	0.1604938
NODE_117219_length_345_cov_2.239837	0	81	14	6	81	0.0740741
NODE_117219_length_345_cov_2.239837	0	81	18	13	81	0.1604938
NODE_117219_length_345_cov_2.239837	0	81	20	1	81	0.0123457
NODE_117219_length_345_cov_2.239837	0	81	22	4	81	0.0493827
NODE_117219_length_345_cov_2.239837	0	81	24	3	81	0.0370370
NODE_117219_length_345_cov_2.239837	0	81	28	10	81	0.1234568
NODE_117219_length_345_cov_2.239837	0	81	30	16	81	0.1975309
NODE_117669_length_345_cov_1.040650	6	73	0	5	67	0.0746269
NODE_117669_length_345_cov_1.040650	6	73	2	14	67	0.2089552
NODE_117669_length_345_cov_1.040650	6	73	4	12	67	0.1791045
NODE_117669_length_345_cov_1.040650	6	73	7	1	67	0.0149254
NODE_117669_length_345_cov_1.040650	6	73	8	1	67	0.0149254
NODE_117669_length_345_cov_1.040650	6	73	10	13	67	0.1940299
NODE_117669_length_345_cov_1.040650	6	73	12	21	67	0.3134328
NODE_117989_length_344_cov_54.020408	6	55	0	38	49	0.7755102
NODE_117989_length_344_cov_54.020408	6	55	4	11	49	0.2244898
NODE_117989_length_344_cov_54.020408	28	105	0	16	77	0.2077922
NODE_117989_length_344_cov_54.020408	28	105	4	13	77	0.1688312
NODE_117989_length_344_cov_54.020408	28	105	6	27	77	0.3506494
NODE_117989_length_344_cov_54.020408	28	105	8	21	77	0.2727273
NODE_117989_length_344_cov_54.020408	28	105	0	16	77	0.2077922
NODE_117989_length_344_cov_54.020408	28	105	4	13	77	0.1688312
NODE_117989_length_344_cov_54.020408	28	105	6	27	77	0.3506494
NODE_117989_length_344_cov_54.020408	28	105	8	21	77	0.2727273
NODE_117989_length_344_cov_54.020408	112	178	8	7	66	0.1060606
NODE_117989_length_344_cov_54.020408	112	178	10	28	66	0.4242424
NODE_117989_length_344_cov_54.020408	112	178	12	31	66	0.4696970
NODE_118009_length_344_cov_5.016327	72	125	19	4	53	0.0754717
NODE_118009_length_344_cov_5.016327	72	125	21	4	53	0.0754717
NODE_118009_length_344_cov_5.016327	72	125	26	4	53	0.0754717
NODE_118009_length_344_cov_5.016327	72	125	28	2	53	0.0377358
NODE_118009_length_344_cov_5.016327	72	125	32	1	53	0.0188679
NODE_118009_length_344_cov_5.016327	72	125	40	2	53	0.0377358
NODE_118009_length_344_cov_5.016327	72	125	44	1	53	0.0188679
NODE_118009_length_344_cov_5.016327	72	125	46	6	53	0.1132075
NODE_118009_length_344_cov_5.016327	72	125	48	29	53	0.5471698
NODE_118009_length_344_cov_5.016327	136	203	16	8	67	0.1194030
NODE_118009_length_344_cov_5.016327	136	203	18	9	67	0.1343284
NODE_118009_length_344_cov_5.016327	136	203	20	1	67	0.0149254
NODE_118009_length_344_cov_5.016327	136	203	24	3	67	0.0447761
NODE_118009_length_344_cov_5.016327	136	203	28	3	67	0.0447761
NODE_118009_length_344_cov_5.016327	136	203	32	2	67	0.0298507
NODE_118009_length_344_cov_5.016327	136	203	34	3	67	0.0447761
NODE_118009_length_344_cov_5.016327	136	203	40	27	67	0.4029851
NODE_118009_length_344_cov_5.016327	136	203	42	7	67	0.1044776
NODE_118009_length_344_cov_5.016327	136	203	44	4	67	0.0597015
NODE_118017_length_344_cov_4.579592	172	254	0	17	82	0.2073171
NODE_118017_length_344_cov_4.579592	172	254	2	65	82	0.7926829
NODE_118045_length_344_cov_3.840816	197	240	2	43	43	1.0000000
NODE_118074_length_344_cov_3.293878	149	189	6	3	40	0.0750000
NODE_118074_length_344_cov_3.293878	149	189	8	37	40	0.9250000
NODE_118074_length_344_cov_3.293878	162	229	2	11	67	0.1641791
NODE_118074_length_344_cov_3.293878	162	229	4	28	67	0.4179105
NODE_118074_length_344_cov_3.293878	162	229	6	4	67	0.0597015
NODE_118074_length_344_cov_3.293878	162	229	8	24	67	0.3582090
NODE_118111_length_344_cov_2.751020	24	87	0	13	63	0.2063492
NODE_118111_length_344_cov_2.751020	24	87	2	50	63	0.7936508
NODE_118179_length_344_cov_2.126531	274	305	4	31	31	1.0000000
NODE_118243_length_344_cov_1.914286	114	194	0	80	80	1.0000000
NODE_118243_length_344_cov_1.914286	167	247	0	58	80	0.7250000
NODE_118243_length_344_cov_1.914286	167	247	2	22	80	0.2750000
NODE_118297_length_344_cov_1.685714	180	220	0	35	40	0.8750000
NODE_118297_length_344_cov_1.685714	180	220	2	5	40	0.1250000
NODE_118393_length_344_cov_1.457143	160	240	16	13	80	0.1625000
NODE_118393_length_344_cov_1.457143	160	240	18	67	80	0.8375000
NODE_118393_length_344_cov_1.457143	213	273	6	3	60	0.0500000
NODE_118393_length_344_cov_1.457143	213	273	8	3	60	0.0500000
NODE_118393_length_344_cov_1.457143	213	273	10	6	60	0.1000000
NODE_118393_length_344_cov_1.457143	213	273	12	6	60	0.1000000
NODE_118393_length_344_cov_1.457143	213	273	14	14	60	0.2333333
NODE_118393_length_344_cov_1.457143	213	273	16	7	60	0.1166667
NODE_118393_length_344_cov_1.457143	213	273	18	21	60	0.3500000
NODE_118743_length_344_cov_0.800000	123	163	0	40	40	1.0000000
NODE_118899_length_343_cov_3.770492	2	60	0	58	58	1.0000000
NODE_118905_length_343_cov_3.598361	97	170	10	19	73	0.2602740
NODE_118905_length_343_cov_3.598361	97	170	12	5	73	0.0684932
NODE_118905_length_343_cov_3.598361	97	170	14	49	73	0.6712329
NODE_118905_length_343_cov_3.598361	150	223	0	25	73	0.3424658
NODE_118905_length_343_cov_3.598361	150	223	2	1	73	0.0136986
NODE_118905_length_343_cov_3.598361	150	223	4	1	73	0.0136986
NODE_118905_length_343_cov_3.598361	150	223	6	4	73	0.0547945
NODE_118905_length_343_cov_3.598361	150	223	8	2	73	0.0273973
NODE_118905_length_343_cov_3.598361	150	223	12	12	73	0.1643836
NODE_118905_length_343_cov_3.598361	150	223	14	28	73	0.3835616
NODE_118911_length_343_cov_3.401639	48	128	10	3	80	0.0375000
NODE_118911_length_343_cov_3.401639	48	128	12	7	80	0.0875000
NODE_118911_length_343_cov_3.401639	48	128	14	3	80	0.0375000
NODE_118911_length_343_cov_3.401639	48	128	16	6	80	0.0750000
NODE_118911_length_343_cov_3.401639	48	128	20	1	80	0.0125000
NODE_118911_length_343_cov_3.401639	48	128	22	5	80	0.0625000
NODE_118911_length_343_cov_3.401639	48	128	24	2	80	0.0250000
NODE_118911_length_343_cov_3.401639	48	128	26	1	80	0.0125000
NODE_118911_length_343_cov_3.401639	48	128	28	1	80	0.0125000
NODE_118911_length_343_cov_3.401639	48	128	30	1	80	0.0125000
NODE_118911_length_343_cov_3.401639	48	128	32	6	80	0.0750000
NODE_118911_length_343_cov_3.401639	48	128	34	5	80	0.0625000
NODE_118911_length_343_cov_3.401639	48	128	36	23	80	0.2875000
NODE_118911_length_343_cov_3.401639	48	128	37	1	80	0.0125000
NODE_118911_length_343_cov_3.401639	48	128	38	1	80	0.0125000
NODE_118911_length_343_cov_3.401639	48	128	40	5	80	0.0625000
NODE_118911_length_343_cov_3.401639	48	128	41	1	80	0.0125000
NODE_118911_length_343_cov_3.401639	48	128	42	4	80	0.0500000
NODE_118911_length_343_cov_3.401639	48	128	44	4	80	0.0500000
NODE_118941_length_343_cov_3.049180	12	62	0	2	50	0.0400000
NODE_118941_length_343_cov_3.049180	12	62	6	48	50	0.9600000
NODE_118941_length_343_cov_3.049180	82	111	8	29	29	1.0000000
NODE_118941_length_343_cov_3.049180	133	205	0	55	72	0.7638889
NODE_118941_length_343_cov_3.049180	133	205	2	17	72	0.2361111
NODE_118957_length_343_cov_2.770492	236	316	6	1	80	0.0125000
NODE_118957_length_343_cov_2.770492	236	316	8	13	80	0.1625000
NODE_118957_length_343_cov_2.770492	236	316	10	7	80	0.0875000
NODE_118957_length_343_cov_2.770492	236	316	12	13	80	0.1625000
NODE_118957_length_343_cov_2.770492	236	316	14	1	80	0.0125000
NODE_118957_length_343_cov_2.770492	236	316	20	1	80	0.0125000
NODE_118957_length_343_cov_2.770492	236	316	22	3	80	0.0375000
NODE_118957_length_343_cov_2.770492	236	316	24	1	80	0.0125000
NODE_118957_length_343_cov_2.770492	236	316	25	1	80	0.0125000
NODE_118957_length_343_cov_2.770492	236	316	27	1	80	0.0125000
NODE_118957_length_343_cov_2.770492	236	316	28	3	80	0.0375000
NODE_118957_length_343_cov_2.770492	236	316	30	1	80	0.0125000
NODE_118957_length_343_cov_2.770492	236	316	32	3	80	0.0375000
NODE_118957_length_343_cov_2.770492	236	316	34	6	80	0.0750000
NODE_118957_length_343_cov_2.770492	236	316	36	1	80	0.0125000
NODE_118957_length_343_cov_2.770492	236	316	40	2	80	0.0250000
NODE_118957_length_343_cov_2.770492	236	316	46	15	80	0.1875000
NODE_118957_length_343_cov_2.770492	236	316	48	1	80	0.0125000
NODE_118957_length_343_cov_2.770492	236	316	50	6	80	0.0750000
NODE_118978_length_343_cov_2.590164	167	225	2	48	58	0.8275862
NODE_118978_length_343_cov_2.590164	167	225	6	10	58	0.1724138
NODE_118998_length_343_cov_2.430328	208	274	1	37	66	0.5606061
NODE_118998_length_343_cov_2.430328	208	274	2	3	66	0.0454545
NODE_118998_length_343_cov_2.430328	208	274	3	13	66	0.1969697
NODE_118998_length_343_cov_2.430328	208	274	4	13	66	0.1969697
NODE_119040_length_343_cov_2.209016	32	111	0	58	79	0.7341772
NODE_119040_length_343_cov_2.209016	32	111	2	21	79	0.2658228
NODE_119067_length_343_cov_2.081967	95	177	4	69	82	0.8414634
NODE_119067_length_343_cov_2.081967	95	177	6	13	82	0.1585366
NODE_119067_length_343_cov_2.081967	150	199	4	14	49	0.2857143
NODE_119067_length_343_cov_2.081967	150	199	6	35	49	0.7142857
NODE_119202_length_343_cov_1.635246	0	52	0	52	52	1.0000000
NODE_119439_length_343_cov_1.143443	60	120	0	3	60	0.0500000
NODE_119439_length_343_cov_1.143443	60	120	2	57	60	0.9500000
NODE_119834_length_342_cov_3.872428	136	216	2	32	80	0.4000000
NODE_119834_length_342_cov_3.872428	136	216	4	48	80	0.6000000
NODE_119834_length_342_cov_3.872428	189	259	0	12	70	0.1714286
NODE_119834_length_342_cov_3.872428	189	259	2	5	70	0.0714286
NODE_119834_length_342_cov_3.872428	189	259	4	53	70	0.7571428
NODE_119840_length_342_cov_3.769547	146	212	0	66	66	1.0000000
NODE_119841_length_342_cov_3.740741	113	146	1	33	33	1.0000000
NODE_119846_length_342_cov_3.674897	20	100	0	15	80	0.1875000
NODE_119846_length_342_cov_3.674897	20	100	2	65	80	0.8125000
NODE_119846_length_342_cov_3.674897	73	153	0	16	80	0.2000000
NODE_119846_length_342_cov_3.674897	73	153	2	28	80	0.3500000
NODE_119846_length_342_cov_3.674897	73	153	4	36	80	0.4500000
NODE_119847_length_342_cov_3.588477	117	197	0	20	80	0.2500000
NODE_119847_length_342_cov_3.588477	117	197	2	26	80	0.3250000
NODE_119847_length_342_cov_3.588477	117	197	4	34	80	0.4250000
NODE_119849_length_342_cov_3.530864	72	151	0	12	79	0.1518987
NODE_119849_length_342_cov_3.530864	72	151	1	6	79	0.0759494
NODE_119849_length_342_cov_3.530864	72	151	2	43	79	0.5443038
NODE_119849_length_342_cov_3.530864	72	151	3	8	79	0.1012658
NODE_119849_length_342_cov_3.530864	72	151	4	10	79	0.1265823
NODE_119852_length_342_cov_3.423868	172	252	0	80	80	1.0000000
NODE_119852_length_342_cov_3.423868	225	283	0	58	58	1.0000000
NODE_119922_length_342_cov_2.432099	16	81	0	56	65	0.8615385
NODE_119922_length_342_cov_2.432099	16	81	3	9	65	0.1384615
NODE_119993_length_342_cov_2.049383	249	317	0	68	68	1.0000000
NODE_120047_length_342_cov_1.864198	138	190	4	1	52	0.0192308
NODE_120047_length_342_cov_1.864198	138	190	6	5	52	0.0961538
NODE_120047_length_342_cov_1.864198	138	190	8	9	52	0.1730769
NODE_120047_length_342_cov_1.864198	138	190	10	18	52	0.3461539
NODE_120047_length_342_cov_1.864198	138	190	12	19	52	0.3653846
NODE_120047_length_342_cov_1.864198	183	243	2	21	60	0.3500000
NODE_120047_length_342_cov_1.864198	183	243	4	33	60	0.5500000
NODE_120047_length_342_cov_1.864198	183	243	6	5	60	0.0833333
NODE_120047_length_342_cov_1.864198	183	243	10	1	60	0.0166667
NODE_120073_length_342_cov_1.720165	91	147	14	18	56	0.3214286
NODE_120073_length_342_cov_1.720165	91	147	16	3	56	0.0535714
NODE_120073_length_342_cov_1.720165	91	147	18	35	56	0.6250000
NODE_120284_length_342_cov_1.271605	201	240	2	20	39	0.5128205
NODE_120284_length_342_cov_1.271605	201	240	4	19	39	0.4871795
NODE_120755_length_341_cov_15.896694	50	130	0	80	80	1.0000000
NODE_120755_length_341_cov_15.896694	103	183	0	65	80	0.8125000
NODE_120755_length_341_cov_15.896694	103	183	2	15	80	0.1875000
NODE_120757_length_341_cov_9.756198	117	196	0	34	79	0.4303797
NODE_120757_length_341_cov_9.756198	117	196	2	1	79	0.0126582
NODE_120757_length_341_cov_9.756198	117	196	6	1	79	0.0126582
NODE_120757_length_341_cov_9.756198	117	196	10	43	79	0.5443038
NODE_120770_length_341_cov_5.404959	141	220	0	36	79	0.4556962
NODE_120770_length_341_cov_5.404959	141	220	1	12	79	0.1518987
NODE_120770_length_341_cov_5.404959	141	220	2	7	79	0.0886076
NODE_120770_length_341_cov_5.404959	141	220	6	19	79	0.2405063
NODE_120770_length_341_cov_5.404959	141	220	8	5	79	0.0632911
NODE_120780_length_341_cov_4.669421	301	320	0	19	19	1.0000000
NODE_120783_length_341_cov_4.438017	57	132	0	20	75	0.2666667
NODE_120783_length_341_cov_4.438017	57	132	2	55	75	0.7333333
NODE_120783_length_341_cov_4.438017	110	185	1	14	75	0.1866667
NODE_120783_length_341_cov_4.438017	110	185	2	39	75	0.5200000
NODE_120783_length_341_cov_4.438017	110	185	3	17	75	0.2266667
NODE_120783_length_341_cov_4.438017	110	185	4	5	75	0.0666667
NODE_120785_length_341_cov_4.400826	164	244	0	80	80	1.0000000
NODE_120785_length_341_cov_4.400826	224	297	0	73	73	1.0000000
NODE_120797_length_341_cov_3.896694	58	122	6	18	64	0.2812500
NODE_120797_length_341_cov_3.896694	58	122	12	29	64	0.4531250
NODE_120797_length_341_cov_3.896694	58	122	14	17	64	0.2656250
NODE_120805_length_341_cov_3.727273	191	273	4	29	82	0.3536585
NODE_120805_length_341_cov_3.727273	191	273	6	9	82	0.1097561
NODE_120805_length_341_cov_3.727273	191	273	8	4	82	0.0487805
NODE_120805_length_341_cov_3.727273	191	273	10	5	82	0.0609756
NODE_120805_length_341_cov_3.727273	191	273	12	35	82	0.4268293
NODE_120805_length_341_cov_3.727273	253	326	1	23	73	0.3150685
NODE_120805_length_341_cov_3.727273	253	326	3	6	73	0.0821918
NODE_120805_length_341_cov_3.727273	253	326	4	44	73	0.6027398
NODE_120839_length_341_cov_3.000000	91	161	10	70	70	1.0000000
NODE_120839_length_341_cov_3.000000	146	215	0	30	69	0.4347826
NODE_120839_length_341_cov_3.000000	146	215	2	9	69	0.1304348
NODE_120839_length_341_cov_3.000000	146	215	6	5	69	0.0724638
NODE_120839_length_341_cov_3.000000	146	215	10	25	69	0.3623188
NODE_120840_length_341_cov_3.000000	127	207	12	14	80	0.1750000
NODE_120840_length_341_cov_3.000000	127	207	13	8	80	0.1000000
NODE_120840_length_341_cov_3.000000	127	207	14	4	80	0.0500000
NODE_120840_length_341_cov_3.000000	127	207	15	9	80	0.1125000
NODE_120840_length_341_cov_3.000000	127	207	16	19	80	0.2375000
NODE_120840_length_341_cov_3.000000	127	207	18	26	80	0.3250000
NODE_120892_length_341_cov_2.533058	92	172	2	31	80	0.3875000
NODE_120892_length_341_cov_2.533058	92	172	4	49	80	0.6125000
NODE_120901_length_341_cov_2.495868	8	89	0	81	81	1.0000000
NODE_120946_length_341_cov_2.235537	10	90	0	80	80	1.0000000
NODE_120972_length_341_cov_2.103306	46	125	2	79	79	1.0000000
NODE_120994_length_341_cov_2.066116	147	184	13	3	37	0.0810811
NODE_120994_length_341_cov_2.066116	147	184	15	5	37	0.1351351
NODE_120994_length_341_cov_2.066116	147	184	17	29	37	0.7837838
NODE_121052_length_341_cov_1.772727	179	250	0	71	71	1.0000000
NODE_121064_length_341_cov_1.727273	105	185	0	80	80	1.0000000
NODE_121160_length_341_cov_1.475207	120	185	6	21	65	0.3230769
NODE_121160_length_341_cov_1.475207	120	185	8	18	65	0.2769231
NODE_121160_length_341_cov_1.475207	120	185	10	26	65	0.4000000
NODE_121160_length_341_cov_1.475207	158	238	2	31	80	0.3875000
NODE_121160_length_341_cov_1.475207	158	238	4	20	80	0.2500000
NODE_121160_length_341_cov_1.475207	158	238	6	10	80	0.1250000
NODE_121160_length_341_cov_1.475207	158	238	8	16	80	0.2000000
NODE_121160_length_341_cov_1.475207	158	238	10	3	80	0.0375000
NODE_121173_length_341_cov_1.471074	186	266	0	11	80	0.1375000
NODE_121173_length_341_cov_1.471074	186	266	4	28	80	0.3500000
NODE_121173_length_341_cov_1.471074	186	266	6	1	80	0.0125000
NODE_121173_length_341_cov_1.471074	186	266	8	40	80	0.5000000
NODE_121173_length_341_cov_1.471074	239	319	0	31	80	0.3875000
NODE_121173_length_341_cov_1.471074	239	319	2	2	80	0.0250000
NODE_121173_length_341_cov_1.471074	239	319	4	25	80	0.3125000
NODE_121173_length_341_cov_1.471074	239	319	8	22	80	0.2750000
NODE_121211_length_341_cov_1.342975	284	322	0	30	38	0.7894737
NODE_121211_length_341_cov_1.342975	284	322	2	8	38	0.2105263
NODE_121431_length_341_cov_0.991736	36	89	0	53	53	1.0000000
NODE_121693_length_340_cov_541.348548	86	144	363	1	58	0.0172414
NODE_121693_length_340_cov_541.348548	86	144	365	1	58	0.0172414
NODE_121693_length_340_cov_541.348548	86	144	384	1	58	0.0172414
NODE_121693_length_340_cov_541.348548	86	144	389	1	58	0.0172414
NODE_121693_length_340_cov_541.348548	86	144	399	1	58	0.0172414
NODE_121693_length_340_cov_541.348548	86	144	405	1	58	0.0172414
NODE_121693_length_340_cov_541.348548	86	144	419	1	58	0.0172414
NODE_121693_length_340_cov_541.348548	86	144	423	1	58	0.0172414
NODE_121693_length_340_cov_541.348548	86	144	432	1	58	0.0172414
NODE_121693_length_340_cov_541.348548	86	144	443	1	58	0.0172414
NODE_121693_length_340_cov_541.348548	86	144	446	1	58	0.0172414
NODE_121693_length_340_cov_541.348548	86	144	452	1	58	0.0172414
NODE_121693_length_340_cov_541.348548	86	144	463	1	58	0.0172414
NODE_121693_length_340_cov_541.348548	86	144	500	1	58	0.0172414
NODE_121693_length_340_cov_541.348548	86	144	516	1	58	0.0172414
NODE_121693_length_340_cov_541.348548	86	144	521	1	58	0.0172414
NODE_121693_length_340_cov_541.348548	86	144	540	1	58	0.0172414
NODE_121693_length_340_cov_541.348548	86	144	547	1	58	0.0172414
NODE_121693_length_340_cov_541.348548	86	144	553	1	58	0.0172414
NODE_121693_length_340_cov_541.348548	86	144	562	1	58	0.0172414
NODE_121693_length_340_cov_541.348548	86	144	575	1	58	0.0172414
NODE_121693_length_340_cov_541.348548	86	144	611	1	58	0.0172414
NODE_121693_length_340_cov_541.348548	86	144	612	1	58	0.0172414
NODE_121693_length_340_cov_541.348548	86	144	624	1	58	0.0172414
NODE_121693_length_340_cov_541.348548	86	144	631	1	58	0.0172414
NODE_121693_length_340_cov_541.348548	86	144	640	1	58	0.0172414
NODE_121693_length_340_cov_541.348548	86	144	666	2	58	0.0344828
NODE_121693_length_340_cov_541.348548	86	144	673	1	58	0.0172414
NODE_121693_length_340_cov_541.348548	86	144	681	1	58	0.0172414
NODE_121693_length_340_cov_541.348548	86	144	697	1	58	0.0172414
NODE_121693_length_340_cov_541.348548	86	144	711	1	58	0.0172414
NODE_121693_length_340_cov_541.348548	86	144	714	2	58	0.0344828
NODE_121693_length_340_cov_541.348548	86	144	755	1	58	0.0172414
NODE_121693_length_340_cov_541.348548	86	144	759	1	58	0.0172414
NODE_121693_length_340_cov_541.348548	86	144	769	1	58	0.0172414
NODE_121693_length_340_cov_541.348548	86	144	782	1	58	0.0172414
NODE_121693_length_340_cov_541.348548	86	144	788	1	58	0.0172414
NODE_121693_length_340_cov_541.348548	86	144	797	1	58	0.0172414
NODE_121693_length_340_cov_541.348548	86	144	803	1	58	0.0172414
NODE_121693_length_340_cov_541.348548	86	144	813	1	58	0.0172414
NODE_121693_length_340_cov_541.348548	86	144	821	1	58	0.0172414
NODE_121693_length_340_cov_541.348548	86	144	841	1	58	0.0172414
NODE_121693_length_340_cov_541.348548	86	144	851	1	58	0.0172414
NODE_121693_length_340_cov_541.348548	86	144	875	2	58	0.0344828
NODE_121693_length_340_cov_541.348548	86	144	879	1	58	0.0172414
NODE_121693_length_340_cov_541.348548	86	144	890	1	58	0.0172414
NODE_121693_length_340_cov_541.348548	86	144	916	1	58	0.0172414
NODE_121693_length_340_cov_541.348548	86	144	936	1	58	0.0172414
NODE_121693_length_340_cov_541.348548	86	144	955	1	58	0.0172414
NODE_121693_length_340_cov_541.348548	86	144	971	1	58	0.0172414
NODE_121693_length_340_cov_541.348548	86	144	997	1	58	0.0172414
NODE_121693_length_340_cov_541.348548	86	144	1012	1	58	0.0172414
NODE_121693_length_340_cov_541.348548	86	144	1036	1	58	0.0172414
NODE_121693_length_340_cov_541.348548	86	144	1040	1	58	0.0172414
NODE_121693_length_340_cov_541.348548	86	144	1061	1	58	0.0172414
NODE_121693_length_340_cov_541.348548	86	154	363	1	68	0.0147059
NODE_121693_length_340_cov_541.348548	86	154	365	1	68	0.0147059
NODE_121693_length_340_cov_541.348548	86	154	384	1	68	0.0147059
NODE_121693_length_340_cov_541.348548	86	154	389	1	68	0.0147059
NODE_121693_length_340_cov_541.348548	86	154	399	1	68	0.0147059
NODE_121693_length_340_cov_541.348548	86	154	405	1	68	0.0147059
NODE_121693_length_340_cov_541.348548	86	154	419	1	68	0.0147059
NODE_121693_length_340_cov_541.348548	86	154	423	1	68	0.0147059
NODE_121693_length_340_cov_541.348548	86	154	432	1	68	0.0147059
NODE_121693_length_340_cov_541.348548	86	154	443	1	68	0.0147059
NODE_121693_length_340_cov_541.348548	86	154	446	1	68	0.0147059
NODE_121693_length_340_cov_541.348548	86	154	452	1	68	0.0147059
NODE_121693_length_340_cov_541.348548	86	154	463	1	68	0.0147059
NODE_121693_length_340_cov_541.348548	86	154	500	1	68	0.0147059
NODE_121693_length_340_cov_541.348548	86	154	516	1	68	0.0147059
NODE_121693_length_340_cov_541.348548	86	154	521	1	68	0.0147059
NODE_121693_length_340_cov_541.348548	86	154	540	1	68	0.0147059
NODE_121693_length_340_cov_541.348548	86	154	547	1	68	0.0147059
NODE_121693_length_340_cov_541.348548	86	154	553	1	68	0.0147059
NODE_121693_length_340_cov_541.348548	86	154	562	1	68	0.0147059
NODE_121693_length_340_cov_541.348548	86	154	575	1	68	0.0147059
NODE_121693_length_340_cov_541.348548	86	154	611	1	68	0.0147059
NODE_121693_length_340_cov_541.348548	86	154	612	1	68	0.0147059
NODE_121693_length_340_cov_541.348548	86	154	624	1	68	0.0147059
NODE_121693_length_340_cov_541.348548	86	154	631	1	68	0.0147059
NODE_121693_length_340_cov_541.348548	86	154	640	1	68	0.0147059
NODE_121693_length_340_cov_541.348548	86	154	666	2	68	0.0294118
NODE_121693_length_340_cov_541.348548	86	154	673	1	68	0.0147059
NODE_121693_length_340_cov_541.348548	86	154	681	1	68	0.0147059
NODE_121693_length_340_cov_541.348548	86	154	697	1	68	0.0147059
NODE_121693_length_340_cov_541.348548	86	154	711	1	68	0.0147059
NODE_121693_length_340_cov_541.348548	86	154	714	2	68	0.0294118
NODE_121693_length_340_cov_541.348548	86	154	755	1	68	0.0147059
NODE_121693_length_340_cov_541.348548	86	154	759	1	68	0.0147059
NODE_121693_length_340_cov_541.348548	86	154	769	1	68	0.0147059
NODE_121693_length_340_cov_541.348548	86	154	782	1	68	0.0147059
NODE_121693_length_340_cov_541.348548	86	154	788	1	68	0.0147059
NODE_121693_length_340_cov_541.348548	86	154	797	1	68	0.0147059
NODE_121693_length_340_cov_541.348548	86	154	803	1	68	0.0147059
NODE_121693_length_340_cov_541.348548	86	154	813	1	68	0.0147059
NODE_121693_length_340_cov_541.348548	86	154	821	1	68	0.0147059
NODE_121693_length_340_cov_541.348548	86	154	841	1	68	0.0147059
NODE_121693_length_340_cov_541.348548	86	154	851	1	68	0.0147059
NODE_121693_length_340_cov_541.348548	86	154	875	2	68	0.0294118
NODE_121693_length_340_cov_541.348548	86	154	879	1	68	0.0147059
NODE_121693_length_340_cov_541.348548	86	154	890	1	68	0.0147059
NODE_121693_length_340_cov_541.348548	86	154	916	1	68	0.0147059
NODE_121693_length_340_cov_541.348548	86	154	936	1	68	0.0147059
NODE_121693_length_340_cov_541.348548	86	154	955	1	68	0.0147059
NODE_121693_length_340_cov_541.348548	86	154	971	1	68	0.0147059
NODE_121693_length_340_cov_541.348548	86	154	997	1	68	0.0147059
NODE_121693_length_340_cov_541.348548	86	154	1012	1	68	0.0147059
NODE_121693_length_340_cov_541.348548	86	154	1036	1	68	0.0147059
NODE_121693_length_340_cov_541.348548	86	154	1040	1	68	0.0147059
NODE_121693_length_340_cov_541.348548	86	154	1061	1	68	0.0147059
NODE_121693_length_340_cov_541.348548	86	154	1079	1	68	0.0147059
NODE_121693_length_340_cov_541.348548	86	154	1089	1	68	0.0147059
NODE_121693_length_340_cov_541.348548	86	154	1091	1	68	0.0147059
NODE_121693_length_340_cov_541.348548	86	154	1093	1	68	0.0147059
NODE_121693_length_340_cov_541.348548	86	154	1097	1	68	0.0147059
NODE_121693_length_340_cov_541.348548	86	154	1100	1	68	0.0147059
NODE_121693_length_340_cov_541.348548	86	154	1102	1	68	0.0147059
NODE_121693_length_340_cov_541.348548	86	154	1103	1	68	0.0147059
NODE_121693_length_340_cov_541.348548	86	154	1109	1	68	0.0147059
NODE_121693_length_340_cov_541.348548	86	154	1139	1	68	0.0147059
NODE_121693_length_340_cov_541.348548	86	107	363	1	21	0.0476190
NODE_121693_length_340_cov_541.348548	86	107	365	1	21	0.0476190
NODE_121693_length_340_cov_541.348548	86	107	384	1	21	0.0476190
NODE_121693_length_340_cov_541.348548	86	107	389	1	21	0.0476190
NODE_121693_length_340_cov_541.348548	86	107	399	1	21	0.0476190
NODE_121693_length_340_cov_541.348548	86	107	405	1	21	0.0476190
NODE_121693_length_340_cov_541.348548	86	107	419	1	21	0.0476190
NODE_121693_length_340_cov_541.348548	86	107	423	1	21	0.0476190
NODE_121693_length_340_cov_541.348548	86	107	432	1	21	0.0476190
NODE_121693_length_340_cov_541.348548	86	107	443	1	21	0.0476190
NODE_121693_length_340_cov_541.348548	86	107	446	1	21	0.0476190
NODE_121693_length_340_cov_541.348548	86	107	452	1	21	0.0476190
NODE_121693_length_340_cov_541.348548	86	107	463	1	21	0.0476190
NODE_121693_length_340_cov_541.348548	86	107	500	1	21	0.0476190
NODE_121693_length_340_cov_541.348548	86	107	516	1	21	0.0476190
NODE_121693_length_340_cov_541.348548	86	107	521	1	21	0.0476190
NODE_121693_length_340_cov_541.348548	86	107	540	1	21	0.0476190
NODE_121693_length_340_cov_541.348548	86	107	547	1	21	0.0476190
NODE_121693_length_340_cov_541.348548	86	107	553	1	21	0.0476190
NODE_121693_length_340_cov_541.348548	86	107	562	1	21	0.0476190
NODE_121693_length_340_cov_541.348548	86	107	575	1	21	0.0476190
NODE_121694_length_340_cov_50.755187	196	266	24	7	70	0.1000000
NODE_121694_length_340_cov_50.755187	196	266	26	1	70	0.0142857
NODE_121694_length_340_cov_50.755187	196	266	28	9	70	0.1285714
NODE_121694_length_340_cov_50.755187	196	266	30	8	70	0.1142857
NODE_121694_length_340_cov_50.755187	196	266	32	27	70	0.3857143
NODE_121694_length_340_cov_50.755187	196	266	34	18	70	0.2571429
NODE_121696_length_340_cov_8.917012	240	270	6	14	30	0.4666667
NODE_121696_length_340_cov_8.917012	240	270	8	16	30	0.5333334
NODE_121696_length_340_cov_8.917012	243	315	2	1	72	0.0138889
NODE_121696_length_340_cov_8.917012	243	315	6	58	72	0.8055556
NODE_121696_length_340_cov_8.917012	243	315	8	13	72	0.1805556
NODE_121702_length_340_cov_6.439834	175	255	0	80	80	1.0000000
NODE_121702_length_340_cov_6.439834	228	310	0	82	82	1.0000000
NODE_121708_length_340_cov_5.883817	72	121	0	1	49	0.0204082
NODE_121708_length_340_cov_5.883817	72	121	2	5	49	0.1020408
NODE_121708_length_340_cov_5.883817	72	121	4	43	49	0.8775510
NODE_121708_length_340_cov_5.883817	82	113	4	31	31	1.0000000
NODE_121714_length_340_cov_5.228216	116	186	0	15	70	0.2142857
NODE_121714_length_340_cov_5.228216	116	186	4	20	70	0.2857143
NODE_121714_length_340_cov_5.228216	116	186	6	18	70	0.2571429
NODE_121714_length_340_cov_5.228216	116	186	8	17	70	0.2428571
NODE_121714_length_340_cov_5.228216	159	201	6	10	42	0.2380952
NODE_121714_length_340_cov_5.228216	159	201	8	32	42	0.7619048
NODE_121730_length_340_cov_4.497925	136	184	0	48	48	1.0000000
NODE_121752_length_340_cov_3.759336	88	169	0	4	81	0.0493827
NODE_121752_length_340_cov_3.759336	88	169	2	77	81	0.9506173
NODE_121849_length_340_cov_2.506224	68	114	0	46	46	1.0000000
NODE_121951_length_340_cov_1.995851	29	101	0	32	72	0.4444444
NODE_121951_length_340_cov_1.995851	29	101	4	16	72	0.2222222
NODE_121951_length_340_cov_1.995851	29	101	6	6	72	0.0833333
NODE_121951_length_340_cov_1.995851	29	101	8	18	72	0.2500000
NODE_121951_length_340_cov_1.995851	96	143	8	29	47	0.6170213
NODE_121951_length_340_cov_1.995851	96	143	10	6	47	0.1276596
NODE_121951_length_340_cov_1.995851	96	143	16	12	47	0.2553191
NODE_122154_length_340_cov_1.427386	244	274	0	30	30	1.0000000
NODE_122218_length_340_cov_1.282158	71	135	0	64	64	1.0000000
NODE_122218_length_340_cov_1.282158	128	188	0	60	60	1.0000000
NODE_122218_length_340_cov_1.282158	142	189	0	47	47	1.0000000
NODE_122220_length_340_cov_1.278008	51	102	4	12	51	0.2352941
NODE_122220_length_340_cov_1.278008	51	102	6	6	51	0.1176471
NODE_122220_length_340_cov_1.278008	51	102	8	33	51	0.6470588
NODE_122321_length_340_cov_1.199170	98	160	0	10	62	0.1612903
NODE_122321_length_340_cov_1.199170	98	160	2	52	62	0.8387097
NODE_122381_length_340_cov_1.070539	32	65	0	33	33	1.0000000
NODE_122429_length_340_cov_1.020747	209	228	0	19	19	1.0000000
NODE_122686_length_339_cov_87.841667	149	227	107	1	78	0.0128205
NODE_122686_length_339_cov_87.841667	149	227	109	1	78	0.0128205
NODE_122686_length_339_cov_87.841667	149	227	112	2	78	0.0256410
NODE_122686_length_339_cov_87.841667	149	227	116	1	78	0.0128205
NODE_122686_length_339_cov_87.841667	149	227	117	1	78	0.0128205
NODE_122686_length_339_cov_87.841667	149	227	125	1	78	0.0128205
NODE_122686_length_339_cov_87.841667	149	227	129	2	78	0.0256410
NODE_122686_length_339_cov_87.841667	149	227	132	1	78	0.0128205
NODE_122686_length_339_cov_87.841667	149	227	133	6	78	0.0769231
NODE_122686_length_339_cov_87.841667	149	227	134	1	78	0.0128205
NODE_122686_length_339_cov_87.841667	149	227	145	1	78	0.0128205
NODE_122686_length_339_cov_87.841667	149	227	147	1	78	0.0128205
NODE_122686_length_339_cov_87.841667	149	227	149	1	78	0.0128205
NODE_122686_length_339_cov_87.841667	149	227	153	1	78	0.0128205
NODE_122686_length_339_cov_87.841667	149	227	159	1	78	0.0128205
NODE_122686_length_339_cov_87.841667	149	227	161	4	78	0.0512821
NODE_122686_length_339_cov_87.841667	149	227	169	1	78	0.0128205
NODE_122686_length_339_cov_87.841667	149	227	170	3	78	0.0384615
NODE_122686_length_339_cov_87.841667	149	227	172	4	78	0.0512821
NODE_122686_length_339_cov_87.841667	149	227	173	1	78	0.0128205
NODE_122686_length_339_cov_87.841667	149	227	174	1	78	0.0128205
NODE_122686_length_339_cov_87.841667	149	227	176	2	78	0.0256410
NODE_122686_length_339_cov_87.841667	149	227	181	1	78	0.0128205
NODE_122686_length_339_cov_87.841667	149	227	185	1	78	0.0128205
NODE_122686_length_339_cov_87.841667	149	227	192	1	78	0.0128205
NODE_122686_length_339_cov_87.841667	149	227	195	2	78	0.0256410
NODE_122686_length_339_cov_87.841667	149	227	197	2	78	0.0256410
NODE_122686_length_339_cov_87.841667	149	227	199	1	78	0.0128205
NODE_122686_length_339_cov_87.841667	149	227	200	1	78	0.0128205
NODE_122686_length_339_cov_87.841667	149	227	201	1	78	0.0128205
NODE_122686_length_339_cov_87.841667	149	227	202	1	78	0.0128205
NODE_122686_length_339_cov_87.841667	149	227	204	1	78	0.0128205
NODE_122686_length_339_cov_87.841667	149	227	206	1	78	0.0128205
NODE_122686_length_339_cov_87.841667	149	227	212	2	78	0.0256410
NODE_122686_length_339_cov_87.841667	149	227	214	1	78	0.0128205
NODE_122686_length_339_cov_87.841667	149	227	216	1	78	0.0128205
NODE_122686_length_339_cov_87.841667	149	227	220	1	78	0.0128205
NODE_122686_length_339_cov_87.841667	149	227	222	1	78	0.0128205
NODE_122686_length_339_cov_87.841667	149	227	226	1	78	0.0128205
NODE_122686_length_339_cov_87.841667	149	227	233	1	78	0.0128205
NODE_122686_length_339_cov_87.841667	149	227	234	1	78	0.0128205
NODE_122686_length_339_cov_87.841667	149	227	237	1	78	0.0128205
NODE_122686_length_339_cov_87.841667	149	227	242	1	78	0.0128205
NODE_122686_length_339_cov_87.841667	149	227	245	1	78	0.0128205
NODE_122686_length_339_cov_87.841667	149	227	249	2	78	0.0256410
NODE_122686_length_339_cov_87.841667	149	227	250	1	78	0.0128205
NODE_122686_length_339_cov_87.841667	149	227	253	1	78	0.0128205
NODE_122686_length_339_cov_87.841667	149	227	254	1	78	0.0128205
NODE_122686_length_339_cov_87.841667	149	227	255	1	78	0.0128205
NODE_122686_length_339_cov_87.841667	149	227	256	4	78	0.0512821
NODE_122686_length_339_cov_87.841667	149	227	258	1	78	0.0128205
NODE_122686_length_339_cov_87.841667	149	227	261	1	78	0.0128205
NODE_122686_length_339_cov_87.841667	149	227	262	1	78	0.0128205
NODE_122686_length_339_cov_87.841667	149	227	265	1	78	0.0128205
NODE_122686_length_339_cov_87.841667	149	227	267	1	78	0.0128205
NODE_122687_length_339_cov_14.304167	69	138	2	69	69	1.0000000
NODE_122687_length_339_cov_14.304167	69	138	2	69	69	1.0000000
NODE_122687_length_339_cov_14.304167	69	138	2	69	69	1.0000000
NODE_122687_length_339_cov_14.304167	88	138	2	50	50	1.0000000
NODE_122687_length_339_cov_14.304167	111	160	0	5	49	0.1020408
NODE_122687_length_339_cov_14.304167	111	160	2	44	49	0.8979592
NODE_122727_length_339_cov_4.320833	187	267	0	80	80	1.0000000
NODE_122804_length_339_cov_2.754167	45	125	0	19	80	0.2375000
NODE_122804_length_339_cov_2.754167	45	125	2	18	80	0.2250000
NODE_122804_length_339_cov_2.754167	45	125	4	43	80	0.5375000
NODE_122971_length_339_cov_1.841667	265	312	2	47	47	1.0000000
NODE_123041_length_339_cov_1.662500	10	57	0	17	47	0.3617021
NODE_123041_length_339_cov_1.662500	10	57	2	5	47	0.1063830
NODE_123041_length_339_cov_1.662500	10	57	4	25	47	0.5319149
NODE_123182_length_339_cov_1.275000	247	312	0	65	65	1.0000000
NODE_123285_length_339_cov_1.070833	147	169	0	22	22	1.0000000
NODE_123633_length_338_cov_57.163180	59	120	0	61	61	1.0000000
NODE_123633_length_338_cov_57.163180	102	176	0	74	74	1.0000000
NODE_123674_length_338_cov_4.263598	113	165	0	52	52	1.0000000
NODE_123679_length_338_cov_4.079498	96	151	0	1	55	0.0181818
NODE_123679_length_338_cov_4.079498	96	151	2	54	55	0.9818182
NODE_123689_length_338_cov_3.841004	122	149	0	27	27	1.0000000
NODE_123793_length_338_cov_2.393305	216	288	6	72	72	1.0000000
NODE_123795_length_338_cov_2.380753	29	93	1	1	64	0.0156250
NODE_123795_length_338_cov_2.380753	29	93	2	63	64	0.9843750
NODE_123919_length_338_cov_1.878661	146	232	5	14	86	0.1627907
NODE_123919_length_338_cov_1.878661	146	232	7	1	86	0.0116279
NODE_123919_length_338_cov_1.878661	146	232	9	10	86	0.1162791
NODE_123919_length_338_cov_1.878661	146	232	11	20	86	0.2325581
NODE_123919_length_338_cov_1.878661	146	232	13	4	86	0.0465116
NODE_123919_length_338_cov_1.878661	146	232	14	1	86	0.0116279
NODE_123919_length_338_cov_1.878661	146	232	15	3	86	0.0348837
NODE_123919_length_338_cov_1.878661	146	232	16	1	86	0.0116279
NODE_123919_length_338_cov_1.878661	146	232	18	8	86	0.0930233
NODE_123919_length_338_cov_1.878661	146	232	20	2	86	0.0232558
NODE_123919_length_338_cov_1.878661	146	232	22	8	86	0.0930233
NODE_123919_length_338_cov_1.878661	146	232	24	6	86	0.0697674
NODE_123919_length_338_cov_1.878661	146	232	27	8	86	0.0930233
NODE_123944_length_338_cov_1.740586	79	159	3	17	80	0.2125000
NODE_123944_length_338_cov_1.740586	79	159	4	63	80	0.7875000
NODE_123946_length_338_cov_1.732218	216	257	0	41	41	1.0000000
NODE_124046_length_338_cov_1.493724	14	90	0	62	76	0.8157895
NODE_124046_length_338_cov_1.493724	14	90	2	14	76	0.1842105
NODE_124247_length_338_cov_1.100418	265	333	0	68	68	1.0000000
NODE_124456_length_338_cov_0.849372	281	338	0	57	57	1.0000000
NODE_124533_length_338_cov_0.711297	188	263	2	5	75	0.0666667
NODE_124533_length_338_cov_0.711297	188	263	4	70	75	0.9333333
NODE_124625_length_337_cov_468.180672	107	187	33	3	80	0.0375000
NODE_124625_length_337_cov_468.180672	107	187	35	1	80	0.0125000
NODE_124625_length_337_cov_468.180672	107	187	37	1	80	0.0125000
NODE_124625_length_337_cov_468.180672	107	187	39	4	80	0.0500000
NODE_124625_length_337_cov_468.180672	107	187	40	1	80	0.0125000
NODE_124625_length_337_cov_468.180672	107	187	41	1	80	0.0125000
NODE_124625_length_337_cov_468.180672	107	187	45	6	80	0.0750000
NODE_124625_length_337_cov_468.180672	107	187	46	1	80	0.0125000
NODE_124625_length_337_cov_468.180672	107	187	59	4	80	0.0500000
NODE_124625_length_337_cov_468.180672	107	187	61	12	80	0.1500000
NODE_124625_length_337_cov_468.180672	107	187	63	3	80	0.0375000
NODE_124625_length_337_cov_468.180672	107	187	65	3	80	0.0375000
NODE_124625_length_337_cov_468.180672	107	187	66	1	80	0.0125000
NODE_124625_length_337_cov_468.180672	107	187	68	1	80	0.0125000
NODE_124625_length_337_cov_468.180672	107	187	69	1	80	0.0125000
NODE_124625_length_337_cov_468.180672	107	187	70	11	80	0.1375000
NODE_124625_length_337_cov_468.180672	107	187	72	22	80	0.2750000
NODE_124625_length_337_cov_468.180672	107	187	74	4	80	0.0500000
NODE_124625_length_337_cov_468.180672	160	230	0	3	70	0.0428571
NODE_124625_length_337_cov_468.180672	160	230	2	7	70	0.1000000
NODE_124625_length_337_cov_468.180672	160	230	10	11	70	0.1571429
NODE_124625_length_337_cov_468.180672	160	230	12	4	70	0.0571429
NODE_124625_length_337_cov_468.180672	160	230	14	1	70	0.0142857
NODE_124625_length_337_cov_468.180672	160	230	16	2	70	0.0285714
NODE_124625_length_337_cov_468.180672	160	230	20	1	70	0.0142857
NODE_124625_length_337_cov_468.180672	160	230	27	4	70	0.0571429
NODE_124625_length_337_cov_468.180672	160	230	31	8	70	0.1142857
NODE_124625_length_337_cov_468.180672	160	230	33	5	70	0.0714286
NODE_124625_length_337_cov_468.180672	160	230	35	1	70	0.0142857
NODE_124625_length_337_cov_468.180672	160	230	37	1	70	0.0142857
NODE_124625_length_337_cov_468.180672	160	230	39	4	70	0.0571429
NODE_124625_length_337_cov_468.180672	160	230	40	1	70	0.0142857
NODE_124625_length_337_cov_468.180672	160	230	41	1	70	0.0142857
NODE_124625_length_337_cov_468.180672	160	230	45	6	70	0.0857143
NODE_124625_length_337_cov_468.180672	160	230	46	1	70	0.0142857
NODE_124625_length_337_cov_468.180672	160	230	59	4	70	0.0571429
NODE_124625_length_337_cov_468.180672	160	230	61	5	70	0.0714286
NODE_124625_length_337_cov_468.180672	226	306	10	6	80	0.0750000
NODE_124625_length_337_cov_468.180672	226	306	12	74	80	0.9250000
NODE_124625_length_337_cov_468.180672	279	337	2	1	58	0.0172414
NODE_124625_length_337_cov_468.180672	279	337	4	23	58	0.3965517
NODE_124625_length_337_cov_468.180672	279	337	10	7	58	0.1206897
NODE_124625_length_337_cov_468.180672	279	337	12	27	58	0.4655173
NODE_124626_length_337_cov_91.344538	1	50	19	1	49	0.0204082
NODE_124626_length_337_cov_91.344538	1	50	20	5	49	0.1020408
NODE_124626_length_337_cov_91.344538	1	50	24	4	49	0.0816327
NODE_124626_length_337_cov_91.344538	1	50	26	2	49	0.0408163
NODE_124626_length_337_cov_91.344538	1	50	28	7	49	0.1428571
NODE_124626_length_337_cov_91.344538	1	50	32	1	49	0.0204082
NODE_124626_length_337_cov_91.344538	1	50	34	1	49	0.0204082
NODE_124626_length_337_cov_91.344538	1	50	38	1	49	0.0204082
NODE_124626_length_337_cov_91.344538	1	50	42	5	49	0.1020408
NODE_124626_length_337_cov_91.344538	1	50	48	3	49	0.0612245
NODE_124626_length_337_cov_91.344538	1	50	50	1	49	0.0204082
NODE_124626_length_337_cov_91.344538	1	50	52	3	49	0.0612245
NODE_124626_length_337_cov_91.344538	1	50	56	1	49	0.0204082
NODE_124626_length_337_cov_91.344538	1	50	59	3	49	0.0612245
NODE_124626_length_337_cov_91.344538	1	50	65	1	49	0.0204082
NODE_124626_length_337_cov_91.344538	1	50	69	5	49	0.1020408
NODE_124626_length_337_cov_91.344538	1	50	73	1	49	0.0204082
NODE_124626_length_337_cov_91.344538	1	50	76	1	49	0.0204082
NODE_124626_length_337_cov_91.344538	1	50	80	3	49	0.0612245
NODE_124626_length_337_cov_91.344538	23	103	42	5	80	0.0625000
NODE_124626_length_337_cov_91.344538	23	103	48	3	80	0.0375000
NODE_124626_length_337_cov_91.344538	23	103	50	1	80	0.0125000
NODE_124626_length_337_cov_91.344538	23	103	52	3	80	0.0375000
NODE_124626_length_337_cov_91.344538	23	103	56	1	80	0.0125000
NODE_124626_length_337_cov_91.344538	23	103	59	3	80	0.0375000
NODE_124626_length_337_cov_91.344538	23	103	65	1	80	0.0125000
NODE_124626_length_337_cov_91.344538	23	103	69	5	80	0.0625000
NODE_124626_length_337_cov_91.344538	23	103	73	1	80	0.0125000
NODE_124626_length_337_cov_91.344538	23	103	76	1	80	0.0125000
NODE_124626_length_337_cov_91.344538	23	103	80	3	80	0.0375000
NODE_124626_length_337_cov_91.344538	23	103	88	5	80	0.0625000
NODE_124626_length_337_cov_91.344538	23	103	90	2	80	0.0250000
NODE_124626_length_337_cov_91.344538	23	103	95	1	80	0.0125000
NODE_124626_length_337_cov_91.344538	23	103	96	1	80	0.0125000
NODE_124626_length_337_cov_91.344538	23	103	98	1	80	0.0125000
NODE_124626_length_337_cov_91.344538	23	103	100	5	80	0.0625000
NODE_124626_length_337_cov_91.344538	23	103	102	8	80	0.1000000
NODE_124626_length_337_cov_91.344538	23	103	108	2	80	0.0250000
NODE_124626_length_337_cov_91.344538	23	103	110	2	80	0.0250000
NODE_124626_length_337_cov_91.344538	23	103	112	1	80	0.0125000
NODE_124626_length_337_cov_91.344538	23	103	114	4	80	0.0500000
NODE_124626_length_337_cov_91.344538	23	103	120	8	80	0.1000000
NODE_124626_length_337_cov_91.344538	23	103	122	2	80	0.0250000
NODE_124626_length_337_cov_91.344538	23	103	123	1	80	0.0125000
NODE_124626_length_337_cov_91.344538	23	103	131	7	80	0.0875000
NODE_124626_length_337_cov_91.344538	23	103	133	2	80	0.0250000
NODE_124626_length_337_cov_91.344538	23	103	134	1	80	0.0125000
NODE_124627_length_337_cov_73.352941	71	151	4	80	80	1.0000000
NODE_124627_length_337_cov_73.352941	124	204	0	6	80	0.0750000
NODE_124627_length_337_cov_73.352941	124	204	2	1	80	0.0125000
NODE_124627_length_337_cov_73.352941	124	204	4	73	80	0.9125000
NODE_124629_length_337_cov_46.978992	220	305	22	8	85	0.0941176
NODE_124629_length_337_cov_46.978992	220	305	28	2	85	0.0235294
NODE_124629_length_337_cov_46.978992	220	305	29	2	85	0.0235294
NODE_124629_length_337_cov_46.978992	220	305	33	1	85	0.0117647
NODE_124629_length_337_cov_46.978992	220	305	34	7	85	0.0823529
NODE_124629_length_337_cov_46.978992	220	305	36	65	85	0.7647059
NODE_124629_length_337_cov_46.978992	220	305	22	8	85	0.0941176
NODE_124629_length_337_cov_46.978992	220	305	28	2	85	0.0235294
NODE_124629_length_337_cov_46.978992	220	305	29	2	85	0.0235294
NODE_124629_length_337_cov_46.978992	220	305	33	1	85	0.0117647
NODE_124629_length_337_cov_46.978992	220	305	34	7	85	0.0823529
NODE_124629_length_337_cov_46.978992	220	305	36	65	85	0.7647059
NODE_124629_length_337_cov_46.978992	220	305	22	8	85	0.0941176
NODE_124629_length_337_cov_46.978992	220	305	28	2	85	0.0235294
NODE_124629_length_337_cov_46.978992	220	305	29	2	85	0.0235294
NODE_124629_length_337_cov_46.978992	220	305	33	1	85	0.0117647
NODE_124629_length_337_cov_46.978992	220	305	34	7	85	0.0823529
NODE_124629_length_337_cov_46.978992	220	305	36	65	85	0.7647059
NODE_124629_length_337_cov_46.978992	278	327	16	15	49	0.3061225
NODE_124629_length_337_cov_46.978992	278	327	18	7	49	0.1428571
NODE_124629_length_337_cov_46.978992	278	327	22	8	49	0.1632653
NODE_124629_length_337_cov_46.978992	278	327	28	2	49	0.0408163
NODE_124629_length_337_cov_46.978992	278	327	36	17	49	0.3469388
NODE_124629_length_337_cov_46.978992	278	337	0	3	59	0.0508475
NODE_124629_length_337_cov_46.978992	278	337	15	3	59	0.0508475
NODE_124629_length_337_cov_46.978992	278	337	16	19	59	0.3220339
NODE_124629_length_337_cov_46.978992	278	337	18	7	59	0.1186441
NODE_124629_length_337_cov_46.978992	278	337	22	8	59	0.1355932
NODE_124629_length_337_cov_46.978992	278	337	28	2	59	0.0338983
NODE_124629_length_337_cov_46.978992	278	337	36	17	59	0.2881356
NODE_124629_length_337_cov_46.978992	283	337	0	3	54	0.0555556
NODE_124629_length_337_cov_46.978992	283	337	15	3	54	0.0555556
NODE_124629_length_337_cov_46.978992	283	337	16	19	54	0.3518519
NODE_124629_length_337_cov_46.978992	283	337	18	7	54	0.1296296
NODE_124629_length_337_cov_46.978992	283	337	22	8	54	0.1481481
NODE_124629_length_337_cov_46.978992	283	337	28	2	54	0.0370370
NODE_124629_length_337_cov_46.978992	283	337	36	12	54	0.2222222
NODE_124640_length_337_cov_6.214286	52	95	0	43	43	1.0000000
NODE_124669_length_337_cov_4.298319	5	58	0	53	53	1.0000000
NODE_124703_length_337_cov_3.478992	179	259	32	4	80	0.0500000
NODE_124703_length_337_cov_3.478992	179	259	34	7	80	0.0875000
NODE_124703_length_337_cov_3.478992	179	259	36	3	80	0.0375000
NODE_124703_length_337_cov_3.478992	179	259	38	1	80	0.0125000
NODE_124703_length_337_cov_3.478992	179	259	39	1	80	0.0125000
NODE_124703_length_337_cov_3.478992	179	259	40	16	80	0.2000000
NODE_124703_length_337_cov_3.478992	179	259	42	24	80	0.3000000
NODE_124703_length_337_cov_3.478992	179	259	44	1	80	0.0125000
NODE_124703_length_337_cov_3.478992	179	259	46	1	80	0.0125000
NODE_124703_length_337_cov_3.478992	179	259	48	6	80	0.0750000
NODE_124703_length_337_cov_3.478992	179	259	50	5	80	0.0625000
NODE_124703_length_337_cov_3.478992	179	259	51	5	80	0.0625000
NODE_124703_length_337_cov_3.478992	179	259	52	4	80	0.0500000
NODE_124703_length_337_cov_3.478992	179	259	53	2	80	0.0250000
NODE_124703_length_337_cov_3.478992	232	307	0	1	75	0.0133333
NODE_124703_length_337_cov_3.478992	232	307	2	1	75	0.0133333
NODE_124703_length_337_cov_3.478992	232	307	6	7	75	0.0933333
NODE_124703_length_337_cov_3.478992	232	307	8	5	75	0.0666667
NODE_124703_length_337_cov_3.478992	232	307	10	3	75	0.0400000
NODE_124703_length_337_cov_3.478992	232	307	15	18	75	0.2400000
NODE_124703_length_337_cov_3.478992	232	307	17	6	75	0.0800000
NODE_124703_length_337_cov_3.478992	232	307	19	1	75	0.0133333
NODE_124703_length_337_cov_3.478992	232	307	21	2	75	0.0266667
NODE_124703_length_337_cov_3.478992	232	307	29	1	75	0.0133333
NODE_124703_length_337_cov_3.478992	232	307	32	7	75	0.0933333
NODE_124703_length_337_cov_3.478992	232	307	34	7	75	0.0933333
NODE_124703_length_337_cov_3.478992	232	307	36	1	75	0.0133333
NODE_124703_length_337_cov_3.478992	232	307	39	1	75	0.0133333
NODE_124703_length_337_cov_3.478992	232	307	40	5	75	0.0666667
NODE_124703_length_337_cov_3.478992	232	307	42	9	75	0.1200000
NODE_124759_length_337_cov_2.647059	80	146	0	44	66	0.6666667
NODE_124759_length_337_cov_2.647059	80	146	2	13	66	0.1969697
NODE_124759_length_337_cov_2.647059	80	146	4	9	66	0.1363636
NODE_124858_length_337_cov_2.121849	23	103	0	1	80	0.0125000
NODE_124858_length_337_cov_2.121849	23	103	2	6	80	0.0750000
NODE_124858_length_337_cov_2.121849	23	103	3	1	80	0.0125000
NODE_124858_length_337_cov_2.121849	23	103	4	1	80	0.0125000
NODE_124858_length_337_cov_2.121849	23	103	6	71	80	0.8875000
NODE_124858_length_337_cov_2.121849	76	141	4	1	65	0.0153846
NODE_124858_length_337_cov_2.121849	76	141	6	64	65	0.9846154
NODE_125001_length_337_cov_1.689076	138	218	2	69	80	0.8625000
NODE_125001_length_337_cov_1.689076	138	218	4	11	80	0.1375000
NODE_125024_length_337_cov_1.592437	109	151	0	42	42	1.0000000
NODE_125024_length_337_cov_1.592437	126	204	0	78	78	1.0000000
NODE_125074_length_337_cov_1.466387	266	332	0	66	66	1.0000000
NODE_125271_length_337_cov_1.071429	279	319	2	40	40	1.0000000
NODE_125332_length_337_cov_0.978992	227	272	0	45	45	1.0000000
NODE_125633_length_336_cov_7.843882	151	231	0	80	80	1.0000000
NODE_125645_length_336_cov_5.578059	159	220	0	12	61	0.1967213
NODE_125645_length_336_cov_5.578059	159	220	6	49	61	0.8032787
NODE_125645_length_336_cov_5.578059	212	273	6	61	61	1.0000000
NODE_125663_length_336_cov_4.481013	129	207	0	32	78	0.4102564
NODE_125663_length_336_cov_4.481013	129	207	2	1	78	0.0128205
NODE_125663_length_336_cov_4.481013	129	207	4	45	78	0.5769231
NODE_125752_length_336_cov_2.755274	83	112	2	4	29	0.1379310
NODE_125752_length_336_cov_2.755274	83	112	4	2	29	0.0689655
NODE_125752_length_336_cov_2.755274	83	112	6	23	29	0.7931035
NODE_125752_length_336_cov_2.755274	187	268	0	10	81	0.1234568
NODE_125752_length_336_cov_2.755274	187	268	2	9	81	0.1111111
NODE_125752_length_336_cov_2.755274	187	268	4	54	81	0.6666667
NODE_125752_length_336_cov_2.755274	187	268	6	8	81	0.0987654
NODE_125806_length_336_cov_2.358650	60	133	2	73	73	1.0000000
NODE_125811_length_336_cov_2.337553	93	173	6	20	80	0.2500000
NODE_125811_length_336_cov_2.337553	93	173	8	4	80	0.0500000
NODE_125811_length_336_cov_2.337553	93	173	10	56	80	0.7000000
NODE_125965_length_336_cov_1.729958	78	141	0	63	63	1.0000000
NODE_125965_length_336_cov_1.729958	131	194	0	63	63	1.0000000
NODE_126134_length_336_cov_1.333333	34	114	0	80	80	1.0000000
NODE_126134_length_336_cov_1.333333	87	124	0	37	37	1.0000000
NODE_126134_length_336_cov_1.333333	182	213	0	31	31	1.0000000
NODE_126216_length_336_cov_1.244726	222	276	0	54	54	1.0000000
NODE_126216_length_336_cov_1.244726	288	312	0	24	24	1.0000000
NODE_126260_length_336_cov_1.143460	129	154	0	25	25	1.0000000
NODE_126545_length_336_cov_0.670886	259	288	2	29	29	1.0000000
NODE_126606_length_335_cov_16.114407	162	242	0	80	80	1.0000000
NODE_126606_length_335_cov_16.114407	215	295	0	80	80	1.0000000
NODE_126609_length_335_cov_9.258475	177	250	0	73	73	1.0000000
NODE_126614_length_335_cov_7.207627	29	109	0	52	80	0.6500000
NODE_126614_length_335_cov_7.207627	29	109	2	28	80	0.3500000
NODE_126614_length_335_cov_7.207627	82	162	0	9	80	0.1125000
NODE_126614_length_335_cov_7.207627	82	162	2	71	80	0.8875000
NODE_126636_length_335_cov_5.046610	182	263	0	81	81	1.0000000
NODE_126639_length_335_cov_4.995763	144	215	0	71	71	1.0000000
NODE_126665_length_335_cov_3.923729	163	231	0	68	68	1.0000000
NODE_126787_length_335_cov_2.411017	230	294	0	5	64	0.0781250
NODE_126787_length_335_cov_2.411017	230	294	2	15	64	0.2343750
NODE_126787_length_335_cov_2.411017	230	294	3	17	64	0.2656250
NODE_126787_length_335_cov_2.411017	230	294	4	20	64	0.3125000
NODE_126787_length_335_cov_2.411017	230	294	10	6	64	0.0937500
NODE_126787_length_335_cov_2.411017	230	294	12	1	64	0.0156250
NODE_126791_length_335_cov_2.402542	164	240	0	31	76	0.4078947
NODE_126791_length_335_cov_2.402542	164	240	2	3	76	0.0394737
NODE_126791_length_335_cov_2.402542	164	240	4	4	76	0.0526316
NODE_126791_length_335_cov_2.402542	164	240	6	26	76	0.3421053
NODE_126791_length_335_cov_2.402542	164	240	8	12	76	0.1578947
NODE_126792_length_335_cov_2.398305	116	179	0	2	63	0.0317460
NODE_126792_length_335_cov_2.398305	116	179	2	28	63	0.4444444
NODE_126792_length_335_cov_2.398305	116	179	5	33	63	0.5238096
NODE_126826_length_335_cov_2.161017	82	141	2	59	59	1.0000000
NODE_126835_length_335_cov_2.152542	61	134	0	6	73	0.0821918
NODE_126835_length_335_cov_2.152542	61	134	4	67	73	0.9178082
NODE_126835_length_335_cov_2.152542	114	134	4	20	20	1.0000000
NODE_126920_length_335_cov_1.766949	257	330	2	73	73	1.0000000
NODE_126920_length_335_cov_1.766949	297	335	2	38	38	1.0000000
NODE_127022_length_335_cov_1.529661	255	320	0	4	65	0.0615385
NODE_127022_length_335_cov_1.529661	255	320	2	61	65	0.9384615
NODE_127023_length_335_cov_1.525424	222	266	0	44	44	1.0000000
NODE_127062_length_335_cov_1.457627	38	87	0	49	49	1.0000000
NODE_127130_length_335_cov_1.296610	291	311	0	20	20	1.0000000
NODE_127130_length_335_cov_1.296610	291	311	0	20	20	1.0000000
NODE_127143_length_335_cov_1.292373	202	232	2	16	30	0.5333334
NODE_127143_length_335_cov_1.292373	202	232	4	14	30	0.4666667
NODE_127200_length_335_cov_1.194915	75	156	6	12	81	0.1481481
NODE_127200_length_335_cov_1.194915	75	156	8	2	81	0.0246914
NODE_127200_length_335_cov_1.194915	75	156	12	1	81	0.0123457
NODE_127200_length_335_cov_1.194915	75	156	13	31	81	0.3827161
NODE_127200_length_335_cov_1.194915	75	156	15	12	81	0.1481481
NODE_127200_length_335_cov_1.194915	75	156	16	23	81	0.2839506
NODE_127200_length_335_cov_1.194915	129	195	0	28	66	0.4242424
NODE_127200_length_335_cov_1.194915	129	195	6	23	66	0.3484848
NODE_127200_length_335_cov_1.194915	129	195	8	2	66	0.0303030
NODE_127200_length_335_cov_1.194915	129	195	12	1	66	0.0151515
NODE_127200_length_335_cov_1.194915	129	195	13	12	66	0.1818182
NODE_127310_length_335_cov_0.983051	96	117	2	21	21	1.0000000
NODE_127585_length_334_cov_275.425532	135	215	85	1	80	0.0125000
NODE_127585_length_334_cov_275.425532	135	215	88	1	80	0.0125000
NODE_127585_length_334_cov_275.425532	135	215	93	3	80	0.0375000
NODE_127585_length_334_cov_275.425532	135	215	97	4	80	0.0500000
NODE_127585_length_334_cov_275.425532	135	215	98	1	80	0.0125000
NODE_127585_length_334_cov_275.425532	135	215	100	1	80	0.0125000
NODE_127585_length_334_cov_275.425532	135	215	101	1	80	0.0125000
NODE_127585_length_334_cov_275.425532	135	215	102	3	80	0.0375000
NODE_127585_length_334_cov_275.425532	135	215	104	4	80	0.0500000
NODE_127585_length_334_cov_275.425532	135	215	105	1	80	0.0125000
NODE_127585_length_334_cov_275.425532	135	215	106	6	80	0.0750000
NODE_127585_length_334_cov_275.425532	135	215	108	3	80	0.0375000
NODE_127585_length_334_cov_275.425532	135	215	110	2	80	0.0250000
NODE_127585_length_334_cov_275.425532	135	215	111	4	80	0.0500000
NODE_127585_length_334_cov_275.425532	135	215	112	6	80	0.0750000
NODE_127585_length_334_cov_275.425532	135	215	114	4	80	0.0500000
NODE_127585_length_334_cov_275.425532	135	215	115	6	80	0.0750000
NODE_127585_length_334_cov_275.425532	135	215	116	5	80	0.0625000
NODE_127585_length_334_cov_275.425532	135	215	117	2	80	0.0250000
NODE_127585_length_334_cov_275.425532	135	215	118	1	80	0.0125000
NODE_127585_length_334_cov_275.425532	135	215	119	4	80	0.0500000
NODE_127585_length_334_cov_275.425532	135	215	120	5	80	0.0625000
NODE_127585_length_334_cov_275.425532	135	215	121	8	80	0.1000000
NODE_127585_length_334_cov_275.425532	135	215	123	4	80	0.0500000
NODE_127585_length_334_cov_275.425532	188	269	38	9	81	0.1111111
NODE_127585_length_334_cov_275.425532	188	269	40	15	81	0.1851852
NODE_127585_length_334_cov_275.425532	188	269	42	2	81	0.0246914
NODE_127585_length_334_cov_275.425532	188	269	44	3	81	0.0370370
NODE_127585_length_334_cov_275.425532	188	269	46	1	81	0.0123457
NODE_127585_length_334_cov_275.425532	188	269	52	5	81	0.0617284
NODE_127585_length_334_cov_275.425532	188	269	54	1	81	0.0123457
NODE_127585_length_334_cov_275.425532	188	269	56	2	81	0.0246914
NODE_127585_length_334_cov_275.425532	188	269	60	1	81	0.0123457
NODE_127585_length_334_cov_275.425532	188	269	61	1	81	0.0123457
NODE_127585_length_334_cov_275.425532	188	269	62	2	81	0.0246914
NODE_127585_length_334_cov_275.425532	188	269	68	3	81	0.0370370
NODE_127585_length_334_cov_275.425532	188	269	70	2	81	0.0246914
NODE_127585_length_334_cov_275.425532	188	269	76	1	81	0.0123457
NODE_127585_length_334_cov_275.425532	188	269	78	1	81	0.0123457
NODE_127585_length_334_cov_275.425532	188	269	80	2	81	0.0246914
NODE_127585_length_334_cov_275.425532	188	269	81	1	81	0.0123457
NODE_127585_length_334_cov_275.425532	188	269	82	1	81	0.0123457
NODE_127585_length_334_cov_275.425532	188	269	85	2	81	0.0246914
NODE_127585_length_334_cov_275.425532	188	269	88	1	81	0.0123457
NODE_127585_length_334_cov_275.425532	188	269	93	3	81	0.0370370
NODE_127585_length_334_cov_275.425532	188	269	97	4	81	0.0493827
NODE_127585_length_334_cov_275.425532	188	269	104	3	81	0.0370370
NODE_127585_length_334_cov_275.425532	188	269	105	1	81	0.0123457
NODE_127585_length_334_cov_275.425532	188	269	106	6	81	0.0740741
NODE_127585_length_334_cov_275.425532	188	269	108	3	81	0.0370370
NODE_127585_length_334_cov_275.425532	188	269	112	3	81	0.0370370
NODE_127585_length_334_cov_275.425532	188	269	114	1	81	0.0123457
NODE_127585_length_334_cov_275.425532	188	269	115	1	81	0.0123457
NODE_127586_length_334_cov_14.753191	135	215	0	80	80	1.0000000
NODE_127586_length_334_cov_14.753191	188	268	0	80	80	1.0000000
NODE_127610_length_334_cov_4.829787	92	174	0	82	82	1.0000000
NODE_127610_length_334_cov_4.829787	151	237	0	86	86	1.0000000
NODE_127612_length_334_cov_4.817021	179	231	0	52	52	1.0000000
NODE_127626_length_334_cov_4.438298	121	201	4	28	80	0.3500000
NODE_127626_length_334_cov_4.438298	121	201	6	37	80	0.4625000
NODE_127626_length_334_cov_4.438298	121	201	8	15	80	0.1875000
NODE_127672_length_334_cov_3.604255	248	314	4	1	66	0.0151515
NODE_127672_length_334_cov_3.604255	248	314	6	65	66	0.9848485
NODE_127672_length_334_cov_3.604255	287	334	4	1	47	0.0212766
NODE_127672_length_334_cov_3.604255	287	334	6	46	47	0.9787234
NODE_127844_length_334_cov_2.165957	0	48	0	48	48	1.0000000
NODE_128026_length_334_cov_1.595745	253	328	2	75	75	1.0000000
NODE_128258_length_334_cov_1.157447	146	177	0	31	31	1.0000000
NODE_128665_length_333_cov_5.423077	172	242	0	6	70	0.0857143
NODE_128665_length_333_cov_5.423077	172	242	4	64	70	0.9142857
NODE_128673_length_333_cov_4.867521	122	172	0	7	50	0.1400000
NODE_128673_length_333_cov_4.867521	122	172	2	43	50	0.8600000
NODE_128673_length_333_cov_4.867521	175	255	2	49	80	0.6125000
NODE_128673_length_333_cov_4.867521	175	255	4	31	80	0.3875000
NODE_128673_length_333_cov_4.867521	194	219	4	25	25	1.0000000
NODE_128717_length_333_cov_3.717949	49	129	0	22	80	0.2750000
NODE_128717_length_333_cov_3.717949	49	129	5	13	80	0.1625000
NODE_128717_length_333_cov_3.717949	49	129	8	23	80	0.2875000
NODE_128717_length_333_cov_3.717949	49	129	10	22	80	0.2750000
NODE_128717_length_333_cov_3.717949	102	182	8	5	80	0.0625000
NODE_128717_length_333_cov_3.717949	102	182	10	24	80	0.3000000
NODE_128717_length_333_cov_3.717949	102	182	11	3	80	0.0375000
NODE_128717_length_333_cov_3.717949	102	182	13	24	80	0.3000000
NODE_128717_length_333_cov_3.717949	102	182	14	20	80	0.2500000
NODE_128717_length_333_cov_3.717949	102	182	16	4	80	0.0500000
NODE_128767_length_333_cov_2.897436	59	139	0	9	80	0.1125000
NODE_128767_length_333_cov_2.897436	59	139	1	1	80	0.0125000
NODE_128767_length_333_cov_2.897436	59	139	3	1	80	0.0125000
NODE_128767_length_333_cov_2.897436	59	139	5	1	80	0.0125000
NODE_128767_length_333_cov_2.897436	59	139	7	3	80	0.0375000
NODE_128767_length_333_cov_2.897436	59	139	9	12	80	0.1500000
NODE_128767_length_333_cov_2.897436	59	139	11	24	80	0.3000000
NODE_128767_length_333_cov_2.897436	59	139	12	29	80	0.3625000
NODE_128850_length_333_cov_2.307692	68	148	0	80	80	1.0000000
NODE_128933_length_333_cov_1.940171	135	215	0	80	80	1.0000000
NODE_129252_length_333_cov_1.200855	0	80	0	17	80	0.2125000
NODE_129252_length_333_cov_1.200855	0	80	2	9	80	0.1125000
NODE_129252_length_333_cov_1.200855	0	80	4	30	80	0.3750000
NODE_129252_length_333_cov_1.200855	0	80	7	3	80	0.0375000
NODE_129252_length_333_cov_1.200855	0	80	8	21	80	0.2625000
NODE_129263_length_333_cov_1.170940	146	193	0	1	47	0.0212766
NODE_129263_length_333_cov_1.170940	146	193	4	46	47	0.9787234
NODE_129263_length_333_cov_1.170940	203	243	2	3	40	0.0750000
NODE_129263_length_333_cov_1.170940	203	243	4	37	40	0.9250000
NODE_129303_length_333_cov_1.089744	241	306	0	65	65	1.0000000
NODE_129310_length_333_cov_1.089744	206	226	2	20	20	1.0000000
NODE_129665_length_332_cov_5.386266	101	167	0	66	66	1.0000000
NODE_129680_length_332_cov_4.768240	221	250	2	29	29	1.0000000
NODE_129695_length_332_cov_4.343348	130	179	0	49	49	1.0000000
NODE_129698_length_332_cov_4.201717	191	237	0	10	46	0.2173913
NODE_129698_length_332_cov_4.201717	191	237	1	2	46	0.0434783
NODE_129698_length_332_cov_4.201717	191	237	2	2	46	0.0434783
NODE_129698_length_332_cov_4.201717	191	237	4	31	46	0.6739131
NODE_129698_length_332_cov_4.201717	191	237	10	1	46	0.0217391
NODE_129698_length_332_cov_4.201717	211	290	4	25	79	0.3164557
NODE_129698_length_332_cov_4.201717	211	290	5	1	79	0.0126582
NODE_129698_length_332_cov_4.201717	211	290	6	1	79	0.0126582
NODE_129698_length_332_cov_4.201717	211	290	7	13	79	0.1645570
NODE_129698_length_332_cov_4.201717	211	290	9	16	79	0.2025317
NODE_129698_length_332_cov_4.201717	211	290	10	23	79	0.2911392
NODE_129879_length_332_cov_2.274678	187	227	20	5	40	0.1250000
NODE_129879_length_332_cov_2.274678	187	227	22	5	40	0.1250000
NODE_129879_length_332_cov_2.274678	187	227	24	3	40	0.0750000
NODE_129879_length_332_cov_2.274678	187	227	30	1	40	0.0250000
NODE_129879_length_332_cov_2.274678	187	227	31	4	40	0.1000000
NODE_129879_length_332_cov_2.274678	187	227	32	5	40	0.1250000
NODE_129879_length_332_cov_2.274678	187	227	36	3	40	0.0750000
NODE_129879_length_332_cov_2.274678	187	227	38	1	40	0.0250000
NODE_129879_length_332_cov_2.274678	187	227	40	4	40	0.1000000
NODE_129879_length_332_cov_2.274678	187	227	42	3	40	0.0750000
NODE_129879_length_332_cov_2.274678	187	227	44	6	40	0.1500000
NODE_129901_length_332_cov_2.184549	194	258	0	4	64	0.0625000
NODE_129901_length_332_cov_2.184549	194	258	2	2	64	0.0312500
NODE_129901_length_332_cov_2.184549	194	258	4	38	64	0.5937500
NODE_129901_length_332_cov_2.184549	194	258	6	20	64	0.3125000
NODE_130053_length_332_cov_1.682403	241	316	0	51	75	0.6800000
NODE_130053_length_332_cov_1.682403	241	316	2	24	75	0.3200000
NODE_130055_length_332_cov_1.673820	157	220	0	63	63	1.0000000
NODE_130183_length_332_cov_1.364807	132	212	0	80	80	1.0000000
NODE_130187_length_332_cov_1.356223	276	332	0	56	56	1.0000000
NODE_130312_length_332_cov_1.210300	120	176	0	56	56	1.0000000
NODE_130757_length_331_cov_5.254310	141	221	0	80	80	1.0000000
NODE_130757_length_331_cov_5.254310	194	274	0	80	80	1.0000000
NODE_130781_length_331_cov_4.323276	26	108	0	9	82	0.1097561
NODE_130781_length_331_cov_4.323276	26	108	2	14	82	0.1707317
NODE_130781_length_331_cov_4.323276	26	108	4	1	82	0.0121951
NODE_130781_length_331_cov_4.323276	26	108	6	38	82	0.4634146
NODE_130781_length_331_cov_4.323276	26	108	10	20	82	0.2439024
NODE_130902_length_331_cov_2.603448	128	181	0	20	53	0.3773585
NODE_130902_length_331_cov_2.603448	128	181	2	33	53	0.6226415
NODE_131036_length_331_cov_1.965517	183	216	0	33	33	1.0000000
NODE_131054_length_331_cov_1.896552	266	331	0	10	65	0.1538462
NODE_131054_length_331_cov_1.896552	266	331	2	37	65	0.5692308
NODE_131054_length_331_cov_1.896552	266	331	4	18	65	0.2769231
NODE_131817_length_330_cov_14.731602	209	280	0	71	71	1.0000000
NODE_131840_length_330_cov_4.935065	16	97	4	28	81	0.3456790
NODE_131840_length_330_cov_4.935065	16	97	6	53	81	0.6543210
NODE_131840_length_330_cov_4.935065	81	149	0	24	68	0.3529412
NODE_131840_length_330_cov_4.935065	81	149	2	1	68	0.0147059
NODE_131840_length_330_cov_4.935065	81	149	4	1	68	0.0147059
NODE_131840_length_330_cov_4.935065	81	149	6	42	68	0.6176471
NODE_131841_length_330_cov_4.891775	177	255	0	43	78	0.5512820
NODE_131841_length_330_cov_4.891775	177	255	2	22	78	0.2820513
NODE_131841_length_330_cov_4.891775	177	255	4	12	78	0.1538462
NODE_131841_length_330_cov_4.891775	177	255	6	1	78	0.0128205
NODE_131845_length_330_cov_4.740260	134	209	0	11	75	0.1466667
NODE_131845_length_330_cov_4.740260	134	209	1	29	75	0.3866667
NODE_131845_length_330_cov_4.740260	134	209	2	4	75	0.0533333
NODE_131845_length_330_cov_4.740260	134	209	3	31	75	0.4133333
NODE_131892_length_330_cov_3.467532	161	225	0	7	64	0.1093750
NODE_131892_length_330_cov_3.467532	161	225	2	7	64	0.1093750
NODE_131892_length_330_cov_3.467532	161	225	6	50	64	0.7812500
NODE_131969_length_330_cov_2.601732	8	88	0	80	80	1.0000000
NODE_132188_length_330_cov_1.623377	154	200	0	46	46	1.0000000
NODE_132238_length_330_cov_1.541126	98	156	0	58	58	1.0000000
NODE_132268_length_330_cov_1.467532	234	287	0	53	53	1.0000000
NODE_132268_length_330_cov_1.467532	242	283	0	41	41	1.0000000
NODE_132306_length_330_cov_1.346320	230	296	0	40	66	0.6060606
NODE_132306_length_330_cov_1.346320	230	296	2	26	66	0.3939394
NODE_132306_length_330_cov_1.346320	230	257	0	1	27	0.0370370
NODE_132306_length_330_cov_1.346320	230	257	2	26	27	0.9629630
NODE_132410_length_330_cov_1.220779	249	272	0	23	23	1.0000000
NODE_132478_length_330_cov_1.103896	189	227	0	38	38	1.0000000
NODE_132542_length_330_cov_1.038961	219	297	7	1	78	0.0128205
NODE_132542_length_330_cov_1.038961	219	297	11	3	78	0.0384615
NODE_132542_length_330_cov_1.038961	219	297	12	1	78	0.0128205
NODE_132542_length_330_cov_1.038961	219	297	14	2	78	0.0256410
NODE_132542_length_330_cov_1.038961	219	297	18	1	78	0.0128205
NODE_132542_length_330_cov_1.038961	219	297	19	3	78	0.0384615
NODE_132542_length_330_cov_1.038961	219	297	24	3	78	0.0384615
NODE_132542_length_330_cov_1.038961	219	297	26	1	78	0.0128205
NODE_132542_length_330_cov_1.038961	219	297	27	1	78	0.0128205
NODE_132542_length_330_cov_1.038961	219	297	28	2	78	0.0256410
NODE_132542_length_330_cov_1.038961	219	297	30	1	78	0.0128205
NODE_132542_length_330_cov_1.038961	219	297	33	1	78	0.0128205
NODE_132542_length_330_cov_1.038961	219	297	36	2	78	0.0256410
NODE_132542_length_330_cov_1.038961	219	297	37	2	78	0.0256410
NODE_132542_length_330_cov_1.038961	219	297	40	6	78	0.0769231
NODE_132542_length_330_cov_1.038961	219	297	51	1	78	0.0128205
NODE_132542_length_330_cov_1.038961	219	297	58	1	78	0.0128205
NODE_132542_length_330_cov_1.038961	219	297	60	4	78	0.0512821
NODE_132542_length_330_cov_1.038961	219	297	62	1	78	0.0128205
NODE_132542_length_330_cov_1.038961	219	297	64	5	78	0.0641026
NODE_132542_length_330_cov_1.038961	219	297	65	1	78	0.0128205
NODE_132542_length_330_cov_1.038961	219	297	66	1	78	0.0128205
NODE_132542_length_330_cov_1.038961	219	297	67	2	78	0.0256410
NODE_132542_length_330_cov_1.038961	219	297	77	1	78	0.0128205
NODE_132542_length_330_cov_1.038961	219	297	78	4	78	0.0512821
NODE_132542_length_330_cov_1.038961	219	297	88	2	78	0.0256410
NODE_132542_length_330_cov_1.038961	219	297	90	1	78	0.0128205
NODE_132542_length_330_cov_1.038961	219	297	93	1	78	0.0128205
NODE_132542_length_330_cov_1.038961	219	297	97	1	78	0.0128205
NODE_132542_length_330_cov_1.038961	219	297	101	3	78	0.0384615
NODE_132542_length_330_cov_1.038961	219	297	102	1	78	0.0128205
NODE_132542_length_330_cov_1.038961	219	297	104	1	78	0.0128205
NODE_132542_length_330_cov_1.038961	219	297	112	1	78	0.0128205
NODE_132542_length_330_cov_1.038961	219	297	113	2	78	0.0256410
NODE_132542_length_330_cov_1.038961	219	297	114	1	78	0.0128205
NODE_132542_length_330_cov_1.038961	219	297	115	2	78	0.0256410
NODE_132542_length_330_cov_1.038961	219	297	118	2	78	0.0256410
NODE_132542_length_330_cov_1.038961	219	297	119	1	78	0.0128205
NODE_132542_length_330_cov_1.038961	219	297	121	1	78	0.0128205
NODE_132542_length_330_cov_1.038961	219	297	127	1	78	0.0128205
NODE_132542_length_330_cov_1.038961	219	297	130	1	78	0.0128205
NODE_132542_length_330_cov_1.038961	219	297	131	1	78	0.0128205
NODE_132542_length_330_cov_1.038961	219	297	132	1	78	0.0128205
NODE_132542_length_330_cov_1.038961	219	297	135	3	78	0.0384615
NODE_132688_length_330_cov_0.883117	284	330	0	46	46	1.0000000
NODE_132873_length_329_cov_110.178261	138	167	46	4	29	0.1379310
NODE_132873_length_329_cov_110.178261	138	167	50	1	29	0.0344828
NODE_132873_length_329_cov_110.178261	138	167	52	11	29	0.3793103
NODE_132873_length_329_cov_110.178261	138	167	56	8	29	0.2758621
NODE_132873_length_329_cov_110.178261	138	167	58	2	29	0.0689655
NODE_132873_length_329_cov_110.178261	138	167	60	2	29	0.0689655
NODE_132873_length_329_cov_110.178261	138	167	62	1	29	0.0344828
NODE_132873_length_329_cov_110.178261	189	269	82	5	80	0.0625000
NODE_132873_length_329_cov_110.178261	189	269	84	1	80	0.0125000
NODE_132873_length_329_cov_110.178261	189	269	86	1	80	0.0125000
NODE_132873_length_329_cov_110.178261	189	269	90	3	80	0.0375000
NODE_132873_length_329_cov_110.178261	189	269	92	1	80	0.0125000
NODE_132873_length_329_cov_110.178261	189	269	93	2	80	0.0250000
NODE_132873_length_329_cov_110.178261	189	269	94	2	80	0.0250000
NODE_132873_length_329_cov_110.178261	189	269	99	2	80	0.0250000
NODE_132873_length_329_cov_110.178261	189	269	101	3	80	0.0375000
NODE_132873_length_329_cov_110.178261	189	269	103	2	80	0.0250000
NODE_132873_length_329_cov_110.178261	189	269	107	3	80	0.0375000
NODE_132873_length_329_cov_110.178261	189	269	109	1	80	0.0125000
NODE_132873_length_329_cov_110.178261	189	269	112	6	80	0.0750000
NODE_132873_length_329_cov_110.178261	189	269	114	2	80	0.0250000
NODE_132873_length_329_cov_110.178261	189	269	116	1	80	0.0125000
NODE_132873_length_329_cov_110.178261	189	269	117	3	80	0.0375000
NODE_132873_length_329_cov_110.178261	189	269	119	1	80	0.0125000
NODE_132873_length_329_cov_110.178261	189	269	120	3	80	0.0375000
NODE_132873_length_329_cov_110.178261	189	269	121	1	80	0.0125000
NODE_132873_length_329_cov_110.178261	189	269	122	6	80	0.0750000
NODE_132873_length_329_cov_110.178261	189	269	124	7	80	0.0875000
NODE_132873_length_329_cov_110.178261	189	269	125	1	80	0.0125000
NODE_132873_length_329_cov_110.178261	189	269	126	11	80	0.1375000
NODE_132873_length_329_cov_110.178261	189	269	128	1	80	0.0125000
NODE_132873_length_329_cov_110.178261	189	269	130	6	80	0.0750000
NODE_132873_length_329_cov_110.178261	189	269	132	5	80	0.0625000
NODE_132873_length_329_cov_110.178261	242	322	22	4	80	0.0500000
NODE_132873_length_329_cov_110.178261	242	322	24	3	80	0.0375000
NODE_132873_length_329_cov_110.178261	242	322	26	2	80	0.0250000
NODE_132873_length_329_cov_110.178261	242	322	28	1	80	0.0125000
NODE_132873_length_329_cov_110.178261	242	322	30	4	80	0.0500000
NODE_132873_length_329_cov_110.178261	242	322	32	5	80	0.0625000
NODE_132873_length_329_cov_110.178261	242	322	34	3	80	0.0375000
NODE_132873_length_329_cov_110.178261	242	322	42	3	80	0.0375000
NODE_132873_length_329_cov_110.178261	242	322	46	1	80	0.0125000
NODE_132873_length_329_cov_110.178261	242	322	48	3	80	0.0375000
NODE_132873_length_329_cov_110.178261	242	322	50	1	80	0.0125000
NODE_132873_length_329_cov_110.178261	242	322	54	1	80	0.0125000
NODE_132873_length_329_cov_110.178261	242	322	60	5	80	0.0625000
NODE_132873_length_329_cov_110.178261	242	322	72	1	80	0.0125000
NODE_132873_length_329_cov_110.178261	242	322	74	5	80	0.0625000
NODE_132873_length_329_cov_110.178261	242	322	76	1	80	0.0125000
NODE_132873_length_329_cov_110.178261	242	322	78	4	80	0.0500000
NODE_132873_length_329_cov_110.178261	242	322	80	1	80	0.0125000
NODE_132873_length_329_cov_110.178261	242	322	84	3	80	0.0375000
NODE_132873_length_329_cov_110.178261	242	322	86	3	80	0.0375000
NODE_132873_length_329_cov_110.178261	242	322	90	3	80	0.0375000
NODE_132873_length_329_cov_110.178261	242	322	93	1	80	0.0125000
NODE_132873_length_329_cov_110.178261	242	322	101	3	80	0.0375000
NODE_132873_length_329_cov_110.178261	242	322	107	2	80	0.0250000
NODE_132873_length_329_cov_110.178261	242	322	109	1	80	0.0125000
NODE_132873_length_329_cov_110.178261	242	322	112	6	80	0.0750000
NODE_132873_length_329_cov_110.178261	242	322	114	2	80	0.0250000
NODE_132873_length_329_cov_110.178261	242	322	116	1	80	0.0125000
NODE_132873_length_329_cov_110.178261	242	322	120	3	80	0.0375000
NODE_132873_length_329_cov_110.178261	242	322	122	1	80	0.0125000
NODE_132873_length_329_cov_110.178261	242	322	124	3	80	0.0375000
NODE_132879_length_329_cov_8.882609	61	141	0	80	80	1.0000000
NODE_132879_length_329_cov_8.882609	114	194	0	80	80	1.0000000
NODE_132885_length_329_cov_6.586957	166	207	0	41	41	1.0000000
NODE_132908_length_329_cov_4.617391	175	229	4	54	54	1.0000000
NODE_132970_length_329_cov_3.160870	59	139	0	80	80	1.0000000
NODE_133003_length_329_cov_2.821739	164	209	2	45	45	1.0000000
NODE_133003_length_329_cov_2.821739	184	262	0	53	78	0.6794872
NODE_133003_length_329_cov_2.821739	184	262	2	25	78	0.3205128
NODE_133033_length_329_cov_2.560870	139	201	2	5	62	0.0806452
NODE_133033_length_329_cov_2.560870	139	201	4	43	62	0.6935484
NODE_133033_length_329_cov_2.560870	139	201	6	14	62	0.2258064
NODE_133036_length_329_cov_2.543478	145	206	0	61	61	1.0000000
NODE_133123_length_329_cov_2.143478	39	119	15	5	80	0.0625000
NODE_133123_length_329_cov_2.143478	39	119	16	15	80	0.1875000
NODE_133123_length_329_cov_2.143478	39	119	20	2	80	0.0250000
NODE_133123_length_329_cov_2.143478	39	119	21	4	80	0.0500000
NODE_133123_length_329_cov_2.143478	39	119	25	1	80	0.0125000
NODE_133123_length_329_cov_2.143478	39	119	26	7	80	0.0875000
NODE_133123_length_329_cov_2.143478	39	119	28	17	80	0.2125000
NODE_133123_length_329_cov_2.143478	39	119	30	29	80	0.3625000
NODE_133123_length_329_cov_2.143478	92	158	16	4	66	0.0606061
NODE_133123_length_329_cov_2.143478	92	158	18	10	66	0.1515152
NODE_133123_length_329_cov_2.143478	92	158	20	1	66	0.0151515
NODE_133123_length_329_cov_2.143478	92	158	26	4	66	0.0606061
NODE_133123_length_329_cov_2.143478	92	158	28	11	66	0.1666667
NODE_133123_length_329_cov_2.143478	92	158	30	36	66	0.5454546
NODE_133184_length_329_cov_1.865217	182	252	0	2	70	0.0285714
NODE_133184_length_329_cov_1.865217	182	252	4	24	70	0.3428572
NODE_133184_length_329_cov_1.865217	182	252	5	5	70	0.0714286
NODE_133184_length_329_cov_1.865217	182	252	7	11	70	0.1571429
NODE_133184_length_329_cov_1.865217	182	252	9	25	70	0.3571429
NODE_133184_length_329_cov_1.865217	182	252	11	3	70	0.0428571
NODE_133200_length_329_cov_1.791304	50	84	0	34	34	1.0000000
NODE_133200_length_329_cov_1.791304	92	149	0	49	57	0.8596491
NODE_133200_length_329_cov_1.791304	92	149	2	8	57	0.1403509
NODE_133200_length_329_cov_1.791304	145	203	0	8	58	0.1379310
NODE_133200_length_329_cov_1.791304	145	203	2	50	58	0.8620690
NODE_133332_length_329_cov_1.508696	261	323	0	62	62	1.0000000
NODE_133348_length_329_cov_1.469565	168	237	0	2	69	0.0289855
NODE_133348_length_329_cov_1.469565	168	237	1	3	69	0.0434783
NODE_133348_length_329_cov_1.469565	168	237	2	64	69	0.9275362
NODE_133376_length_329_cov_1.391304	275	307	24	32	32	1.0000000
NODE_133547_length_329_cov_1.165217	199	242	0	43	43	1.0000000
NODE_133768_length_329_cov_0.878261	221	296	5	75	75	1.0000000
NODE_133970_length_328_cov_4.484716	95	175	0	80	80	1.0000000
NODE_133989_length_328_cov_4.087336	79	159	4	7	80	0.0875000
NODE_133989_length_328_cov_4.087336	79	159	9	32	80	0.4000000
NODE_133989_length_328_cov_4.087336	79	159	10	2	80	0.0250000
NODE_133989_length_328_cov_4.087336	79	159	14	15	80	0.1875000
NODE_133989_length_328_cov_4.087336	79	159	16	24	80	0.3000000
NODE_133989_length_328_cov_4.087336	132	207	0	27	75	0.3600000
NODE_133989_length_328_cov_4.087336	132	207	1	5	75	0.0666667
NODE_133989_length_328_cov_4.087336	132	207	2	5	75	0.0666667
NODE_133989_length_328_cov_4.087336	132	207	4	18	75	0.2400000
NODE_133989_length_328_cov_4.087336	132	207	9	20	75	0.2666667
NODE_133993_length_328_cov_3.895197	110	190	6	3	80	0.0375000
NODE_133993_length_328_cov_3.895197	110	190	8	77	80	0.9625000
NODE_134019_length_328_cov_3.393013	30	78	0	48	48	1.0000000
NODE_134144_length_328_cov_2.161572	103	134	4	31	31	1.0000000
NODE_134247_length_328_cov_1.781659	16	44	0	28	28	1.0000000
NODE_134335_length_328_cov_1.567686	0	76	0	10	76	0.1315790
NODE_134335_length_328_cov_1.567686	0	76	1	2	76	0.0263158
NODE_134335_length_328_cov_1.567686	0	76	5	13	76	0.1710526
NODE_134335_length_328_cov_1.567686	0	76	7	5	76	0.0657895
NODE_134335_length_328_cov_1.567686	0	76	8	46	76	0.6052632
NODE_134335_length_328_cov_1.567686	49	94	8	44	45	0.9777778
NODE_134335_length_328_cov_1.567686	49	94	10	1	45	0.0222222
NODE_134452_length_328_cov_1.336245	0	73	0	73	73	1.0000000
NODE_134508_length_328_cov_1.266376	78	158	0	17	80	0.2125000
NODE_134508_length_328_cov_1.266376	78	158	2	63	80	0.7875000
NODE_135002_length_327_cov_4.934211	170	250	0	80	80	1.0000000
NODE_135009_length_327_cov_4.701754	225	305	0	10	80	0.1250000
NODE_135009_length_327_cov_4.701754	225	305	2	70	80	0.8750000
NODE_135018_length_327_cov_4.241228	97	173	16	17	76	0.2236842
NODE_135018_length_327_cov_4.241228	97	173	18	4	76	0.0526316
NODE_135018_length_327_cov_4.241228	97	173	20	11	76	0.1447368
NODE_135018_length_327_cov_4.241228	97	173	22	3	76	0.0394737
NODE_135018_length_327_cov_4.241228	97	173	24	24	76	0.3157895
NODE_135018_length_327_cov_4.241228	97	173	26	17	76	0.2236842
NODE_135037_length_327_cov_3.719298	70	150	0	43	80	0.5375000
NODE_135037_length_327_cov_3.719298	70	150	2	37	80	0.4625000
NODE_135063_length_327_cov_3.350877	156	227	0	4	71	0.0563380
NODE_135063_length_327_cov_3.350877	156	227	2	4	71	0.0563380
NODE_135063_length_327_cov_3.350877	156	227	7	8	71	0.1126761
NODE_135063_length_327_cov_3.350877	156	227	8	16	71	0.2253521
NODE_135063_length_327_cov_3.350877	156	227	11	7	71	0.0985916
NODE_135063_length_327_cov_3.350877	156	227	12	32	71	0.4507042
NODE_135328_length_327_cov_1.780702	191	271	6	3	80	0.0375000
NODE_135328_length_327_cov_1.780702	191	271	8	4	80	0.0500000
NODE_135328_length_327_cov_1.780702	191	271	10	5	80	0.0625000
NODE_135328_length_327_cov_1.780702	191	271	11	1	80	0.0125000
NODE_135328_length_327_cov_1.780702	191	271	12	4	80	0.0500000
NODE_135328_length_327_cov_1.780702	191	271	14	63	80	0.7875000
NODE_136081_length_326_cov_3.964758	178	228	0	50	50	1.0000000
NODE_136100_length_326_cov_3.502203	211	253	2	12	42	0.2857143
NODE_136100_length_326_cov_3.502203	211	253	4	30	42	0.7142857
NODE_136100_length_326_cov_3.502203	220	255	2	3	35	0.0857143
NODE_136100_length_326_cov_3.502203	220	255	4	32	35	0.9142857
NODE_136116_length_326_cov_3.202643	149	203	1	2	54	0.0370370
NODE_136116_length_326_cov_3.202643	149	203	3	2	54	0.0370370
NODE_136116_length_326_cov_3.202643	149	203	5	10	54	0.1851852
NODE_136116_length_326_cov_3.202643	149	203	7	21	54	0.3888889
NODE_136116_length_326_cov_3.202643	149	203	8	2	54	0.0370370
NODE_136116_length_326_cov_3.202643	149	203	10	17	54	0.3148148
NODE_136130_length_326_cov_3.057269	107	126	0	17	19	0.8947368
NODE_136130_length_326_cov_3.057269	107	126	2	2	19	0.1052632
NODE_136176_length_326_cov_2.594714	125	196	0	71	71	1.0000000
NODE_136283_length_326_cov_2.123348	184	244	0	60	60	1.0000000
NODE_136496_length_326_cov_1.515419	86	166	0	78	80	0.9750000
NODE_136496_length_326_cov_1.515419	86	166	2	2	80	0.0250000
NODE_137182_length_325_cov_4.893805	142	222	26	9	80	0.1125000
NODE_137182_length_325_cov_4.893805	142	222	30	7	80	0.0875000
NODE_137182_length_325_cov_4.893805	142	222	32	11	80	0.1375000
NODE_137182_length_325_cov_4.893805	142	222	34	10	80	0.1250000
NODE_137182_length_325_cov_4.893805	142	222	36	1	80	0.0125000
NODE_137182_length_325_cov_4.893805	142	222	38	11	80	0.1375000
NODE_137182_length_325_cov_4.893805	142	222	39	1	80	0.0125000
NODE_137182_length_325_cov_4.893805	142	222	40	16	80	0.2000000
NODE_137182_length_325_cov_4.893805	142	222	42	14	80	0.1750000
NODE_137182_length_325_cov_4.893805	195	275	7	4	80	0.0500000
NODE_137182_length_325_cov_4.893805	195	275	14	2	80	0.0250000
NODE_137182_length_325_cov_4.893805	195	275	15	7	80	0.0875000
NODE_137182_length_325_cov_4.893805	195	275	17	1	80	0.0125000
NODE_137182_length_325_cov_4.893805	195	275	18	9	80	0.1125000
NODE_137182_length_325_cov_4.893805	195	275	20	6	80	0.0750000
NODE_137182_length_325_cov_4.893805	195	275	25	1	80	0.0125000
NODE_137182_length_325_cov_4.893805	195	275	27	2	80	0.0250000
NODE_137182_length_325_cov_4.893805	195	275	28	9	80	0.1125000
NODE_137182_length_325_cov_4.893805	195	275	30	3	80	0.0375000
NODE_137182_length_325_cov_4.893805	195	275	34	7	80	0.0875000
NODE_137182_length_325_cov_4.893805	195	275	36	2	80	0.0250000
NODE_137182_length_325_cov_4.893805	195	275	38	3	80	0.0375000
NODE_137182_length_325_cov_4.893805	195	275	39	1	80	0.0125000
NODE_137182_length_325_cov_4.893805	195	275	40	9	80	0.1125000
NODE_137182_length_325_cov_4.893805	195	275	42	14	80	0.1750000
NODE_137199_length_325_cov_4.000000	134	198	0	64	64	1.0000000
NODE_137221_length_325_cov_3.513274	191	266	11	3	75	0.0400000
NODE_137221_length_325_cov_3.513274	191	266	13	34	75	0.4533333
NODE_137221_length_325_cov_3.513274	191	266	15	16	75	0.2133333
NODE_137221_length_325_cov_3.513274	191	266	17	1	75	0.0133333
NODE_137221_length_325_cov_3.513274	191	266	19	9	75	0.1200000
NODE_137221_length_325_cov_3.513274	191	266	20	12	75	0.1600000
NODE_137221_length_325_cov_3.513274	240	319	5	1	79	0.0126582
NODE_137221_length_325_cov_3.513274	240	319	6	1	79	0.0126582
NODE_137221_length_325_cov_3.513274	240	319	10	16	79	0.2025317
NODE_137221_length_325_cov_3.513274	240	319	14	1	79	0.0126582
NODE_137221_length_325_cov_3.513274	240	319	15	4	79	0.0506329
NODE_137221_length_325_cov_3.513274	240	319	16	13	79	0.1645570
NODE_137221_length_325_cov_3.513274	240	319	17	1	79	0.0126582
NODE_137221_length_325_cov_3.513274	240	319	18	11	79	0.1392405
NODE_137221_length_325_cov_3.513274	240	319	19	9	79	0.1139240
NODE_137221_length_325_cov_3.513274	240	319	20	22	79	0.2784810
NODE_137223_length_325_cov_3.469027	216	278	0	62	62	1.0000000
NODE_137224_length_325_cov_3.429204	178	224	0	1	46	0.0217391
NODE_137224_length_325_cov_3.429204	178	224	2	45	46	0.9782609
NODE_137243_length_325_cov_3.168142	188	274	0	10	86	0.1162791
NODE_137243_length_325_cov_3.168142	188	274	2	76	86	0.8837209
NODE_137268_length_325_cov_2.880531	72	152	0	11	80	0.1375000
NODE_137268_length_325_cov_2.880531	72	152	2	10	80	0.1250000
NODE_137268_length_325_cov_2.880531	72	152	4	7	80	0.0875000
NODE_137268_length_325_cov_2.880531	72	152	6	15	80	0.1875000
NODE_137268_length_325_cov_2.880531	72	152	8	21	80	0.2625000
NODE_137268_length_325_cov_2.880531	72	152	10	12	80	0.1500000
NODE_137268_length_325_cov_2.880531	72	152	11	4	80	0.0500000
NODE_137268_length_325_cov_2.880531	125	205	8	13	80	0.1625000
NODE_137268_length_325_cov_2.880531	125	205	10	16	80	0.2000000
NODE_137268_length_325_cov_2.880531	125	205	11	6	80	0.0750000
NODE_137268_length_325_cov_2.880531	125	205	12	10	80	0.1250000
NODE_137268_length_325_cov_2.880531	125	205	13	16	80	0.2000000
NODE_137268_length_325_cov_2.880531	125	205	14	6	80	0.0750000
NODE_137268_length_325_cov_2.880531	125	205	16	13	80	0.1625000
NODE_137291_length_325_cov_2.707965	203	261	0	56	58	0.9655172
NODE_137291_length_325_cov_2.707965	203	261	2	2	58	0.0344828
NODE_137296_length_325_cov_2.703540	68	148	0	35	80	0.4375000
NODE_137296_length_325_cov_2.703540	68	148	2	45	80	0.5625000
NODE_137330_length_325_cov_2.500000	0	42	0	42	42	1.0000000
NODE_137407_length_325_cov_2.048673	122	202	24	6	80	0.0750000
NODE_137407_length_325_cov_2.048673	122	202	26	1	80	0.0125000
NODE_137407_length_325_cov_2.048673	122	202	30	4	80	0.0500000
NODE_137407_length_325_cov_2.048673	122	202	31	1	80	0.0125000
NODE_137407_length_325_cov_2.048673	122	202	32	6	80	0.0750000
NODE_137407_length_325_cov_2.048673	122	202	33	4	80	0.0500000
NODE_137407_length_325_cov_2.048673	122	202	34	24	80	0.3000000
NODE_137407_length_325_cov_2.048673	122	202	36	21	80	0.2625000
NODE_137407_length_325_cov_2.048673	122	202	38	13	80	0.1625000
NODE_137409_length_325_cov_2.035398	83	154	0	9	71	0.1267606
NODE_137409_length_325_cov_2.035398	83	154	2	62	71	0.8732395
NODE_137642_length_325_cov_1.464602	153	224	0	2	71	0.0281690
NODE_137642_length_325_cov_1.464602	153	224	2	69	71	0.9718310
NODE_137939_length_325_cov_1.017699	103	134	0	25	31	0.8064516
NODE_137939_length_325_cov_1.017699	103	134	6	6	31	0.1935484
NODE_138113_length_325_cov_0.827434	258	308	2	3	50	0.0600000
NODE_138113_length_325_cov_0.827434	258	308	8	12	50	0.2400000
NODE_138113_length_325_cov_0.827434	258	308	10	35	50	0.7000000
NODE_138309_length_324_cov_4.737778	113	160	0	47	47	1.0000000
NODE_138309_length_324_cov_4.737778	142	213	0	71	71	1.0000000
NODE_138358_length_324_cov_3.626667	218	273	0	55	55	1.0000000
NODE_138396_length_324_cov_3.124444	101	181	0	60	80	0.7500000
NODE_138396_length_324_cov_3.124444	101	181	2	20	80	0.2500000
NODE_138396_length_324_cov_3.124444	256	285	2	29	29	1.0000000
NODE_138416_length_324_cov_2.924444	114	198	0	84	84	1.0000000
NODE_138416_length_324_cov_2.924444	178	237	0	51	59	0.8644068
NODE_138416_length_324_cov_2.924444	178	237	2	8	59	0.1355932
NODE_138418_length_324_cov_2.915556	141	221	0	80	80	1.0000000
NODE_138434_length_324_cov_2.715556	4	51	2	32	47	0.6808510
NODE_138434_length_324_cov_2.715556	4	51	4	15	47	0.3191489
NODE_138434_length_324_cov_2.715556	24	104	0	8	80	0.1000000
NODE_138434_length_324_cov_2.715556	24	104	2	26	80	0.3250000
NODE_138434_length_324_cov_2.715556	24	104	4	46	80	0.5750000
NODE_138463_length_324_cov_2.506667	270	306	0	36	36	1.0000000
NODE_138483_length_324_cov_2.448889	187	238	8	5	51	0.0980392
NODE_138483_length_324_cov_2.448889	187	238	10	38	51	0.7450981
NODE_138483_length_324_cov_2.448889	187	238	12	8	51	0.1568628
NODE_138527_length_324_cov_2.248889	30	96	0	66	66	1.0000000
NODE_138778_length_324_cov_1.502222	10	90	0	7	80	0.0875000
NODE_138778_length_324_cov_1.502222	10	90	6	48	80	0.6000000
NODE_138778_length_324_cov_1.502222	10	90	8	25	80	0.3125000
NODE_138792_length_324_cov_1.457778	0	45	0	45	45	1.0000000
NODE_138792_length_324_cov_1.457778	18	75	0	50	57	0.8771930
NODE_138792_length_324_cov_1.457778	18	75	6	2	57	0.0350877
NODE_138792_length_324_cov_1.457778	18	75	10	5	57	0.0877193
NODE_138808_length_324_cov_1.382222	263	304	0	41	41	1.0000000
NODE_139129_length_324_cov_1.017778	0	59	0	59	59	1.0000000
NODE_139497_length_323_cov_6.669643	215	286	0	71	71	1.0000000
NODE_139497_length_323_cov_6.669643	268	315	0	47	47	1.0000000
NODE_139511_length_323_cov_5.089286	224	290	4	25	66	0.3787879
NODE_139511_length_323_cov_5.089286	224	290	6	10	66	0.1515152
NODE_139511_length_323_cov_5.089286	224	290	7	2	66	0.0303030
NODE_139511_length_323_cov_5.089286	224	290	8	29	66	0.4393939
NODE_139511_length_323_cov_5.089286	263	319	0	13	56	0.2321429
NODE_139511_length_323_cov_5.089286	263	319	4	8	56	0.1428571
NODE_139511_length_323_cov_5.089286	263	319	6	18	56	0.3214286
NODE_139511_length_323_cov_5.089286	263	319	8	17	56	0.3035714
NODE_139572_length_323_cov_3.276786	189	269	2	16	80	0.2000000
NODE_139572_length_323_cov_3.276786	189	269	4	17	80	0.2125000
NODE_139572_length_323_cov_3.276786	189	269	6	12	80	0.1500000
NODE_139572_length_323_cov_3.276786	189	269	11	2	80	0.0250000
NODE_139572_length_323_cov_3.276786	189	269	12	18	80	0.2250000
NODE_139572_length_323_cov_3.276786	189	269	14	1	80	0.0125000
NODE_139572_length_323_cov_3.276786	189	269	16	7	80	0.0875000
NODE_139572_length_323_cov_3.276786	189	269	17	2	80	0.0250000
NODE_139572_length_323_cov_3.276786	189	269	18	5	80	0.0625000
NODE_139575_length_323_cov_3.263393	101	181	4	18	80	0.2250000
NODE_139575_length_323_cov_3.263393	101	181	6	7	80	0.0875000
NODE_139575_length_323_cov_3.263393	101	181	8	33	80	0.4125000
NODE_139575_length_323_cov_3.263393	101	181	10	5	80	0.0625000
NODE_139575_length_323_cov_3.263393	101	181	12	17	80	0.2125000
NODE_139591_length_323_cov_3.089286	128	208	0	21	80	0.2625000
NODE_139591_length_323_cov_3.089286	128	208	2	59	80	0.7375000
NODE_139591_length_323_cov_3.089286	166	208	2	42	42	1.0000000
NODE_139591_length_323_cov_3.089286	181	261	0	30	80	0.3750000
NODE_139591_length_323_cov_3.089286	181	261	2	50	80	0.6250000
NODE_139591_length_323_cov_3.089286	181	261	0	30	80	0.3750000
NODE_139591_length_323_cov_3.089286	181	261	2	50	80	0.6250000
NODE_139629_length_323_cov_2.683036	144	215	24	1	71	0.0140845
NODE_139629_length_323_cov_2.683036	144	215	26	2	71	0.0281690
NODE_139629_length_323_cov_2.683036	144	215	28	68	71	0.9577465
NODE_139746_length_323_cov_2.089286	64	144	4	80	80	1.0000000
NODE_139797_length_323_cov_1.888393	148	207	0	17	59	0.2881356
NODE_139797_length_323_cov_1.888393	148	207	2	14	59	0.2372881
NODE_139797_length_323_cov_1.888393	148	207	6	4	59	0.0677966
NODE_139797_length_323_cov_1.888393	148	207	8	24	59	0.4067796
NODE_139901_length_323_cov_1.705357	195	262	0	67	67	1.0000000
NODE_139901_length_323_cov_1.705357	235	315	0	80	80	1.0000000
NODE_140651_length_322_cov_5.475336	56	136	0	80	80	1.0000000
NODE_140651_length_322_cov_5.475336	113	189	0	76	76	1.0000000
NODE_140692_length_322_cov_3.753363	63	133	0	24	70	0.3428572
NODE_140692_length_322_cov_3.753363	63	133	2	34	70	0.4857143
NODE_140692_length_322_cov_3.753363	63	133	4	12	70	0.1714286
NODE_140692_length_322_cov_3.753363	116	190	0	74	74	1.0000000
NODE_140693_length_322_cov_3.735426	60	86	0	26	26	1.0000000
NODE_140693_length_322_cov_3.735426	99	139	0	40	40	1.0000000
NODE_140701_length_322_cov_3.605381	73	116	10	3	43	0.0697674
NODE_140701_length_322_cov_3.605381	73	116	12	9	43	0.2093023
NODE_140701_length_322_cov_3.605381	73	116	14	13	43	0.3023256
NODE_140701_length_322_cov_3.605381	73	116	16	18	43	0.4186046
NODE_140702_length_322_cov_3.600897	75	145	2	37	70	0.5285714
NODE_140702_length_322_cov_3.600897	75	145	4	33	70	0.4714286
NODE_140820_length_322_cov_2.304933	182	213	8	31	31	1.0000000
NODE_141738_length_321_cov_8.527027	176	240	10	3	64	0.0468750
NODE_141738_length_321_cov_8.527027	176	240	12	5	64	0.0781250
NODE_141738_length_321_cov_8.527027	176	240	14	3	64	0.0468750
NODE_141738_length_321_cov_8.527027	176	240	16	2	64	0.0312500
NODE_141738_length_321_cov_8.527027	176	240	18	51	64	0.7968750
NODE_141786_length_321_cov_4.094595	196	266	0	52	70	0.7428572
NODE_141786_length_321_cov_4.094595	196	266	2	18	70	0.2571429
NODE_141811_length_321_cov_3.563063	59	131	8	3	72	0.0416667
NODE_141811_length_321_cov_3.563063	59	131	10	5	72	0.0694444
NODE_141811_length_321_cov_3.563063	59	131	12	13	72	0.1805556
NODE_141811_length_321_cov_3.563063	59	131	14	29	72	0.4027778
NODE_141811_length_321_cov_3.563063	59	131	16	22	72	0.3055556
NODE_141811_length_321_cov_3.563063	112	183	6	11	71	0.1549296
NODE_141811_length_321_cov_3.563063	112	183	8	9	71	0.1267606
NODE_141811_length_321_cov_3.563063	112	183	10	40	71	0.5633803
NODE_141811_length_321_cov_3.563063	112	183	14	11	71	0.1549296
NODE_141813_length_321_cov_3.540541	112	141	6	16	29	0.5517241
NODE_141813_length_321_cov_3.540541	112	141	8	13	29	0.4482759
NODE_141833_length_321_cov_3.049550	65	115	53	3	50	0.0600000
NODE_141833_length_321_cov_3.049550	65	115	54	10	50	0.2000000
NODE_141833_length_321_cov_3.049550	65	115	56	4	50	0.0800000
NODE_141833_length_321_cov_3.049550	65	115	60	1	50	0.0200000
NODE_141833_length_321_cov_3.049550	65	115	64	1	50	0.0200000
NODE_141833_length_321_cov_3.049550	65	115	68	6	50	0.1200000
NODE_141833_length_321_cov_3.049550	65	115	70	18	50	0.3600000
NODE_141833_length_321_cov_3.049550	65	115	72	7	50	0.1400000
NODE_141833_length_321_cov_3.049550	95	138	64	17	43	0.3953488
NODE_141833_length_321_cov_3.049550	95	138	68	7	43	0.1627907
NODE_141833_length_321_cov_3.049550	95	138	70	13	43	0.3023256
NODE_141833_length_321_cov_3.049550	95	138	72	6	43	0.1395349
NODE_141833_length_321_cov_3.049550	118	168	4	1	50	0.0200000
NODE_141833_length_321_cov_3.049550	118	168	6	1	50	0.0200000
NODE_141833_length_321_cov_3.049550	118	168	10	3	50	0.0600000
NODE_141833_length_321_cov_3.049550	118	168	22	2	50	0.0400000
NODE_141833_length_321_cov_3.049550	118	168	24	1	50	0.0200000
NODE_141833_length_321_cov_3.049550	118	168	30	1	50	0.0200000
NODE_141833_length_321_cov_3.049550	118	168	32	1	50	0.0200000
NODE_141833_length_321_cov_3.049550	118	168	36	1	50	0.0200000
NODE_141833_length_321_cov_3.049550	118	168	46	3	50	0.0600000
NODE_141833_length_321_cov_3.049550	118	168	50	2	50	0.0400000
NODE_141833_length_321_cov_3.049550	118	168	52	1	50	0.0200000
NODE_141833_length_321_cov_3.049550	118	168	56	6	50	0.1200000
NODE_141833_length_321_cov_3.049550	118	168	61	1	50	0.0200000
NODE_141833_length_321_cov_3.049550	118	168	62	1	50	0.0200000
NODE_141833_length_321_cov_3.049550	118	168	64	22	50	0.4400000
NODE_141833_length_321_cov_3.049550	118	168	68	3	50	0.0600000
NODE_141837_length_321_cov_2.995495	146	220	0	22	74	0.2972973
NODE_141837_length_321_cov_2.995495	146	220	2	52	74	0.7027027
NODE_141842_length_321_cov_2.981982	251	304	2	53	53	1.0000000
NODE_141876_length_321_cov_2.734234	239	306	0	62	67	0.9253731
NODE_141876_length_321_cov_2.734234	239	306	2	5	67	0.0746269
NODE_141910_length_321_cov_2.427928	221	265	0	44	44	1.0000000
NODE_141922_length_321_cov_2.315315	22	65	0	43	43	1.0000000
NODE_141951_length_321_cov_2.270270	43	105	0	31	62	0.5000000
NODE_141951_length_321_cov_2.270270	43	105	2	31	62	0.5000000
NODE_141951_length_321_cov_2.270270	120	203	2	68	83	0.8192771
NODE_141951_length_321_cov_2.270270	120	203	4	15	83	0.1807229
NODE_141951_length_321_cov_2.270270	127	208	2	71	81	0.8765432
NODE_141951_length_321_cov_2.270270	127	208	4	10	81	0.1234568
NODE_142200_length_321_cov_1.576577	241	321	0	80	80	1.0000000
NODE_142363_length_321_cov_1.319820	253	304	2	51	51	1.0000000
NODE_142484_length_321_cov_1.130631	0	43	0	43	43	1.0000000
NODE_142700_length_321_cov_0.869369	248	294	2	46	46	1.0000000
NODE_142885_length_320_cov_200.484163	264	320	4	1	56	0.0178571
NODE_142885_length_320_cov_200.484163	264	320	14	2	56	0.0357143
NODE_142885_length_320_cov_200.484163	264	320	18	9	56	0.1607143
NODE_142885_length_320_cov_200.484163	264	320	20	2	56	0.0357143
NODE_142885_length_320_cov_200.484163	264	320	24	2	56	0.0357143
NODE_142885_length_320_cov_200.484163	264	320	28	2	56	0.0357143
NODE_142885_length_320_cov_200.484163	264	320	30	3	56	0.0535714
NODE_142885_length_320_cov_200.484163	264	320	32	1	56	0.0178571
NODE_142885_length_320_cov_200.484163	264	320	38	15	56	0.2678571
NODE_142885_length_320_cov_200.484163	264	320	40	11	56	0.1964286
NODE_142885_length_320_cov_200.484163	264	320	42	8	56	0.1428571
NODE_142886_length_320_cov_73.357466	51	97	0	46	46	1.0000000
NODE_142886_length_320_cov_73.357466	108	154	0	46	46	1.0000000
NODE_142886_length_320_cov_73.357466	165	245	0	43	80	0.5375000
NODE_142886_length_320_cov_73.357466	165	245	9	37	80	0.4625000
NODE_142886_length_320_cov_73.357466	218	296	9	78	78	1.0000000
NODE_142887_length_320_cov_35.787330	212	292	14	4	80	0.0500000
NODE_142887_length_320_cov_35.787330	212	292	18	22	80	0.2750000
NODE_142887_length_320_cov_35.787330	212	292	22	30	80	0.3750000
NODE_142887_length_320_cov_35.787330	212	292	23	1	80	0.0125000
NODE_142887_length_320_cov_35.787330	212	292	24	23	80	0.2875000
NODE_142887_length_320_cov_35.787330	212	292	14	4	80	0.0500000
NODE_142887_length_320_cov_35.787330	212	292	18	22	80	0.2750000
NODE_142887_length_320_cov_35.787330	212	292	22	30	80	0.3750000
NODE_142887_length_320_cov_35.787330	212	292	23	1	80	0.0125000
NODE_142887_length_320_cov_35.787330	212	292	24	23	80	0.2875000
NODE_142887_length_320_cov_35.787330	212	292	14	4	80	0.0500000
NODE_142887_length_320_cov_35.787330	212	292	18	22	80	0.2750000
NODE_142887_length_320_cov_35.787330	212	292	22	30	80	0.3750000
NODE_142887_length_320_cov_35.787330	212	292	23	1	80	0.0125000
NODE_142887_length_320_cov_35.787330	212	292	24	23	80	0.2875000
NODE_142887_length_320_cov_35.787330	212	292	14	4	80	0.0500000
NODE_142887_length_320_cov_35.787330	212	292	18	22	80	0.2750000
NODE_142887_length_320_cov_35.787330	212	292	22	30	80	0.3750000
NODE_142887_length_320_cov_35.787330	212	292	23	1	80	0.0125000
NODE_142887_length_320_cov_35.787330	212	292	24	23	80	0.2875000
NODE_142887_length_320_cov_35.787330	212	292	14	4	80	0.0500000
NODE_142887_length_320_cov_35.787330	212	292	18	22	80	0.2750000
NODE_142887_length_320_cov_35.787330	212	292	22	30	80	0.3750000
NODE_142887_length_320_cov_35.787330	212	292	23	1	80	0.0125000
NODE_142887_length_320_cov_35.787330	212	292	24	23	80	0.2875000
NODE_142887_length_320_cov_35.787330	265	314	0	2	49	0.0408163
NODE_142887_length_320_cov_35.787330	265	314	2	4	49	0.0816327
NODE_142887_length_320_cov_35.787330	265	314	8	11	49	0.2244898
NODE_142887_length_320_cov_35.787330	265	314	18	27	49	0.5510204
NODE_142887_length_320_cov_35.787330	265	314	22	5	49	0.1020408
NODE_142887_length_320_cov_35.787330	265	320	0	8	55	0.1454545
NODE_142887_length_320_cov_35.787330	265	320	2	4	55	0.0727273
NODE_142887_length_320_cov_35.787330	265	320	8	11	55	0.2000000
NODE_142887_length_320_cov_35.787330	265	320	18	27	55	0.4909091
NODE_142887_length_320_cov_35.787330	265	320	22	5	55	0.0909091
NODE_142887_length_320_cov_35.787330	265	320	0	8	55	0.1454545
NODE_142887_length_320_cov_35.787330	265	320	2	4	55	0.0727273
NODE_142887_length_320_cov_35.787330	265	320	8	11	55	0.2000000
NODE_142887_length_320_cov_35.787330	265	320	18	27	55	0.4909091
NODE_142887_length_320_cov_35.787330	265	320	22	5	55	0.0909091
NODE_142887_length_320_cov_35.787330	268	320	0	8	52	0.1538462
NODE_142887_length_320_cov_35.787330	268	320	2	4	52	0.0769231
NODE_142887_length_320_cov_35.787330	268	320	8	11	52	0.2115385
NODE_142887_length_320_cov_35.787330	268	320	18	27	52	0.5192308
NODE_142887_length_320_cov_35.787330	268	320	22	2	52	0.0384615
NODE_142887_length_320_cov_35.787330	270	320	0	8	50	0.1600000
NODE_142887_length_320_cov_35.787330	270	320	2	4	50	0.0800000
NODE_142887_length_320_cov_35.787330	270	320	8	11	50	0.2200000
NODE_142887_length_320_cov_35.787330	270	320	18	27	50	0.5400000
NODE_142900_length_320_cov_5.841629	115	172	4	32	57	0.5614035
NODE_142900_length_320_cov_5.841629	115	172	6	25	57	0.4385965
NODE_142900_length_320_cov_5.841629	168	225	6	57	57	1.0000000
NODE_142934_length_320_cov_4.153846	134	200	0	66	66	1.0000000
NODE_142958_length_320_cov_3.733032	5	40	0	35	35	1.0000000
NODE_142985_length_320_cov_3.402715	142	222	0	80	80	1.0000000
NODE_143076_length_320_cov_2.475113	120	187	1	1	67	0.0149254
NODE_143076_length_320_cov_2.475113	120	187	2	2	67	0.0298507
NODE_143076_length_320_cov_2.475113	120	187	3	2	67	0.0298507
NODE_143076_length_320_cov_2.475113	120	187	4	5	67	0.0746269
NODE_143076_length_320_cov_2.475113	120	187	5	18	67	0.2686567
NODE_143076_length_320_cov_2.475113	120	187	6	3	67	0.0447761
NODE_143076_length_320_cov_2.475113	120	187	8	9	67	0.1343284
NODE_143076_length_320_cov_2.475113	120	187	13	5	67	0.0746269
NODE_143076_length_320_cov_2.475113	120	187	19	12	67	0.1791045
NODE_143076_length_320_cov_2.475113	120	187	22	2	67	0.0298507
NODE_143076_length_320_cov_2.475113	120	187	25	1	67	0.0149254
NODE_143076_length_320_cov_2.475113	120	187	27	1	67	0.0149254
NODE_143076_length_320_cov_2.475113	120	187	29	1	67	0.0149254
NODE_143076_length_320_cov_2.475113	120	187	33	3	67	0.0447761
NODE_143076_length_320_cov_2.475113	120	187	37	1	67	0.0149254
NODE_143076_length_320_cov_2.475113	120	187	41	1	67	0.0149254
NODE_143142_length_320_cov_2.171946	16	96	2	8	80	0.1000000
NODE_143142_length_320_cov_2.171946	16	96	4	2	80	0.0250000
NODE_143142_length_320_cov_2.171946	16	96	5	2	80	0.0250000
NODE_143142_length_320_cov_2.171946	16	96	11	1	80	0.0125000
NODE_143142_length_320_cov_2.171946	16	96	17	1	80	0.0125000
NODE_143142_length_320_cov_2.171946	16	96	19	9	80	0.1125000
NODE_143142_length_320_cov_2.171946	16	96	20	21	80	0.2625000
NODE_143142_length_320_cov_2.171946	16	96	22	29	80	0.3625000
NODE_143142_length_320_cov_2.171946	16	96	26	7	80	0.0875000
NODE_143142_length_320_cov_2.171946	69	149	16	9	80	0.1125000
NODE_143142_length_320_cov_2.171946	69	149	18	3	80	0.0375000
NODE_143142_length_320_cov_2.171946	69	149	20	11	80	0.1375000
NODE_143142_length_320_cov_2.171946	69	149	22	35	80	0.4375000
NODE_143142_length_320_cov_2.171946	69	149	25	1	80	0.0125000
NODE_143142_length_320_cov_2.171946	69	149	26	21	80	0.2625000
NODE_143207_length_320_cov_1.900452	37	117	0	11	80	0.1375000
NODE_143207_length_320_cov_1.900452	37	117	4	29	80	0.3625000
NODE_143207_length_320_cov_1.900452	37	117	6	37	80	0.4625000
NODE_143207_length_320_cov_1.900452	37	117	8	3	80	0.0375000
NODE_143207_length_320_cov_1.900452	90	164	2	21	74	0.2837838
NODE_143207_length_320_cov_1.900452	90	164	4	26	74	0.3513514
NODE_143207_length_320_cov_1.900452	90	164	6	24	74	0.3243243
NODE_143207_length_320_cov_1.900452	90	164	8	3	74	0.0405405
NODE_143230_length_320_cov_1.846154	188	220	0	32	32	1.0000000
NODE_143309_length_320_cov_1.665158	144	198	0	54	54	1.0000000
NODE_143309_length_320_cov_1.665158	198	251	0	53	53	1.0000000
NODE_143351_length_320_cov_1.601810	157	181	10	7	24	0.2916667
NODE_143351_length_320_cov_1.601810	157	181	14	17	24	0.7083333
NODE_143351_length_320_cov_1.601810	231	290	6	4	59	0.0677966
NODE_143351_length_320_cov_1.601810	231	290	10	8	59	0.1355932
NODE_143351_length_320_cov_1.601810	231	290	12	20	59	0.3389831
NODE_143351_length_320_cov_1.601810	231	290	18	20	59	0.3389831
NODE_143351_length_320_cov_1.601810	231	290	20	7	59	0.1186441
NODE_143366_length_320_cov_1.556561	0	39	0	2	39	0.0512821
NODE_143366_length_320_cov_1.556561	0	39	1	4	39	0.1025641
NODE_143366_length_320_cov_1.556561	0	39	3	10	39	0.2564103
NODE_143366_length_320_cov_1.556561	0	39	6	1	39	0.0256410
NODE_143366_length_320_cov_1.556561	0	39	7	1	39	0.0256410
NODE_143366_length_320_cov_1.556561	0	39	8	4	39	0.1025641
NODE_143366_length_320_cov_1.556561	0	39	12	10	39	0.2564103
NODE_143366_length_320_cov_1.556561	0	39	14	7	39	0.1794872
NODE_143442_length_320_cov_1.384615	18	98	4	6	80	0.0750000
NODE_143442_length_320_cov_1.384615	18	98	6	2	80	0.0250000
NODE_143442_length_320_cov_1.384615	18	98	8	8	80	0.1000000
NODE_143442_length_320_cov_1.384615	18	98	12	34	80	0.4250000
NODE_143442_length_320_cov_1.384615	18	98	14	25	80	0.3125000
NODE_143442_length_320_cov_1.384615	18	98	18	5	80	0.0625000
NODE_143442_length_320_cov_1.384615	71	145	14	22	74	0.2972973
NODE_143442_length_320_cov_1.384615	71	145	16	27	74	0.3648649
NODE_143442_length_320_cov_1.384615	71	145	18	8	74	0.1081081
NODE_143442_length_320_cov_1.384615	71	145	20	15	74	0.2027027
NODE_143442_length_320_cov_1.384615	71	145	22	2	74	0.0270270
NODE_143521_length_320_cov_1.312217	117	170	0	53	53	1.0000000
NODE_143670_length_320_cov_1.117647	58	109	2	18	51	0.3529412
NODE_143670_length_320_cov_1.117647	58	109	4	4	51	0.0784314
NODE_143670_length_320_cov_1.117647	58	109	5	1	51	0.0196078
NODE_143670_length_320_cov_1.117647	58	109	6	28	51	0.5490196
NODE_144091_length_319_cov_5.940909	122	202	9	37	80	0.4625000
NODE_144091_length_319_cov_5.940909	122	202	10	43	80	0.5375000
NODE_144107_length_319_cov_4.700000	16	47	2	31	31	1.0000000
NODE_144137_length_319_cov_4.068182	5	36	0	31	31	1.0000000
NODE_144162_length_319_cov_3.568182	149	229	0	32	80	0.4000000
NODE_144162_length_319_cov_3.568182	149	229	1	31	80	0.3875000
NODE_144162_length_319_cov_3.568182	149	229	2	17	80	0.2125000
NODE_144206_length_319_cov_3.036364	112	174	0	62	62	1.0000000
NODE_144226_length_319_cov_2.800000	25	106	0	6	81	0.0740741
NODE_144226_length_319_cov_2.800000	25	106	7	1	81	0.0123457
NODE_144226_length_319_cov_2.800000	25	106	14	1	81	0.0123457
NODE_144226_length_319_cov_2.800000	25	106	19	1	81	0.0123457
NODE_144226_length_319_cov_2.800000	25	106	21	1	81	0.0123457
NODE_144226_length_319_cov_2.800000	25	106	38	2	81	0.0246914
NODE_144226_length_319_cov_2.800000	25	106	39	1	81	0.0123457
NODE_144226_length_319_cov_2.800000	25	106	41	1	81	0.0123457
NODE_144226_length_319_cov_2.800000	25	106	49	5	81	0.0617284
NODE_144226_length_319_cov_2.800000	25	106	51	1	81	0.0123457
NODE_144226_length_319_cov_2.800000	25	106	52	1	81	0.0123457
NODE_144226_length_319_cov_2.800000	25	106	68	3	81	0.0370370
NODE_144226_length_319_cov_2.800000	25	106	71	1	81	0.0123457
NODE_144226_length_319_cov_2.800000	25	106	72	3	81	0.0370370
NODE_144226_length_319_cov_2.800000	25	106	74	2	81	0.0246914
NODE_144226_length_319_cov_2.800000	25	106	80	1	81	0.0123457
NODE_144226_length_319_cov_2.800000	25	106	82	1	81	0.0123457
NODE_144226_length_319_cov_2.800000	25	106	84	4	81	0.0493827
NODE_144226_length_319_cov_2.800000	25	106	90	1	81	0.0123457
NODE_144226_length_319_cov_2.800000	25	106	95	1	81	0.0123457
NODE_144226_length_319_cov_2.800000	25	106	99	1	81	0.0123457
NODE_144226_length_319_cov_2.800000	25	106	116	1	81	0.0123457
NODE_144226_length_319_cov_2.800000	25	106	117	1	81	0.0123457
NODE_144226_length_319_cov_2.800000	25	106	119	1	81	0.0123457
NODE_144226_length_319_cov_2.800000	25	106	121	1	81	0.0123457
NODE_144226_length_319_cov_2.800000	25	106	124	1	81	0.0123457
NODE_144226_length_319_cov_2.800000	25	106	128	1	81	0.0123457
NODE_144226_length_319_cov_2.800000	25	106	129	1	81	0.0123457
NODE_144226_length_319_cov_2.800000	25	106	132	1	81	0.0123457
NODE_144226_length_319_cov_2.800000	25	106	133	1	81	0.0123457
NODE_144226_length_319_cov_2.800000	25	106	138	3	81	0.0370370
NODE_144226_length_319_cov_2.800000	25	106	143	3	81	0.0370370
NODE_144226_length_319_cov_2.800000	25	106	151	3	81	0.0370370
NODE_144226_length_319_cov_2.800000	25	106	155	1	81	0.0123457
NODE_144226_length_319_cov_2.800000	25	106	159	4	81	0.0493827
NODE_144226_length_319_cov_2.800000	25	106	174	1	81	0.0123457
NODE_144226_length_319_cov_2.800000	25	106	175	1	81	0.0123457
NODE_144226_length_319_cov_2.800000	25	106	177	1	81	0.0123457
NODE_144226_length_319_cov_2.800000	25	106	179	1	81	0.0123457
NODE_144226_length_319_cov_2.800000	25	106	209	1	81	0.0123457
NODE_144226_length_319_cov_2.800000	25	106	213	2	81	0.0246914
NODE_144226_length_319_cov_2.800000	25	106	219	12	81	0.1481481
NODE_144226_length_319_cov_2.800000	79	158	151	3	79	0.0379747
NODE_144226_length_319_cov_2.800000	79	158	155	1	79	0.0126582
NODE_144226_length_319_cov_2.800000	79	158	159	4	79	0.0506329
NODE_144226_length_319_cov_2.800000	79	158	174	1	79	0.0126582
NODE_144226_length_319_cov_2.800000	79	158	175	1	79	0.0126582
NODE_144226_length_319_cov_2.800000	79	158	177	1	79	0.0126582
NODE_144226_length_319_cov_2.800000	79	158	179	1	79	0.0126582
NODE_144226_length_319_cov_2.800000	79	158	205	1	79	0.0126582
NODE_144226_length_319_cov_2.800000	79	158	209	3	79	0.0379747
NODE_144226_length_319_cov_2.800000	79	158	210	9	79	0.1139240
NODE_144226_length_319_cov_2.800000	79	158	211	7	79	0.0886076
NODE_144226_length_319_cov_2.800000	79	158	212	6	79	0.0759494
NODE_144226_length_319_cov_2.800000	79	158	213	7	79	0.0886076
NODE_144226_length_319_cov_2.800000	79	158	215	4	79	0.0506329
NODE_144226_length_319_cov_2.800000	79	158	217	1	79	0.0126582
NODE_144226_length_319_cov_2.800000	79	158	218	5	79	0.0632911
NODE_144226_length_319_cov_2.800000	79	158	219	24	79	0.3037975
NODE_144237_length_319_cov_2.740909	67	147	10	5	80	0.0625000
NODE_144237_length_319_cov_2.740909	67	147	11	9	80	0.1125000
NODE_144237_length_319_cov_2.740909	67	147	12	5	80	0.0625000
NODE_144237_length_319_cov_2.740909	67	147	14	2	80	0.0250000
NODE_144237_length_319_cov_2.740909	67	147	15	59	80	0.7375000
NODE_144252_length_319_cov_2.586364	247	319	0	72	72	1.0000000
NODE_144272_length_319_cov_2.463636	90	153	0	63	63	1.0000000
NODE_144272_length_319_cov_2.463636	163	216	0	53	53	1.0000000
NODE_144316_length_319_cov_2.259091	146	212	0	66	66	1.0000000
NODE_144340_length_319_cov_2.163636	213	275	0	62	62	1.0000000
NODE_144390_length_319_cov_1.968182	120	200	0	24	80	0.3000000
NODE_144390_length_319_cov_1.968182	120	200	2	56	80	0.7000000
NODE_144616_length_319_cov_1.431818	111	157	0	26	46	0.5652174
NODE_144616_length_319_cov_1.431818	111	157	2	2	46	0.0434783
NODE_144616_length_319_cov_1.431818	111	157	4	4	46	0.0869565
NODE_144616_length_319_cov_1.431818	111	157	6	14	46	0.3043478
NODE_144629_length_319_cov_1.395455	129	179	2	14	50	0.2800000
NODE_144629_length_319_cov_1.395455	129	179	4	36	50	0.7200000
NODE_144788_length_319_cov_1.190909	119	182	0	63	63	1.0000000
NODE_144788_length_319_cov_1.190909	197	232	0	30	35	0.8571429
NODE_144788_length_319_cov_1.190909	197	232	2	5	35	0.1428571
NODE_145289_length_318_cov_232.639269	169	198	302	1	29	0.0344828
NODE_145289_length_318_cov_232.639269	169	198	310	2	29	0.0689655
NODE_145289_length_318_cov_232.639269	169	198	314	1	29	0.0344828
NODE_145289_length_318_cov_232.639269	169	198	319	1	29	0.0344828
NODE_145289_length_318_cov_232.639269	169	198	321	4	29	0.1379310
NODE_145289_length_318_cov_232.639269	169	198	325	1	29	0.0344828
NODE_145289_length_318_cov_232.639269	169	198	327	1	29	0.0344828
NODE_145289_length_318_cov_232.639269	169	198	329	2	29	0.0689655
NODE_145289_length_318_cov_232.639269	169	198	333	1	29	0.0344828
NODE_145289_length_318_cov_232.639269	169	198	336	2	29	0.0689655
NODE_145289_length_318_cov_232.639269	169	198	339	1	29	0.0344828
NODE_145289_length_318_cov_232.639269	169	198	340	2	29	0.0689655
NODE_145289_length_318_cov_232.639269	169	198	348	1	29	0.0344828
NODE_145289_length_318_cov_232.639269	169	198	350	1	29	0.0344828
NODE_145289_length_318_cov_232.639269	169	198	352	2	29	0.0689655
NODE_145289_length_318_cov_232.639269	169	198	362	4	29	0.1379310
NODE_145289_length_318_cov_232.639269	169	198	363	1	29	0.0344828
NODE_145289_length_318_cov_232.639269	169	198	364	1	29	0.0344828
NODE_145289_length_318_cov_232.639269	171	246	266	1	75	0.0133333
NODE_145289_length_318_cov_232.639269	171	246	272	2	75	0.0266667
NODE_145289_length_318_cov_232.639269	171	246	273	1	75	0.0133333
NODE_145289_length_318_cov_232.639269	171	246	275	2	75	0.0266667
NODE_145289_length_318_cov_232.639269	171	246	277	2	75	0.0266667
NODE_145289_length_318_cov_232.639269	171	246	279	1	75	0.0133333
NODE_145289_length_318_cov_232.639269	171	246	285	2	75	0.0266667
NODE_145289_length_318_cov_232.639269	171	246	287	1	75	0.0133333
NODE_145289_length_318_cov_232.639269	171	246	292	1	75	0.0133333
NODE_145289_length_318_cov_232.639269	171	246	295	1	75	0.0133333
NODE_145289_length_318_cov_232.639269	171	246	297	1	75	0.0133333
NODE_145289_length_318_cov_232.639269	171	246	300	1	75	0.0133333
NODE_145289_length_318_cov_232.639269	171	246	302	1	75	0.0133333
NODE_145289_length_318_cov_232.639269	171	246	310	1	75	0.0133333
NODE_145289_length_318_cov_232.639269	171	246	312	1	75	0.0133333
NODE_145289_length_318_cov_232.639269	171	246	314	2	75	0.0266667
NODE_145289_length_318_cov_232.639269	171	246	315	1	75	0.0133333
NODE_145289_length_318_cov_232.639269	171	246	317	1	75	0.0133333
NODE_145289_length_318_cov_232.639269	171	246	319	2	75	0.0266667
NODE_145289_length_318_cov_232.639269	171	246	321	4	75	0.0533333
NODE_145289_length_318_cov_232.639269	171	246	325	2	75	0.0266667
NODE_145289_length_318_cov_232.639269	171	246	327	1	75	0.0133333
NODE_145289_length_318_cov_232.639269	171	246	329	2	75	0.0266667
NODE_145289_length_318_cov_232.639269	171	246	331	1	75	0.0133333
NODE_145289_length_318_cov_232.639269	171	246	333	1	75	0.0133333
NODE_145289_length_318_cov_232.639269	171	246	336	2	75	0.0266667
NODE_145289_length_318_cov_232.639269	171	246	338	3	75	0.0400000
NODE_145289_length_318_cov_232.639269	171	246	339	1	75	0.0133333
NODE_145289_length_318_cov_232.639269	171	246	340	3	75	0.0400000
NODE_145289_length_318_cov_232.639269	171	246	342	1	75	0.0133333
NODE_145289_length_318_cov_232.639269	171	246	346	1	75	0.0133333
NODE_145289_length_318_cov_232.639269	171	246	348	2	75	0.0266667
NODE_145289_length_318_cov_232.639269	171	246	350	1	75	0.0133333
NODE_145289_length_318_cov_232.639269	171	246	352	3	75	0.0400000
NODE_145289_length_318_cov_232.639269	171	246	355	3	75	0.0400000
NODE_145289_length_318_cov_232.639269	171	246	358	1	75	0.0133333
NODE_145289_length_318_cov_232.639269	171	246	359	1	75	0.0133333
NODE_145289_length_318_cov_232.639269	171	246	360	2	75	0.0266667
NODE_145289_length_318_cov_232.639269	171	246	362	10	75	0.1333333
NODE_145289_length_318_cov_232.639269	171	246	363	1	75	0.0133333
NODE_145289_length_318_cov_232.639269	171	246	364	3	75	0.0400000
NODE_145289_length_318_cov_232.639269	171	246	366	1	75	0.0133333
NODE_145333_length_318_cov_4.237443	222	294	2	1	72	0.0138889
NODE_145333_length_318_cov_4.237443	222	294	4	2	72	0.0277778
NODE_145333_length_318_cov_4.237443	222	294	8	16	72	0.2222222
NODE_145333_length_318_cov_4.237443	222	294	9	2	72	0.0277778
NODE_145333_length_318_cov_4.237443	222	294	11	51	72	0.7083333
NODE_145348_length_318_cov_3.721461	98	148	0	50	50	1.0000000
NODE_145362_length_318_cov_3.515982	60	129	0	69	69	1.0000000
NODE_145362_length_318_cov_3.515982	60	140	0	80	80	1.0000000
NODE_145362_length_318_cov_3.515982	60	140	0	80	80	1.0000000
NODE_145362_length_318_cov_3.515982	113	153	0	40	40	1.0000000
NODE_145362_length_318_cov_3.515982	122	153	0	31	31	1.0000000
NODE_145465_length_318_cov_2.557078	205	247	0	10	42	0.2380952
NODE_145465_length_318_cov_2.557078	205	247	2	2	42	0.0476190
NODE_145465_length_318_cov_2.557078	205	247	4	30	42	0.7142857
NODE_145551_length_318_cov_2.109589	70	150	4	15	80	0.1875000
NODE_145551_length_318_cov_2.109589	70	150	6	16	80	0.2000000
NODE_145551_length_318_cov_2.109589	70	150	8	34	80	0.4250000
NODE_145551_length_318_cov_2.109589	70	150	10	11	80	0.1375000
NODE_145551_length_318_cov_2.109589	70	150	11	1	80	0.0125000
NODE_145551_length_318_cov_2.109589	70	150	12	3	80	0.0375000
NODE_145619_length_318_cov_1.945205	229	286	0	57	57	1.0000000
NODE_145709_length_318_cov_1.739726	242	308	0	66	66	1.0000000
NODE_145725_length_318_cov_1.684932	49	80	0	31	31	1.0000000
NODE_145787_length_318_cov_1.561644	99	158	2	6	59	0.1016949
NODE_145787_length_318_cov_1.561644	99	158	4	2	59	0.0338983
NODE_145787_length_318_cov_1.561644	99	158	7	6	59	0.1016949
NODE_145787_length_318_cov_1.561644	99	158	8	10	59	0.1694915
NODE_145787_length_318_cov_1.561644	99	158	9	3	59	0.0508475
NODE_145787_length_318_cov_1.561644	99	158	13	25	59	0.4237288
NODE_145787_length_318_cov_1.561644	99	158	15	7	59	0.1186441
NODE_145807_length_318_cov_1.493151	151	195	0	44	44	1.0000000
NODE_145807_length_318_cov_1.493151	199	258	6	59	59	1.0000000
NODE_145968_length_318_cov_1.301370	91	141	4	50	50	1.0000000
NODE_146017_length_318_cov_1.173516	83	150	2	22	67	0.3283582
NODE_146017_length_318_cov_1.173516	83	150	4	30	67	0.4477612
NODE_146017_length_318_cov_1.173516	83	150	6	15	67	0.2238806
NODE_146065_length_318_cov_1.127854	24	51	0	12	27	0.4444444
NODE_146065_length_318_cov_1.127854	24	51	2	15	27	0.5555556
NODE_146065_length_318_cov_1.127854	24	60	0	12	36	0.3333333
NODE_146065_length_318_cov_1.127854	24	60	2	24	36	0.6666667
NODE_146467_length_317_cov_55.467890	172	243	18	3	71	0.0422535
NODE_146467_length_317_cov_55.467890	172	243	20	2	71	0.0281690
NODE_146467_length_317_cov_55.467890	172	243	24	1	71	0.0140845
NODE_146467_length_317_cov_55.467890	172	243	28	12	71	0.1690141
NODE_146467_length_317_cov_55.467890	172	243	32	9	71	0.1267606
NODE_146467_length_317_cov_55.467890	172	243	34	1	71	0.0140845
NODE_146467_length_317_cov_55.467890	172	243	36	3	71	0.0422535
NODE_146467_length_317_cov_55.467890	172	243	42	1	71	0.0140845
NODE_146467_length_317_cov_55.467890	172	243	45	4	71	0.0563380
NODE_146467_length_317_cov_55.467890	172	243	46	17	71	0.2394366
NODE_146467_length_317_cov_55.467890	172	243	48	18	71	0.2535211
NODE_146487_length_317_cov_5.252294	247	307	5	46	60	0.7666667
NODE_146487_length_317_cov_5.252294	247	307	7	14	60	0.2333333
NODE_146503_length_317_cov_4.467890	105	185	0	12	80	0.1500000
NODE_146503_length_317_cov_4.467890	105	185	2	63	80	0.7875000
NODE_146503_length_317_cov_4.467890	105	185	4	5	80	0.0625000
NODE_146503_length_317_cov_4.467890	113	193	0	4	80	0.0500000
NODE_146503_length_317_cov_4.467890	113	193	2	63	80	0.7875000
NODE_146503_length_317_cov_4.467890	113	193	4	13	80	0.1625000
NODE_146554_length_317_cov_3.298165	146	206	4	2	60	0.0333333
NODE_146554_length_317_cov_3.298165	146	206	8	1	60	0.0166667
NODE_146554_length_317_cov_3.298165	146	206	12	5	60	0.0833333
NODE_146554_length_317_cov_3.298165	146	206	14	5	60	0.0833333
NODE_146554_length_317_cov_3.298165	146	206	18	10	60	0.1666667
NODE_146554_length_317_cov_3.298165	146	206	20	37	60	0.6166667
NODE_146562_length_317_cov_3.266055	111	191	2	12	80	0.1500000
NODE_146562_length_317_cov_3.266055	111	191	4	2	80	0.0250000
NODE_146562_length_317_cov_3.266055	111	191	6	7	80	0.0875000
NODE_146562_length_317_cov_3.266055	111	191	8	22	80	0.2750000
NODE_146562_length_317_cov_3.266055	111	191	10	7	80	0.0875000
NODE_146562_length_317_cov_3.266055	111	191	12	1	80	0.0125000
NODE_146562_length_317_cov_3.266055	111	191	14	9	80	0.1125000
NODE_146562_length_317_cov_3.266055	111	191	16	20	80	0.2500000
NODE_146562_length_317_cov_3.266055	164	244	0	30	80	0.3750000
NODE_146562_length_317_cov_3.266055	164	244	2	35	80	0.4375000
NODE_146562_length_317_cov_3.266055	164	244	4	2	80	0.0250000
NODE_146562_length_317_cov_3.266055	164	244	6	7	80	0.0875000
NODE_146562_length_317_cov_3.266055	164	244	8	6	80	0.0750000
NODE_146585_length_317_cov_3.036697	3	79	0	76	76	1.0000000
NODE_146601_length_317_cov_2.825688	14	94	0	80	80	1.0000000
NODE_146601_length_317_cov_2.825688	67	147	0	80	80	1.0000000
NODE_146602_length_317_cov_2.821101	142	208	0	1	66	0.0151515
NODE_146602_length_317_cov_2.821101	142	208	2	65	66	0.9848485
NODE_146604_length_317_cov_2.816514	121	201	0	80	80	1.0000000
NODE_146612_length_317_cov_2.779817	67	138	0	71	71	1.0000000
NODE_147046_length_317_cov_1.353211	166	239	6	17	73	0.2328767
NODE_147046_length_317_cov_1.353211	166	239	10	38	73	0.5205479
NODE_147046_length_317_cov_1.353211	166	239	12	18	73	0.2465753
NODE_147046_length_317_cov_1.353211	212	292	0	18	80	0.2250000
NODE_147046_length_317_cov_1.353211	212	292	4	18	80	0.2250000
NODE_147046_length_317_cov_1.353211	212	292	6	30	80	0.3750000
NODE_147046_length_317_cov_1.353211	212	292	10	13	80	0.1625000
NODE_147046_length_317_cov_1.353211	212	292	12	1	80	0.0125000
NODE_147172_length_317_cov_1.160550	58	117	0	46	59	0.7796610
NODE_147172_length_317_cov_1.160550	58	117	2	12	59	0.2033898
NODE_147172_length_317_cov_1.160550	58	117	4	1	59	0.0169492
NODE_147172_length_317_cov_1.160550	90	170	0	14	80	0.1750000
NODE_147172_length_317_cov_1.160550	90	170	2	12	80	0.1500000
NODE_147172_length_317_cov_1.160550	90	170	4	3	80	0.0375000
NODE_147172_length_317_cov_1.160550	90	170	7	5	80	0.0625000
NODE_147172_length_317_cov_1.160550	90	170	9	1	80	0.0125000
NODE_147172_length_317_cov_1.160550	90	170	11	7	80	0.0875000
NODE_147172_length_317_cov_1.160550	90	170	13	13	80	0.1625000
NODE_147172_length_317_cov_1.160550	90	170	19	3	80	0.0375000
NODE_147172_length_317_cov_1.160550	90	170	21	9	80	0.1125000
NODE_147172_length_317_cov_1.160550	90	170	23	11	80	0.1375000
NODE_147172_length_317_cov_1.160550	90	170	25	2	80	0.0250000
NODE_147187_length_317_cov_1.137615	245	313	0	68	68	1.0000000
NODE_147259_length_317_cov_0.967890	170	211	0	41	41	1.0000000
NODE_147373_length_317_cov_0.926606	194	232	0	38	38	1.0000000
NODE_147383_length_317_cov_0.912844	186	244	0	58	58	1.0000000
NODE_147595_length_316_cov_31.502304	96	174	0	10	78	0.1282051
NODE_147595_length_316_cov_31.502304	96	174	2	9	78	0.1153846
NODE_147595_length_316_cov_31.502304	96	174	5	8	78	0.1025641
NODE_147595_length_316_cov_31.502304	96	174	6	1	78	0.0128205
NODE_147595_length_316_cov_31.502304	96	174	9	2	78	0.0256410
NODE_147595_length_316_cov_31.502304	96	174	11	10	78	0.1282051
NODE_147595_length_316_cov_31.502304	96	174	16	1	78	0.0128205
NODE_147595_length_316_cov_31.502304	96	174	20	1	78	0.0128205
NODE_147595_length_316_cov_31.502304	96	174	24	4	78	0.0512821
NODE_147595_length_316_cov_31.502304	96	174	26	3	78	0.0384615
NODE_147595_length_316_cov_31.502304	96	174	28	11	78	0.1410256
NODE_147595_length_316_cov_31.502304	96	174	30	1	78	0.0128205
NODE_147595_length_316_cov_31.502304	96	174	33	8	78	0.1025641
NODE_147595_length_316_cov_31.502304	96	174	37	3	78	0.0384615
NODE_147595_length_316_cov_31.502304	96	174	41	6	78	0.0769231
NODE_147595_length_316_cov_31.502304	96	121	0	10	25	0.4000000
NODE_147595_length_316_cov_31.502304	96	121	2	9	25	0.3600000
NODE_147595_length_316_cov_31.502304	96	121	5	6	25	0.2400000
NODE_147609_length_316_cov_6.179724	225	278	0	53	53	1.0000000
NODE_147623_length_316_cov_5.539171	91	171	4	11	80	0.1375000
NODE_147623_length_316_cov_5.539171	91	171	6	48	80	0.6000000
NODE_147623_length_316_cov_5.539171	91	171	7	2	80	0.0250000
NODE_147623_length_316_cov_5.539171	91	171	8	19	80	0.2375000
NODE_147668_length_316_cov_3.732719	128	208	0	42	80	0.5250000
NODE_147668_length_316_cov_3.732719	128	208	4	27	80	0.3375000
NODE_147668_length_316_cov_3.732719	128	208	8	11	80	0.1375000
NODE_147668_length_316_cov_3.732719	181	257	4	16	76	0.2105263
NODE_147668_length_316_cov_3.732719	181	257	8	60	76	0.7894737
NODE_147680_length_316_cov_3.589862	185	247	0	42	62	0.6774194
NODE_147680_length_316_cov_3.589862	185	247	1	20	62	0.3225806
NODE_147684_length_316_cov_3.520737	101	143	0	24	42	0.5714286
NODE_147684_length_316_cov_3.520737	101	143	4	18	42	0.4285714
NODE_147702_length_316_cov_3.221198	108	184	0	31	76	0.4078947
NODE_147702_length_316_cov_3.221198	108	184	2	45	76	0.5921053
NODE_147734_length_316_cov_2.824885	274	311	0	3	37	0.0810811
NODE_147734_length_316_cov_2.824885	274	311	9	26	37	0.7027027
NODE_147734_length_316_cov_2.824885	274	311	10	8	37	0.2162162
NODE_147736_length_316_cov_2.820276	200	280	0	80	80	1.0000000
NODE_147757_length_316_cov_2.672811	23	80	0	57	57	1.0000000
NODE_147796_length_316_cov_2.456221	104	144	0	40	40	1.0000000
NODE_147985_length_316_cov_1.751152	73	122	0	49	49	1.0000000
NODE_148030_length_316_cov_1.640553	218	300	0	82	82	1.0000000
NODE_148042_length_316_cov_1.631336	180	233	0	24	53	0.4528302
NODE_148042_length_316_cov_1.631336	180	233	2	29	53	0.5471698
NODE_148042_length_316_cov_1.631336	180	215	0	24	35	0.6857143
NODE_148042_length_316_cov_1.631336	180	215	2	11	35	0.3142857
NODE_148080_length_316_cov_1.520737	194	275	0	81	81	1.0000000
NODE_148080_length_316_cov_1.520737	248	302	0	54	54	1.0000000
NODE_148086_length_316_cov_1.493088	64	144	4	3	80	0.0375000
NODE_148086_length_316_cov_1.493088	64	144	6	3	80	0.0375000
NODE_148086_length_316_cov_1.493088	64	144	8	21	80	0.2625000
NODE_148086_length_316_cov_1.493088	64	144	10	15	80	0.1875000
NODE_148086_length_316_cov_1.493088	64	144	12	19	80	0.2375000
NODE_148086_length_316_cov_1.493088	64	144	14	19	80	0.2375000
NODE_148193_length_316_cov_1.377880	22	64	0	40	42	0.9523810
NODE_148193_length_316_cov_1.377880	22	64	2	2	42	0.0476190
NODE_148204_length_316_cov_1.350230	74	117	0	43	43	1.0000000
NODE_148204_length_316_cov_1.350230	90	140	0	50	50	1.0000000
NODE_148533_length_316_cov_0.940092	104	180	0	10	76	0.1315790
NODE_148533_length_316_cov_0.940092	104	180	2	9	76	0.1184211
NODE_148533_length_316_cov_0.940092	104	180	4	1	76	0.0131579
NODE_148533_length_316_cov_0.940092	104	180	8	10	76	0.1315790
NODE_148533_length_316_cov_0.940092	104	180	10	9	76	0.1184211
NODE_148533_length_316_cov_0.940092	104	180	12	37	76	0.4868421
NODE_148533_length_316_cov_0.940092	155	234	2	7	79	0.0886076
NODE_148533_length_316_cov_0.940092	155	234	4	7	79	0.0886076
NODE_148533_length_316_cov_0.940092	155	234	6	2	79	0.0253165
NODE_148533_length_316_cov_0.940092	155	234	8	2	79	0.0253165
NODE_148533_length_316_cov_0.940092	155	234	10	12	79	0.1518987
NODE_148533_length_316_cov_0.940092	155	234	12	49	79	0.6202531
NODE_148693_length_316_cov_0.695853	232	267	0	2	35	0.0571429
NODE_148693_length_316_cov_0.695853	232	267	2	33	35	0.9428571
NODE_148778_length_315_cov_6.967593	127	191	0	1	64	0.0156250
NODE_148778_length_315_cov_6.967593	127	191	4	63	64	0.9843750
NODE_148786_length_315_cov_6.300926	67	147	0	80	80	1.0000000
NODE_148786_length_315_cov_6.300926	120	200	0	80	80	1.0000000
NODE_148812_length_315_cov_4.449074	125	205	4	2	80	0.0250000
NODE_148812_length_315_cov_4.449074	125	205	6	13	80	0.1625000
NODE_148812_length_315_cov_4.449074	125	205	8	7	80	0.0875000
NODE_148812_length_315_cov_4.449074	125	205	10	58	80	0.7250000
NODE_148812_length_315_cov_4.449074	178	225	4	22	47	0.4680851
NODE_148812_length_315_cov_4.449074	178	225	6	3	47	0.0638298
NODE_148812_length_315_cov_4.449074	178	225	8	5	47	0.1063830
NODE_148812_length_315_cov_4.449074	178	225	10	17	47	0.3617021
NODE_148834_length_315_cov_4.009259	0	61	0	61	61	1.0000000
NODE_148834_length_315_cov_4.009259	42	61	0	19	19	1.0000000
NODE_148872_length_315_cov_3.421296	37	120	8	11	83	0.1325301
NODE_148872_length_315_cov_3.421296	37	120	10	24	83	0.2891566
NODE_148872_length_315_cov_3.421296	37	120	12	48	83	0.5783132
NODE_148915_length_315_cov_2.847222	0	74	0	74	74	1.0000000
NODE_148915_length_315_cov_2.847222	47	127	0	80	80	1.0000000
NODE_148921_length_315_cov_2.833333	186	253	2	25	67	0.3731343
NODE_148921_length_315_cov_2.833333	186	253	4	42	67	0.6268657
NODE_148921_length_315_cov_2.833333	186	253	2	25	67	0.3731343
NODE_148921_length_315_cov_2.833333	186	253	4	42	67	0.6268657
NODE_148991_length_315_cov_2.416667	44	117	28	8	73	0.1095890
NODE_148991_length_315_cov_2.416667	44	117	32	1	73	0.0136986
NODE_148991_length_315_cov_2.416667	44	117	39	5	73	0.0684932
NODE_148991_length_315_cov_2.416667	44	117	45	4	73	0.0547945
NODE_148991_length_315_cov_2.416667	44	117	46	1	73	0.0136986
NODE_148991_length_315_cov_2.416667	44	117	51	11	73	0.1506849
NODE_148991_length_315_cov_2.416667	44	117	55	5	73	0.0684932
NODE_148991_length_315_cov_2.416667	44	117	63	1	73	0.0136986
NODE_148991_length_315_cov_2.416667	44	117	67	2	73	0.0273973
NODE_148991_length_315_cov_2.416667	44	117	68	1	73	0.0136986
NODE_148991_length_315_cov_2.416667	44	117	69	7	73	0.0958904
NODE_148991_length_315_cov_2.416667	44	117	70	1	73	0.0136986
NODE_148991_length_315_cov_2.416667	44	117	71	1	73	0.0136986
NODE_148991_length_315_cov_2.416667	44	117	75	3	73	0.0410959
NODE_148991_length_315_cov_2.416667	44	117	79	5	73	0.0684932
NODE_148991_length_315_cov_2.416667	44	117	81	1	73	0.0136986
NODE_148991_length_315_cov_2.416667	44	117	87	5	73	0.0684932
NODE_148991_length_315_cov_2.416667	44	117	89	1	73	0.0136986
NODE_148991_length_315_cov_2.416667	44	117	93	8	73	0.1095890
NODE_148991_length_315_cov_2.416667	44	117	94	2	73	0.0273973
NODE_149074_length_315_cov_2.115741	128	193	0	4	65	0.0615385
NODE_149074_length_315_cov_2.115741	128	193	4	61	65	0.9384615
NODE_149095_length_315_cov_2.004630	270	315	0	45	45	1.0000000
NODE_149201_length_315_cov_1.731481	125	202	4	30	77	0.3896104
NODE_149201_length_315_cov_1.731481	125	202	6	47	77	0.6103896
NODE_149391_length_315_cov_1.384259	183	233	0	20	50	0.4000000
NODE_149391_length_315_cov_1.384259	183	233	2	1	50	0.0200000
NODE_149391_length_315_cov_1.384259	183	233	4	29	50	0.5800000
NODE_149935_length_315_cov_0.430556	125	145	2	20	20	1.0000000
NODE_149943_length_314_cov_108.139535	151	213	108	1	62	0.0161290
NODE_149943_length_314_cov_108.139535	151	213	109	2	62	0.0322581
NODE_149943_length_314_cov_108.139535	151	213	110	2	62	0.0322581
NODE_149943_length_314_cov_108.139535	151	213	113	1	62	0.0161290
NODE_149943_length_314_cov_108.139535	151	213	114	1	62	0.0161290
NODE_149943_length_314_cov_108.139535	151	213	116	2	62	0.0322581
NODE_149943_length_314_cov_108.139535	151	213	117	3	62	0.0483871
NODE_149943_length_314_cov_108.139535	151	213	119	3	62	0.0483871
NODE_149943_length_314_cov_108.139535	151	213	120	6	62	0.0967742
NODE_149943_length_314_cov_108.139535	151	213	121	3	62	0.0483871
NODE_149943_length_314_cov_108.139535	151	213	126	1	62	0.0161290
NODE_149943_length_314_cov_108.139535	151	213	127	6	62	0.0967742
NODE_149943_length_314_cov_108.139535	151	213	128	10	62	0.1612903
NODE_149943_length_314_cov_108.139535	151	213	129	1	62	0.0161290
NODE_149943_length_314_cov_108.139535	151	213	131	3	62	0.0483871
NODE_149943_length_314_cov_108.139535	151	213	132	7	62	0.1129032
NODE_149943_length_314_cov_108.139535	151	213	133	1	62	0.0161290
NODE_149943_length_314_cov_108.139535	151	213	134	1	62	0.0161290
NODE_149943_length_314_cov_108.139535	151	213	136	3	62	0.0483871
NODE_149943_length_314_cov_108.139535	151	213	138	4	62	0.0645161
NODE_149943_length_314_cov_108.139535	151	213	140	1	62	0.0161290
NODE_149943_length_314_cov_108.139535	160	213	109	2	53	0.0377358
NODE_149943_length_314_cov_108.139535	160	213	114	1	53	0.0188679
NODE_149943_length_314_cov_108.139535	160	213	116	1	53	0.0188679
NODE_149943_length_314_cov_108.139535	160	213	117	3	53	0.0566038
NODE_149943_length_314_cov_108.139535	160	213	119	1	53	0.0188679
NODE_149943_length_314_cov_108.139535	160	213	120	4	53	0.0754717
NODE_149943_length_314_cov_108.139535	160	213	121	3	53	0.0566038
NODE_149943_length_314_cov_108.139535	160	213	126	1	53	0.0188679
NODE_149943_length_314_cov_108.139535	160	213	127	6	53	0.1132075
NODE_149943_length_314_cov_108.139535	160	213	128	10	53	0.1886792
NODE_149943_length_314_cov_108.139535	160	213	129	1	53	0.0188679
NODE_149943_length_314_cov_108.139535	160	213	131	3	53	0.0566038
NODE_149943_length_314_cov_108.139535	160	213	132	7	53	0.1320755
NODE_149943_length_314_cov_108.139535	160	213	133	1	53	0.0188679
NODE_149943_length_314_cov_108.139535	160	213	134	1	53	0.0188679
NODE_149943_length_314_cov_108.139535	160	213	136	3	53	0.0566038
NODE_149943_length_314_cov_108.139535	160	213	138	4	53	0.0754717
NODE_149943_length_314_cov_108.139535	160	213	140	1	53	0.0188679
NODE_149944_length_314_cov_48.134884	245	314	0	69	69	1.0000000
NODE_149946_length_314_cov_9.097674	149	206	0	8	57	0.1403509
NODE_149946_length_314_cov_9.097674	149	206	2	49	57	0.8596491
NODE_149967_length_314_cov_4.897674	109	189	3	13	80	0.1625000
NODE_149967_length_314_cov_4.897674	109	189	5	65	80	0.8125000
NODE_149967_length_314_cov_4.897674	109	189	7	2	80	0.0250000
NODE_150004_length_314_cov_3.823256	119	199	0	80	80	1.0000000
NODE_150020_length_314_cov_3.558140	32	92	2	9	60	0.1500000
NODE_150020_length_314_cov_3.558140	32	92	4	22	60	0.3666667
NODE_150020_length_314_cov_3.558140	32	92	6	16	60	0.2666667
NODE_150020_length_314_cov_3.558140	32	92	8	13	60	0.2166667
NODE_150035_length_314_cov_3.316279	84	126	14	4	42	0.0952381
NODE_150035_length_314_cov_3.316279	84	126	16	7	42	0.1666667
NODE_150035_length_314_cov_3.316279	84	126	18	19	42	0.4523810
NODE_150035_length_314_cov_3.316279	84	126	20	12	42	0.2857143
NODE_150035_length_314_cov_3.316279	127	180	0	21	53	0.3962264
NODE_150035_length_314_cov_3.316279	127	180	2	13	53	0.2452830
NODE_150035_length_314_cov_3.316279	127	180	4	3	53	0.0566038
NODE_150035_length_314_cov_3.316279	127	180	9	4	53	0.0754717
NODE_150035_length_314_cov_3.316279	127	180	11	1	53	0.0188679
NODE_150035_length_314_cov_3.316279	127	180	12	4	53	0.0754717
NODE_150035_length_314_cov_3.316279	127	180	13	1	53	0.0188679
NODE_150035_length_314_cov_3.316279	127	180	14	6	53	0.1132075
NODE_150035_length_314_cov_3.316279	128	148	2	2	20	0.1000000
NODE_150035_length_314_cov_3.316279	128	148	4	3	20	0.1500000
NODE_150035_length_314_cov_3.316279	128	148	9	4	20	0.2000000
NODE_150035_length_314_cov_3.316279	128	148	11	1	20	0.0500000
NODE_150035_length_314_cov_3.316279	128	148	12	4	20	0.2000000
NODE_150035_length_314_cov_3.316279	128	148	13	1	20	0.0500000
NODE_150035_length_314_cov_3.316279	128	148	14	5	20	0.2500000
NODE_150066_length_314_cov_3.032558	252	308	0	11	56	0.1964286
NODE_150066_length_314_cov_3.032558	252	308	2	18	56	0.3214286
NODE_150066_length_314_cov_3.032558	252	308	4	27	56	0.4821429
NODE_150141_length_314_cov_2.520930	0	61	0	61	61	1.0000000
NODE_150141_length_314_cov_2.520930	34	93	0	59	59	1.0000000
NODE_150153_length_314_cov_2.441860	48	84	0	1	36	0.0277778
NODE_150153_length_314_cov_2.441860	48	84	2	35	36	0.9722222
NODE_150159_length_314_cov_2.395349	62	112	8	4	50	0.0800000
NODE_150159_length_314_cov_2.395349	62	112	10	46	50	0.9200000
NODE_150200_length_314_cov_2.265116	7	53	0	26	46	0.5652174
NODE_150200_length_314_cov_2.265116	7	53	2	12	46	0.2608696
NODE_150200_length_314_cov_2.265116	7	53	4	8	46	0.1739130
NODE_150220_length_314_cov_2.144186	224	264	0	28	40	0.7000000
NODE_150220_length_314_cov_2.144186	224	264	2	12	40	0.3000000
NODE_150257_length_314_cov_2.004651	68	148	0	4	80	0.0500000
NODE_150257_length_314_cov_2.004651	68	148	2	76	80	0.9500000
NODE_150257_length_314_cov_2.004651	121	201	0	40	80	0.5000000
NODE_150257_length_314_cov_2.004651	121	201	2	40	80	0.5000000
NODE_150385_length_314_cov_1.665116	204	242	0	38	38	1.0000000
NODE_150385_length_314_cov_1.665116	215	295	0	80	80	1.0000000
NODE_150647_length_314_cov_1.223256	7	87	0	80	80	1.0000000
NODE_150709_length_314_cov_1.167442	1	69	0	68	68	1.0000000
NODE_151193_length_313_cov_156.051402	177	254	2	4	77	0.0519481
NODE_151193_length_313_cov_156.051402	177	254	5	4	77	0.0519481
NODE_151193_length_313_cov_156.051402	177	254	9	13	77	0.1688312
NODE_151193_length_313_cov_156.051402	177	254	10	2	77	0.0259740
NODE_151193_length_313_cov_156.051402	177	254	16	3	77	0.0389610
NODE_151193_length_313_cov_156.051402	177	254	30	1	77	0.0129870
NODE_151193_length_313_cov_156.051402	177	254	32	50	77	0.6493506
NODE_151193_length_313_cov_156.051402	177	254	2	4	77	0.0519481
NODE_151193_length_313_cov_156.051402	177	254	5	4	77	0.0519481
NODE_151193_length_313_cov_156.051402	177	254	9	13	77	0.1688312
NODE_151193_length_313_cov_156.051402	177	254	10	2	77	0.0259740
NODE_151193_length_313_cov_156.051402	177	254	16	3	77	0.0389610
NODE_151193_length_313_cov_156.051402	177	254	30	1	77	0.0129870
NODE_151193_length_313_cov_156.051402	177	254	32	50	77	0.6493506
NODE_151214_length_313_cov_5.359813	135	196	10	32	61	0.5245901
NODE_151214_length_313_cov_5.359813	135	196	12	29	61	0.4754098
NODE_151214_length_313_cov_5.359813	169	241	10	43	72	0.5972222
NODE_151214_length_313_cov_5.359813	169	241	12	29	72	0.4027778
NODE_151230_length_313_cov_4.794393	126	206	2	14	80	0.1750000
NODE_151230_length_313_cov_4.794393	126	206	4	4	80	0.0500000
NODE_151230_length_313_cov_4.794393	126	206	6	39	80	0.4875000
NODE_151230_length_313_cov_4.794393	126	206	8	23	80	0.2875000
NODE_151230_length_313_cov_4.794393	179	259	4	4	80	0.0500000
NODE_151230_length_313_cov_4.794393	179	259	8	76	80	0.9500000
NODE_151232_length_313_cov_4.761682	104	162	0	58	58	1.0000000
NODE_151232_length_313_cov_4.761682	135	215	0	80	80	1.0000000
NODE_151277_length_313_cov_3.560748	106	186	12	4	80	0.0500000
NODE_151277_length_313_cov_3.560748	106	186	13	12	80	0.1500000
NODE_151277_length_313_cov_3.560748	106	186	14	62	80	0.7750000
NODE_151277_length_313_cov_3.560748	106	186	15	2	80	0.0250000
NODE_151331_length_313_cov_2.953271	92	153	8	33	61	0.5409836
NODE_151331_length_313_cov_2.953271	92	153	12	28	61	0.4590164
NODE_151364_length_313_cov_2.640187	110	182	0	48	72	0.6666667
NODE_151364_length_313_cov_2.640187	110	182	2	24	72	0.3333333
NODE_151364_length_313_cov_2.640187	113	184	0	45	71	0.6338028
NODE_151364_length_313_cov_2.640187	113	184	2	26	71	0.3661972
NODE_151409_length_313_cov_2.383178	58	137	0	79	79	1.0000000
NODE_151409_length_313_cov_2.383178	110	190	0	72	80	0.9000000
NODE_151409_length_313_cov_2.383178	110	190	2	6	80	0.0750000
NODE_151409_length_313_cov_2.383178	110	190	8	2	80	0.0250000
NODE_151474_length_313_cov_2.107477	153	221	0	4	68	0.0588235
NODE_151474_length_313_cov_2.107477	153	221	2	30	68	0.4411765
NODE_151474_length_313_cov_2.107477	153	221	6	3	68	0.0441176
NODE_151474_length_313_cov_2.107477	153	221	8	31	68	0.4558823
NODE_151510_length_313_cov_1.934579	107	187	0	16	80	0.2000000
NODE_151510_length_313_cov_1.934579	107	187	2	4	80	0.0500000
NODE_151510_length_313_cov_1.934579	107	187	4	5	80	0.0625000
NODE_151510_length_313_cov_1.934579	107	187	6	1	80	0.0125000
NODE_151510_length_313_cov_1.934579	107	187	7	1	80	0.0125000
NODE_151510_length_313_cov_1.934579	107	187	12	1	80	0.0125000
NODE_151510_length_313_cov_1.934579	107	187	17	2	80	0.0250000
NODE_151510_length_313_cov_1.934579	107	187	18	1	80	0.0125000
NODE_151510_length_313_cov_1.934579	107	187	21	2	80	0.0250000
NODE_151510_length_313_cov_1.934579	107	187	24	1	80	0.0125000
NODE_151510_length_313_cov_1.934579	107	187	28	2	80	0.0250000
NODE_151510_length_313_cov_1.934579	107	187	29	1	80	0.0125000
NODE_151510_length_313_cov_1.934579	107	187	39	1	80	0.0125000
NODE_151510_length_313_cov_1.934579	107	187	43	1	80	0.0125000
NODE_151510_length_313_cov_1.934579	107	187	49	4	80	0.0500000
NODE_151510_length_313_cov_1.934579	107	187	50	4	80	0.0500000
NODE_151510_length_313_cov_1.934579	107	187	52	2	80	0.0250000
NODE_151510_length_313_cov_1.934579	107	187	56	1	80	0.0125000
NODE_151510_length_313_cov_1.934579	107	187	58	2	80	0.0250000
NODE_151510_length_313_cov_1.934579	107	187	61	1	80	0.0125000
NODE_151510_length_313_cov_1.934579	107	187	64	1	80	0.0125000
NODE_151510_length_313_cov_1.934579	107	187	66	2	80	0.0250000
NODE_151510_length_313_cov_1.934579	107	187	72	1	80	0.0125000
NODE_151510_length_313_cov_1.934579	107	187	76	1	80	0.0125000
NODE_151510_length_313_cov_1.934579	107	187	79	2	80	0.0250000
NODE_151510_length_313_cov_1.934579	107	187	84	1	80	0.0125000
NODE_151510_length_313_cov_1.934579	107	187	89	1	80	0.0125000
NODE_151510_length_313_cov_1.934579	107	187	91	1	80	0.0125000
NODE_151510_length_313_cov_1.934579	107	187	96	1	80	0.0125000
NODE_151510_length_313_cov_1.934579	107	187	102	2	80	0.0250000
NODE_151510_length_313_cov_1.934579	107	187	104	1	80	0.0125000
NODE_151510_length_313_cov_1.934579	107	187	106	1	80	0.0125000
NODE_151510_length_313_cov_1.934579	107	187	108	3	80	0.0375000
NODE_151510_length_313_cov_1.934579	107	187	114	2	80	0.0250000
NODE_151510_length_313_cov_1.934579	107	187	118	7	80	0.0875000
NODE_151510_length_313_cov_1.934579	160	240	64	1	80	0.0125000
NODE_151510_length_313_cov_1.934579	160	240	66	2	80	0.0250000
NODE_151510_length_313_cov_1.934579	160	240	72	1	80	0.0125000
NODE_151510_length_313_cov_1.934579	160	240	76	1	80	0.0125000
NODE_151510_length_313_cov_1.934579	160	240	79	2	80	0.0250000
NODE_151510_length_313_cov_1.934579	160	240	84	1	80	0.0125000
NODE_151510_length_313_cov_1.934579	160	240	89	1	80	0.0125000
NODE_151510_length_313_cov_1.934579	160	240	91	1	80	0.0125000
NODE_151510_length_313_cov_1.934579	160	240	96	1	80	0.0125000
NODE_151510_length_313_cov_1.934579	160	240	102	2	80	0.0250000
NODE_151510_length_313_cov_1.934579	160	240	104	1	80	0.0125000
NODE_151510_length_313_cov_1.934579	160	240	106	1	80	0.0125000
NODE_151510_length_313_cov_1.934579	160	240	108	3	80	0.0375000
NODE_151510_length_313_cov_1.934579	160	240	112	5	80	0.0625000
NODE_151510_length_313_cov_1.934579	160	240	114	4	80	0.0500000
NODE_151510_length_313_cov_1.934579	160	240	116	1	80	0.0125000
NODE_151510_length_313_cov_1.934579	160	240	118	10	80	0.1250000
NODE_151510_length_313_cov_1.934579	160	240	120	18	80	0.2250000
NODE_151510_length_313_cov_1.934579	160	240	122	1	80	0.0125000
NODE_151510_length_313_cov_1.934579	160	240	124	13	80	0.1625000
NODE_151510_length_313_cov_1.934579	160	240	126	10	80	0.1250000
NODE_151576_length_313_cov_1.780374	236	296	0	27	60	0.4500000
NODE_151576_length_313_cov_1.780374	236	296	2	33	60	0.5500000
NODE_151623_length_313_cov_1.663551	58	135	1	14	77	0.1818182
NODE_151623_length_313_cov_1.663551	58	135	2	63	77	0.8181818
NODE_151703_length_313_cov_1.439252	0	64	0	64	64	1.0000000
NODE_151703_length_313_cov_1.439252	37	82	0	45	45	1.0000000
NODE_151753_length_313_cov_1.429907	74	111	2	37	37	1.0000000
NODE_151753_length_313_cov_1.429907	109	172	2	13	63	0.2063492
NODE_151753_length_313_cov_1.429907	109	172	4	50	63	0.7936508
NODE_151953_length_313_cov_1.172897	106	161	4	11	55	0.2000000
NODE_151953_length_313_cov_1.172897	106	161	8	20	55	0.3636364
NODE_151953_length_313_cov_1.172897	106	161	10	24	55	0.4363636
NODE_151953_length_313_cov_1.172897	149	214	8	3	65	0.0461538
NODE_151953_length_313_cov_1.172897	149	214	10	10	65	0.1538462
NODE_151953_length_313_cov_1.172897	149	214	12	12	65	0.1846154
NODE_151953_length_313_cov_1.172897	149	214	14	10	65	0.1538462
NODE_151953_length_313_cov_1.172897	149	214	18	2	65	0.0307692
NODE_151953_length_313_cov_1.172897	149	214	20	4	65	0.0615385
NODE_151953_length_313_cov_1.172897	149	214	22	7	65	0.1076923
NODE_151953_length_313_cov_1.172897	149	214	24	7	65	0.1076923
NODE_151953_length_313_cov_1.172897	149	214	26	9	65	0.1384615
NODE_151953_length_313_cov_1.172897	149	214	28	1	65	0.0153846
NODE_152525_length_312_cov_3.723005	178	238	4	60	60	1.0000000
NODE_152525_length_312_cov_3.723005	231	291	2	51	60	0.8500000
NODE_152525_length_312_cov_3.723005	231	291	3	1	60	0.0166667
NODE_152525_length_312_cov_3.723005	231	291	4	8	60	0.1333333
NODE_152609_length_312_cov_2.723005	34	96	0	62	62	1.0000000
NODE_152609_length_312_cov_2.723005	87	149	0	62	62	1.0000000
NODE_152680_length_312_cov_2.333333	6	70	0	64	64	1.0000000
NODE_152680_length_312_cov_2.333333	43	123	0	80	80	1.0000000
NODE_152686_length_312_cov_2.267606	176	208	2	8	32	0.2500000
NODE_152686_length_312_cov_2.267606	176	208	4	6	32	0.1875000
NODE_152686_length_312_cov_2.267606	176	208	8	10	32	0.3125000
NODE_152686_length_312_cov_2.267606	176	208	10	8	32	0.2500000
NODE_152697_length_312_cov_2.234742	108	169	2	55	61	0.9016393
NODE_152697_length_312_cov_2.234742	108	169	3	1	61	0.0163934
NODE_152697_length_312_cov_2.234742	108	169	4	5	61	0.0819672
NODE_152751_length_312_cov_2.014085	141	205	0	36	64	0.5625000
NODE_152751_length_312_cov_2.014085	141	205	2	28	64	0.4375000
NODE_152751_length_312_cov_2.014085	178	258	0	3	80	0.0375000
NODE_152751_length_312_cov_2.014085	178	258	2	77	80	0.9625000
NODE_152827_length_312_cov_1.835681	176	221	0	45	45	1.0000000
NODE_152827_length_312_cov_1.835681	194	269	0	75	75	1.0000000
NODE_153222_length_312_cov_1.173709	87	133	0	36	46	0.7826087
NODE_153222_length_312_cov_1.173709	87	133	1	10	46	0.2173913
NODE_153222_length_312_cov_1.173709	150	217	16	4	67	0.0597015
NODE_153222_length_312_cov_1.173709	150	217	18	1	67	0.0149254
NODE_153222_length_312_cov_1.173709	150	217	20	3	67	0.0447761
NODE_153222_length_312_cov_1.173709	150	217	22	2	67	0.0298507
NODE_153222_length_312_cov_1.173709	150	217	24	3	67	0.0447761
NODE_153222_length_312_cov_1.173709	150	217	26	35	67	0.5223880
NODE_153222_length_312_cov_1.173709	150	217	28	15	67	0.2238806
NODE_153222_length_312_cov_1.173709	150	217	34	2	67	0.0298507
NODE_153222_length_312_cov_1.173709	150	217	38	2	67	0.0298507
NODE_153532_length_312_cov_0.788732	49	110	0	61	61	1.0000000
NODE_153532_length_312_cov_0.788732	102	163	0	61	61	1.0000000
NODE_153708_length_311_cov_5.179245	155	235	0	80	80	1.0000000
NODE_153721_length_311_cov_4.589623	133	200	0	67	67	1.0000000
NODE_153730_length_311_cov_4.358491	199	263	0	64	64	1.0000000
NODE_153743_length_311_cov_3.929245	91	127	0	36	36	1.0000000
NODE_153755_length_311_cov_3.825472	224	304	0	21	80	0.2625000
NODE_153755_length_311_cov_3.825472	224	304	2	17	80	0.2125000
NODE_153755_length_311_cov_3.825472	224	304	8	42	80	0.5250000
NODE_153773_length_311_cov_3.466981	106	186	0	80	80	1.0000000
NODE_153796_length_311_cov_3.188679	39	96	0	57	57	1.0000000
NODE_153846_length_311_cov_2.702830	144	193	2	49	49	1.0000000
NODE_153850_length_311_cov_2.665094	43	113	0	33	70	0.4714286
NODE_153850_length_311_cov_2.665094	43	113	4	36	70	0.5142857
NODE_153850_length_311_cov_2.665094	43	113	6	1	70	0.0142857
NODE_153859_length_311_cov_2.617925	206	284	0	78	78	1.0000000
NODE_153859_length_311_cov_2.617925	257	301	0	44	44	1.0000000
NODE_153913_length_311_cov_2.349057	177	204	0	27	27	1.0000000
NODE_153919_length_311_cov_2.325472	74	138	0	64	64	1.0000000
NODE_153947_length_311_cov_2.188679	21	92	0	71	71	1.0000000
NODE_154014_length_311_cov_1.924528	46	65	0	14	19	0.7368421
NODE_154014_length_311_cov_1.924528	46	65	2	5	19	0.2631579
NODE_154056_length_311_cov_1.891509	122	180	0	58	58	1.0000000
NODE_154188_length_311_cov_1.594340	0	35	0	35	35	1.0000000
NODE_154190_length_311_cov_1.589623	96	151	0	8	55	0.1454545
NODE_154190_length_311_cov_1.589623	96	151	4	5	55	0.0909091
NODE_154190_length_311_cov_1.589623	96	151	8	15	55	0.2727273
NODE_154190_length_311_cov_1.589623	96	151	10	27	55	0.4909091
NODE_154194_length_311_cov_1.570755	125	145	2	20	20	1.0000000
NODE_154957_length_311_cov_0.613208	136	216	0	80	80	1.0000000
NODE_154957_length_311_cov_0.613208	189	264	0	75	75	1.0000000
NODE_154996_length_310_cov_96.995261	211	249	99	2	38	0.0526316
NODE_154996_length_310_cov_96.995261	211	249	100	3	38	0.0789474
NODE_154996_length_310_cov_96.995261	211	249	107	1	38	0.0263158
NODE_154996_length_310_cov_96.995261	211	249	108	4	38	0.1052632
NODE_154996_length_310_cov_96.995261	211	249	110	4	38	0.1052632
NODE_154996_length_310_cov_96.995261	211	249	111	1	38	0.0263158
NODE_154996_length_310_cov_96.995261	211	249	113	12	38	0.3157895
NODE_154996_length_310_cov_96.995261	211	249	117	2	38	0.0526316
NODE_154996_length_310_cov_96.995261	211	249	119	5	38	0.1315790
NODE_154996_length_310_cov_96.995261	211	249	121	2	38	0.0526316
NODE_154996_length_310_cov_96.995261	211	249	123	2	38	0.0526316
NODE_155001_length_310_cov_7.767773	80	151	0	71	71	1.0000000
NODE_155001_length_310_cov_7.767773	134	189	0	55	55	1.0000000
NODE_155017_length_310_cov_5.914692	84	134	0	49	50	0.9800000
NODE_155017_length_310_cov_5.914692	84	134	4	1	50	0.0200000
NODE_155017_length_310_cov_5.914692	113	134	0	21	21	1.0000000
NODE_155017_length_310_cov_5.914692	113	188	0	75	75	1.0000000
NODE_155066_length_310_cov_3.777251	146	226	0	71	80	0.8875000
NODE_155066_length_310_cov_3.777251	146	226	2	9	80	0.1125000
NODE_155115_length_310_cov_3.180095	137	211	0	3	74	0.0405405
NODE_155115_length_310_cov_3.180095	137	211	2	33	74	0.4459459
NODE_155115_length_310_cov_3.180095	137	211	4	38	74	0.5135135
NODE_155179_length_310_cov_2.630332	122	174	0	7	52	0.1346154
NODE_155179_length_310_cov_2.630332	122	174	2	45	52	0.8653846
NODE_155179_length_310_cov_2.630332	175	222	0	3	47	0.0638298
NODE_155179_length_310_cov_2.630332	175	222	2	44	47	0.9361702
NODE_155180_length_310_cov_2.625592	258	301	0	43	43	1.0000000
NODE_155195_length_310_cov_2.563981	149	196	8	30	47	0.6382979
NODE_155195_length_310_cov_2.563981	149	196	10	2	47	0.0425532
NODE_155195_length_310_cov_2.563981	149	196	11	7	47	0.1489362
NODE_155195_length_310_cov_2.563981	149	196	12	8	47	0.1702128
NODE_155195_length_310_cov_2.563981	169	249	3	25	80	0.3125000
NODE_155195_length_310_cov_2.563981	169	249	4	25	80	0.3125000
NODE_155195_length_310_cov_2.563981	169	249	6	3	80	0.0375000
NODE_155195_length_310_cov_2.563981	169	249	8	26	80	0.3250000
NODE_155195_length_310_cov_2.563981	169	249	10	1	80	0.0125000
NODE_155261_length_310_cov_2.298578	213	259	0	46	46	1.0000000
NODE_155334_length_310_cov_2.009479	223	303	0	76	80	0.9500000
NODE_155334_length_310_cov_2.009479	223	303	3	4	80	0.0500000
NODE_155439_length_310_cov_1.729858	53	91	0	38	38	1.0000000
NODE_155768_length_310_cov_1.222749	181	244	0	40	63	0.6349207
NODE_155768_length_310_cov_1.222749	181	244	2	23	63	0.3650794
NODE_155864_length_310_cov_1.142180	65	135	2	1	70	0.0142857
NODE_155864_length_310_cov_1.142180	65	135	5	1	70	0.0142857
NODE_155864_length_310_cov_1.142180	65	135	7	3	70	0.0428571
NODE_155864_length_310_cov_1.142180	65	135	11	4	70	0.0571429
NODE_155864_length_310_cov_1.142180	65	135	13	2	70	0.0285714
NODE_155864_length_310_cov_1.142180	65	135	17	5	70	0.0714286
NODE_155864_length_310_cov_1.142180	65	135	21	7	70	0.1000000
NODE_155864_length_310_cov_1.142180	65	135	23	5	70	0.0714286
NODE_155864_length_310_cov_1.142180	65	135	25	28	70	0.4000000
NODE_155864_length_310_cov_1.142180	65	135	27	14	70	0.2000000
NODE_155937_length_310_cov_0.966825	131	212	0	11	81	0.1358025
NODE_155937_length_310_cov_0.966825	131	212	2	70	81	0.8641976
NODE_155937_length_310_cov_0.966825	193	256	0	55	63	0.8730159
NODE_155937_length_310_cov_0.966825	193	256	2	8	63	0.1269841
NODE_156078_length_310_cov_0.924171	180	222	0	1	42	0.0238095
NODE_156078_length_310_cov_0.924171	180	222	2	7	42	0.1666667
NODE_156078_length_310_cov_0.924171	180	222	4	34	42	0.8095238
NODE_156174_length_310_cov_0.739336	208	288	0	80	80	1.0000000
NODE_156332_length_309_cov_8.552381	154	234	0	80	80	1.0000000
NODE_156340_length_309_cov_6.147619	20	83	2	3	63	0.0476190
NODE_156340_length_309_cov_6.147619	20	83	4	60	63	0.9523810
NODE_156349_length_309_cov_5.147619	213	291	0	78	78	1.0000000
NODE_156364_length_309_cov_4.585714	15	95	0	80	80	1.0000000
NODE_156472_length_309_cov_3.028571	0	47	0	13	47	0.2765957
NODE_156472_length_309_cov_3.028571	0	47	2	34	47	0.7234042
NODE_156472_length_309_cov_3.028571	20	101	2	81	81	1.0000000
NODE_156563_length_309_cov_2.304762	179	218	10	1	39	0.0256410
NODE_156563_length_309_cov_2.304762	179	218	11	27	39	0.6923077
NODE_156563_length_309_cov_2.304762	179	218	13	5	39	0.1282051
NODE_156563_length_309_cov_2.304762	179	218	14	6	39	0.1538462
NODE_156615_length_309_cov_2.095238	55	85	0	30	30	1.0000000
NODE_156678_length_309_cov_1.938095	2	73	0	71	71	1.0000000
NODE_156950_length_309_cov_1.414286	189	231	0	42	42	1.0000000
NODE_156978_length_309_cov_1.376190	94	168	0	68	74	0.9189189
NODE_156978_length_309_cov_1.376190	94	168	2	6	74	0.0810811
NODE_157334_length_309_cov_0.966667	134	153	0	19	19	1.0000000
NODE_157469_length_309_cov_0.738095	150	215	8	5	65	0.0769231
NODE_157469_length_309_cov_0.738095	150	215	10	8	65	0.1230769
NODE_157469_length_309_cov_0.738095	150	215	14	3	65	0.0461538
NODE_157469_length_309_cov_0.738095	150	215	16	22	65	0.3384615
NODE_157469_length_309_cov_0.738095	150	215	18	27	65	0.4153846
NODE_157661_length_308_cov_4.775120	137	174	4	37	37	1.0000000
NODE_157690_length_308_cov_3.966507	126	206	0	51	80	0.6375000
NODE_157690_length_308_cov_3.966507	126	206	2	6	80	0.0750000
NODE_157690_length_308_cov_3.966507	126	206	6	23	80	0.2875000
NODE_157705_length_308_cov_3.665072	11	75	0	64	64	1.0000000
NODE_157819_length_308_cov_2.593301	137	193	8	1	56	0.0178571
NODE_157819_length_308_cov_2.593301	137	193	10	55	56	0.9821429
NODE_157852_length_308_cov_2.435407	14	58	0	44	44	1.0000000
NODE_157852_length_308_cov_2.435407	31	111	0	80	80	1.0000000
NODE_157898_length_308_cov_2.191388	14	80	0	66	66	1.0000000
NODE_157903_length_308_cov_2.191388	236	296	0	60	60	1.0000000
NODE_157969_length_308_cov_1.952153	251	296	0	45	45	1.0000000
NODE_158083_length_308_cov_1.708134	102	148	0	46	46	1.0000000
NODE_158276_length_308_cov_1.435407	196	276	0	80	80	1.0000000
NODE_158439_length_308_cov_1.162679	260	300	2	40	40	1.0000000
NODE_158439_length_308_cov_1.162679	273	307	0	3	34	0.0882353
NODE_158439_length_308_cov_1.162679	273	307	2	31	34	0.9117647
NODE_158447_length_308_cov_1.148325	35	83	0	48	48	1.0000000
NODE_158448_length_308_cov_1.148325	253	308	0	55	55	1.0000000
NODE_158510_length_308_cov_1.038278	147	202	2	55	55	1.0000000
NODE_158811_length_308_cov_0.684211	196	275	0	79	79	1.0000000
NODE_158821_length_308_cov_0.660287	109	157	0	14	48	0.2916667
NODE_158821_length_308_cov_0.660287	109	157	2	12	48	0.2500000
NODE_158821_length_308_cov_0.660287	109	157	4	13	48	0.2708333
NODE_158821_length_308_cov_0.660287	109	157	6	9	48	0.1875000
NODE_158821_length_308_cov_0.660287	130	210	2	5	80	0.0625000
NODE_158821_length_308_cov_0.660287	130	210	4	15	80	0.1875000
NODE_158821_length_308_cov_0.660287	130	210	6	60	80	0.7500000
NODE_158905_length_307_cov_30.725962	0	73	0	73	73	1.0000000
NODE_158905_length_307_cov_30.725962	46	99	0	33	53	0.6226415
NODE_158905_length_307_cov_30.725962	46	99	2	20	53	0.3773585
NODE_158906_length_307_cov_25.096154	84	164	0	46	80	0.5750000
NODE_158906_length_307_cov_25.096154	84	164	2	34	80	0.4250000
NODE_158906_length_307_cov_25.096154	137	217	0	7	80	0.0875000
NODE_158906_length_307_cov_25.096154	137	217	2	73	80	0.9125000
NODE_158933_length_307_cov_5.524038	150	221	2	21	71	0.2957746
NODE_158933_length_307_cov_5.524038	150	221	4	20	71	0.2816902
NODE_158933_length_307_cov_5.524038	150	221	6	21	71	0.2957746
NODE_158933_length_307_cov_5.524038	150	221	8	9	71	0.1267606
NODE_158983_length_307_cov_3.730769	172	252	0	80	80	1.0000000
NODE_158983_length_307_cov_3.730769	225	305	0	80	80	1.0000000
NODE_158999_length_307_cov_3.322115	20	100	6	7	80	0.0875000
NODE_158999_length_307_cov_3.322115	20	100	8	73	80	0.9125000
NODE_158999_length_307_cov_3.322115	78	153	7	18	75	0.2400000
NODE_158999_length_307_cov_3.322115	78	153	8	22	75	0.2933333
NODE_158999_length_307_cov_3.322115	78	153	9	1	75	0.0133333
NODE_158999_length_307_cov_3.322115	78	153	10	34	75	0.4533333
NODE_159000_length_307_cov_3.317308	12	94	0	82	82	1.0000000
NODE_159000_length_307_cov_3.317308	76	134	0	58	58	1.0000000
NODE_159053_length_307_cov_2.870192	43	108	0	65	65	1.0000000
NODE_159084_length_307_cov_2.653846	117	177	18	1	60	0.0166667
NODE_159084_length_307_cov_2.653846	117	177	19	1	60	0.0166667
NODE_159084_length_307_cov_2.653846	117	177	20	16	60	0.2666667
NODE_159084_length_307_cov_2.653846	117	177	22	3	60	0.0500000
NODE_159084_length_307_cov_2.653846	117	177	24	39	60	0.6500000
NODE_159142_length_307_cov_2.346154	54	105	2	51	51	1.0000000
NODE_159351_length_307_cov_1.716346	124	165	4	3	41	0.0731707
NODE_159351_length_307_cov_1.716346	124	165	6	38	41	0.9268293
NODE_159362_length_307_cov_1.716346	30	93	0	3	63	0.0476190
NODE_159362_length_307_cov_1.716346	30	93	4	4	63	0.0634921
NODE_159362_length_307_cov_1.716346	30	93	8	12	63	0.1904762
NODE_159362_length_307_cov_1.716346	30	93	10	13	63	0.2063492
NODE_159362_length_307_cov_1.716346	30	93	12	31	63	0.4920635
NODE_159407_length_307_cov_1.600962	221	269	0	15	48	0.3125000
NODE_159407_length_307_cov_1.600962	221	269	2	33	48	0.6875000
NODE_159407_length_307_cov_1.600962	242	307	0	53	65	0.8153846
NODE_159407_length_307_cov_1.600962	242	307	2	12	65	0.1846154
NODE_159447_length_307_cov_1.475962	252	307	0	4	55	0.0727273
NODE_159447_length_307_cov_1.475962	252	307	2	51	55	0.9272727
NODE_159585_length_307_cov_1.326923	96	142	4	12	46	0.2608696
NODE_159585_length_307_cov_1.326923	96	142	6	34	46	0.7391304
NODE_159585_length_307_cov_1.326923	115	195	6	72	80	0.9000000
NODE_159585_length_307_cov_1.326923	115	195	8	8	80	0.1000000
NODE_159618_length_307_cov_1.264423	13	61	0	48	48	1.0000000
NODE_159618_length_307_cov_1.264423	23	54	0	31	31	1.0000000
NODE_159696_length_307_cov_1.197115	92	121	0	29	29	1.0000000
NODE_159787_length_307_cov_1.000000	132	168	0	36	36	1.0000000
NODE_160213_length_306_cov_74.526570	68	136	6	3	68	0.0441176
NODE_160213_length_306_cov_74.526570	68	136	11	2	68	0.0294118
NODE_160213_length_306_cov_74.526570	68	136	12	12	68	0.1764706
NODE_160213_length_306_cov_74.526570	68	136	14	39	68	0.5735294
NODE_160213_length_306_cov_74.526570	68	136	30	12	68	0.1764706
NODE_160213_length_306_cov_74.526570	68	148	6	3	80	0.0375000
NODE_160213_length_306_cov_74.526570	68	148	11	2	80	0.0250000
NODE_160213_length_306_cov_74.526570	68	148	12	12	80	0.1500000
NODE_160213_length_306_cov_74.526570	68	148	14	39	80	0.4875000
NODE_160213_length_306_cov_74.526570	68	148	27	1	80	0.0125000
NODE_160213_length_306_cov_74.526570	68	148	30	20	80	0.2500000
NODE_160213_length_306_cov_74.526570	68	148	31	3	80	0.0375000
NODE_160213_length_306_cov_74.526570	121	201	14	3	80	0.0375000
NODE_160213_length_306_cov_74.526570	121	201	27	3	80	0.0375000
NODE_160213_length_306_cov_74.526570	121	201	29	6	80	0.0750000
NODE_160213_length_306_cov_74.526570	121	201	30	20	80	0.2500000
NODE_160213_length_306_cov_74.526570	121	201	31	3	80	0.0375000
NODE_160213_length_306_cov_74.526570	121	201	35	13	80	0.1625000
NODE_160213_length_306_cov_74.526570	121	201	36	15	80	0.1875000
NODE_160213_length_306_cov_74.526570	121	201	37	17	80	0.2125000
NODE_160213_length_306_cov_74.526570	121	201	14	3	80	0.0375000
NODE_160213_length_306_cov_74.526570	121	201	27	3	80	0.0375000
NODE_160213_length_306_cov_74.526570	121	201	29	6	80	0.0750000
NODE_160213_length_306_cov_74.526570	121	201	30	20	80	0.2500000
NODE_160213_length_306_cov_74.526570	121	201	31	3	80	0.0375000
NODE_160213_length_306_cov_74.526570	121	201	35	13	80	0.1625000
NODE_160213_length_306_cov_74.526570	121	201	36	15	80	0.1875000
NODE_160213_length_306_cov_74.526570	121	201	37	17	80	0.2125000
NODE_160213_length_306_cov_74.526570	197	277	1	10	80	0.1250000
NODE_160213_length_306_cov_74.526570	197	277	16	1	80	0.0125000
NODE_160213_length_306_cov_74.526570	197	277	17	6	80	0.0750000
NODE_160213_length_306_cov_74.526570	197	277	19	5	80	0.0625000
NODE_160213_length_306_cov_74.526570	197	277	27	23	80	0.2875000
NODE_160213_length_306_cov_74.526570	197	277	29	28	80	0.3500000
NODE_160213_length_306_cov_74.526570	197	277	35	7	80	0.0875000
NODE_160213_length_306_cov_74.526570	197	277	1	10	80	0.1250000
NODE_160213_length_306_cov_74.526570	197	277	16	1	80	0.0125000
NODE_160213_length_306_cov_74.526570	197	277	17	6	80	0.0750000
NODE_160213_length_306_cov_74.526570	197	277	19	5	80	0.0625000
NODE_160213_length_306_cov_74.526570	197	277	27	23	80	0.2875000
NODE_160213_length_306_cov_74.526570	197	277	29	28	80	0.3500000
NODE_160213_length_306_cov_74.526570	197	277	35	7	80	0.0875000
NODE_160213_length_306_cov_74.526570	197	277	1	10	80	0.1250000
NODE_160213_length_306_cov_74.526570	197	277	16	1	80	0.0125000
NODE_160213_length_306_cov_74.526570	197	277	17	6	80	0.0750000
NODE_160213_length_306_cov_74.526570	197	277	19	5	80	0.0625000
NODE_160213_length_306_cov_74.526570	197	277	27	23	80	0.2875000
NODE_160213_length_306_cov_74.526570	197	277	29	28	80	0.3500000
NODE_160213_length_306_cov_74.526570	197	277	35	7	80	0.0875000
NODE_160213_length_306_cov_74.526570	250	299	0	5	49	0.1020408
NODE_160213_length_306_cov_74.526570	250	299	1	27	49	0.5510204
NODE_160213_length_306_cov_74.526570	250	299	16	1	49	0.0204082
NODE_160213_length_306_cov_74.526570	250	299	17	6	49	0.1224490
NODE_160213_length_306_cov_74.526570	250	299	19	5	49	0.1020408
NODE_160213_length_306_cov_74.526570	250	299	27	5	49	0.1020408
NODE_160213_length_306_cov_74.526570	250	306	0	12	56	0.2142857
NODE_160213_length_306_cov_74.526570	250	306	1	27	56	0.4821429
NODE_160213_length_306_cov_74.526570	250	306	16	1	56	0.0178571
NODE_160213_length_306_cov_74.526570	250	306	17	6	56	0.1071429
NODE_160213_length_306_cov_74.526570	250	306	19	5	56	0.0892857
NODE_160213_length_306_cov_74.526570	250	306	27	5	56	0.0892857
NODE_160213_length_306_cov_74.526570	255	306	0	12	51	0.2352941
NODE_160213_length_306_cov_74.526570	255	306	1	27	51	0.5294118
NODE_160213_length_306_cov_74.526570	255	306	16	1	51	0.0196078
NODE_160213_length_306_cov_74.526570	255	306	17	6	51	0.1176471
NODE_160213_length_306_cov_74.526570	255	306	19	5	51	0.0980392
NODE_160217_length_306_cov_7.396135	23	117	0	94	94	1.0000000
NODE_160217_length_306_cov_7.396135	90	170	0	80	80	1.0000000
NODE_160261_length_306_cov_4.275362	67	147	0	14	80	0.1750000
NODE_160261_length_306_cov_4.275362	67	147	2	66	80	0.8250000
NODE_160275_length_306_cov_3.937198	104	176	0	72	72	1.0000000
NODE_160300_length_306_cov_3.444444	130	206	4	76	76	1.0000000
NODE_160323_length_306_cov_3.217391	198	278	0	80	80	1.0000000
NODE_160333_length_306_cov_3.043478	90	171	8	13	81	0.1604938
NODE_160333_length_306_cov_3.043478	90	171	10	1	81	0.0123457
NODE_160333_length_306_cov_3.043478	90	171	12	67	81	0.8271605
NODE_160333_length_306_cov_3.043478	144	202	0	12	58	0.2068966
NODE_160333_length_306_cov_3.043478	144	202	4	7	58	0.1206897
NODE_160333_length_306_cov_3.043478	144	202	6	2	58	0.0344828
NODE_160333_length_306_cov_3.043478	144	202	8	2	58	0.0344828
NODE_160333_length_306_cov_3.043478	144	202	12	35	58	0.6034483
NODE_160340_length_306_cov_2.956522	242	273	2	31	31	1.0000000
NODE_160355_length_306_cov_2.884058	173	243	4	66	70	0.9428571
NODE_160355_length_306_cov_2.884058	173	243	6	4	70	0.0571429
NODE_160403_length_306_cov_2.574879	122	203	10	1	81	0.0123457
NODE_160403_length_306_cov_2.574879	122	203	12	4	81	0.0493827
NODE_160403_length_306_cov_2.574879	122	203	14	7	81	0.0864198
NODE_160403_length_306_cov_2.574879	122	203	16	1	81	0.0123457
NODE_160403_length_306_cov_2.574879	122	203	18	43	81	0.5308642
NODE_160403_length_306_cov_2.574879	122	203	20	25	81	0.3086420
NODE_160403_length_306_cov_2.574879	176	254	2	12	78	0.1538462
NODE_160403_length_306_cov_2.574879	176	254	4	25	78	0.3205128
NODE_160403_length_306_cov_2.574879	176	254	6	9	78	0.1153846
NODE_160403_length_306_cov_2.574879	176	254	10	6	78	0.0769231
NODE_160403_length_306_cov_2.574879	176	254	12	4	78	0.0512821
NODE_160403_length_306_cov_2.574879	176	254	14	7	78	0.0897436
NODE_160403_length_306_cov_2.574879	176	254	16	1	78	0.0128205
NODE_160403_length_306_cov_2.574879	176	254	18	14	78	0.1794872
NODE_160475_length_306_cov_2.265700	223	278	7	9	55	0.1636364
NODE_160475_length_306_cov_2.265700	223	278	8	46	55	0.8363636
NODE_160512_length_306_cov_2.106280	73	149	0	6	76	0.0789474
NODE_160512_length_306_cov_2.106280	73	149	4	70	76	0.9210526
NODE_160512_length_306_cov_2.106280	125	205	0	62	80	0.7750000
NODE_160512_length_306_cov_2.106280	125	205	4	18	80	0.2250000
NODE_160608_length_306_cov_1.879227	165	196	8	31	31	1.0000000
NODE_160752_length_306_cov_1.478261	206	237	0	31	31	1.0000000
NODE_160761_length_306_cov_1.478261	157	220	0	63	63	1.0000000
NODE_160833_length_306_cov_1.434783	40	88	0	48	48	1.0000000
NODE_160875_length_306_cov_1.357488	128	171	0	31	43	0.7209302
NODE_160875_length_306_cov_1.357488	128	171	2	12	43	0.2790698
NODE_160992_length_306_cov_1.222222	216	252	0	36	36	1.0000000
NODE_160992_length_306_cov_1.222222	230	305	0	75	75	1.0000000
NODE_161018_length_306_cov_1.188406	79	159	0	80	80	1.0000000
NODE_161042_length_306_cov_1.130435	122	202	0	28	80	0.3500000
NODE_161042_length_306_cov_1.130435	122	202	2	52	80	0.6500000
NODE_161042_length_306_cov_1.130435	175	255	0	31	80	0.3875000
NODE_161042_length_306_cov_1.130435	175	255	2	49	80	0.6125000
NODE_161078_length_306_cov_1.067633	156	188	0	32	32	1.0000000
NODE_161234_length_306_cov_0.975845	219	247	0	28	28	1.0000000
NODE_161246_length_306_cov_0.956522	206	284	0	12	78	0.1538462
NODE_161246_length_306_cov_0.956522	206	284	13	66	78	0.8461539
NODE_161550_length_305_cov_5.718447	177	243	0	66	66	1.0000000
NODE_161566_length_305_cov_4.854369	55	135	0	2	80	0.0250000
NODE_161566_length_305_cov_4.854369	55	135	2	11	80	0.1375000
NODE_161566_length_305_cov_4.854369	55	135	6	67	80	0.8375000
NODE_161584_length_305_cov_4.266990	186	266	2	31	80	0.3875000
NODE_161584_length_305_cov_4.266990	186	266	4	49	80	0.6125000
NODE_161723_length_305_cov_2.616505	220	263	2	43	43	1.0000000
NODE_161723_length_305_cov_2.616505	236	305	0	41	69	0.5942029
NODE_161723_length_305_cov_2.616505	236	305	2	28	69	0.4057971
NODE_161726_length_305_cov_2.597087	171	256	165	3	85	0.0352941
NODE_161726_length_305_cov_2.597087	171	256	167	2	85	0.0235294
NODE_161726_length_305_cov_2.597087	171	256	170	1	85	0.0117647
NODE_161726_length_305_cov_2.597087	171	256	171	1	85	0.0117647
NODE_161726_length_305_cov_2.597087	171	256	172	1	85	0.0117647
NODE_161726_length_305_cov_2.597087	171	256	174	1	85	0.0117647
NODE_161726_length_305_cov_2.597087	171	256	182	1	85	0.0117647
NODE_161726_length_305_cov_2.597087	171	256	184	1	85	0.0117647
NODE_161726_length_305_cov_2.597087	171	256	190	6	85	0.0705882
NODE_161726_length_305_cov_2.597087	171	256	191	3	85	0.0352941
NODE_161726_length_305_cov_2.597087	171	256	192	1	85	0.0117647
NODE_161726_length_305_cov_2.597087	171	256	203	1	85	0.0117647
NODE_161726_length_305_cov_2.597087	171	256	221	1	85	0.0117647
NODE_161726_length_305_cov_2.597087	171	256	225	2	85	0.0235294
NODE_161726_length_305_cov_2.597087	171	256	233	1	85	0.0117647
NODE_161726_length_305_cov_2.597087	171	256	241	1	85	0.0117647
NODE_161726_length_305_cov_2.597087	171	256	245	2	85	0.0235294
NODE_161726_length_305_cov_2.597087	171	256	247	2	85	0.0235294
NODE_161726_length_305_cov_2.597087	171	256	249	1	85	0.0117647
NODE_161726_length_305_cov_2.597087	171	256	257	1	85	0.0117647
NODE_161726_length_305_cov_2.597087	171	256	262	1	85	0.0117647
NODE_161726_length_305_cov_2.597087	171	256	266	1	85	0.0117647
NODE_161726_length_305_cov_2.597087	171	256	269	1	85	0.0117647
NODE_161726_length_305_cov_2.597087	171	256	270	1	85	0.0117647
NODE_161726_length_305_cov_2.597087	171	256	272	2	85	0.0235294
NODE_161726_length_305_cov_2.597087	171	256	278	1	85	0.0117647
NODE_161726_length_305_cov_2.597087	171	256	284	1	85	0.0117647
NODE_161726_length_305_cov_2.597087	171	256	291	1	85	0.0117647
NODE_161726_length_305_cov_2.597087	171	256	294	1	85	0.0117647
NODE_161726_length_305_cov_2.597087	171	256	297	1	85	0.0117647
NODE_161726_length_305_cov_2.597087	171	256	301	1	85	0.0117647
NODE_161726_length_305_cov_2.597087	171	256	305	2	85	0.0235294
NODE_161726_length_305_cov_2.597087	171	256	311	1	85	0.0117647
NODE_161726_length_305_cov_2.597087	171	256	322	1	85	0.0117647
NODE_161726_length_305_cov_2.597087	171	256	330	2	85	0.0235294
NODE_161726_length_305_cov_2.597087	171	256	339	1	85	0.0117647
NODE_161726_length_305_cov_2.597087	171	256	341	1	85	0.0117647
NODE_161726_length_305_cov_2.597087	171	256	355	5	85	0.0588235
NODE_161726_length_305_cov_2.597087	171	256	356	21	85	0.2470588
NODE_161726_length_305_cov_2.597087	171	256	358	2	85	0.0235294
NODE_161726_length_305_cov_2.597087	171	256	360	4	85	0.0470588
NODE_161732_length_305_cov_2.533981	3	57	0	54	54	1.0000000
NODE_161775_length_305_cov_2.339806	149	237	22	8	88	0.0909091
NODE_161775_length_305_cov_2.339806	149	237	24	2	88	0.0227273
NODE_161775_length_305_cov_2.339806	149	237	26	10	88	0.1136364
NODE_161775_length_305_cov_2.339806	149	237	28	17	88	0.1931818
NODE_161775_length_305_cov_2.339806	149	237	29	17	88	0.1931818
NODE_161775_length_305_cov_2.339806	149	237	30	17	88	0.1931818
NODE_161775_length_305_cov_2.339806	149	237	32	17	88	0.1931818
NODE_161795_length_305_cov_2.228155	194	274	0	49	80	0.6125000
NODE_161795_length_305_cov_2.228155	194	274	2	31	80	0.3875000
NODE_161795_length_305_cov_2.228155	247	300	0	53	53	1.0000000
NODE_161877_length_305_cov_1.975728	44	116	4	7	72	0.0972222
NODE_161877_length_305_cov_1.975728	44	116	8	32	72	0.4444444
NODE_161877_length_305_cov_1.975728	44	116	10	33	72	0.4583333
NODE_161908_length_305_cov_1.883495	135	172	39	2	37	0.0540541
NODE_161908_length_305_cov_1.883495	135	172	45	2	37	0.0540541
NODE_161908_length_305_cov_1.883495	135	172	49	16	37	0.4324324
NODE_161908_length_305_cov_1.883495	135	172	51	2	37	0.0540541
NODE_161908_length_305_cov_1.883495	135	172	53	3	37	0.0810811
NODE_161908_length_305_cov_1.883495	135	172	54	2	37	0.0540541
NODE_161908_length_305_cov_1.883495	135	172	58	1	37	0.0270270
NODE_161908_length_305_cov_1.883495	135	172	60	4	37	0.1081081
NODE_161908_length_305_cov_1.883495	135	172	61	4	37	0.1081081
NODE_161908_length_305_cov_1.883495	135	172	63	1	37	0.0270270
NODE_161990_length_305_cov_1.674757	14	80	0	66	66	1.0000000
NODE_161990_length_305_cov_1.674757	53	133	0	80	80	1.0000000
NODE_161996_length_305_cov_1.655340	110	179	8	3	69	0.0434783
NODE_161996_length_305_cov_1.655340	110	179	10	26	69	0.3768116
NODE_161996_length_305_cov_1.655340	110	179	12	40	69	0.5797101
NODE_162123_length_305_cov_1.466019	153	238	12	5	85	0.0588235
NODE_162123_length_305_cov_1.466019	153	238	16	6	85	0.0705882
NODE_162123_length_305_cov_1.466019	153	238	18	13	85	0.1529412
NODE_162123_length_305_cov_1.466019	153	238	22	2	85	0.0235294
NODE_162123_length_305_cov_1.466019	153	238	26	5	85	0.0588235
NODE_162123_length_305_cov_1.466019	153	238	29	5	85	0.0588235
NODE_162123_length_305_cov_1.466019	153	238	30	3	85	0.0352941
NODE_162123_length_305_cov_1.466019	153	238	31	15	85	0.1764706
NODE_162123_length_305_cov_1.466019	153	238	33	13	85	0.1529412
NODE_162123_length_305_cov_1.466019	153	238	39	1	85	0.0117647
NODE_162123_length_305_cov_1.466019	153	238	40	1	85	0.0117647
NODE_162123_length_305_cov_1.466019	153	238	45	2	85	0.0235294
NODE_162123_length_305_cov_1.466019	153	238	49	8	85	0.0941176
NODE_162123_length_305_cov_1.466019	153	238	51	6	85	0.0705882
NODE_162123_length_305_cov_1.466019	222	284	37	2	62	0.0322581
NODE_162123_length_305_cov_1.466019	222	284	38	2	62	0.0322581
NODE_162123_length_305_cov_1.466019	222	284	42	1	62	0.0161290
NODE_162123_length_305_cov_1.466019	222	284	44	2	62	0.0322581
NODE_162123_length_305_cov_1.466019	222	284	45	2	62	0.0322581
NODE_162123_length_305_cov_1.466019	222	284	46	6	62	0.0967742
NODE_162123_length_305_cov_1.466019	222	284	48	5	62	0.0806452
NODE_162123_length_305_cov_1.466019	222	284	49	9	62	0.1451613
NODE_162123_length_305_cov_1.466019	222	284	50	3	62	0.0483871
NODE_162123_length_305_cov_1.466019	222	284	51	28	62	0.4516129
NODE_162123_length_305_cov_1.466019	222	284	52	2	62	0.0322581
NODE_162169_length_305_cov_1.398058	28	75	0	47	47	1.0000000
NODE_162198_length_305_cov_1.330097	212	292	12	6	80	0.0750000
NODE_162198_length_305_cov_1.330097	212	292	14	3	80	0.0375000
NODE_162198_length_305_cov_1.330097	212	292	18	2	80	0.0250000
NODE_162198_length_305_cov_1.330097	212	292	20	1	80	0.0125000
NODE_162198_length_305_cov_1.330097	212	292	22	3	80	0.0375000
NODE_162198_length_305_cov_1.330097	212	292	28	3	80	0.0375000
NODE_162198_length_305_cov_1.330097	212	292	34	3	80	0.0375000
NODE_162198_length_305_cov_1.330097	212	292	35	2	80	0.0250000
NODE_162198_length_305_cov_1.330097	212	292	38	6	80	0.0750000
NODE_162198_length_305_cov_1.330097	212	292	40	1	80	0.0125000
NODE_162198_length_305_cov_1.330097	212	292	44	1	80	0.0125000
NODE_162198_length_305_cov_1.330097	212	292	46	5	80	0.0625000
NODE_162198_length_305_cov_1.330097	212	292	48	4	80	0.0500000
NODE_162198_length_305_cov_1.330097	212	292	50	8	80	0.1000000
NODE_162198_length_305_cov_1.330097	212	292	54	1	80	0.0125000
NODE_162198_length_305_cov_1.330097	212	292	58	2	80	0.0250000
NODE_162198_length_305_cov_1.330097	212	292	63	2	80	0.0250000
NODE_162198_length_305_cov_1.330097	212	292	65	2	80	0.0250000
NODE_162198_length_305_cov_1.330097	212	292	67	1	80	0.0125000
NODE_162198_length_305_cov_1.330097	212	292	73	1	80	0.0125000
NODE_162198_length_305_cov_1.330097	212	292	77	4	80	0.0500000
NODE_162198_length_305_cov_1.330097	212	292	79	2	80	0.0250000
NODE_162198_length_305_cov_1.330097	212	292	81	1	80	0.0125000
NODE_162198_length_305_cov_1.330097	212	292	83	3	80	0.0375000
NODE_162198_length_305_cov_1.330097	212	292	85	1	80	0.0125000
NODE_162198_length_305_cov_1.330097	212	292	87	2	80	0.0250000
NODE_162198_length_305_cov_1.330097	212	292	89	2	80	0.0250000
NODE_162198_length_305_cov_1.330097	212	292	90	8	80	0.1000000
NODE_162198_length_305_cov_1.330097	265	305	3	1	40	0.0250000
NODE_162198_length_305_cov_1.330097	265	305	6	3	40	0.0750000
NODE_162198_length_305_cov_1.330097	265	305	8	1	40	0.0250000
NODE_162198_length_305_cov_1.330097	265	305	10	5	40	0.1250000
NODE_162198_length_305_cov_1.330097	265	305	12	9	40	0.2250000
NODE_162198_length_305_cov_1.330097	265	305	14	3	40	0.0750000
NODE_162198_length_305_cov_1.330097	265	305	18	2	40	0.0500000
NODE_162198_length_305_cov_1.330097	265	305	20	1	40	0.0250000
NODE_162198_length_305_cov_1.330097	265	305	22	3	40	0.0750000
NODE_162198_length_305_cov_1.330097	265	305	28	3	40	0.0750000
NODE_162198_length_305_cov_1.330097	265	305	34	3	40	0.0750000
NODE_162198_length_305_cov_1.330097	265	305	35	2	40	0.0500000
NODE_162198_length_305_cov_1.330097	265	305	38	4	40	0.1000000
NODE_162359_length_305_cov_1.111650	245	275	0	30	30	1.0000000
NODE_162411_length_305_cov_0.990291	46	126	0	80	80	1.0000000
NODE_162593_length_305_cov_0.873786	73	109	0	36	36	1.0000000
NODE_162782_length_305_cov_0.631068	86	166	0	80	80	1.0000000
NODE_162782_length_305_cov_0.631068	139	186	0	47	47	1.0000000
NODE_162854_length_304_cov_44.482927	61	102	78	3	41	0.0731707
NODE_162854_length_304_cov_44.482927	61	102	80	1	41	0.0243902
NODE_162854_length_304_cov_44.482927	61	102	82	4	41	0.0975610
NODE_162854_length_304_cov_44.482927	61	102	84	5	41	0.1219512
NODE_162854_length_304_cov_44.482927	61	102	86	2	41	0.0487805
NODE_162854_length_304_cov_44.482927	61	102	88	12	41	0.2926829
NODE_162854_length_304_cov_44.482927	61	102	90	5	41	0.1219512
NODE_162854_length_304_cov_44.482927	61	102	92	1	41	0.0243902
NODE_162854_length_304_cov_44.482927	61	102	94	8	41	0.1951219
NODE_162855_length_304_cov_30.678049	205	281	0	76	76	1.0000000
NODE_162855_length_304_cov_30.678049	254	304	0	50	50	1.0000000
NODE_162886_length_304_cov_4.956098	72	152	4	8	80	0.1000000
NODE_162886_length_304_cov_4.956098	72	152	6	65	80	0.8125000
NODE_162886_length_304_cov_4.956098	72	152	7	3	80	0.0375000
NODE_162886_length_304_cov_4.956098	72	152	10	4	80	0.0500000
NODE_162919_length_304_cov_3.980488	46	126	0	80	80	1.0000000
NODE_162919_length_304_cov_3.980488	99	179	0	80	80	1.0000000
NODE_162932_length_304_cov_3.809756	108	156	6	48	48	1.0000000
NODE_162955_length_304_cov_3.424390	67	129	0	62	62	1.0000000
NODE_162955_length_304_cov_3.424390	120	182	0	62	62	1.0000000
NODE_162997_length_304_cov_2.980488	105	126	0	21	21	1.0000000
NODE_163048_length_304_cov_2.629268	106	186	7	17	80	0.2125000
NODE_163048_length_304_cov_2.629268	106	186	8	29	80	0.3625000
NODE_163048_length_304_cov_2.629268	106	186	10	34	80	0.4250000
NODE_163048_length_304_cov_2.629268	159	209	2	1	50	0.0200000
NODE_163048_length_304_cov_2.629268	159	209	4	6	50	0.1200000
NODE_163048_length_304_cov_2.629268	159	209	5	13	50	0.2600000
NODE_163048_length_304_cov_2.629268	159	209	7	20	50	0.4000000
NODE_163048_length_304_cov_2.629268	159	209	10	10	50	0.2000000
NODE_163116_length_304_cov_2.239024	57	137	2	5	80	0.0625000
NODE_163116_length_304_cov_2.239024	57	137	4	75	80	0.9375000
NODE_163116_length_304_cov_2.239024	110	152	2	20	42	0.4761905
NODE_163116_length_304_cov_2.239024	110	152	4	22	42	0.5238096
NODE_163148_length_304_cov_2.170732	112	145	0	4	33	0.1212121
NODE_163148_length_304_cov_2.170732	112	145	2	13	33	0.3939394
NODE_163148_length_304_cov_2.170732	112	145	4	1	33	0.0303030
NODE_163148_length_304_cov_2.170732	112	145	6	15	33	0.4545455
NODE_163148_length_304_cov_2.170732	146	198	6	1	52	0.0192308
NODE_163148_length_304_cov_2.170732	146	198	10	1	52	0.0192308
NODE_163148_length_304_cov_2.170732	146	198	12	50	52	0.9615384
NODE_163333_length_304_cov_1.687805	219	288	0	69	69	1.0000000
NODE_163432_length_304_cov_1.492683	190	238	0	6	48	0.1250000
NODE_163432_length_304_cov_1.492683	190	238	2	42	48	0.8750000
NODE_163559_length_304_cov_1.287805	99	165	2	4	66	0.0606061
NODE_163559_length_304_cov_1.287805	99	165	4	21	66	0.3181818
NODE_163559_length_304_cov_1.287805	99	165	10	15	66	0.2272727
NODE_163559_length_304_cov_1.287805	99	165	12	26	66	0.3939394
NODE_163670_length_304_cov_1.175610	0	30	0	30	30	1.0000000
NODE_163895_length_304_cov_0.951220	70	150	4	57	80	0.7125000
NODE_163895_length_304_cov_0.951220	70	150	6	22	80	0.2750000
NODE_163895_length_304_cov_0.951220	70	150	8	1	80	0.0125000
NODE_164171_length_303_cov_30.843137	46	97	0	51	51	1.0000000
NODE_164194_length_303_cov_5.401961	33	79	0	22	46	0.4782609
NODE_164194_length_303_cov_5.401961	33	79	2	24	46	0.5217391
NODE_164224_length_303_cov_4.210784	136	205	8	3	69	0.0434783
NODE_164224_length_303_cov_4.210784	136	205	10	1	69	0.0144928
NODE_164224_length_303_cov_4.210784	136	205	12	4	69	0.0579710
NODE_164224_length_303_cov_4.210784	136	205	14	1	69	0.0144928
NODE_164224_length_303_cov_4.210784	136	205	16	10	69	0.1449275
NODE_164224_length_303_cov_4.210784	136	205	18	23	69	0.3333333
NODE_164224_length_303_cov_4.210784	136	205	20	17	69	0.2463768
NODE_164224_length_303_cov_4.210784	136	205	22	2	69	0.0289855
NODE_164224_length_303_cov_4.210784	136	205	24	8	69	0.1159420
NODE_164224_length_303_cov_4.210784	178	259	0	41	81	0.5061728
NODE_164224_length_303_cov_4.210784	178	259	1	3	81	0.0370370
NODE_164224_length_303_cov_4.210784	178	259	3	8	81	0.0987654
NODE_164224_length_303_cov_4.210784	178	259	4	2	81	0.0246914
NODE_164224_length_303_cov_4.210784	178	259	8	3	81	0.0370370
NODE_164224_length_303_cov_4.210784	178	259	10	1	81	0.0123457
NODE_164224_length_303_cov_4.210784	178	259	12	4	81	0.0493827
NODE_164224_length_303_cov_4.210784	178	259	14	1	81	0.0123457
NODE_164224_length_303_cov_4.210784	178	259	16	10	81	0.1234568
NODE_164224_length_303_cov_4.210784	178	259	18	8	81	0.0987654
NODE_164251_length_303_cov_3.671569	9	75	0	66	66	1.0000000
NODE_164251_length_303_cov_3.671569	48	128	0	80	80	1.0000000
NODE_164251_length_303_cov_3.671569	48	128	0	80	80	1.0000000
NODE_164251_length_303_cov_3.671569	220	300	0	20	80	0.2500000
NODE_164251_length_303_cov_3.671569	220	300	2	6	80	0.0750000
NODE_164251_length_303_cov_3.671569	220	300	4	54	80	0.6750000
NODE_164267_length_303_cov_3.500000	55	123	0	68	68	1.0000000
NODE_164272_length_303_cov_3.460784	0	67	0	5	67	0.0746269
NODE_164272_length_303_cov_3.460784	0	67	2	5	67	0.0746269
NODE_164272_length_303_cov_3.460784	0	67	4	4	67	0.0597015
NODE_164272_length_303_cov_3.460784	0	67	6	13	67	0.1940299
NODE_164272_length_303_cov_3.460784	0	67	9	2	67	0.0298507
NODE_164272_length_303_cov_3.460784	0	67	10	1	67	0.0149254
NODE_164272_length_303_cov_3.460784	0	67	12	1	67	0.0149254
NODE_164272_length_303_cov_3.460784	0	67	16	1	67	0.0149254
NODE_164272_length_303_cov_3.460784	0	67	21	2	67	0.0298507
NODE_164272_length_303_cov_3.460784	0	67	25	2	67	0.0298507
NODE_164272_length_303_cov_3.460784	0	67	28	1	67	0.0149254
NODE_164272_length_303_cov_3.460784	0	67	31	1	67	0.0149254
NODE_164272_length_303_cov_3.460784	0	67	34	1	67	0.0149254
NODE_164272_length_303_cov_3.460784	0	67	39	5	67	0.0746269
NODE_164272_length_303_cov_3.460784	0	67	41	1	67	0.0149254
NODE_164272_length_303_cov_3.460784	0	67	45	2	67	0.0298507
NODE_164272_length_303_cov_3.460784	0	67	46	1	67	0.0149254
NODE_164272_length_303_cov_3.460784	0	67	48	2	67	0.0298507
NODE_164272_length_303_cov_3.460784	0	67	50	4	67	0.0597015
NODE_164272_length_303_cov_3.460784	0	67	54	1	67	0.0149254
NODE_164272_length_303_cov_3.460784	0	67	56	1	67	0.0149254
NODE_164272_length_303_cov_3.460784	0	67	66	2	67	0.0298507
NODE_164272_length_303_cov_3.460784	0	67	68	7	67	0.1044776
NODE_164272_length_303_cov_3.460784	0	67	69	1	67	0.0149254
NODE_164272_length_303_cov_3.460784	0	67	71	1	67	0.0149254
NODE_164272_length_303_cov_3.460784	98	178	156	1	80	0.0125000
NODE_164272_length_303_cov_3.460784	98	178	162	1	80	0.0125000
NODE_164272_length_303_cov_3.460784	98	178	168	1	80	0.0125000
NODE_164272_length_303_cov_3.460784	98	178	174	1	80	0.0125000
NODE_164272_length_303_cov_3.460784	98	178	177	1	80	0.0125000
NODE_164272_length_303_cov_3.460784	98	178	178	1	80	0.0125000
NODE_164272_length_303_cov_3.460784	98	178	179	2	80	0.0250000
NODE_164272_length_303_cov_3.460784	98	178	186	2	80	0.0250000
NODE_164272_length_303_cov_3.460784	98	178	189	1	80	0.0125000
NODE_164272_length_303_cov_3.460784	98	178	191	3	80	0.0375000
NODE_164272_length_303_cov_3.460784	98	178	193	1	80	0.0125000
NODE_164272_length_303_cov_3.460784	98	178	195	1	80	0.0125000
NODE_164272_length_303_cov_3.460784	98	178	201	1	80	0.0125000
NODE_164272_length_303_cov_3.460784	98	178	203	2	80	0.0250000
NODE_164272_length_303_cov_3.460784	98	178	205	4	80	0.0500000
NODE_164272_length_303_cov_3.460784	98	178	207	2	80	0.0250000
NODE_164272_length_303_cov_3.460784	98	178	209	4	80	0.0500000
NODE_164272_length_303_cov_3.460784	98	178	211	2	80	0.0250000
NODE_164272_length_303_cov_3.460784	98	178	213	1	80	0.0125000
NODE_164272_length_303_cov_3.460784	98	178	219	1	80	0.0125000
NODE_164272_length_303_cov_3.460784	98	178	220	1	80	0.0125000
NODE_164272_length_303_cov_3.460784	98	178	222	1	80	0.0125000
NODE_164272_length_303_cov_3.460784	98	178	223	1	80	0.0125000
NODE_164272_length_303_cov_3.460784	98	178	224	3	80	0.0375000
NODE_164272_length_303_cov_3.460784	98	178	232	2	80	0.0250000
NODE_164272_length_303_cov_3.460784	98	178	234	2	80	0.0250000
NODE_164272_length_303_cov_3.460784	98	178	236	4	80	0.0500000
NODE_164272_length_303_cov_3.460784	98	178	237	2	80	0.0250000
NODE_164272_length_303_cov_3.460784	98	178	238	8	80	0.1000000
NODE_164272_length_303_cov_3.460784	98	178	239	1	80	0.0125000
NODE_164272_length_303_cov_3.460784	98	178	240	2	80	0.0250000
NODE_164272_length_303_cov_3.460784	98	178	242	3	80	0.0375000
NODE_164272_length_303_cov_3.460784	98	178	244	6	80	0.0750000
NODE_164272_length_303_cov_3.460784	98	178	246	1	80	0.0125000
NODE_164272_length_303_cov_3.460784	98	178	248	3	80	0.0375000
NODE_164272_length_303_cov_3.460784	98	178	251	1	80	0.0125000
NODE_164272_length_303_cov_3.460784	98	178	254	2	80	0.0250000
NODE_164272_length_303_cov_3.460784	98	178	256	4	80	0.0500000
NODE_164272_length_303_cov_3.460784	151	191	206	1	40	0.0250000
NODE_164272_length_303_cov_3.460784	151	191	207	2	40	0.0500000
NODE_164272_length_303_cov_3.460784	151	191	209	2	40	0.0500000
NODE_164272_length_303_cov_3.460784	151	191	214	2	40	0.0500000
NODE_164272_length_303_cov_3.460784	151	191	215	2	40	0.0500000
NODE_164272_length_303_cov_3.460784	151	191	217	1	40	0.0250000
NODE_164272_length_303_cov_3.460784	151	191	218	1	40	0.0250000
NODE_164272_length_303_cov_3.460784	151	191	230	1	40	0.0250000
NODE_164272_length_303_cov_3.460784	151	191	232	2	40	0.0500000
NODE_164272_length_303_cov_3.460784	151	191	233	1	40	0.0250000
NODE_164272_length_303_cov_3.460784	151	191	234	2	40	0.0500000
NODE_164272_length_303_cov_3.460784	151	191	236	4	40	0.1000000
NODE_164272_length_303_cov_3.460784	151	191	237	1	40	0.0250000
NODE_164272_length_303_cov_3.460784	151	191	238	6	40	0.1500000
NODE_164272_length_303_cov_3.460784	151	191	240	1	40	0.0250000
NODE_164272_length_303_cov_3.460784	151	191	242	1	40	0.0250000
NODE_164272_length_303_cov_3.460784	151	191	248	3	40	0.0750000
NODE_164272_length_303_cov_3.460784	151	191	251	1	40	0.0250000
NODE_164272_length_303_cov_3.460784	151	191	254	2	40	0.0500000
NODE_164272_length_303_cov_3.460784	151	191	256	4	40	0.1000000
NODE_164283_length_303_cov_3.352941	77	146	4	10	69	0.1449275
NODE_164283_length_303_cov_3.352941	77	146	6	59	69	0.8550724
NODE_164433_length_303_cov_2.284314	78	158	0	80	80	1.0000000
NODE_164433_length_303_cov_2.284314	215	295	0	16	80	0.2000000
NODE_164433_length_303_cov_2.284314	215	295	2	45	80	0.5625000
NODE_164433_length_303_cov_2.284314	215	295	4	19	80	0.2375000
NODE_164581_length_303_cov_1.848039	90	170	0	80	80	1.0000000
NODE_164581_length_303_cov_1.848039	143	223	0	80	80	1.0000000
NODE_164581_length_303_cov_1.848039	212	235	0	23	23	1.0000000
NODE_164668_length_303_cov_1.686275	62	88	0	26	26	1.0000000
NODE_164695_length_303_cov_1.583333	206	270	0	64	64	1.0000000
NODE_164800_length_303_cov_1.475490	155	221	0	13	66	0.1969697
NODE_164800_length_303_cov_1.475490	155	221	2	53	66	0.8030303
NODE_164846_length_303_cov_1.392157	135	213	10	78	78	1.0000000
NODE_164878_length_303_cov_1.318627	0	75	0	75	75	1.0000000
NODE_164974_length_303_cov_1.215686	278	297	0	5	19	0.2631579
NODE_164974_length_303_cov_1.215686	278	297	2	14	19	0.7368421
NODE_165498_length_302_cov_10.852217	266	300	0	34	34	1.0000000
NODE_165502_length_302_cov_7.896552	46	131	0	85	85	1.0000000
NODE_165502_length_302_cov_7.896552	104	160	0	56	56	1.0000000
NODE_165505_length_302_cov_7.266010	135	191	0	56	56	1.0000000
NODE_165507_length_302_cov_7.216749	93	149	0	28	56	0.5000000
NODE_165507_length_302_cov_7.216749	93	149	2	28	56	0.5000000
NODE_165507_length_302_cov_7.216749	155	226	0	71	71	1.0000000
NODE_165517_length_302_cov_6.172414	179	243	0	64	64	1.0000000
NODE_165517_length_302_cov_6.172414	232	287	0	55	55	1.0000000
NODE_165528_length_302_cov_5.586207	221	293	2	11	72	0.1527778
NODE_165528_length_302_cov_5.586207	221	293	4	2	72	0.0277778
NODE_165528_length_302_cov_5.586207	221	293	6	31	72	0.4305556
NODE_165528_length_302_cov_5.586207	221	293	8	9	72	0.1250000
NODE_165528_length_302_cov_5.586207	221	293	9	1	72	0.0138889
NODE_165528_length_302_cov_5.586207	221	293	10	18	72	0.2500000
NODE_165641_length_302_cov_2.985222	104	186	18	8	82	0.0975610
NODE_165641_length_302_cov_2.985222	104	186	20	2	82	0.0243902
NODE_165641_length_302_cov_2.985222	104	186	22	1	82	0.0121951
NODE_165641_length_302_cov_2.985222	104	186	24	2	82	0.0243902
NODE_165641_length_302_cov_2.985222	104	186	26	5	82	0.0609756
NODE_165641_length_302_cov_2.985222	104	186	28	10	82	0.1219512
NODE_165641_length_302_cov_2.985222	104	186	30	1	82	0.0121951
NODE_165641_length_302_cov_2.985222	104	186	32	27	82	0.3292683
NODE_165641_length_302_cov_2.985222	104	186	34	9	82	0.1097561
NODE_165641_length_302_cov_2.985222	104	186	36	17	82	0.2073171
NODE_165848_length_302_cov_2.009852	12	34	0	22	22	1.0000000
NODE_165934_length_302_cov_1.758621	98	152	2	30	54	0.5555556
NODE_165934_length_302_cov_1.758621	98	152	4	9	54	0.1666667
NODE_165934_length_302_cov_1.758621	98	152	6	15	54	0.2777778
NODE_165945_length_302_cov_1.758621	230	294	0	64	64	1.0000000
NODE_166007_length_302_cov_1.620690	172	232	14	25	60	0.4166667
NODE_166007_length_302_cov_1.620690	172	232	16	27	60	0.4500000
NODE_166007_length_302_cov_1.620690	172	232	18	8	60	0.1333333
NODE_166007_length_302_cov_1.620690	225	277	4	7	52	0.1346154
NODE_166007_length_302_cov_1.620690	225	277	6	24	52	0.4615385
NODE_166007_length_302_cov_1.620690	225	277	12	10	52	0.1923077
NODE_166007_length_302_cov_1.620690	225	277	14	11	52	0.2115385
NODE_166320_length_302_cov_1.172414	34	103	0	18	69	0.2608696
NODE_166320_length_302_cov_1.172414	34	103	2	30	69	0.4347826
NODE_166320_length_302_cov_1.172414	34	103	4	21	69	0.3043478
NODE_166381_length_302_cov_1.044335	54	130	0	19	76	0.2500000
NODE_166381_length_302_cov_1.044335	54	130	2	57	76	0.7500000
NODE_166617_length_302_cov_0.847291	94	172	4	2	78	0.0256410
NODE_166617_length_302_cov_0.847291	94	172	6	1	78	0.0128205
NODE_166617_length_302_cov_0.847291	94	172	12	5	78	0.0641026
NODE_166617_length_302_cov_0.847291	94	172	27	11	78	0.1410256
NODE_166617_length_302_cov_0.847291	94	172	31	3	78	0.0384615
NODE_166617_length_302_cov_0.847291	94	172	35	8	78	0.1025641
NODE_166617_length_302_cov_0.847291	94	172	37	2	78	0.0256410
NODE_166617_length_302_cov_0.847291	94	172	39	3	78	0.0384615
NODE_166617_length_302_cov_0.847291	94	172	40	4	78	0.0512821
NODE_166617_length_302_cov_0.847291	94	172	42	1	78	0.0128205
NODE_166617_length_302_cov_0.847291	94	172	44	3	78	0.0384615
NODE_166617_length_302_cov_0.847291	94	172	48	3	78	0.0384615
NODE_166617_length_302_cov_0.847291	94	172	50	6	78	0.0769231
NODE_166617_length_302_cov_0.847291	94	172	52	1	78	0.0128205
NODE_166617_length_302_cov_0.847291	94	172	56	19	78	0.2435897
NODE_166617_length_302_cov_0.847291	94	172	60	1	78	0.0128205
NODE_166617_length_302_cov_0.847291	94	172	62	1	78	0.0128205
NODE_166617_length_302_cov_0.847291	94	172	64	4	78	0.0512821
NODE_166617_length_302_cov_0.847291	94	172	4	2	78	0.0256410
NODE_166617_length_302_cov_0.847291	94	172	6	1	78	0.0128205
NODE_166617_length_302_cov_0.847291	94	172	12	5	78	0.0641026
NODE_166617_length_302_cov_0.847291	94	172	27	11	78	0.1410256
NODE_166617_length_302_cov_0.847291	94	172	31	3	78	0.0384615
NODE_166617_length_302_cov_0.847291	94	172	35	8	78	0.1025641
NODE_166617_length_302_cov_0.847291	94	172	37	2	78	0.0256410
NODE_166617_length_302_cov_0.847291	94	172	39	3	78	0.0384615
NODE_166617_length_302_cov_0.847291	94	172	40	4	78	0.0512821
NODE_166617_length_302_cov_0.847291	94	172	42	1	78	0.0128205
NODE_166617_length_302_cov_0.847291	94	172	44	3	78	0.0384615
NODE_166617_length_302_cov_0.847291	94	172	48	3	78	0.0384615
NODE_166617_length_302_cov_0.847291	94	172	50	6	78	0.0769231
NODE_166617_length_302_cov_0.847291	94	172	52	1	78	0.0128205
NODE_166617_length_302_cov_0.847291	94	172	56	19	78	0.2435897
NODE_166617_length_302_cov_0.847291	94	172	60	1	78	0.0128205
NODE_166617_length_302_cov_0.847291	94	172	62	1	78	0.0128205
NODE_166617_length_302_cov_0.847291	94	172	64	4	78	0.0512821
NODE_166617_length_302_cov_0.847291	103	172	27	10	69	0.1449275
NODE_166617_length_302_cov_0.847291	103	172	31	3	69	0.0434783
NODE_166617_length_302_cov_0.847291	103	172	35	8	69	0.1159420
NODE_166617_length_302_cov_0.847291	103	172	37	2	69	0.0289855
NODE_166617_length_302_cov_0.847291	103	172	39	3	69	0.0434783
NODE_166617_length_302_cov_0.847291	103	172	40	4	69	0.0579710
NODE_166617_length_302_cov_0.847291	103	172	42	1	69	0.0144928
NODE_166617_length_302_cov_0.847291	103	172	44	3	69	0.0434783
NODE_166617_length_302_cov_0.847291	103	172	48	3	69	0.0434783
NODE_166617_length_302_cov_0.847291	103	172	50	6	69	0.0869565
NODE_166617_length_302_cov_0.847291	103	172	52	1	69	0.0144928
NODE_166617_length_302_cov_0.847291	103	172	56	19	69	0.2753623
NODE_166617_length_302_cov_0.847291	103	172	60	1	69	0.0144928
NODE_166617_length_302_cov_0.847291	103	172	62	1	69	0.0144928
NODE_166617_length_302_cov_0.847291	103	172	64	4	69	0.0579710
NODE_166638_length_302_cov_0.807882	97	177	0	80	80	1.0000000
NODE_166819_length_301_cov_6.960396	268	299	4	15	31	0.4838710
NODE_166819_length_301_cov_6.960396	268	299	6	16	31	0.5161290
NODE_166827_length_301_cov_6.148515	214	283	0	69	69	1.0000000
NODE_166889_length_301_cov_3.747525	116	196	0	40	80	0.5000000
NODE_166889_length_301_cov_3.747525	116	196	2	40	80	0.5000000
NODE_166904_length_301_cov_3.509901	217	277	2	7	60	0.1166667
NODE_166904_length_301_cov_3.509901	217	277	3	1	60	0.0166667
NODE_166904_length_301_cov_3.509901	217	277	5	1	60	0.0166667
NODE_166904_length_301_cov_3.509901	217	277	7	1	60	0.0166667
NODE_166904_length_301_cov_3.509901	217	277	9	1	60	0.0166667
NODE_166904_length_301_cov_3.509901	217	277	13	1	60	0.0166667
NODE_166904_length_301_cov_3.509901	217	277	15	2	60	0.0333333
NODE_166904_length_301_cov_3.509901	217	277	19	2	60	0.0333333
NODE_166904_length_301_cov_3.509901	217	277	21	6	60	0.1000000
NODE_166904_length_301_cov_3.509901	217	277	23	1	60	0.0166667
NODE_166904_length_301_cov_3.509901	217	277	24	1	60	0.0166667
NODE_166904_length_301_cov_3.509901	217	277	25	3	60	0.0500000
NODE_166904_length_301_cov_3.509901	217	277	28	3	60	0.0500000
NODE_166904_length_301_cov_3.509901	217	277	30	1	60	0.0166667
NODE_166904_length_301_cov_3.509901	217	277	31	1	60	0.0166667
NODE_166904_length_301_cov_3.509901	217	277	32	1	60	0.0166667
NODE_166904_length_301_cov_3.509901	217	277	33	8	60	0.1333333
NODE_166904_length_301_cov_3.509901	217	277	35	2	60	0.0333333
NODE_166904_length_301_cov_3.509901	217	277	37	1	60	0.0166667
NODE_166904_length_301_cov_3.509901	217	277	41	1	60	0.0166667
NODE_166904_length_301_cov_3.509901	217	277	50	4	60	0.0666667
NODE_166904_length_301_cov_3.509901	217	277	52	4	60	0.0666667
NODE_166904_length_301_cov_3.509901	217	277	54	2	60	0.0333333
NODE_166904_length_301_cov_3.509901	217	277	58	4	60	0.0666667
NODE_166904_length_301_cov_3.509901	217	277	61	1	60	0.0166667
NODE_166993_length_301_cov_2.653465	133	213	0	35	80	0.4375000
NODE_166993_length_301_cov_2.653465	133	213	2	45	80	0.5625000
NODE_167126_length_301_cov_2.084158	178	258	22	1	80	0.0125000
NODE_167126_length_301_cov_2.084158	178	258	24	2	80	0.0250000
NODE_167126_length_301_cov_2.084158	178	258	26	2	80	0.0250000
NODE_167126_length_301_cov_2.084158	178	258	32	2	80	0.0250000
NODE_167126_length_301_cov_2.084158	178	258	34	4	80	0.0500000
NODE_167126_length_301_cov_2.084158	178	258	36	2	80	0.0250000
NODE_167126_length_301_cov_2.084158	178	258	38	3	80	0.0375000
NODE_167126_length_301_cov_2.084158	178	258	40	8	80	0.1000000
NODE_167126_length_301_cov_2.084158	178	258	44	3	80	0.0375000
NODE_167126_length_301_cov_2.084158	178	258	48	1	80	0.0125000
NODE_167126_length_301_cov_2.084158	178	258	50	5	80	0.0625000
NODE_167126_length_301_cov_2.084158	178	258	52	17	80	0.2125000
NODE_167126_length_301_cov_2.084158	178	258	53	3	80	0.0375000
NODE_167126_length_301_cov_2.084158	178	258	54	27	80	0.3375000
NODE_167215_length_301_cov_1.831683	111	175	0	64	64	1.0000000
NODE_167215_length_301_cov_1.831683	164	228	0	64	64	1.0000000
NODE_167308_length_301_cov_1.603960	173	233	0	55	60	0.9166667
NODE_167308_length_301_cov_1.603960	173	233	2	5	60	0.0833333
NODE_167313_length_301_cov_1.584158	30	108	0	78	78	1.0000000
NODE_167434_length_301_cov_1.470297	90	165	0	75	75	1.0000000
NODE_167508_length_301_cov_1.326733	175	247	6	4	72	0.0555556
NODE_167508_length_301_cov_1.326733	175	247	7	1	72	0.0138889
NODE_167508_length_301_cov_1.326733	175	247	8	1	72	0.0138889
NODE_167508_length_301_cov_1.326733	175	247	9	6	72	0.0833333
NODE_167508_length_301_cov_1.326733	175	247	11	60	72	0.8333333
NODE_167612_length_301_cov_1.247525	29	73	0	44	44	1.0000000
NODE_167642_length_301_cov_1.183168	123	203	0	8	80	0.1000000
NODE_167642_length_301_cov_1.183168	123	203	2	19	80	0.2375000
NODE_167642_length_301_cov_1.183168	123	203	4	6	80	0.0750000
NODE_167642_length_301_cov_1.183168	123	203	8	2	80	0.0250000
NODE_167642_length_301_cov_1.183168	123	203	10	2	80	0.0250000
NODE_167642_length_301_cov_1.183168	123	203	12	1	80	0.0125000
NODE_167642_length_301_cov_1.183168	123	203	14	3	80	0.0375000
NODE_167642_length_301_cov_1.183168	123	203	16	4	80	0.0500000
NODE_167642_length_301_cov_1.183168	123	203	18	11	80	0.1375000
NODE_167642_length_301_cov_1.183168	123	203	20	4	80	0.0500000
NODE_167642_length_301_cov_1.183168	123	203	22	1	80	0.0125000
NODE_167642_length_301_cov_1.183168	123	203	26	5	80	0.0625000
NODE_167642_length_301_cov_1.183168	123	203	28	14	80	0.1750000
NODE_167659_length_301_cov_1.163366	10	83	0	73	73	1.0000000
NODE_167659_length_301_cov_1.163366	91	121	0	30	30	1.0000000
NODE_167668_length_301_cov_1.148515	161	209	0	48	48	1.0000000
NODE_167880_length_301_cov_0.980198	242	297	0	55	55	1.0000000
NODE_167891_length_301_cov_0.960396	22	63	0	23	41	0.5609756
NODE_167891_length_301_cov_0.960396	22	63	1	1	41	0.0243902
NODE_167891_length_301_cov_0.960396	22	63	2	17	41	0.4146341
NODE_168253_length_300_cov_3.402985	44	124	0	25	80	0.3125000
NODE_168253_length_300_cov_3.402985	44	124	3	1	80	0.0125000
NODE_168253_length_300_cov_3.402985	44	124	4	54	80	0.6750000
NODE_168253_length_300_cov_3.402985	97	177	0	11	80	0.1375000
NODE_168253_length_300_cov_3.402985	97	177	4	69	80	0.8625000
NODE_168253_length_300_cov_3.402985	173	254	0	6	81	0.0740741
NODE_168253_length_300_cov_3.402985	173	254	2	13	81	0.1604938
NODE_168253_length_300_cov_3.402985	173	254	4	26	81	0.3209876
NODE_168253_length_300_cov_3.402985	173	254	6	36	81	0.4444444
NODE_168253_length_300_cov_3.402985	233	300	0	2	67	0.0298507
NODE_168253_length_300_cov_3.402985	233	300	2	3	67	0.0447761
NODE_168253_length_300_cov_3.402985	233	300	4	6	67	0.0895522
NODE_168253_length_300_cov_3.402985	233	300	6	56	67	0.8358209
NODE_168265_length_300_cov_3.298507	18	98	0	18	80	0.2250000
NODE_168265_length_300_cov_3.298507	18	98	2	6	80	0.0750000
NODE_168265_length_300_cov_3.298507	18	98	4	9	80	0.1125000
NODE_168265_length_300_cov_3.298507	18	98	6	47	80	0.5875000
NODE_168360_length_300_cov_2.597015	110	182	8	12	72	0.1666667
NODE_168360_length_300_cov_2.597015	110	182	10	60	72	0.8333333
NODE_168363_length_300_cov_2.572139	28	102	0	4	74	0.0540541
NODE_168363_length_300_cov_2.572139	28	102	1	13	74	0.1756757
NODE_168363_length_300_cov_2.572139	28	102	2	4	74	0.0540541
NODE_168363_length_300_cov_2.572139	28	102	4	1	74	0.0135135
NODE_168363_length_300_cov_2.572139	28	102	8	4	74	0.0540541
NODE_168363_length_300_cov_2.572139	28	102	10	22	74	0.2972973
NODE_168363_length_300_cov_2.572139	28	102	12	3	74	0.0405405
NODE_168363_length_300_cov_2.572139	28	102	14	1	74	0.0135135
NODE_168363_length_300_cov_2.572139	28	102	16	6	74	0.0810811
NODE_168363_length_300_cov_2.572139	28	102	18	9	74	0.1216216
NODE_168363_length_300_cov_2.572139	28	102	20	1	74	0.0135135
NODE_168363_length_300_cov_2.572139	28	102	22	6	74	0.0810811
NODE_168363_length_300_cov_2.572139	75	141	10	1	66	0.0151515
NODE_168363_length_300_cov_2.572139	75	141	12	3	66	0.0454545
NODE_168363_length_300_cov_2.572139	75	141	14	1	66	0.0151515
NODE_168363_length_300_cov_2.572139	75	141	16	6	66	0.0909091
NODE_168363_length_300_cov_2.572139	75	141	18	9	66	0.1363636
NODE_168363_length_300_cov_2.572139	75	141	20	1	66	0.0151515
NODE_168363_length_300_cov_2.572139	75	141	22	7	66	0.1060606
NODE_168363_length_300_cov_2.572139	75	141	24	38	66	0.5757576
NODE_168402_length_300_cov_2.417910	0	44	0	20	44	0.4545455
NODE_168402_length_300_cov_2.417910	0	44	2	24	44	0.5454546
NODE_168459_length_300_cov_2.174129	117	197	6	21	80	0.2625000
NODE_168459_length_300_cov_2.174129	117	197	8	8	80	0.1000000
NODE_168459_length_300_cov_2.174129	117	197	10	8	80	0.1000000
NODE_168459_length_300_cov_2.174129	117	197	11	2	80	0.0250000
NODE_168459_length_300_cov_2.174129	117	197	12	1	80	0.0125000
NODE_168459_length_300_cov_2.174129	117	197	13	2	80	0.0250000
NODE_168459_length_300_cov_2.174129	117	197	14	34	80	0.4250000
NODE_168459_length_300_cov_2.174129	117	197	15	3	80	0.0375000
NODE_168459_length_300_cov_2.174129	117	197	16	1	80	0.0125000
NODE_168459_length_300_cov_2.174129	170	250	14	41	80	0.5125000
NODE_168459_length_300_cov_2.174129	170	250	16	1	80	0.0125000
NODE_168459_length_300_cov_2.174129	170	250	18	1	80	0.0125000
NODE_168459_length_300_cov_2.174129	170	250	22	1	80	0.0125000
NODE_168459_length_300_cov_2.174129	170	250	24	1	80	0.0125000
NODE_168459_length_300_cov_2.174129	170	250	30	3	80	0.0375000
NODE_168459_length_300_cov_2.174129	170	250	34	1	80	0.0125000
NODE_168459_length_300_cov_2.174129	170	250	38	1	80	0.0125000
NODE_168459_length_300_cov_2.174129	170	250	40	4	80	0.0500000
NODE_168459_length_300_cov_2.174129	170	250	41	1	80	0.0125000
NODE_168459_length_300_cov_2.174129	170	250	42	1	80	0.0125000
NODE_168459_length_300_cov_2.174129	170	250	43	1	80	0.0125000
NODE_168459_length_300_cov_2.174129	170	250	45	5	80	0.0625000
NODE_168459_length_300_cov_2.174129	170	250	47	18	80	0.2250000
NODE_168459_length_300_cov_2.174129	216	296	30	2	80	0.0250000
NODE_168459_length_300_cov_2.174129	216	296	32	1	80	0.0125000
NODE_168459_length_300_cov_2.174129	216	296	34	2	80	0.0250000
NODE_168459_length_300_cov_2.174129	216	296	38	6	80	0.0750000
NODE_168459_length_300_cov_2.174129	216	296	40	7	80	0.0875000
NODE_168459_length_300_cov_2.174129	216	296	41	1	80	0.0125000
NODE_168459_length_300_cov_2.174129	216	296	42	1	80	0.0125000
NODE_168459_length_300_cov_2.174129	216	296	43	1	80	0.0125000
NODE_168459_length_300_cov_2.174129	216	296	44	12	80	0.1500000
NODE_168459_length_300_cov_2.174129	216	296	45	29	80	0.3625000
NODE_168459_length_300_cov_2.174129	216	296	47	18	80	0.2250000
NODE_168462_length_300_cov_2.164179	122	141	0	19	19	1.0000000
NODE_168479_length_300_cov_2.079602	127	207	0	19	80	0.2375000
NODE_168479_length_300_cov_2.079602	127	207	2	61	80	0.7625000
NODE_168479_length_300_cov_2.079602	203	273	0	48	70	0.6857143
NODE_168479_length_300_cov_2.079602	203	273	2	22	70	0.3142857
NODE_168541_length_300_cov_1.965174	15	86	0	71	71	1.0000000
NODE_168656_length_300_cov_1.731343	31	88	6	57	57	1.0000000
NODE_168906_length_300_cov_1.268657	62	98	0	36	36	1.0000000
NODE_168906_length_300_cov_1.268657	151	186	0	35	35	1.0000000
NODE_169014_length_300_cov_1.104478	86	165	4	79	79	1.0000000
NODE_169053_length_300_cov_1.029851	110	177	2	28	67	0.4179105
NODE_169053_length_300_cov_1.029851	110	177	4	10	67	0.1492537
NODE_169053_length_300_cov_1.029851	110	177	6	17	67	0.2537313
NODE_169053_length_300_cov_1.029851	110	177	8	12	67	0.1791045
NODE_169053_length_300_cov_1.029851	120	177	2	28	57	0.4912281
NODE_169053_length_300_cov_1.029851	120	177	4	10	57	0.1754386
NODE_169053_length_300_cov_1.029851	120	177	6	13	57	0.2280702
NODE_169053_length_300_cov_1.029851	120	177	8	6	57	0.1052632
NODE_169378_length_300_cov_0.716418	191	210	0	19	19	1.0000000
NODE_169528_length_299_cov_4.435000	48	128	2	3	80	0.0375000
NODE_169528_length_299_cov_4.435000	48	128	4	6	80	0.0750000
NODE_169528_length_299_cov_4.435000	48	128	6	1	80	0.0125000
NODE_169528_length_299_cov_4.435000	48	128	8	42	80	0.5250000
NODE_169528_length_299_cov_4.435000	48	128	10	28	80	0.3500000
NODE_169528_length_299_cov_4.435000	101	167	8	66	66	1.0000000
NODE_169567_length_299_cov_3.780000	114	181	0	67	67	1.0000000
NODE_169631_length_299_cov_3.095000	0	73	0	73	73	1.0000000
NODE_169631_length_299_cov_3.095000	0	20	0	20	20	1.0000000
NODE_169725_length_299_cov_2.495000	46	126	0	80	80	1.0000000
NODE_169725_length_299_cov_2.495000	99	179	0	80	80	1.0000000
NODE_169769_length_299_cov_2.275000	127	192	0	6	65	0.0923077
NODE_169769_length_299_cov_2.275000	127	192	6	13	65	0.2000000
NODE_169769_length_299_cov_2.275000	127	192	8	46	65	0.7076923
NODE_169781_length_299_cov_2.250000	72	135	2	53	63	0.8412699
NODE_169781_length_299_cov_2.250000	72	135	4	10	63	0.1587302
NODE_169781_length_299_cov_2.250000	108	188	2	80	80	1.0000000
NODE_169811_length_299_cov_2.090000	25	105	0	80	80	1.0000000
NODE_169888_length_299_cov_1.955000	173	214	6	11	41	0.2682927
NODE_169888_length_299_cov_1.955000	173	214	8	8	41	0.1951219
NODE_169888_length_299_cov_1.955000	173	214	10	13	41	0.3170732
NODE_169888_length_299_cov_1.955000	173	214	12	1	41	0.0243902
NODE_169888_length_299_cov_1.955000	173	214	14	6	41	0.1463415
NODE_169888_length_299_cov_1.955000	173	214	16	2	41	0.0487805
NODE_169888_length_299_cov_1.955000	187	227	6	1	40	0.0250000
NODE_169888_length_299_cov_1.955000	187	227	8	4	40	0.1000000
NODE_169888_length_299_cov_1.955000	187	227	10	13	40	0.3250000
NODE_169888_length_299_cov_1.955000	187	227	12	1	40	0.0250000
NODE_169888_length_299_cov_1.955000	187	227	14	16	40	0.4000000
NODE_169888_length_299_cov_1.955000	187	227	16	5	40	0.1250000
NODE_169916_length_299_cov_1.885000	29	109	0	31	80	0.3875000
NODE_169916_length_299_cov_1.885000	29	109	2	49	80	0.6125000
NODE_169920_length_299_cov_1.880000	204	236	0	32	32	1.0000000
NODE_169938_length_299_cov_1.840000	154	190	0	36	36	1.0000000
NODE_169995_length_299_cov_1.710000	211	291	0	80	80	1.0000000
NODE_170048_length_299_cov_1.550000	174	205	0	31	31	1.0000000
NODE_170501_length_299_cov_1.020000	42	115	0	14	73	0.1917808
NODE_170501_length_299_cov_1.020000	42	115	2	31	73	0.4246575
NODE_170501_length_299_cov_1.020000	42	115	4	1	73	0.0136986
NODE_170501_length_299_cov_1.020000	42	115	6	27	73	0.3698630
NODE_170546_length_299_cov_1.020000	132	175	0	43	43	1.0000000
NODE_170620_length_299_cov_0.935000	173	216	6	8	43	0.1860465
NODE_170620_length_299_cov_0.935000	173	216	8	35	43	0.8139535
NODE_170691_length_299_cov_0.765000	86	128	0	42	42	1.0000000
NODE_170887_length_298_cov_20.894472	70	150	0	72	80	0.9000000
NODE_170887_length_298_cov_20.894472	70	150	2	8	80	0.1000000
NODE_170887_length_298_cov_20.894472	123	203	0	19	80	0.2375000
NODE_170887_length_298_cov_20.894472	123	203	2	61	80	0.7625000
NODE_170888_length_298_cov_13.859296	228	298	0	19	70	0.2714286
NODE_170888_length_298_cov_13.859296	228	298	2	13	70	0.1857143
NODE_170888_length_298_cov_13.859296	228	298	5	1	70	0.0142857
NODE_170888_length_298_cov_13.859296	228	298	6	10	70	0.1428571
NODE_170888_length_298_cov_13.859296	228	298	12	2	70	0.0285714
NODE_170888_length_298_cov_13.859296	228	298	13	2	70	0.0285714
NODE_170888_length_298_cov_13.859296	228	298	15	9	70	0.1285714
NODE_170888_length_298_cov_13.859296	228	298	17	11	70	0.1571429
NODE_170888_length_298_cov_13.859296	228	298	19	3	70	0.0428571
NODE_170909_length_298_cov_5.859296	1	65	6	1	64	0.0156250
NODE_170909_length_298_cov_5.859296	1	65	8	63	64	0.9843750
NODE_170909_length_298_cov_5.859296	38	118	6	29	80	0.3625000
NODE_170909_length_298_cov_5.859296	38	118	8	51	80	0.6375000
NODE_170909_length_298_cov_5.859296	114	194	2	6	80	0.0750000
NODE_170909_length_298_cov_5.859296	114	194	6	8	80	0.1000000
NODE_170909_length_298_cov_5.859296	114	194	12	6	80	0.0750000
NODE_170909_length_298_cov_5.859296	114	194	14	15	80	0.1875000
NODE_170909_length_298_cov_5.859296	114	194	16	5	80	0.0625000
NODE_170909_length_298_cov_5.859296	114	194	18	9	80	0.1125000
NODE_170909_length_298_cov_5.859296	114	194	22	3	80	0.0375000
NODE_170909_length_298_cov_5.859296	114	194	26	13	80	0.1625000
NODE_170909_length_298_cov_5.859296	114	194	28	2	80	0.0250000
NODE_170909_length_298_cov_5.859296	114	194	30	1	80	0.0125000
NODE_170909_length_298_cov_5.859296	114	194	34	12	80	0.1500000
NODE_170909_length_298_cov_5.859296	167	238	26	12	71	0.1690141
NODE_170909_length_298_cov_5.859296	167	238	28	2	71	0.0281690
NODE_170909_length_298_cov_5.859296	167	238	30	1	71	0.0140845
NODE_170909_length_298_cov_5.859296	167	238	32	11	71	0.1549296
NODE_170909_length_298_cov_5.859296	167	238	34	40	71	0.5633803
NODE_170909_length_298_cov_5.859296	167	238	36	5	71	0.0704225
NODE_170964_length_298_cov_3.829146	80	160	50	2	80	0.0250000
NODE_170964_length_298_cov_3.829146	80	160	51	5	80	0.0625000
NODE_170964_length_298_cov_3.829146	80	160	52	2	80	0.0250000
NODE_170964_length_298_cov_3.829146	80	160	54	6	80	0.0750000
NODE_170964_length_298_cov_3.829146	80	160	55	4	80	0.0500000
NODE_170964_length_298_cov_3.829146	80	160	56	6	80	0.0750000
NODE_170964_length_298_cov_3.829146	80	160	57	6	80	0.0750000
NODE_170964_length_298_cov_3.829146	80	160	58	10	80	0.1250000
NODE_170964_length_298_cov_3.829146	80	160	60	13	80	0.1625000
NODE_170964_length_298_cov_3.829146	80	160	62	3	80	0.0375000
NODE_170964_length_298_cov_3.829146	80	160	64	8	80	0.1000000
NODE_170964_length_298_cov_3.829146	80	160	65	3	80	0.0375000
NODE_170964_length_298_cov_3.829146	80	160	66	3	80	0.0375000
NODE_170964_length_298_cov_3.829146	80	160	67	1	80	0.0125000
NODE_170964_length_298_cov_3.829146	80	160	68	6	80	0.0750000
NODE_170964_length_298_cov_3.829146	80	160	70	2	80	0.0250000
NODE_170964_length_298_cov_3.829146	133	213	20	8	80	0.1000000
NODE_170964_length_298_cov_3.829146	133	213	24	3	80	0.0375000
NODE_170964_length_298_cov_3.829146	133	213	26	1	80	0.0125000
NODE_170964_length_298_cov_3.829146	133	213	30	3	80	0.0375000
NODE_170964_length_298_cov_3.829146	133	213	31	3	80	0.0375000
NODE_170964_length_298_cov_3.829146	133	213	33	3	80	0.0375000
NODE_170964_length_298_cov_3.829146	133	213	37	1	80	0.0125000
NODE_170964_length_298_cov_3.829146	133	213	39	1	80	0.0125000
NODE_170964_length_298_cov_3.829146	133	213	41	1	80	0.0125000
NODE_170964_length_298_cov_3.829146	133	213	42	2	80	0.0250000
NODE_170964_length_298_cov_3.829146	133	213	44	4	80	0.0500000
NODE_170964_length_298_cov_3.829146	133	213	46	4	80	0.0500000
NODE_170964_length_298_cov_3.829146	133	213	48	2	80	0.0250000
NODE_170964_length_298_cov_3.829146	133	213	50	9	80	0.1125000
NODE_170964_length_298_cov_3.829146	133	213	51	5	80	0.0625000
NODE_170964_length_298_cov_3.829146	133	213	52	6	80	0.0750000
NODE_170964_length_298_cov_3.829146	133	213	54	10	80	0.1250000
NODE_170964_length_298_cov_3.829146	133	213	55	5	80	0.0625000
NODE_170964_length_298_cov_3.829146	133	213	56	7	80	0.0875000
NODE_170964_length_298_cov_3.829146	133	213	57	2	80	0.0250000
NODE_170968_length_298_cov_3.733668	203	283	0	80	80	1.0000000
NODE_170972_length_298_cov_3.673367	117	175	2	26	58	0.4482759
NODE_170972_length_298_cov_3.673367	117	175	6	5	58	0.0862069
NODE_170972_length_298_cov_3.673367	117	175	8	27	58	0.4655173
NODE_171043_length_298_cov_2.924623	159	239	0	20	80	0.2500000
NODE_171043_length_298_cov_2.924623	159	239	4	47	80	0.5875000
NODE_171043_length_298_cov_2.924623	159	239	6	6	80	0.0750000
NODE_171043_length_298_cov_2.924623	159	239	8	2	80	0.0250000
NODE_171043_length_298_cov_2.924623	159	239	11	2	80	0.0250000
NODE_171043_length_298_cov_2.924623	159	239	13	3	80	0.0375000
NODE_171043_length_298_cov_2.924623	212	265	0	46	53	0.8679245
NODE_171043_length_298_cov_2.924623	212	265	4	7	53	0.1320755
NODE_171047_length_298_cov_2.854271	50	120	0	70	70	1.0000000
NODE_171082_length_298_cov_2.663317	87	167	0	33	80	0.4125000
NODE_171082_length_298_cov_2.663317	87	167	2	47	80	0.5875000
NODE_171082_length_298_cov_2.663317	140	192	0	52	52	1.0000000
NODE_171191_length_298_cov_2.201005	112	166	0	54	54	1.0000000
NODE_171210_length_298_cov_2.120603	135	166	0	31	31	1.0000000
NODE_171226_length_298_cov_2.055276	69	132	0	30	63	0.4761905
NODE_171226_length_298_cov_2.055276	69	132	2	33	63	0.5238096
NODE_171286_length_298_cov_2.025126	21	92	0	68	71	0.9577465
NODE_171286_length_298_cov_2.025126	21	92	2	3	71	0.0422535
NODE_171356_length_298_cov_1.798995	0	67	0	2	67	0.0298507
NODE_171356_length_298_cov_1.798995	0	67	2	6	67	0.0895522
NODE_171356_length_298_cov_1.798995	0	67	4	23	67	0.3432836
NODE_171356_length_298_cov_1.798995	0	67	6	3	67	0.0447761
NODE_171356_length_298_cov_1.798995	0	67	9	24	67	0.3582090
NODE_171356_length_298_cov_1.798995	0	67	11	9	67	0.1343284
NODE_171356_length_298_cov_1.798995	40	106	2	1	66	0.0151515
NODE_171356_length_298_cov_1.798995	40	106	6	3	66	0.0454545
NODE_171356_length_298_cov_1.798995	40	106	8	3	66	0.0454545
NODE_171356_length_298_cov_1.798995	40	106	9	18	66	0.2727273
NODE_171356_length_298_cov_1.798995	40	106	10	7	66	0.1060606
NODE_171356_length_298_cov_1.798995	40	106	11	16	66	0.2424242
NODE_171356_length_298_cov_1.798995	40	106	12	18	66	0.2727273
NODE_171391_length_298_cov_1.788945	140	197	0	4	57	0.0701754
NODE_171391_length_298_cov_1.788945	140	197	2	53	57	0.9298246
NODE_171415_length_298_cov_1.733668	56	91	8	5	35	0.1428571
NODE_171415_length_298_cov_1.733668	56	91	10	19	35	0.5428572
NODE_171415_length_298_cov_1.733668	56	91	12	11	35	0.3142857
NODE_171415_length_298_cov_1.733668	118	172	0	2	54	0.0370370
NODE_171415_length_298_cov_1.733668	118	172	2	6	54	0.1111111
NODE_171415_length_298_cov_1.733668	118	172	4	7	54	0.1296296
NODE_171415_length_298_cov_1.733668	118	172	6	3	54	0.0555556
NODE_171415_length_298_cov_1.733668	118	172	8	11	54	0.2037037
NODE_171415_length_298_cov_1.733668	118	172	10	25	54	0.4629630
NODE_171505_length_298_cov_1.537688	101	154	8	2	53	0.0377358
NODE_171505_length_298_cov_1.537688	101	154	10	51	53	0.9622642
NODE_172083_length_298_cov_0.829146	34	96	0	62	62	1.0000000
NODE_172330_length_297_cov_6.525253	100	122	14	10	22	0.4545455
NODE_172330_length_297_cov_6.525253	100	122	15	12	22	0.5454546
NODE_172352_length_297_cov_4.888889	150	218	0	3	68	0.0441176
NODE_172352_length_297_cov_4.888889	150	218	2	2	68	0.0294118
NODE_172352_length_297_cov_4.888889	150	218	4	8	68	0.1176471
NODE_172352_length_297_cov_4.888889	150	218	5	4	68	0.0588235
NODE_172352_length_297_cov_4.888889	150	218	8	51	68	0.7500000
NODE_172356_length_297_cov_4.671717	56	120	0	64	64	1.0000000
NODE_172422_length_297_cov_3.338384	96	176	0	9	80	0.1125000
NODE_172422_length_297_cov_3.338384	96	176	2	8	80	0.1000000
NODE_172422_length_297_cov_3.338384	96	176	5	3	80	0.0375000
NODE_172422_length_297_cov_3.338384	96	176	6	6	80	0.0750000
NODE_172422_length_297_cov_3.338384	96	176	8	17	80	0.2125000
NODE_172422_length_297_cov_3.338384	96	176	9	37	80	0.4625000
NODE_172422_length_297_cov_3.338384	149	198	0	31	49	0.6326531
NODE_172422_length_297_cov_3.338384	149	198	2	8	49	0.1632653
NODE_172422_length_297_cov_3.338384	149	198	5	3	49	0.0612245
NODE_172422_length_297_cov_3.338384	149	198	6	6	49	0.1224490
NODE_172422_length_297_cov_3.338384	149	198	9	1	49	0.0204082
NODE_172447_length_297_cov_3.040404	0	55	0	55	55	1.0000000
NODE_172447_length_297_cov_3.040404	14	55	0	41	41	1.0000000
NODE_172447_length_297_cov_3.040404	65	119	0	54	54	1.0000000
NODE_172574_length_297_cov_2.308081	8	70	1	62	62	1.0000000
NODE_172606_length_297_cov_2.196970	219	259	70	1	40	0.0250000
NODE_172606_length_297_cov_2.196970	219	259	76	4	40	0.1000000
NODE_172606_length_297_cov_2.196970	219	259	78	2	40	0.0500000
NODE_172606_length_297_cov_2.196970	219	259	82	1	40	0.0250000
NODE_172606_length_297_cov_2.196970	219	259	84	1	40	0.0250000
NODE_172606_length_297_cov_2.196970	219	259	88	2	40	0.0500000
NODE_172606_length_297_cov_2.196970	219	259	90	1	40	0.0250000
NODE_172606_length_297_cov_2.196970	219	259	94	1	40	0.0250000
NODE_172606_length_297_cov_2.196970	219	259	98	1	40	0.0250000
NODE_172606_length_297_cov_2.196970	219	259	100	3	40	0.0750000
NODE_172606_length_297_cov_2.196970	219	259	104	1	40	0.0250000
NODE_172606_length_297_cov_2.196970	219	259	106	1	40	0.0250000
NODE_172606_length_297_cov_2.196970	219	259	114	1	40	0.0250000
NODE_172606_length_297_cov_2.196970	219	259	124	1	40	0.0250000
NODE_172606_length_297_cov_2.196970	219	259	130	1	40	0.0250000
NODE_172606_length_297_cov_2.196970	219	259	132	1	40	0.0250000
NODE_172606_length_297_cov_2.196970	219	259	136	1	40	0.0250000
NODE_172606_length_297_cov_2.196970	219	259	144	2	40	0.0500000
NODE_172606_length_297_cov_2.196970	219	259	150	1	40	0.0250000
NODE_172606_length_297_cov_2.196970	219	259	154	2	40	0.0500000
NODE_172606_length_297_cov_2.196970	219	259	156	11	40	0.2750000
NODE_172629_length_297_cov_2.106061	81	161	2	4	80	0.0500000
NODE_172629_length_297_cov_2.106061	81	161	4	44	80	0.5500000
NODE_172629_length_297_cov_2.106061	81	161	6	32	80	0.4000000
NODE_172629_length_297_cov_2.106061	134	178	4	20	44	0.4545455
NODE_172629_length_297_cov_2.106061	134	178	6	24	44	0.5454546
NODE_172668_length_297_cov_2.060606	46	76	2	30	30	1.0000000
NODE_172697_length_297_cov_2.010101	9	85	2	7	76	0.0921053
NODE_172697_length_297_cov_2.010101	9	85	4	1	76	0.0131579
NODE_172697_length_297_cov_2.010101	9	85	6	21	76	0.2763158
NODE_172697_length_297_cov_2.010101	9	85	8	47	76	0.6184211
NODE_172783_length_297_cov_1.777778	168	208	4	2	40	0.0500000
NODE_172783_length_297_cov_1.777778	168	208	6	1	40	0.0250000
NODE_172783_length_297_cov_1.777778	168	208	8	4	40	0.1000000
NODE_172783_length_297_cov_1.777778	168	208	10	29	40	0.7250000
NODE_172783_length_297_cov_1.777778	168	208	12	4	40	0.1000000
NODE_172855_length_297_cov_1.595960	175	255	2	4	80	0.0500000
NODE_172855_length_297_cov_1.595960	175	255	4	13	80	0.1625000
NODE_172855_length_297_cov_1.595960	175	255	6	4	80	0.0500000
NODE_172855_length_297_cov_1.595960	175	255	8	1	80	0.0125000
NODE_172855_length_297_cov_1.595960	175	255	10	4	80	0.0500000
NODE_172855_length_297_cov_1.595960	175	255	12	15	80	0.1875000
NODE_172855_length_297_cov_1.595960	175	255	14	4	80	0.0500000
NODE_172855_length_297_cov_1.595960	175	255	18	18	80	0.2250000
NODE_172855_length_297_cov_1.595960	175	255	20	7	80	0.0875000
NODE_172855_length_297_cov_1.595960	175	255	22	10	80	0.1250000
NODE_172862_length_297_cov_1.570707	100	177	0	77	77	1.0000000
NODE_172863_length_297_cov_1.570707	194	275	0	81	81	1.0000000
NODE_173063_length_297_cov_1.338384	140	199	0	59	59	1.0000000
NODE_173136_length_297_cov_1.277778	39	115	0	76	76	1.0000000
NODE_173176_length_297_cov_1.196970	7	87	0	80	80	1.0000000
NODE_173176_length_297_cov_1.196970	60	116	0	56	56	1.0000000
NODE_173345_length_297_cov_1.030303	0	33	0	33	33	1.0000000
NODE_173467_length_297_cov_0.888889	109	172	0	63	63	1.0000000
NODE_173520_length_297_cov_0.782828	24	104	1	6	80	0.0750000
NODE_173520_length_297_cov_0.782828	24	104	2	8	80	0.1000000
NODE_173520_length_297_cov_0.782828	24	104	3	66	80	0.8250000
NODE_173708_length_296_cov_41.390863	189	260	14	38	71	0.5352113
NODE_173708_length_296_cov_41.390863	189	260	16	8	71	0.1126761
NODE_173708_length_296_cov_41.390863	189	260	18	10	71	0.1408451
NODE_173708_length_296_cov_41.390863	189	260	19	9	71	0.1267606
NODE_173708_length_296_cov_41.390863	189	260	20	6	71	0.0845070
NODE_173709_length_296_cov_34.776650	214	294	0	80	80	1.0000000
NODE_173758_length_296_cov_4.243655	14	54	0	40	40	1.0000000
NODE_173773_length_296_cov_3.954315	120	200	0	80	80	1.0000000
NODE_173787_length_296_cov_3.736041	6	46	0	40	40	1.0000000
NODE_173797_length_296_cov_3.619289	193	251	2	1	58	0.0172414
NODE_173797_length_296_cov_3.619289	193	251	6	57	58	0.9827586
NODE_173797_length_296_cov_3.619289	246	296	0	28	50	0.5600000
NODE_173797_length_296_cov_3.619289	246	296	2	18	50	0.3600000
NODE_173797_length_296_cov_3.619289	246	296	6	4	50	0.0800000
NODE_173859_length_296_cov_3.015228	177	257	0	3	80	0.0375000
NODE_173859_length_296_cov_3.015228	177	257	2	77	80	0.9625000
NODE_173992_length_296_cov_2.309645	5	77	3	5	72	0.0694444
NODE_173992_length_296_cov_2.309645	5	77	4	4	72	0.0555556
NODE_173992_length_296_cov_2.309645	5	77	6	2	72	0.0277778
NODE_173992_length_296_cov_2.309645	5	77	8	11	72	0.1527778
NODE_173992_length_296_cov_2.309645	5	77	10	2	72	0.0277778
NODE_173992_length_296_cov_2.309645	5	77	14	1	72	0.0138889
NODE_173992_length_296_cov_2.309645	5	77	16	3	72	0.0416667
NODE_173992_length_296_cov_2.309645	5	77	18	1	72	0.0138889
NODE_173992_length_296_cov_2.309645	5	77	20	11	72	0.1527778
NODE_173992_length_296_cov_2.309645	5	77	26	10	72	0.1388889
NODE_173992_length_296_cov_2.309645	5	77	28	8	72	0.1111111
NODE_173992_length_296_cov_2.309645	5	77	32	14	72	0.1944444
NODE_173992_length_296_cov_2.309645	50	130	26	5	80	0.0625000
NODE_173992_length_296_cov_2.309645	50	130	28	8	80	0.1000000
NODE_173992_length_296_cov_2.309645	50	130	30	1	80	0.0125000
NODE_173992_length_296_cov_2.309645	50	130	32	36	80	0.4500000
NODE_173992_length_296_cov_2.309645	50	130	34	25	80	0.3125000
NODE_173992_length_296_cov_2.309645	50	130	36	5	80	0.0625000
NODE_174040_length_296_cov_2.081218	90	139	0	49	49	1.0000000
NODE_174167_length_296_cov_1.807107	199	246	0	47	47	1.0000000
NODE_174167_length_296_cov_1.807107	219	296	0	77	77	1.0000000
NODE_174213_length_296_cov_1.670051	28	103	4	49	75	0.6533333
NODE_174213_length_296_cov_1.670051	28	103	6	26	75	0.3466667
NODE_174274_length_296_cov_1.553299	102	179	2	56	77	0.7272727
NODE_174274_length_296_cov_1.553299	102	179	4	21	77	0.2727273
NODE_174274_length_296_cov_1.553299	160	179	2	17	19	0.8947368
NODE_174274_length_296_cov_1.553299	160	179	4	2	19	0.1052632
NODE_174438_length_296_cov_1.319797	82	162	3	1	80	0.0125000
NODE_174438_length_296_cov_1.319797	82	162	6	5	80	0.0625000
NODE_174438_length_296_cov_1.319797	82	162	7	20	80	0.2500000
NODE_174438_length_296_cov_1.319797	82	162	8	15	80	0.1875000
NODE_174438_length_296_cov_1.319797	82	162	9	39	80	0.4875000
NODE_174438_length_296_cov_1.319797	135	205	2	17	70	0.2428571
NODE_174438_length_296_cov_1.319797	135	205	4	4	70	0.0571429
NODE_174438_length_296_cov_1.319797	135	205	6	7	70	0.1000000
NODE_174438_length_296_cov_1.319797	135	205	8	34	70	0.4857143
NODE_174438_length_296_cov_1.319797	135	205	9	8	70	0.1142857
NODE_174545_length_296_cov_1.258883	222	280	0	58	58	1.0000000
NODE_174554_length_296_cov_1.238579	90	147	4	57	57	1.0000000
NODE_174614_length_296_cov_1.116751	130	169	0	10	39	0.2564103
NODE_174614_length_296_cov_1.116751	130	169	2	2	39	0.0512821
NODE_174614_length_296_cov_1.116751	130	169	4	4	39	0.1025641
NODE_174614_length_296_cov_1.116751	130	169	6	14	39	0.3589744
NODE_174614_length_296_cov_1.116751	130	169	8	5	39	0.1282051
NODE_174614_length_296_cov_1.116751	130	169	10	4	39	0.1025641
NODE_175210_length_295_cov_4.290816	2	70	2	8	68	0.1176471
NODE_175210_length_295_cov_4.290816	2	70	4	60	68	0.8823529
NODE_175210_length_295_cov_4.290816	55	123	0	4	68	0.0588235
NODE_175210_length_295_cov_4.290816	55	123	2	32	68	0.4705882
NODE_175210_length_295_cov_4.290816	55	123	4	32	68	0.4705882
NODE_175220_length_295_cov_4.040816	119	165	2	10	46	0.2173913
NODE_175220_length_295_cov_4.040816	119	165	4	36	46	0.7826087
NODE_175258_length_295_cov_3.576531	130	198	0	6	68	0.0882353
NODE_175258_length_295_cov_3.576531	130	198	2	62	68	0.9117647
NODE_175324_length_295_cov_2.918367	0	77	0	77	77	1.0000000
NODE_175416_length_295_cov_2.454082	216	277	5	4	61	0.0655738
NODE_175416_length_295_cov_2.454082	216	277	6	1	61	0.0163934
NODE_175416_length_295_cov_2.454082	216	277	8	56	61	0.9180328
NODE_175475_length_295_cov_2.224490	11	91	0	1	80	0.0125000
NODE_175475_length_295_cov_2.224490	11	91	2	8	80	0.1000000
NODE_175475_length_295_cov_2.224490	11	91	4	71	80	0.8875000
NODE_175483_length_295_cov_2.183673	93	151	4	1	58	0.0172414
NODE_175483_length_295_cov_2.183673	93	151	7	1	58	0.0172414
NODE_175483_length_295_cov_2.183673	93	151	9	2	58	0.0344828
NODE_175483_length_295_cov_2.183673	93	151	13	5	58	0.0862069
NODE_175483_length_295_cov_2.183673	93	151	16	2	58	0.0344828
NODE_175483_length_295_cov_2.183673	93	151	17	3	58	0.0517241
NODE_175483_length_295_cov_2.183673	93	151	21	5	58	0.0862069
NODE_175483_length_295_cov_2.183673	93	151	28	1	58	0.0172414
NODE_175483_length_295_cov_2.183673	93	151	30	1	58	0.0172414
NODE_175483_length_295_cov_2.183673	93	151	36	3	58	0.0517241
NODE_175483_length_295_cov_2.183673	93	151	37	1	58	0.0172414
NODE_175483_length_295_cov_2.183673	93	151	38	22	58	0.3793103
NODE_175483_length_295_cov_2.183673	93	151	39	6	58	0.1034483
NODE_175483_length_295_cov_2.183673	93	151	40	5	58	0.0862069
NODE_175483_length_295_cov_2.183673	124	204	36	20	80	0.2500000
NODE_175483_length_295_cov_2.183673	124	204	38	36	80	0.4500000
NODE_175483_length_295_cov_2.183673	124	204	39	6	80	0.0750000
NODE_175483_length_295_cov_2.183673	124	204	40	18	80	0.2250000
NODE_175597_length_295_cov_1.867347	191	239	0	1	48	0.0208333
NODE_175597_length_295_cov_1.867347	191	239	2	47	48	0.9791667
NODE_175598_length_295_cov_1.862245	225	285	2	60	60	1.0000000
NODE_175721_length_295_cov_1.596939	173	254	2	25	81	0.3086420
NODE_175721_length_295_cov_1.596939	173	254	4	8	81	0.0987654
NODE_175721_length_295_cov_1.596939	173	254	6	42	81	0.5185185
NODE_175721_length_295_cov_1.596939	173	254	8	6	81	0.0740741
NODE_175804_length_295_cov_1.520408	217	282	0	16	65	0.2461538
NODE_175804_length_295_cov_1.520408	217	282	2	15	65	0.2307692
NODE_175804_length_295_cov_1.520408	217	282	4	34	65	0.5230770
NODE_175930_length_295_cov_1.301020	99	121	0	22	22	1.0000000
NODE_176250_length_295_cov_0.938776	200	247	0	4	47	0.0851064
NODE_176250_length_295_cov_0.938776	200	247	2	43	47	0.9148936
NODE_176367_length_295_cov_0.780612	24	44	0	20	20	1.0000000
NODE_176436_length_295_cov_0.724490	6	87	0	81	81	1.0000000
NODE_176436_length_295_cov_0.724490	83	163	0	80	80	1.0000000
NODE_176436_length_295_cov_0.724490	136	216	0	66	80	0.8250000
NODE_176436_length_295_cov_0.724490	136	216	2	14	80	0.1750000
NODE_176547_length_294_cov_83.882051	143	173	0	30	30	1.0000000
NODE_176547_length_294_cov_83.882051	209	239	0	30	30	1.0000000
NODE_176549_length_294_cov_50.589744	187	258	20	1	71	0.0140845
NODE_176549_length_294_cov_50.589744	187	258	22	5	71	0.0704225
NODE_176549_length_294_cov_50.589744	187	258	24	3	71	0.0422535
NODE_176549_length_294_cov_50.589744	187	258	26	3	71	0.0422535
NODE_176549_length_294_cov_50.589744	187	258	28	3	71	0.0422535
NODE_176549_length_294_cov_50.589744	187	258	41	1	71	0.0140845
NODE_176549_length_294_cov_50.589744	187	258	42	1	71	0.0140845
NODE_176549_length_294_cov_50.589744	187	258	44	2	71	0.0281690
NODE_176549_length_294_cov_50.589744	187	258	46	1	71	0.0140845
NODE_176549_length_294_cov_50.589744	187	258	48	1	71	0.0140845
NODE_176549_length_294_cov_50.589744	187	258	59	1	71	0.0140845
NODE_176549_length_294_cov_50.589744	187	258	61	1	71	0.0140845
NODE_176549_length_294_cov_50.589744	187	258	63	4	71	0.0563380
NODE_176549_length_294_cov_50.589744	187	258	68	2	71	0.0281690
NODE_176549_length_294_cov_50.589744	187	258	70	3	71	0.0422535
NODE_176549_length_294_cov_50.589744	187	258	73	2	71	0.0281690
NODE_176549_length_294_cov_50.589744	187	258	75	1	71	0.0140845
NODE_176549_length_294_cov_50.589744	187	258	77	1	71	0.0140845
NODE_176549_length_294_cov_50.589744	187	258	79	1	71	0.0140845
NODE_176549_length_294_cov_50.589744	187	258	81	4	71	0.0563380
NODE_176549_length_294_cov_50.589744	187	258	87	1	71	0.0140845
NODE_176549_length_294_cov_50.589744	187	258	94	2	71	0.0281690
NODE_176549_length_294_cov_50.589744	187	258	96	1	71	0.0140845
NODE_176549_length_294_cov_50.589744	187	258	100	1	71	0.0140845
NODE_176549_length_294_cov_50.589744	187	258	102	1	71	0.0140845
NODE_176549_length_294_cov_50.589744	187	258	104	1	71	0.0140845
NODE_176549_length_294_cov_50.589744	187	258	108	2	71	0.0281690
NODE_176549_length_294_cov_50.589744	187	258	114	6	71	0.0845070
NODE_176549_length_294_cov_50.589744	187	258	116	2	71	0.0281690
NODE_176549_length_294_cov_50.589744	187	258	118	2	71	0.0281690
NODE_176549_length_294_cov_50.589744	187	258	120	1	71	0.0140845
NODE_176549_length_294_cov_50.589744	187	258	122	2	71	0.0281690
NODE_176549_length_294_cov_50.589744	187	258	124	1	71	0.0140845
NODE_176549_length_294_cov_50.589744	187	258	126	1	71	0.0140845
NODE_176549_length_294_cov_50.589744	187	258	128	2	71	0.0281690
NODE_176549_length_294_cov_50.589744	187	258	130	4	71	0.0563380
NODE_176561_length_294_cov_6.676923	61	138	0	77	77	1.0000000
NODE_176596_length_294_cov_4.538462	127	214	4	3	87	0.0344828
NODE_176596_length_294_cov_4.538462	127	214	7	4	87	0.0459770
NODE_176596_length_294_cov_4.538462	127	214	9	4	87	0.0459770
NODE_176596_length_294_cov_4.538462	127	214	10	2	87	0.0229885
NODE_176596_length_294_cov_4.538462	127	214	11	14	87	0.1609195
NODE_176596_length_294_cov_4.538462	127	214	12	2	87	0.0229885
NODE_176596_length_294_cov_4.538462	127	214	13	2	87	0.0229885
NODE_176596_length_294_cov_4.538462	127	214	14	13	87	0.1494253
NODE_176596_length_294_cov_4.538462	127	214	15	11	87	0.1264368
NODE_176596_length_294_cov_4.538462	127	214	16	32	87	0.3678161
NODE_176598_length_294_cov_4.512821	218	248	0	30	30	1.0000000
NODE_176600_length_294_cov_4.497436	159	200	0	41	41	1.0000000
NODE_176697_length_294_cov_2.953846	114	194	2	24	80	0.3000000
NODE_176697_length_294_cov_2.953846	114	194	4	10	80	0.1250000
NODE_176697_length_294_cov_2.953846	114	194	6	27	80	0.3375000
NODE_176697_length_294_cov_2.953846	114	194	8	19	80	0.2375000
NODE_176727_length_294_cov_2.764103	103	183	2	16	80	0.2000000
NODE_176727_length_294_cov_2.764103	103	183	8	1	80	0.0125000
NODE_176727_length_294_cov_2.764103	103	183	9	11	80	0.1375000
NODE_176727_length_294_cov_2.764103	103	183	11	22	80	0.2750000
NODE_176727_length_294_cov_2.764103	103	183	18	20	80	0.2500000
NODE_176727_length_294_cov_2.764103	103	183	20	10	80	0.1250000
NODE_176727_length_294_cov_2.764103	156	236	18	23	80	0.2875000
NODE_176727_length_294_cov_2.764103	156	236	20	19	80	0.2375000
NODE_176727_length_294_cov_2.764103	156	236	22	38	80	0.4750000
NODE_176728_length_294_cov_2.764103	224	282	0	54	58	0.9310345
NODE_176728_length_294_cov_2.764103	224	282	1	4	58	0.0689655
NODE_176728_length_294_cov_2.764103	225	277	0	49	52	0.9423077
NODE_176728_length_294_cov_2.764103	225	277	1	3	52	0.0576923
NODE_176735_length_294_cov_2.697436	204	261	0	57	57	1.0000000
NODE_176735_length_294_cov_2.697436	234	294	0	60	60	1.0000000
NODE_176779_length_294_cov_2.517949	23	85	14	1	62	0.0161290
NODE_176779_length_294_cov_2.517949	23	85	16	19	62	0.3064516
NODE_176779_length_294_cov_2.517949	23	85	18	42	62	0.6774194
NODE_176816_length_294_cov_2.353846	129	167	0	38	38	1.0000000
NODE_176833_length_294_cov_2.338462	133	213	8	3	80	0.0375000
NODE_176833_length_294_cov_2.338462	133	213	10	8	80	0.1000000
NODE_176833_length_294_cov_2.338462	133	213	11	1	80	0.0125000
NODE_176833_length_294_cov_2.338462	133	213	12	25	80	0.3125000
NODE_176833_length_294_cov_2.338462	133	213	15	6	80	0.0750000
NODE_176833_length_294_cov_2.338462	133	213	16	37	80	0.4625000
NODE_176943_length_294_cov_2.046154	219	269	0	50	50	1.0000000
NODE_176957_length_294_cov_2.010256	191	235	0	14	44	0.3181818
NODE_176957_length_294_cov_2.010256	191	235	2	28	44	0.6363636
NODE_176957_length_294_cov_2.010256	191	235	4	2	44	0.0454545
NODE_176999_length_294_cov_1.902564	52	83	4	17	31	0.5483871
NODE_176999_length_294_cov_1.902564	52	83	6	14	31	0.4516129
NODE_177102_length_294_cov_1.692308	46	112	2	46	66	0.6969697
NODE_177102_length_294_cov_1.692308	46	112	4	20	66	0.3030303
NODE_177187_length_294_cov_1.569231	49	95	0	46	46	1.0000000
NODE_177252_length_294_cov_1.482051	28	108	4	80	80	1.0000000
NODE_177252_length_294_cov_1.482051	201	281	0	15	80	0.1875000
NODE_177252_length_294_cov_1.482051	201	281	2	65	80	0.8125000
NODE_177252_length_294_cov_1.482051	201	281	0	15	80	0.1875000
NODE_177252_length_294_cov_1.482051	201	281	2	65	80	0.8125000
NODE_177298_length_294_cov_1.420513	216	262	0	46	46	1.0000000
NODE_177298_length_294_cov_1.420513	235	294	0	59	59	1.0000000
NODE_177972_length_294_cov_0.666667	245	293	0	48	48	1.0000000
NODE_178066_length_293_cov_6.257732	167	247	0	2	80	0.0250000
NODE_178066_length_293_cov_6.257732	167	247	2	6	80	0.0750000
NODE_178066_length_293_cov_6.257732	167	247	4	72	80	0.9000000
NODE_178161_length_293_cov_3.567010	50	130	0	40	80	0.5000000
NODE_178161_length_293_cov_3.567010	50	130	2	40	80	0.5000000
NODE_178226_length_293_cov_2.907216	218	281	2	63	63	1.0000000
NODE_178246_length_293_cov_2.768041	95	175	0	46	80	0.5750000
NODE_178246_length_293_cov_2.768041	95	175	2	8	80	0.1000000
NODE_178246_length_293_cov_2.768041	95	175	4	26	80	0.3250000
NODE_178246_length_293_cov_2.768041	148	228	2	1	80	0.0125000
NODE_178246_length_293_cov_2.768041	148	228	4	79	80	0.9875000
NODE_178268_length_293_cov_2.628866	207	266	5	14	59	0.2372881
NODE_178268_length_293_cov_2.628866	207	266	7	25	59	0.4237288
NODE_178268_length_293_cov_2.628866	207	266	9	5	59	0.0847458
NODE_178268_length_293_cov_2.628866	207	266	11	2	59	0.0338983
NODE_178268_length_293_cov_2.628866	207	266	13	9	59	0.1525424
NODE_178268_length_293_cov_2.628866	207	266	14	4	59	0.0677966
NODE_178277_length_293_cov_2.623711	182	223	0	41	41	1.0000000
NODE_178299_length_293_cov_2.561856	139	192	0	37	53	0.6981132
NODE_178299_length_293_cov_2.561856	139	192	2	4	53	0.0754717
NODE_178299_length_293_cov_2.561856	139	192	4	12	53	0.2264151
NODE_178299_length_293_cov_2.561856	177	223	2	3	46	0.0652174
NODE_178299_length_293_cov_2.561856	177	223	4	43	46	0.9347826
NODE_178317_length_293_cov_2.448454	98	158	0	4	60	0.0666667
NODE_178317_length_293_cov_2.448454	98	158	2	56	60	0.9333333
NODE_178351_length_293_cov_2.335052	62	91	0	15	29	0.5172414
NODE_178351_length_293_cov_2.335052	62	91	2	14	29	0.4827586
NODE_178357_length_293_cov_2.314433	35	89	0	13	54	0.2407407
NODE_178357_length_293_cov_2.314433	35	89	1	1	54	0.0185185
NODE_178357_length_293_cov_2.314433	35	89	2	40	54	0.7407407
NODE_178523_length_293_cov_1.840206	27	107	0	73	80	0.9125000
NODE_178523_length_293_cov_1.840206	27	107	2	2	80	0.0250000
NODE_178523_length_293_cov_1.840206	27	107	4	5	80	0.0625000
NODE_178523_length_293_cov_1.840206	80	160	0	20	80	0.2500000
NODE_178523_length_293_cov_1.840206	80	160	2	2	80	0.0250000
NODE_178523_length_293_cov_1.840206	80	160	4	58	80	0.7250000
NODE_178560_length_293_cov_1.804124	144	173	10	4	29	0.1379310
NODE_178560_length_293_cov_1.804124	144	173	12	1	29	0.0344828
NODE_178560_length_293_cov_1.804124	144	173	14	3	29	0.1034483
NODE_178560_length_293_cov_1.804124	144	173	16	5	29	0.1724138
NODE_178560_length_293_cov_1.804124	144	173	18	16	29	0.5517241
NODE_178570_length_293_cov_1.778351	224	258	0	34	34	1.0000000
NODE_178646_length_293_cov_1.577320	158	177	0	19	19	1.0000000
NODE_178692_length_293_cov_1.577320	161	225	2	64	64	1.0000000
NODE_178693_length_293_cov_1.577320	15	55	0	40	40	1.0000000
NODE_178788_length_293_cov_1.402062	3	72	0	3	69	0.0434783
NODE_178788_length_293_cov_1.402062	3	72	2	66	69	0.9565217
NODE_178822_length_293_cov_1.319588	202	268	2	1	66	0.0151515
NODE_178822_length_293_cov_1.319588	202	268	4	33	66	0.5000000
NODE_178822_length_293_cov_1.319588	202	268	6	32	66	0.4848485
NODE_178927_length_293_cov_1.226804	84	141	0	57	57	1.0000000
NODE_179542_length_292_cov_4.523316	240	290	0	50	50	1.0000000
NODE_179552_length_292_cov_4.145078	106	186	2	11	80	0.1375000
NODE_179552_length_292_cov_4.145078	106	186	4	69	80	0.8625000
NODE_179604_length_292_cov_3.502591	129	205	6	8	76	0.1052632
NODE_179604_length_292_cov_3.502591	129	205	8	3	76	0.0394737
NODE_179604_length_292_cov_3.502591	129	205	10	6	76	0.0789474
NODE_179604_length_292_cov_3.502591	129	205	12	9	76	0.1184211
NODE_179604_length_292_cov_3.502591	129	205	14	10	76	0.1315790
NODE_179604_length_292_cov_3.502591	129	205	16	40	76	0.5263158
NODE_179613_length_292_cov_3.435233	176	200	0	24	24	1.0000000
NODE_179621_length_292_cov_3.341969	70	150	6	2	80	0.0250000
NODE_179621_length_292_cov_3.341969	70	150	8	22	80	0.2750000
NODE_179621_length_292_cov_3.341969	70	150	10	41	80	0.5125000
NODE_179621_length_292_cov_3.341969	70	150	12	15	80	0.1875000
NODE_179621_length_292_cov_3.341969	118	175	6	19	57	0.3333333
NODE_179621_length_292_cov_3.341969	118	175	8	28	57	0.4912281
NODE_179621_length_292_cov_3.341969	118	175	10	10	57	0.1754386
NODE_179627_length_292_cov_3.222798	47	127	0	80	80	1.0000000
NODE_179627_length_292_cov_3.222798	100	129	0	29	29	1.0000000
NODE_179819_length_292_cov_2.238342	211	290	0	79	79	1.0000000
NODE_179943_length_292_cov_1.865285	34	114	31	3	80	0.0375000
NODE_179943_length_292_cov_1.865285	34	114	37	2	80	0.0250000
NODE_179943_length_292_cov_1.865285	34	114	40	10	80	0.1250000
NODE_179943_length_292_cov_1.865285	34	114	41	44	80	0.5500000
NODE_179943_length_292_cov_1.865285	34	114	42	7	80	0.0875000
NODE_179943_length_292_cov_1.865285	34	114	43	14	80	0.1750000
NODE_179943_length_292_cov_1.865285	87	167	8	12	80	0.1500000
NODE_179943_length_292_cov_1.865285	87	167	10	4	80	0.0500000
NODE_179943_length_292_cov_1.865285	87	167	11	2	80	0.0250000
NODE_179943_length_292_cov_1.865285	87	167	13	5	80	0.0625000
NODE_179943_length_292_cov_1.865285	87	167	14	3	80	0.0375000
NODE_179943_length_292_cov_1.865285	87	167	29	4	80	0.0500000
NODE_179943_length_292_cov_1.865285	87	167	31	26	80	0.3250000
NODE_179943_length_292_cov_1.865285	87	167	37	2	80	0.0250000
NODE_179943_length_292_cov_1.865285	87	167	41	9	80	0.1125000
NODE_179943_length_292_cov_1.865285	87	167	43	13	80	0.1625000
NODE_180013_length_292_cov_1.761658	174	254	0	80	80	1.0000000
NODE_180029_length_292_cov_1.699482	0	80	0	55	80	0.6875000
NODE_180029_length_292_cov_1.699482	0	80	4	3	80	0.0375000
NODE_180029_length_292_cov_1.699482	0	80	6	3	80	0.0375000
NODE_180029_length_292_cov_1.699482	0	80	10	1	80	0.0125000
NODE_180029_length_292_cov_1.699482	0	80	12	18	80	0.2250000
NODE_180068_length_292_cov_1.611399	89	157	0	16	68	0.2352941
NODE_180068_length_292_cov_1.611399	89	157	2	11	68	0.1617647
NODE_180068_length_292_cov_1.611399	89	157	4	41	68	0.6029412
NODE_180210_length_292_cov_1.455959	72	115	12	14	43	0.3255814
NODE_180210_length_292_cov_1.455959	72	115	14	2	43	0.0465116
NODE_180210_length_292_cov_1.455959	72	115	16	15	43	0.3488372
NODE_180210_length_292_cov_1.455959	72	115	17	5	43	0.1162791
NODE_180210_length_292_cov_1.455959	72	115	18	7	43	0.1627907
NODE_180210_length_292_cov_1.455959	203	265	2	62	62	1.0000000
NODE_180302_length_292_cov_1.321244	102	182	0	80	80	1.0000000
NODE_180302_length_292_cov_1.321244	155	217	0	62	62	1.0000000
NODE_180968_length_291_cov_45.031250	71	145	16	11	74	0.1486486
NODE_180968_length_291_cov_45.031250	71	145	20	13	74	0.1756757
NODE_180968_length_291_cov_45.031250	71	145	22	17	74	0.2297297
NODE_180968_length_291_cov_45.031250	71	145	24	26	74	0.3513514
NODE_180968_length_291_cov_45.031250	71	145	28	7	74	0.0945946
NODE_180968_length_291_cov_45.031250	71	145	16	11	74	0.1486486
NODE_180968_length_291_cov_45.031250	71	145	20	13	74	0.1756757
NODE_180968_length_291_cov_45.031250	71	145	22	17	74	0.2297297
NODE_180968_length_291_cov_45.031250	71	145	24	26	74	0.3513514
NODE_180968_length_291_cov_45.031250	71	145	28	7	74	0.0945946
NODE_180968_length_291_cov_45.031250	118	184	20	13	66	0.1969697
NODE_180968_length_291_cov_45.031250	118	184	22	23	66	0.3484848
NODE_180968_length_291_cov_45.031250	118	184	24	7	66	0.1060606
NODE_180968_length_291_cov_45.031250	118	184	26	3	66	0.0454545
NODE_180968_length_291_cov_45.031250	118	184	28	12	66	0.1818182
NODE_180968_length_291_cov_45.031250	118	184	29	1	66	0.0151515
NODE_180968_length_291_cov_45.031250	118	184	32	3	66	0.0454545
NODE_180968_length_291_cov_45.031250	118	184	34	4	66	0.0606061
NODE_180969_length_291_cov_14.791667	125	205	0	80	80	1.0000000
NODE_180969_length_291_cov_14.791667	178	258	0	80	80	1.0000000
NODE_180983_length_291_cov_5.536458	97	169	0	72	72	1.0000000
NODE_180986_length_291_cov_5.401042	77	130	0	53	53	1.0000000
NODE_180998_length_291_cov_4.859375	185	257	0	47	72	0.6527778
NODE_180998_length_291_cov_4.859375	185	257	2	25	72	0.3472222
NODE_181043_length_291_cov_3.723958	196	276	0	80	80	1.0000000
NODE_181057_length_291_cov_3.531250	129	152	0	9	23	0.3913043
NODE_181057_length_291_cov_3.531250	129	152	2	14	23	0.6086956
NODE_181191_length_291_cov_2.390625	18	80	0	62	62	1.0000000
NODE_181272_length_291_cov_2.125000	70	117	0	3	47	0.0638298
NODE_181272_length_291_cov_2.125000	70	117	2	44	47	0.9361702
NODE_181391_length_291_cov_1.859375	197	228	10	31	31	1.0000000
NODE_181497_length_291_cov_1.593750	144	175	2	31	31	1.0000000
NODE_181530_length_291_cov_1.593750	206	281	0	75	75	1.0000000
NODE_181599_length_291_cov_1.552083	189	269	1	42	80	0.5250000
NODE_181599_length_291_cov_1.552083	189	269	2	28	80	0.3500000
NODE_181599_length_291_cov_1.552083	189	269	3	10	80	0.1250000
NODE_181615_length_291_cov_1.520833	180	258	0	78	78	1.0000000
NODE_181623_length_291_cov_1.510417	245	291	0	46	46	1.0000000
NODE_181696_length_291_cov_1.385417	80	120	0	34	40	0.8500000
NODE_181696_length_291_cov_1.385417	80	120	4	6	40	0.1500000
NODE_181791_length_291_cov_1.322917	70	96	0	26	26	1.0000000
NODE_181799_length_291_cov_1.307292	108	188	0	28	80	0.3500000
NODE_181799_length_291_cov_1.307292	108	188	2	17	80	0.2125000
NODE_181799_length_291_cov_1.307292	108	188	4	4	80	0.0500000
NODE_181799_length_291_cov_1.307292	108	188	6	1	80	0.0125000
NODE_181799_length_291_cov_1.307292	108	188	8	1	80	0.0125000
NODE_181799_length_291_cov_1.307292	108	188	12	3	80	0.0375000
NODE_181799_length_291_cov_1.307292	108	188	14	1	80	0.0125000
NODE_181799_length_291_cov_1.307292	108	188	16	2	80	0.0250000
NODE_181799_length_291_cov_1.307292	108	188	18	7	80	0.0875000
NODE_181799_length_291_cov_1.307292	108	188	20	2	80	0.0250000
NODE_181799_length_291_cov_1.307292	108	188	24	4	80	0.0500000
NODE_181799_length_291_cov_1.307292	108	188	26	8	80	0.1000000
NODE_181799_length_291_cov_1.307292	108	188	28	2	80	0.0250000
NODE_181907_length_291_cov_1.114583	79	174	16	2	95	0.0210526
NODE_181907_length_291_cov_1.114583	79	174	18	6	95	0.0631579
NODE_181907_length_291_cov_1.114583	79	174	20	2	95	0.0210526
NODE_181907_length_291_cov_1.114583	79	174	24	1	95	0.0105263
NODE_181907_length_291_cov_1.114583	79	174	26	7	95	0.0736842
NODE_181907_length_291_cov_1.114583	79	174	28	1	95	0.0105263
NODE_181907_length_291_cov_1.114583	79	174	30	3	95	0.0315789
NODE_181907_length_291_cov_1.114583	79	174	32	9	95	0.0947368
NODE_181907_length_291_cov_1.114583	79	174	33	1	95	0.0105263
NODE_181907_length_291_cov_1.114583	79	174	34	6	95	0.0631579
NODE_181907_length_291_cov_1.114583	79	174	36	16	95	0.1684211
NODE_181907_length_291_cov_1.114583	79	174	38	41	95	0.4315789
NODE_181930_length_291_cov_1.078125	4	85	0	43	81	0.5308642
NODE_181930_length_291_cov_1.078125	4	85	4	3	81	0.0370370
NODE_181930_length_291_cov_1.078125	4	85	6	28	81	0.3456790
NODE_181930_length_291_cov_1.078125	4	85	8	7	81	0.0864198
NODE_182112_length_291_cov_1.031250	5	50	0	45	45	1.0000000
NODE_182205_length_291_cov_0.890625	0	55	0	55	55	1.0000000
NODE_182252_length_291_cov_0.802083	80	160	0	16	80	0.2000000
NODE_182252_length_291_cov_0.802083	80	160	2	16	80	0.2000000
NODE_182252_length_291_cov_0.802083	80	160	4	17	80	0.2125000
NODE_182252_length_291_cov_0.802083	80	160	6	4	80	0.0500000
NODE_182252_length_291_cov_0.802083	80	160	10	27	80	0.3375000
NODE_182491_length_290_cov_96.963351	44	124	0	16	80	0.2000000
NODE_182491_length_290_cov_96.963351	44	124	2	64	80	0.8000000
NODE_182491_length_290_cov_96.963351	97	177	0	22	80	0.2750000
NODE_182491_length_290_cov_96.963351	97	177	2	58	80	0.7250000
NODE_182512_length_290_cov_5.968586	89	150	4	61	61	1.0000000
NODE_182512_length_290_cov_5.968586	142	203	4	31	61	0.5081967
NODE_182512_length_290_cov_5.968586	142	203	6	30	61	0.4918033
NODE_182535_length_290_cov_4.968586	32	52	2	20	20	1.0000000
NODE_182535_length_290_cov_4.968586	73	93	0	11	20	0.5500000
NODE_182535_length_290_cov_4.968586	73	93	2	9	20	0.4500000
NODE_182547_length_290_cov_4.670157	63	139	2	76	76	1.0000000
NODE_182550_length_290_cov_4.575916	110	153	4	43	43	1.0000000
NODE_182589_length_290_cov_3.816754	113	186	0	63	73	0.8630137
NODE_182589_length_290_cov_3.816754	113	186	2	10	73	0.1369863
NODE_182607_length_290_cov_3.612565	114	181	0	8	67	0.1194030
NODE_182607_length_290_cov_3.612565	114	181	2	20	67	0.2985075
NODE_182607_length_290_cov_3.612565	114	181	4	39	67	0.5820895
NODE_182622_length_290_cov_3.445026	91	150	0	18	59	0.3050847
NODE_182622_length_290_cov_3.445026	91	150	2	19	59	0.3220339
NODE_182622_length_290_cov_3.445026	91	150	4	22	59	0.3728814
NODE_182772_length_290_cov_2.596859	189	218	0	29	29	1.0000000
NODE_182844_length_290_cov_2.319372	45	74	0	29	29	1.0000000
NODE_182973_length_290_cov_2.041885	59	139	2	5	80	0.0625000
NODE_182973_length_290_cov_2.041885	59	139	4	1	80	0.0125000
NODE_182973_length_290_cov_2.041885	59	139	6	11	80	0.1375000
NODE_182973_length_290_cov_2.041885	59	139	8	63	80	0.7875000
NODE_182995_length_290_cov_1.979058	229	271	18	5	42	0.1190476
NODE_182995_length_290_cov_1.979058	229	271	20	13	42	0.3095238
NODE_182995_length_290_cov_1.979058	229	271	21	1	42	0.0238095
NODE_182995_length_290_cov_1.979058	229	271	22	11	42	0.2619048
NODE_182995_length_290_cov_1.979058	229	271	24	12	42	0.2857143
NODE_183288_length_290_cov_1.602094	16	68	0	52	52	1.0000000
NODE_183347_length_290_cov_1.575916	173	250	0	77	77	1.0000000
NODE_183373_length_290_cov_1.544503	151	203	0	52	52	1.0000000
NODE_183403_length_290_cov_1.513089	22	107	0	24	85	0.2823530
NODE_183403_length_290_cov_1.513089	22	107	2	13	85	0.1529412
NODE_183403_length_290_cov_1.513089	22	107	4	48	85	0.5647059
NODE_183436_length_290_cov_1.460733	11	91	0	80	80	1.0000000
NODE_183546_length_290_cov_1.335079	91	163	2	21	72	0.2916667
NODE_183546_length_290_cov_1.335079	91	163	4	46	72	0.6388889
NODE_183546_length_290_cov_1.335079	91	163	6	5	72	0.0694444
NODE_183546_length_290_cov_1.335079	144	216	2	17	72	0.2361111
NODE_183546_length_290_cov_1.335079	144	216	4	55	72	0.7638889
NODE_183642_length_290_cov_1.314136	0	80	0	80	80	1.0000000
NODE_183663_length_290_cov_1.287958	17	97	0	80	80	1.0000000
NODE_183946_length_290_cov_1.068063	0	60	0	60	60	1.0000000
NODE_183946_length_290_cov_1.068063	33	113	0	80	80	1.0000000
NODE_184119_length_290_cov_1.000000	198	254	48	1	56	0.0178571
NODE_184119_length_290_cov_1.000000	198	254	57	2	56	0.0357143
NODE_184119_length_290_cov_1.000000	198	254	61	1	56	0.0178571
NODE_184119_length_290_cov_1.000000	198	254	63	3	56	0.0535714
NODE_184119_length_290_cov_1.000000	198	254	65	1	56	0.0178571
NODE_184119_length_290_cov_1.000000	198	254	66	11	56	0.1964286
NODE_184119_length_290_cov_1.000000	198	254	67	3	56	0.0535714
NODE_184119_length_290_cov_1.000000	198	254	69	1	56	0.0178571
NODE_184119_length_290_cov_1.000000	198	254	73	1	56	0.0178571
NODE_184119_length_290_cov_1.000000	198	254	77	2	56	0.0357143
NODE_184119_length_290_cov_1.000000	198	254	79	1	56	0.0178571
NODE_184119_length_290_cov_1.000000	198	254	81	2	56	0.0357143
NODE_184119_length_290_cov_1.000000	198	254	83	3	56	0.0535714
NODE_184119_length_290_cov_1.000000	198	254	85	5	56	0.0892857
NODE_184119_length_290_cov_1.000000	198	254	87	19	56	0.3392857
NODE_184326_length_290_cov_0.832461	154	236	0	82	82	1.0000000
NODE_184585_length_290_cov_0.701571	201	281	0	80	80	1.0000000
NODE_184716_length_289_cov_554.947368	45	125	228	1	80	0.0125000
NODE_184716_length_289_cov_554.947368	45	125	236	3	80	0.0375000
NODE_184716_length_289_cov_554.947368	45	125	252	1	80	0.0125000
NODE_184716_length_289_cov_554.947368	45	125	255	1	80	0.0125000
NODE_184716_length_289_cov_554.947368	45	125	257	1	80	0.0125000
NODE_184716_length_289_cov_554.947368	45	125	259	1	80	0.0125000
NODE_184716_length_289_cov_554.947368	45	125	265	1	80	0.0125000
NODE_184716_length_289_cov_554.947368	45	125	273	1	80	0.0125000
NODE_184716_length_289_cov_554.947368	45	125	275	1	80	0.0125000
NODE_184716_length_289_cov_554.947368	45	125	277	3	80	0.0375000
NODE_184716_length_289_cov_554.947368	45	125	278	4	80	0.0500000
NODE_184716_length_289_cov_554.947368	45	125	284	1	80	0.0125000
NODE_184716_length_289_cov_554.947368	45	125	288	1	80	0.0125000
NODE_184716_length_289_cov_554.947368	45	125	290	1	80	0.0125000
NODE_184716_length_289_cov_554.947368	45	125	292	1	80	0.0125000
NODE_184716_length_289_cov_554.947368	45	125	294	1	80	0.0125000
NODE_184716_length_289_cov_554.947368	45	125	296	5	80	0.0625000
NODE_184716_length_289_cov_554.947368	45	125	298	1	80	0.0125000
NODE_184716_length_289_cov_554.947368	45	125	300	1	80	0.0125000
NODE_184716_length_289_cov_554.947368	45	125	302	2	80	0.0250000
NODE_184716_length_289_cov_554.947368	45	125	304	2	80	0.0250000
NODE_184716_length_289_cov_554.947368	45	125	305	1	80	0.0125000
NODE_184716_length_289_cov_554.947368	45	125	308	1	80	0.0125000
NODE_184716_length_289_cov_554.947368	45	125	309	3	80	0.0375000
NODE_184716_length_289_cov_554.947368	45	125	310	2	80	0.0250000
NODE_184716_length_289_cov_554.947368	45	125	312	3	80	0.0375000
NODE_184716_length_289_cov_554.947368	45	125	314	1	80	0.0125000
NODE_184716_length_289_cov_554.947368	45	125	316	3	80	0.0375000
NODE_184716_length_289_cov_554.947368	45	125	320	11	80	0.1375000
NODE_184716_length_289_cov_554.947368	45	125	322	7	80	0.0875000
NODE_184716_length_289_cov_554.947368	45	125	324	10	80	0.1250000
NODE_184716_length_289_cov_554.947368	45	125	325	1	80	0.0125000
NODE_184716_length_289_cov_554.947368	45	125	328	2	80	0.0250000
NODE_184716_length_289_cov_554.947368	45	125	330	1	80	0.0125000
NODE_184729_length_289_cov_7.436842	181	229	0	1	48	0.0208333
NODE_184729_length_289_cov_7.436842	181	229	2	6	48	0.1250000
NODE_184729_length_289_cov_7.436842	181	229	4	41	48	0.8541667
NODE_184745_length_289_cov_5.789474	35	100	2	65	65	1.0000000
NODE_184745_length_289_cov_5.789474	85	153	1	9	68	0.1323529
NODE_184745_length_289_cov_5.789474	85	153	2	59	68	0.8676471
NODE_184745_length_289_cov_5.789474	146	181	0	14	35	0.4000000
NODE_184745_length_289_cov_5.789474	146	181	1	21	35	0.6000000
NODE_184781_length_289_cov_4.515789	192	254	0	62	62	1.0000000
NODE_184806_length_289_cov_4.136842	101	148	0	36	47	0.7659575
NODE_184806_length_289_cov_4.136842	101	148	2	11	47	0.2340426
NODE_184892_length_289_cov_2.973684	38	83	0	45	45	1.0000000
NODE_184960_length_289_cov_2.678947	105	168	10	25	63	0.3968254
NODE_184960_length_289_cov_2.678947	105	168	12	24	63	0.3809524
NODE_184960_length_289_cov_2.678947	105	168	14	14	63	0.2222222
NODE_184960_length_289_cov_2.678947	158	204	8	35	46	0.7608696
NODE_184960_length_289_cov_2.678947	158	204	10	6	46	0.1304348
NODE_184960_length_289_cov_2.678947	158	204	12	5	46	0.1086956
NODE_184963_length_289_cov_2.673684	216	263	0	47	47	1.0000000
NODE_185036_length_289_cov_2.378947	233	289	0	56	56	1.0000000
NODE_185152_length_289_cov_2.089474	26	91	0	65	65	1.0000000
NODE_185213_length_289_cov_1.921053	0	54	0	54	54	1.0000000
NODE_185383_length_289_cov_1.642105	58	123	0	65	65	1.0000000
NODE_185570_length_289_cov_1.547368	81	124	0	21	43	0.4883721
NODE_185570_length_289_cov_1.547368	81	124	2	12	43	0.2790698
NODE_185570_length_289_cov_1.547368	81	124	6	10	43	0.2325581
NODE_185617_length_289_cov_1.489474	192	274	0	82	82	1.0000000
NODE_185622_length_289_cov_1.484211	50	69	2	19	19	1.0000000
NODE_185708_length_289_cov_1.357895	31	74	0	43	43	1.0000000
NODE_185852_length_289_cov_1.278947	239	270	0	31	31	1.0000000
NODE_185864_length_289_cov_1.252632	23	66	0	43	43	1.0000000
NODE_185926_length_289_cov_1.168421	40	100	0	60	60	1.0000000
NODE_185937_length_289_cov_1.152632	0	50	0	50	50	1.0000000
NODE_185937_length_289_cov_1.152632	41	103	0	62	62	1.0000000
NODE_186095_length_289_cov_1.073684	152	198	0	8	46	0.1739130
NODE_186095_length_289_cov_1.073684	152	198	2	38	46	0.8260869
NODE_186491_length_289_cov_0.878947	113	193	0	1	80	0.0125000
NODE_186491_length_289_cov_0.878947	113	193	6	1	80	0.0125000
NODE_186491_length_289_cov_0.878947	113	193	8	2	80	0.0250000
NODE_186491_length_289_cov_0.878947	113	193	11	7	80	0.0875000
NODE_186491_length_289_cov_0.878947	113	193	13	1	80	0.0125000
NODE_186491_length_289_cov_0.878947	113	193	15	1	80	0.0125000
NODE_186491_length_289_cov_0.878947	113	193	17	1	80	0.0125000
NODE_186491_length_289_cov_0.878947	113	193	19	1	80	0.0125000
NODE_186491_length_289_cov_0.878947	113	193	20	13	80	0.1625000
NODE_186491_length_289_cov_0.878947	113	193	22	9	80	0.1125000
NODE_186491_length_289_cov_0.878947	113	193	24	43	80	0.5375000
NODE_186491_length_289_cov_0.878947	166	246	4	5	80	0.0625000
NODE_186491_length_289_cov_0.878947	166	246	6	2	80	0.0250000
NODE_186491_length_289_cov_0.878947	166	246	8	6	80	0.0750000
NODE_186491_length_289_cov_0.878947	166	246	10	2	80	0.0250000
NODE_186491_length_289_cov_0.878947	166	246	12	1	80	0.0125000
NODE_186491_length_289_cov_0.878947	166	246	14	1	80	0.0125000
NODE_186491_length_289_cov_0.878947	166	246	16	2	80	0.0250000
NODE_186491_length_289_cov_0.878947	166	246	18	2	80	0.0250000
NODE_186491_length_289_cov_0.878947	166	246	22	20	80	0.2500000
NODE_186491_length_289_cov_0.878947	166	246	24	39	80	0.4875000
NODE_186507_length_289_cov_0.863158	116	211	3	6	95	0.0631579
NODE_186507_length_289_cov_0.863158	116	211	5	6	95	0.0631579
NODE_186507_length_289_cov_0.863158	116	211	8	9	95	0.0947368
NODE_186507_length_289_cov_0.863158	116	211	9	11	95	0.1157895
NODE_186507_length_289_cov_0.863158	116	211	10	8	95	0.0842105
NODE_186507_length_289_cov_0.863158	116	211	12	23	95	0.2421053
NODE_186507_length_289_cov_0.863158	116	211	14	4	95	0.0421053
NODE_186507_length_289_cov_0.863158	116	211	16	28	95	0.2947368
NODE_186515_length_289_cov_0.857895	6	75	0	57	69	0.8260869
NODE_186515_length_289_cov_0.857895	6	75	2	12	69	0.1739130
NODE_186547_length_289_cov_0.831579	230	289	2	5	59	0.0847458
NODE_186547_length_289_cov_0.831579	230	289	4	8	59	0.1355932
NODE_186547_length_289_cov_0.831579	230	289	6	1	59	0.0169492
NODE_186547_length_289_cov_0.831579	230	289	8	14	59	0.2372881
NODE_186547_length_289_cov_0.831579	230	289	10	16	59	0.2711864
NODE_186547_length_289_cov_0.831579	230	289	12	6	59	0.1016949
NODE_186547_length_289_cov_0.831579	230	289	16	1	59	0.0169492
NODE_186547_length_289_cov_0.831579	230	289	18	5	59	0.0847458
NODE_186547_length_289_cov_0.831579	230	289	22	3	59	0.0508475
NODE_186631_length_289_cov_0.805263	98	159	2	17	61	0.2786885
NODE_186631_length_289_cov_0.805263	98	159	4	9	61	0.1475410
NODE_186631_length_289_cov_0.805263	98	159	6	35	61	0.5737705
NODE_186865_length_289_cov_0.568421	141	213	0	72	72	1.0000000
NODE_186934_length_288_cov_11.089947	135	195	3	9	60	0.1500000
NODE_186934_length_288_cov_11.089947	135	195	5	51	60	0.8500000
NODE_187025_length_288_cov_3.587302	108	188	2	43	80	0.5375000
NODE_187025_length_288_cov_3.587302	108	188	4	37	80	0.4625000
NODE_187049_length_288_cov_3.296296	61	125	0	17	64	0.2656250
NODE_187049_length_288_cov_3.296296	61	125	2	47	64	0.7343750
NODE_187049_length_288_cov_3.296296	102	178	0	70	76	0.9210526
NODE_187049_length_288_cov_3.296296	102	178	2	6	76	0.0789474
NODE_187062_length_288_cov_3.206349	149	202	2	14	53	0.2641509
NODE_187062_length_288_cov_3.206349	149	202	4	39	53	0.7358491
NODE_187170_length_288_cov_2.539683	4	68	18	1	64	0.0156250
NODE_187170_length_288_cov_2.539683	4	68	20	1	64	0.0156250
NODE_187170_length_288_cov_2.539683	4	68	30	1	64	0.0156250
NODE_187170_length_288_cov_2.539683	4	68	38	3	64	0.0468750
NODE_187170_length_288_cov_2.539683	4	68	40	5	64	0.0781250
NODE_187170_length_288_cov_2.539683	4	68	42	3	64	0.0468750
NODE_187170_length_288_cov_2.539683	4	68	44	8	64	0.1250000
NODE_187170_length_288_cov_2.539683	4	68	46	5	64	0.0781250
NODE_187170_length_288_cov_2.539683	4	68	50	3	64	0.0468750
NODE_187170_length_288_cov_2.539683	4	68	52	14	64	0.2187500
NODE_187170_length_288_cov_2.539683	4	68	54	20	64	0.3125000
NODE_187187_length_288_cov_2.465608	137	182	0	35	45	0.7777778
NODE_187187_length_288_cov_2.465608	137	182	2	9	45	0.2000000
NODE_187187_length_288_cov_2.465608	137	182	4	1	45	0.0222222
NODE_187191_length_288_cov_2.449735	216	278	0	15	62	0.2419355
NODE_187191_length_288_cov_2.449735	216	278	1	1	62	0.0161290
NODE_187191_length_288_cov_2.449735	216	278	2	46	62	0.7419355
NODE_187191_length_288_cov_2.449735	237	273	0	10	36	0.2777778
NODE_187191_length_288_cov_2.449735	237	273	1	1	36	0.0277778
NODE_187191_length_288_cov_2.449735	237	273	2	25	36	0.6944444
NODE_187248_length_288_cov_2.275132	10	46	6	36	36	1.0000000
NODE_187248_length_288_cov_2.275132	13	86	6	73	73	1.0000000
NODE_187248_length_288_cov_2.275132	47	100	6	53	53	1.0000000
NODE_187318_length_288_cov_2.153439	50	81	2	1	31	0.0322581
NODE_187318_length_288_cov_2.153439	50	81	4	30	31	0.9677419
NODE_187431_length_288_cov_1.915344	0	75	0	75	75	1.0000000
NODE_187443_length_288_cov_1.888889	49	125	0	8	76	0.1052632
NODE_187443_length_288_cov_1.888889	49	125	2	68	76	0.8947368
NODE_187484_length_288_cov_1.878307	0	42	0	42	42	1.0000000
NODE_187484_length_288_cov_1.878307	15	63	0	48	48	1.0000000
NODE_187810_length_288_cov_1.492063	0	42	0	42	42	1.0000000
NODE_188135_length_288_cov_1.158730	213	288	0	75	75	1.0000000
NODE_188161_length_288_cov_1.100529	256	288	0	32	32	1.0000000
NODE_188169_length_288_cov_1.079365	10	74	0	54	64	0.8437500
NODE_188169_length_288_cov_1.079365	10	74	2	2	64	0.0312500
NODE_188169_length_288_cov_1.079365	10	74	4	8	64	0.1250000
NODE_188169_length_288_cov_1.079365	65	110	2	1	45	0.0222222
NODE_188169_length_288_cov_1.079365	65	110	4	44	45	0.9777778
NODE_188760_length_288_cov_0.809524	141	170	0	14	29	0.4827586
NODE_188760_length_288_cov_0.809524	141	170	10	15	29	0.5172414
NODE_189068_length_287_cov_7.632979	117	184	34	1	67	0.0149254
NODE_189068_length_287_cov_7.632979	117	184	36	5	67	0.0746269
NODE_189068_length_287_cov_7.632979	117	184	38	10	67	0.1492537
NODE_189068_length_287_cov_7.632979	117	184	40	51	67	0.7611941
NODE_189079_length_287_cov_6.510638	20	100	0	80	80	1.0000000
NODE_189097_length_287_cov_5.781915	164	246	2	14	82	0.1707317
NODE_189097_length_287_cov_5.781915	164	246	4	68	82	0.8292683
NODE_189182_length_287_cov_3.590426	114	194	2	80	80	1.0000000
NODE_189192_length_287_cov_3.452128	0	52	0	52	52	1.0000000
NODE_189208_length_287_cov_3.281915	263	286	0	23	23	1.0000000
NODE_189266_length_287_cov_2.936170	41	110	0	3	69	0.0434783
NODE_189266_length_287_cov_2.936170	41	110	2	3	69	0.0434783
NODE_189266_length_287_cov_2.936170	41	110	4	63	69	0.9130435
NODE_189266_length_287_cov_2.936170	41	111	0	4	70	0.0571429
NODE_189266_length_287_cov_2.936170	41	111	2	3	70	0.0428571
NODE_189266_length_287_cov_2.936170	41	111	4	63	70	0.9000000
NODE_189266_length_287_cov_2.936170	94	167	0	20	73	0.2739726
NODE_189266_length_287_cov_2.936170	94	167	2	43	73	0.5890411
NODE_189266_length_287_cov_2.936170	94	167	4	10	73	0.1369863
NODE_189266_length_287_cov_2.936170	156	179	2	23	23	1.0000000
NODE_189330_length_287_cov_2.638298	22	86	0	64	64	1.0000000
NODE_189381_length_287_cov_2.436170	182	262	0	3	80	0.0375000
NODE_189381_length_287_cov_2.436170	182	262	2	5	80	0.0625000
NODE_189381_length_287_cov_2.436170	182	262	4	72	80	0.9000000
NODE_189582_length_287_cov_1.984043	137	166	6	2	29	0.0689655
NODE_189582_length_287_cov_1.984043	137	166	8	3	29	0.1034483
NODE_189582_length_287_cov_1.984043	137	166	9	1	29	0.0344828
NODE_189582_length_287_cov_1.984043	137	166	13	13	29	0.4482759
NODE_189582_length_287_cov_1.984043	137	166	15	2	29	0.0689655
NODE_189582_length_287_cov_1.984043	137	166	17	2	29	0.0689655
NODE_189582_length_287_cov_1.984043	137	166	19	6	29	0.2068966
NODE_189594_length_287_cov_1.941489	56	123	2	67	67	1.0000000
NODE_189614_length_287_cov_1.904255	8	51	4	1	43	0.0232558
NODE_189614_length_287_cov_1.904255	8	51	6	12	43	0.2790698
NODE_189614_length_287_cov_1.904255	8	51	8	8	43	0.1860465
NODE_189614_length_287_cov_1.904255	8	51	10	6	43	0.1395349
NODE_189614_length_287_cov_1.904255	8	51	12	6	43	0.1395349
NODE_189614_length_287_cov_1.904255	8	51	14	5	43	0.1162791
NODE_189614_length_287_cov_1.904255	8	51	16	5	43	0.1162791
NODE_189710_length_287_cov_1.803191	146	217	0	71	71	1.0000000
NODE_189843_length_287_cov_1.627660	113	175	9	10	62	0.1612903
NODE_189843_length_287_cov_1.627660	113	175	11	6	62	0.0967742
NODE_189843_length_287_cov_1.627660	113	175	12	17	62	0.2741936
NODE_189843_length_287_cov_1.627660	113	175	16	7	62	0.1129032
NODE_189843_length_287_cov_1.627660	113	175	18	14	62	0.2258064
NODE_189843_length_287_cov_1.627660	113	175	19	1	62	0.0161290
NODE_189843_length_287_cov_1.627660	113	175	20	7	62	0.1129032
NODE_189843_length_287_cov_1.627660	148	228	6	17	80	0.2125000
NODE_189843_length_287_cov_1.627660	148	228	8	14	80	0.1750000
NODE_189843_length_287_cov_1.627660	148	228	9	10	80	0.1250000
NODE_189843_length_287_cov_1.627660	148	228	10	22	80	0.2750000
NODE_189843_length_287_cov_1.627660	148	228	11	6	80	0.0750000
NODE_189843_length_287_cov_1.627660	148	228	12	11	80	0.1375000
NODE_189864_length_287_cov_1.627660	14	59	0	45	45	1.0000000
NODE_189864_length_287_cov_1.627660	41	112	0	71	71	1.0000000
NODE_189949_length_287_cov_1.574468	150	220	0	20	70	0.2857143
NODE_189949_length_287_cov_1.574468	150	220	2	50	70	0.7142857
NODE_189985_length_287_cov_1.531915	123	154	0	31	31	1.0000000
NODE_190122_length_287_cov_1.356383	93	147	0	54	54	1.0000000
NODE_190142_length_287_cov_1.356383	135	199	0	64	64	1.0000000
NODE_190189_length_287_cov_1.335106	149	201	0	52	52	1.0000000
NODE_190654_length_287_cov_1.037234	23	44	0	21	21	1.0000000
NODE_190701_length_287_cov_0.994681	206	225	0	19	19	1.0000000
NODE_190802_length_287_cov_0.898936	0	57	0	26	57	0.4561403
NODE_190802_length_287_cov_0.898936	0	57	2	4	57	0.0701754
NODE_190802_length_287_cov_0.898936	0	57	3	5	57	0.0877193
NODE_190802_length_287_cov_0.898936	0	57	5	4	57	0.0701754
NODE_190802_length_287_cov_0.898936	0	57	6	1	57	0.0175439
NODE_190802_length_287_cov_0.898936	0	57	8	7	57	0.1228070
NODE_190802_length_287_cov_0.898936	0	57	10	1	57	0.0175439
NODE_190802_length_287_cov_0.898936	0	57	12	2	57	0.0350877
NODE_190802_length_287_cov_0.898936	0	57	14	7	57	0.1228070
NODE_190873_length_287_cov_0.840426	46	121	0	75	75	1.0000000
NODE_191306_length_286_cov_141.540107	4	63	0	59	59	1.0000000
NODE_191389_length_286_cov_3.935829	79	123	0	44	44	1.0000000
NODE_191391_length_286_cov_3.871658	45	121	4	21	76	0.2763158
NODE_191391_length_286_cov_3.871658	45	121	6	55	76	0.7236842
NODE_191391_length_286_cov_3.871658	102	169	0	2	67	0.0298507
NODE_191391_length_286_cov_3.871658	102	169	4	65	67	0.9701493
NODE_191393_length_286_cov_3.812834	62	142	2	4	80	0.0500000
NODE_191393_length_286_cov_3.812834	62	142	4	18	80	0.2250000
NODE_191393_length_286_cov_3.812834	62	142	6	4	80	0.0500000
NODE_191393_length_286_cov_3.812834	62	142	8	8	80	0.1000000
NODE_191393_length_286_cov_3.812834	62	142	10	16	80	0.2000000
NODE_191393_length_286_cov_3.812834	62	142	16	30	80	0.3750000
NODE_191430_length_286_cov_3.352941	63	143	0	80	80	1.0000000
NODE_191430_length_286_cov_3.352941	116	196	0	80	80	1.0000000
NODE_191466_length_286_cov_3.101604	217	271	0	54	54	1.0000000
NODE_191509_length_286_cov_2.823529	56	122	4	3	66	0.0454545
NODE_191509_length_286_cov_2.823529	56	122	6	1	66	0.0151515
NODE_191509_length_286_cov_2.823529	56	122	8	7	66	0.1060606
NODE_191509_length_286_cov_2.823529	56	122	11	3	66	0.0454545
NODE_191509_length_286_cov_2.823529	56	122	13	5	66	0.0757576
NODE_191509_length_286_cov_2.823529	56	122	15	1	66	0.0151515
NODE_191509_length_286_cov_2.823529	56	122	17	1	66	0.0151515
NODE_191509_length_286_cov_2.823529	56	122	27	1	66	0.0151515
NODE_191509_length_286_cov_2.823529	56	122	31	2	66	0.0303030
NODE_191509_length_286_cov_2.823529	56	122	35	2	66	0.0303030
NODE_191509_length_286_cov_2.823529	56	122	37	2	66	0.0303030
NODE_191509_length_286_cov_2.823529	56	122	39	2	66	0.0303030
NODE_191509_length_286_cov_2.823529	56	122	41	1	66	0.0151515
NODE_191509_length_286_cov_2.823529	56	122	45	1	66	0.0151515
NODE_191509_length_286_cov_2.823529	56	122	47	1	66	0.0151515
NODE_191509_length_286_cov_2.823529	56	122	51	2	66	0.0303030
NODE_191509_length_286_cov_2.823529	56	122	55	3	66	0.0454545
NODE_191509_length_286_cov_2.823529	56	122	59	2	66	0.0303030
NODE_191509_length_286_cov_2.823529	56	122	61	2	66	0.0303030
NODE_191509_length_286_cov_2.823529	56	122	66	1	66	0.0151515
NODE_191509_length_286_cov_2.823529	56	122	67	1	66	0.0151515
NODE_191509_length_286_cov_2.823529	56	122	71	1	66	0.0151515
NODE_191509_length_286_cov_2.823529	56	122	73	3	66	0.0454545
NODE_191509_length_286_cov_2.823529	56	122	77	1	66	0.0151515
NODE_191509_length_286_cov_2.823529	56	122	81	1	66	0.0151515
NODE_191509_length_286_cov_2.823529	56	122	83	6	66	0.0909091
NODE_191509_length_286_cov_2.823529	56	122	87	1	66	0.0151515
NODE_191509_length_286_cov_2.823529	56	122	89	1	66	0.0151515
NODE_191509_length_286_cov_2.823529	56	122	91	1	66	0.0151515
NODE_191509_length_286_cov_2.823529	56	122	93	1	66	0.0151515
NODE_191509_length_286_cov_2.823529	56	122	95	4	66	0.0606061
NODE_191509_length_286_cov_2.823529	56	122	97	1	66	0.0151515
NODE_191509_length_286_cov_2.823529	56	122	102	1	66	0.0151515
NODE_191598_length_286_cov_2.438503	151	218	0	67	67	1.0000000
NODE_191754_length_286_cov_2.037433	57	138	6	8	81	0.0987654
NODE_191754_length_286_cov_2.037433	57	138	8	1	81	0.0123457
NODE_191754_length_286_cov_2.037433	57	138	10	25	81	0.3086420
NODE_191754_length_286_cov_2.037433	57	138	12	47	81	0.5802469
NODE_191892_length_286_cov_1.807487	186	232	0	46	46	1.0000000
NODE_191892_length_286_cov_1.807487	239	285	0	46	46	1.0000000
NODE_192100_length_286_cov_1.566845	112	160	0	48	48	1.0000000
NODE_192100_length_286_cov_1.566845	165	213	0	48	48	1.0000000
NODE_192150_length_286_cov_1.497326	107	160	0	53	53	1.0000000
NODE_192233_length_286_cov_1.363636	20	87	0	2	67	0.0298507
NODE_192233_length_286_cov_1.363636	20	87	2	65	67	0.9701493
NODE_192302_length_286_cov_1.358289	218	262	2	35	44	0.7954546
NODE_192302_length_286_cov_1.358289	218	262	4	9	44	0.2045455
NODE_192357_length_286_cov_1.304813	147	205	2	27	58	0.4655173
NODE_192357_length_286_cov_1.304813	147	205	4	31	58	0.5344828
NODE_192427_length_286_cov_1.203209	30	76	0	46	46	1.0000000
NODE_192427_length_286_cov_1.203209	49	129	0	80	80	1.0000000
NODE_192757_length_286_cov_1.074866	160	220	0	60	60	1.0000000
NODE_193023_length_286_cov_0.871658	218	279	0	61	61	1.0000000
NODE_193038_length_286_cov_0.855615	224	281	0	10	57	0.1754386
NODE_193038_length_286_cov_0.855615	224	281	4	8	57	0.1403509
NODE_193038_length_286_cov_0.855615	224	281	5	3	57	0.0526316
NODE_193038_length_286_cov_0.855615	224	281	7	1	57	0.0175439
NODE_193038_length_286_cov_0.855615	224	281	9	1	57	0.0175439
NODE_193038_length_286_cov_0.855615	224	281	11	1	57	0.0175439
NODE_193038_length_286_cov_0.855615	224	281	12	16	57	0.2807018
NODE_193038_length_286_cov_0.855615	224	281	13	17	57	0.2982456
NODE_193362_length_286_cov_0.625668	110	190	0	11	80	0.1375000
NODE_193362_length_286_cov_0.625668	110	190	2	69	80	0.8625000
NODE_193362_length_286_cov_0.625668	163	240	0	61	77	0.7922078
NODE_193362_length_286_cov_0.625668	163	240	2	16	77	0.2077922
NODE_193481_length_285_cov_7.392473	91	152	0	24	61	0.3934426
NODE_193481_length_285_cov_7.392473	91	152	2	37	61	0.6065574
NODE_193481_length_285_cov_7.392473	150	184	0	34	34	1.0000000
NODE_193513_length_285_cov_4.650538	0	74	0	74	74	1.0000000
NODE_193513_length_285_cov_4.650538	47	127	0	80	80	1.0000000
NODE_193513_length_285_cov_4.650538	123	203	0	80	80	1.0000000
NODE_193513_length_285_cov_4.650538	176	256	0	80	80	1.0000000
NODE_193532_length_285_cov_4.091398	91	154	0	5	63	0.0793651
NODE_193532_length_285_cov_4.091398	91	154	2	58	63	0.9206349
NODE_193538_length_285_cov_4.010753	120	201	6	55	81	0.6790124
NODE_193538_length_285_cov_4.010753	120	201	8	26	81	0.3209876
NODE_193547_length_285_cov_3.854839	97	151	2	54	54	1.0000000
NODE_193547_length_285_cov_3.854839	106	153	0	1	47	0.0212766
NODE_193547_length_285_cov_3.854839	106	153	2	45	47	0.9574468
NODE_193547_length_285_cov_3.854839	106	153	4	1	47	0.0212766
NODE_193566_length_285_cov_3.607527	197	258	0	18	61	0.2950820
NODE_193566_length_285_cov_3.607527	197	258	2	4	61	0.0655738
NODE_193566_length_285_cov_3.607527	197	258	3	16	61	0.2622951
NODE_193566_length_285_cov_3.607527	197	258	4	2	61	0.0327869
NODE_193566_length_285_cov_3.607527	197	258	6	3	61	0.0491803
NODE_193566_length_285_cov_3.607527	197	258	8	4	61	0.0655738
NODE_193566_length_285_cov_3.607527	197	258	10	1	61	0.0163934
NODE_193566_length_285_cov_3.607527	197	258	12	11	61	0.1803279
NODE_193566_length_285_cov_3.607527	197	258	18	2	61	0.0327869
NODE_193624_length_285_cov_3.037634	190	272	0	57	82	0.6951219
NODE_193624_length_285_cov_3.037634	190	272	4	25	82	0.3048781
NODE_193660_length_285_cov_2.806452	215	279	0	17	64	0.2656250
NODE_193660_length_285_cov_2.806452	215	279	2	42	64	0.6562500
NODE_193660_length_285_cov_2.806452	215	279	4	5	64	0.0781250
NODE_193688_length_285_cov_2.736559	106	173	8	9	67	0.1343284
NODE_193688_length_285_cov_2.736559	106	173	9	16	67	0.2388060
NODE_193688_length_285_cov_2.736559	106	173	10	42	67	0.6268657
NODE_193784_length_285_cov_2.311828	220	262	0	42	42	1.0000000
NODE_193883_length_285_cov_2.043011	77	150	0	64	73	0.8767123
NODE_193883_length_285_cov_2.043011	77	150	2	9	73	0.1232877
NODE_193883_length_285_cov_2.043011	155	197	2	42	42	1.0000000
NODE_193978_length_285_cov_1.876344	67	110	0	43	43	1.0000000
NODE_194150_length_285_cov_1.645161	112	160	4	48	48	1.0000000
NODE_194260_length_285_cov_1.548387	124	172	0	48	48	1.0000000
NODE_194332_length_285_cov_1.456989	210	277	0	8	67	0.1194030
NODE_194332_length_285_cov_1.456989	210	277	2	59	67	0.8805970
NODE_194499_length_285_cov_1.327957	114	191	0	28	77	0.3636364
NODE_194499_length_285_cov_1.327957	114	191	4	49	77	0.6363636
NODE_194865_length_285_cov_1.096774	175	229	0	54	54	1.0000000
NODE_194865_length_285_cov_1.096774	230	271	0	41	41	1.0000000
NODE_195109_length_285_cov_0.924731	128	208	6	4	80	0.0500000
NODE_195109_length_285_cov_0.924731	128	208	10	15	80	0.1875000
NODE_195109_length_285_cov_0.924731	128	208	12	57	80	0.7125000
NODE_195109_length_285_cov_0.924731	128	208	14	4	80	0.0500000
NODE_195115_length_285_cov_0.919355	5	65	0	60	60	1.0000000
NODE_195124_length_285_cov_0.913978	6	80	2	3	74	0.0405405
NODE_195124_length_285_cov_0.913978	6	80	4	18	74	0.2432432
NODE_195124_length_285_cov_0.913978	6	80	6	50	74	0.6756757
NODE_195124_length_285_cov_0.913978	6	80	8	3	74	0.0405405
NODE_195124_length_285_cov_0.913978	58	133	2	3	75	0.0400000
NODE_195124_length_285_cov_0.913978	58	133	4	27	75	0.3600000
NODE_195124_length_285_cov_0.913978	58	133	6	42	75	0.5600000
NODE_195124_length_285_cov_0.913978	58	133	8	3	75	0.0400000
NODE_195642_length_284_cov_7.967568	143	207	0	2	64	0.0312500
NODE_195642_length_284_cov_7.967568	143	207	2	62	64	0.9687500
NODE_195667_length_284_cov_5.016216	115	169	4	54	54	1.0000000
NODE_195715_length_284_cov_3.913514	26	82	0	56	56	1.0000000
NODE_195760_length_284_cov_3.405405	209	283	0	74	74	1.0000000
NODE_195863_length_284_cov_2.718919	138	162	0	10	24	0.4166667
NODE_195863_length_284_cov_2.718919	138	162	2	2	24	0.0833333
NODE_195863_length_284_cov_2.718919	138	162	4	12	24	0.5000000
NODE_195863_length_284_cov_2.718919	138	215	0	10	77	0.1298701
NODE_195863_length_284_cov_2.718919	138	215	2	2	77	0.0259740
NODE_195863_length_284_cov_2.718919	138	215	4	65	77	0.8441558
NODE_196090_length_284_cov_2.097297	46	122	2	76	76	1.0000000
NODE_196253_length_284_cov_1.756757	27	100	6	28	73	0.3835616
NODE_196253_length_284_cov_1.756757	27	100	8	1	73	0.0136986
NODE_196253_length_284_cov_1.756757	27	100	10	5	73	0.0684932
NODE_196253_length_284_cov_1.756757	27	100	12	39	73	0.5342466
NODE_196253_length_284_cov_1.756757	97	153	10	25	56	0.4464286
NODE_196253_length_284_cov_1.756757	97	153	12	31	56	0.5535714
NODE_196273_length_284_cov_1.713514	24	59	2	35	35	1.0000000
NODE_196372_length_284_cov_1.654054	207	251	0	2	44	0.0454545
NODE_196372_length_284_cov_1.654054	207	251	4	29	44	0.6590909
NODE_196372_length_284_cov_1.654054	207	251	5	13	44	0.2954545
NODE_196426_length_284_cov_1.643243	180	239	0	59	59	1.0000000
NODE_196505_length_284_cov_1.540541	148	186	15	1	38	0.0263158
NODE_196505_length_284_cov_1.540541	148	186	21	1	38	0.0263158
NODE_196505_length_284_cov_1.540541	148	186	23	4	38	0.1052632
NODE_196505_length_284_cov_1.540541	148	186	27	1	38	0.0263158
NODE_196505_length_284_cov_1.540541	148	186	28	1	38	0.0263158
NODE_196505_length_284_cov_1.540541	148	186	29	1	38	0.0263158
NODE_196505_length_284_cov_1.540541	148	186	30	5	38	0.1315790
NODE_196505_length_284_cov_1.540541	148	186	32	3	38	0.0789474
NODE_196505_length_284_cov_1.540541	148	186	34	3	38	0.0789474
NODE_196505_length_284_cov_1.540541	148	186	38	4	38	0.1052632
NODE_196505_length_284_cov_1.540541	148	186	40	5	38	0.1315790
NODE_196505_length_284_cov_1.540541	148	186	42	1	38	0.0263158
NODE_196505_length_284_cov_1.540541	148	186	44	5	38	0.1315790
NODE_196505_length_284_cov_1.540541	148	186	46	1	38	0.0263158
NODE_196505_length_284_cov_1.540541	148	186	48	2	38	0.0526316
NODE_196670_length_284_cov_1.378378	65	145	0	64	80	0.8000000
NODE_196670_length_284_cov_1.378378	65	145	2	1	80	0.0125000
NODE_196670_length_284_cov_1.378378	65	145	4	15	80	0.1875000
NODE_196670_length_284_cov_1.378378	118	165	0	11	47	0.2340426
NODE_196670_length_284_cov_1.378378	118	165	2	1	47	0.0212766
NODE_196670_length_284_cov_1.378378	118	165	4	18	47	0.3829787
NODE_196670_length_284_cov_1.378378	118	165	6	11	47	0.2340426
NODE_196670_length_284_cov_1.378378	118	165	16	6	47	0.1276596
NODE_196733_length_284_cov_1.329730	114	170	0	56	56	1.0000000
NODE_197755_length_284_cov_0.686486	13	94	0	81	81	1.0000000
NODE_197755_length_284_cov_0.686486	13	94	0	81	81	1.0000000
NODE_197755_length_284_cov_0.686486	13	94	0	81	81	1.0000000
NODE_197835_length_284_cov_0.551351	167	219	0	52	52	1.0000000
NODE_197936_length_283_cov_4.434783	81	137	26	4	56	0.0714286
NODE_197936_length_283_cov_4.434783	81	137	27	2	56	0.0357143
NODE_197936_length_283_cov_4.434783	81	137	32	2	56	0.0357143
NODE_197936_length_283_cov_4.434783	81	137	34	4	56	0.0714286
NODE_197936_length_283_cov_4.434783	81	137	36	5	56	0.0892857
NODE_197936_length_283_cov_4.434783	81	137	38	2	56	0.0357143
NODE_197936_length_283_cov_4.434783	81	137	40	4	56	0.0714286
NODE_197936_length_283_cov_4.434783	81	137	42	2	56	0.0357143
NODE_197936_length_283_cov_4.434783	81	137	44	3	56	0.0535714
NODE_197936_length_283_cov_4.434783	81	137	48	4	56	0.0714286
NODE_197936_length_283_cov_4.434783	81	137	52	7	56	0.1250000
NODE_197936_length_283_cov_4.434783	81	137	58	2	56	0.0357143
NODE_197936_length_283_cov_4.434783	81	137	60	15	56	0.2678571
NODE_197936_length_283_cov_4.434783	114	190	0	1	76	0.0131579
NODE_197936_length_283_cov_4.434783	114	190	2	1	76	0.0131579
NODE_197936_length_283_cov_4.434783	114	190	3	2	76	0.0263158
NODE_197936_length_283_cov_4.434783	114	190	4	1	76	0.0131579
NODE_197936_length_283_cov_4.434783	114	190	8	1	76	0.0131579
NODE_197936_length_283_cov_4.434783	114	190	9	4	76	0.0526316
NODE_197936_length_283_cov_4.434783	114	190	11	2	76	0.0263158
NODE_197936_length_283_cov_4.434783	114	190	14	4	76	0.0526316
NODE_197936_length_283_cov_4.434783	114	190	15	8	76	0.1052632
NODE_197936_length_283_cov_4.434783	114	190	19	6	76	0.0789474
NODE_197936_length_283_cov_4.434783	114	190	21	10	76	0.1315790
NODE_197936_length_283_cov_4.434783	114	190	23	5	76	0.0657895
NODE_197936_length_283_cov_4.434783	114	190	25	5	76	0.0657895
NODE_197936_length_283_cov_4.434783	114	190	26	7	76	0.0921053
NODE_197936_length_283_cov_4.434783	114	190	27	2	76	0.0263158
NODE_197936_length_283_cov_4.434783	114	190	32	2	76	0.0263158
NODE_197936_length_283_cov_4.434783	114	190	34	4	76	0.0526316
NODE_197936_length_283_cov_4.434783	114	190	36	5	76	0.0657895
NODE_197936_length_283_cov_4.434783	114	190	38	2	76	0.0263158
NODE_197936_length_283_cov_4.434783	114	190	40	4	76	0.0526316
NODE_197936_length_283_cov_4.434783	190	270	0	4	80	0.0500000
NODE_197936_length_283_cov_4.434783	190	270	2	10	80	0.1250000
NODE_197936_length_283_cov_4.434783	190	270	4	13	80	0.1625000
NODE_197936_length_283_cov_4.434783	190	270	6	53	80	0.6625000
NODE_197937_length_283_cov_4.429348	104	168	4	24	64	0.3750000
NODE_197937_length_283_cov_4.429348	104	168	6	21	64	0.3281250
NODE_197937_length_283_cov_4.429348	104	168	8	19	64	0.2968750
NODE_197937_length_283_cov_4.429348	104	168	4	24	64	0.3750000
NODE_197937_length_283_cov_4.429348	104	168	6	21	64	0.3281250
NODE_197937_length_283_cov_4.429348	104	168	8	19	64	0.2968750
NODE_197937_length_283_cov_4.429348	141	207	2	29	66	0.4393939
NODE_197937_length_283_cov_4.429348	141	207	4	34	66	0.5151515
NODE_197937_length_283_cov_4.429348	141	207	8	3	66	0.0454545
NODE_197937_length_283_cov_4.429348	141	221	2	43	80	0.5375000
NODE_197937_length_283_cov_4.429348	141	221	4	34	80	0.4250000
NODE_197937_length_283_cov_4.429348	141	221	8	3	80	0.0375000
NODE_198007_length_283_cov_3.369565	0	35	0	35	35	1.0000000
NODE_198022_length_283_cov_3.309783	47	91	0	44	44	1.0000000
NODE_198081_length_283_cov_2.923913	95	137	4	9	42	0.2142857
NODE_198081_length_283_cov_2.923913	95	137	6	18	42	0.4285714
NODE_198081_length_283_cov_2.923913	95	137	8	7	42	0.1666667
NODE_198081_length_283_cov_2.923913	95	137	10	8	42	0.1904762
NODE_198081_length_283_cov_2.923913	110	190	6	12	80	0.1500000
NODE_198081_length_283_cov_2.923913	110	190	8	7	80	0.0875000
NODE_198081_length_283_cov_2.923913	110	190	10	46	80	0.5750000
NODE_198081_length_283_cov_2.923913	110	190	12	15	80	0.1875000
NODE_198098_length_283_cov_2.782609	120	200	4	14	80	0.1750000
NODE_198098_length_283_cov_2.782609	120	200	6	3	80	0.0375000
NODE_198098_length_283_cov_2.782609	120	200	9	15	80	0.1875000
NODE_198098_length_283_cov_2.782609	120	200	12	30	80	0.3750000
NODE_198098_length_283_cov_2.782609	120	200	14	18	80	0.2250000
NODE_198109_length_283_cov_2.771739	29	72	0	43	43	1.0000000
NODE_198171_length_283_cov_2.494565	186	229	0	43	43	1.0000000
NODE_198176_length_283_cov_2.494565	181	238	0	33	57	0.5789474
NODE_198176_length_283_cov_2.494565	181	238	4	24	57	0.4210526
NODE_198271_length_283_cov_2.217391	222	281	0	59	59	1.0000000
NODE_198518_length_283_cov_1.777174	40	120	0	69	80	0.8625000
NODE_198518_length_283_cov_1.777174	40	120	2	11	80	0.1375000
NODE_198745_length_283_cov_1.543478	125	161	4	3	36	0.0833333
NODE_198745_length_283_cov_1.543478	125	161	6	5	36	0.1388889
NODE_198745_length_283_cov_1.543478	125	161	10	1	36	0.0277778
NODE_198745_length_283_cov_1.543478	125	161	16	9	36	0.2500000
NODE_198745_length_283_cov_1.543478	125	161	18	10	36	0.2777778
NODE_198745_length_283_cov_1.543478	125	161	19	2	36	0.0555556
NODE_198745_length_283_cov_1.543478	125	161	20	4	36	0.1111111
NODE_198745_length_283_cov_1.543478	125	161	22	2	36	0.0555556
NODE_198751_length_283_cov_1.538043	182	203	0	21	21	1.0000000
NODE_198986_length_283_cov_1.304348	208	270	6	1	62	0.0161290
NODE_198986_length_283_cov_1.304348	208	270	8	1	62	0.0161290
NODE_198986_length_283_cov_1.304348	208	270	12	2	62	0.0322581
NODE_198986_length_283_cov_1.304348	208	270	14	19	62	0.3064516
NODE_198986_length_283_cov_1.304348	208	270	15	1	62	0.0161290
NODE_198986_length_283_cov_1.304348	208	270	16	2	62	0.0322581
NODE_198986_length_283_cov_1.304348	208	270	18	36	62	0.5806451
NODE_199042_length_283_cov_1.211957	157	234	0	77	77	1.0000000
NODE_199070_length_283_cov_1.168478	183	250	10	10	67	0.1492537
NODE_199070_length_283_cov_1.168478	183	250	12	57	67	0.8507463
NODE_199606_length_283_cov_0.918478	146	226	6	6	80	0.0750000
NODE_199606_length_283_cov_0.918478	146	226	8	8	80	0.1000000
NODE_199606_length_283_cov_0.918478	146	226	10	66	80	0.8250000
NODE_199606_length_283_cov_0.918478	199	279	0	46	80	0.5750000
NODE_199606_length_283_cov_0.918478	199	279	2	3	80	0.0375000
NODE_199606_length_283_cov_0.918478	199	279	4	1	80	0.0125000
NODE_199606_length_283_cov_0.918478	199	279	6	9	80	0.1125000
NODE_199606_length_283_cov_0.918478	199	279	10	21	80	0.2625000
NODE_199641_length_283_cov_0.885870	143	205	4	59	62	0.9516129
NODE_199641_length_283_cov_0.885870	143	205	6	3	62	0.0483871
NODE_199958_length_283_cov_0.706522	119	159	0	40	40	1.0000000
NODE_200085_length_282_cov_51.027322	219	280	0	61	61	1.0000000
NODE_200085_length_282_cov_51.027322	219	282	0	63	63	1.0000000
NODE_200166_length_282_cov_3.901639	38	118	0	80	80	1.0000000
NODE_200166_length_282_cov_3.901639	91	171	0	80	80	1.0000000
NODE_200171_length_282_cov_3.874317	96	116	8	16	20	0.8000000
NODE_200171_length_282_cov_3.874317	96	116	10	4	20	0.2000000
NODE_200201_length_282_cov_3.562842	224	279	0	47	55	0.8545455
NODE_200201_length_282_cov_3.562842	224	279	2	8	55	0.1454545
NODE_200270_length_282_cov_2.890710	41	123	0	82	82	1.0000000
NODE_200276_length_282_cov_2.846995	26	47	0	21	21	1.0000000
NODE_200304_length_282_cov_2.770492	145	225	4	35	80	0.4375000
NODE_200304_length_282_cov_2.770492	145	225	6	45	80	0.5625000
NODE_200304_length_282_cov_2.770492	198	278	0	33	80	0.4125000
NODE_200304_length_282_cov_2.770492	198	278	2	10	80	0.1250000
NODE_200304_length_282_cov_2.770492	198	278	6	37	80	0.4625000
NODE_200329_length_282_cov_2.655738	46	119	0	34	73	0.4657534
NODE_200329_length_282_cov_2.655738	46	119	2	39	73	0.5342466
NODE_200329_length_282_cov_2.655738	100	159	2	59	59	1.0000000
NODE_200335_length_282_cov_2.622951	0	36	0	36	36	1.0000000
NODE_200335_length_282_cov_2.622951	9	89	0	80	80	1.0000000
NODE_200336_length_282_cov_2.622951	38	111	0	73	73	1.0000000
NODE_200336_length_282_cov_2.622951	98	144	0	46	46	1.0000000
NODE_200367_length_282_cov_2.508197	138	186	0	48	48	1.0000000
NODE_200367_length_282_cov_2.508197	191	234	0	43	43	1.0000000
NODE_200425_length_282_cov_2.289617	68	137	2	4	69	0.0579710
NODE_200425_length_282_cov_2.289617	68	137	4	8	69	0.1159420
NODE_200425_length_282_cov_2.289617	68	137	8	57	69	0.8260869
NODE_200443_length_282_cov_2.229508	169	249	0	80	80	1.0000000
NODE_200501_length_282_cov_2.163934	138	192	2	29	54	0.5370370
NODE_200501_length_282_cov_2.163934	138	192	4	8	54	0.1481481
NODE_200501_length_282_cov_2.163934	138	192	6	17	54	0.3148148
NODE_200634_length_282_cov_1.901639	149	216	6	6	67	0.0895522
NODE_200634_length_282_cov_1.901639	149	216	8	6	67	0.0895522
NODE_200634_length_282_cov_1.901639	149	216	10	26	67	0.3880597
NODE_200634_length_282_cov_1.901639	149	216	12	29	67	0.4328358
NODE_200924_length_282_cov_1.612022	123	162	0	39	39	1.0000000
NODE_201084_length_282_cov_1.393443	158	225	2	42	67	0.6268657
NODE_201084_length_282_cov_1.393443	158	225	4	25	67	0.3731343
NODE_201219_length_282_cov_1.273224	91	140	0	49	49	1.0000000
NODE_201413_length_282_cov_1.114754	5	53	0	48	48	1.0000000
NODE_202284_length_281_cov_7.895604	165	210	10	1	45	0.0222222
NODE_202284_length_281_cov_7.895604	165	210	13	1	45	0.0222222
NODE_202284_length_281_cov_7.895604	165	210	14	3	45	0.0666667
NODE_202284_length_281_cov_7.895604	165	210	16	1	45	0.0222222
NODE_202284_length_281_cov_7.895604	165	210	17	1	45	0.0222222
NODE_202284_length_281_cov_7.895604	165	210	18	2	45	0.0444444
NODE_202284_length_281_cov_7.895604	165	210	20	4	45	0.0888889
NODE_202284_length_281_cov_7.895604	165	210	24	32	45	0.7111111
NODE_202284_length_281_cov_7.895604	183	263	17	5	80	0.0625000
NODE_202284_length_281_cov_7.895604	183	263	19	9	80	0.1125000
NODE_202284_length_281_cov_7.895604	183	263	21	10	80	0.1250000
NODE_202284_length_281_cov_7.895604	183	263	23	11	80	0.1375000
NODE_202284_length_281_cov_7.895604	183	263	24	45	80	0.5625000
NODE_202294_length_281_cov_6.379121	151	231	1	80	80	1.0000000
NODE_202333_length_281_cov_4.565934	71	127	2	25	56	0.4464286
NODE_202333_length_281_cov_4.565934	71	127	4	31	56	0.5535714
NODE_202337_length_281_cov_4.494505	211	261	4	50	50	1.0000000
NODE_202356_length_281_cov_4.219780	85	135	0	50	50	1.0000000
NODE_202356_length_281_cov_4.219780	145	188	0	43	43	1.0000000
NODE_202401_length_281_cov_3.620879	245	281	0	36	36	1.0000000
NODE_202421_length_281_cov_3.324176	104	161	2	19	57	0.3333333
NODE_202421_length_281_cov_3.324176	104	161	4	10	57	0.1754386
NODE_202421_length_281_cov_3.324176	104	161	8	28	57	0.4912281
NODE_202421_length_281_cov_3.324176	112	192	2	11	80	0.1375000
NODE_202421_length_281_cov_3.324176	112	192	4	10	80	0.1250000
NODE_202421_length_281_cov_3.324176	112	192	6	9	80	0.1125000
NODE_202421_length_281_cov_3.324176	112	192	8	50	80	0.6250000
NODE_202436_length_281_cov_3.197802	6	80	0	74	74	1.0000000
NODE_202473_length_281_cov_2.923077	92	150	0	58	58	1.0000000
NODE_202650_length_281_cov_2.241758	5	58	0	53	53	1.0000000
NODE_202712_length_281_cov_2.120879	56	136	0	5	80	0.0625000
NODE_202712_length_281_cov_2.120879	56	136	2	75	80	0.9375000
NODE_202788_length_281_cov_1.961538	199	270	0	26	71	0.3661972
NODE_202788_length_281_cov_1.961538	199	270	2	27	71	0.3802817
NODE_202788_length_281_cov_1.961538	199	270	4	18	71	0.2535211
NODE_203008_length_281_cov_1.675824	147	199	2	52	52	1.0000000
NODE_203008_length_281_cov_1.675824	178	198	2	20	20	1.0000000
NODE_203008_length_281_cov_1.675824	200	241	0	17	41	0.4146341
NODE_203008_length_281_cov_1.675824	200	241	2	24	41	0.5853658
NODE_203065_length_281_cov_1.653846	29	65	0	33	36	0.9166667
NODE_203065_length_281_cov_1.653846	29	65	4	3	36	0.0833333
NODE_203168_length_281_cov_1.483516	85	135	0	50	50	1.0000000
NODE_203168_length_281_cov_1.483516	86	166	0	80	80	1.0000000
NODE_203168_length_281_cov_1.483516	139	184	0	45	45	1.0000000
NODE_203183_length_281_cov_1.461538	223	276	0	53	53	1.0000000
NODE_203262_length_281_cov_1.401099	237	281	0	44	44	1.0000000
NODE_203281_length_281_cov_1.401099	150	214	0	24	64	0.3750000
NODE_203281_length_281_cov_1.401099	150	214	6	2	64	0.0312500
NODE_203281_length_281_cov_1.401099	150	214	8	38	64	0.5937500
NODE_203281_length_281_cov_1.401099	187	267	0	77	80	0.9625000
NODE_203281_length_281_cov_1.401099	187	267	6	2	80	0.0250000
NODE_203281_length_281_cov_1.401099	187	267	8	1	80	0.0125000
NODE_203292_length_281_cov_1.401099	31	111	0	80	80	1.0000000
NODE_203440_length_281_cov_1.186813	0	79	0	48	79	0.6075949
NODE_203440_length_281_cov_1.186813	0	79	2	1	79	0.0126582
NODE_203440_length_281_cov_1.186813	0	79	6	12	79	0.1518987
NODE_203440_length_281_cov_1.186813	0	79	7	5	79	0.0632911
NODE_203440_length_281_cov_1.186813	0	79	9	3	79	0.0379747
NODE_203440_length_281_cov_1.186813	0	79	11	5	79	0.0632911
NODE_203440_length_281_cov_1.186813	0	79	12	5	79	0.0632911
NODE_203440_length_281_cov_1.186813	52	132	6	9	80	0.1125000
NODE_203440_length_281_cov_1.186813	52	132	7	5	80	0.0625000
NODE_203440_length_281_cov_1.186813	52	132	9	3	80	0.0375000
NODE_203440_length_281_cov_1.186813	52	132	11	5	80	0.0625000
NODE_203440_length_281_cov_1.186813	52	132	12	14	80	0.1750000
NODE_203440_length_281_cov_1.186813	52	132	14	44	80	0.5500000
NODE_203516_length_281_cov_1.120879	47	82	0	35	35	1.0000000
NODE_203534_length_281_cov_1.120879	243	276	0	33	33	1.0000000
NODE_203544_length_281_cov_1.120879	216	281	4	65	65	1.0000000
NODE_203785_length_281_cov_1.060440	139	179	20	6	40	0.1500000
NODE_203785_length_281_cov_1.060440	139	179	24	6	40	0.1500000
NODE_203785_length_281_cov_1.060440	139	179	25	12	40	0.3000000
NODE_203785_length_281_cov_1.060440	139	179	27	16	40	0.4000000
NODE_204094_length_281_cov_0.840659	72	138	0	66	66	1.0000000
NODE_204094_length_281_cov_0.840659	111	191	0	80	80	1.0000000
NODE_204467_length_280_cov_39.320442	118	198	0	80	80	1.0000000
NODE_204467_length_280_cov_39.320442	181	251	0	70	70	1.0000000
NODE_204468_length_280_cov_34.259669	97	137	0	11	40	0.2750000
NODE_204468_length_280_cov_34.259669	97	137	2	1	40	0.0250000
NODE_204468_length_280_cov_34.259669	97	137	4	2	40	0.0500000
NODE_204468_length_280_cov_34.259669	97	137	8	4	40	0.1000000
NODE_204468_length_280_cov_34.259669	97	137	12	7	40	0.1750000
NODE_204468_length_280_cov_34.259669	97	137	13	3	40	0.0750000
NODE_204468_length_280_cov_34.259669	97	137	15	1	40	0.0250000
NODE_204468_length_280_cov_34.259669	97	137	17	4	40	0.1000000
NODE_204468_length_280_cov_34.259669	97	137	19	7	40	0.1750000
NODE_204532_length_280_cov_4.287293	53	100	0	12	47	0.2553191
NODE_204532_length_280_cov_4.287293	53	100	2	22	47	0.4680851
NODE_204532_length_280_cov_4.287293	53	100	4	4	47	0.0851064
NODE_204532_length_280_cov_4.287293	53	100	6	9	47	0.1914894
NODE_204532_length_280_cov_4.287293	129	186	8	57	57	1.0000000
NODE_204596_length_280_cov_3.436464	34	103	16	1	69	0.0144928
NODE_204596_length_280_cov_3.436464	34	103	18	5	69	0.0724638
NODE_204596_length_280_cov_3.436464	34	103	20	1	69	0.0144928
NODE_204596_length_280_cov_3.436464	34	103	22	3	69	0.0434783
NODE_204596_length_280_cov_3.436464	34	103	24	1	69	0.0144928
NODE_204596_length_280_cov_3.436464	34	103	26	5	69	0.0724638
NODE_204596_length_280_cov_3.436464	34	103	30	1	69	0.0144928
NODE_204596_length_280_cov_3.436464	34	103	34	4	69	0.0579710
NODE_204596_length_280_cov_3.436464	34	103	36	3	69	0.0434783
NODE_204596_length_280_cov_3.436464	34	103	38	4	69	0.0579710
NODE_204596_length_280_cov_3.436464	34	103	40	3	69	0.0434783
NODE_204596_length_280_cov_3.436464	34	103	46	3	69	0.0434783
NODE_204596_length_280_cov_3.436464	34	103	48	3	69	0.0434783
NODE_204596_length_280_cov_3.436464	34	103	50	6	69	0.0869565
NODE_204596_length_280_cov_3.436464	34	103	52	26	69	0.3768116
NODE_204597_length_280_cov_3.430939	17	97	2	4	80	0.0500000
NODE_204597_length_280_cov_3.430939	17	97	4	76	80	0.9500000
NODE_204597_length_280_cov_3.430939	27	97	2	3	70	0.0428571
NODE_204597_length_280_cov_3.430939	27	97	4	67	70	0.9571428
NODE_204674_length_280_cov_2.988950	118	164	0	46	46	1.0000000
NODE_204938_length_280_cov_2.165746	2	48	0	46	46	1.0000000
NODE_204938_length_280_cov_2.165746	6	48	0	42	42	1.0000000
NODE_204938_length_280_cov_2.165746	21	101	0	80	80	1.0000000
NODE_204938_length_280_cov_2.165746	22	101	0	79	79	1.0000000
NODE_204938_length_280_cov_2.165746	32	101	0	69	69	1.0000000
NODE_204976_length_280_cov_2.022099	105	148	0	5	43	0.1162791
NODE_204976_length_280_cov_2.022099	105	148	2	38	43	0.8837209
NODE_204976_length_280_cov_2.022099	121	148	2	27	27	1.0000000
NODE_205044_length_280_cov_1.889503	50	132	0	4	82	0.0487805
NODE_205044_length_280_cov_1.889503	50	132	4	78	82	0.9512195
NODE_205062_length_280_cov_1.828729	45	75	38	2	30	0.0666667
NODE_205062_length_280_cov_1.828729	45	75	39	2	30	0.0666667
NODE_205062_length_280_cov_1.828729	45	75	41	1	30	0.0333333
NODE_205062_length_280_cov_1.828729	45	75	45	2	30	0.0666667
NODE_205062_length_280_cov_1.828729	45	75	47	1	30	0.0333333
NODE_205062_length_280_cov_1.828729	45	75	48	1	30	0.0333333
NODE_205062_length_280_cov_1.828729	45	75	50	3	30	0.1000000
NODE_205062_length_280_cov_1.828729	45	75	54	2	30	0.0666667
NODE_205062_length_280_cov_1.828729	45	75	56	1	30	0.0333333
NODE_205062_length_280_cov_1.828729	45	75	57	1	30	0.0333333
NODE_205062_length_280_cov_1.828729	45	75	59	3	30	0.1000000
NODE_205062_length_280_cov_1.828729	45	75	61	11	30	0.3666667
NODE_205410_length_280_cov_1.425414	17	50	0	33	33	1.0000000
NODE_205410_length_280_cov_1.425414	70	112	0	42	42	1.0000000
NODE_205416_length_280_cov_1.414365	37	97	2	26	60	0.4333333
NODE_205416_length_280_cov_1.414365	37	97	4	34	60	0.5666667
NODE_205633_length_280_cov_1.187845	56	136	0	80	80	1.0000000
NODE_205635_length_280_cov_1.182320	154	234	0	11	80	0.1375000
NODE_205635_length_280_cov_1.182320	154	234	2	5	80	0.0625000
NODE_205635_length_280_cov_1.182320	154	234	4	20	80	0.2500000
NODE_205635_length_280_cov_1.182320	154	234	6	5	80	0.0625000
NODE_205635_length_280_cov_1.182320	154	234	8	39	80	0.4875000
NODE_205635_length_280_cov_1.182320	207	280	0	57	73	0.7808219
NODE_205635_length_280_cov_1.182320	207	280	2	5	73	0.0684932
NODE_205635_length_280_cov_1.182320	207	280	4	11	73	0.1506849
NODE_205701_length_280_cov_1.127072	204	265	4	3	61	0.0491803
NODE_205701_length_280_cov_1.127072	204	265	6	14	61	0.2295082
NODE_205701_length_280_cov_1.127072	204	265	8	27	61	0.4426230
NODE_205701_length_280_cov_1.127072	204	265	10	17	61	0.2786885
NODE_205794_length_280_cov_1.127072	0	39	0	39	39	1.0000000
NODE_205801_length_280_cov_1.127072	218	253	0	35	35	1.0000000
NODE_205894_length_280_cov_1.127072	0	59	0	59	59	1.0000000
NODE_206211_length_280_cov_0.911602	176	256	0	3	80	0.0375000
NODE_206211_length_280_cov_0.911602	176	256	2	77	80	0.9625000
NODE_206211_length_280_cov_0.911602	229	280	0	27	51	0.5294118
NODE_206211_length_280_cov_0.911602	229	280	2	24	51	0.4705882
NODE_206319_length_280_cov_0.845304	211	268	0	57	57	1.0000000
NODE_206531_length_280_cov_0.779006	129	203	14	9	74	0.1216216
NODE_206531_length_280_cov_0.779006	129	203	16	12	74	0.1621622
NODE_206531_length_280_cov_0.779006	129	203	18	39	74	0.5270270
NODE_206531_length_280_cov_0.779006	129	203	20	14	74	0.1891892
NODE_206721_length_279_cov_50.005556	51	130	40	6	79	0.0759494
NODE_206721_length_279_cov_50.005556	51	130	42	1	79	0.0126582
NODE_206721_length_279_cov_50.005556	51	130	46	5	79	0.0632911
NODE_206721_length_279_cov_50.005556	51	130	48	7	79	0.0886076
NODE_206721_length_279_cov_50.005556	51	130	50	11	79	0.1392405
NODE_206721_length_279_cov_50.005556	51	130	52	7	79	0.0886076
NODE_206721_length_279_cov_50.005556	51	130	54	13	79	0.1645570
NODE_206721_length_279_cov_50.005556	51	130	56	3	79	0.0379747
NODE_206721_length_279_cov_50.005556	51	130	58	21	79	0.2658228
NODE_206721_length_279_cov_50.005556	51	130	60	5	79	0.0632911
NODE_206721_length_279_cov_50.005556	103	179	2	9	76	0.1184211
NODE_206721_length_279_cov_50.005556	103	179	6	3	76	0.0394737
NODE_206721_length_279_cov_50.005556	103	179	8	11	76	0.1447368
NODE_206721_length_279_cov_50.005556	103	179	10	1	76	0.0131579
NODE_206721_length_279_cov_50.005556	103	179	22	1	76	0.0131579
NODE_206721_length_279_cov_50.005556	103	179	26	10	76	0.1315790
NODE_206721_length_279_cov_50.005556	103	179	29	1	76	0.0131579
NODE_206721_length_279_cov_50.005556	103	179	36	6	76	0.0789474
NODE_206721_length_279_cov_50.005556	103	179	38	4	76	0.0526316
NODE_206721_length_279_cov_50.005556	103	179	40	9	76	0.1184211
NODE_206721_length_279_cov_50.005556	103	179	42	1	76	0.0131579
NODE_206721_length_279_cov_50.005556	103	179	50	4	76	0.0526316
NODE_206721_length_279_cov_50.005556	103	179	52	1	76	0.0131579
NODE_206721_length_279_cov_50.005556	103	179	54	3	76	0.0394737
NODE_206721_length_279_cov_50.005556	103	179	56	1	76	0.0131579
NODE_206721_length_279_cov_50.005556	103	179	58	7	76	0.0921053
NODE_206721_length_279_cov_50.005556	103	179	60	4	76	0.0526316
NODE_206744_length_279_cov_6.055556	196	228	0	32	32	1.0000000
NODE_206762_length_279_cov_5.166667	197	277	0	80	80	1.0000000
NODE_206788_length_279_cov_4.427778	107	187	0	6	80	0.0750000
NODE_206788_length_279_cov_4.427778	107	187	2	74	80	0.9250000
NODE_206879_length_279_cov_3.200000	205	225	0	20	20	1.0000000
NODE_206886_length_279_cov_3.116667	115	195	0	44	80	0.5500000
NODE_206886_length_279_cov_3.116667	115	195	2	36	80	0.4500000
NODE_206886_length_279_cov_3.116667	168	248	0	76	80	0.9500000
NODE_206886_length_279_cov_3.116667	168	248	2	4	80	0.0500000
NODE_206972_length_279_cov_2.600000	67	147	2	21	80	0.2625000
NODE_206972_length_279_cov_2.600000	67	147	6	42	80	0.5250000
NODE_206972_length_279_cov_2.600000	67	147	8	17	80	0.2125000
NODE_206972_length_279_cov_2.600000	120	199	0	9	79	0.1139240
NODE_206972_length_279_cov_2.600000	120	199	2	64	79	0.8101266
NODE_206972_length_279_cov_2.600000	120	199	6	6	79	0.0759494
NODE_207023_length_279_cov_2.427778	155	199	2	44	44	1.0000000
NODE_207052_length_279_cov_2.283333	168	240	0	72	72	1.0000000
NODE_207054_length_279_cov_2.277778	190	265	0	75	75	1.0000000
NODE_207086_length_279_cov_2.266667	66	109	0	43	43	1.0000000
NODE_207115_length_279_cov_2.255556	115	176	4	21	61	0.3442623
NODE_207115_length_279_cov_2.255556	115	176	6	3	61	0.0491803
NODE_207115_length_279_cov_2.255556	115	176	8	37	61	0.6065574
NODE_207115_length_279_cov_2.255556	168	222	2	28	54	0.5185185
NODE_207115_length_279_cov_2.255556	168	222	4	20	54	0.3703704
NODE_207115_length_279_cov_2.255556	168	222	8	6	54	0.1111111
NODE_207155_length_279_cov_2.200000	57	104	0	2	47	0.0425532
NODE_207155_length_279_cov_2.200000	57	104	2	10	47	0.2127660
NODE_207155_length_279_cov_2.200000	57	104	4	2	47	0.0425532
NODE_207155_length_279_cov_2.200000	57	104	6	4	47	0.0851064
NODE_207155_length_279_cov_2.200000	57	104	8	29	47	0.6170213
NODE_207269_length_279_cov_1.977778	0	62	0	62	62	1.0000000
NODE_207293_length_279_cov_1.944444	63	105	0	42	42	1.0000000
NODE_207306_length_279_cov_1.916667	182	262	0	80	80	1.0000000
NODE_207318_length_279_cov_1.866667	63	143	0	23	80	0.2875000
NODE_207318_length_279_cov_1.866667	63	143	2	57	80	0.7125000
NODE_207387_length_279_cov_1.700000	8	37	0	29	29	1.0000000
NODE_207389_length_279_cov_1.700000	10	42	0	32	32	1.0000000
NODE_207534_length_279_cov_1.672222	103	183	0	9	80	0.1125000
NODE_207534_length_279_cov_1.672222	103	183	2	71	80	0.8875000
NODE_207641_length_279_cov_1.433333	51	110	2	52	59	0.8813559
NODE_207641_length_279_cov_1.433333	51	110	4	7	59	0.1186441
NODE_207641_length_279_cov_1.433333	83	119	2	28	36	0.7777778
NODE_207641_length_279_cov_1.433333	83	119	4	8	36	0.2222222
NODE_207929_length_279_cov_1.144444	146	211	2	4	65	0.0615385
NODE_207929_length_279_cov_1.144444	146	211	4	61	65	0.9384615
NODE_207929_length_279_cov_1.144444	184	266	0	23	82	0.2804878
NODE_207929_length_279_cov_1.144444	184	266	2	14	82	0.1707317
NODE_207929_length_279_cov_1.144444	184	266	4	45	82	0.5487805
NODE_207931_length_279_cov_1.138889	125	188	18	1	63	0.0158730
NODE_207931_length_279_cov_1.138889	125	188	20	1	63	0.0158730
NODE_207931_length_279_cov_1.138889	125	188	22	7	63	0.1111111
NODE_207931_length_279_cov_1.138889	125	188	26	20	63	0.3174603
NODE_207931_length_279_cov_1.138889	125	188	28	34	63	0.5396826
NODE_207932_length_279_cov_1.138889	111	191	0	80	80	1.0000000
NODE_207948_length_279_cov_1.133333	231	271	0	40	40	1.0000000
NODE_208183_length_279_cov_1.116667	15	92	0	16	77	0.2077922
NODE_208183_length_279_cov_1.116667	15	92	2	61	77	0.7922078
NODE_208334_length_279_cov_0.988889	181	261	0	23	80	0.2875000
NODE_208334_length_279_cov_0.988889	181	261	2	57	80	0.7125000
NODE_208410_length_279_cov_0.927778	50	69	0	19	19	1.0000000
NODE_208410_length_279_cov_0.927778	50	69	0	19	19	1.0000000
NODE_208664_length_279_cov_0.844444	35	70	0	35	35	1.0000000
NODE_209293_length_278_cov_44.882682	158	210	8	20	52	0.3846154
NODE_209293_length_278_cov_44.882682	158	210	12	18	52	0.3461539
NODE_209293_length_278_cov_44.882682	158	210	14	10	52	0.1923077
NODE_209293_length_278_cov_44.882682	158	210	16	1	52	0.0192308
NODE_209293_length_278_cov_44.882682	158	210	17	3	52	0.0576923
NODE_209293_length_278_cov_44.882682	206	232	8	26	26	1.0000000
NODE_209293_length_278_cov_44.882682	206	265	6	10	59	0.1694915
NODE_209293_length_278_cov_44.882682	206	265	8	49	59	0.8305085
NODE_209294_length_278_cov_37.474860	0	52	0	52	52	1.0000000
NODE_209294_length_278_cov_37.474860	48	128	0	57	80	0.7125000
NODE_209294_length_278_cov_37.474860	48	128	2	23	80	0.2875000
NODE_209294_length_278_cov_37.474860	101	181	0	4	80	0.0500000
NODE_209294_length_278_cov_37.474860	101	181	2	73	80	0.9125000
NODE_209294_length_278_cov_37.474860	101	181	4	3	80	0.0375000
NODE_209295_length_278_cov_21.340782	84	164	2	66	80	0.8250000
NODE_209295_length_278_cov_21.340782	84	164	4	14	80	0.1750000
NODE_209295_length_278_cov_21.340782	137	217	2	57	80	0.7125000
NODE_209295_length_278_cov_21.340782	137	217	4	23	80	0.2875000
NODE_209360_length_278_cov_4.156425	132	210	6	41	78	0.5256410
NODE_209360_length_278_cov_4.156425	132	210	8	24	78	0.3076923
NODE_209360_length_278_cov_4.156425	132	210	10	1	78	0.0128205
NODE_209360_length_278_cov_4.156425	132	210	12	2	78	0.0256410
NODE_209360_length_278_cov_4.156425	132	210	14	10	78	0.1282051
NODE_209360_length_278_cov_4.156425	193	263	2	10	70	0.1428571
NODE_209360_length_278_cov_4.156425	193	263	4	35	70	0.5000000
NODE_209360_length_278_cov_4.156425	193	263	6	25	70	0.3571429
NODE_209372_length_278_cov_3.977654	142	221	0	13	79	0.1645570
NODE_209372_length_278_cov_3.977654	142	221	2	66	79	0.8354430
NODE_209378_length_278_cov_3.865922	168	210	0	42	42	1.0000000
NODE_209552_length_278_cov_2.558659	93	123	0	30	30	1.0000000
NODE_209565_length_278_cov_2.513966	54	106	0	52	52	1.0000000
NODE_209565_length_278_cov_2.513966	79	158	0	49	79	0.6202531
NODE_209565_length_278_cov_2.513966	79	158	2	19	79	0.2405063
NODE_209565_length_278_cov_2.513966	79	158	4	11	79	0.1392405
NODE_209605_length_278_cov_2.296089	127	207	2	19	80	0.2375000
NODE_209605_length_278_cov_2.296089	127	207	4	61	80	0.7625000
NODE_209883_length_278_cov_1.731844	145	194	33	4	49	0.0816327
NODE_209883_length_278_cov_1.731844	145	194	34	3	49	0.0612245
NODE_209883_length_278_cov_1.731844	145	194	36	2	49	0.0408163
NODE_209883_length_278_cov_1.731844	145	194	37	2	49	0.0408163
NODE_209883_length_278_cov_1.731844	145	194	39	2	49	0.0408163
NODE_209883_length_278_cov_1.731844	145	194	41	5	49	0.1020408
NODE_209883_length_278_cov_1.731844	145	194	45	1	49	0.0204082
NODE_209883_length_278_cov_1.731844	145	194	48	8	49	0.1632653
NODE_209883_length_278_cov_1.731844	145	194	50	1	49	0.0204082
NODE_209883_length_278_cov_1.731844	145	194	51	2	49	0.0408163
NODE_209883_length_278_cov_1.731844	145	194	53	1	49	0.0204082
NODE_209883_length_278_cov_1.731844	145	194	54	11	49	0.2244898
NODE_209883_length_278_cov_1.731844	145	194	56	7	49	0.1428571
NODE_210038_length_278_cov_1.681564	129	184	6	55	55	1.0000000
NODE_210068_length_278_cov_1.636872	13	41	22	2	28	0.0714286
NODE_210068_length_278_cov_1.636872	13	41	26	2	28	0.0714286
NODE_210068_length_278_cov_1.636872	13	41	28	24	28	0.8571429
NODE_210373_length_278_cov_1.290503	3	67	25	4	64	0.0625000
NODE_210373_length_278_cov_1.290503	3	67	30	1	64	0.0156250
NODE_210373_length_278_cov_1.290503	3	67	40	3	64	0.0468750
NODE_210373_length_278_cov_1.290503	3	67	43	2	64	0.0312500
NODE_210373_length_278_cov_1.290503	3	67	45	1	64	0.0156250
NODE_210373_length_278_cov_1.290503	3	67	46	1	64	0.0156250
NODE_210373_length_278_cov_1.290503	3	67	61	1	64	0.0156250
NODE_210373_length_278_cov_1.290503	3	67	62	3	64	0.0468750
NODE_210373_length_278_cov_1.290503	3	67	63	1	64	0.0156250
NODE_210373_length_278_cov_1.290503	3	67	70	3	64	0.0468750
NODE_210373_length_278_cov_1.290503	3	67	74	1	64	0.0156250
NODE_210373_length_278_cov_1.290503	3	67	75	1	64	0.0156250
NODE_210373_length_278_cov_1.290503	3	67	77	1	64	0.0156250
NODE_210373_length_278_cov_1.290503	3	67	79	1	64	0.0156250
NODE_210373_length_278_cov_1.290503	3	67	80	1	64	0.0156250
NODE_210373_length_278_cov_1.290503	3	67	81	1	64	0.0156250
NODE_210373_length_278_cov_1.290503	3	67	82	1	64	0.0156250
NODE_210373_length_278_cov_1.290503	3	67	83	1	64	0.0156250
NODE_210373_length_278_cov_1.290503	3	67	85	1	64	0.0156250
NODE_210373_length_278_cov_1.290503	3	67	87	4	64	0.0625000
NODE_210373_length_278_cov_1.290503	3	67	88	4	64	0.0625000
NODE_210373_length_278_cov_1.290503	3	67	89	2	64	0.0312500
NODE_210373_length_278_cov_1.290503	3	67	91	2	64	0.0312500
NODE_210373_length_278_cov_1.290503	3	67	93	1	64	0.0156250
NODE_210373_length_278_cov_1.290503	3	67	96	3	64	0.0468750
NODE_210373_length_278_cov_1.290503	3	67	97	2	64	0.0312500
NODE_210373_length_278_cov_1.290503	3	67	99	13	64	0.2031250
NODE_210373_length_278_cov_1.290503	3	67	103	1	64	0.0156250
NODE_210373_length_278_cov_1.290503	3	67	104	2	64	0.0312500
NODE_210373_length_278_cov_1.290503	3	67	106	1	64	0.0156250
NODE_210373_length_278_cov_1.290503	3	67	25	4	64	0.0625000
NODE_210373_length_278_cov_1.290503	3	67	30	1	64	0.0156250
NODE_210373_length_278_cov_1.290503	3	67	40	3	64	0.0468750
NODE_210373_length_278_cov_1.290503	3	67	43	2	64	0.0312500
NODE_210373_length_278_cov_1.290503	3	67	45	1	64	0.0156250
NODE_210373_length_278_cov_1.290503	3	67	46	1	64	0.0156250
NODE_210373_length_278_cov_1.290503	3	67	61	1	64	0.0156250
NODE_210373_length_278_cov_1.290503	3	67	62	3	64	0.0468750
NODE_210373_length_278_cov_1.290503	3	67	63	1	64	0.0156250
NODE_210373_length_278_cov_1.290503	3	67	70	3	64	0.0468750
NODE_210373_length_278_cov_1.290503	3	67	74	1	64	0.0156250
NODE_210373_length_278_cov_1.290503	3	67	75	1	64	0.0156250
NODE_210373_length_278_cov_1.290503	3	67	77	1	64	0.0156250
NODE_210373_length_278_cov_1.290503	3	67	79	1	64	0.0156250
NODE_210373_length_278_cov_1.290503	3	67	80	1	64	0.0156250
NODE_210373_length_278_cov_1.290503	3	67	81	1	64	0.0156250
NODE_210373_length_278_cov_1.290503	3	67	82	1	64	0.0156250
NODE_210373_length_278_cov_1.290503	3	67	83	1	64	0.0156250
NODE_210373_length_278_cov_1.290503	3	67	85	1	64	0.0156250
NODE_210373_length_278_cov_1.290503	3	67	87	4	64	0.0625000
NODE_210373_length_278_cov_1.290503	3	67	88	4	64	0.0625000
NODE_210373_length_278_cov_1.290503	3	67	89	2	64	0.0312500
NODE_210373_length_278_cov_1.290503	3	67	91	2	64	0.0312500
NODE_210373_length_278_cov_1.290503	3	67	93	1	64	0.0156250
NODE_210373_length_278_cov_1.290503	3	67	96	3	64	0.0468750
NODE_210373_length_278_cov_1.290503	3	67	97	2	64	0.0312500
NODE_210373_length_278_cov_1.290503	3	67	99	13	64	0.2031250
NODE_210373_length_278_cov_1.290503	3	67	103	1	64	0.0156250
NODE_210373_length_278_cov_1.290503	3	67	104	2	64	0.0312500
NODE_210373_length_278_cov_1.290503	3	67	106	1	64	0.0156250
NODE_210373_length_278_cov_1.290503	3	67	25	4	64	0.0625000
NODE_210373_length_278_cov_1.290503	3	67	30	1	64	0.0156250
NODE_210373_length_278_cov_1.290503	3	67	40	3	64	0.0468750
NODE_210373_length_278_cov_1.290503	3	67	43	2	64	0.0312500
NODE_210373_length_278_cov_1.290503	3	67	45	1	64	0.0156250
NODE_210373_length_278_cov_1.290503	3	67	46	1	64	0.0156250
NODE_210373_length_278_cov_1.290503	3	67	61	1	64	0.0156250
NODE_210373_length_278_cov_1.290503	3	67	62	3	64	0.0468750
NODE_210373_length_278_cov_1.290503	3	67	63	1	64	0.0156250
NODE_210373_length_278_cov_1.290503	3	67	70	3	64	0.0468750
NODE_210373_length_278_cov_1.290503	3	67	74	1	64	0.0156250
NODE_210373_length_278_cov_1.290503	3	67	75	1	64	0.0156250
NODE_210373_length_278_cov_1.290503	3	67	77	1	64	0.0156250
NODE_210373_length_278_cov_1.290503	3	67	79	1	64	0.0156250
NODE_210373_length_278_cov_1.290503	3	67	80	1	64	0.0156250
NODE_210373_length_278_cov_1.290503	3	67	81	1	64	0.0156250
NODE_210373_length_278_cov_1.290503	3	67	82	1	64	0.0156250
NODE_210373_length_278_cov_1.290503	3	67	83	1	64	0.0156250
NODE_210373_length_278_cov_1.290503	3	67	85	1	64	0.0156250
NODE_210373_length_278_cov_1.290503	3	67	87	4	64	0.0625000
NODE_210373_length_278_cov_1.290503	3	67	88	4	64	0.0625000
NODE_210373_length_278_cov_1.290503	3	67	89	2	64	0.0312500
NODE_210373_length_278_cov_1.290503	3	67	91	2	64	0.0312500
NODE_210373_length_278_cov_1.290503	3	67	93	1	64	0.0156250
NODE_210373_length_278_cov_1.290503	3	67	96	3	64	0.0468750
NODE_210373_length_278_cov_1.290503	3	67	97	2	64	0.0312500
NODE_210373_length_278_cov_1.290503	3	67	99	13	64	0.2031250
NODE_210373_length_278_cov_1.290503	3	67	103	1	64	0.0156250
NODE_210373_length_278_cov_1.290503	3	67	104	2	64	0.0312500
NODE_210373_length_278_cov_1.290503	3	67	106	1	64	0.0156250
NODE_210463_length_278_cov_1.150838	52	76	0	24	24	1.0000000
NODE_210463_length_278_cov_1.150838	58	84	0	26	26	1.0000000
NODE_210559_length_278_cov_1.139665	108	187	0	36	79	0.4556962
NODE_210559_length_278_cov_1.139665	108	187	2	37	79	0.4683544
NODE_210559_length_278_cov_1.139665	108	187	4	6	79	0.0759494
NODE_210612_length_278_cov_1.139665	232	278	0	46	46	1.0000000
NODE_210691_length_278_cov_1.139665	210	278	0	68	68	1.0000000
NODE_212166_length_277_cov_2.691011	0	60	0	60	60	1.0000000
NODE_212166_length_277_cov_2.691011	33	113	0	80	80	1.0000000
NODE_212175_length_277_cov_2.617978	85	127	2	42	42	1.0000000
NODE_212233_length_277_cov_2.438202	137	218	2	1	81	0.0123457
NODE_212233_length_277_cov_2.438202	137	218	4	65	81	0.8024691
NODE_212233_length_277_cov_2.438202	137	218	6	15	81	0.1851852
NODE_212357_length_277_cov_2.140449	234	276	0	42	42	1.0000000
NODE_212377_length_277_cov_2.095506	41	114	0	73	73	1.0000000
NODE_212377_length_277_cov_2.095506	41	114	0	73	73	1.0000000
NODE_212377_length_277_cov_2.095506	94	161	0	67	67	1.0000000
NODE_212525_length_277_cov_1.837079	92	172	0	10	80	0.1250000
NODE_212525_length_277_cov_1.837079	92	172	1	4	80	0.0500000
NODE_212525_length_277_cov_1.837079	92	172	2	22	80	0.2750000
NODE_212525_length_277_cov_1.837079	92	172	4	44	80	0.5500000
NODE_212558_length_277_cov_1.764045	115	155	0	17	40	0.4250000
NODE_212558_length_277_cov_1.764045	115	155	2	10	40	0.2500000
NODE_212558_length_277_cov_1.764045	115	155	4	1	40	0.0250000
NODE_212558_length_277_cov_1.764045	115	155	6	10	40	0.2500000
NODE_212558_length_277_cov_1.764045	115	155	8	2	40	0.0500000
NODE_212605_length_277_cov_1.719101	150	215	0	65	65	1.0000000
NODE_212845_length_277_cov_1.505618	0	47	0	47	47	1.0000000
NODE_212845_length_277_cov_1.505618	20	100	0	80	80	1.0000000
NODE_212970_length_277_cov_1.426966	113	191	0	36	78	0.4615385
NODE_212970_length_277_cov_1.426966	113	191	4	42	78	0.5384616
NODE_213057_length_277_cov_1.314607	127	176	2	9	49	0.1836735
NODE_213057_length_277_cov_1.314607	127	176	4	3	49	0.0612245
NODE_213057_length_277_cov_1.314607	127	176	6	17	49	0.3469388
NODE_213057_length_277_cov_1.314607	127	176	10	20	49	0.4081633
NODE_213091_length_277_cov_1.258427	141	222	0	68	81	0.8395061
NODE_213091_length_277_cov_1.258427	141	222	2	13	81	0.1604938
NODE_213223_length_277_cov_1.146067	19	95	2	14	76	0.1842105
NODE_213223_length_277_cov_1.146067	19	95	4	4	76	0.0526316
NODE_213223_length_277_cov_1.146067	19	95	6	41	76	0.5394737
NODE_213223_length_277_cov_1.146067	19	95	8	4	76	0.0526316
NODE_213223_length_277_cov_1.146067	19	95	10	10	76	0.1315790
NODE_213223_length_277_cov_1.146067	19	95	12	3	76	0.0394737
NODE_213490_length_277_cov_1.061798	67	105	0	17	38	0.4473684
NODE_213490_length_277_cov_1.061798	67	105	2	1	38	0.0263158
NODE_213490_length_277_cov_1.061798	67	105	4	20	38	0.5263158
NODE_213505_length_277_cov_1.044944	19	77	0	58	58	1.0000000
NODE_214572_length_276_cov_31.774011	91	153	40	1	62	0.0161290
NODE_214572_length_276_cov_31.774011	91	153	42	2	62	0.0322581
NODE_214572_length_276_cov_31.774011	91	153	46	2	62	0.0322581
NODE_214572_length_276_cov_31.774011	91	153	48	2	62	0.0322581
NODE_214572_length_276_cov_31.774011	91	153	49	1	62	0.0161290
NODE_214572_length_276_cov_31.774011	91	153	53	2	62	0.0322581
NODE_214572_length_276_cov_31.774011	91	153	55	1	62	0.0161290
NODE_214572_length_276_cov_31.774011	91	153	57	3	62	0.0483871
NODE_214572_length_276_cov_31.774011	91	153	59	1	62	0.0161290
NODE_214572_length_276_cov_31.774011	91	153	61	1	62	0.0161290
NODE_214572_length_276_cov_31.774011	91	153	63	2	62	0.0322581
NODE_214572_length_276_cov_31.774011	91	153	70	1	62	0.0161290
NODE_214572_length_276_cov_31.774011	91	153	72	1	62	0.0161290
NODE_214572_length_276_cov_31.774011	91	153	73	1	62	0.0161290
NODE_214572_length_276_cov_31.774011	91	153	80	1	62	0.0161290
NODE_214572_length_276_cov_31.774011	91	153	81	1	62	0.0161290
NODE_214572_length_276_cov_31.774011	91	153	82	1	62	0.0161290
NODE_214572_length_276_cov_31.774011	91	153	86	5	62	0.0806452
NODE_214572_length_276_cov_31.774011	91	153	94	1	62	0.0161290
NODE_214572_length_276_cov_31.774011	91	153	95	1	62	0.0161290
NODE_214572_length_276_cov_31.774011	91	153	99	1	62	0.0161290
NODE_214572_length_276_cov_31.774011	91	153	103	1	62	0.0161290
NODE_214572_length_276_cov_31.774011	91	153	106	1	62	0.0161290
NODE_214572_length_276_cov_31.774011	91	153	114	1	62	0.0161290
NODE_214572_length_276_cov_31.774011	91	153	116	1	62	0.0161290
NODE_214572_length_276_cov_31.774011	91	153	122	1	62	0.0161290
NODE_214572_length_276_cov_31.774011	91	153	128	1	62	0.0161290
NODE_214572_length_276_cov_31.774011	91	153	130	1	62	0.0161290
NODE_214572_length_276_cov_31.774011	91	153	135	1	62	0.0161290
NODE_214572_length_276_cov_31.774011	91	153	146	1	62	0.0161290
NODE_214572_length_276_cov_31.774011	91	153	151	2	62	0.0322581
NODE_214572_length_276_cov_31.774011	91	153	152	1	62	0.0161290
NODE_214572_length_276_cov_31.774011	91	153	156	2	62	0.0322581
NODE_214572_length_276_cov_31.774011	91	153	158	1	62	0.0161290
NODE_214572_length_276_cov_31.774011	91	153	162	1	62	0.0161290
NODE_214572_length_276_cov_31.774011	91	153	168	1	62	0.0161290
NODE_214572_length_276_cov_31.774011	91	153	175	1	62	0.0161290
NODE_214572_length_276_cov_31.774011	91	153	182	2	62	0.0322581
NODE_214572_length_276_cov_31.774011	91	153	187	2	62	0.0322581
NODE_214572_length_276_cov_31.774011	91	153	201	2	62	0.0322581
NODE_214572_length_276_cov_31.774011	91	153	203	3	62	0.0483871
NODE_214572_length_276_cov_31.774011	91	153	207	2	62	0.0322581
NODE_214572_length_276_cov_31.774011	91	153	208	1	62	0.0161290
NODE_214576_length_276_cov_10.056497	66	146	0	60	80	0.7500000
NODE_214576_length_276_cov_10.056497	66	146	4	4	80	0.0500000
NODE_214576_length_276_cov_10.056497	66	146	6	16	80	0.2000000
NODE_214698_length_276_cov_3.564972	176	256	2	2	80	0.0250000
NODE_214698_length_276_cov_3.564972	176	256	5	4	80	0.0500000
NODE_214698_length_276_cov_3.564972	176	256	6	18	80	0.2250000
NODE_214698_length_276_cov_3.564972	176	256	8	56	80	0.7000000
NODE_214785_length_276_cov_2.920904	203	260	0	57	57	1.0000000
NODE_214785_length_276_cov_2.920904	233	276	0	43	43	1.0000000
NODE_214883_length_276_cov_2.542373	164	204	12	20	40	0.5000000
NODE_214883_length_276_cov_2.542373	164	204	14	20	40	0.5000000
NODE_215016_length_276_cov_2.197740	64	144	10	13	80	0.1625000
NODE_215016_length_276_cov_2.197740	64	144	12	8	80	0.1000000
NODE_215016_length_276_cov_2.197740	64	144	14	40	80	0.5000000
NODE_215016_length_276_cov_2.197740	64	144	16	19	80	0.2375000
NODE_215086_length_276_cov_2.022599	136	193	0	31	57	0.5438597
NODE_215086_length_276_cov_2.022599	136	193	2	21	57	0.3684210
NODE_215086_length_276_cov_2.022599	136	193	4	5	57	0.0877193
NODE_215105_length_276_cov_2.016949	97	138	0	37	41	0.9024390
NODE_215105_length_276_cov_2.016949	97	138	2	4	41	0.0975610
NODE_215139_length_276_cov_2.005650	82	153	0	17	71	0.2394366
NODE_215139_length_276_cov_2.005650	82	153	2	54	71	0.7605634
NODE_215234_length_276_cov_1.734463	102	182	8	1	80	0.0125000
NODE_215234_length_276_cov_1.734463	102	182	10	5	80	0.0625000
NODE_215234_length_276_cov_1.734463	102	182	14	1	80	0.0125000
NODE_215234_length_276_cov_1.734463	102	182	16	1	80	0.0125000
NODE_215234_length_276_cov_1.734463	102	182	18	5	80	0.0625000
NODE_215234_length_276_cov_1.734463	102	182	20	4	80	0.0500000
NODE_215234_length_276_cov_1.734463	102	182	24	10	80	0.1250000
NODE_215234_length_276_cov_1.734463	102	182	26	2	80	0.0250000
NODE_215234_length_276_cov_1.734463	102	182	28	1	80	0.0125000
NODE_215234_length_276_cov_1.734463	102	182	32	4	80	0.0500000
NODE_215234_length_276_cov_1.734463	102	182	34	21	80	0.2625000
NODE_215234_length_276_cov_1.734463	102	182	36	1	80	0.0125000
NODE_215234_length_276_cov_1.734463	102	182	40	4	80	0.0500000
NODE_215234_length_276_cov_1.734463	102	182	42	2	80	0.0250000
NODE_215234_length_276_cov_1.734463	102	182	44	4	80	0.0500000
NODE_215234_length_276_cov_1.734463	102	182	46	7	80	0.0875000
NODE_215234_length_276_cov_1.734463	102	182	47	7	80	0.0875000
NODE_215516_length_276_cov_1.525424	70	116	2	23	46	0.5000000
NODE_215516_length_276_cov_1.525424	70	116	4	23	46	0.5000000
NODE_215516_length_276_cov_1.525424	123	169	2	1	46	0.0217391
NODE_215516_length_276_cov_1.525424	123	169	4	9	46	0.1956522
NODE_215516_length_276_cov_1.525424	123	169	6	36	46	0.7826087
NODE_215519_length_276_cov_1.514124	115	155	24	40	40	1.0000000
NODE_215748_length_276_cov_1.288136	114	154	8	13	40	0.3250000
NODE_215748_length_276_cov_1.288136	114	154	10	27	40	0.6750000
NODE_216141_length_276_cov_1.124294	122	170	2	1	48	0.0208333
NODE_216141_length_276_cov_1.124294	122	170	6	47	48	0.9791667
NODE_216141_length_276_cov_1.124294	132	163	6	31	31	1.0000000
NODE_216220_length_276_cov_1.039548	7	68	0	61	61	1.0000000
NODE_216220_length_276_cov_1.039548	7	70	0	63	63	1.0000000
NODE_216220_length_276_cov_1.039548	7	70	0	63	63	1.0000000
NODE_216220_length_276_cov_1.039548	7	70	0	63	63	1.0000000
NODE_216269_length_276_cov_1.000000	48	89	0	41	41	1.0000000
NODE_216269_length_276_cov_1.000000	62	106	0	44	44	1.0000000
NODE_216414_length_276_cov_0.898305	54	105	0	51	51	1.0000000
NODE_217265_length_275_cov_85.085227	94	174	0	4	80	0.0500000
NODE_217265_length_275_cov_85.085227	94	174	4	14	80	0.1750000
NODE_217265_length_275_cov_85.085227	94	174	6	7	80	0.0875000
NODE_217265_length_275_cov_85.085227	94	174	8	55	80	0.6875000
NODE_217265_length_275_cov_85.085227	147	227	0	57	80	0.7125000
NODE_217265_length_275_cov_85.085227	147	227	4	14	80	0.1750000
NODE_217265_length_275_cov_85.085227	147	227	6	7	80	0.0875000
NODE_217265_length_275_cov_85.085227	147	227	8	2	80	0.0250000
NODE_217287_length_275_cov_5.818182	0	44	0	44	44	1.0000000
NODE_217355_length_275_cov_3.857955	0	67	0	67	67	1.0000000
NODE_217396_length_275_cov_3.306818	199	275	0	76	76	1.0000000
NODE_217402_length_275_cov_3.284091	127	175	0	6	48	0.1250000
NODE_217402_length_275_cov_3.284091	127	175	2	42	48	0.8750000
NODE_217433_length_275_cov_2.977273	95	145	8	2	50	0.0400000
NODE_217433_length_275_cov_2.977273	95	145	10	2	50	0.0400000
NODE_217433_length_275_cov_2.977273	95	145	12	46	50	0.9200000
NODE_217531_length_275_cov_2.585227	85	122	72	18	37	0.4864865
NODE_217531_length_275_cov_2.585227	85	122	74	19	37	0.5135135
NODE_217714_length_275_cov_2.090909	0	47	0	8	47	0.1702128
NODE_217714_length_275_cov_2.090909	0	47	7	1	47	0.0212766
NODE_217714_length_275_cov_2.090909	0	47	8	38	47	0.8085107
NODE_217714_length_275_cov_2.090909	20	91	8	71	71	1.0000000
NODE_217801_length_275_cov_1.960227	198	251	0	53	53	1.0000000
NODE_217835_length_275_cov_1.875000	190	247	0	57	57	1.0000000
NODE_217839_length_275_cov_1.857955	52	119	2	67	67	1.0000000
NODE_217839_length_275_cov_1.857955	136	182	4	6	46	0.1304348
NODE_217839_length_275_cov_1.857955	136	182	6	40	46	0.8695652
NODE_217885_length_275_cov_1.755682	21	76	0	24	55	0.4363636
NODE_217885_length_275_cov_1.755682	21	76	2	31	55	0.5636364
NODE_217912_length_275_cov_1.738636	225	256	0	31	31	1.0000000
NODE_217967_length_275_cov_1.738636	161	241	0	2	80	0.0250000
NODE_217967_length_275_cov_1.738636	161	241	4	78	80	0.9750000
NODE_218257_length_275_cov_1.448864	123	155	24	32	32	1.0000000
NODE_218402_length_275_cov_1.301136	132	196	0	64	64	1.0000000
NODE_218706_length_275_cov_1.159091	13	93	0	80	80	1.0000000
NODE_218734_length_275_cov_1.153409	11	91	6	80	80	1.0000000
NODE_219031_length_275_cov_0.937500	13	49	15	2	36	0.0555556
NODE_219031_length_275_cov_0.937500	13	49	19	4	36	0.1111111
NODE_219031_length_275_cov_0.937500	13	49	23	2	36	0.0555556
NODE_219031_length_275_cov_0.937500	13	49	29	5	36	0.1388889
NODE_219031_length_275_cov_0.937500	13	49	31	2	36	0.0555556
NODE_219031_length_275_cov_0.937500	13	49	32	1	36	0.0277778
NODE_219031_length_275_cov_0.937500	13	49	33	3	36	0.0833333
NODE_219031_length_275_cov_0.937500	13	49	36	3	36	0.0833333
NODE_219031_length_275_cov_0.937500	13	49	37	3	36	0.0833333
NODE_219031_length_275_cov_0.937500	13	49	39	1	36	0.0277778
NODE_219031_length_275_cov_0.937500	13	49	42	1	36	0.0277778
NODE_219031_length_275_cov_0.937500	13	49	44	1	36	0.0277778
NODE_219031_length_275_cov_0.937500	13	49	45	1	36	0.0277778
NODE_219031_length_275_cov_0.937500	13	49	47	1	36	0.0277778
NODE_219031_length_275_cov_0.937500	13	49	49	3	36	0.0833333
NODE_219031_length_275_cov_0.937500	13	49	53	1	36	0.0277778
NODE_219031_length_275_cov_0.937500	13	49	54	2	36	0.0555556
NODE_219031_length_275_cov_0.937500	22	86	29	4	64	0.0625000
NODE_219031_length_275_cov_0.937500	22	86	31	2	64	0.0312500
NODE_219031_length_275_cov_0.937500	22	86	32	1	64	0.0156250
NODE_219031_length_275_cov_0.937500	22	86	33	3	64	0.0468750
NODE_219031_length_275_cov_0.937500	22	86	36	3	64	0.0468750
NODE_219031_length_275_cov_0.937500	22	86	37	3	64	0.0468750
NODE_219031_length_275_cov_0.937500	22	86	39	1	64	0.0156250
NODE_219031_length_275_cov_0.937500	22	86	42	1	64	0.0156250
NODE_219031_length_275_cov_0.937500	22	86	44	1	64	0.0156250
NODE_219031_length_275_cov_0.937500	22	86	45	1	64	0.0156250
NODE_219031_length_275_cov_0.937500	22	86	47	1	64	0.0156250
NODE_219031_length_275_cov_0.937500	22	86	49	3	64	0.0468750
NODE_219031_length_275_cov_0.937500	22	86	53	1	64	0.0156250
NODE_219031_length_275_cov_0.937500	22	86	54	10	64	0.1562500
NODE_219031_length_275_cov_0.937500	22	86	56	1	64	0.0156250
NODE_219031_length_275_cov_0.937500	22	86	59	1	64	0.0156250
NODE_219031_length_275_cov_0.937500	22	86	60	11	64	0.1718750
NODE_219031_length_275_cov_0.937500	22	86	64	3	64	0.0468750
NODE_219031_length_275_cov_0.937500	22	86	66	5	64	0.0781250
NODE_219031_length_275_cov_0.937500	22	86	74	1	64	0.0156250
NODE_219031_length_275_cov_0.937500	22	86	78	1	64	0.0156250
NODE_219031_length_275_cov_0.937500	22	86	80	3	64	0.0468750
NODE_219031_length_275_cov_0.937500	22	86	84	1	64	0.0156250
NODE_219031_length_275_cov_0.937500	22	86	88	1	64	0.0156250
NODE_219031_length_275_cov_0.937500	22	86	90	1	64	0.0156250
NODE_219220_length_275_cov_0.869318	67	126	2	59	59	1.0000000
NODE_219655_length_275_cov_0.579545	40	70	0	30	30	1.0000000
NODE_220021_length_274_cov_6.074286	141	175	0	34	34	1.0000000
NODE_220047_length_274_cov_4.845714	48	105	0	57	57	1.0000000
NODE_220047_length_274_cov_4.845714	113	175	0	62	62	1.0000000
NODE_220078_length_274_cov_4.080000	210	274	0	64	64	1.0000000
NODE_220215_length_274_cov_2.988571	104	161	0	57	57	1.0000000
NODE_220221_length_274_cov_2.937143	199	234	0	35	35	1.0000000
NODE_220293_length_274_cov_2.622857	29	76	6	5	47	0.1063830
NODE_220293_length_274_cov_2.622857	29	76	8	4	47	0.0851064
NODE_220293_length_274_cov_2.622857	29	76	9	1	47	0.0212766
NODE_220293_length_274_cov_2.622857	29	76	10	14	47	0.2978723
NODE_220293_length_274_cov_2.622857	29	76	11	1	47	0.0212766
NODE_220293_length_274_cov_2.622857	29	76	12	22	47	0.4680851
NODE_220293_length_274_cov_2.622857	82	157	4	17	75	0.2266667
NODE_220293_length_274_cov_2.622857	82	157	6	5	75	0.0666667
NODE_220293_length_274_cov_2.622857	82	157	7	1	75	0.0133333
NODE_220293_length_274_cov_2.622857	82	157	8	20	75	0.2666667
NODE_220293_length_274_cov_2.622857	82	157	10	32	75	0.4266667
NODE_220413_length_274_cov_2.308571	51	130	10	4	79	0.0506329
NODE_220413_length_274_cov_2.308571	51	130	12	3	79	0.0379747
NODE_220413_length_274_cov_2.308571	51	130	13	1	79	0.0126582
NODE_220413_length_274_cov_2.308571	51	130	14	6	79	0.0759494
NODE_220413_length_274_cov_2.308571	51	130	16	2	79	0.0253165
NODE_220413_length_274_cov_2.308571	51	130	18	6	79	0.0759494
NODE_220413_length_274_cov_2.308571	51	130	22	1	79	0.0126582
NODE_220413_length_274_cov_2.308571	51	130	26	1	79	0.0126582
NODE_220413_length_274_cov_2.308571	51	130	29	1	79	0.0126582
NODE_220413_length_274_cov_2.308571	51	130	31	3	79	0.0379747
NODE_220413_length_274_cov_2.308571	51	130	33	1	79	0.0126582
NODE_220413_length_274_cov_2.308571	51	130	35	2	79	0.0253165
NODE_220413_length_274_cov_2.308571	51	130	37	1	79	0.0126582
NODE_220413_length_274_cov_2.308571	51	130	39	3	79	0.0379747
NODE_220413_length_274_cov_2.308571	51	130	45	2	79	0.0253165
NODE_220413_length_274_cov_2.308571	51	130	47	7	79	0.0886076
NODE_220413_length_274_cov_2.308571	51	130	49	2	79	0.0253165
NODE_220413_length_274_cov_2.308571	51	130	53	3	79	0.0379747
NODE_220413_length_274_cov_2.308571	51	130	55	1	79	0.0126582
NODE_220413_length_274_cov_2.308571	51	130	62	1	79	0.0126582
NODE_220413_length_274_cov_2.308571	51	130	64	1	79	0.0126582
NODE_220413_length_274_cov_2.308571	51	130	71	1	79	0.0126582
NODE_220413_length_274_cov_2.308571	51	130	73	3	79	0.0379747
NODE_220413_length_274_cov_2.308571	51	130	75	2	79	0.0253165
NODE_220413_length_274_cov_2.308571	51	130	79	2	79	0.0253165
NODE_220413_length_274_cov_2.308571	51	130	81	3	79	0.0379747
NODE_220413_length_274_cov_2.308571	51	130	83	1	79	0.0126582
NODE_220413_length_274_cov_2.308571	51	130	85	15	79	0.1898734
NODE_220504_length_274_cov_2.062857	172	242	0	67	70	0.9571428
NODE_220504_length_274_cov_2.062857	172	242	2	3	70	0.0428571
NODE_220504_length_274_cov_2.062857	215	256	0	41	41	1.0000000
NODE_220662_length_274_cov_1.754286	219	259	0	40	40	1.0000000
NODE_220681_length_274_cov_1.748571	168	231	4	26	63	0.4126984
NODE_220681_length_274_cov_1.748571	168	231	6	37	63	0.5873016
NODE_220806_length_274_cov_1.737143	134	172	0	32	38	0.8421053
NODE_220806_length_274_cov_1.737143	134	172	2	6	38	0.1578947
NODE_220847_length_274_cov_1.685714	132	189	2	6	57	0.1052632
NODE_220847_length_274_cov_1.685714	132	189	4	51	57	0.8947368
NODE_220847_length_274_cov_1.685714	141	199	4	58	58	1.0000000
NODE_220966_length_274_cov_1.502857	170	232	0	60	62	0.9677419
NODE_220966_length_274_cov_1.502857	170	232	2	1	62	0.0161290
NODE_220966_length_274_cov_1.502857	170	232	6	1	62	0.0161290
NODE_220966_length_274_cov_1.502857	223	274	0	51	51	1.0000000
NODE_221005_length_274_cov_1.457143	118	147	0	29	29	1.0000000
NODE_221101_length_274_cov_1.434286	25	69	4	44	44	1.0000000
NODE_221211_length_274_cov_1.285714	84	156	0	22	72	0.3055556
NODE_221211_length_274_cov_1.285714	84	156	2	50	72	0.6944444
NODE_221612_length_274_cov_1.131429	205	251	0	44	46	0.9565217
NODE_221612_length_274_cov_1.131429	205	251	2	2	46	0.0434783
NODE_221764_length_274_cov_0.994286	219	260	0	41	41	1.0000000
NODE_222849_length_273_cov_4.948276	204	262	2	28	58	0.4827586
NODE_222849_length_273_cov_4.948276	204	262	6	30	58	0.5172414
NODE_222849_length_273_cov_4.948276	204	258	2	24	54	0.4444444
NODE_222849_length_273_cov_4.948276	204	258	6	30	54	0.5555556
NODE_222914_length_273_cov_3.712644	103	183	0	1	80	0.0125000
NODE_222914_length_273_cov_3.712644	103	183	4	1	80	0.0125000
NODE_222914_length_273_cov_3.712644	103	183	8	2	80	0.0250000
NODE_222914_length_273_cov_3.712644	103	183	10	1	80	0.0125000
NODE_222914_length_273_cov_3.712644	103	183	12	2	80	0.0250000
NODE_222914_length_273_cov_3.712644	103	183	14	12	80	0.1500000
NODE_222914_length_273_cov_3.712644	103	183	18	13	80	0.1625000
NODE_222914_length_273_cov_3.712644	103	183	20	3	80	0.0375000
NODE_222914_length_273_cov_3.712644	103	183	24	6	80	0.0750000
NODE_222914_length_273_cov_3.712644	103	183	26	10	80	0.1250000
NODE_222914_length_273_cov_3.712644	103	183	28	29	80	0.3625000
NODE_222955_length_273_cov_3.298851	69	100	0	31	31	1.0000000
NODE_222955_length_273_cov_3.298851	73	153	0	80	80	1.0000000
NODE_222974_length_273_cov_3.195402	122	189	14	41	67	0.6119403
NODE_222974_length_273_cov_3.195402	122	189	16	26	67	0.3880597
NODE_222991_length_273_cov_3.063218	76	151	12	1	75	0.0133333
NODE_222991_length_273_cov_3.063218	76	151	16	2	75	0.0266667
NODE_222991_length_273_cov_3.063218	76	151	18	3	75	0.0400000
NODE_222991_length_273_cov_3.063218	76	151	20	5	75	0.0666667
NODE_222991_length_273_cov_3.063218	76	151	22	5	75	0.0666667
NODE_222991_length_273_cov_3.063218	76	151	32	2	75	0.0266667
NODE_222991_length_273_cov_3.063218	76	151	34	6	75	0.0800000
NODE_222991_length_273_cov_3.063218	76	151	36	5	75	0.0666667
NODE_222991_length_273_cov_3.063218	76	151	38	2	75	0.0266667
NODE_222991_length_273_cov_3.063218	76	151	39	4	75	0.0533333
NODE_222991_length_273_cov_3.063218	76	151	40	6	75	0.0800000
NODE_222991_length_273_cov_3.063218	76	151	41	12	75	0.1600000
NODE_222991_length_273_cov_3.063218	76	151	43	7	75	0.0933333
NODE_222991_length_273_cov_3.063218	76	151	45	3	75	0.0400000
NODE_222991_length_273_cov_3.063218	76	151	47	2	75	0.0266667
NODE_222991_length_273_cov_3.063218	76	151	49	10	75	0.1333333
NODE_222991_length_273_cov_3.063218	135	191	3	7	56	0.1250000
NODE_222991_length_273_cov_3.063218	135	191	5	11	56	0.1964286
NODE_222991_length_273_cov_3.063218	135	191	10	17	56	0.3035714
NODE_222991_length_273_cov_3.063218	135	191	12	6	56	0.1071429
NODE_222991_length_273_cov_3.063218	135	191	16	2	56	0.0357143
NODE_222991_length_273_cov_3.063218	135	191	18	3	56	0.0535714
NODE_222991_length_273_cov_3.063218	135	191	20	5	56	0.0892857
NODE_222991_length_273_cov_3.063218	135	191	22	5	56	0.0892857
NODE_223066_length_273_cov_2.706897	11	45	0	18	34	0.5294118
NODE_223066_length_273_cov_2.706897	11	45	2	16	34	0.4705882
NODE_223203_length_273_cov_2.339080	69	145	2	4	76	0.0526316
NODE_223203_length_273_cov_2.339080	69	145	4	2	76	0.0263158
NODE_223203_length_273_cov_2.339080	69	145	6	13	76	0.1710526
NODE_223203_length_273_cov_2.339080	69	145	8	23	76	0.3026316
NODE_223203_length_273_cov_2.339080	69	145	10	4	76	0.0526316
NODE_223203_length_273_cov_2.339080	69	145	12	12	76	0.1578947
NODE_223203_length_273_cov_2.339080	69	145	14	18	76	0.2368421
NODE_223353_length_273_cov_2.051724	31	74	0	43	43	1.0000000
NODE_223377_length_273_cov_2.034483	81	161	8	9	80	0.1125000
NODE_223377_length_273_cov_2.034483	81	161	10	43	80	0.5375000
NODE_223377_length_273_cov_2.034483	81	161	12	28	80	0.3500000
NODE_223377_length_273_cov_2.034483	213	263	0	24	50	0.4800000
NODE_223377_length_273_cov_2.034483	213	263	2	6	50	0.1200000
NODE_223377_length_273_cov_2.034483	213	263	4	10	50	0.2000000
NODE_223377_length_273_cov_2.034483	213	263	6	10	50	0.2000000
NODE_223680_length_273_cov_1.706897	181	238	0	57	57	1.0000000
NODE_223913_length_273_cov_1.442529	5	47	2	42	42	1.0000000
NODE_224023_length_273_cov_1.281609	167	247	0	80	80	1.0000000
NODE_224082_length_273_cov_1.189655	120	156	0	36	36	1.0000000
NODE_224082_length_273_cov_1.189655	129	160	0	31	31	1.0000000
NODE_224165_length_273_cov_1.172414	94	130	6	36	36	1.0000000
NODE_224254_length_273_cov_1.172414	8	58	0	50	50	1.0000000
NODE_224367_length_273_cov_1.166667	74	93	4	19	19	1.0000000
NODE_224441_length_273_cov_1.091954	6	42	0	36	36	1.0000000
NODE_224441_length_273_cov_1.091954	43	95	0	52	52	1.0000000
NODE_224587_length_273_cov_0.971264	188	235	2	14	47	0.2978723
NODE_224587_length_273_cov_0.971264	188	235	4	33	47	0.7021276
NODE_225303_length_273_cov_0.586207	27	88	0	1	61	0.0163934
NODE_225303_length_273_cov_0.586207	27	88	2	60	61	0.9836066
NODE_225344_length_273_cov_0.586207	24	79	0	55	55	1.0000000
NODE_225344_length_273_cov_0.586207	81	113	0	9	32	0.2812500
NODE_225344_length_273_cov_0.586207	81	113	2	23	32	0.7187500
NODE_225592_length_272_cov_6.190751	172	236	4	27	64	0.4218750
NODE_225592_length_272_cov_6.190751	172	236	8	27	64	0.4218750
NODE_225592_length_272_cov_6.190751	172	236	10	10	64	0.1562500
NODE_225607_length_272_cov_5.335260	193	272	0	79	79	1.0000000
NODE_225633_length_272_cov_4.716763	228	257	4	16	29	0.5517241
NODE_225633_length_272_cov_4.716763	228	257	10	13	29	0.4482759
NODE_225656_length_272_cov_4.219653	93	166	0	73	73	1.0000000
NODE_225656_length_272_cov_4.219653	146	219	0	44	73	0.6027398
NODE_225656_length_272_cov_4.219653	146	219	2	29	73	0.3972603
NODE_225658_length_272_cov_4.184971	75	128	0	53	53	1.0000000
NODE_225739_length_272_cov_3.352601	154	199	2	45	45	1.0000000
NODE_225872_length_272_cov_2.664740	106	186	0	37	80	0.4625000
NODE_225872_length_272_cov_2.664740	106	186	4	43	80	0.5375000
NODE_226010_length_272_cov_2.335260	33	103	0	70	70	1.0000000
NODE_226029_length_272_cov_2.277457	219	256	0	37	37	1.0000000
NODE_226045_length_272_cov_2.236994	104	184	2	3	80	0.0375000
NODE_226045_length_272_cov_2.236994	104	184	4	7	80	0.0875000
NODE_226045_length_272_cov_2.236994	104	184	8	3	80	0.0375000
NODE_226045_length_272_cov_2.236994	104	184	10	4	80	0.0500000
NODE_226045_length_272_cov_2.236994	104	184	12	3	80	0.0375000
NODE_226045_length_272_cov_2.236994	104	184	14	1	80	0.0125000
NODE_226045_length_272_cov_2.236994	104	184	16	15	80	0.1875000
NODE_226045_length_272_cov_2.236994	104	184	18	2	80	0.0250000
NODE_226045_length_272_cov_2.236994	104	184	20	16	80	0.2000000
NODE_226045_length_272_cov_2.236994	104	184	22	26	80	0.3250000
NODE_226169_length_272_cov_1.982659	172	252	2	19	80	0.2375000
NODE_226169_length_272_cov_1.982659	172	252	4	27	80	0.3375000
NODE_226169_length_272_cov_1.982659	172	252	5	34	80	0.4250000
NODE_226245_length_272_cov_1.780347	37	99	0	62	62	1.0000000
NODE_226245_length_272_cov_1.780347	90	152	0	62	62	1.0000000
NODE_226248_length_272_cov_1.768786	12	45	0	33	33	1.0000000
NODE_226461_length_272_cov_1.618497	97	160	4	3	63	0.0476190
NODE_226461_length_272_cov_1.618497	97	160	8	2	63	0.0317460
NODE_226461_length_272_cov_1.618497	97	160	10	3	63	0.0476190
NODE_226461_length_272_cov_1.618497	97	160	12	15	63	0.2380952
NODE_226461_length_272_cov_1.618497	97	160	14	6	63	0.0952381
NODE_226461_length_272_cov_1.618497	97	160	16	23	63	0.3650794
NODE_226461_length_272_cov_1.618497	97	160	18	1	63	0.0158730
NODE_226461_length_272_cov_1.618497	97	160	22	2	63	0.0317460
NODE_226461_length_272_cov_1.618497	97	160	24	5	63	0.0793651
NODE_226461_length_272_cov_1.618497	97	160	26	2	63	0.0317460
NODE_226461_length_272_cov_1.618497	97	160	28	1	63	0.0158730
NODE_226508_length_272_cov_1.543353	69	137	4	68	68	1.0000000
NODE_227037_length_272_cov_1.173410	147	203	2	56	56	1.0000000
NODE_227265_length_272_cov_0.988439	169	215	0	46	46	1.0000000
NODE_227444_length_272_cov_0.884393	126	163	0	37	37	1.0000000
NODE_228332_length_271_cov_5.238372	103	183	0	80	80	1.0000000
NODE_228423_length_271_cov_3.546512	102	165	0	63	63	1.0000000
NODE_228429_length_271_cov_3.476744	62	93	0	31	31	1.0000000
NODE_228494_length_271_cov_2.959302	96	176	0	52	80	0.6500000
NODE_228494_length_271_cov_2.959302	96	176	2	28	80	0.3500000
NODE_228494_length_271_cov_2.959302	149	229	2	80	80	1.0000000
NODE_228554_length_271_cov_2.715116	160	241	0	81	81	1.0000000
NODE_228593_length_271_cov_2.622093	180	253	0	73	73	1.0000000
NODE_228623_length_271_cov_2.465116	45	75	0	30	30	1.0000000
NODE_228731_length_271_cov_2.284884	95	158	2	8	63	0.1269841
NODE_228731_length_271_cov_2.284884	95	158	4	5	63	0.0793651
NODE_228731_length_271_cov_2.284884	95	158	6	36	63	0.5714286
NODE_228731_length_271_cov_2.284884	95	158	8	14	63	0.2222222
NODE_228731_length_271_cov_2.284884	131	211	0	46	80	0.5750000
NODE_228731_length_271_cov_2.284884	131	211	2	15	80	0.1875000
NODE_228731_length_271_cov_2.284884	131	211	4	5	80	0.0625000
NODE_228731_length_271_cov_2.284884	131	211	6	14	80	0.1750000
NODE_228737_length_271_cov_2.273256	163	219	0	56	56	1.0000000
NODE_228830_length_271_cov_2.069767	130	212	0	14	82	0.1707317
NODE_228830_length_271_cov_2.069767	130	212	4	68	82	0.8292683
NODE_228932_length_271_cov_1.784884	135	183	0	48	48	1.0000000
NODE_228937_length_271_cov_1.779070	204	268	0	64	64	1.0000000
NODE_229085_length_271_cov_1.755814	119	199	2	14	80	0.1750000
NODE_229085_length_271_cov_1.755814	119	199	4	66	80	0.8250000
NODE_229242_length_271_cov_1.523256	122	183	0	24	61	0.3934426
NODE_229242_length_271_cov_1.523256	122	183	2	37	61	0.6065574
NODE_229254_length_271_cov_1.511628	106	186	42	4	80	0.0500000
NODE_229254_length_271_cov_1.511628	106	186	43	1	80	0.0125000
NODE_229254_length_271_cov_1.511628	106	186	46	4	80	0.0500000
NODE_229254_length_271_cov_1.511628	106	186	48	5	80	0.0625000
NODE_229254_length_271_cov_1.511628	106	186	50	3	80	0.0375000
NODE_229254_length_271_cov_1.511628	106	186	52	2	80	0.0250000
NODE_229254_length_271_cov_1.511628	106	186	54	14	80	0.1750000
NODE_229254_length_271_cov_1.511628	106	186	56	2	80	0.0250000
NODE_229254_length_271_cov_1.511628	106	186	58	1	80	0.0125000
NODE_229254_length_271_cov_1.511628	106	186	60	8	80	0.1000000
NODE_229254_length_271_cov_1.511628	106	186	62	4	80	0.0500000
NODE_229254_length_271_cov_1.511628	106	186	64	20	80	0.2500000
NODE_229254_length_271_cov_1.511628	106	186	66	12	80	0.1500000
NODE_229525_length_271_cov_1.226744	119	184	0	3	65	0.0461538
NODE_229525_length_271_cov_1.226744	119	184	2	62	65	0.9538462
NODE_229541_length_271_cov_1.197674	88	145	0	8	57	0.1403509
NODE_229541_length_271_cov_1.197674	88	145	2	16	57	0.2807018
NODE_229541_length_271_cov_1.197674	88	145	4	33	57	0.5789474
NODE_229541_length_271_cov_1.197674	118	192	4	74	74	1.0000000
NODE_230154_length_271_cov_0.918605	155	227	0	72	72	1.0000000
NODE_230255_length_271_cov_0.889535	101	148	0	46	47	0.9787234
NODE_230255_length_271_cov_0.889535	101	148	4	1	47	0.0212766
NODE_230318_length_271_cov_0.889535	127	188	0	5	61	0.0819672
NODE_230318_length_271_cov_0.889535	127	188	2	2	61	0.0327869
NODE_230318_length_271_cov_0.889535	127	188	4	4	61	0.0655738
NODE_230318_length_271_cov_0.889535	127	188	6	50	61	0.8196721
NODE_231165_length_270_cov_4.818713	72	118	2	46	46	1.0000000
NODE_231187_length_270_cov_4.327485	5	82	0	77	77	1.0000000
NODE_231240_length_270_cov_3.666667	87	154	0	2	67	0.0298507
NODE_231240_length_270_cov_3.666667	87	154	10	25	67	0.3731343
NODE_231240_length_270_cov_3.666667	87	154	12	32	67	0.4776119
NODE_231240_length_270_cov_3.666667	87	154	16	2	67	0.0298507
NODE_231240_length_270_cov_3.666667	87	154	22	6	67	0.0895522
NODE_231240_length_270_cov_3.666667	140	207	12	6	67	0.0895522
NODE_231240_length_270_cov_3.666667	140	207	16	2	67	0.0298507
NODE_231240_length_270_cov_3.666667	140	207	22	22	67	0.3283582
NODE_231240_length_270_cov_3.666667	140	207	24	37	67	0.5522388
NODE_231263_length_270_cov_3.491228	186	270	0	84	84	1.0000000
NODE_231310_length_270_cov_3.105263	43	90	4	30	47	0.6382979
NODE_231310_length_270_cov_3.105263	43	90	6	17	47	0.3617021
NODE_231316_length_270_cov_3.046784	64	135	0	71	71	1.0000000
NODE_231439_length_270_cov_2.649123	210	270	0	60	60	1.0000000
NODE_231655_length_270_cov_2.087719	16	55	0	39	39	1.0000000
NODE_231655_length_270_cov_2.087719	78	108	0	30	30	1.0000000
NODE_231714_length_270_cov_2.040936	103	159	16	1	56	0.0178571
NODE_231714_length_270_cov_2.040936	103	159	28	2	56	0.0357143
NODE_231714_length_270_cov_2.040936	103	159	32	1	56	0.0178571
NODE_231714_length_270_cov_2.040936	103	159	36	2	56	0.0357143
NODE_231714_length_270_cov_2.040936	103	159	48	2	56	0.0357143
NODE_231714_length_270_cov_2.040936	103	159	52	1	56	0.0178571
NODE_231714_length_270_cov_2.040936	103	159	54	2	56	0.0357143
NODE_231714_length_270_cov_2.040936	103	159	58	1	56	0.0178571
NODE_231714_length_270_cov_2.040936	103	159	60	1	56	0.0178571
NODE_231714_length_270_cov_2.040936	103	159	62	1	56	0.0178571
NODE_231714_length_270_cov_2.040936	103	159	64	2	56	0.0357143
NODE_231714_length_270_cov_2.040936	103	159	66	3	56	0.0535714
NODE_231714_length_270_cov_2.040936	103	159	68	1	56	0.0178571
NODE_231714_length_270_cov_2.040936	103	159	70	1	56	0.0178571
NODE_231714_length_270_cov_2.040936	103	159	78	2	56	0.0357143
NODE_231714_length_270_cov_2.040936	103	159	80	2	56	0.0357143
NODE_231714_length_270_cov_2.040936	103	159	82	2	56	0.0357143
NODE_231714_length_270_cov_2.040936	103	159	86	1	56	0.0178571
NODE_231714_length_270_cov_2.040936	103	159	92	2	56	0.0357143
NODE_231714_length_270_cov_2.040936	103	159	94	1	56	0.0178571
NODE_231714_length_270_cov_2.040936	103	159	98	4	56	0.0714286
NODE_231714_length_270_cov_2.040936	103	159	105	1	56	0.0178571
NODE_231714_length_270_cov_2.040936	103	159	106	2	56	0.0357143
NODE_231714_length_270_cov_2.040936	103	159	108	3	56	0.0535714
NODE_231714_length_270_cov_2.040936	103	159	110	3	56	0.0535714
NODE_231714_length_270_cov_2.040936	103	159	118	11	56	0.1964286
NODE_231714_length_270_cov_2.040936	103	159	120	1	56	0.0178571
NODE_231726_length_270_cov_2.017544	1	48	0	47	47	1.0000000
NODE_231820_length_270_cov_1.789474	146	228	0	25	82	0.3048781
NODE_231820_length_270_cov_1.789474	146	228	2	57	82	0.6951219
NODE_232008_length_270_cov_1.678363	178	246	0	68	68	1.0000000
NODE_232021_length_270_cov_1.666667	127	191	18	3	64	0.0468750
NODE_232021_length_270_cov_1.666667	127	191	20	1	64	0.0156250
NODE_232021_length_270_cov_1.666667	127	191	26	17	64	0.2656250
NODE_232021_length_270_cov_1.666667	127	191	28	1	64	0.0156250
NODE_232021_length_270_cov_1.666667	127	191	30	2	64	0.0312500
NODE_232021_length_270_cov_1.666667	127	191	36	1	64	0.0156250
NODE_232021_length_270_cov_1.666667	127	191	38	2	64	0.0312500
NODE_232021_length_270_cov_1.666667	127	191	40	6	64	0.0937500
NODE_232021_length_270_cov_1.666667	127	191	42	1	64	0.0156250
NODE_232021_length_270_cov_1.666667	127	191	44	5	64	0.0781250
NODE_232021_length_270_cov_1.666667	127	191	46	3	64	0.0468750
NODE_232021_length_270_cov_1.666667	127	191	50	1	64	0.0156250
NODE_232021_length_270_cov_1.666667	127	191	52	2	64	0.0312500
NODE_232021_length_270_cov_1.666667	127	191	54	1	64	0.0156250
NODE_232021_length_270_cov_1.666667	127	191	56	2	64	0.0312500
NODE_232021_length_270_cov_1.666667	127	191	58	6	64	0.0937500
NODE_232021_length_270_cov_1.666667	127	191	60	1	64	0.0156250
NODE_232021_length_270_cov_1.666667	127	191	61	1	64	0.0156250
NODE_232021_length_270_cov_1.666667	127	191	62	8	64	0.1250000
NODE_232021_length_270_cov_1.666667	180	227	10	18	47	0.3829787
NODE_232021_length_270_cov_1.666667	180	227	14	4	47	0.0851064
NODE_232021_length_270_cov_1.666667	180	227	16	5	47	0.1063830
NODE_232021_length_270_cov_1.666667	180	227	18	12	47	0.2553191
NODE_232021_length_270_cov_1.666667	180	227	20	1	47	0.0212766
NODE_232021_length_270_cov_1.666667	180	227	26	7	47	0.1489362
NODE_232087_length_270_cov_1.555556	138	218	0	45	80	0.5625000
NODE_232087_length_270_cov_1.555556	138	218	2	35	80	0.4375000
NODE_232331_length_270_cov_1.280702	4	75	0	30	71	0.4225352
NODE_232331_length_270_cov_1.280702	4	75	2	41	71	0.5774648
NODE_232331_length_270_cov_1.280702	57	137	0	25	80	0.3125000
NODE_232331_length_270_cov_1.280702	57	137	2	55	80	0.6875000
NODE_232331_length_270_cov_1.280702	65	120	0	8	55	0.1454545
NODE_232331_length_270_cov_1.280702	65	120	2	47	55	0.8545455
NODE_232331_length_270_cov_1.280702	125	198	0	73	73	1.0000000
NODE_232440_length_270_cov_1.192982	146	194	0	48	48	1.0000000
NODE_232583_length_270_cov_1.192982	61	141	2	80	80	1.0000000
NODE_233290_length_270_cov_0.847953	53	128	0	2	75	0.0266667
NODE_233290_length_270_cov_0.847953	53	128	4	73	75	0.9733334
NODE_234072_length_269_cov_3.894118	30	110	2	38	80	0.4750000
NODE_234072_length_269_cov_3.894118	30	110	5	1	80	0.0125000
NODE_234072_length_269_cov_3.894118	30	110	6	14	80	0.1750000
NODE_234072_length_269_cov_3.894118	30	110	8	27	80	0.3375000
NODE_234072_length_269_cov_3.894118	83	163	4	2	80	0.0250000
NODE_234072_length_269_cov_3.894118	83	163	6	24	80	0.3000000
NODE_234072_length_269_cov_3.894118	83	163	8	54	80	0.6750000
NODE_234100_length_269_cov_3.605882	175	205	0	30	30	1.0000000
NODE_234116_length_269_cov_3.523529	192	233	3	16	41	0.3902439
NODE_234116_length_269_cov_3.523529	192	233	4	6	41	0.1463415
NODE_234116_length_269_cov_3.523529	192	233	6	19	41	0.4634146
NODE_234116_length_269_cov_3.523529	206	268	0	10	62	0.1612903
NODE_234116_length_269_cov_3.523529	206	268	1	11	62	0.1774193
NODE_234116_length_269_cov_3.523529	206	268	2	7	62	0.1129032
NODE_234116_length_269_cov_3.523529	206	268	3	23	62	0.3709677
NODE_234116_length_269_cov_3.523529	206	268	4	6	62	0.0967742
NODE_234116_length_269_cov_3.523529	206	268	6	5	62	0.0806452
NODE_234118_length_269_cov_3.505882	13	93	0	80	80	1.0000000
NODE_234118_length_269_cov_3.505882	66	145	0	79	79	1.0000000
NODE_234162_length_269_cov_3.147059	134	174	0	40	40	1.0000000
NODE_234167_length_269_cov_3.111765	39	119	0	80	80	1.0000000
NODE_234167_length_269_cov_3.111765	92	169	0	77	77	1.0000000
NODE_234178_length_269_cov_3.000000	166	233	0	67	67	1.0000000
NODE_234205_length_269_cov_2.947059	55	123	0	68	68	1.0000000
NODE_234224_length_269_cov_2.858824	9	89	0	80	80	1.0000000
NODE_234224_length_269_cov_2.858824	62	91	0	29	29	1.0000000
NODE_234228_length_269_cov_2.823529	0	73	2	1	73	0.0136986
NODE_234228_length_269_cov_2.823529	0	73	4	2	73	0.0273973
NODE_234228_length_269_cov_2.823529	0	73	6	5	73	0.0684932
NODE_234228_length_269_cov_2.823529	0	73	8	7	73	0.0958904
NODE_234228_length_269_cov_2.823529	0	73	14	58	73	0.7945206
NODE_234228_length_269_cov_2.823529	46	77	14	31	31	1.0000000
NODE_234431_length_269_cov_2.311765	111	157	0	44	46	0.9565217
NODE_234431_length_269_cov_2.311765	111	157	2	2	46	0.0434783
NODE_234431_length_269_cov_2.311765	130	209	0	79	79	1.0000000
NODE_234606_length_269_cov_1.958824	176	248	0	72	72	1.0000000
NODE_234647_length_269_cov_1.847059	72	99	0	27	27	1.0000000
NODE_234657_length_269_cov_1.823529	30	81	16	4	51	0.0784314
NODE_234657_length_269_cov_1.823529	30	81	19	8	51	0.1568628
NODE_234657_length_269_cov_1.823529	30	81	21	3	51	0.0588235
NODE_234657_length_269_cov_1.823529	30	81	22	12	51	0.2352941
NODE_234657_length_269_cov_1.823529	30	81	24	12	51	0.2352941
NODE_234657_length_269_cov_1.823529	30	81	27	5	51	0.0980392
NODE_234657_length_269_cov_1.823529	30	81	28	7	51	0.1372549
NODE_234758_length_269_cov_1.800000	0	42	0	42	42	1.0000000
NODE_234978_length_269_cov_1.552941	90	170	0	30	80	0.3750000
NODE_234978_length_269_cov_1.552941	90	170	2	50	80	0.6250000
NODE_235157_length_269_cov_1.400000	139	219	4	2	80	0.0250000
NODE_235157_length_269_cov_1.400000	139	219	5	4	80	0.0500000
NODE_235157_length_269_cov_1.400000	139	219	7	2	80	0.0250000
NODE_235157_length_269_cov_1.400000	139	219	8	34	80	0.4250000
NODE_235157_length_269_cov_1.400000	139	219	10	16	80	0.2000000
NODE_235157_length_269_cov_1.400000	139	219	11	12	80	0.1500000
NODE_235157_length_269_cov_1.400000	139	219	12	10	80	0.1250000
NODE_235168_length_269_cov_1.388235	185	252	0	67	67	1.0000000
NODE_235239_length_269_cov_1.288235	150	179	2	4	29	0.1379310
NODE_235239_length_269_cov_1.288235	150	179	6	7	29	0.2413793
NODE_235239_length_269_cov_1.288235	150	179	8	6	29	0.2068966
NODE_235239_length_269_cov_1.288235	150	179	10	6	29	0.2068966
NODE_235239_length_269_cov_1.288235	150	179	12	6	29	0.2068966
NODE_235292_length_269_cov_1.217647	141	221	0	80	80	1.0000000
NODE_235561_length_269_cov_1.194118	107	170	0	63	63	1.0000000
NODE_235561_length_269_cov_1.194118	143	221	0	78	78	1.0000000
NODE_235714_length_269_cov_1.094118	38	72	0	34	34	1.0000000
NODE_235780_length_269_cov_1.035294	6	36	0	30	30	1.0000000
NODE_235780_length_269_cov_1.035294	96	150	0	54	54	1.0000000
NODE_235930_length_269_cov_0.917647	4	79	0	75	75	1.0000000
NODE_235930_length_269_cov_0.917647	57	93	0	36	36	1.0000000
NODE_236243_length_269_cov_0.782353	2	52	0	4	50	0.0800000
NODE_236243_length_269_cov_0.782353	2	52	2	2	50	0.0400000
NODE_236243_length_269_cov_0.782353	2	52	4	3	50	0.0600000
NODE_236243_length_269_cov_0.782353	2	52	6	19	50	0.3800000
NODE_236243_length_269_cov_0.782353	2	52	8	6	50	0.1200000
NODE_236243_length_269_cov_0.782353	2	52	12	2	50	0.0400000
NODE_236243_length_269_cov_0.782353	2	52	14	6	50	0.1200000
NODE_236243_length_269_cov_0.782353	2	52	16	8	50	0.1600000
NODE_236243_length_269_cov_0.782353	76	132	24	8	56	0.1428571
NODE_236243_length_269_cov_0.782353	76	132	28	35	56	0.6250000
NODE_236243_length_269_cov_0.782353	76	132	30	13	56	0.2321429
NODE_236856_length_268_cov_223.165680	161	188	6	3	27	0.1111111
NODE_236856_length_268_cov_223.165680	161	188	10	24	27	0.8888889
NODE_236856_length_268_cov_223.165680	161	241	6	3	80	0.0375000
NODE_236856_length_268_cov_223.165680	161	241	8	7	80	0.0875000
NODE_236856_length_268_cov_223.165680	161	241	10	70	80	0.8750000
NODE_236878_length_268_cov_6.266272	29	111	2	82	82	1.0000000
NODE_236909_length_268_cov_5.053254	137	217	0	67	80	0.8375000
NODE_236909_length_268_cov_5.053254	137	217	2	13	80	0.1625000
NODE_236909_length_268_cov_5.053254	190	253	0	14	63	0.2222222
NODE_236909_length_268_cov_5.053254	190	253	2	49	63	0.7777778
NODE_236911_length_268_cov_4.994083	92	168	2	46	76	0.6052632
NODE_236911_length_268_cov_4.994083	92	168	4	10	76	0.1315790
NODE_236911_length_268_cov_4.994083	92	168	6	3	76	0.0394737
NODE_236911_length_268_cov_4.994083	92	168	8	17	76	0.2236842
NODE_236972_length_268_cov_3.905325	1	61	2	44	60	0.7333333
NODE_236972_length_268_cov_3.905325	1	61	4	5	60	0.0833333
NODE_236972_length_268_cov_3.905325	1	61	6	11	60	0.1833333
NODE_237107_length_268_cov_2.982249	95	175	15	3	80	0.0375000
NODE_237107_length_268_cov_2.982249	95	175	16	10	80	0.1250000
NODE_237107_length_268_cov_2.982249	95	175	17	11	80	0.1375000
NODE_237107_length_268_cov_2.982249	95	175	18	4	80	0.0500000
NODE_237107_length_268_cov_2.982249	95	175	19	7	80	0.0875000
NODE_237107_length_268_cov_2.982249	95	175	20	40	80	0.5000000
NODE_237107_length_268_cov_2.982249	95	175	22	5	80	0.0625000
NODE_237115_length_268_cov_2.940828	28	97	0	69	69	1.0000000
NODE_237185_length_268_cov_2.668639	57	110	2	43	53	0.8113208
NODE_237185_length_268_cov_2.668639	57	110	4	10	53	0.1886792
NODE_237190_length_268_cov_2.621302	149	176	6	27	27	1.0000000
NODE_237325_length_268_cov_2.289941	87	127	22	4	40	0.1000000
NODE_237325_length_268_cov_2.289941	87	127	24	14	40	0.3500000
NODE_237325_length_268_cov_2.289941	87	127	26	6	40	0.1500000
NODE_237325_length_268_cov_2.289941	87	127	28	16	40	0.4000000
NODE_237345_length_268_cov_2.224852	96	176	0	10	80	0.1250000
NODE_237345_length_268_cov_2.224852	96	176	2	70	80	0.8750000
NODE_237345_length_268_cov_2.224852	149	229	0	9	80	0.1125000
NODE_237345_length_268_cov_2.224852	149	229	2	71	80	0.8875000
NODE_237457_length_268_cov_2.005917	97	162	0	65	65	1.0000000
NODE_237502_length_268_cov_1.840237	80	155	4	1	75	0.0133333
NODE_237502_length_268_cov_1.840237	80	155	6	7	75	0.0933333
NODE_237502_length_268_cov_1.840237	80	155	8	41	75	0.5466667
NODE_237502_length_268_cov_1.840237	80	155	10	26	75	0.3466667
NODE_237572_length_268_cov_1.810651	8	84	0	76	76	1.0000000
NODE_237831_length_268_cov_1.532544	186	257	2	7	71	0.0985916
NODE_237831_length_268_cov_1.532544	186	257	8	1	71	0.0140845
NODE_237831_length_268_cov_1.532544	186	257	12	3	71	0.0422535
NODE_237831_length_268_cov_1.532544	186	257	14	4	71	0.0563380
NODE_237831_length_268_cov_1.532544	186	257	20	3	71	0.0422535
NODE_237831_length_268_cov_1.532544	186	257	26	7	71	0.0985916
NODE_237831_length_268_cov_1.532544	186	257	28	1	71	0.0140845
NODE_237831_length_268_cov_1.532544	186	257	30	1	71	0.0140845
NODE_237831_length_268_cov_1.532544	186	257	34	2	71	0.0281690
NODE_237831_length_268_cov_1.532544	186	257	36	2	71	0.0281690
NODE_237831_length_268_cov_1.532544	186	257	40	1	71	0.0140845
NODE_237831_length_268_cov_1.532544	186	257	42	13	71	0.1830986
NODE_237831_length_268_cov_1.532544	186	257	44	1	71	0.0140845
NODE_237831_length_268_cov_1.532544	186	257	48	5	71	0.0704225
NODE_237831_length_268_cov_1.532544	186	257	50	1	71	0.0140845
NODE_237831_length_268_cov_1.532544	186	257	52	5	71	0.0704225
NODE_237831_length_268_cov_1.532544	186	257	56	11	71	0.1549296
NODE_237831_length_268_cov_1.532544	186	257	58	2	71	0.0281690
NODE_237831_length_268_cov_1.532544	186	257	60	1	71	0.0140845
NODE_237906_length_268_cov_1.508876	52	131	0	79	79	1.0000000
NODE_238009_length_268_cov_1.384615	0	46	0	16	46	0.3478261
NODE_238009_length_268_cov_1.384615	0	46	2	30	46	0.6521739
NODE_238070_length_268_cov_1.278107	100	175	0	15	75	0.2000000
NODE_238070_length_268_cov_1.278107	100	175	2	60	75	0.8000000
NODE_238153_length_268_cov_1.207101	187	209	2	22	22	1.0000000
NODE_238478_length_268_cov_1.153846	135	195	0	60	60	1.0000000
NODE_239018_length_268_cov_0.852071	59	119	15	5	60	0.0833333
NODE_239018_length_268_cov_0.852071	59	119	17	55	60	0.9166667
NODE_239805_length_267_cov_4.297619	0	52	0	10	52	0.1923077
NODE_239805_length_267_cov_4.297619	0	52	2	42	52	0.8076923
NODE_239817_length_267_cov_4.119048	41	87	0	46	46	1.0000000
NODE_239845_length_267_cov_3.785714	96	163	4	67	67	1.0000000
NODE_239845_length_267_cov_3.785714	136	178	0	10	42	0.2380952
NODE_239845_length_267_cov_3.785714	136	178	4	32	42	0.7619048
NODE_239873_length_267_cov_3.535714	40	101	0	12	61	0.1967213
NODE_239873_length_267_cov_3.535714	40	101	2	49	61	0.8032787
NODE_239873_length_267_cov_3.535714	74	154	2	59	80	0.7375000
NODE_239873_length_267_cov_3.535714	74	154	4	19	80	0.2375000
NODE_239873_length_267_cov_3.535714	74	154	8	2	80	0.0250000
NODE_239958_length_267_cov_3.005952	216	267	0	51	51	1.0000000
NODE_239959_length_267_cov_3.000000	87	144	0	1	57	0.0175439
NODE_239959_length_267_cov_3.000000	87	144	4	8	57	0.1403509
NODE_239959_length_267_cov_3.000000	87	144	8	3	57	0.0526316
NODE_239959_length_267_cov_3.000000	87	144	10	18	57	0.3157895
NODE_239959_length_267_cov_3.000000	87	144	11	12	57	0.2105263
NODE_239959_length_267_cov_3.000000	87	144	13	3	57	0.0526316
NODE_239959_length_267_cov_3.000000	87	144	14	12	57	0.2105263
NODE_240007_length_267_cov_2.726190	177	220	2	43	43	1.0000000
NODE_240024_length_267_cov_2.690476	117	170	22	8	53	0.1509434
NODE_240024_length_267_cov_2.690476	117	170	26	7	53	0.1320755
NODE_240024_length_267_cov_2.690476	117	170	28	11	53	0.2075472
NODE_240024_length_267_cov_2.690476	117	170	30	27	53	0.5094340
NODE_240029_length_267_cov_2.666667	198	267	0	69	69	1.0000000
NODE_240114_length_267_cov_2.428571	189	254	0	61	65	0.9384615
NODE_240114_length_267_cov_2.428571	189	254	2	1	65	0.0153846
NODE_240114_length_267_cov_2.428571	189	254	4	1	65	0.0153846
NODE_240114_length_267_cov_2.428571	189	254	30	1	65	0.0153846
NODE_240114_length_267_cov_2.428571	189	254	32	1	65	0.0153846
NODE_240207_length_267_cov_2.208333	45	103	3	10	58	0.1724138
NODE_240207_length_267_cov_2.208333	45	103	5	3	58	0.0517241
NODE_240207_length_267_cov_2.208333	45	103	6	12	58	0.2068966
NODE_240207_length_267_cov_2.208333	45	103	7	33	58	0.5689655
NODE_240246_length_267_cov_2.125000	124	175	2	2	51	0.0392157
NODE_240246_length_267_cov_2.125000	124	175	4	49	51	0.9607843
NODE_240303_length_267_cov_2.077381	65	146	0	13	81	0.1604938
NODE_240303_length_267_cov_2.077381	65	146	2	68	81	0.8395061
NODE_240303_length_267_cov_2.077381	229	264	0	35	35	1.0000000
NODE_240331_length_267_cov_2.005952	147	228	0	19	81	0.2345679
NODE_240331_length_267_cov_2.005952	147	228	2	38	81	0.4691358
NODE_240331_length_267_cov_2.005952	147	228	4	7	81	0.0864198
NODE_240331_length_267_cov_2.005952	147	228	6	5	81	0.0617284
NODE_240331_length_267_cov_2.005952	147	228	8	1	81	0.0123457
NODE_240331_length_267_cov_2.005952	147	228	10	5	81	0.0617284
NODE_240331_length_267_cov_2.005952	147	228	12	6	81	0.0740741
NODE_240331_length_267_cov_2.005952	201	267	0	58	66	0.8787879
NODE_240331_length_267_cov_2.005952	201	267	2	8	66	0.1212121
NODE_240336_length_267_cov_1.988095	77	157	0	80	80	1.0000000
NODE_240336_length_267_cov_1.988095	130	210	0	80	80	1.0000000
NODE_240620_length_267_cov_1.755952	119	199	0	13	80	0.1625000
NODE_240620_length_267_cov_1.755952	119	199	2	67	80	0.8375000
NODE_240624_length_267_cov_1.750000	23	104	12	2	81	0.0246914
NODE_240624_length_267_cov_1.750000	23	104	15	1	81	0.0123457
NODE_240624_length_267_cov_1.750000	23	104	18	2	81	0.0246914
NODE_240624_length_267_cov_1.750000	23	104	20	7	81	0.0864198
NODE_240624_length_267_cov_1.750000	23	104	22	3	81	0.0370370
NODE_240624_length_267_cov_1.750000	23	104	28	1	81	0.0123457
NODE_240624_length_267_cov_1.750000	23	104	29	13	81	0.1604938
NODE_240624_length_267_cov_1.750000	23	104	31	2	81	0.0246914
NODE_240624_length_267_cov_1.750000	23	104	33	5	81	0.0617284
NODE_240624_length_267_cov_1.750000	23	104	35	7	81	0.0864198
NODE_240624_length_267_cov_1.750000	23	104	39	3	81	0.0370370
NODE_240624_length_267_cov_1.750000	23	104	41	2	81	0.0246914
NODE_240624_length_267_cov_1.750000	23	104	43	33	81	0.4074074
NODE_240624_length_267_cov_1.750000	179	208	0	19	29	0.6551724
NODE_240624_length_267_cov_1.750000	179	208	1	4	29	0.1379310
NODE_240624_length_267_cov_1.750000	179	208	5	5	29	0.1724138
NODE_240624_length_267_cov_1.750000	179	208	7	1	29	0.0344828
NODE_240653_length_267_cov_1.690476	18	90	0	72	72	1.0000000
NODE_240790_length_267_cov_1.517857	6	43	0	37	37	1.0000000
NODE_241075_length_267_cov_1.214286	37	91	0	54	54	1.0000000
NODE_241240_length_267_cov_1.214286	89	126	0	37	37	1.0000000
NODE_241352_length_267_cov_1.208333	124	164	0	12	40	0.3000000
NODE_241352_length_267_cov_1.208333	124	164	2	28	40	0.7000000
NODE_241484_length_267_cov_1.125000	57	103	0	46	46	1.0000000
NODE_241512_length_267_cov_1.089286	119	196	0	77	77	1.0000000
NODE_241512_length_267_cov_1.089286	169	249	0	80	80	1.0000000
NODE_241517_length_267_cov_1.083333	133	152	22	1	19	0.0526316
NODE_241517_length_267_cov_1.083333	133	152	24	3	19	0.1578947
NODE_241517_length_267_cov_1.083333	133	152	26	2	19	0.1052632
NODE_241517_length_267_cov_1.083333	133	152	28	1	19	0.0526316
NODE_241517_length_267_cov_1.083333	133	152	30	12	19	0.6315789
NODE_241517_length_267_cov_1.083333	183	264	0	22	81	0.2716049
NODE_241517_length_267_cov_1.083333	183	264	2	7	81	0.0864198
NODE_241517_length_267_cov_1.083333	183	264	4	7	81	0.0864198
NODE_241517_length_267_cov_1.083333	183	264	6	2	81	0.0246914
NODE_241517_length_267_cov_1.083333	183	264	8	4	81	0.0493827
NODE_241517_length_267_cov_1.083333	183	264	10	1	81	0.0123457
NODE_241517_length_267_cov_1.083333	183	264	12	1	81	0.0123457
NODE_241517_length_267_cov_1.083333	183	264	14	3	81	0.0370370
NODE_241517_length_267_cov_1.083333	183	264	16	4	81	0.0493827
NODE_241517_length_267_cov_1.083333	183	264	18	1	81	0.0123457
NODE_241517_length_267_cov_1.083333	183	264	20	19	81	0.2345679
NODE_241517_length_267_cov_1.083333	183	264	22	10	81	0.1234568
NODE_241588_length_267_cov_1.017857	205	267	0	35	62	0.5645161
NODE_241588_length_267_cov_1.017857	205	267	1	27	62	0.4354839
NODE_241633_length_267_cov_0.982143	4	75	0	4	71	0.0563380
NODE_241633_length_267_cov_0.982143	4	75	2	67	71	0.9436620
NODE_242999_length_266_cov_5.706587	120	199	0	79	79	1.0000000
NODE_242999_length_266_cov_5.706587	172	239	0	67	67	1.0000000
NODE_243010_length_266_cov_5.107784	68	150	4	82	82	1.0000000
NODE_243064_length_266_cov_4.125749	99	168	8	4	69	0.0579710
NODE_243064_length_266_cov_4.125749	99	168	16	15	69	0.2173913
NODE_243064_length_266_cov_4.125749	99	168	17	14	69	0.2028985
NODE_243064_length_266_cov_4.125749	99	168	18	14	69	0.2028985
NODE_243064_length_266_cov_4.125749	99	168	19	6	69	0.0869565
NODE_243064_length_266_cov_4.125749	99	168	20	16	69	0.2318841
NODE_243079_length_266_cov_3.958084	40	120	0	80	80	1.0000000
NODE_243079_length_266_cov_3.958084	93	159	0	66	66	1.0000000
NODE_243136_length_266_cov_3.419162	68	130	0	62	62	1.0000000
NODE_243136_length_266_cov_3.419162	116	183	0	16	67	0.2388060
NODE_243136_length_266_cov_3.419162	116	183	2	51	67	0.7611941
NODE_243168_length_266_cov_3.137725	6	86	0	80	80	1.0000000
NODE_243168_length_266_cov_3.137725	59	120	0	61	61	1.0000000
NODE_243174_length_266_cov_3.107784	166	232	16	1	66	0.0151515
NODE_243174_length_266_cov_3.107784	166	232	18	4	66	0.0606061
NODE_243174_length_266_cov_3.107784	166	232	22	21	66	0.3181818
NODE_243174_length_266_cov_3.107784	166	232	24	10	66	0.1515152
NODE_243174_length_266_cov_3.107784	166	232	26	14	66	0.2121212
NODE_243174_length_266_cov_3.107784	166	232	28	5	66	0.0757576
NODE_243174_length_266_cov_3.107784	166	232	34	1	66	0.0151515
NODE_243174_length_266_cov_3.107784	166	232	36	5	66	0.0757576
NODE_243174_length_266_cov_3.107784	166	232	38	4	66	0.0606061
NODE_243174_length_266_cov_3.107784	166	232	39	1	66	0.0151515
NODE_243475_length_266_cov_2.179641	110	191	10	1	81	0.0123457
NODE_243475_length_266_cov_2.179641	110	191	12	2	81	0.0246914
NODE_243475_length_266_cov_2.179641	110	191	13	4	81	0.0493827
NODE_243475_length_266_cov_2.179641	110	191	15	7	81	0.0864198
NODE_243475_length_266_cov_2.179641	110	191	17	12	81	0.1481481
NODE_243475_length_266_cov_2.179641	110	191	19	1	81	0.0123457
NODE_243475_length_266_cov_2.179641	110	191	21	7	81	0.0864198
NODE_243475_length_266_cov_2.179641	110	191	25	2	81	0.0246914
NODE_243475_length_266_cov_2.179641	110	191	27	17	81	0.2098765
NODE_243475_length_266_cov_2.179641	110	191	29	11	81	0.1358025
NODE_243475_length_266_cov_2.179641	110	191	31	8	81	0.0987654
NODE_243475_length_266_cov_2.179641	110	191	33	9	81	0.1111111
NODE_243497_length_266_cov_2.137725	156	236	2	11	80	0.1375000
NODE_243497_length_266_cov_2.137725	156	236	4	69	80	0.8625000
NODE_243570_length_266_cov_2.023952	47	123	0	76	76	1.0000000
NODE_243972_length_266_cov_1.532934	155	235	0	52	80	0.6500000
NODE_243972_length_266_cov_1.532934	155	235	4	28	80	0.3500000
NODE_244681_length_266_cov_1.113772	70	97	0	27	27	1.0000000
NODE_244760_length_266_cov_1.023952	144	201	4	26	57	0.4561403
NODE_244760_length_266_cov_1.023952	144	201	6	31	57	0.5438597
NODE_244760_length_266_cov_1.023952	199	265	2	33	66	0.5000000
NODE_244760_length_266_cov_1.023952	199	265	4	16	66	0.2424242
NODE_244760_length_266_cov_1.023952	199	265	6	17	66	0.2575758
NODE_245049_length_266_cov_0.916168	51	122	0	27	71	0.3802817
NODE_245049_length_266_cov_0.916168	51	122	2	11	71	0.1549296
NODE_245049_length_266_cov_0.916168	51	122	3	8	71	0.1126761
NODE_245049_length_266_cov_0.916168	51	122	4	25	71	0.3521127
NODE_245280_length_266_cov_0.730539	132	158	0	26	26	1.0000000
NODE_245538_length_266_cov_0.610778	99	139	0	40	40	1.0000000
NODE_245538_length_266_cov_0.610778	112	156	0	44	44	1.0000000
NODE_246087_length_265_cov_7.843373	128	208	6	33	80	0.4125000
NODE_246087_length_265_cov_7.843373	128	208	8	2	80	0.0250000
NODE_246087_length_265_cov_7.843373	128	208	9	1	80	0.0125000
NODE_246087_length_265_cov_7.843373	128	208	10	13	80	0.1625000
NODE_246087_length_265_cov_7.843373	128	208	11	2	80	0.0250000
NODE_246087_length_265_cov_7.843373	128	208	12	3	80	0.0375000
NODE_246087_length_265_cov_7.843373	128	208	14	1	80	0.0125000
NODE_246087_length_265_cov_7.843373	128	208	16	11	80	0.1375000
NODE_246087_length_265_cov_7.843373	128	208	17	3	80	0.0375000
NODE_246087_length_265_cov_7.843373	128	208	19	2	80	0.0250000
NODE_246087_length_265_cov_7.843373	128	208	21	1	80	0.0125000
NODE_246087_length_265_cov_7.843373	128	208	22	1	80	0.0125000
NODE_246087_length_265_cov_7.843373	128	208	26	4	80	0.0500000
NODE_246087_length_265_cov_7.843373	128	208	27	1	80	0.0125000
NODE_246087_length_265_cov_7.843373	128	208	28	1	80	0.0125000
NODE_246087_length_265_cov_7.843373	128	208	29	1	80	0.0125000
NODE_246192_length_265_cov_4.054217	65	145	0	80	80	1.0000000
NODE_246192_length_265_cov_4.054217	118	198	0	80	80	1.0000000
NODE_246198_length_265_cov_3.993976	195	231	0	36	36	1.0000000
NODE_246284_length_265_cov_3.150602	183	263	0	80	80	1.0000000
NODE_246374_length_265_cov_2.789157	177	238	0	61	61	1.0000000
NODE_246409_length_265_cov_2.734940	167	247	2	17	80	0.2125000
NODE_246409_length_265_cov_2.734940	167	247	4	63	80	0.7875000
NODE_246432_length_265_cov_2.608434	188	259	0	71	71	1.0000000
NODE_246606_length_265_cov_2.156627	197	237	2	40	40	1.0000000
NODE_246624_length_265_cov_2.150602	169	218	2	49	49	1.0000000
NODE_246692_length_265_cov_1.975904	15	44	0	29	29	1.0000000
NODE_246811_length_265_cov_1.843373	195	265	0	70	70	1.0000000
NODE_247028_length_265_cov_1.620482	115	186	0	30	71	0.4225352
NODE_247028_length_265_cov_1.620482	115	186	2	1	71	0.0140845
NODE_247028_length_265_cov_1.620482	115	186	4	7	71	0.0985916
NODE_247028_length_265_cov_1.620482	115	186	8	33	71	0.4647887
NODE_247028_length_265_cov_1.620482	117	171	0	28	54	0.5185185
NODE_247028_length_265_cov_1.620482	117	171	2	1	54	0.0185185
NODE_247028_length_265_cov_1.620482	117	171	4	7	54	0.1296296
NODE_247028_length_265_cov_1.620482	117	171	8	18	54	0.3333333
NODE_247031_length_265_cov_1.614458	53	113	12	3	60	0.0500000
NODE_247031_length_265_cov_1.614458	53	113	14	3	60	0.0500000
NODE_247031_length_265_cov_1.614458	53	113	18	2	60	0.0333333
NODE_247031_length_265_cov_1.614458	53	113	20	8	60	0.1333333
NODE_247031_length_265_cov_1.614458	53	113	26	3	60	0.0500000
NODE_247031_length_265_cov_1.614458	53	113	29	3	60	0.0500000
NODE_247031_length_265_cov_1.614458	53	113	31	4	60	0.0666667
NODE_247031_length_265_cov_1.614458	53	113	33	1	60	0.0166667
NODE_247031_length_265_cov_1.614458	53	113	39	5	60	0.0833333
NODE_247031_length_265_cov_1.614458	53	113	40	2	60	0.0333333
NODE_247031_length_265_cov_1.614458	53	113	41	5	60	0.0833333
NODE_247031_length_265_cov_1.614458	53	113	43	1	60	0.0166667
NODE_247031_length_265_cov_1.614458	53	113	47	1	60	0.0166667
NODE_247031_length_265_cov_1.614458	53	113	48	7	60	0.1166667
NODE_247031_length_265_cov_1.614458	53	113	50	2	60	0.0333333
NODE_247031_length_265_cov_1.614458	53	113	54	2	60	0.0333333
NODE_247031_length_265_cov_1.614458	53	113	56	8	60	0.1333333
NODE_247031_length_265_cov_1.614458	86	166	40	1	80	0.0125000
NODE_247031_length_265_cov_1.614458	86	166	41	5	80	0.0625000
NODE_247031_length_265_cov_1.614458	86	166	43	1	80	0.0125000
NODE_247031_length_265_cov_1.614458	86	166	47	1	80	0.0125000
NODE_247031_length_265_cov_1.614458	86	166	48	7	80	0.0875000
NODE_247031_length_265_cov_1.614458	86	166	50	2	80	0.0250000
NODE_247031_length_265_cov_1.614458	86	166	54	2	80	0.0250000
NODE_247031_length_265_cov_1.614458	86	166	56	10	80	0.1250000
NODE_247031_length_265_cov_1.614458	86	166	60	2	80	0.0250000
NODE_247031_length_265_cov_1.614458	86	166	62	1	80	0.0125000
NODE_247031_length_265_cov_1.614458	86	166	63	3	80	0.0375000
NODE_247031_length_265_cov_1.614458	86	166	64	6	80	0.0750000
NODE_247031_length_265_cov_1.614458	86	166	65	3	80	0.0375000
NODE_247031_length_265_cov_1.614458	86	166	66	1	80	0.0125000
NODE_247031_length_265_cov_1.614458	86	166	67	3	80	0.0375000
NODE_247031_length_265_cov_1.614458	86	166	68	3	80	0.0375000
NODE_247031_length_265_cov_1.614458	86	166	69	1	80	0.0125000
NODE_247031_length_265_cov_1.614458	86	166	71	1	80	0.0125000
NODE_247031_length_265_cov_1.614458	86	166	72	5	80	0.0625000
NODE_247031_length_265_cov_1.614458	86	166	74	13	80	0.1625000
NODE_247031_length_265_cov_1.614458	86	166	76	4	80	0.0500000
NODE_247031_length_265_cov_1.614458	86	166	78	5	80	0.0625000
NODE_247314_length_265_cov_1.337349	107	168	6	4	61	0.0655738
NODE_247314_length_265_cov_1.337349	107	168	10	1	61	0.0163934
NODE_247314_length_265_cov_1.337349	107	168	12	12	61	0.1967213
NODE_247314_length_265_cov_1.337349	107	168	13	3	61	0.0491803
NODE_247314_length_265_cov_1.337349	107	168	15	41	61	0.6721311
NODE_247952_length_265_cov_1.000000	187	251	8	64	64	1.0000000
NODE_247972_length_265_cov_0.987952	44	63	0	19	19	1.0000000
NODE_249395_length_264_cov_4.018182	141	178	0	37	37	1.0000000
NODE_249404_length_264_cov_3.957576	59	132	0	9	73	0.1232877
NODE_249404_length_264_cov_3.957576	59	132	6	3	73	0.0410959
NODE_249404_length_264_cov_3.957576	59	132	8	61	73	0.8356164
NODE_249404_length_264_cov_3.957576	112	192	0	5	80	0.0625000
NODE_249404_length_264_cov_3.957576	112	192	2	26	80	0.3250000
NODE_249404_length_264_cov_3.957576	112	192	8	49	80	0.6125000
NODE_249415_length_264_cov_3.824242	178	220	2	42	42	1.0000000
NODE_249452_length_264_cov_3.400000	73	125	0	52	52	1.0000000
NODE_249452_length_264_cov_3.400000	124	165	0	22	41	0.5365854
NODE_249452_length_264_cov_3.400000	124	165	2	19	41	0.4634146
NODE_249485_length_264_cov_3.133333	119	186	0	67	67	1.0000000
NODE_249530_length_264_cov_3.012121	122	198	0	76	76	1.0000000
NODE_249904_length_264_cov_2.048485	32	98	0	4	66	0.0606061
NODE_249904_length_264_cov_2.048485	32	98	2	53	66	0.8030303
NODE_249904_length_264_cov_2.048485	32	98	8	6	66	0.0909091
NODE_249904_length_264_cov_2.048485	32	98	10	3	66	0.0454545
NODE_249905_length_264_cov_2.048485	133	176	0	43	43	1.0000000
NODE_249912_length_264_cov_2.012121	20	84	0	8	64	0.1250000
NODE_249912_length_264_cov_2.012121	20	84	4	56	64	0.8750000
NODE_249931_length_264_cov_1.951515	178	211	4	33	33	1.0000000
NODE_249982_length_264_cov_1.854545	130	161	2	29	31	0.9354839
NODE_249982_length_264_cov_1.854545	130	161	4	2	31	0.0645161
NODE_250202_length_264_cov_1.745455	26	81	0	55	55	1.0000000
NODE_250202_length_264_cov_1.745455	86	153	0	67	67	1.0000000
NODE_250203_length_264_cov_1.745455	90	169	8	7	79	0.0886076
NODE_250203_length_264_cov_1.745455	90	169	10	13	79	0.1645570
NODE_250203_length_264_cov_1.745455	90	169	12	12	79	0.1518987
NODE_250203_length_264_cov_1.745455	90	169	16	3	79	0.0379747
NODE_250203_length_264_cov_1.745455	90	169	18	5	79	0.0632911
NODE_250203_length_264_cov_1.745455	90	169	20	2	79	0.0253165
NODE_250203_length_264_cov_1.745455	90	169	22	4	79	0.0506329
NODE_250203_length_264_cov_1.745455	90	169	24	24	79	0.3037975
NODE_250203_length_264_cov_1.745455	90	169	26	9	79	0.1139240
NODE_250203_length_264_cov_1.745455	143	207	18	23	64	0.3593750
NODE_250203_length_264_cov_1.745455	143	207	20	16	64	0.2500000
NODE_250203_length_264_cov_1.745455	143	207	24	16	64	0.2500000
NODE_250203_length_264_cov_1.745455	143	207	26	9	64	0.1406250
NODE_250297_length_264_cov_1.569697	173	236	0	63	63	1.0000000
NODE_250314_length_264_cov_1.545455	206	255	2	1	49	0.0204082
NODE_250314_length_264_cov_1.545455	206	255	6	48	49	0.9795918
NODE_250381_length_264_cov_1.545455	35	66	2	31	31	1.0000000
NODE_250446_length_264_cov_1.503030	0	63	0	63	63	1.0000000
NODE_250513_length_264_cov_1.406061	149	230	0	81	81	1.0000000
NODE_250513_length_264_cov_1.406061	225	260	0	35	35	1.0000000
NODE_250635_length_264_cov_1.236364	2	63	2	61	61	1.0000000
NODE_251015_length_264_cov_1.151515	11	68	0	38	57	0.6666667
NODE_251015_length_264_cov_1.151515	11	68	2	19	57	0.3333333
NODE_251529_length_264_cov_0.921212	49	85	0	36	36	1.0000000
NODE_251703_length_264_cov_0.721212	233	252	0	19	19	1.0000000
NODE_252559_length_263_cov_5.115854	132	219	32	3	87	0.0344828
NODE_252559_length_263_cov_5.115854	132	219	35	1	87	0.0114943
NODE_252559_length_263_cov_5.115854	132	219	36	1	87	0.0114943
NODE_252559_length_263_cov_5.115854	132	219	42	7	87	0.0804598
NODE_252559_length_263_cov_5.115854	132	219	44	6	87	0.0689655
NODE_252559_length_263_cov_5.115854	132	219	46	4	87	0.0459770
NODE_252559_length_263_cov_5.115854	132	219	48	1	87	0.0114943
NODE_252559_length_263_cov_5.115854	132	219	52	2	87	0.0229885
NODE_252559_length_263_cov_5.115854	132	219	56	30	87	0.3448276
NODE_252559_length_263_cov_5.115854	132	219	58	32	87	0.3678161
NODE_252563_length_263_cov_4.914634	45	117	4	14	72	0.1944444
NODE_252563_length_263_cov_4.914634	45	117	6	5	72	0.0694444
NODE_252563_length_263_cov_4.914634	45	117	8	24	72	0.3333333
NODE_252563_length_263_cov_4.914634	45	117	10	29	72	0.4027778
NODE_252595_length_263_cov_4.225610	67	124	2	22	57	0.3859649
NODE_252595_length_263_cov_4.225610	67	124	4	35	57	0.6140351
NODE_252663_length_263_cov_3.518293	104	176	0	72	72	1.0000000
NODE_252766_length_263_cov_2.908537	7	93	0	78	86	0.9069768
NODE_252766_length_263_cov_2.908537	7	93	2	3	86	0.0348837
NODE_252766_length_263_cov_2.908537	7	93	4	5	86	0.0581395
NODE_252778_length_263_cov_2.798780	67	146	14	16	79	0.2025317
NODE_252778_length_263_cov_2.798780	67	146	16	39	79	0.4936709
NODE_252778_length_263_cov_2.798780	67	146	18	24	79	0.3037975
NODE_252932_length_263_cov_2.396341	207	238	0	31	31	1.0000000
NODE_253261_length_263_cov_1.865854	51	81	13	12	30	0.4000000
NODE_253261_length_263_cov_1.865854	51	81	16	3	30	0.1000000
NODE_253261_length_263_cov_1.865854	51	81	19	5	30	0.1666667
NODE_253261_length_263_cov_1.865854	51	81	23	1	30	0.0333333
NODE_253261_length_263_cov_1.865854	51	81	24	9	30	0.3000000
NODE_253310_length_263_cov_1.847561	113	189	2	7	76	0.0921053
NODE_253310_length_263_cov_1.847561	113	189	4	24	76	0.3157895
NODE_253310_length_263_cov_1.847561	113	189	8	45	76	0.5921053
NODE_253379_length_263_cov_1.750000	151	231	0	33	80	0.4125000
NODE_253379_length_263_cov_1.750000	151	231	2	47	80	0.5875000
NODE_253468_length_263_cov_1.579268	32	95	24	4	63	0.0634921
NODE_253468_length_263_cov_1.579268	32	95	26	5	63	0.0793651
NODE_253468_length_263_cov_1.579268	32	95	28	5	63	0.0793651
NODE_253468_length_263_cov_1.579268	32	95	32	2	63	0.0317460
NODE_253468_length_263_cov_1.579268	32	95	36	7	63	0.1111111
NODE_253468_length_263_cov_1.579268	32	95	38	1	63	0.0158730
NODE_253468_length_263_cov_1.579268	32	95	40	2	63	0.0317460
NODE_253468_length_263_cov_1.579268	32	95	42	6	63	0.0952381
NODE_253468_length_263_cov_1.579268	32	95	44	2	63	0.0317460
NODE_253468_length_263_cov_1.579268	32	95	46	9	63	0.1428571
NODE_253468_length_263_cov_1.579268	32	95	48	6	63	0.0952381
NODE_253468_length_263_cov_1.579268	32	95	50	1	63	0.0158730
NODE_253468_length_263_cov_1.579268	32	95	52	2	63	0.0317460
NODE_253468_length_263_cov_1.579268	32	95	54	11	63	0.1746032
NODE_253477_length_263_cov_1.567073	98	155	0	21	57	0.3684210
NODE_253477_length_263_cov_1.567073	98	155	2	36	57	0.6315789
NODE_253619_length_263_cov_1.506098	157	217	0	25	60	0.4166667
NODE_253619_length_263_cov_1.506098	157	217	2	35	60	0.5833333
NODE_253620_length_263_cov_1.506098	84	113	6	29	29	1.0000000
NODE_253753_length_263_cov_1.286585	143	223	0	3	80	0.0375000
NODE_253753_length_263_cov_1.286585	143	223	6	2	80	0.0250000
NODE_253753_length_263_cov_1.286585	143	223	8	5	80	0.0625000
NODE_253753_length_263_cov_1.286585	143	223	10	3	80	0.0375000
NODE_253753_length_263_cov_1.286585	143	223	12	2	80	0.0250000
NODE_253753_length_263_cov_1.286585	143	223	14	5	80	0.0625000
NODE_253753_length_263_cov_1.286585	143	223	16	1	80	0.0125000
NODE_253753_length_263_cov_1.286585	143	223	18	8	80	0.1000000
NODE_253753_length_263_cov_1.286585	143	223	20	4	80	0.0500000
NODE_253753_length_263_cov_1.286585	143	223	22	3	80	0.0375000
NODE_253753_length_263_cov_1.286585	143	223	23	2	80	0.0250000
NODE_253753_length_263_cov_1.286585	143	223	25	1	80	0.0125000
NODE_253753_length_263_cov_1.286585	143	223	31	1	80	0.0125000
NODE_253753_length_263_cov_1.286585	143	223	34	8	80	0.1000000
NODE_253753_length_263_cov_1.286585	143	223	36	32	80	0.4000000
NODE_253788_length_263_cov_1.243902	206	263	0	57	57	1.0000000
NODE_254174_length_263_cov_1.170732	12	66	0	54	54	1.0000000
NODE_254174_length_263_cov_1.170732	39	119	0	80	80	1.0000000
NODE_254301_length_263_cov_1.067073	137	202	0	11	65	0.1692308
NODE_254301_length_263_cov_1.067073	137	202	2	54	65	0.8307692
NODE_254301_length_263_cov_1.067073	175	255	0	19	80	0.2375000
NODE_254301_length_263_cov_1.067073	175	255	2	61	80	0.7625000
NODE_254783_length_263_cov_0.810976	163	245	73	1	82	0.0121951
NODE_254783_length_263_cov_0.810976	163	245	76	1	82	0.0121951
NODE_254783_length_263_cov_0.810976	163	245	80	2	82	0.0243902
NODE_254783_length_263_cov_0.810976	163	245	83	1	82	0.0121951
NODE_254783_length_263_cov_0.810976	163	245	88	1	82	0.0121951
NODE_254783_length_263_cov_0.810976	163	245	90	1	82	0.0121951
NODE_254783_length_263_cov_0.810976	163	245	98	1	82	0.0121951
NODE_254783_length_263_cov_0.810976	163	245	110	1	82	0.0121951
NODE_254783_length_263_cov_0.810976	163	245	125	3	82	0.0365854
NODE_254783_length_263_cov_0.810976	163	245	129	1	82	0.0121951
NODE_254783_length_263_cov_0.810976	163	245	133	1	82	0.0121951
NODE_254783_length_263_cov_0.810976	163	245	138	1	82	0.0121951
NODE_254783_length_263_cov_0.810976	163	245	140	1	82	0.0121951
NODE_254783_length_263_cov_0.810976	163	245	144	1	82	0.0121951
NODE_254783_length_263_cov_0.810976	163	245	150	2	82	0.0243902
NODE_254783_length_263_cov_0.810976	163	245	151	1	82	0.0121951
NODE_254783_length_263_cov_0.810976	163	245	161	2	82	0.0243902
NODE_254783_length_263_cov_0.810976	163	245	162	1	82	0.0121951
NODE_254783_length_263_cov_0.810976	163	245	165	1	82	0.0121951
NODE_254783_length_263_cov_0.810976	163	245	168	1	82	0.0121951
NODE_254783_length_263_cov_0.810976	163	245	172	1	82	0.0121951
NODE_254783_length_263_cov_0.810976	163	245	173	1	82	0.0121951
NODE_254783_length_263_cov_0.810976	163	245	175	1	82	0.0121951
NODE_254783_length_263_cov_0.810976	163	245	179	3	82	0.0365854
NODE_254783_length_263_cov_0.810976	163	245	181	1	82	0.0121951
NODE_254783_length_263_cov_0.810976	163	245	193	2	82	0.0243902
NODE_254783_length_263_cov_0.810976	163	245	210	1	82	0.0121951
NODE_254783_length_263_cov_0.810976	163	245	223	2	82	0.0243902
NODE_254783_length_263_cov_0.810976	163	245	245	1	82	0.0121951
NODE_254783_length_263_cov_0.810976	163	245	256	1	82	0.0121951
NODE_254783_length_263_cov_0.810976	163	245	278	1	82	0.0121951
NODE_254783_length_263_cov_0.810976	163	245	289	1	82	0.0121951
NODE_254783_length_263_cov_0.810976	163	245	314	1	82	0.0121951
NODE_254783_length_263_cov_0.810976	163	245	315	1	82	0.0121951
NODE_254783_length_263_cov_0.810976	163	245	319	1	82	0.0121951
NODE_254783_length_263_cov_0.810976	163	245	326	1	82	0.0121951
NODE_254783_length_263_cov_0.810976	163	245	340	1	82	0.0121951
NODE_254783_length_263_cov_0.810976	163	245	348	2	82	0.0243902
NODE_254783_length_263_cov_0.810976	163	245	352	1	82	0.0121951
NODE_254783_length_263_cov_0.810976	163	245	356	1	82	0.0121951
NODE_254783_length_263_cov_0.810976	163	245	364	1	82	0.0121951
NODE_254783_length_263_cov_0.810976	163	245	369	1	82	0.0121951
NODE_254783_length_263_cov_0.810976	163	245	375	1	82	0.0121951
NODE_254783_length_263_cov_0.810976	163	245	379	2	82	0.0243902
NODE_254783_length_263_cov_0.810976	163	245	383	2	82	0.0243902
NODE_254783_length_263_cov_0.810976	163	245	393	1	82	0.0121951
NODE_254783_length_263_cov_0.810976	163	245	401	1	82	0.0121951
NODE_254783_length_263_cov_0.810976	163	245	408	1	82	0.0121951
NODE_254783_length_263_cov_0.810976	163	245	416	1	82	0.0121951
NODE_254783_length_263_cov_0.810976	163	245	419	1	82	0.0121951
NODE_254783_length_263_cov_0.810976	163	245	425	1	82	0.0121951
NODE_254783_length_263_cov_0.810976	163	245	429	1	82	0.0121951
NODE_254783_length_263_cov_0.810976	163	245	435	1	82	0.0121951
NODE_254783_length_263_cov_0.810976	163	245	444	1	82	0.0121951
NODE_254783_length_263_cov_0.810976	163	245	459	1	82	0.0121951
NODE_254783_length_263_cov_0.810976	163	245	466	1	82	0.0121951
NODE_254783_length_263_cov_0.810976	163	245	471	1	82	0.0121951
NODE_254783_length_263_cov_0.810976	163	245	485	1	82	0.0121951
NODE_254783_length_263_cov_0.810976	163	245	487	1	82	0.0121951
NODE_254783_length_263_cov_0.810976	163	245	489	1	82	0.0121951
NODE_254783_length_263_cov_0.810976	163	245	492	2	82	0.0243902
NODE_254783_length_263_cov_0.810976	163	245	503	1	82	0.0121951
NODE_254783_length_263_cov_0.810976	163	245	505	1	82	0.0121951
NODE_254783_length_263_cov_0.810976	163	245	507	3	82	0.0365854
NODE_254783_length_263_cov_0.810976	163	245	508	3	82	0.0365854
NODE_255446_length_263_cov_0.621951	212	258	0	46	46	1.0000000
NODE_255524_length_263_cov_0.621951	131	151	0	20	20	1.0000000
NODE_255559_length_263_cov_0.621951	67	86	0	19	19	1.0000000
NODE_255727_length_262_cov_5.312883	20	82	0	62	62	1.0000000
NODE_255769_length_262_cov_4.447853	102	155	0	15	53	0.2830189
NODE_255769_length_262_cov_4.447853	102	155	5	2	53	0.0377358
NODE_255769_length_262_cov_4.447853	102	155	6	33	53	0.6226415
NODE_255769_length_262_cov_4.447853	102	155	8	3	53	0.0566038
NODE_255821_length_262_cov_3.766871	48	89	0	29	41	0.7073171
NODE_255821_length_262_cov_3.766871	48	89	2	7	41	0.1707317
NODE_255821_length_262_cov_3.766871	48	89	4	5	41	0.1219512
NODE_255860_length_262_cov_3.435583	158	235	0	77	77	1.0000000
NODE_255945_length_262_cov_2.938650	142	222	9	17	80	0.2125000
NODE_255945_length_262_cov_2.938650	142	222	10	44	80	0.5500000
NODE_255945_length_262_cov_2.938650	142	222	11	19	80	0.2375000
NODE_256009_length_262_cov_2.723926	103	183	0	48	80	0.6000000
NODE_256009_length_262_cov_2.723926	103	183	2	32	80	0.4000000
NODE_256049_length_262_cov_2.509202	88	148	12	1	60	0.0166667
NODE_256049_length_262_cov_2.509202	88	148	16	2	60	0.0333333
NODE_256049_length_262_cov_2.509202	88	148	18	4	60	0.0666667
NODE_256049_length_262_cov_2.509202	88	148	20	8	60	0.1333333
NODE_256049_length_262_cov_2.509202	88	148	22	30	60	0.5000000
NODE_256049_length_262_cov_2.509202	88	148	26	15	60	0.2500000
NODE_256050_length_262_cov_2.509202	0	61	0	61	61	1.0000000
NODE_256050_length_262_cov_2.509202	107	171	0	64	64	1.0000000
NODE_256050_length_262_cov_2.509202	144	224	0	80	80	1.0000000
NODE_256129_length_262_cov_2.429448	14	87	0	39	73	0.5342466
NODE_256129_length_262_cov_2.429448	14	87	2	34	73	0.4657534
NODE_256129_length_262_cov_2.429448	62	149	0	80	87	0.9195402
NODE_256129_length_262_cov_2.429448	62	149	2	7	87	0.0804598
NODE_256176_length_262_cov_2.226994	2	79	0	77	77	1.0000000
NODE_256187_length_262_cov_2.202454	61	81	0	20	20	1.0000000
NODE_256199_length_262_cov_2.190184	172	235	36	3	63	0.0476190
NODE_256199_length_262_cov_2.190184	172	235	38	1	63	0.0158730
NODE_256199_length_262_cov_2.190184	172	235	41	3	63	0.0476190
NODE_256199_length_262_cov_2.190184	172	235	43	3	63	0.0476190
NODE_256199_length_262_cov_2.190184	172	235	45	4	63	0.0634921
NODE_256199_length_262_cov_2.190184	172	235	47	3	63	0.0476190
NODE_256199_length_262_cov_2.190184	172	235	48	5	63	0.0793651
NODE_256199_length_262_cov_2.190184	172	235	49	1	63	0.0158730
NODE_256199_length_262_cov_2.190184	172	235	50	8	63	0.1269841
NODE_256199_length_262_cov_2.190184	172	235	51	10	63	0.1587302
NODE_256199_length_262_cov_2.190184	172	235	53	22	63	0.3492064
NODE_256239_length_262_cov_2.177914	133	189	2	56	56	1.0000000
NODE_256265_length_262_cov_2.122699	96	157	0	57	61	0.9344262
NODE_256265_length_262_cov_2.122699	96	157	2	4	61	0.0655738
NODE_256386_length_262_cov_1.877301	0	77	0	77	77	1.0000000
NODE_256390_length_262_cov_1.877301	77	124	12	2	47	0.0425532
NODE_256390_length_262_cov_1.877301	77	124	14	2	47	0.0425532
NODE_256390_length_262_cov_1.877301	77	124	16	11	47	0.2340426
NODE_256390_length_262_cov_1.877301	77	124	18	32	47	0.6808510
NODE_256481_length_262_cov_1.871166	192	252	0	60	60	1.0000000
NODE_256596_length_262_cov_1.736196	149	208	0	59	59	1.0000000
NODE_256630_length_262_cov_1.680982	2	82	0	80	80	1.0000000
NODE_256650_length_262_cov_1.656442	135	166	4	2	31	0.0645161
NODE_256650_length_262_cov_1.656442	135	166	5	29	31	0.9354839
NODE_256659_length_262_cov_1.638037	111	142	8	11	31	0.3548387
NODE_256659_length_262_cov_1.638037	111	142	10	8	31	0.2580645
NODE_256659_length_262_cov_1.638037	111	142	12	4	31	0.1290323
NODE_256659_length_262_cov_1.638037	111	142	14	8	31	0.2580645
NODE_256704_length_262_cov_1.576687	102	182	4	80	80	1.0000000
NODE_256704_length_262_cov_1.576687	155	221	0	12	66	0.1818182
NODE_256704_length_262_cov_1.576687	155	221	4	54	66	0.8181818
NODE_256742_length_262_cov_1.564417	69	124	2	6	55	0.1090909
NODE_256742_length_262_cov_1.564417	69	124	4	13	55	0.2363636
NODE_256742_length_262_cov_1.564417	69	124	8	7	55	0.1272727
NODE_256742_length_262_cov_1.564417	69	124	10	29	55	0.5272727
NODE_256742_length_262_cov_1.564417	106	177	8	7	71	0.0985916
NODE_256742_length_262_cov_1.564417	106	177	10	27	71	0.3802817
NODE_256742_length_262_cov_1.564417	106	177	12	37	71	0.5211267
NODE_256933_length_262_cov_1.349693	52	102	0	50	50	1.0000000
NODE_256933_length_262_cov_1.349693	83	149	0	66	66	1.0000000
NODE_257199_length_262_cov_1.251534	44	124	0	29	80	0.3625000
NODE_257199_length_262_cov_1.251534	44	124	2	11	80	0.1375000
NODE_257199_length_262_cov_1.251534	44	124	4	40	80	0.5000000
NODE_257199_length_262_cov_1.251534	97	171	2	3	74	0.0405405
NODE_257199_length_262_cov_1.251534	97	171	4	71	74	0.9594595
NODE_258876_length_261_cov_31.913580	32	112	2	7	80	0.0875000
NODE_258876_length_261_cov_31.913580	32	112	4	24	80	0.3000000
NODE_258876_length_261_cov_31.913580	32	112	6	49	80	0.6125000
NODE_258876_length_261_cov_31.913580	85	171	0	47	86	0.5465117
NODE_258876_length_261_cov_31.913580	85	171	2	19	86	0.2209302
NODE_258876_length_261_cov_31.913580	85	171	6	20	86	0.2325581
NODE_258901_length_261_cov_6.376543	126	201	0	75	75	1.0000000
NODE_258901_length_261_cov_6.376543	179	254	0	75	75	1.0000000
NODE_258929_length_261_cov_5.469136	56	132	0	76	76	1.0000000
NODE_259329_length_261_cov_2.425926	53	134	0	81	81	1.0000000
NODE_259361_length_261_cov_2.333333	41	136	0	13	95	0.1368421
NODE_259361_length_261_cov_2.333333	41	136	4	82	95	0.8631579
NODE_259435_length_261_cov_2.191358	86	122	0	12	36	0.3333333
NODE_259435_length_261_cov_2.191358	86	122	2	24	36	0.6666667
NODE_259495_length_261_cov_1.993827	134	214	0	16	80	0.2000000
NODE_259495_length_261_cov_1.993827	134	214	2	64	80	0.8000000
NODE_259672_length_261_cov_1.882716	51	105	13	4	54	0.0740741
NODE_259672_length_261_cov_1.882716	51	105	15	8	54	0.1481481
NODE_259672_length_261_cov_1.882716	51	105	17	2	54	0.0370370
NODE_259672_length_261_cov_1.882716	51	105	19	40	54	0.7407407
NODE_259740_length_261_cov_1.839506	118	197	0	2	79	0.0253165
NODE_259740_length_261_cov_1.839506	118	197	2	43	79	0.5443038
NODE_259740_length_261_cov_1.839506	118	197	4	18	79	0.2278481
NODE_259740_length_261_cov_1.839506	118	197	6	3	79	0.0379747
NODE_259740_length_261_cov_1.839506	118	197	8	4	79	0.0506329
NODE_259740_length_261_cov_1.839506	118	197	10	9	79	0.1139240
NODE_259769_length_261_cov_1.783951	69	141	0	19	72	0.2638889
NODE_259769_length_261_cov_1.783951	69	141	2	4	72	0.0555556
NODE_259769_length_261_cov_1.783951	69	141	8	49	72	0.6805556
NODE_260089_length_261_cov_1.388889	202	247	0	45	45	1.0000000
NODE_260090_length_261_cov_1.382716	14	61	0	47	47	1.0000000
NODE_260428_length_261_cov_1.253086	100	138	8	38	38	1.0000000
NODE_260738_length_261_cov_1.030864	122	205	0	83	83	1.0000000
NODE_260738_length_261_cov_1.030864	129	210	0	81	81	1.0000000
NODE_260738_length_261_cov_1.030864	129	184	0	55	55	1.0000000
NODE_260738_length_261_cov_1.030864	187	248	0	61	61	1.0000000
NODE_260767_length_261_cov_1.006173	3	45	0	42	42	1.0000000
NODE_260767_length_261_cov_1.006173	46	98	0	51	52	0.9807692
NODE_260767_length_261_cov_1.006173	46	98	2	1	52	0.0192308
NODE_262062_length_261_cov_0.580247	11	31	0	20	20	1.0000000
NODE_262121_length_260_cov_8.844720	74	138	4	7	64	0.1093750
NODE_262121_length_260_cov_8.844720	74	138	6	57	64	0.8906250
NODE_262123_length_260_cov_8.447205	30	110	0	80	80	1.0000000
NODE_262123_length_260_cov_8.447205	83	167	0	84	84	1.0000000
NODE_262123_length_260_cov_8.447205	163	243	0	80	80	1.0000000
NODE_262149_length_260_cov_5.807453	38	118	0	80	80	1.0000000
NODE_262149_length_260_cov_5.807453	91	171	0	80	80	1.0000000
NODE_262264_length_260_cov_3.645963	5	57	0	52	52	1.0000000
NODE_262329_length_260_cov_3.167702	91	163	0	12	72	0.1666667
NODE_262329_length_260_cov_3.167702	91	163	2	60	72	0.8333333
NODE_262378_length_260_cov_2.981366	58	127	0	69	69	1.0000000
NODE_262384_length_260_cov_2.913043	10	90	0	80	80	1.0000000
NODE_262708_length_260_cov_2.161491	174	251	0	77	77	1.0000000
NODE_262733_length_260_cov_2.080745	188	258	0	70	70	1.0000000
NODE_262788_length_260_cov_1.950311	27	85	0	2	58	0.0344828
NODE_262788_length_260_cov_1.950311	27	85	2	4	58	0.0689655
NODE_262788_length_260_cov_1.950311	27	85	6	14	58	0.2413793
NODE_262788_length_260_cov_1.950311	27	85	8	38	58	0.6551724
NODE_262930_length_260_cov_1.900621	14	50	0	36	36	1.0000000
NODE_263117_length_260_cov_1.683230	50	130	0	80	80	1.0000000
NODE_263428_length_260_cov_1.347826	38	118	0	80	80	1.0000000
NODE_263533_length_260_cov_1.267081	114	199	0	85	85	1.0000000
NODE_263556_length_260_cov_1.267081	198	244	0	46	46	1.0000000
NODE_263568_length_260_cov_1.267081	145	189	10	44	44	1.0000000
NODE_265483_length_259_cov_4.800000	35	95	0	60	60	1.0000000
NODE_265584_length_259_cov_3.675000	119	161	0	42	42	1.0000000
NODE_265584_length_259_cov_3.675000	134	214	0	80	80	1.0000000
NODE_265592_length_259_cov_3.593750	100	143	2	43	43	1.0000000
NODE_265611_length_259_cov_3.475000	198	259	0	61	61	1.0000000
NODE_265625_length_259_cov_3.331250	72	118	0	46	46	1.0000000
NODE_265636_length_259_cov_3.237500	103	160	0	57	57	1.0000000
NODE_265704_length_259_cov_2.937500	209	233	5	16	24	0.6666667
NODE_265704_length_259_cov_2.937500	209	233	7	6	24	0.2500000
NODE_265704_length_259_cov_2.937500	209	233	9	1	24	0.0416667
NODE_265704_length_259_cov_2.937500	209	233	10	1	24	0.0416667
NODE_265735_length_259_cov_2.850000	0	41	0	41	41	1.0000000
NODE_265735_length_259_cov_2.850000	14	94	0	80	80	1.0000000
NODE_265818_length_259_cov_2.550000	9	82	2	73	73	1.0000000
NODE_265942_length_259_cov_2.287500	147	225	0	78	78	1.0000000
NODE_265942_length_259_cov_2.287500	198	241	0	43	43	1.0000000
NODE_266032_length_259_cov_2.156250	0	72	0	72	72	1.0000000
NODE_266080_length_259_cov_2.012500	8	73	0	65	65	1.0000000
NODE_266080_length_259_cov_2.012500	53	126	0	59	73	0.8082192
NODE_266080_length_259_cov_2.012500	53	126	2	7	73	0.0958904
NODE_266080_length_259_cov_2.012500	53	126	4	7	73	0.0958904
NODE_266101_length_259_cov_1.962500	108	189	10	11	81	0.1358025
NODE_266101_length_259_cov_1.962500	108	189	12	70	81	0.8641976
NODE_266117_length_259_cov_1.918750	49	120	0	68	71	0.9577465
NODE_266117_length_259_cov_1.918750	49	120	2	3	71	0.0422535
NODE_266183_length_259_cov_1.912500	114	177	0	57	63	0.9047619
NODE_266183_length_259_cov_1.912500	114	177	2	6	63	0.0952381
NODE_266365_length_259_cov_1.837500	180	252	0	1	72	0.0138889
NODE_266365_length_259_cov_1.837500	180	252	2	16	72	0.2222222
NODE_266365_length_259_cov_1.837500	180	252	4	6	72	0.0833333
NODE_266365_length_259_cov_1.837500	180	252	8	49	72	0.6805556
NODE_266609_length_259_cov_1.593750	27	67	0	40	40	1.0000000
NODE_266746_length_259_cov_1.400000	117	164	0	47	47	1.0000000
NODE_266746_length_259_cov_1.400000	137	217	0	51	80	0.6375000
NODE_266746_length_259_cov_1.400000	137	217	2	29	80	0.3625000
NODE_268816_length_258_cov_6.415094	129	209	0	80	80	1.0000000
NODE_268816_length_258_cov_6.415094	182	258	0	76	76	1.0000000
NODE_268823_length_258_cov_6.157233	1	81	0	80	80	1.0000000
NODE_268823_length_258_cov_6.157233	9	64	0	55	55	1.0000000
NODE_268852_length_258_cov_4.798742	83	163	0	80	80	1.0000000
NODE_268870_length_258_cov_4.396226	0	44	0	41	44	0.9318182
NODE_268870_length_258_cov_4.396226	0	44	2	3	44	0.0681818
NODE_268870_length_258_cov_4.396226	24	97	0	17	73	0.2328767
NODE_268870_length_258_cov_4.396226	24	97	2	21	73	0.2876712
NODE_268870_length_258_cov_4.396226	24	97	3	1	73	0.0136986
NODE_268870_length_258_cov_4.396226	24	97	4	34	73	0.4657534
NODE_268880_length_258_cov_4.301887	0	54	0	52	54	0.9629630
NODE_268880_length_258_cov_4.301887	0	54	4	2	54	0.0370370
NODE_268942_length_258_cov_3.616352	29	58	0	29	29	1.0000000
NODE_268982_length_258_cov_3.352201	47	127	0	2	80	0.0250000
NODE_268982_length_258_cov_3.352201	47	127	2	2	80	0.0250000
NODE_268982_length_258_cov_3.352201	47	127	6	1	80	0.0125000
NODE_268982_length_258_cov_3.352201	47	127	10	2	80	0.0250000
NODE_268982_length_258_cov_3.352201	47	127	12	1	80	0.0125000
NODE_268982_length_258_cov_3.352201	47	127	14	5	80	0.0625000
NODE_268982_length_258_cov_3.352201	47	127	16	54	80	0.6750000
NODE_268982_length_258_cov_3.352201	47	127	18	13	80	0.1625000
NODE_269086_length_258_cov_2.886792	102	121	0	19	19	1.0000000
NODE_269091_length_258_cov_2.880503	92	172	0	61	80	0.7625000
NODE_269091_length_258_cov_2.880503	92	172	2	19	80	0.2375000
NODE_269102_length_258_cov_2.855346	96	138	52	6	42	0.1428571
NODE_269102_length_258_cov_2.855346	96	138	54	5	42	0.1190476
NODE_269102_length_258_cov_2.855346	96	138	58	8	42	0.1904762
NODE_269102_length_258_cov_2.855346	96	138	60	14	42	0.3333333
NODE_269102_length_258_cov_2.855346	96	138	62	3	42	0.0714286
NODE_269102_length_258_cov_2.855346	96	138	64	6	42	0.1428571
NODE_269102_length_258_cov_2.855346	148	191	6	1	43	0.0232558
NODE_269102_length_258_cov_2.855346	148	191	10	6	43	0.1395349
NODE_269102_length_258_cov_2.855346	148	191	13	1	43	0.0232558
NODE_269102_length_258_cov_2.855346	148	191	17	6	43	0.1395349
NODE_269102_length_258_cov_2.855346	148	191	21	1	43	0.0232558
NODE_269102_length_258_cov_2.855346	148	191	23	6	43	0.1395349
NODE_269102_length_258_cov_2.855346	148	191	27	5	43	0.1162791
NODE_269102_length_258_cov_2.855346	148	191	28	1	43	0.0232558
NODE_269102_length_258_cov_2.855346	148	191	31	6	43	0.1395349
NODE_269102_length_258_cov_2.855346	148	191	35	1	43	0.0232558
NODE_269102_length_258_cov_2.855346	148	191	37	6	43	0.1395349
NODE_269102_length_258_cov_2.855346	148	191	40	3	43	0.0697674
NODE_269113_length_258_cov_2.817610	10	58	0	41	48	0.8541667
NODE_269113_length_258_cov_2.817610	10	58	1	5	48	0.1041667
NODE_269113_length_258_cov_2.817610	10	58	3	1	48	0.0208333
NODE_269113_length_258_cov_2.817610	10	58	5	1	48	0.0208333
NODE_269264_length_258_cov_2.383648	48	128	0	80	80	1.0000000
NODE_269264_length_258_cov_2.383648	101	182	0	81	81	1.0000000
NODE_269338_length_258_cov_2.238994	61	141	0	80	80	1.0000000
NODE_269615_length_258_cov_1.918239	0	51	0	51	51	1.0000000
NODE_269682_length_258_cov_1.855346	26	47	1	19	21	0.9047619
NODE_269682_length_258_cov_1.855346	26	47	3	2	21	0.0952381
NODE_269682_length_258_cov_1.855346	71	104	7	33	33	1.0000000
NODE_269682_length_258_cov_1.855346	81	156	6	6	75	0.0800000
NODE_269682_length_258_cov_1.855346	81	156	7	62	75	0.8266667
NODE_269682_length_258_cov_1.855346	81	156	9	7	75	0.0933333
NODE_269749_length_258_cov_1.735849	105	176	3	7	71	0.0985916
NODE_269749_length_258_cov_1.735849	105	176	4	40	71	0.5633803
NODE_269749_length_258_cov_1.735849	105	176	6	10	71	0.1408451
NODE_269749_length_258_cov_1.735849	105	176	8	2	71	0.0281690
NODE_269749_length_258_cov_1.735849	105	176	12	9	71	0.1267606
NODE_269749_length_258_cov_1.735849	105	176	14	3	71	0.0422535
NODE_269767_length_258_cov_1.710692	8	49	0	41	41	1.0000000
NODE_270191_length_258_cov_1.283019	127	191	4	10	64	0.1562500
NODE_270191_length_258_cov_1.283019	127	191	6	6	64	0.0937500
NODE_270191_length_258_cov_1.283019	127	191	8	48	64	0.7500000
NODE_270191_length_258_cov_1.283019	164	227	0	1	63	0.0158730
NODE_270191_length_258_cov_1.283019	164	227	2	2	63	0.0317460
NODE_270191_length_258_cov_1.283019	164	227	4	25	63	0.3968254
NODE_270191_length_258_cov_1.283019	164	227	6	1	63	0.0158730
NODE_270191_length_258_cov_1.283019	164	227	8	34	63	0.5396826
NODE_270465_length_258_cov_1.270440	4	55	0	51	51	1.0000000
NODE_270504_length_258_cov_1.232704	90	166	2	13	76	0.1710526
NODE_270504_length_258_cov_1.232704	90	166	4	3	76	0.0394737
NODE_270504_length_258_cov_1.232704	90	166	6	14	76	0.1842105
NODE_270504_length_258_cov_1.232704	90	166	8	7	76	0.0921053
NODE_270504_length_258_cov_1.232704	90	166	10	14	76	0.1842105
NODE_270504_length_258_cov_1.232704	90	166	12	10	76	0.1315790
NODE_270504_length_258_cov_1.232704	90	166	14	14	76	0.1842105
NODE_270504_length_258_cov_1.232704	90	166	16	1	76	0.0131579
NODE_270547_length_258_cov_1.201258	49	98	2	49	49	1.0000000
NODE_270876_length_258_cov_0.962264	186	258	0	72	72	1.0000000
NODE_270970_length_258_cov_0.962264	69	124	0	19	55	0.3454545
NODE_270970_length_258_cov_0.962264	69	124	2	36	55	0.6545454
NODE_272169_length_257_cov_71.158228	81	165	138	1	84	0.0119048
NODE_272169_length_257_cov_71.158228	81	165	140	2	84	0.0238095
NODE_272169_length_257_cov_71.158228	81	165	148	3	84	0.0357143
NODE_272169_length_257_cov_71.158228	81	165	150	3	84	0.0357143
NODE_272169_length_257_cov_71.158228	81	165	152	2	84	0.0238095
NODE_272169_length_257_cov_71.158228	81	165	154	1	84	0.0119048
NODE_272169_length_257_cov_71.158228	81	165	156	1	84	0.0119048
NODE_272169_length_257_cov_71.158228	81	165	162	1	84	0.0119048
NODE_272169_length_257_cov_71.158228	81	165	164	1	84	0.0119048
NODE_272169_length_257_cov_71.158228	81	165	170	1	84	0.0119048
NODE_272169_length_257_cov_71.158228	81	165	172	1	84	0.0119048
NODE_272169_length_257_cov_71.158228	81	165	173	2	84	0.0238095
NODE_272169_length_257_cov_71.158228	81	165	177	2	84	0.0238095
NODE_272169_length_257_cov_71.158228	81	165	181	2	84	0.0238095
NODE_272169_length_257_cov_71.158228	81	165	183	1	84	0.0119048
NODE_272169_length_257_cov_71.158228	81	165	186	1	84	0.0119048
NODE_272169_length_257_cov_71.158228	81	165	187	1	84	0.0119048
NODE_272169_length_257_cov_71.158228	81	165	188	1	84	0.0119048
NODE_272169_length_257_cov_71.158228	81	165	190	1	84	0.0119048
NODE_272169_length_257_cov_71.158228	81	165	191	1	84	0.0119048
NODE_272169_length_257_cov_71.158228	81	165	193	1	84	0.0119048
NODE_272169_length_257_cov_71.158228	81	165	194	1	84	0.0119048
NODE_272169_length_257_cov_71.158228	81	165	196	1	84	0.0119048
NODE_272169_length_257_cov_71.158228	81	165	197	2	84	0.0238095
NODE_272169_length_257_cov_71.158228	81	165	199	1	84	0.0119048
NODE_272169_length_257_cov_71.158228	81	165	201	1	84	0.0119048
NODE_272169_length_257_cov_71.158228	81	165	204	1	84	0.0119048
NODE_272169_length_257_cov_71.158228	81	165	207	1	84	0.0119048
NODE_272169_length_257_cov_71.158228	81	165	210	3	84	0.0357143
NODE_272169_length_257_cov_71.158228	81	165	211	5	84	0.0595238
NODE_272169_length_257_cov_71.158228	81	165	215	3	84	0.0357143
NODE_272169_length_257_cov_71.158228	81	165	217	2	84	0.0238095
NODE_272169_length_257_cov_71.158228	81	165	218	1	84	0.0119048
NODE_272169_length_257_cov_71.158228	81	165	219	3	84	0.0357143
NODE_272169_length_257_cov_71.158228	81	165	221	7	84	0.0833333
NODE_272169_length_257_cov_71.158228	81	165	222	6	84	0.0714286
NODE_272169_length_257_cov_71.158228	81	165	223	2	84	0.0238095
NODE_272169_length_257_cov_71.158228	81	165	224	2	84	0.0238095
NODE_272169_length_257_cov_71.158228	81	165	226	5	84	0.0595238
NODE_272169_length_257_cov_71.158228	81	165	228	3	84	0.0357143
NODE_272169_length_257_cov_71.158228	81	165	230	3	84	0.0357143
NODE_272169_length_257_cov_71.158228	81	165	232	1	84	0.0119048
NODE_272169_length_257_cov_71.158228	145	218	49	1	73	0.0136986
NODE_272169_length_257_cov_71.158228	145	218	51	4	73	0.0547945
NODE_272169_length_257_cov_71.158228	145	218	52	3	73	0.0410959
NODE_272169_length_257_cov_71.158228	145	218	57	1	73	0.0136986
NODE_272169_length_257_cov_71.158228	145	218	58	2	73	0.0273973
NODE_272169_length_257_cov_71.158228	145	218	60	1	73	0.0136986
NODE_272169_length_257_cov_71.158228	145	218	62	1	73	0.0136986
NODE_272169_length_257_cov_71.158228	145	218	64	1	73	0.0136986
NODE_272169_length_257_cov_71.158228	145	218	66	1	73	0.0136986
NODE_272169_length_257_cov_71.158228	145	218	70	1	73	0.0136986
NODE_272169_length_257_cov_71.158228	145	218	76	3	73	0.0410959
NODE_272169_length_257_cov_71.158228	145	218	78	2	73	0.0273973
NODE_272169_length_257_cov_71.158228	145	218	82	3	73	0.0410959
NODE_272169_length_257_cov_71.158228	145	218	83	1	73	0.0136986
NODE_272169_length_257_cov_71.158228	145	218	84	3	73	0.0410959
NODE_272169_length_257_cov_71.158228	145	218	86	1	73	0.0136986
NODE_272169_length_257_cov_71.158228	145	218	88	2	73	0.0273973
NODE_272169_length_257_cov_71.158228	145	218	90	3	73	0.0410959
NODE_272169_length_257_cov_71.158228	145	218	94	2	73	0.0273973
NODE_272169_length_257_cov_71.158228	145	218	96	3	73	0.0410959
NODE_272169_length_257_cov_71.158228	145	218	98	1	73	0.0136986
NODE_272169_length_257_cov_71.158228	145	218	100	1	73	0.0136986
NODE_272169_length_257_cov_71.158228	145	218	102	1	73	0.0136986
NODE_272169_length_257_cov_71.158228	145	218	104	2	73	0.0273973
NODE_272169_length_257_cov_71.158228	145	218	106	1	73	0.0136986
NODE_272169_length_257_cov_71.158228	145	218	110	2	73	0.0273973
NODE_272169_length_257_cov_71.158228	145	218	112	1	73	0.0136986
NODE_272169_length_257_cov_71.158228	145	218	116	1	73	0.0136986
NODE_272169_length_257_cov_71.158228	145	218	120	1	73	0.0136986
NODE_272169_length_257_cov_71.158228	145	218	134	3	73	0.0410959
NODE_272169_length_257_cov_71.158228	145	218	138	1	73	0.0136986
NODE_272169_length_257_cov_71.158228	145	218	140	2	73	0.0273973
NODE_272169_length_257_cov_71.158228	145	218	148	3	73	0.0410959
NODE_272169_length_257_cov_71.158228	145	218	150	3	73	0.0410959
NODE_272169_length_257_cov_71.158228	145	218	152	2	73	0.0273973
NODE_272169_length_257_cov_71.158228	145	218	154	1	73	0.0136986
NODE_272169_length_257_cov_71.158228	145	218	156	1	73	0.0136986
NODE_272169_length_257_cov_71.158228	145	218	162	1	73	0.0136986
NODE_272169_length_257_cov_71.158228	145	218	164	1	73	0.0136986
NODE_272169_length_257_cov_71.158228	145	218	170	1	73	0.0136986
NODE_272169_length_257_cov_71.158228	145	218	172	1	73	0.0136986
NODE_272169_length_257_cov_71.158228	145	218	173	2	73	0.0273973
NODE_272169_length_257_cov_71.158228	145	218	177	1	73	0.0136986
NODE_272194_length_257_cov_6.329114	15	93	2	78	78	1.0000000
NODE_272275_length_257_cov_4.177215	25	86	0	58	61	0.9508197
NODE_272275_length_257_cov_4.177215	25	86	2	3	61	0.0491803
NODE_272291_length_257_cov_3.987342	55	107	0	52	52	1.0000000
NODE_272304_length_257_cov_3.873418	145	225	0	80	80	1.0000000
NODE_272304_length_257_cov_3.873418	198	254	0	56	56	1.0000000
NODE_272322_length_257_cov_3.740506	133	199	7	3	66	0.0454545
NODE_272322_length_257_cov_3.740506	133	199	8	5	66	0.0757576
NODE_272322_length_257_cov_3.740506	133	199	10	3	66	0.0454545
NODE_272322_length_257_cov_3.740506	133	199	11	2	66	0.0303030
NODE_272322_length_257_cov_3.740506	133	199	12	4	66	0.0606061
NODE_272322_length_257_cov_3.740506	133	199	14	1	66	0.0151515
NODE_272322_length_257_cov_3.740506	133	199	16	1	66	0.0151515
NODE_272322_length_257_cov_3.740506	133	199	18	1	66	0.0151515
NODE_272322_length_257_cov_3.740506	133	199	23	5	66	0.0757576
NODE_272322_length_257_cov_3.740506	133	199	25	1	66	0.0151515
NODE_272322_length_257_cov_3.740506	133	199	27	2	66	0.0303030
NODE_272322_length_257_cov_3.740506	133	199	29	1	66	0.0151515
NODE_272322_length_257_cov_3.740506	133	199	31	4	66	0.0606061
NODE_272322_length_257_cov_3.740506	133	199	33	1	66	0.0151515
NODE_272322_length_257_cov_3.740506	133	199	35	5	66	0.0757576
NODE_272322_length_257_cov_3.740506	133	199	36	2	66	0.0303030
NODE_272322_length_257_cov_3.740506	133	199	38	4	66	0.0606061
NODE_272322_length_257_cov_3.740506	133	199	40	2	66	0.0303030
NODE_272322_length_257_cov_3.740506	133	199	42	2	66	0.0303030
NODE_272322_length_257_cov_3.740506	133	199	44	5	66	0.0757576
NODE_272322_length_257_cov_3.740506	133	199	46	5	66	0.0757576
NODE_272322_length_257_cov_3.740506	133	199	48	2	66	0.0303030
NODE_272322_length_257_cov_3.740506	133	199	50	2	66	0.0303030
NODE_272322_length_257_cov_3.740506	133	199	52	1	66	0.0151515
NODE_272322_length_257_cov_3.740506	133	199	54	1	66	0.0151515
NODE_272322_length_257_cov_3.740506	133	199	56	1	66	0.0151515
NODE_272322_length_257_cov_3.740506	177	256	0	44	79	0.5569620
NODE_272322_length_257_cov_3.740506	177	256	1	5	79	0.0632911
NODE_272322_length_257_cov_3.740506	177	256	2	1	79	0.0126582
NODE_272322_length_257_cov_3.740506	177	256	3	4	79	0.0506329
NODE_272322_length_257_cov_3.740506	177	256	5	3	79	0.0379747
NODE_272322_length_257_cov_3.740506	177	256	7	3	79	0.0379747
NODE_272322_length_257_cov_3.740506	177	256	8	5	79	0.0632911
NODE_272322_length_257_cov_3.740506	177	256	10	3	79	0.0379747
NODE_272322_length_257_cov_3.740506	177	256	11	2	79	0.0253165
NODE_272322_length_257_cov_3.740506	177	256	12	4	79	0.0506329
NODE_272322_length_257_cov_3.740506	177	256	14	1	79	0.0126582
NODE_272322_length_257_cov_3.740506	177	256	16	1	79	0.0126582
NODE_272322_length_257_cov_3.740506	177	256	18	1	79	0.0126582
NODE_272322_length_257_cov_3.740506	177	256	23	2	79	0.0253165
NODE_272486_length_257_cov_2.734177	1	65	0	64	64	1.0000000
NODE_272491_length_257_cov_2.677215	170	250	0	5	80	0.0625000
NODE_272491_length_257_cov_2.677215	170	250	1	1	80	0.0125000
NODE_272491_length_257_cov_2.677215	170	250	2	26	80	0.3250000
NODE_272491_length_257_cov_2.677215	170	250	5	1	80	0.0125000
NODE_272491_length_257_cov_2.677215	170	250	8	5	80	0.0625000
NODE_272491_length_257_cov_2.677215	170	250	10	6	80	0.0750000
NODE_272491_length_257_cov_2.677215	170	250	12	2	80	0.0250000
NODE_272491_length_257_cov_2.677215	170	250	14	1	80	0.0125000
NODE_272491_length_257_cov_2.677215	170	250	16	2	80	0.0250000
NODE_272491_length_257_cov_2.677215	170	250	18	9	80	0.1125000
NODE_272491_length_257_cov_2.677215	170	250	24	3	80	0.0375000
NODE_272491_length_257_cov_2.677215	170	250	26	5	80	0.0625000
NODE_272491_length_257_cov_2.677215	170	250	27	1	80	0.0125000
NODE_272491_length_257_cov_2.677215	170	250	30	1	80	0.0125000
NODE_272491_length_257_cov_2.677215	170	250	34	4	80	0.0500000
NODE_272491_length_257_cov_2.677215	170	250	40	4	80	0.0500000
NODE_272491_length_257_cov_2.677215	170	250	44	4	80	0.0500000
NODE_272580_length_257_cov_2.537975	60	137	2	10	77	0.1298701
NODE_272580_length_257_cov_2.537975	60	137	4	67	77	0.8701299
NODE_272596_length_257_cov_2.487342	95	172	0	47	77	0.6103896
NODE_272596_length_257_cov_2.487342	95	172	1	30	77	0.3896104
NODE_272625_length_257_cov_2.379747	106	186	6	6	80	0.0750000
NODE_272625_length_257_cov_2.379747	106	186	8	2	80	0.0250000
NODE_272625_length_257_cov_2.379747	106	186	10	6	80	0.0750000
NODE_272625_length_257_cov_2.379747	106	186	12	39	80	0.4875000
NODE_272625_length_257_cov_2.379747	106	186	14	27	80	0.3375000
NODE_272625_length_257_cov_2.379747	159	207	6	10	48	0.2083333
NODE_272625_length_257_cov_2.379747	159	207	8	9	48	0.1875000
NODE_272625_length_257_cov_2.379747	159	207	10	4	48	0.0833333
NODE_272625_length_257_cov_2.379747	159	207	12	25	48	0.5208333
NODE_272724_length_257_cov_2.221519	163	240	4	10	77	0.1298701
NODE_272724_length_257_cov_2.221519	163	240	6	9	77	0.1168831
NODE_272724_length_257_cov_2.221519	163	240	8	58	77	0.7532467
NODE_272729_length_257_cov_2.202532	16	97	0	29	81	0.3580247
NODE_272729_length_257_cov_2.202532	16	97	2	52	81	0.6419753
NODE_273151_length_257_cov_1.664557	220	239	0	19	19	1.0000000
NODE_273357_length_257_cov_1.500000	85	166	6	42	81	0.5185185
NODE_273357_length_257_cov_1.500000	85	166	8	39	81	0.4814815
NODE_273462_length_257_cov_1.329114	120	186	0	17	66	0.2575758
NODE_273462_length_257_cov_1.329114	120	186	2	49	66	0.7424242
NODE_273533_length_257_cov_1.291139	13	53	0	40	40	1.0000000
NODE_273697_length_257_cov_1.291139	205	257	0	52	52	1.0000000
NODE_273894_length_257_cov_1.221519	10	74	0	64	64	1.0000000
NODE_273917_length_257_cov_1.196203	70	150	2	70	80	0.8750000
NODE_273917_length_257_cov_1.196203	70	150	4	10	80	0.1250000
NODE_273917_length_257_cov_1.196203	123	204	2	69	81	0.8518519
NODE_273917_length_257_cov_1.196203	123	204	4	12	81	0.1481481
NODE_275399_length_257_cov_0.645570	138	158	0	20	20	1.0000000
NODE_275419_length_257_cov_0.645570	181	241	2	32	60	0.5333334
NODE_275419_length_257_cov_0.645570	181	241	4	27	60	0.4500000
NODE_275419_length_257_cov_0.645570	181	241	6	1	60	0.0166667
NODE_275598_length_256_cov_5.235669	30	77	0	47	47	1.0000000
NODE_275624_length_256_cov_4.598726	100	180	0	80	80	1.0000000
NODE_275624_length_256_cov_4.598726	160	211	0	51	51	1.0000000
NODE_275682_length_256_cov_3.866242	112	166	0	4	54	0.0740741
NODE_275682_length_256_cov_3.866242	112	166	2	7	54	0.1296296
NODE_275682_length_256_cov_3.866242	112	166	6	20	54	0.3703704
NODE_275682_length_256_cov_3.866242	112	166	8	2	54	0.0370370
NODE_275682_length_256_cov_3.866242	112	166	10	21	54	0.3888889
NODE_275840_length_256_cov_2.878981	79	159	0	80	80	1.0000000
NODE_275840_length_256_cov_2.878981	132	212	0	80	80	1.0000000
NODE_275909_length_256_cov_2.598726	157	222	0	65	65	1.0000000
NODE_275909_length_256_cov_2.598726	195	249	0	54	54	1.0000000
NODE_275981_length_256_cov_2.445860	104	183	0	79	79	1.0000000
NODE_276082_length_256_cov_2.229299	0	58	0	58	58	1.0000000
NODE_276082_length_256_cov_2.229299	17	68	0	51	51	1.0000000
NODE_276082_length_256_cov_2.229299	41	88	0	47	47	1.0000000
NODE_276082_length_256_cov_2.229299	42	122	0	80	80	1.0000000
NODE_276098_length_256_cov_2.184713	192	246	0	54	54	1.0000000
NODE_276119_length_256_cov_2.121019	150	236	0	51	86	0.5930232
NODE_276119_length_256_cov_2.121019	150	236	2	35	86	0.4069767
NODE_276174_length_256_cov_1.974522	130	174	0	44	44	1.0000000
NODE_276471_length_256_cov_1.707006	39	92	3	1	53	0.0188679
NODE_276471_length_256_cov_1.707006	39	92	5	4	53	0.0754717
NODE_276471_length_256_cov_1.707006	39	92	7	7	53	0.1320755
NODE_276471_length_256_cov_1.707006	39	92	11	3	53	0.0566038
NODE_276471_length_256_cov_1.707006	39	92	15	15	53	0.2830189
NODE_276471_length_256_cov_1.707006	39	92	17	7	53	0.1320755
NODE_276471_length_256_cov_1.707006	39	92	20	3	53	0.0566038
NODE_276471_length_256_cov_1.707006	39	92	21	6	53	0.1132075
NODE_276471_length_256_cov_1.707006	39	92	23	2	53	0.0377358
NODE_276471_length_256_cov_1.707006	39	92	25	5	53	0.0943396
NODE_276471_length_256_cov_1.707006	93	135	25	5	42	0.1190476
NODE_276471_length_256_cov_1.707006	93	135	27	1	42	0.0238095
NODE_276471_length_256_cov_1.707006	93	135	28	1	42	0.0238095
NODE_276471_length_256_cov_1.707006	93	135	29	8	42	0.1904762
NODE_276471_length_256_cov_1.707006	93	135	30	4	42	0.0952381
NODE_276471_length_256_cov_1.707006	93	135	32	5	42	0.1190476
NODE_276471_length_256_cov_1.707006	93	135	34	3	42	0.0714286
NODE_276471_length_256_cov_1.707006	93	135	36	5	42	0.1190476
NODE_276471_length_256_cov_1.707006	93	135	38	4	42	0.0952381
NODE_276471_length_256_cov_1.707006	93	135	40	6	42	0.1428571
NODE_276484_length_256_cov_1.700637	107	129	0	22	22	1.0000000
NODE_276495_length_256_cov_1.675159	52	98	2	31	46	0.6739131
NODE_276495_length_256_cov_1.675159	52	98	4	15	46	0.3260870
NODE_276654_length_256_cov_1.598726	125	202	2	41	77	0.5324675
NODE_276654_length_256_cov_1.598726	125	202	4	36	77	0.4675325
NODE_276654_length_256_cov_1.598726	178	256	0	14	78	0.1794872
NODE_276654_length_256_cov_1.598726	178	256	2	10	78	0.1282051
NODE_276654_length_256_cov_1.598726	178	256	4	54	78	0.6923077
NODE_276672_length_256_cov_1.579618	110	172	2	32	62	0.5161290
NODE_276672_length_256_cov_1.579618	110	172	6	30	62	0.4838710
NODE_276672_length_256_cov_1.579618	194	239	0	45	45	1.0000000
NODE_276742_length_256_cov_1.464968	112	135	2	23	23	1.0000000
NODE_276826_length_256_cov_1.331210	138	209	2	3	71	0.0422535
NODE_276826_length_256_cov_1.331210	138	209	4	19	71	0.2676056
NODE_276826_length_256_cov_1.331210	138	209	8	49	71	0.6901408
NODE_276826_length_256_cov_1.331210	182	240	2	34	58	0.5862069
NODE_276826_length_256_cov_1.331210	182	240	4	19	58	0.3275862
NODE_276826_length_256_cov_1.331210	182	240	8	5	58	0.0862069
NODE_277113_length_256_cov_1.299363	88	160	0	23	72	0.3194444
NODE_277113_length_256_cov_1.299363	88	160	2	2	72	0.0277778
NODE_277113_length_256_cov_1.299363	88	160	6	4	72	0.0555556
NODE_277113_length_256_cov_1.299363	88	160	10	43	72	0.5972222
NODE_277305_length_256_cov_1.203822	3	43	0	8	40	0.2000000
NODE_277305_length_256_cov_1.203822	3	43	2	5	40	0.1250000
NODE_277305_length_256_cov_1.203822	3	43	4	8	40	0.2000000
NODE_277305_length_256_cov_1.203822	3	43	10	1	40	0.0250000
NODE_277305_length_256_cov_1.203822	3	43	12	1	40	0.0250000
NODE_277305_length_256_cov_1.203822	3	43	14	14	40	0.3500000
NODE_277305_length_256_cov_1.203822	3	43	16	3	40	0.0750000
NODE_277305_length_256_cov_1.203822	16	96	4	8	80	0.1000000
NODE_277305_length_256_cov_1.203822	16	96	10	1	80	0.0125000
NODE_277305_length_256_cov_1.203822	16	96	12	5	80	0.0625000
NODE_277305_length_256_cov_1.203822	16	96	14	24	80	0.3000000
NODE_277305_length_256_cov_1.203822	16	96	16	42	80	0.5250000
NODE_278934_length_255_cov_73.756410	52	99	6	47	47	1.0000000
NODE_278934_length_255_cov_73.756410	133	184	0	22	51	0.4313726
NODE_278934_length_255_cov_73.756410	133	184	5	3	51	0.0588235
NODE_278934_length_255_cov_73.756410	133	184	6	26	51	0.5098040
NODE_278934_length_255_cov_73.756410	157	237	0	75	80	0.9375000
NODE_278934_length_255_cov_73.756410	157	237	5	3	80	0.0375000
NODE_278934_length_255_cov_73.756410	157	237	6	2	80	0.0250000
NODE_278937_length_255_cov_15.538462	219	255	0	36	36	1.0000000
NODE_279003_length_255_cov_4.884615	157	230	0	71	73	0.9726027
NODE_279003_length_255_cov_4.884615	157	230	2	2	73	0.0273973
NODE_279003_length_255_cov_4.884615	203	248	0	45	45	1.0000000
NODE_279058_length_255_cov_4.012821	68	148	0	22	80	0.2750000
NODE_279058_length_255_cov_4.012821	68	148	2	58	80	0.7250000
NODE_279075_length_255_cov_3.826923	16	80	6	13	64	0.2031250
NODE_279075_length_255_cov_3.826923	16	80	8	1	64	0.0156250
NODE_279075_length_255_cov_3.826923	16	80	10	7	64	0.1093750
NODE_279075_length_255_cov_3.826923	16	80	12	11	64	0.1718750
NODE_279075_length_255_cov_3.826923	16	80	14	21	64	0.3281250
NODE_279075_length_255_cov_3.826923	16	80	16	11	64	0.1718750
NODE_279102_length_255_cov_3.596154	30	60	0	30	30	1.0000000
NODE_279134_length_255_cov_3.423077	64	109	6	8	45	0.1777778
NODE_279134_length_255_cov_3.423077	64	109	8	37	45	0.8222222
NODE_279166_length_255_cov_3.262821	0	48	0	41	48	0.8541667
NODE_279166_length_255_cov_3.262821	0	48	2	7	48	0.1458333
NODE_279166_length_255_cov_3.262821	66	113	1	2	47	0.0425532
NODE_279166_length_255_cov_3.262821	66	113	2	42	47	0.8936170
NODE_279166_length_255_cov_3.262821	66	113	3	3	47	0.0638298
NODE_279241_length_255_cov_2.942308	157	176	0	19	19	1.0000000
NODE_279320_length_255_cov_2.621795	227	254	0	27	27	1.0000000
NODE_279379_length_255_cov_2.602564	131	185	2	2	54	0.0370370
NODE_279379_length_255_cov_2.602564	131	185	4	20	54	0.3703704
NODE_279379_length_255_cov_2.602564	131	185	6	19	54	0.3518519
NODE_279379_length_255_cov_2.602564	131	185	8	13	54	0.2407407
NODE_279427_length_255_cov_2.487179	43	119	4	5	76	0.0657895
NODE_279427_length_255_cov_2.487179	43	119	9	1	76	0.0131579
NODE_279427_length_255_cov_2.487179	43	119	10	7	76	0.0921053
NODE_279427_length_255_cov_2.487179	43	119	11	3	76	0.0394737
NODE_279427_length_255_cov_2.487179	43	119	12	60	76	0.7894737
NODE_279447_length_255_cov_2.435897	0	58	0	12	58	0.2068966
NODE_279447_length_255_cov_2.435897	0	58	4	9	58	0.1551724
NODE_279447_length_255_cov_2.435897	0	58	6	37	58	0.6379310
NODE_279462_length_255_cov_2.391026	189	255	0	66	66	1.0000000
NODE_279507_length_255_cov_2.288462	0	60	0	60	60	1.0000000
NODE_279510_length_255_cov_2.288462	0	74	0	22	74	0.2972973
NODE_279510_length_255_cov_2.288462	0	74	2	52	74	0.7027027
NODE_279620_length_255_cov_2.089744	105	145	2	40	40	1.0000000
NODE_279649_length_255_cov_1.987179	0	72	0	72	72	1.0000000
NODE_279842_length_255_cov_1.910256	198	255	0	57	57	1.0000000
NODE_279871_length_255_cov_1.871795	16	68	0	52	52	1.0000000
NODE_279892_length_255_cov_1.826923	146	218	0	72	72	1.0000000
NODE_279956_length_255_cov_1.705128	0	45	0	4	45	0.0888889
NODE_279956_length_255_cov_1.705128	0	45	2	41	45	0.9111111
NODE_279956_length_255_cov_1.705128	41	121	2	10	80	0.1250000
NODE_279956_length_255_cov_1.705128	41	121	7	1	80	0.0125000
NODE_279956_length_255_cov_1.705128	41	121	8	14	80	0.1750000
NODE_279956_length_255_cov_1.705128	41	121	10	55	80	0.6875000
NODE_279956_length_255_cov_1.705128	94	174	0	9	80	0.1125000
NODE_279956_length_255_cov_1.705128	94	174	6	10	80	0.1250000
NODE_279956_length_255_cov_1.705128	94	174	8	3	80	0.0375000
NODE_279956_length_255_cov_1.705128	94	174	10	58	80	0.7250000
NODE_280153_length_255_cov_1.576923	43	117	0	4	74	0.0540541
NODE_280153_length_255_cov_1.576923	43	117	2	5	74	0.0675676
NODE_280153_length_255_cov_1.576923	43	117	4	1	74	0.0135135
NODE_280153_length_255_cov_1.576923	43	117	6	1	74	0.0135135
NODE_280153_length_255_cov_1.576923	43	117	8	7	74	0.0945946
NODE_280153_length_255_cov_1.576923	43	117	10	2	74	0.0270270
NODE_280153_length_255_cov_1.576923	43	117	12	3	74	0.0405405
NODE_280153_length_255_cov_1.576923	43	117	14	7	74	0.0945946
NODE_280153_length_255_cov_1.576923	43	117	16	20	74	0.2702703
NODE_280153_length_255_cov_1.576923	43	117	20	3	74	0.0405405
NODE_280153_length_255_cov_1.576923	43	117	26	21	74	0.2837838
NODE_280153_length_255_cov_1.576923	90	175	2	2	85	0.0235294
NODE_280153_length_255_cov_1.576923	90	175	16	1	85	0.0117647
NODE_280153_length_255_cov_1.576923	90	175	20	3	85	0.0352941
NODE_280153_length_255_cov_1.576923	90	175	26	39	85	0.4588235
NODE_280153_length_255_cov_1.576923	90	175	28	7	85	0.0823529
NODE_280153_length_255_cov_1.576923	90	175	30	33	85	0.3882353
NODE_280168_length_255_cov_1.557692	62	125	0	57	63	0.9047619
NODE_280168_length_255_cov_1.557692	62	125	4	6	63	0.0952381
NODE_280297_length_255_cov_1.358974	178	246	0	66	68	0.9705882
NODE_280297_length_255_cov_1.358974	178	246	2	2	68	0.0294118
NODE_280904_length_255_cov_1.128205	183	219	0	36	36	1.0000000
NODE_281094_length_255_cov_0.987179	220	241	0	21	21	1.0000000
NODE_281380_length_255_cov_0.955128	119	171	8	8	52	0.1538462
NODE_281380_length_255_cov_0.955128	119	171	10	44	52	0.8461539
NODE_281384_length_255_cov_0.955128	12	92	4	80	80	1.0000000
NODE_282137_length_255_cov_0.653846	87	106	2	19	19	1.0000000
NODE_282534_length_254_cov_4.935484	144	189	2	13	45	0.2888889
NODE_282534_length_254_cov_4.935484	144	189	4	32	45	0.7111111
NODE_282534_length_254_cov_4.935484	164	242	0	28	78	0.3589744
NODE_282534_length_254_cov_4.935484	164	242	2	38	78	0.4871795
NODE_282534_length_254_cov_4.935484	164	242	4	12	78	0.1538462
NODE_282548_length_254_cov_4.722581	44	85	8	13	41	0.3170732
NODE_282548_length_254_cov_4.722581	44	85	9	6	41	0.1463415
NODE_282548_length_254_cov_4.722581	44	85	10	22	41	0.5365854
NODE_282576_length_254_cov_4.296774	149	174	0	25	25	1.0000000
NODE_282576_length_254_cov_4.296774	149	223	0	74	74	1.0000000
NODE_282590_length_254_cov_4.206452	57	86	23	8	29	0.2758621
NODE_282590_length_254_cov_4.206452	57	86	25	2	29	0.0689655
NODE_282590_length_254_cov_4.206452	57	86	27	1	29	0.0344828
NODE_282590_length_254_cov_4.206452	57	86	28	9	29	0.3103448
NODE_282590_length_254_cov_4.206452	57	86	30	3	29	0.1034483
NODE_282590_length_254_cov_4.206452	57	86	32	6	29	0.2068966
NODE_282626_length_254_cov_3.677419	7	64	14	2	57	0.0350877
NODE_282626_length_254_cov_3.677419	7	64	18	5	57	0.0877193
NODE_282626_length_254_cov_3.677419	7	64	20	3	57	0.0526316
NODE_282626_length_254_cov_3.677419	7	64	22	5	57	0.0877193
NODE_282626_length_254_cov_3.677419	7	64	26	42	57	0.7368421
NODE_282626_length_254_cov_3.677419	60	117	6	9	57	0.1578947
NODE_282626_length_254_cov_3.677419	60	117	8	3	57	0.0526316
NODE_282626_length_254_cov_3.677419	60	117	12	3	57	0.0526316
NODE_282626_length_254_cov_3.677419	60	117	14	1	57	0.0175439
NODE_282626_length_254_cov_3.677419	60	117	16	4	57	0.0701754
NODE_282626_length_254_cov_3.677419	60	117	21	1	57	0.0175439
NODE_282626_length_254_cov_3.677419	60	117	22	9	57	0.1578947
NODE_282626_length_254_cov_3.677419	60	117	24	4	57	0.0701754
NODE_282626_length_254_cov_3.677419	60	117	26	23	57	0.4035088
NODE_282642_length_254_cov_3.593548	154	197	0	43	43	1.0000000
NODE_282659_length_254_cov_3.438710	82	129	0	47	47	1.0000000
NODE_282659_length_254_cov_3.438710	102	182	0	32	80	0.4000000
NODE_282659_length_254_cov_3.438710	102	182	2	11	80	0.1375000
NODE_282659_length_254_cov_3.438710	102	182	5	6	80	0.0750000
NODE_282659_length_254_cov_3.438710	102	182	6	31	80	0.3875000
NODE_282736_length_254_cov_2.961290	5	79	0	74	74	1.0000000
NODE_282736_length_254_cov_2.961290	52	118	0	33	66	0.5000000
NODE_282736_length_254_cov_2.961290	52	118	2	3	66	0.0454545
NODE_282736_length_254_cov_2.961290	52	118	4	30	66	0.4545455
NODE_282771_length_254_cov_2.780645	169	252	0	4	83	0.0481928
NODE_282771_length_254_cov_2.780645	169	252	2	5	83	0.0602410
NODE_282771_length_254_cov_2.780645	169	252	4	1	83	0.0120482
NODE_282771_length_254_cov_2.780645	169	252	6	4	83	0.0481928
NODE_282771_length_254_cov_2.780645	169	252	7	9	83	0.1084337
NODE_282771_length_254_cov_2.780645	169	252	12	2	83	0.0240964
NODE_282771_length_254_cov_2.780645	169	252	14	9	83	0.1084337
NODE_282771_length_254_cov_2.780645	169	252	18	10	83	0.1204819
NODE_282771_length_254_cov_2.780645	169	252	20	2	83	0.0240964
NODE_282771_length_254_cov_2.780645	169	252	24	5	83	0.0602410
NODE_282771_length_254_cov_2.780645	169	252	26	2	83	0.0240964
NODE_282771_length_254_cov_2.780645	169	252	28	3	83	0.0361446
NODE_282771_length_254_cov_2.780645	169	252	32	1	83	0.0120482
NODE_282771_length_254_cov_2.780645	169	252	34	9	83	0.1084337
NODE_282771_length_254_cov_2.780645	169	252	36	1	83	0.0120482
NODE_282771_length_254_cov_2.780645	169	252	38	3	83	0.0361446
NODE_282771_length_254_cov_2.780645	169	252	40	3	83	0.0361446
NODE_282771_length_254_cov_2.780645	169	252	42	2	83	0.0240964
NODE_282771_length_254_cov_2.780645	169	252	48	1	83	0.0120482
NODE_282771_length_254_cov_2.780645	169	252	52	2	83	0.0240964
NODE_282771_length_254_cov_2.780645	169	252	56	3	83	0.0361446
NODE_282771_length_254_cov_2.780645	169	252	58	2	83	0.0240964
NODE_282947_length_254_cov_2.341935	167	201	4	34	34	1.0000000
NODE_283082_length_254_cov_2.161290	14	74	0	60	60	1.0000000
NODE_283244_length_254_cov_1.974194	156	204	0	48	48	1.0000000
NODE_283440_length_254_cov_1.780645	79	126	8	14	47	0.2978723
NODE_283440_length_254_cov_1.780645	79	126	10	1	47	0.0212766
NODE_283440_length_254_cov_1.780645	79	126	12	3	47	0.0638298
NODE_283440_length_254_cov_1.780645	79	126	16	28	47	0.5957447
NODE_283440_length_254_cov_1.780645	79	126	18	1	47	0.0212766
NODE_283952_length_254_cov_1.316129	23	87	0	5	64	0.0781250
NODE_283952_length_254_cov_1.316129	23	87	2	59	64	0.9218750
NODE_284013_length_254_cov_1.316129	193	215	0	22	22	1.0000000
NODE_284256_length_254_cov_1.258065	181	249	0	68	68	1.0000000
NODE_284275_length_254_cov_1.238710	9	82	0	27	73	0.3698630
NODE_284275_length_254_cov_1.238710	9	82	2	40	73	0.5479452
NODE_284275_length_254_cov_1.238710	9	82	4	6	73	0.0821918
NODE_284275_length_254_cov_1.238710	62	82	2	14	20	0.7000000
NODE_284275_length_254_cov_1.238710	62	82	4	6	20	0.3000000
NODE_284277_length_254_cov_1.238710	54	73	0	19	19	1.0000000
NODE_284301_length_254_cov_1.219355	98	157	0	59	59	1.0000000
NODE_284638_length_254_cov_0.987097	139	193	0	54	54	1.0000000
NODE_284638_length_254_cov_0.987097	205	254	0	49	49	1.0000000
NODE_284796_length_254_cov_0.987097	121	152	4	21	31	0.6774194
NODE_284796_length_254_cov_0.987097	121	152	6	10	31	0.3225806
NODE_285963_length_253_cov_60.311688	137	202	8	1	65	0.0153846
NODE_285963_length_253_cov_60.311688	137	202	16	1	65	0.0153846
NODE_285963_length_253_cov_60.311688	137	202	20	4	65	0.0615385
NODE_285963_length_253_cov_60.311688	137	202	22	2	65	0.0307692
NODE_285963_length_253_cov_60.311688	137	202	28	3	65	0.0461538
NODE_285963_length_253_cov_60.311688	137	202	36	2	65	0.0307692
NODE_285963_length_253_cov_60.311688	137	202	38	52	65	0.8000000
NODE_285963_length_253_cov_60.311688	175	253	9	1	78	0.0128205
NODE_285963_length_253_cov_60.311688	175	253	12	2	78	0.0256410
NODE_285963_length_253_cov_60.311688	175	253	18	3	78	0.0384615
NODE_285963_length_253_cov_60.311688	175	253	20	2	78	0.0256410
NODE_285963_length_253_cov_60.311688	175	253	26	1	78	0.0128205
NODE_285963_length_253_cov_60.311688	175	253	30	4	78	0.0512821
NODE_285963_length_253_cov_60.311688	175	253	32	1	78	0.0128205
NODE_285963_length_253_cov_60.311688	175	253	34	4	78	0.0512821
NODE_285963_length_253_cov_60.311688	175	253	38	60	78	0.7692308
NODE_285965_length_253_cov_41.519481	0	68	9	11	68	0.1617647
NODE_285965_length_253_cov_41.519481	0	68	10	3	68	0.0441176
NODE_285965_length_253_cov_41.519481	0	68	14	4	68	0.0588235
NODE_285965_length_253_cov_41.519481	0	68	16	5	68	0.0735294
NODE_285965_length_253_cov_41.519481	0	68	18	1	68	0.0147059
NODE_285965_length_253_cov_41.519481	0	68	20	4	68	0.0588235
NODE_285965_length_253_cov_41.519481	0	68	22	18	68	0.2647059
NODE_285965_length_253_cov_41.519481	0	68	24	12	68	0.1764706
NODE_285965_length_253_cov_41.519481	0	68	26	5	68	0.0735294
NODE_285965_length_253_cov_41.519481	0	68	30	5	68	0.0735294
NODE_285965_length_253_cov_41.519481	0	70	9	11	70	0.1571429
NODE_285965_length_253_cov_41.519481	0	70	10	3	70	0.0428571
NODE_285965_length_253_cov_41.519481	0	70	14	4	70	0.0571429
NODE_285965_length_253_cov_41.519481	0	70	16	5	70	0.0714286
NODE_285965_length_253_cov_41.519481	0	70	18	1	70	0.0142857
NODE_285965_length_253_cov_41.519481	0	70	20	4	70	0.0571429
NODE_285965_length_253_cov_41.519481	0	70	22	18	70	0.2571429
NODE_285965_length_253_cov_41.519481	0	70	24	12	70	0.1714286
NODE_285965_length_253_cov_41.519481	0	70	26	5	70	0.0714286
NODE_285965_length_253_cov_41.519481	0	70	30	6	70	0.0857143
NODE_285965_length_253_cov_41.519481	0	70	32	1	70	0.0142857
NODE_285965_length_253_cov_41.519481	2	73	9	9	71	0.1267606
NODE_285965_length_253_cov_41.519481	2	73	10	3	71	0.0422535
NODE_285965_length_253_cov_41.519481	2	73	14	4	71	0.0563380
NODE_285965_length_253_cov_41.519481	2	73	16	5	71	0.0704225
NODE_285965_length_253_cov_41.519481	2	73	18	1	71	0.0140845
NODE_285965_length_253_cov_41.519481	2	73	20	4	71	0.0563380
NODE_285965_length_253_cov_41.519481	2	73	22	18	71	0.2535211
NODE_285965_length_253_cov_41.519481	2	73	24	12	71	0.1690141
NODE_285965_length_253_cov_41.519481	2	73	26	5	71	0.0704225
NODE_285965_length_253_cov_41.519481	2	73	30	6	71	0.0845070
NODE_285965_length_253_cov_41.519481	2	73	32	4	71	0.0563380
NODE_285965_length_253_cov_41.519481	7	73	9	4	66	0.0606061
NODE_285965_length_253_cov_41.519481	7	73	10	3	66	0.0454545
NODE_285965_length_253_cov_41.519481	7	73	14	4	66	0.0606061
NODE_285965_length_253_cov_41.519481	7	73	16	5	66	0.0757576
NODE_285965_length_253_cov_41.519481	7	73	18	1	66	0.0151515
NODE_285965_length_253_cov_41.519481	7	73	20	4	66	0.0606061
NODE_285965_length_253_cov_41.519481	7	73	22	18	66	0.2727273
NODE_285965_length_253_cov_41.519481	7	73	24	12	66	0.1818182
NODE_285965_length_253_cov_41.519481	7	73	26	5	66	0.0757576
NODE_285965_length_253_cov_41.519481	7	73	30	6	66	0.0909091
NODE_285965_length_253_cov_41.519481	7	73	32	4	66	0.0606061
NODE_285965_length_253_cov_41.519481	46	123	22	7	77	0.0909091
NODE_285965_length_253_cov_41.519481	46	123	24	12	77	0.1558442
NODE_285965_length_253_cov_41.519481	46	123	26	5	77	0.0649351
NODE_285965_length_253_cov_41.519481	46	123	30	18	77	0.2337662
NODE_285965_length_253_cov_41.519481	46	123	32	35	77	0.4545455
NODE_285965_length_253_cov_41.519481	46	123	22	7	77	0.0909091
NODE_285965_length_253_cov_41.519481	46	123	24	12	77	0.1558442
NODE_285965_length_253_cov_41.519481	46	123	26	5	77	0.0649351
NODE_285965_length_253_cov_41.519481	46	123	30	18	77	0.2337662
NODE_285965_length_253_cov_41.519481	46	123	32	35	77	0.4545455
NODE_285965_length_253_cov_41.519481	46	123	22	7	77	0.0909091
NODE_285965_length_253_cov_41.519481	46	123	24	12	77	0.1558442
NODE_285965_length_253_cov_41.519481	46	123	26	5	77	0.0649351
NODE_285965_length_253_cov_41.519481	46	123	30	18	77	0.2337662
NODE_285965_length_253_cov_41.519481	46	123	32	35	77	0.4545455
NODE_285967_length_253_cov_13.967532	25	105	0	80	80	1.0000000
NODE_285967_length_253_cov_13.967532	78	158	0	80	80	1.0000000
NODE_285969_length_253_cov_12.259740	0	54	0	54	54	1.0000000
NODE_285969_length_253_cov_12.259740	27	62	0	35	35	1.0000000
NODE_285969_length_253_cov_12.259740	51	131	0	80	80	1.0000000
NODE_285969_length_253_cov_12.259740	104	139	0	35	35	1.0000000
NODE_285969_length_253_cov_12.259740	128	208	0	80	80	1.0000000
NODE_285969_length_253_cov_12.259740	181	216	0	35	35	1.0000000
NODE_285987_length_253_cov_7.279221	184	250	0	8	66	0.1212121
NODE_285987_length_253_cov_7.279221	184	250	4	38	66	0.5757576
NODE_285987_length_253_cov_7.279221	184	250	6	1	66	0.0151515
NODE_285987_length_253_cov_7.279221	184	250	8	6	66	0.0909091
NODE_285987_length_253_cov_7.279221	184	250	10	13	66	0.1969697
NODE_286022_length_253_cov_5.376623	66	147	2	17	81	0.2098765
NODE_286022_length_253_cov_5.376623	66	147	4	13	81	0.1604938
NODE_286022_length_253_cov_5.376623	66	147	5	1	81	0.0123457
NODE_286022_length_253_cov_5.376623	66	147	6	25	81	0.3086420
NODE_286022_length_253_cov_5.376623	66	147	8	25	81	0.3086420
NODE_286022_length_253_cov_5.376623	120	185	5	6	65	0.0923077
NODE_286022_length_253_cov_5.376623	120	185	6	2	65	0.0307692
NODE_286022_length_253_cov_5.376623	120	185	7	2	65	0.0307692
NODE_286022_length_253_cov_5.376623	120	185	8	55	65	0.8461539
NODE_286042_length_253_cov_4.896104	102	182	7	1	80	0.0125000
NODE_286042_length_253_cov_4.896104	102	182	8	2	80	0.0250000
NODE_286042_length_253_cov_4.896104	102	182	9	2	80	0.0250000
NODE_286042_length_253_cov_4.896104	102	182	11	2	80	0.0250000
NODE_286042_length_253_cov_4.896104	102	182	16	3	80	0.0375000
NODE_286042_length_253_cov_4.896104	102	182	18	1	80	0.0125000
NODE_286042_length_253_cov_4.896104	102	182	20	1	80	0.0125000
NODE_286042_length_253_cov_4.896104	102	182	21	3	80	0.0375000
NODE_286042_length_253_cov_4.896104	102	182	23	1	80	0.0125000
NODE_286042_length_253_cov_4.896104	102	182	32	1	80	0.0125000
NODE_286042_length_253_cov_4.896104	102	182	34	1	80	0.0125000
NODE_286042_length_253_cov_4.896104	102	182	37	1	80	0.0125000
NODE_286042_length_253_cov_4.896104	102	182	38	2	80	0.0250000
NODE_286042_length_253_cov_4.896104	102	182	41	5	80	0.0625000
NODE_286042_length_253_cov_4.896104	102	182	45	1	80	0.0125000
NODE_286042_length_253_cov_4.896104	102	182	47	3	80	0.0375000
NODE_286042_length_253_cov_4.896104	102	182	50	2	80	0.0250000
NODE_286042_length_253_cov_4.896104	102	182	51	1	80	0.0125000
NODE_286042_length_253_cov_4.896104	102	182	57	1	80	0.0125000
NODE_286042_length_253_cov_4.896104	102	182	61	3	80	0.0375000
NODE_286042_length_253_cov_4.896104	102	182	65	1	80	0.0125000
NODE_286042_length_253_cov_4.896104	102	182	67	2	80	0.0250000
NODE_286042_length_253_cov_4.896104	102	182	69	3	80	0.0375000
NODE_286042_length_253_cov_4.896104	102	182	73	7	80	0.0875000
NODE_286042_length_253_cov_4.896104	102	182	75	1	80	0.0125000
NODE_286042_length_253_cov_4.896104	102	182	80	8	80	0.1000000
NODE_286042_length_253_cov_4.896104	102	182	81	1	80	0.0125000
NODE_286042_length_253_cov_4.896104	102	182	84	6	80	0.0750000
NODE_286042_length_253_cov_4.896104	102	182	86	1	80	0.0125000
NODE_286042_length_253_cov_4.896104	102	182	88	9	80	0.1125000
NODE_286042_length_253_cov_4.896104	102	182	89	1	80	0.0125000
NODE_286042_length_253_cov_4.896104	102	182	90	2	80	0.0250000
NODE_286042_length_253_cov_4.896104	102	182	93	1	80	0.0125000
NODE_286046_length_253_cov_4.798701	199	253	0	54	54	1.0000000
NODE_286069_length_253_cov_4.487013	85	126	0	41	41	1.0000000
NODE_286151_length_253_cov_3.500000	44	105	10	11	61	0.1803279
NODE_286151_length_253_cov_3.500000	44	105	12	50	61	0.8196721
NODE_286151_length_253_cov_3.500000	90	158	0	20	68	0.2941177
NODE_286151_length_253_cov_3.500000	90	158	4	9	68	0.1323529
NODE_286151_length_253_cov_3.500000	90	158	6	1	68	0.0147059
NODE_286151_length_253_cov_3.500000	90	158	10	34	68	0.5000000
NODE_286151_length_253_cov_3.500000	90	158	12	4	68	0.0588235
NODE_286259_length_253_cov_2.987013	85	165	0	80	80	1.0000000
NODE_286259_length_253_cov_2.987013	138	169	0	31	31	1.0000000
NODE_286275_length_253_cov_2.954545	100	148	0	48	48	1.0000000
NODE_286281_length_253_cov_2.909091	34	99	9	11	65	0.1692308
NODE_286281_length_253_cov_2.909091	34	99	11	6	65	0.0923077
NODE_286281_length_253_cov_2.909091	34	99	12	11	65	0.1692308
NODE_286281_length_253_cov_2.909091	34	99	14	7	65	0.1076923
NODE_286281_length_253_cov_2.909091	34	99	16	22	65	0.3384615
NODE_286281_length_253_cov_2.909091	34	99	20	8	65	0.1230769
NODE_286288_length_253_cov_2.889610	129	200	2	16	71	0.2253521
NODE_286288_length_253_cov_2.889610	129	200	4	2	71	0.0281690
NODE_286288_length_253_cov_2.889610	129	200	6	4	71	0.0563380
NODE_286288_length_253_cov_2.889610	129	200	8	2	71	0.0281690
NODE_286288_length_253_cov_2.889610	129	200	10	4	71	0.0563380
NODE_286288_length_253_cov_2.889610	129	200	12	34	71	0.4788733
NODE_286288_length_253_cov_2.889610	129	200	14	9	71	0.1267606
NODE_286288_length_253_cov_2.889610	173	253	0	1	80	0.0125000
NODE_286288_length_253_cov_2.889610	173	253	2	1	80	0.0125000
NODE_286288_length_253_cov_2.889610	173	253	4	1	80	0.0125000
NODE_286288_length_253_cov_2.889610	173	253	8	1	80	0.0125000
NODE_286288_length_253_cov_2.889610	173	253	10	15	80	0.1875000
NODE_286288_length_253_cov_2.889610	173	253	12	61	80	0.7625000
NODE_286289_length_253_cov_2.889610	21	76	0	55	55	1.0000000
NODE_286289_length_253_cov_2.889610	149	229	0	1	80	0.0125000
NODE_286289_length_253_cov_2.889610	149	229	4	79	80	0.9875000
NODE_286379_length_253_cov_2.610390	113	193	0	80	80	1.0000000
NODE_286386_length_253_cov_2.584416	97	154	2	4	57	0.0701754
NODE_286386_length_253_cov_2.584416	97	154	6	53	57	0.9298246
NODE_286545_length_253_cov_2.240260	185	250	0	65	65	1.0000000
NODE_286667_length_253_cov_1.987013	157	237	2	80	80	1.0000000
NODE_286667_length_253_cov_1.987013	210	253	0	2	43	0.0465116
NODE_286667_length_253_cov_1.987013	210	253	2	41	43	0.9534883
NODE_286685_length_253_cov_1.987013	18	60	0	42	42	1.0000000
NODE_286829_length_253_cov_1.961039	186	232	0	46	46	1.0000000
NODE_286837_length_253_cov_1.948052	68	120	0	52	52	1.0000000
NODE_286838_length_253_cov_1.948052	63	114	0	22	51	0.4313726
NODE_286838_length_253_cov_1.948052	63	114	1	29	51	0.5686275
NODE_286947_length_253_cov_1.746753	164	193	0	29	29	1.0000000
NODE_287031_length_253_cov_1.655844	40	120	0	20	80	0.2500000
NODE_287031_length_253_cov_1.655844	40	120	1	6	80	0.0750000
NODE_287031_length_253_cov_1.655844	40	120	3	10	80	0.1250000
NODE_287031_length_253_cov_1.655844	40	120	5	3	80	0.0375000
NODE_287031_length_253_cov_1.655844	40	120	7	16	80	0.2000000
NODE_287031_length_253_cov_1.655844	40	120	8	25	80	0.3125000
NODE_287031_length_253_cov_1.655844	93	152	2	1	59	0.0169492
NODE_287031_length_253_cov_1.655844	93	152	3	1	59	0.0169492
NODE_287031_length_253_cov_1.655844	93	152	4	1	59	0.0169492
NODE_287031_length_253_cov_1.655844	93	152	6	13	59	0.2203390
NODE_287031_length_253_cov_1.655844	93	152	7	2	59	0.0338983
NODE_287031_length_253_cov_1.655844	93	152	8	41	59	0.6949152
NODE_287133_length_253_cov_1.590909	102	148	4	14	46	0.3043478
NODE_287133_length_253_cov_1.590909	102	148	6	25	46	0.5434783
NODE_287133_length_253_cov_1.590909	102	148	8	7	46	0.1521739
NODE_287156_length_253_cov_1.558442	67	149	2	16	82	0.1951219
NODE_287156_length_253_cov_1.558442	67	149	4	7	82	0.0853659
NODE_287156_length_253_cov_1.558442	67	149	6	15	82	0.1829268
NODE_287156_length_253_cov_1.558442	67	149	8	11	82	0.1341463
NODE_287156_length_253_cov_1.558442	67	149	10	33	82	0.4024390
NODE_287230_length_253_cov_1.441558	49	113	0	64	64	1.0000000
NODE_287230_length_253_cov_1.441558	102	166	0	64	64	1.0000000
NODE_287232_length_253_cov_1.441558	121	185	0	64	64	1.0000000
NODE_287234_length_253_cov_1.435065	50	81	2	9	31	0.2903226
NODE_287234_length_253_cov_1.435065	50	81	4	22	31	0.7096774
NODE_287584_length_253_cov_1.324675	193	239	6	43	46	0.9347826
NODE_287584_length_253_cov_1.324675	193	239	8	3	46	0.0652174
NODE_287599_length_253_cov_1.324675	90	132	22	34	42	0.8095238
NODE_287599_length_253_cov_1.324675	90	132	24	8	42	0.1904762
NODE_287599_length_253_cov_1.324675	133	185	6	2	52	0.0384615
NODE_287599_length_253_cov_1.324675	133	185	10	6	52	0.1153846
NODE_287599_length_253_cov_1.324675	133	185	12	4	52	0.0769231
NODE_287599_length_253_cov_1.324675	133	185	14	2	52	0.0384615
NODE_287599_length_253_cov_1.324675	133	185	16	27	52	0.5192308
NODE_287599_length_253_cov_1.324675	133	185	18	6	52	0.1153846
NODE_287599_length_253_cov_1.324675	133	185	20	1	52	0.0192308
NODE_287599_length_253_cov_1.324675	133	185	22	4	52	0.0769231
NODE_287721_length_253_cov_1.285714	87	125	2	9	38	0.2368421
NODE_287721_length_253_cov_1.285714	87	125	4	29	38	0.7631579
NODE_287794_length_253_cov_1.214286	99	148	2	32	49	0.6530612
NODE_287794_length_253_cov_1.214286	99	148	3	10	49	0.2040816
NODE_287794_length_253_cov_1.214286	99	148	4	7	49	0.1428571
NODE_287845_length_253_cov_1.181818	185	247	0	62	62	1.0000000
NODE_287845_length_253_cov_1.181818	185	247	0	62	62	1.0000000
NODE_287989_length_253_cov_1.064935	83	159	6	1	76	0.0131579
NODE_287989_length_253_cov_1.064935	83	159	8	1	76	0.0131579
NODE_287989_length_253_cov_1.064935	83	159	10	1	76	0.0131579
NODE_287989_length_253_cov_1.064935	83	159	12	2	76	0.0263158
NODE_287989_length_253_cov_1.064935	83	159	15	1	76	0.0131579
NODE_287989_length_253_cov_1.064935	83	159	17	1	76	0.0131579
NODE_287989_length_253_cov_1.064935	83	159	21	4	76	0.0526316
NODE_287989_length_253_cov_1.064935	83	159	25	12	76	0.1578947
NODE_287989_length_253_cov_1.064935	83	159	27	4	76	0.0526316
NODE_287989_length_253_cov_1.064935	83	159	29	1	76	0.0131579
NODE_287989_length_253_cov_1.064935	83	159	31	10	76	0.1315790
NODE_287989_length_253_cov_1.064935	83	159	33	7	76	0.0921053
NODE_287989_length_253_cov_1.064935	83	159	35	13	76	0.1710526
NODE_287989_length_253_cov_1.064935	83	159	37	18	76	0.2368421
NODE_288099_length_253_cov_0.993506	0	44	5	20	44	0.4545455
NODE_288099_length_253_cov_0.993506	0	44	9	24	44	0.5454546
NODE_288465_length_253_cov_0.870130	17	46	2	29	29	1.0000000
NODE_288478_length_253_cov_0.850649	0	89	0	89	89	1.0000000
NODE_289563_length_252_cov_4.771242	94	148	0	54	54	1.0000000
NODE_289574_length_252_cov_4.614379	16	37	0	21	21	1.0000000
NODE_289624_length_252_cov_3.960784	7	85	0	78	78	1.0000000
NODE_289624_length_252_cov_3.960784	63	136	0	73	73	1.0000000
NODE_289663_length_252_cov_3.549020	89	157	5	3	68	0.0441176
NODE_289663_length_252_cov_3.549020	89	157	7	49	68	0.7205882
NODE_289663_length_252_cov_3.549020	89	157	9	16	68	0.2352941
NODE_289672_length_252_cov_3.405229	26	107	4	25	81	0.3086420
NODE_289672_length_252_cov_3.405229	26	107	5	1	81	0.0123457
NODE_289672_length_252_cov_3.405229	26	107	7	32	81	0.3950617
NODE_289672_length_252_cov_3.405229	26	107	8	23	81	0.2839506
NODE_289705_length_252_cov_3.307190	91	141	0	50	50	1.0000000
NODE_289742_length_252_cov_3.032680	135	212	6	7	77	0.0909091
NODE_289742_length_252_cov_3.032680	135	212	8	12	77	0.1558442
NODE_289742_length_252_cov_3.032680	135	212	10	18	77	0.2337662
NODE_289742_length_252_cov_3.032680	135	212	12	40	77	0.5194805
NODE_289775_length_252_cov_2.928105	0	57	0	55	57	0.9649123
NODE_289775_length_252_cov_2.928105	0	57	2	2	57	0.0350877
NODE_289799_length_252_cov_2.803922	41	121	0	80	80	1.0000000
NODE_290032_length_252_cov_2.320261	0	64	0	64	64	1.0000000
NODE_290046_length_252_cov_2.281046	120	170	0	50	50	1.0000000
NODE_290066_length_252_cov_2.215686	137	175	53	7	38	0.1842105
NODE_290066_length_252_cov_2.215686	137	175	55	17	38	0.4473684
NODE_290066_length_252_cov_2.215686	137	175	57	14	38	0.3684210
NODE_290103_length_252_cov_2.052288	18	39	0	21	21	1.0000000
NODE_290238_length_252_cov_1.993464	80	139	2	59	59	1.0000000
NODE_290385_length_252_cov_1.810458	3	49	0	46	46	1.0000000
NODE_290623_length_252_cov_1.594771	103	156	0	53	53	1.0000000
NODE_290623_length_252_cov_1.594771	152	192	0	40	40	1.0000000
NODE_290638_length_252_cov_1.568627	1	68	0	4	67	0.0597015
NODE_290638_length_252_cov_1.568627	1	68	2	63	67	0.9402985
NODE_290767_length_252_cov_1.359477	26	93	0	67	67	1.0000000
NODE_290790_length_252_cov_1.333333	179	232	0	53	53	1.0000000
NODE_290850_length_252_cov_1.333333	187	222	4	35	35	1.0000000
NODE_291072_length_252_cov_1.333333	31	111	0	80	80	1.0000000
NODE_291076_length_252_cov_1.333333	90	140	10	12	50	0.2400000
NODE_291076_length_252_cov_1.333333	90	140	11	1	50	0.0200000
NODE_291076_length_252_cov_1.333333	90	140	12	28	50	0.5600000
NODE_291076_length_252_cov_1.333333	90	140	14	9	50	0.1800000
NODE_291118_length_252_cov_1.326797	112	143	0	31	31	1.0000000
NODE_291351_length_252_cov_1.156863	1	32	0	31	31	1.0000000
NODE_291650_length_252_cov_1.000000	49	79	2	30	30	1.0000000
NODE_291911_length_252_cov_0.836601	125	172	0	1	47	0.0212766
NODE_291911_length_252_cov_0.836601	125	172	4	18	47	0.3829787
NODE_291911_length_252_cov_0.836601	125	172	8	25	47	0.5319149
NODE_291911_length_252_cov_0.836601	125	172	10	3	47	0.0638298
NODE_293004_length_251_cov_5.032895	0	62	0	62	62	1.0000000
NODE_293005_length_251_cov_5.026316	84	164	0	2	80	0.0250000
NODE_293005_length_251_cov_5.026316	84	164	2	78	80	0.9750000
NODE_293165_length_251_cov_3.302632	187	249	0	4	62	0.0645161
NODE_293165_length_251_cov_3.302632	187	249	2	58	62	0.9354839
NODE_293195_length_251_cov_3.131579	96	148	0	52	52	1.0000000
NODE_293238_length_251_cov_2.980263	11	38	3	1	27	0.0370370
NODE_293238_length_251_cov_2.980263	11	38	11	2	27	0.0740741
NODE_293238_length_251_cov_2.980263	11	38	14	1	27	0.0370370
NODE_293238_length_251_cov_2.980263	11	38	17	3	27	0.1111111
NODE_293238_length_251_cov_2.980263	11	38	19	2	27	0.0740741
NODE_293238_length_251_cov_2.980263	11	38	21	18	27	0.6666667
NODE_293238_length_251_cov_2.980263	11	91	3	1	80	0.0125000
NODE_293238_length_251_cov_2.980263	11	91	11	2	80	0.0250000
NODE_293238_length_251_cov_2.980263	11	91	14	1	80	0.0125000
NODE_293238_length_251_cov_2.980263	11	91	17	3	80	0.0375000
NODE_293238_length_251_cov_2.980263	11	91	19	2	80	0.0250000
NODE_293238_length_251_cov_2.980263	11	91	21	19	80	0.2375000
NODE_293238_length_251_cov_2.980263	11	91	23	3	80	0.0375000
NODE_293238_length_251_cov_2.980263	11	91	24	49	80	0.6125000
NODE_293259_length_251_cov_2.842105	170	198	0	10	28	0.3571429
NODE_293259_length_251_cov_2.842105	170	198	2	5	28	0.1785714
NODE_293259_length_251_cov_2.842105	170	198	4	13	28	0.4642857
NODE_293279_length_251_cov_2.743421	181	232	0	51	51	1.0000000
NODE_293335_length_251_cov_2.677632	35	54	0	19	19	1.0000000
NODE_293454_length_251_cov_2.348684	196	251	0	55	55	1.0000000
NODE_293502_length_251_cov_2.328947	86	149	0	58	63	0.9206349
NODE_293502_length_251_cov_2.328947	86	149	4	5	63	0.0793651
NODE_293516_length_251_cov_2.296053	91	171	0	80	80	1.0000000
NODE_293516_length_251_cov_2.296053	144	224	0	80	80	1.0000000
NODE_293591_length_251_cov_2.065789	7	52	0	45	45	1.0000000
NODE_293698_length_251_cov_2.013158	96	179	0	49	83	0.5903614
NODE_293698_length_251_cov_2.013158	96	179	2	34	83	0.4096386
NODE_293698_length_251_cov_2.013158	96	179	0	49	83	0.5903614
NODE_293698_length_251_cov_2.013158	96	179	2	34	83	0.4096386
NODE_293698_length_251_cov_2.013158	152	203	2	51	51	1.0000000
NODE_293698_length_251_cov_2.013158	152	201	2	49	49	1.0000000
NODE_293919_length_251_cov_1.710526	135	194	0	59	59	1.0000000
NODE_294028_length_251_cov_1.671053	94	127	0	33	33	1.0000000
NODE_294063_length_251_cov_1.644737	135	164	0	29	29	1.0000000
NODE_294147_length_251_cov_1.473684	137	202	4	43	65	0.6615385
NODE_294147_length_251_cov_1.473684	137	202	5	1	65	0.0153846
NODE_294147_length_251_cov_1.473684	137	202	6	21	65	0.3230769
NODE_294153_length_251_cov_1.460526	17	78	2	44	61	0.7213115
NODE_294153_length_251_cov_1.460526	17	78	4	17	61	0.2786885
NODE_294190_length_251_cov_1.407895	182	246	2	23	64	0.3593750
NODE_294190_length_251_cov_1.407895	182	246	4	41	64	0.6406250
NODE_294393_length_251_cov_1.342105	9	89	0	80	80	1.0000000
NODE_294393_length_251_cov_1.342105	62	91	0	29	29	1.0000000
NODE_294624_length_251_cov_1.296053	7	47	0	40	40	1.0000000
NODE_294624_length_251_cov_1.296053	24	47	0	23	23	1.0000000
NODE_295165_length_251_cov_1.006579	4	50	0	46	46	1.0000000
NODE_296033_length_251_cov_0.671053	184	204	0	20	20	1.0000000
NODE_296386_length_251_cov_0.572368	54	74	0	20	20	1.0000000
NODE_296437_length_250_cov_35.662252	33	99	0	66	66	1.0000000
NODE_296437_length_250_cov_35.662252	143	223	0	19	80	0.2375000
NODE_296437_length_250_cov_35.662252	143	223	2	61	80	0.7625000
NODE_296456_length_250_cov_6.503311	186	250	0	64	64	1.0000000
NODE_296467_length_250_cov_5.867550	99	120	0	21	21	1.0000000
NODE_296520_length_250_cov_4.662252	143	187	0	44	44	1.0000000
NODE_296520_length_250_cov_4.662252	160	227	0	67	67	1.0000000
NODE_296598_length_250_cov_3.715232	37	90	6	53	53	1.0000000
NODE_296633_length_250_cov_3.417219	113	193	0	80	80	1.0000000
NODE_296633_length_250_cov_3.417219	166	246	0	80	80	1.0000000
NODE_296653_length_250_cov_3.364238	0	61	0	43	61	0.7049180
NODE_296653_length_250_cov_3.364238	0	61	2	18	61	0.2950820
NODE_296653_length_250_cov_3.364238	34	94	0	9	60	0.1500000
NODE_296653_length_250_cov_3.364238	34	94	2	51	60	0.8500000
NODE_296680_length_250_cov_3.225166	157	209	6	52	52	1.0000000
NODE_296680_length_250_cov_3.225166	182	250	0	2	68	0.0294118
NODE_296680_length_250_cov_3.225166	182	250	2	8	68	0.1176471
NODE_296680_length_250_cov_3.225166	182	250	4	1	68	0.0147059
NODE_296680_length_250_cov_3.225166	182	250	6	57	68	0.8382353
NODE_296699_length_250_cov_3.086093	33	67	6	34	34	1.0000000
NODE_296703_length_250_cov_3.052980	29	94	2	10	65	0.1538462
NODE_296703_length_250_cov_3.052980	29	94	4	38	65	0.5846154
NODE_296703_length_250_cov_3.052980	29	94	6	17	65	0.2615385
NODE_296707_length_250_cov_3.039735	51	106	0	55	55	1.0000000
NODE_296737_length_250_cov_2.986755	124	185	10	15	61	0.2459016
NODE_296737_length_250_cov_2.986755	124	185	12	6	61	0.0983607
NODE_296737_length_250_cov_2.986755	124	185	14	28	61	0.4590164
NODE_296737_length_250_cov_2.986755	124	185	16	12	61	0.1967213
NODE_296737_length_250_cov_2.986755	172	243	2	6	71	0.0845070
NODE_296737_length_250_cov_2.986755	172	243	4	10	71	0.1408451
NODE_296737_length_250_cov_2.986755	172	243	6	3	71	0.0422535
NODE_296737_length_250_cov_2.986755	172	243	8	28	71	0.3943662
NODE_296737_length_250_cov_2.986755	172	243	10	24	71	0.3380282
NODE_296885_length_250_cov_2.516556	0	49	0	49	49	1.0000000
NODE_296893_length_250_cov_2.476821	94	174	0	80	80	1.0000000
NODE_296893_length_250_cov_2.476821	147	227	0	80	80	1.0000000
NODE_296897_length_250_cov_2.470199	166	212	0	46	46	1.0000000
NODE_297070_length_250_cov_2.059603	150	207	0	57	57	1.0000000
NODE_297211_length_250_cov_2.019868	74	141	10	24	67	0.3582090
NODE_297211_length_250_cov_2.019868	74	141	12	32	67	0.4776119
NODE_297211_length_250_cov_2.019868	74	141	14	1	67	0.0149254
NODE_297211_length_250_cov_2.019868	74	141	18	10	67	0.1492537
NODE_297211_length_250_cov_2.019868	158	204	14	11	46	0.2391304
NODE_297211_length_250_cov_2.019868	158	204	16	3	46	0.0652174
NODE_297211_length_250_cov_2.019868	158	204	18	27	46	0.5869565
NODE_297211_length_250_cov_2.019868	158	204	20	5	46	0.1086956
NODE_297550_length_250_cov_1.688742	6	42	0	36	36	1.0000000
NODE_297624_length_250_cov_1.635762	150	191	2	6	41	0.1463415
NODE_297624_length_250_cov_1.635762	150	191	4	17	41	0.4146341
NODE_297624_length_250_cov_1.635762	150	191	5	18	41	0.4390244
NODE_297679_length_250_cov_1.529801	59	108	0	47	49	0.9591837
NODE_297679_length_250_cov_1.529801	59	108	2	2	49	0.0408163
NODE_297679_length_250_cov_1.529801	81	161	0	25	80	0.3125000
NODE_297679_length_250_cov_1.529801	81	161	2	55	80	0.6875000
NODE_297693_length_250_cov_1.516556	124	184	0	4	60	0.0666667
NODE_297693_length_250_cov_1.516556	124	184	2	28	60	0.4666667
NODE_297693_length_250_cov_1.516556	124	184	4	28	60	0.4666667
NODE_297693_length_250_cov_1.516556	166	237	0	57	71	0.8028169
NODE_297693_length_250_cov_1.516556	166	237	2	14	71	0.1971831
NODE_297762_length_250_cov_1.377483	0	80	0	80	80	1.0000000
NODE_297963_length_250_cov_1.350993	40	98	0	58	58	1.0000000
NODE_298213_length_250_cov_1.291391	116	196	2	18	80	0.2250000
NODE_298213_length_250_cov_1.291391	116	196	4	62	80	0.7750000
NODE_298719_length_250_cov_1.013245	126	163	0	37	37	1.0000000
NODE_298794_length_250_cov_1.006623	129	148	2	19	19	1.0000000
NODE_298900_length_250_cov_0.920530	126	178	24	8	52	0.1538462
NODE_298900_length_250_cov_0.920530	126	178	26	1	52	0.0192308
NODE_298900_length_250_cov_0.920530	126	178	28	21	52	0.4038461
NODE_298900_length_250_cov_0.920530	126	178	30	2	52	0.0384615
NODE_298900_length_250_cov_0.920530	126	178	34	2	52	0.0384615
NODE_298900_length_250_cov_0.920530	126	178	36	12	52	0.2307692
NODE_298900_length_250_cov_0.920530	126	178	38	6	52	0.1153846
NODE_299979_length_249_cov_55.413333	97	172	0	75	75	1.0000000
NODE_299979_length_249_cov_55.413333	150	225	0	75	75	1.0000000
NODE_300012_length_247_cov_51.243243	172	247	0	75	75	1.0000000
NODE_300014_length_247_cov_37.614865	156	239	0	83	83	1.0000000
NODE_300056_length_245_cov_40.876712	138	202	37	5	64	0.0781250
NODE_300056_length_245_cov_40.876712	138	202	45	1	64	0.0156250
NODE_300056_length_245_cov_40.876712	138	202	58	2	64	0.0312500
NODE_300056_length_245_cov_40.876712	138	202	60	2	64	0.0312500
NODE_300056_length_245_cov_40.876712	138	202	64	3	64	0.0468750
NODE_300056_length_245_cov_40.876712	138	202	65	1	64	0.0156250
NODE_300056_length_245_cov_40.876712	138	202	66	1	64	0.0156250
NODE_300056_length_245_cov_40.876712	138	202	69	1	64	0.0156250
NODE_300056_length_245_cov_40.876712	138	202	70	3	64	0.0468750
NODE_300056_length_245_cov_40.876712	138	202	74	1	64	0.0156250
NODE_300056_length_245_cov_40.876712	138	202	76	1	64	0.0156250
NODE_300056_length_245_cov_40.876712	138	202	78	1	64	0.0156250
NODE_300056_length_245_cov_40.876712	138	202	82	1	64	0.0156250
NODE_300056_length_245_cov_40.876712	138	202	83	2	64	0.0312500
NODE_300056_length_245_cov_40.876712	138	202	84	2	64	0.0312500
NODE_300056_length_245_cov_40.876712	138	202	86	5	64	0.0781250
NODE_300056_length_245_cov_40.876712	138	202	88	1	64	0.0156250
NODE_300056_length_245_cov_40.876712	138	202	91	3	64	0.0468750
NODE_300056_length_245_cov_40.876712	138	202	92	2	64	0.0312500
NODE_300056_length_245_cov_40.876712	138	202	93	2	64	0.0312500
NODE_300056_length_245_cov_40.876712	138	202	95	4	64	0.0625000
NODE_300056_length_245_cov_40.876712	138	202	98	9	64	0.1406250
NODE_300056_length_245_cov_40.876712	138	202	99	1	64	0.0156250
NODE_300056_length_245_cov_40.876712	138	202	101	1	64	0.0156250
NODE_300056_length_245_cov_40.876712	138	202	111	1	64	0.0156250
NODE_300056_length_245_cov_40.876712	138	202	115	4	64	0.0625000
NODE_300056_length_245_cov_40.876712	138	202	117	4	64	0.0625000
NODE_300056_length_245_cov_40.876712	138	202	37	5	64	0.0781250
NODE_300056_length_245_cov_40.876712	138	202	45	1	64	0.0156250
NODE_300056_length_245_cov_40.876712	138	202	58	2	64	0.0312500
NODE_300056_length_245_cov_40.876712	138	202	60	2	64	0.0312500
NODE_300056_length_245_cov_40.876712	138	202	64	3	64	0.0468750
NODE_300056_length_245_cov_40.876712	138	202	65	1	64	0.0156250
NODE_300056_length_245_cov_40.876712	138	202	66	1	64	0.0156250
NODE_300056_length_245_cov_40.876712	138	202	69	1	64	0.0156250
NODE_300056_length_245_cov_40.876712	138	202	70	3	64	0.0468750
NODE_300056_length_245_cov_40.876712	138	202	74	1	64	0.0156250
NODE_300056_length_245_cov_40.876712	138	202	76	1	64	0.0156250
NODE_300056_length_245_cov_40.876712	138	202	78	1	64	0.0156250
NODE_300056_length_245_cov_40.876712	138	202	82	1	64	0.0156250
NODE_300056_length_245_cov_40.876712	138	202	83	2	64	0.0312500
NODE_300056_length_245_cov_40.876712	138	202	84	2	64	0.0312500
NODE_300056_length_245_cov_40.876712	138	202	86	5	64	0.0781250
NODE_300056_length_245_cov_40.876712	138	202	88	1	64	0.0156250
NODE_300056_length_245_cov_40.876712	138	202	91	3	64	0.0468750
NODE_300056_length_245_cov_40.876712	138	202	92	2	64	0.0312500
NODE_300056_length_245_cov_40.876712	138	202	93	2	64	0.0312500
NODE_300056_length_245_cov_40.876712	138	202	95	4	64	0.0625000
NODE_300056_length_245_cov_40.876712	138	202	98	9	64	0.1406250
NODE_300056_length_245_cov_40.876712	138	202	99	1	64	0.0156250
NODE_300056_length_245_cov_40.876712	138	202	101	1	64	0.0156250
NODE_300056_length_245_cov_40.876712	138	202	111	1	64	0.0156250
NODE_300056_length_245_cov_40.876712	138	202	115	4	64	0.0625000
NODE_300056_length_245_cov_40.876712	138	202	117	4	64	0.0625000
NODE_300056_length_245_cov_40.876712	138	202	37	5	64	0.0781250
NODE_300056_length_245_cov_40.876712	138	202	45	1	64	0.0156250
NODE_300056_length_245_cov_40.876712	138	202	58	2	64	0.0312500
NODE_300056_length_245_cov_40.876712	138	202	60	2	64	0.0312500
NODE_300056_length_245_cov_40.876712	138	202	64	3	64	0.0468750
NODE_300056_length_245_cov_40.876712	138	202	65	1	64	0.0156250
NODE_300056_length_245_cov_40.876712	138	202	66	1	64	0.0156250
NODE_300056_length_245_cov_40.876712	138	202	69	1	64	0.0156250
NODE_300056_length_245_cov_40.876712	138	202	70	3	64	0.0468750
NODE_300056_length_245_cov_40.876712	138	202	74	1	64	0.0156250
NODE_300056_length_245_cov_40.876712	138	202	76	1	64	0.0156250
NODE_300056_length_245_cov_40.876712	138	202	78	1	64	0.0156250
NODE_300056_length_245_cov_40.876712	138	202	82	1	64	0.0156250
NODE_300056_length_245_cov_40.876712	138	202	83	2	64	0.0312500
NODE_300056_length_245_cov_40.876712	138	202	84	2	64	0.0312500
NODE_300056_length_245_cov_40.876712	138	202	86	5	64	0.0781250
NODE_300056_length_245_cov_40.876712	138	202	88	1	64	0.0156250
NODE_300056_length_245_cov_40.876712	138	202	91	3	64	0.0468750
NODE_300056_length_245_cov_40.876712	138	202	92	2	64	0.0312500
NODE_300056_length_245_cov_40.876712	138	202	93	2	64	0.0312500
NODE_300056_length_245_cov_40.876712	138	202	95	4	64	0.0625000
NODE_300056_length_245_cov_40.876712	138	202	98	9	64	0.1406250
NODE_300056_length_245_cov_40.876712	138	202	99	1	64	0.0156250
NODE_300056_length_245_cov_40.876712	138	202	101	1	64	0.0156250
NODE_300056_length_245_cov_40.876712	138	202	111	1	64	0.0156250
NODE_300056_length_245_cov_40.876712	138	202	115	4	64	0.0625000
NODE_300056_length_245_cov_40.876712	138	202	117	4	64	0.0625000
NODE_300056_length_245_cov_40.876712	175	241	4	9	66	0.1363636
NODE_300056_length_245_cov_40.876712	175	241	6	4	66	0.0606061
NODE_300056_length_245_cov_40.876712	175	241	8	5	66	0.0757576
NODE_300056_length_245_cov_40.876712	175	241	15	1	66	0.0151515
NODE_300056_length_245_cov_40.876712	175	241	18	5	66	0.0757576
NODE_300056_length_245_cov_40.876712	175	241	20	1	66	0.0151515
NODE_300056_length_245_cov_40.876712	175	241	22	3	66	0.0454545
NODE_300056_length_245_cov_40.876712	175	241	23	6	66	0.0909091
NODE_300056_length_245_cov_40.876712	175	241	27	2	66	0.0303030
NODE_300056_length_245_cov_40.876712	175	241	30	2	66	0.0303030
NODE_300056_length_245_cov_40.876712	175	241	37	6	66	0.0909091
NODE_300056_length_245_cov_40.876712	175	241	45	1	66	0.0151515
NODE_300056_length_245_cov_40.876712	175	241	58	2	66	0.0303030
NODE_300056_length_245_cov_40.876712	175	241	60	2	66	0.0303030
NODE_300056_length_245_cov_40.876712	175	241	64	3	66	0.0454545
NODE_300056_length_245_cov_40.876712	175	241	65	1	66	0.0151515
NODE_300056_length_245_cov_40.876712	175	241	66	1	66	0.0151515
NODE_300056_length_245_cov_40.876712	175	241	69	1	66	0.0151515
NODE_300056_length_245_cov_40.876712	175	241	70	3	66	0.0454545
NODE_300056_length_245_cov_40.876712	175	241	74	1	66	0.0151515
NODE_300056_length_245_cov_40.876712	175	241	76	1	66	0.0151515
NODE_300056_length_245_cov_40.876712	175	241	78	1	66	0.0151515
NODE_300056_length_245_cov_40.876712	175	241	82	1	66	0.0151515
NODE_300056_length_245_cov_40.876712	175	241	83	2	66	0.0303030
NODE_300056_length_245_cov_40.876712	175	241	84	2	66	0.0303030
NODE_300147_length_240_cov_80.744681	167	238	0	57	71	0.8028169
NODE_300147_length_240_cov_80.744681	167	238	2	3	71	0.0422535
NODE_300147_length_240_cov_80.744681	167	238	18	11	71	0.1549296
NODE_300148_length_240_cov_38.035461	31	82	0	51	51	1.0000000
NODE_300165_length_239_cov_72.878571	0	48	0	48	48	1.0000000
NODE_300165_length_239_cov_72.878571	21	101	0	34	80	0.4250000
NODE_300165_length_239_cov_72.878571	21	101	2	20	80	0.2500000
NODE_300165_length_239_cov_72.878571	21	101	4	26	80	0.3250000
NODE_300165_length_239_cov_72.878571	150	230	0	19	80	0.2375000
NODE_300165_length_239_cov_72.878571	150	230	2	3	80	0.0375000
NODE_300165_length_239_cov_72.878571	150	230	6	25	80	0.3125000
NODE_300165_length_239_cov_72.878571	150	230	8	28	80	0.3500000
NODE_300165_length_239_cov_72.878571	150	230	10	5	80	0.0625000
NODE_300165_length_239_cov_72.878571	150	230	0	19	80	0.2375000
NODE_300165_length_239_cov_72.878571	150	230	2	3	80	0.0375000
NODE_300165_length_239_cov_72.878571	150	230	6	25	80	0.3125000
NODE_300165_length_239_cov_72.878571	150	230	8	28	80	0.3500000
NODE_300165_length_239_cov_72.878571	150	230	10	5	80	0.0625000
NODE_300165_length_239_cov_72.878571	150	212	0	1	62	0.0161290
NODE_300165_length_239_cov_72.878571	150	212	2	3	62	0.0483871
NODE_300165_length_239_cov_72.878571	150	212	6	25	62	0.4032258
NODE_300165_length_239_cov_72.878571	150	212	8	28	62	0.4516129
NODE_300165_length_239_cov_72.878571	150	212	10	5	62	0.0806452
NODE_300165_length_239_cov_72.878571	150	221	0	10	71	0.1408451
NODE_300165_length_239_cov_72.878571	150	221	2	3	71	0.0422535
NODE_300165_length_239_cov_72.878571	150	221	6	25	71	0.3521127
NODE_300165_length_239_cov_72.878571	150	221	8	28	71	0.3943662
NODE_300165_length_239_cov_72.878571	150	221	10	5	71	0.0704225
NODE_300208_length_238_cov_385.683453	35	104	72	6	69	0.0869565
NODE_300208_length_238_cov_385.683453	35	104	74	2	69	0.0289855
NODE_300208_length_238_cov_385.683453	35	104	78	1	69	0.0144928
NODE_300208_length_238_cov_385.683453	35	104	82	1	69	0.0144928
NODE_300208_length_238_cov_385.683453	35	104	87	2	69	0.0289855
NODE_300208_length_238_cov_385.683453	35	104	92	13	69	0.1884058
NODE_300208_length_238_cov_385.683453	35	104	96	1	69	0.0144928
NODE_300208_length_238_cov_385.683453	35	104	98	1	69	0.0144928
NODE_300208_length_238_cov_385.683453	35	104	113	1	69	0.0144928
NODE_300208_length_238_cov_385.683453	35	104	116	4	69	0.0579710
NODE_300208_length_238_cov_385.683453	35	104	118	4	69	0.0579710
NODE_300208_length_238_cov_385.683453	35	104	120	2	69	0.0289855
NODE_300208_length_238_cov_385.683453	35	104	123	1	69	0.0144928
NODE_300208_length_238_cov_385.683453	35	104	125	5	69	0.0724638
NODE_300208_length_238_cov_385.683453	35	104	129	2	69	0.0289855
NODE_300208_length_238_cov_385.683453	35	104	131	5	69	0.0724638
NODE_300208_length_238_cov_385.683453	35	104	133	2	69	0.0289855
NODE_300208_length_238_cov_385.683453	35	104	137	6	69	0.0869565
NODE_300208_length_238_cov_385.683453	35	104	139	5	69	0.0724638
NODE_300208_length_238_cov_385.683453	35	104	140	2	69	0.0289855
NODE_300208_length_238_cov_385.683453	35	104	144	3	69	0.0434783
NODE_300225_length_237_cov_101.543478	83	163	6	16	80	0.2000000
NODE_300225_length_237_cov_101.543478	83	163	8	20	80	0.2500000
NODE_300225_length_237_cov_101.543478	83	163	10	43	80	0.5375000
NODE_300225_length_237_cov_101.543478	83	163	12	1	80	0.0125000
NODE_300225_length_237_cov_101.543478	83	163	6	16	80	0.2000000
NODE_300225_length_237_cov_101.543478	83	163	8	20	80	0.2500000
NODE_300225_length_237_cov_101.543478	83	163	10	43	80	0.5375000
NODE_300225_length_237_cov_101.543478	83	163	12	1	80	0.0125000
NODE_300225_length_237_cov_101.543478	83	163	6	16	80	0.2000000
NODE_300225_length_237_cov_101.543478	83	163	8	20	80	0.2500000
NODE_300225_length_237_cov_101.543478	83	163	10	43	80	0.5375000
NODE_300225_length_237_cov_101.543478	83	163	12	1	80	0.0125000
NODE_300225_length_237_cov_101.543478	83	163	6	16	80	0.2000000
NODE_300225_length_237_cov_101.543478	83	163	8	20	80	0.2500000
NODE_300225_length_237_cov_101.543478	83	163	10	43	80	0.5375000
NODE_300225_length_237_cov_101.543478	83	163	12	1	80	0.0125000
NODE_300225_length_237_cov_101.543478	136	216	2	29	80	0.3625000
NODE_300225_length_237_cov_101.543478	136	216	4	6	80	0.0750000
NODE_300225_length_237_cov_101.543478	136	216	6	16	80	0.2000000
NODE_300225_length_237_cov_101.543478	136	216	10	29	80	0.3625000
NODE_300225_length_237_cov_101.543478	136	216	2	29	80	0.3625000
NODE_300225_length_237_cov_101.543478	136	216	4	6	80	0.0750000
NODE_300225_length_237_cov_101.543478	136	216	6	16	80	0.2000000
NODE_300225_length_237_cov_101.543478	136	216	10	29	80	0.3625000
NODE_300225_length_237_cov_101.543478	136	216	2	29	80	0.3625000
NODE_300225_length_237_cov_101.543478	136	216	4	6	80	0.0750000
NODE_300225_length_237_cov_101.543478	136	216	6	16	80	0.2000000
NODE_300225_length_237_cov_101.543478	136	216	10	29	80	0.3625000
NODE_300225_length_237_cov_101.543478	138	216	2	29	78	0.3717949
NODE_300225_length_237_cov_101.543478	138	216	4	6	78	0.0769231
NODE_300225_length_237_cov_101.543478	138	216	6	16	78	0.2051282
NODE_300225_length_237_cov_101.543478	138	216	10	27	78	0.3461539
NODE_300225_length_237_cov_101.543478	138	216	2	29	78	0.3717949
NODE_300225_length_237_cov_101.543478	138	216	4	6	78	0.0769231
NODE_300225_length_237_cov_101.543478	138	216	6	16	78	0.2051282
NODE_300225_length_237_cov_101.543478	138	216	10	27	78	0.3461539
NODE_300227_length_237_cov_49.623188	13	88	0	75	75	1.0000000
NODE_300227_length_237_cov_49.623188	73	153	0	80	80	1.0000000
NODE_300227_length_237_cov_49.623188	126	206	0	80	80	1.0000000
NODE_300289_length_235_cov_67.904412	0	62	0	16	62	0.2580645
NODE_300289_length_235_cov_67.904412	0	62	5	6	62	0.0967742
NODE_300289_length_235_cov_67.904412	0	62	6	40	62	0.6451613
NODE_300289_length_235_cov_67.904412	25	111	6	86	86	1.0000000
NODE_300289_length_235_cov_67.904412	69	150	0	6	81	0.0740741
NODE_300289_length_235_cov_67.904412	69	150	6	75	81	0.9259259
NODE_300289_length_235_cov_67.904412	113	194	0	50	81	0.6172839
NODE_300289_length_235_cov_67.904412	113	194	6	31	81	0.3827161
NODE_300289_length_235_cov_67.904412	157	235	0	78	78	1.0000000
NODE_300322_length_234_cov_76.496296	0	76	0	11	76	0.1447368
NODE_300322_length_234_cov_76.496296	0	76	2	9	76	0.1184211
NODE_300322_length_234_cov_76.496296	0	76	4	13	76	0.1710526
NODE_300322_length_234_cov_76.496296	0	76	8	20	76	0.2631579
NODE_300322_length_234_cov_76.496296	0	76	12	23	76	0.3026316
NODE_300322_length_234_cov_76.496296	0	76	0	11	76	0.1447368
NODE_300322_length_234_cov_76.496296	0	76	2	9	76	0.1184211
NODE_300322_length_234_cov_76.496296	0	76	4	13	76	0.1710526
NODE_300322_length_234_cov_76.496296	0	76	8	20	76	0.2631579
NODE_300322_length_234_cov_76.496296	0	76	12	23	76	0.3026316
NODE_300322_length_234_cov_76.496296	0	76	0	11	76	0.1447368
NODE_300322_length_234_cov_76.496296	0	76	2	9	76	0.1184211
NODE_300322_length_234_cov_76.496296	0	76	4	13	76	0.1710526
NODE_300322_length_234_cov_76.496296	0	76	8	20	76	0.2631579
NODE_300322_length_234_cov_76.496296	0	76	12	23	76	0.3026316
NODE_300322_length_234_cov_76.496296	0	76	0	11	76	0.1447368
NODE_300322_length_234_cov_76.496296	0	76	2	9	76	0.1184211
NODE_300322_length_234_cov_76.496296	0	76	4	13	76	0.1710526
NODE_300322_length_234_cov_76.496296	0	76	8	20	76	0.2631579
NODE_300322_length_234_cov_76.496296	0	76	12	23	76	0.3026316
NODE_300322_length_234_cov_76.496296	49	128	8	4	79	0.0506329
NODE_300322_length_234_cov_76.496296	49	128	12	54	79	0.6835443
NODE_300322_length_234_cov_76.496296	49	128	20	16	79	0.2025317
NODE_300322_length_234_cov_76.496296	49	128	22	4	79	0.0506329
NODE_300322_length_234_cov_76.496296	49	128	30	1	79	0.0126582
NODE_300322_length_234_cov_76.496296	49	128	8	4	79	0.0506329
NODE_300322_length_234_cov_76.496296	49	128	12	54	79	0.6835443
NODE_300322_length_234_cov_76.496296	49	128	20	16	79	0.2025317
NODE_300322_length_234_cov_76.496296	49	128	22	4	79	0.0506329
NODE_300322_length_234_cov_76.496296	49	128	30	1	79	0.0126582
NODE_300322_length_234_cov_76.496296	124	204	16	17	80	0.2125000
NODE_300322_length_234_cov_76.496296	124	204	18	9	80	0.1125000
NODE_300322_length_234_cov_76.496296	124	204	22	12	80	0.1500000
NODE_300322_length_234_cov_76.496296	124	204	24	9	80	0.1125000
NODE_300322_length_234_cov_76.496296	124	204	26	16	80	0.2000000
NODE_300322_length_234_cov_76.496296	124	204	30	17	80	0.2125000
NODE_300322_length_234_cov_76.496296	124	204	16	17	80	0.2125000
NODE_300322_length_234_cov_76.496296	124	204	18	9	80	0.1125000
NODE_300322_length_234_cov_76.496296	124	204	22	12	80	0.1500000
NODE_300322_length_234_cov_76.496296	124	204	24	9	80	0.1125000
NODE_300322_length_234_cov_76.496296	124	204	26	16	80	0.2000000
NODE_300322_length_234_cov_76.496296	124	204	30	17	80	0.2125000
NODE_300322_length_234_cov_76.496296	124	204	16	17	80	0.2125000
NODE_300322_length_234_cov_76.496296	124	204	18	9	80	0.1125000
NODE_300322_length_234_cov_76.496296	124	204	22	12	80	0.1500000
NODE_300322_length_234_cov_76.496296	124	204	24	9	80	0.1125000
NODE_300322_length_234_cov_76.496296	124	204	26	16	80	0.2000000
NODE_300322_length_234_cov_76.496296	124	204	30	17	80	0.2125000
NODE_300322_length_234_cov_76.496296	177	226	1	8	49	0.1632653
NODE_300322_length_234_cov_76.496296	177	226	2	4	49	0.0816327
NODE_300322_length_234_cov_76.496296	177	226	8	1	49	0.0204082
NODE_300322_length_234_cov_76.496296	177	226	16	26	49	0.5306122
NODE_300322_length_234_cov_76.496296	177	226	18	9	49	0.1836735
NODE_300322_length_234_cov_76.496296	177	226	22	1	49	0.0204082
NODE_300322_length_234_cov_76.496296	177	234	0	1	57	0.0175439
NODE_300322_length_234_cov_76.496296	177	234	1	15	57	0.2631579
NODE_300322_length_234_cov_76.496296	177	234	2	4	57	0.0701754
NODE_300322_length_234_cov_76.496296	177	234	8	1	57	0.0175439
NODE_300322_length_234_cov_76.496296	177	234	16	26	57	0.4561403
NODE_300322_length_234_cov_76.496296	177	234	18	9	57	0.1578947
NODE_300322_length_234_cov_76.496296	177	234	22	1	57	0.0175439
NODE_300322_length_234_cov_76.496296	182	234	0	1	52	0.0192308
NODE_300322_length_234_cov_76.496296	182	234	1	15	52	0.2884615
NODE_300322_length_234_cov_76.496296	182	234	2	4	52	0.0769231
NODE_300322_length_234_cov_76.496296	182	234	8	1	52	0.0192308
NODE_300322_length_234_cov_76.496296	182	234	16	26	52	0.5000000
NODE_300322_length_234_cov_76.496296	182	234	18	5	52	0.0961538
NODE_300323_length_234_cov_71.548148	90	162	8	72	72	1.0000000
NODE_300323_length_234_cov_71.548148	90	162	8	72	72	1.0000000
NODE_300323_length_234_cov_71.548148	135	215	0	3	80	0.0375000
NODE_300323_length_234_cov_71.548148	135	215	7	1	80	0.0125000
NODE_300323_length_234_cov_71.548148	135	215	8	76	80	0.9500000
NODE_300323_length_234_cov_71.548148	135	215	0	3	80	0.0375000
NODE_300323_length_234_cov_71.548148	135	215	7	1	80	0.0125000
NODE_300323_length_234_cov_71.548148	135	215	8	76	80	0.9500000
NODE_300357_length_233_cov_180.701493	0	65	0	8	65	0.1230769
NODE_300357_length_233_cov_180.701493	0	65	1	1	65	0.0153846
NODE_300357_length_233_cov_180.701493	0	65	2	19	65	0.2923077
NODE_300357_length_233_cov_180.701493	0	65	6	29	65	0.4461538
NODE_300357_length_233_cov_180.701493	0	65	8	8	65	0.1230769
NODE_300357_length_233_cov_180.701493	38	118	6	19	80	0.2375000
NODE_300357_length_233_cov_180.701493	38	118	7	28	80	0.3500000
NODE_300357_length_233_cov_180.701493	38	118	8	33	80	0.4125000
NODE_300392_length_232_cov_132.045113	53	133	0	27	80	0.3375000
NODE_300392_length_232_cov_132.045113	53	133	4	17	80	0.2125000
NODE_300392_length_232_cov_132.045113	53	133	6	5	80	0.0625000
NODE_300392_length_232_cov_132.045113	53	133	8	5	80	0.0625000
NODE_300392_length_232_cov_132.045113	53	133	10	26	80	0.3250000
NODE_300392_length_232_cov_132.045113	106	186	8	17	80	0.2125000
NODE_300392_length_232_cov_132.045113	106	186	10	63	80	0.7875000
NODE_300471_length_230_cov_34.427481	0	59	0	59	59	1.0000000
NODE_300471_length_230_cov_34.427481	0	59	0	59	59	1.0000000
NODE_300471_length_230_cov_34.427481	10	59	0	49	49	1.0000000
NODE_300487_length_229_cov_76.907692	94	176	18	5	82	0.0609756
NODE_300487_length_229_cov_76.907692	94	176	20	4	82	0.0487805
NODE_300487_length_229_cov_76.907692	94	176	22	1	82	0.0121951
NODE_300487_length_229_cov_76.907692	94	176	24	3	82	0.0365854
NODE_300487_length_229_cov_76.907692	94	176	28	1	82	0.0121951
NODE_300487_length_229_cov_76.907692	94	176	30	2	82	0.0243902
NODE_300487_length_229_cov_76.907692	94	176	32	9	82	0.1097561
NODE_300487_length_229_cov_76.907692	94	176	34	10	82	0.1219512
NODE_300487_length_229_cov_76.907692	94	176	36	5	82	0.0609756
NODE_300487_length_229_cov_76.907692	94	176	38	17	82	0.2073171
NODE_300487_length_229_cov_76.907692	94	176	40	1	82	0.0121951
NODE_300487_length_229_cov_76.907692	94	176	42	1	82	0.0121951
NODE_300487_length_229_cov_76.907692	94	176	44	3	82	0.0365854
NODE_300487_length_229_cov_76.907692	94	176	46	4	82	0.0487805
NODE_300487_length_229_cov_76.907692	94	176	48	9	82	0.1097561
NODE_300487_length_229_cov_76.907692	94	176	50	5	82	0.0609756
NODE_300487_length_229_cov_76.907692	94	176	52	2	82	0.0243902
NODE_300523_length_228_cov_127.131783	0	76	0	4	76	0.0526316
NODE_300523_length_228_cov_127.131783	0	76	2	19	76	0.2500000
NODE_300523_length_228_cov_127.131783	0	76	4	17	76	0.2236842
NODE_300523_length_228_cov_127.131783	0	76	14	36	76	0.4736842
NODE_300523_length_228_cov_127.131783	5	76	2	18	71	0.2535211
NODE_300523_length_228_cov_127.131783	5	76	4	17	71	0.2394366
NODE_300523_length_228_cov_127.131783	5	76	14	36	71	0.5070422
NODE_300523_length_228_cov_127.131783	10	76	2	13	66	0.1969697
NODE_300523_length_228_cov_127.131783	10	76	4	17	66	0.2575758
NODE_300523_length_228_cov_127.131783	10	76	14	36	66	0.5454546
NODE_300523_length_228_cov_127.131783	49	129	10	19	80	0.2375000
NODE_300523_length_228_cov_127.131783	49	129	12	2	80	0.0250000
NODE_300523_length_228_cov_127.131783	49	129	14	59	80	0.7375000
NODE_300523_length_228_cov_127.131783	49	129	10	19	80	0.2375000
NODE_300523_length_228_cov_127.131783	49	129	12	2	80	0.0250000
NODE_300523_length_228_cov_127.131783	49	129	14	59	80	0.7375000
NODE_300523_length_228_cov_127.131783	49	129	10	19	80	0.2375000
NODE_300523_length_228_cov_127.131783	49	129	12	2	80	0.0250000
NODE_300523_length_228_cov_127.131783	49	129	14	59	80	0.7375000
NODE_300523_length_228_cov_127.131783	125	205	0	37	80	0.4625000
NODE_300523_length_228_cov_127.131783	125	205	10	43	80	0.5375000
NODE_300523_length_228_cov_127.131783	125	205	0	37	80	0.4625000
NODE_300523_length_228_cov_127.131783	125	205	10	43	80	0.5375000
NODE_300523_length_228_cov_127.131783	125	205	0	37	80	0.4625000
NODE_300523_length_228_cov_127.131783	125	205	10	43	80	0.5375000
NODE_300523_length_228_cov_127.131783	178	228	0	50	50	1.0000000
NODE_300523_length_228_cov_127.131783	178	228	0	50	50	1.0000000
NODE_300523_length_228_cov_127.131783	178	228	0	50	50	1.0000000
NODE_300524_length_228_cov_94.255814	34	99	7	8	65	0.1230769
NODE_300524_length_228_cov_94.255814	34	99	8	18	65	0.2769231
NODE_300524_length_228_cov_94.255814	34	99	34	17	65	0.2615385
NODE_300524_length_228_cov_94.255814	34	99	36	22	65	0.3384615
NODE_300524_length_228_cov_94.255814	34	114	7	8	80	0.1000000
NODE_300524_length_228_cov_94.255814	34	114	8	18	80	0.2250000
NODE_300524_length_228_cov_94.255814	34	114	34	17	80	0.2125000
NODE_300524_length_228_cov_94.255814	34	114	36	37	80	0.4625000
NODE_300524_length_228_cov_94.255814	41	111	7	1	70	0.0142857
NODE_300524_length_228_cov_94.255814	41	111	8	18	70	0.2571429
NODE_300524_length_228_cov_94.255814	41	111	34	17	70	0.2428571
NODE_300524_length_228_cov_94.255814	41	111	36	34	70	0.4857143
NODE_300524_length_228_cov_94.255814	43	114	8	17	71	0.2394366
NODE_300524_length_228_cov_94.255814	43	114	34	17	71	0.2394366
NODE_300524_length_228_cov_94.255814	43	114	36	37	71	0.5211267
NODE_300524_length_228_cov_94.255814	87	167	27	13	80	0.1625000
NODE_300524_length_228_cov_94.255814	87	167	28	5	80	0.0625000
NODE_300524_length_228_cov_94.255814	87	167	30	11	80	0.1375000
NODE_300524_length_228_cov_94.255814	87	167	36	31	80	0.3875000
NODE_300524_length_228_cov_94.255814	87	167	38	20	80	0.2500000
NODE_300524_length_228_cov_94.255814	87	167	27	13	80	0.1625000
NODE_300524_length_228_cov_94.255814	87	167	28	5	80	0.0625000
NODE_300524_length_228_cov_94.255814	87	167	30	11	80	0.1375000
NODE_300524_length_228_cov_94.255814	87	167	36	31	80	0.3875000
NODE_300524_length_228_cov_94.255814	87	167	38	20	80	0.2500000
NODE_300524_length_228_cov_94.255814	87	167	27	13	80	0.1625000
NODE_300524_length_228_cov_94.255814	87	167	28	5	80	0.0625000
NODE_300524_length_228_cov_94.255814	87	167	30	11	80	0.1375000
NODE_300524_length_228_cov_94.255814	87	167	36	31	80	0.3875000
NODE_300524_length_228_cov_94.255814	87	167	38	20	80	0.2500000
NODE_300524_length_228_cov_94.255814	87	167	27	13	80	0.1625000
NODE_300524_length_228_cov_94.255814	87	167	28	5	80	0.0625000
NODE_300524_length_228_cov_94.255814	87	167	30	11	80	0.1375000
NODE_300524_length_228_cov_94.255814	87	167	36	31	80	0.3875000
NODE_300524_length_228_cov_94.255814	87	167	38	20	80	0.2500000
NODE_300547_length_228_cov_0.395349	27	107	0	80	80	1.0000000
NODE_300547_length_228_cov_0.395349	70	150	0	80	80	1.0000000
NODE_300556_length_227_cov_37.429688	40	111	0	71	71	1.0000000
NODE_300556_length_227_cov_37.429688	49	112	0	63	63	1.0000000
NODE_300556_length_227_cov_37.429688	93	172	0	79	79	1.0000000
NODE_300556_length_227_cov_37.429688	168	227	0	59	59	1.0000000
NODE_300556_length_227_cov_37.429688	168	227	0	59	59	1.0000000
NODE_300595_length_226_cov_547.629921	82	162	649	1	80	0.0125000
NODE_300595_length_226_cov_547.629921	82	162	675	1	80	0.0125000
NODE_300595_length_226_cov_547.629921	82	162	689	1	80	0.0125000
NODE_300595_length_226_cov_547.629921	82	162	697	1	80	0.0125000
NODE_300595_length_226_cov_547.629921	82	162	705	1	80	0.0125000
NODE_300595_length_226_cov_547.629921	82	162	707	1	80	0.0125000
NODE_300595_length_226_cov_547.629921	82	162	717	1	80	0.0125000
NODE_300595_length_226_cov_547.629921	82	162	720	1	80	0.0125000
NODE_300595_length_226_cov_547.629921	82	162	722	1	80	0.0125000
NODE_300595_length_226_cov_547.629921	82	162	730	1	80	0.0125000
NODE_300595_length_226_cov_547.629921	82	162	732	1	80	0.0125000
NODE_300595_length_226_cov_547.629921	82	162	748	2	80	0.0250000
NODE_300595_length_226_cov_547.629921	82	162	749	1	80	0.0125000
NODE_300595_length_226_cov_547.629921	82	162	751	1	80	0.0125000
NODE_300595_length_226_cov_547.629921	82	162	753	1	80	0.0125000
NODE_300595_length_226_cov_547.629921	82	162	755	1	80	0.0125000
NODE_300595_length_226_cov_547.629921	82	162	756	3	80	0.0375000
NODE_300595_length_226_cov_547.629921	82	162	759	1	80	0.0125000
NODE_300595_length_226_cov_547.629921	82	162	761	2	80	0.0250000
NODE_300595_length_226_cov_547.629921	82	162	765	1	80	0.0125000
NODE_300595_length_226_cov_547.629921	82	162	768	1	80	0.0125000
NODE_300595_length_226_cov_547.629921	82	162	773	1	80	0.0125000
NODE_300595_length_226_cov_547.629921	82	162	777	1	80	0.0125000
NODE_300595_length_226_cov_547.629921	82	162	787	1	80	0.0125000
NODE_300595_length_226_cov_547.629921	82	162	788	1	80	0.0125000
NODE_300595_length_226_cov_547.629921	82	162	796	1	80	0.0125000
NODE_300595_length_226_cov_547.629921	82	162	812	1	80	0.0125000
NODE_300595_length_226_cov_547.629921	82	162	828	1	80	0.0125000
NODE_300595_length_226_cov_547.629921	82	162	830	1	80	0.0125000
NODE_300595_length_226_cov_547.629921	82	162	831	1	80	0.0125000
NODE_300595_length_226_cov_547.629921	82	162	838	1	80	0.0125000
NODE_300595_length_226_cov_547.629921	82	162	841	1	80	0.0125000
NODE_300595_length_226_cov_547.629921	82	162	844	2	80	0.0250000
NODE_300595_length_226_cov_547.629921	82	162	845	3	80	0.0375000
NODE_300595_length_226_cov_547.629921	82	162	847	1	80	0.0125000
NODE_300595_length_226_cov_547.629921	82	162	849	1	80	0.0125000
NODE_300595_length_226_cov_547.629921	82	162	856	1	80	0.0125000
NODE_300595_length_226_cov_547.629921	82	162	857	1	80	0.0125000
NODE_300595_length_226_cov_547.629921	82	162	861	1	80	0.0125000
NODE_300595_length_226_cov_547.629921	82	162	866	2	80	0.0250000
NODE_300595_length_226_cov_547.629921	82	162	870	2	80	0.0250000
NODE_300595_length_226_cov_547.629921	82	162	874	1	80	0.0125000
NODE_300595_length_226_cov_547.629921	82	162	875	1	80	0.0125000
NODE_300595_length_226_cov_547.629921	82	162	881	1	80	0.0125000
NODE_300595_length_226_cov_547.629921	82	162	888	1	80	0.0125000
NODE_300595_length_226_cov_547.629921	82	162	890	1	80	0.0125000
NODE_300595_length_226_cov_547.629921	82	162	892	2	80	0.0250000
NODE_300595_length_226_cov_547.629921	82	162	894	1	80	0.0125000
NODE_300595_length_226_cov_547.629921	82	162	898	5	80	0.0625000
NODE_300595_length_226_cov_547.629921	82	162	901	1	80	0.0125000
NODE_300595_length_226_cov_547.629921	82	162	903	2	80	0.0250000
NODE_300595_length_226_cov_547.629921	82	162	907	1	80	0.0125000
NODE_300595_length_226_cov_547.629921	82	162	908	2	80	0.0250000
NODE_300595_length_226_cov_547.629921	82	162	910	1	80	0.0125000
NODE_300595_length_226_cov_547.629921	82	162	916	1	80	0.0125000
NODE_300595_length_226_cov_547.629921	82	162	918	1	80	0.0125000
NODE_300595_length_226_cov_547.629921	82	162	920	2	80	0.0250000
NODE_300595_length_226_cov_547.629921	82	162	921	1	80	0.0125000
NODE_300595_length_226_cov_547.629921	82	162	922	1	80	0.0125000
NODE_300595_length_226_cov_547.629921	82	162	924	2	80	0.0250000
NODE_300595_length_226_cov_547.629921	82	162	928	2	80	0.0250000
NODE_300617_length_225_cov_41.269841	81	165	6	8	84	0.0952381
NODE_300617_length_225_cov_41.269841	81	165	8	2	84	0.0238095
NODE_300617_length_225_cov_41.269841	81	165	10	1	84	0.0119048
NODE_300617_length_225_cov_41.269841	81	165	12	5	84	0.0595238
NODE_300617_length_225_cov_41.269841	81	165	16	3	84	0.0357143
NODE_300617_length_225_cov_41.269841	81	165	19	2	84	0.0238095
NODE_300617_length_225_cov_41.269841	81	165	23	2	84	0.0238095
NODE_300617_length_225_cov_41.269841	81	165	25	1	84	0.0119048
NODE_300617_length_225_cov_41.269841	81	165	27	1	84	0.0119048
NODE_300617_length_225_cov_41.269841	81	165	29	3	84	0.0357143
NODE_300617_length_225_cov_41.269841	81	165	33	1	84	0.0119048
NODE_300617_length_225_cov_41.269841	81	165	34	1	84	0.0119048
NODE_300617_length_225_cov_41.269841	81	165	38	1	84	0.0119048
NODE_300617_length_225_cov_41.269841	81	165	40	6	84	0.0714286
NODE_300617_length_225_cov_41.269841	81	165	42	45	84	0.5357143
NODE_300617_length_225_cov_41.269841	81	165	44	2	84	0.0238095
NODE_300617_length_225_cov_41.269841	134	218	0	14	84	0.1666667
NODE_300617_length_225_cov_41.269841	134	218	2	19	84	0.2261905
NODE_300617_length_225_cov_41.269841	134	218	6	28	84	0.3333333
NODE_300617_length_225_cov_41.269841	134	218	8	2	84	0.0238095
NODE_300617_length_225_cov_41.269841	134	218	10	1	84	0.0119048
NODE_300617_length_225_cov_41.269841	134	218	12	5	84	0.0595238
NODE_300617_length_225_cov_41.269841	134	218	16	3	84	0.0357143
NODE_300617_length_225_cov_41.269841	134	218	19	2	84	0.0238095
NODE_300617_length_225_cov_41.269841	134	218	23	2	84	0.0238095
NODE_300617_length_225_cov_41.269841	134	218	25	1	84	0.0119048
NODE_300617_length_225_cov_41.269841	134	218	27	1	84	0.0119048
NODE_300617_length_225_cov_41.269841	134	218	29	3	84	0.0357143
NODE_300617_length_225_cov_41.269841	134	218	33	1	84	0.0119048
NODE_300617_length_225_cov_41.269841	134	218	34	1	84	0.0119048
NODE_300617_length_225_cov_41.269841	134	218	38	1	84	0.0119048
NODE_300661_length_224_cov_209.528000	12	84	12	4	72	0.0555556
NODE_300661_length_224_cov_209.528000	12	84	15	14	72	0.1944444
NODE_300661_length_224_cov_209.528000	12	84	17	7	72	0.0972222
NODE_300661_length_224_cov_209.528000	12	84	23	5	72	0.0694444
NODE_300661_length_224_cov_209.528000	12	84	24	1	72	0.0138889
NODE_300661_length_224_cov_209.528000	12	84	26	2	72	0.0277778
NODE_300661_length_224_cov_209.528000	12	84	27	2	72	0.0277778
NODE_300661_length_224_cov_209.528000	12	84	28	3	72	0.0416667
NODE_300661_length_224_cov_209.528000	12	84	30	4	72	0.0555556
NODE_300661_length_224_cov_209.528000	12	84	31	16	72	0.2222222
NODE_300661_length_224_cov_209.528000	12	84	32	2	72	0.0277778
NODE_300661_length_224_cov_209.528000	12	84	38	12	72	0.1666667
NODE_300663_length_224_cov_146.568000	13	72	4	2	59	0.0338983
NODE_300663_length_224_cov_146.568000	13	72	5	6	59	0.1016949
NODE_300663_length_224_cov_146.568000	13	72	7	1	59	0.0169492
NODE_300663_length_224_cov_146.568000	13	72	9	1	59	0.0169492
NODE_300663_length_224_cov_146.568000	13	72	11	3	59	0.0508475
NODE_300663_length_224_cov_146.568000	13	72	14	1	59	0.0169492
NODE_300663_length_224_cov_146.568000	13	72	16	1	59	0.0169492
NODE_300663_length_224_cov_146.568000	13	72	18	1	59	0.0169492
NODE_300663_length_224_cov_146.568000	13	72	19	5	59	0.0847458
NODE_300663_length_224_cov_146.568000	13	72	21	1	59	0.0169492
NODE_300663_length_224_cov_146.568000	13	72	23	2	59	0.0338983
NODE_300663_length_224_cov_146.568000	13	72	25	7	59	0.1186441
NODE_300663_length_224_cov_146.568000	13	72	27	9	59	0.1525424
NODE_300663_length_224_cov_146.568000	13	72	29	1	59	0.0169492
NODE_300663_length_224_cov_146.568000	13	72	30	2	59	0.0338983
NODE_300663_length_224_cov_146.568000	13	72	34	2	59	0.0338983
NODE_300663_length_224_cov_146.568000	13	72	36	1	59	0.0169492
NODE_300663_length_224_cov_146.568000	13	72	38	7	59	0.1186441
NODE_300663_length_224_cov_146.568000	13	72	42	6	59	0.1016949
NODE_300663_length_224_cov_146.568000	46	72	27	7	26	0.2692308
NODE_300663_length_224_cov_146.568000	46	72	29	1	26	0.0384615
NODE_300663_length_224_cov_146.568000	46	72	30	2	26	0.0769231
NODE_300663_length_224_cov_146.568000	46	72	34	2	26	0.0769231
NODE_300663_length_224_cov_146.568000	46	72	36	1	26	0.0384615
NODE_300663_length_224_cov_146.568000	46	72	38	7	26	0.2692308
NODE_300663_length_224_cov_146.568000	46	72	42	6	26	0.2307692
NODE_300663_length_224_cov_146.568000	68	120	42	9	52	0.1730769
NODE_300663_length_224_cov_146.568000	68	120	44	1	52	0.0192308
NODE_300663_length_224_cov_146.568000	68	120	48	3	52	0.0576923
NODE_300663_length_224_cov_146.568000	68	120	50	1	52	0.0192308
NODE_300663_length_224_cov_146.568000	68	120	52	1	52	0.0192308
NODE_300663_length_224_cov_146.568000	68	120	54	3	52	0.0576923
NODE_300663_length_224_cov_146.568000	68	120	56	1	52	0.0192308
NODE_300663_length_224_cov_146.568000	68	120	58	4	52	0.0769231
NODE_300663_length_224_cov_146.568000	68	120	60	4	52	0.0769231
NODE_300663_length_224_cov_146.568000	68	120	62	3	52	0.0576923
NODE_300663_length_224_cov_146.568000	68	120	66	2	52	0.0384615
NODE_300663_length_224_cov_146.568000	68	120	70	15	52	0.2884615
NODE_300663_length_224_cov_146.568000	68	120	72	2	52	0.0384615
NODE_300663_length_224_cov_146.568000	68	120	76	3	52	0.0576923
NODE_300665_length_224_cov_59.088000	98	178	12	6	80	0.0750000
NODE_300665_length_224_cov_59.088000	98	178	19	1	80	0.0125000
NODE_300665_length_224_cov_59.088000	98	178	20	14	80	0.1750000
NODE_300665_length_224_cov_59.088000	98	178	22	25	80	0.3125000
NODE_300665_length_224_cov_59.088000	98	178	24	34	80	0.4250000
NODE_300665_length_224_cov_59.088000	98	178	12	6	80	0.0750000
NODE_300665_length_224_cov_59.088000	98	178	19	1	80	0.0125000
NODE_300665_length_224_cov_59.088000	98	178	20	14	80	0.1750000
NODE_300665_length_224_cov_59.088000	98	178	22	25	80	0.3125000
NODE_300665_length_224_cov_59.088000	98	178	24	34	80	0.4250000
NODE_300665_length_224_cov_59.088000	98	178	12	6	80	0.0750000
NODE_300665_length_224_cov_59.088000	98	178	19	1	80	0.0125000
NODE_300665_length_224_cov_59.088000	98	178	20	14	80	0.1750000
NODE_300665_length_224_cov_59.088000	98	178	22	25	80	0.3125000
NODE_300665_length_224_cov_59.088000	98	178	24	34	80	0.4250000
NODE_300665_length_224_cov_59.088000	151	217	4	32	66	0.4848485
NODE_300665_length_224_cov_59.088000	151	217	8	5	66	0.0757576
NODE_300665_length_224_cov_59.088000	151	217	11	1	66	0.0151515
NODE_300665_length_224_cov_59.088000	151	217	12	7	66	0.1060606
NODE_300665_length_224_cov_59.088000	151	217	19	1	66	0.0151515
NODE_300665_length_224_cov_59.088000	151	217	20	10	66	0.1515152
NODE_300665_length_224_cov_59.088000	151	217	22	10	66	0.1515152
NODE_300665_length_224_cov_59.088000	151	224	4	39	73	0.5342466
NODE_300665_length_224_cov_59.088000	151	224	8	5	73	0.0684932
NODE_300665_length_224_cov_59.088000	151	224	11	1	73	0.0136986
NODE_300665_length_224_cov_59.088000	151	224	12	7	73	0.0958904
NODE_300665_length_224_cov_59.088000	151	224	19	1	73	0.0136986
NODE_300665_length_224_cov_59.088000	151	224	20	10	73	0.1369863
NODE_300665_length_224_cov_59.088000	151	224	22	10	73	0.1369863
NODE_300667_length_224_cov_43.640000	98	157	0	59	59	1.0000000
NODE_300667_length_224_cov_43.640000	98	157	0	59	59	1.0000000
NODE_300667_length_224_cov_43.640000	106	157	0	51	51	1.0000000
NODE_300669_length_224_cov_36.224000	100	171	22	5	71	0.0704225
NODE_300669_length_224_cov_36.224000	100	171	23	66	71	0.9295775
NODE_300669_length_224_cov_36.224000	151	224	0	5	73	0.0684932
NODE_300669_length_224_cov_36.224000	151	224	3	1	73	0.0136986
NODE_300669_length_224_cov_36.224000	151	224	5	1	73	0.0136986
NODE_300669_length_224_cov_36.224000	151	224	7	3	73	0.0410959
NODE_300669_length_224_cov_36.224000	151	224	11	7	73	0.0958904
NODE_300669_length_224_cov_36.224000	151	224	13	3	73	0.0410959
NODE_300669_length_224_cov_36.224000	151	224	18	2	73	0.0273973
NODE_300669_length_224_cov_36.224000	151	224	22	2	73	0.0273973
NODE_300669_length_224_cov_36.224000	151	224	23	49	73	0.6712329
NODE_300696_length_223_cov_35.814516	0	54	0	26	54	0.4814815
NODE_300696_length_223_cov_35.814516	0	54	2	9	54	0.1666667
NODE_300696_length_223_cov_35.814516	0	54	4	19	54	0.3518519
NODE_300696_length_223_cov_35.814516	30	107	2	5	77	0.0649351
NODE_300696_length_223_cov_35.814516	30	107	4	65	77	0.8441558
NODE_300696_length_223_cov_35.814516	30	107	6	7	77	0.0909091
NODE_300768_length_221_cov_71.319672	14	94	40	4	80	0.0500000
NODE_300768_length_221_cov_71.319672	14	94	44	1	80	0.0125000
NODE_300768_length_221_cov_71.319672	14	94	46	1	80	0.0125000
NODE_300768_length_221_cov_71.319672	14	94	48	4	80	0.0500000
NODE_300768_length_221_cov_71.319672	14	94	52	3	80	0.0375000
NODE_300768_length_221_cov_71.319672	14	94	57	2	80	0.0250000
NODE_300768_length_221_cov_71.319672	14	94	60	1	80	0.0125000
NODE_300768_length_221_cov_71.319672	14	94	66	2	80	0.0250000
NODE_300768_length_221_cov_71.319672	14	94	67	2	80	0.0250000
NODE_300768_length_221_cov_71.319672	14	94	70	5	80	0.0625000
NODE_300768_length_221_cov_71.319672	14	94	88	3	80	0.0375000
NODE_300768_length_221_cov_71.319672	14	94	89	1	80	0.0125000
NODE_300768_length_221_cov_71.319672	14	94	93	2	80	0.0250000
NODE_300768_length_221_cov_71.319672	14	94	97	2	80	0.0250000
NODE_300768_length_221_cov_71.319672	14	94	99	1	80	0.0125000
NODE_300768_length_221_cov_71.319672	14	94	101	3	80	0.0375000
NODE_300768_length_221_cov_71.319672	14	94	103	4	80	0.0500000
NODE_300768_length_221_cov_71.319672	14	94	105	6	80	0.0750000
NODE_300768_length_221_cov_71.319672	14	94	106	1	80	0.0125000
NODE_300768_length_221_cov_71.319672	14	94	109	2	80	0.0250000
NODE_300768_length_221_cov_71.319672	14	94	110	1	80	0.0125000
NODE_300768_length_221_cov_71.319672	14	94	111	1	80	0.0125000
NODE_300768_length_221_cov_71.319672	14	94	117	1	80	0.0125000
NODE_300768_length_221_cov_71.319672	14	94	120	27	80	0.3375000
NODE_300800_length_220_cov_42.206612	3	74	23	2	71	0.0281690
NODE_300800_length_220_cov_42.206612	3	74	24	1	71	0.0140845
NODE_300800_length_220_cov_42.206612	3	74	26	3	71	0.0422535
NODE_300800_length_220_cov_42.206612	3	74	30	6	71	0.0845070
NODE_300800_length_220_cov_42.206612	3	74	32	1	71	0.0140845
NODE_300800_length_220_cov_42.206612	3	74	43	1	71	0.0140845
NODE_300800_length_220_cov_42.206612	3	74	44	8	71	0.1126761
NODE_300800_length_220_cov_42.206612	3	74	46	1	71	0.0140845
NODE_300800_length_220_cov_42.206612	3	74	47	1	71	0.0140845
NODE_300800_length_220_cov_42.206612	3	74	53	1	71	0.0140845
NODE_300800_length_220_cov_42.206612	3	74	65	1	71	0.0140845
NODE_300800_length_220_cov_42.206612	3	74	71	3	71	0.0422535
NODE_300800_length_220_cov_42.206612	3	74	76	1	71	0.0140845
NODE_300800_length_220_cov_42.206612	3	74	79	4	71	0.0563380
NODE_300800_length_220_cov_42.206612	3	74	85	1	71	0.0140845
NODE_300800_length_220_cov_42.206612	3	74	88	6	71	0.0845070
NODE_300800_length_220_cov_42.206612	3	74	90	3	71	0.0422535
NODE_300800_length_220_cov_42.206612	3	74	92	7	71	0.0985916
NODE_300800_length_220_cov_42.206612	3	74	94	5	71	0.0704225
NODE_300800_length_220_cov_42.206612	3	74	98	15	71	0.2112676
NODE_300800_length_220_cov_42.206612	8	74	26	1	66	0.0151515
NODE_300800_length_220_cov_42.206612	8	74	30	6	66	0.0909091
NODE_300800_length_220_cov_42.206612	8	74	32	1	66	0.0151515
NODE_300800_length_220_cov_42.206612	8	74	43	1	66	0.0151515
NODE_300800_length_220_cov_42.206612	8	74	44	8	66	0.1212121
NODE_300800_length_220_cov_42.206612	8	74	46	1	66	0.0151515
NODE_300800_length_220_cov_42.206612	8	74	47	1	66	0.0151515
NODE_300800_length_220_cov_42.206612	8	74	53	1	66	0.0151515
NODE_300800_length_220_cov_42.206612	8	74	65	1	66	0.0151515
NODE_300800_length_220_cov_42.206612	8	74	71	3	66	0.0454545
NODE_300800_length_220_cov_42.206612	8	74	76	1	66	0.0151515
NODE_300800_length_220_cov_42.206612	8	74	79	4	66	0.0606061
NODE_300800_length_220_cov_42.206612	8	74	85	1	66	0.0151515
NODE_300800_length_220_cov_42.206612	8	74	88	6	66	0.0909091
NODE_300800_length_220_cov_42.206612	8	74	90	3	66	0.0454545
NODE_300800_length_220_cov_42.206612	8	74	92	7	66	0.1060606
NODE_300800_length_220_cov_42.206612	8	74	94	5	66	0.0757576
NODE_300800_length_220_cov_42.206612	8	74	98	15	66	0.2272727
NODE_300800_length_220_cov_42.206612	47	98	92	7	51	0.1372549
NODE_300800_length_220_cov_42.206612	47	98	94	5	51	0.0980392
NODE_300800_length_220_cov_42.206612	47	98	98	27	51	0.5294118
NODE_300800_length_220_cov_42.206612	47	98	104	12	51	0.2352941
NODE_300800_length_220_cov_42.206612	47	98	92	7	51	0.1372549
NODE_300800_length_220_cov_42.206612	47	98	94	5	51	0.0980392
NODE_300800_length_220_cov_42.206612	47	98	98	27	51	0.5294118
NODE_300800_length_220_cov_42.206612	47	98	104	12	51	0.2352941
NODE_300800_length_220_cov_42.206612	47	98	92	7	51	0.1372549
NODE_300800_length_220_cov_42.206612	47	98	94	5	51	0.0980392
NODE_300800_length_220_cov_42.206612	47	98	98	27	51	0.5294118
NODE_300800_length_220_cov_42.206612	47	98	104	12	51	0.2352941
NODE_300874_length_218_cov_244.773109	128	203	11	7	75	0.0933333
NODE_300874_length_218_cov_244.773109	128	203	13	9	75	0.1200000
NODE_300874_length_218_cov_244.773109	128	203	15	3	75	0.0400000
NODE_300874_length_218_cov_244.773109	128	203	17	1	75	0.0133333
NODE_300874_length_218_cov_244.773109	128	203	19	2	75	0.0266667
NODE_300874_length_218_cov_244.773109	128	203	26	1	75	0.0133333
NODE_300874_length_218_cov_244.773109	128	203	27	14	75	0.1866667
NODE_300874_length_218_cov_244.773109	128	203	29	1	75	0.0133333
NODE_300874_length_218_cov_244.773109	128	203	33	7	75	0.0933333
NODE_300874_length_218_cov_244.773109	128	203	35	1	75	0.0133333
NODE_300874_length_218_cov_244.773109	128	203	36	2	75	0.0266667
NODE_300874_length_218_cov_244.773109	128	203	37	2	75	0.0266667
NODE_300874_length_218_cov_244.773109	128	203	38	1	75	0.0133333
NODE_300874_length_218_cov_244.773109	128	203	40	1	75	0.0133333
NODE_300874_length_218_cov_244.773109	128	203	41	1	75	0.0133333
NODE_300874_length_218_cov_244.773109	128	203	43	5	75	0.0666667
NODE_300874_length_218_cov_244.773109	128	203	45	7	75	0.0933333
NODE_300874_length_218_cov_244.773109	128	203	47	10	75	0.1333333
NODE_300874_length_218_cov_244.773109	176	218	3	1	42	0.0238095
NODE_300874_length_218_cov_244.773109	176	218	5	1	42	0.0238095
NODE_300874_length_218_cov_244.773109	176	218	7	2	42	0.0476190
NODE_300874_length_218_cov_244.773109	176	218	9	2	42	0.0476190
NODE_300874_length_218_cov_244.773109	176	218	11	16	42	0.3809524
NODE_300874_length_218_cov_244.773109	176	218	13	9	42	0.2142857
NODE_300874_length_218_cov_244.773109	176	218	15	3	42	0.0714286
NODE_300874_length_218_cov_244.773109	176	218	17	1	42	0.0238095
NODE_300874_length_218_cov_244.773109	176	218	19	2	42	0.0476190
NODE_300874_length_218_cov_244.773109	176	218	26	1	42	0.0238095
NODE_300874_length_218_cov_244.773109	176	218	27	4	42	0.0952381
NODE_300915_length_217_cov_2.144068	14	49	0	35	35	1.0000000
NODE_300915_length_217_cov_2.144068	132	167	0	35	35	1.0000000
NODE_300924_length_216_cov_215.410256	0	63	0	11	63	0.1746032
NODE_300924_length_216_cov_215.410256	0	63	3	7	63	0.1111111
NODE_300924_length_216_cov_215.410256	0	63	5	14	63	0.2222222
NODE_300924_length_216_cov_215.410256	0	63	7	15	63	0.2380952
NODE_300924_length_216_cov_215.410256	0	63	9	16	63	0.2539683
NODE_300924_length_216_cov_215.410256	36	102	7	11	66	0.1666667
NODE_300924_length_216_cov_215.410256	36	102	9	20	66	0.3030303
NODE_300924_length_216_cov_215.410256	36	102	10	1	66	0.0151515
NODE_300924_length_216_cov_215.410256	36	102	12	12	66	0.1818182
NODE_300924_length_216_cov_215.410256	36	102	14	9	66	0.1363636
NODE_300924_length_216_cov_215.410256	36	102	16	13	66	0.1969697
NODE_300925_length_216_cov_51.940171	164	216	0	52	52	1.0000000
NODE_300953_length_215_cov_14.784483	0	50	0	50	50	1.0000000
NODE_300953_length_215_cov_14.784483	23	103	0	80	80	1.0000000
NODE_300984_length_214_cov_144.165217	0	62	0	37	62	0.5967742
NODE_300984_length_214_cov_144.165217	0	62	13	15	62	0.2419355
NODE_300984_length_214_cov_144.165217	0	62	15	3	62	0.0483871
NODE_300984_length_214_cov_144.165217	0	62	27	1	62	0.0161290
NODE_300984_length_214_cov_144.165217	0	62	28	1	62	0.0161290
NODE_300984_length_214_cov_144.165217	0	62	32	5	62	0.0806452
NODE_300984_length_214_cov_144.165217	0	62	0	37	62	0.5967742
NODE_300984_length_214_cov_144.165217	0	62	13	15	62	0.2419355
NODE_300984_length_214_cov_144.165217	0	62	15	3	62	0.0483871
NODE_300984_length_214_cov_144.165217	0	62	27	1	62	0.0161290
NODE_300984_length_214_cov_144.165217	0	62	28	1	62	0.0161290
NODE_300984_length_214_cov_144.165217	0	62	32	5	62	0.0806452
NODE_300984_length_214_cov_144.165217	35	115	0	2	80	0.0250000
NODE_300984_length_214_cov_144.165217	35	115	13	15	80	0.1875000
NODE_300984_length_214_cov_144.165217	35	115	15	3	80	0.0375000
NODE_300984_length_214_cov_144.165217	35	115	22	3	80	0.0375000
NODE_300984_length_214_cov_144.165217	35	115	27	1	80	0.0125000
NODE_300984_length_214_cov_144.165217	35	115	28	1	80	0.0125000
NODE_300984_length_214_cov_144.165217	35	115	32	21	80	0.2625000
NODE_300984_length_214_cov_144.165217	35	115	33	16	80	0.2000000
NODE_300984_length_214_cov_144.165217	35	115	34	5	80	0.0625000
NODE_300984_length_214_cov_144.165217	35	115	35	13	80	0.1625000
NODE_300984_length_214_cov_144.165217	35	115	0	2	80	0.0250000
NODE_300984_length_214_cov_144.165217	35	115	13	15	80	0.1875000
NODE_300984_length_214_cov_144.165217	35	115	15	3	80	0.0375000
NODE_300984_length_214_cov_144.165217	35	115	22	3	80	0.0375000
NODE_300984_length_214_cov_144.165217	35	115	27	1	80	0.0125000
NODE_300984_length_214_cov_144.165217	35	115	28	1	80	0.0125000
NODE_300984_length_214_cov_144.165217	35	115	32	21	80	0.2625000
NODE_300984_length_214_cov_144.165217	35	115	33	16	80	0.2000000
NODE_300984_length_214_cov_144.165217	35	115	34	5	80	0.0625000
NODE_300984_length_214_cov_144.165217	35	115	35	13	80	0.1625000
NODE_300984_length_214_cov_144.165217	35	115	0	2	80	0.0250000
NODE_300984_length_214_cov_144.165217	35	115	13	15	80	0.1875000
NODE_300984_length_214_cov_144.165217	35	115	15	3	80	0.0375000
NODE_300984_length_214_cov_144.165217	35	115	22	3	80	0.0375000
NODE_300984_length_214_cov_144.165217	35	115	27	1	80	0.0125000
NODE_300984_length_214_cov_144.165217	35	115	28	1	80	0.0125000
NODE_300984_length_214_cov_144.165217	35	115	32	21	80	0.2625000
NODE_300984_length_214_cov_144.165217	35	115	33	16	80	0.2000000
NODE_300984_length_214_cov_144.165217	35	115	34	5	80	0.0625000
NODE_300984_length_214_cov_144.165217	35	115	35	13	80	0.1625000
NODE_300984_length_214_cov_144.165217	111	191	0	2	80	0.0250000
NODE_300984_length_214_cov_144.165217	111	191	2	3	80	0.0375000
NODE_300984_length_214_cov_144.165217	111	191	14	26	80	0.3250000
NODE_300984_length_214_cov_144.165217	111	191	18	12	80	0.1500000
NODE_300984_length_214_cov_144.165217	111	191	20	13	80	0.1625000
NODE_300984_length_214_cov_144.165217	111	191	21	4	80	0.0500000
NODE_300984_length_214_cov_144.165217	111	191	22	19	80	0.2375000
NODE_300984_length_214_cov_144.165217	111	191	35	1	80	0.0125000
NODE_300984_length_214_cov_144.165217	111	191	0	2	80	0.0250000
NODE_300984_length_214_cov_144.165217	111	191	2	3	80	0.0375000
NODE_300984_length_214_cov_144.165217	111	191	14	26	80	0.3250000
NODE_300984_length_214_cov_144.165217	111	191	18	12	80	0.1500000
NODE_300984_length_214_cov_144.165217	111	191	20	13	80	0.1625000
NODE_300984_length_214_cov_144.165217	111	191	21	4	80	0.0500000
NODE_300984_length_214_cov_144.165217	111	191	22	19	80	0.2375000
NODE_300984_length_214_cov_144.165217	111	191	35	1	80	0.0125000
NODE_300984_length_214_cov_144.165217	111	191	0	2	80	0.0250000
NODE_300984_length_214_cov_144.165217	111	191	2	3	80	0.0375000
NODE_300984_length_214_cov_144.165217	111	191	14	26	80	0.3250000
NODE_300984_length_214_cov_144.165217	111	191	18	12	80	0.1500000
NODE_300984_length_214_cov_144.165217	111	191	20	13	80	0.1625000
NODE_300984_length_214_cov_144.165217	111	191	21	4	80	0.0500000
NODE_300984_length_214_cov_144.165217	111	191	22	19	80	0.2375000
NODE_300984_length_214_cov_144.165217	111	191	35	1	80	0.0125000
NODE_300984_length_214_cov_144.165217	164	214	0	25	50	0.5000000
NODE_300984_length_214_cov_144.165217	164	214	2	3	50	0.0600000
NODE_300984_length_214_cov_144.165217	164	214	14	22	50	0.4400000
NODE_300984_length_214_cov_144.165217	164	214	0	25	50	0.5000000
NODE_300984_length_214_cov_144.165217	164	214	2	3	50	0.0600000
NODE_300984_length_214_cov_144.165217	164	214	14	22	50	0.4400000
NODE_300984_length_214_cov_144.165217	164	214	0	25	50	0.5000000
NODE_300984_length_214_cov_144.165217	164	214	2	3	50	0.0600000
NODE_300984_length_214_cov_144.165217	164	214	14	22	50	0.4400000
NODE_301068_length_211_cov_39.571429	4	84	0	80	80	1.0000000
NODE_301169_length_208_cov_45.238532	3	59	0	35	56	0.6250000
NODE_301169_length_208_cov_45.238532	3	59	6	21	56	0.3750000
NODE_301169_length_208_cov_45.238532	35	112	0	3	77	0.0389610
NODE_301169_length_208_cov_45.238532	35	112	6	74	77	0.9610389
NODE_301170_length_208_cov_35.229358	76	156	0	80	80	1.0000000
NODE_301179_length_207_cov_341.324074	33	113	0	80	80	1.0000000
NODE_301179_length_207_cov_341.324074	86	166	0	80	80	1.0000000
NODE_301248_length_205_cov_64.179245	6	77	0	25	71	0.3521127
NODE_301248_length_205_cov_64.179245	6	77	4	11	71	0.1549296
NODE_301248_length_205_cov_64.179245	6	77	6	8	71	0.1126761
NODE_301248_length_205_cov_64.179245	6	77	8	5	71	0.0704225
NODE_301248_length_205_cov_64.179245	6	77	10	7	71	0.0985916
NODE_301248_length_205_cov_64.179245	6	77	12	1	71	0.0140845
NODE_301248_length_205_cov_64.179245	6	77	14	1	71	0.0140845
NODE_301248_length_205_cov_64.179245	6	77	20	4	71	0.0563380
NODE_301248_length_205_cov_64.179245	6	77	22	9	71	0.1267606
NODE_301248_length_205_cov_64.179245	11	77	0	20	66	0.3030303
NODE_301248_length_205_cov_64.179245	11	77	4	11	66	0.1666667
NODE_301248_length_205_cov_64.179245	11	77	6	8	66	0.1212121
NODE_301248_length_205_cov_64.179245	11	77	8	5	66	0.0757576
NODE_301248_length_205_cov_64.179245	11	77	10	7	66	0.1060606
NODE_301248_length_205_cov_64.179245	11	77	12	1	66	0.0151515
NODE_301248_length_205_cov_64.179245	11	77	14	1	66	0.0151515
NODE_301248_length_205_cov_64.179245	11	77	20	4	66	0.0606061
NODE_301248_length_205_cov_64.179245	11	77	22	9	66	0.1363636
NODE_301248_length_205_cov_64.179245	50	98	8	5	48	0.1041667
NODE_301248_length_205_cov_64.179245	50	98	10	7	48	0.1458333
NODE_301248_length_205_cov_64.179245	50	98	12	1	48	0.0208333
NODE_301248_length_205_cov_64.179245	50	98	14	1	48	0.0208333
NODE_301248_length_205_cov_64.179245	50	98	20	4	48	0.0833333
NODE_301248_length_205_cov_64.179245	50	98	22	12	48	0.2500000
NODE_301248_length_205_cov_64.179245	50	98	24	5	48	0.1041667
NODE_301248_length_205_cov_64.179245	50	98	26	13	48	0.2708333
NODE_301248_length_205_cov_64.179245	50	98	8	5	48	0.1041667
NODE_301248_length_205_cov_64.179245	50	98	10	7	48	0.1458333
NODE_301248_length_205_cov_64.179245	50	98	12	1	48	0.0208333
NODE_301248_length_205_cov_64.179245	50	98	14	1	48	0.0208333
NODE_301248_length_205_cov_64.179245	50	98	20	4	48	0.0833333
NODE_301248_length_205_cov_64.179245	50	98	22	12	48	0.2500000
NODE_301248_length_205_cov_64.179245	50	98	24	5	48	0.1041667
NODE_301248_length_205_cov_64.179245	50	98	26	13	48	0.2708333
NODE_301248_length_205_cov_64.179245	50	98	8	5	48	0.1041667
NODE_301248_length_205_cov_64.179245	50	98	10	7	48	0.1458333
NODE_301248_length_205_cov_64.179245	50	98	12	1	48	0.0208333
NODE_301248_length_205_cov_64.179245	50	98	14	1	48	0.0208333
NODE_301248_length_205_cov_64.179245	50	98	20	4	48	0.0833333
NODE_301248_length_205_cov_64.179245	50	98	22	12	48	0.2500000
NODE_301248_length_205_cov_64.179245	50	98	24	5	48	0.1041667
NODE_301248_length_205_cov_64.179245	50	98	26	13	48	0.2708333
NODE_301281_length_204_cov_183.390476	119	199	2	8	80	0.1000000
NODE_301281_length_204_cov_183.390476	119	199	11	3	80	0.0375000
NODE_301281_length_204_cov_183.390476	119	199	18	12	80	0.1500000
NODE_301281_length_204_cov_183.390476	119	199	27	4	80	0.0500000
NODE_301281_length_204_cov_183.390476	119	199	30	1	80	0.0125000
NODE_301281_length_204_cov_183.390476	119	199	31	8	80	0.1000000
NODE_301281_length_204_cov_183.390476	119	199	32	4	80	0.0500000
NODE_301281_length_204_cov_183.390476	119	199	34	2	80	0.0250000
NODE_301281_length_204_cov_183.390476	119	199	35	10	80	0.1250000
NODE_301281_length_204_cov_183.390476	119	199	39	11	80	0.1375000
NODE_301281_length_204_cov_183.390476	119	199	40	2	80	0.0250000
NODE_301281_length_204_cov_183.390476	119	199	41	1	80	0.0125000
NODE_301281_length_204_cov_183.390476	119	199	42	3	80	0.0375000
NODE_301281_length_204_cov_183.390476	119	199	46	11	80	0.1375000
NODE_301281_length_204_cov_183.390476	172	194	2	3	22	0.1363636
NODE_301281_length_204_cov_183.390476	172	194	11	3	22	0.1363636
NODE_301281_length_204_cov_183.390476	172	194	18	12	22	0.5454546
NODE_301281_length_204_cov_183.390476	172	194	27	4	22	0.1818182
NODE_301283_length_204_cov_80.095238	10	90	0	5	80	0.0625000
NODE_301283_length_204_cov_80.095238	10	90	6	38	80	0.4750000
NODE_301283_length_204_cov_80.095238	10	90	8	37	80	0.4625000
NODE_301283_length_204_cov_80.095238	63	143	2	24	80	0.3000000
NODE_301283_length_204_cov_80.095238	63	143	8	56	80	0.7000000
NODE_301345_length_202_cov_123.184466	0	64	2	1	64	0.0156250
NODE_301345_length_202_cov_123.184466	0	64	7	2	64	0.0312500
NODE_301345_length_202_cov_123.184466	0	64	9	1	64	0.0156250
NODE_301345_length_202_cov_123.184466	0	64	13	1	64	0.0156250
NODE_301345_length_202_cov_123.184466	0	64	15	1	64	0.0156250
NODE_301345_length_202_cov_123.184466	0	64	17	4	64	0.0625000
NODE_301345_length_202_cov_123.184466	0	64	19	1	64	0.0156250
NODE_301345_length_202_cov_123.184466	0	64	24	2	64	0.0312500
NODE_301345_length_202_cov_123.184466	0	64	25	1	64	0.0156250
NODE_301345_length_202_cov_123.184466	0	64	33	3	64	0.0468750
NODE_301345_length_202_cov_123.184466	0	64	35	1	64	0.0156250
NODE_301345_length_202_cov_123.184466	0	64	39	1	64	0.0156250
NODE_301345_length_202_cov_123.184466	0	64	40	4	64	0.0625000
NODE_301345_length_202_cov_123.184466	0	64	44	2	64	0.0312500
NODE_301345_length_202_cov_123.184466	0	64	51	1	64	0.0156250
NODE_301345_length_202_cov_123.184466	0	64	58	1	64	0.0156250
NODE_301345_length_202_cov_123.184466	0	64	60	5	64	0.0781250
NODE_301345_length_202_cov_123.184466	0	64	62	1	64	0.0156250
NODE_301345_length_202_cov_123.184466	0	64	64	1	64	0.0156250
NODE_301345_length_202_cov_123.184466	0	64	68	3	64	0.0468750
NODE_301345_length_202_cov_123.184466	0	64	71	1	64	0.0156250
NODE_301345_length_202_cov_123.184466	0	64	76	2	64	0.0312500
NODE_301345_length_202_cov_123.184466	0	64	78	1	64	0.0156250
NODE_301345_length_202_cov_123.184466	0	64	84	1	64	0.0156250
NODE_301345_length_202_cov_123.184466	0	64	86	2	64	0.0312500
NODE_301345_length_202_cov_123.184466	0	64	88	1	64	0.0156250
NODE_301345_length_202_cov_123.184466	0	64	89	1	64	0.0156250
NODE_301345_length_202_cov_123.184466	0	64	91	1	64	0.0156250
NODE_301345_length_202_cov_123.184466	0	64	92	1	64	0.0156250
NODE_301345_length_202_cov_123.184466	0	64	95	1	64	0.0156250
NODE_301345_length_202_cov_123.184466	0	64	96	1	64	0.0156250
NODE_301345_length_202_cov_123.184466	0	64	98	1	64	0.0156250
NODE_301345_length_202_cov_123.184466	0	64	106	1	64	0.0156250
NODE_301345_length_202_cov_123.184466	0	64	112	2	64	0.0312500
NODE_301345_length_202_cov_123.184466	0	64	116	1	64	0.0156250
NODE_301345_length_202_cov_123.184466	0	64	124	1	64	0.0156250
NODE_301345_length_202_cov_123.184466	0	64	125	1	64	0.0156250
NODE_301345_length_202_cov_123.184466	0	64	126	2	64	0.0312500
NODE_301345_length_202_cov_123.184466	0	64	136	3	64	0.0468750
NODE_301345_length_202_cov_123.184466	0	64	138	2	64	0.0312500
NODE_301345_length_202_cov_123.184466	31	72	60	1	41	0.0243902
NODE_301345_length_202_cov_123.184466	31	72	62	1	41	0.0243902
NODE_301345_length_202_cov_123.184466	31	72	64	1	41	0.0243902
NODE_301345_length_202_cov_123.184466	31	72	68	3	41	0.0731707
NODE_301345_length_202_cov_123.184466	31	72	71	1	41	0.0243902
NODE_301345_length_202_cov_123.184466	31	72	76	2	41	0.0487805
NODE_301345_length_202_cov_123.184466	31	72	78	1	41	0.0243902
NODE_301345_length_202_cov_123.184466	31	72	84	1	41	0.0243902
NODE_301345_length_202_cov_123.184466	31	72	86	2	41	0.0487805
NODE_301345_length_202_cov_123.184466	31	72	88	1	41	0.0243902
NODE_301345_length_202_cov_123.184466	31	72	89	1	41	0.0243902
NODE_301345_length_202_cov_123.184466	31	72	91	1	41	0.0243902
NODE_301345_length_202_cov_123.184466	31	72	92	1	41	0.0243902
NODE_301345_length_202_cov_123.184466	31	72	95	1	41	0.0243902
NODE_301345_length_202_cov_123.184466	31	72	96	1	41	0.0243902
NODE_301345_length_202_cov_123.184466	31	72	98	1	41	0.0243902
NODE_301345_length_202_cov_123.184466	31	72	106	1	41	0.0243902
NODE_301345_length_202_cov_123.184466	31	72	112	2	41	0.0487805
NODE_301345_length_202_cov_123.184466	31	72	116	1	41	0.0243902
NODE_301345_length_202_cov_123.184466	31	72	124	1	41	0.0243902
NODE_301345_length_202_cov_123.184466	31	72	125	1	41	0.0243902
NODE_301345_length_202_cov_123.184466	31	72	126	2	41	0.0487805
NODE_301345_length_202_cov_123.184466	31	72	136	3	41	0.0731707
NODE_301345_length_202_cov_123.184466	31	72	138	2	41	0.0487805
NODE_301345_length_202_cov_123.184466	31	72	142	1	41	0.0243902
NODE_301345_length_202_cov_123.184466	31	72	150	1	41	0.0243902
NODE_301345_length_202_cov_123.184466	31	72	162	1	41	0.0243902
NODE_301345_length_202_cov_123.184466	31	72	165	1	41	0.0243902
NODE_301345_length_202_cov_123.184466	31	72	169	1	41	0.0243902
NODE_301345_length_202_cov_123.184466	31	72	180	2	41	0.0487805
NODE_301345_length_202_cov_123.184466	31	72	191	1	41	0.0243902
NODE_301370_length_201_cov_56.323529	133	201	2	12	68	0.1764706
NODE_301370_length_201_cov_56.323529	133	201	4	3	68	0.0441176
NODE_301370_length_201_cov_56.323529	133	201	6	32	68	0.4705882
NODE_301370_length_201_cov_56.323529	133	201	8	18	68	0.2647059
NODE_301370_length_201_cov_56.323529	133	201	12	3	68	0.0441176
NODE_301371_length_201_cov_50.647059	44	99	42	2	55	0.0363636
NODE_301371_length_201_cov_50.647059	44	99	47	1	55	0.0181818
NODE_301371_length_201_cov_50.647059	44	99	55	2	55	0.0363636
NODE_301371_length_201_cov_50.647059	44	99	60	1	55	0.0181818
NODE_301371_length_201_cov_50.647059	44	99	62	1	55	0.0181818
NODE_301371_length_201_cov_50.647059	44	99	66	5	55	0.0909091
NODE_301371_length_201_cov_50.647059	44	99	68	1	55	0.0181818
NODE_301371_length_201_cov_50.647059	44	99	83	3	55	0.0545455
NODE_301371_length_201_cov_50.647059	44	99	87	12	55	0.2181818
NODE_301371_length_201_cov_50.647059	44	99	89	1	55	0.0181818
NODE_301371_length_201_cov_50.647059	44	99	90	1	55	0.0181818
NODE_301371_length_201_cov_50.647059	44	99	91	12	55	0.2181818
NODE_301371_length_201_cov_50.647059	44	99	93	13	55	0.2363636
NODE_301371_length_201_cov_50.647059	136	201	2	2	65	0.0307692
NODE_301371_length_201_cov_50.647059	136	201	7	2	65	0.0307692
NODE_301371_length_201_cov_50.647059	136	201	14	1	65	0.0153846
NODE_301371_length_201_cov_50.647059	136	201	25	1	65	0.0153846
NODE_301371_length_201_cov_50.647059	136	201	36	11	65	0.1692308
NODE_301371_length_201_cov_50.647059	136	201	40	2	65	0.0307692
NODE_301371_length_201_cov_50.647059	136	201	42	1	65	0.0153846
NODE_301371_length_201_cov_50.647059	136	201	48	1	65	0.0153846
NODE_301371_length_201_cov_50.647059	136	201	54	16	65	0.2461538
NODE_301371_length_201_cov_50.647059	136	201	55	7	65	0.1076923
NODE_301371_length_201_cov_50.647059	136	201	56	4	65	0.0615385
NODE_301371_length_201_cov_50.647059	136	201	57	1	65	0.0153846
NODE_301371_length_201_cov_50.647059	136	201	58	1	65	0.0153846
NODE_301371_length_201_cov_50.647059	136	201	60	5	65	0.0769231
NODE_301371_length_201_cov_50.647059	136	201	62	1	65	0.0153846
NODE_301371_length_201_cov_50.647059	136	201	66	1	65	0.0153846
NODE_301371_length_201_cov_50.647059	136	201	68	2	65	0.0307692
NODE_301371_length_201_cov_50.647059	136	201	70	1	65	0.0153846
NODE_301371_length_201_cov_50.647059	136	201	72	5	65	0.0769231
NODE_301371_length_201_cov_50.647059	136	201	2	2	65	0.0307692
NODE_301371_length_201_cov_50.647059	136	201	7	2	65	0.0307692
NODE_301371_length_201_cov_50.647059	136	201	14	1	65	0.0153846
NODE_301371_length_201_cov_50.647059	136	201	25	1	65	0.0153846
NODE_301371_length_201_cov_50.647059	136	201	36	11	65	0.1692308
NODE_301371_length_201_cov_50.647059	136	201	40	2	65	0.0307692
NODE_301371_length_201_cov_50.647059	136	201	42	1	65	0.0153846
NODE_301371_length_201_cov_50.647059	136	201	48	1	65	0.0153846
NODE_301371_length_201_cov_50.647059	136	201	54	16	65	0.2461538
NODE_301371_length_201_cov_50.647059	136	201	55	7	65	0.1076923
NODE_301371_length_201_cov_50.647059	136	201	56	4	65	0.0615385
NODE_301371_length_201_cov_50.647059	136	201	57	1	65	0.0153846
NODE_301371_length_201_cov_50.647059	136	201	58	1	65	0.0153846
NODE_301371_length_201_cov_50.647059	136	201	60	5	65	0.0769231
NODE_301371_length_201_cov_50.647059	136	201	62	1	65	0.0153846
NODE_301371_length_201_cov_50.647059	136	201	66	1	65	0.0153846
NODE_301371_length_201_cov_50.647059	136	201	68	2	65	0.0307692
NODE_301371_length_201_cov_50.647059	136	201	70	1	65	0.0153846
NODE_301371_length_201_cov_50.647059	136	201	72	5	65	0.0769231
NODE_301371_length_201_cov_50.647059	136	201	2	2	65	0.0307692
NODE_301371_length_201_cov_50.647059	136	201	7	2	65	0.0307692
NODE_301371_length_201_cov_50.647059	136	201	14	1	65	0.0153846
NODE_301371_length_201_cov_50.647059	136	201	25	1	65	0.0153846
NODE_301371_length_201_cov_50.647059	136	201	36	11	65	0.1692308
NODE_301371_length_201_cov_50.647059	136	201	40	2	65	0.0307692
NODE_301371_length_201_cov_50.647059	136	201	42	1	65	0.0153846
NODE_301371_length_201_cov_50.647059	136	201	48	1	65	0.0153846
NODE_301371_length_201_cov_50.647059	136	201	54	16	65	0.2461538
NODE_301371_length_201_cov_50.647059	136	201	55	7	65	0.1076923
NODE_301371_length_201_cov_50.647059	136	201	56	4	65	0.0615385
NODE_301371_length_201_cov_50.647059	136	201	57	1	65	0.0153846
NODE_301371_length_201_cov_50.647059	136	201	58	1	65	0.0153846
NODE_301371_length_201_cov_50.647059	136	201	60	5	65	0.0769231
NODE_301371_length_201_cov_50.647059	136	201	62	1	65	0.0153846
NODE_301371_length_201_cov_50.647059	136	201	66	1	65	0.0153846
NODE_301371_length_201_cov_50.647059	136	201	68	2	65	0.0307692
NODE_301371_length_201_cov_50.647059	136	201	70	1	65	0.0153846
NODE_301371_length_201_cov_50.647059	136	201	72	5	65	0.0769231
NODE_301371_length_201_cov_50.647059	136	201	2	2	65	0.0307692
NODE_301371_length_201_cov_50.647059	136	201	7	2	65	0.0307692
NODE_301371_length_201_cov_50.647059	136	201	14	1	65	0.0153846
NODE_301371_length_201_cov_50.647059	136	201	25	1	65	0.0153846
NODE_301371_length_201_cov_50.647059	136	201	36	11	65	0.1692308
NODE_301371_length_201_cov_50.647059	136	201	40	2	65	0.0307692
NODE_301371_length_201_cov_50.647059	136	201	42	1	65	0.0153846
NODE_301371_length_201_cov_50.647059	136	201	48	1	65	0.0153846
NODE_301371_length_201_cov_50.647059	136	201	54	16	65	0.2461538
NODE_301371_length_201_cov_50.647059	136	201	55	7	65	0.1076923
NODE_301371_length_201_cov_50.647059	136	201	56	4	65	0.0615385
NODE_301371_length_201_cov_50.647059	136	201	57	1	65	0.0153846
NODE_301371_length_201_cov_50.647059	136	201	58	1	65	0.0153846
NODE_301371_length_201_cov_50.647059	136	201	60	5	65	0.0769231
NODE_301371_length_201_cov_50.647059	136	201	62	1	65	0.0153846
NODE_301371_length_201_cov_50.647059	136	201	66	1	65	0.0153846
NODE_301371_length_201_cov_50.647059	136	201	68	2	65	0.0307692
NODE_301371_length_201_cov_50.647059	136	201	70	1	65	0.0153846
NODE_301371_length_201_cov_50.647059	136	201	72	5	65	0.0769231
NODE_301405_length_200_cov_29.118812	0	73	5	3	73	0.0410959
NODE_301405_length_200_cov_29.118812	0	73	7	1	73	0.0136986
NODE_301405_length_200_cov_29.118812	0	73	13	2	73	0.0273973
NODE_301405_length_200_cov_29.118812	0	73	14	3	73	0.0410959
NODE_301405_length_200_cov_29.118812	0	73	16	3	73	0.0410959
NODE_301405_length_200_cov_29.118812	0	73	24	3	73	0.0410959
NODE_301405_length_200_cov_29.118812	0	73	26	2	73	0.0273973
NODE_301405_length_200_cov_29.118812	0	73	31	1	73	0.0136986
NODE_301405_length_200_cov_29.118812	0	73	33	2	73	0.0273973
NODE_301405_length_200_cov_29.118812	0	73	35	1	73	0.0136986
NODE_301405_length_200_cov_29.118812	0	73	41	1	73	0.0136986
NODE_301405_length_200_cov_29.118812	0	73	43	3	73	0.0410959
NODE_301405_length_200_cov_29.118812	0	73	47	2	73	0.0273973
NODE_301405_length_200_cov_29.118812	0	73	49	4	73	0.0547945
NODE_301405_length_200_cov_29.118812	0	73	51	4	73	0.0547945
NODE_301405_length_200_cov_29.118812	0	73	57	1	73	0.0136986
NODE_301405_length_200_cov_29.118812	0	73	58	1	73	0.0136986
NODE_301405_length_200_cov_29.118812	0	73	60	6	73	0.0821918
NODE_301405_length_200_cov_29.118812	0	73	68	4	73	0.0547945
NODE_301405_length_200_cov_29.118812	0	73	70	4	73	0.0547945
NODE_301405_length_200_cov_29.118812	0	73	72	3	73	0.0410959
NODE_301405_length_200_cov_29.118812	0	73	74	2	73	0.0273973
NODE_301405_length_200_cov_29.118812	0	73	76	1	73	0.0136986
NODE_301405_length_200_cov_29.118812	0	73	78	16	73	0.2191781
NODE_301419_length_199_cov_768.700000	94	142	365	4	48	0.0833333
NODE_301419_length_199_cov_768.700000	94	142	367	1	48	0.0208333
NODE_301419_length_199_cov_768.700000	94	142	369	2	48	0.0416667
NODE_301419_length_199_cov_768.700000	94	142	373	2	48	0.0416667
NODE_301419_length_199_cov_768.700000	94	142	377	1	48	0.0208333
NODE_301419_length_199_cov_768.700000	94	142	381	4	48	0.0833333
NODE_301419_length_199_cov_768.700000	94	142	385	4	48	0.0833333
NODE_301419_length_199_cov_768.700000	94	142	387	7	48	0.1458333
NODE_301419_length_199_cov_768.700000	94	142	389	2	48	0.0416667
NODE_301419_length_199_cov_768.700000	94	142	391	2	48	0.0416667
NODE_301419_length_199_cov_768.700000	94	142	397	1	48	0.0208333
NODE_301419_length_199_cov_768.700000	94	142	399	3	48	0.0625000
NODE_301419_length_199_cov_768.700000	94	142	400	3	48	0.0625000
NODE_301419_length_199_cov_768.700000	94	142	402	5	48	0.1041667
NODE_301419_length_199_cov_768.700000	94	142	404	7	48	0.1458333
NODE_301419_length_199_cov_768.700000	115	186	51	1	71	0.0140845
NODE_301419_length_199_cov_768.700000	115	186	53	1	71	0.0140845
NODE_301419_length_199_cov_768.700000	115	186	59	1	71	0.0140845
NODE_301419_length_199_cov_768.700000	115	186	75	1	71	0.0140845
NODE_301419_length_199_cov_768.700000	115	186	77	1	71	0.0140845
NODE_301419_length_199_cov_768.700000	115	186	93	1	71	0.0140845
NODE_301419_length_199_cov_768.700000	115	186	97	1	71	0.0140845
NODE_301419_length_199_cov_768.700000	115	186	101	1	71	0.0140845
NODE_301419_length_199_cov_768.700000	115	186	112	1	71	0.0140845
NODE_301419_length_199_cov_768.700000	115	186	135	1	71	0.0140845
NODE_301419_length_199_cov_768.700000	115	186	142	1	71	0.0140845
NODE_301419_length_199_cov_768.700000	115	186	161	1	71	0.0140845
NODE_301419_length_199_cov_768.700000	115	186	171	1	71	0.0140845
NODE_301419_length_199_cov_768.700000	115	186	175	1	71	0.0140845
NODE_301419_length_199_cov_768.700000	115	186	183	1	71	0.0140845
NODE_301419_length_199_cov_768.700000	115	186	191	1	71	0.0140845
NODE_301419_length_199_cov_768.700000	115	186	193	1	71	0.0140845
NODE_301419_length_199_cov_768.700000	115	186	207	1	71	0.0140845
NODE_301419_length_199_cov_768.700000	115	186	210	1	71	0.0140845
NODE_301419_length_199_cov_768.700000	115	186	224	2	71	0.0281690
NODE_301419_length_199_cov_768.700000	115	186	226	1	71	0.0140845
NODE_301419_length_199_cov_768.700000	115	186	235	1	71	0.0140845
NODE_301419_length_199_cov_768.700000	115	186	239	1	71	0.0140845
NODE_301419_length_199_cov_768.700000	115	186	243	1	71	0.0140845
NODE_301419_length_199_cov_768.700000	115	186	256	1	71	0.0140845
NODE_301419_length_199_cov_768.700000	115	186	257	1	71	0.0140845
NODE_301419_length_199_cov_768.700000	115	186	266	1	71	0.0140845
NODE_301419_length_199_cov_768.700000	115	186	273	1	71	0.0140845
NODE_301419_length_199_cov_768.700000	115	186	290	1	71	0.0140845
NODE_301419_length_199_cov_768.700000	115	186	301	1	71	0.0140845
NODE_301419_length_199_cov_768.700000	115	186	310	1	71	0.0140845
NODE_301419_length_199_cov_768.700000	115	186	314	3	71	0.0422535
NODE_301419_length_199_cov_768.700000	115	186	322	1	71	0.0140845
NODE_301419_length_199_cov_768.700000	115	186	330	1	71	0.0140845
NODE_301419_length_199_cov_768.700000	115	186	335	1	71	0.0140845
NODE_301419_length_199_cov_768.700000	115	186	338	1	71	0.0140845
NODE_301419_length_199_cov_768.700000	115	186	349	1	71	0.0140845
NODE_301419_length_199_cov_768.700000	115	186	351	1	71	0.0140845
NODE_301419_length_199_cov_768.700000	115	186	355	1	71	0.0140845
NODE_301419_length_199_cov_768.700000	115	186	357	1	71	0.0140845
NODE_301419_length_199_cov_768.700000	115	186	364	1	71	0.0140845
NODE_301419_length_199_cov_768.700000	115	186	365	4	71	0.0563380
NODE_301419_length_199_cov_768.700000	115	186	367	1	71	0.0140845
NODE_301419_length_199_cov_768.700000	115	186	369	2	71	0.0281690
NODE_301419_length_199_cov_768.700000	115	186	373	2	71	0.0281690
NODE_301419_length_199_cov_768.700000	115	186	377	1	71	0.0140845
NODE_301419_length_199_cov_768.700000	115	186	381	4	71	0.0563380
NODE_301419_length_199_cov_768.700000	115	186	385	4	71	0.0563380
NODE_301419_length_199_cov_768.700000	115	186	387	7	71	0.0985916
NODE_301419_length_199_cov_768.700000	115	186	389	2	71	0.0281690
NODE_301420_length_199_cov_702.860000	3	78	42	1	75	0.0133333
NODE_301420_length_199_cov_702.860000	3	78	69	1	75	0.0133333
NODE_301420_length_199_cov_702.860000	3	78	75	1	75	0.0133333
NODE_301420_length_199_cov_702.860000	3	78	81	1	75	0.0133333
NODE_301420_length_199_cov_702.860000	3	78	84	1	75	0.0133333
NODE_301420_length_199_cov_702.860000	3	78	86	1	75	0.0133333
NODE_301420_length_199_cov_702.860000	3	78	88	1	75	0.0133333
NODE_301420_length_199_cov_702.860000	3	78	92	1	75	0.0133333
NODE_301420_length_199_cov_702.860000	3	78	100	1	75	0.0133333
NODE_301420_length_199_cov_702.860000	3	78	111	1	75	0.0133333
NODE_301420_length_199_cov_702.860000	3	78	113	1	75	0.0133333
NODE_301420_length_199_cov_702.860000	3	78	125	1	75	0.0133333
NODE_301420_length_199_cov_702.860000	3	78	135	1	75	0.0133333
NODE_301420_length_199_cov_702.860000	3	78	144	1	75	0.0133333
NODE_301420_length_199_cov_702.860000	3	78	161	1	75	0.0133333
NODE_301420_length_199_cov_702.860000	3	78	190	1	75	0.0133333
NODE_301420_length_199_cov_702.860000	3	78	196	1	75	0.0133333
NODE_301420_length_199_cov_702.860000	3	78	213	1	75	0.0133333
NODE_301420_length_199_cov_702.860000	3	78	226	1	75	0.0133333
NODE_301420_length_199_cov_702.860000	3	78	233	1	75	0.0133333
NODE_301420_length_199_cov_702.860000	3	78	237	1	75	0.0133333
NODE_301420_length_199_cov_702.860000	3	78	239	1	75	0.0133333
NODE_301420_length_199_cov_702.860000	3	78	258	1	75	0.0133333
NODE_301420_length_199_cov_702.860000	3	78	274	1	75	0.0133333
NODE_301420_length_199_cov_702.860000	3	78	294	1	75	0.0133333
NODE_301420_length_199_cov_702.860000	3	78	333	1	75	0.0133333
NODE_301420_length_199_cov_702.860000	3	78	334	1	75	0.0133333
NODE_301420_length_199_cov_702.860000	3	78	351	1	75	0.0133333
NODE_301420_length_199_cov_702.860000	3	78	372	1	75	0.0133333
NODE_301420_length_199_cov_702.860000	3	78	386	1	75	0.0133333
NODE_301420_length_199_cov_702.860000	3	78	392	1	75	0.0133333
NODE_301420_length_199_cov_702.860000	3	78	394	1	75	0.0133333
NODE_301420_length_199_cov_702.860000	3	78	399	1	75	0.0133333
NODE_301420_length_199_cov_702.860000	3	78	406	1	75	0.0133333
NODE_301420_length_199_cov_702.860000	3	78	412	1	75	0.0133333
NODE_301420_length_199_cov_702.860000	3	78	424	1	75	0.0133333
NODE_301420_length_199_cov_702.860000	3	78	426	1	75	0.0133333
NODE_301420_length_199_cov_702.860000	3	78	432	1	75	0.0133333
NODE_301420_length_199_cov_702.860000	3	78	434	1	75	0.0133333
NODE_301420_length_199_cov_702.860000	3	78	446	1	75	0.0133333
NODE_301420_length_199_cov_702.860000	3	78	448	1	75	0.0133333
NODE_301420_length_199_cov_702.860000	3	78	454	1	75	0.0133333
NODE_301420_length_199_cov_702.860000	3	78	460	1	75	0.0133333
NODE_301420_length_199_cov_702.860000	3	78	470	1	75	0.0133333
NODE_301420_length_199_cov_702.860000	3	78	474	2	75	0.0266667
NODE_301420_length_199_cov_702.860000	3	78	479	1	75	0.0133333
NODE_301420_length_199_cov_702.860000	3	78	480	1	75	0.0133333
NODE_301420_length_199_cov_702.860000	3	78	496	1	75	0.0133333
NODE_301420_length_199_cov_702.860000	3	78	508	1	75	0.0133333
NODE_301420_length_199_cov_702.860000	3	78	514	1	75	0.0133333
NODE_301420_length_199_cov_702.860000	3	78	542	1	75	0.0133333
NODE_301420_length_199_cov_702.860000	3	78	564	1	75	0.0133333
NODE_301420_length_199_cov_702.860000	3	78	588	1	75	0.0133333
NODE_301420_length_199_cov_702.860000	3	78	596	1	75	0.0133333
NODE_301420_length_199_cov_702.860000	3	78	600	1	75	0.0133333
NODE_301420_length_199_cov_702.860000	3	78	606	1	75	0.0133333
NODE_301420_length_199_cov_702.860000	3	78	614	1	75	0.0133333
NODE_301420_length_199_cov_702.860000	3	78	622	1	75	0.0133333
NODE_301420_length_199_cov_702.860000	3	78	624	1	75	0.0133333
NODE_301420_length_199_cov_702.860000	3	78	628	3	75	0.0400000
NODE_301420_length_199_cov_702.860000	3	78	632	1	75	0.0133333
NODE_301420_length_199_cov_702.860000	3	78	634	4	75	0.0533333
NODE_301420_length_199_cov_702.860000	3	78	636	2	75	0.0266667
NODE_301420_length_199_cov_702.860000	3	78	640	1	75	0.0133333
NODE_301420_length_199_cov_702.860000	3	78	642	1	75	0.0133333
NODE_301420_length_199_cov_702.860000	3	78	646	1	75	0.0133333
NODE_301420_length_199_cov_702.860000	3	78	648	1	75	0.0133333
NODE_301420_length_199_cov_702.860000	3	78	650	1	75	0.0133333
NODE_301420_length_199_cov_702.860000	51	131	461	1	80	0.0125000
NODE_301420_length_199_cov_702.860000	51	131	466	1	80	0.0125000
NODE_301420_length_199_cov_702.860000	51	131	485	1	80	0.0125000
NODE_301420_length_199_cov_702.860000	51	131	487	1	80	0.0125000
NODE_301420_length_199_cov_702.860000	51	131	493	1	80	0.0125000
NODE_301420_length_199_cov_702.860000	51	131	496	1	80	0.0125000
NODE_301420_length_199_cov_702.860000	51	131	497	1	80	0.0125000
NODE_301420_length_199_cov_702.860000	51	131	503	1	80	0.0125000
NODE_301420_length_199_cov_702.860000	51	131	508	1	80	0.0125000
NODE_301420_length_199_cov_702.860000	51	131	514	1	80	0.0125000
NODE_301420_length_199_cov_702.860000	51	131	533	1	80	0.0125000
NODE_301420_length_199_cov_702.860000	51	131	542	1	80	0.0125000
NODE_301420_length_199_cov_702.860000	51	131	553	1	80	0.0125000
NODE_301420_length_199_cov_702.860000	51	131	564	1	80	0.0125000
NODE_301420_length_199_cov_702.860000	51	131	569	1	80	0.0125000
NODE_301420_length_199_cov_702.860000	51	131	578	1	80	0.0125000
NODE_301420_length_199_cov_702.860000	51	131	586	1	80	0.0125000
NODE_301420_length_199_cov_702.860000	51	131	588	1	80	0.0125000
NODE_301420_length_199_cov_702.860000	51	131	596	1	80	0.0125000
NODE_301420_length_199_cov_702.860000	51	131	600	1	80	0.0125000
NODE_301420_length_199_cov_702.860000	51	131	606	1	80	0.0125000
NODE_301420_length_199_cov_702.860000	51	131	607	1	80	0.0125000
NODE_301420_length_199_cov_702.860000	51	131	611	1	80	0.0125000
NODE_301420_length_199_cov_702.860000	51	131	614	1	80	0.0125000
NODE_301420_length_199_cov_702.860000	51	131	615	1	80	0.0125000
NODE_301420_length_199_cov_702.860000	51	131	622	1	80	0.0125000
NODE_301420_length_199_cov_702.860000	51	131	624	1	80	0.0125000
NODE_301420_length_199_cov_702.860000	51	131	625	1	80	0.0125000
NODE_301420_length_199_cov_702.860000	51	131	628	3	80	0.0375000
NODE_301420_length_199_cov_702.860000	51	131	632	1	80	0.0125000
NODE_301420_length_199_cov_702.860000	51	131	634	4	80	0.0500000
NODE_301420_length_199_cov_702.860000	51	131	636	2	80	0.0250000
NODE_301420_length_199_cov_702.860000	51	131	640	1	80	0.0125000
NODE_301420_length_199_cov_702.860000	51	131	642	1	80	0.0125000
NODE_301420_length_199_cov_702.860000	51	131	646	1	80	0.0125000
NODE_301420_length_199_cov_702.860000	51	131	648	2	80	0.0250000
NODE_301420_length_199_cov_702.860000	51	131	650	1	80	0.0125000
NODE_301420_length_199_cov_702.860000	51	131	652	1	80	0.0125000
NODE_301420_length_199_cov_702.860000	51	131	670	1	80	0.0125000
NODE_301420_length_199_cov_702.860000	51	131	682	3	80	0.0375000
NODE_301420_length_199_cov_702.860000	51	131	690	1	80	0.0125000
NODE_301420_length_199_cov_702.860000	51	131	692	4	80	0.0500000
NODE_301420_length_199_cov_702.860000	51	131	696	1	80	0.0125000
NODE_301420_length_199_cov_702.860000	51	131	698	1	80	0.0125000
NODE_301420_length_199_cov_702.860000	51	131	700	1	80	0.0125000
NODE_301420_length_199_cov_702.860000	51	131	712	1	80	0.0125000
NODE_301420_length_199_cov_702.860000	51	131	714	1	80	0.0125000
NODE_301420_length_199_cov_702.860000	51	131	720	1	80	0.0125000
NODE_301420_length_199_cov_702.860000	51	131	722	1	80	0.0125000
NODE_301420_length_199_cov_702.860000	51	131	726	2	80	0.0250000
NODE_301420_length_199_cov_702.860000	51	131	730	2	80	0.0250000
NODE_301420_length_199_cov_702.860000	51	131	732	6	80	0.0750000
NODE_301420_length_199_cov_702.860000	51	131	734	2	80	0.0250000
NODE_301420_length_199_cov_702.860000	51	131	740	7	80	0.0875000
NODE_301421_length_199_cov_670.570000	22	52	210	1	30	0.0333333
NODE_301421_length_199_cov_670.570000	22	52	219	1	30	0.0333333
NODE_301421_length_199_cov_670.570000	22	52	243	1	30	0.0333333
NODE_301421_length_199_cov_670.570000	22	52	262	1	30	0.0333333
NODE_301421_length_199_cov_670.570000	22	52	287	1	30	0.0333333
NODE_301421_length_199_cov_670.570000	22	52	290	1	30	0.0333333
NODE_301421_length_199_cov_670.570000	22	52	311	1	30	0.0333333
NODE_301421_length_199_cov_670.570000	22	52	315	1	30	0.0333333
NODE_301421_length_199_cov_670.570000	22	52	322	1	30	0.0333333
NODE_301421_length_199_cov_670.570000	22	52	333	2	30	0.0666667
NODE_301421_length_199_cov_670.570000	22	52	345	1	30	0.0333333
NODE_301421_length_199_cov_670.570000	22	52	346	1	30	0.0333333
NODE_301421_length_199_cov_670.570000	22	52	352	1	30	0.0333333
NODE_301421_length_199_cov_670.570000	22	52	359	1	30	0.0333333
NODE_301421_length_199_cov_670.570000	22	52	361	1	30	0.0333333
NODE_301421_length_199_cov_670.570000	22	52	366	1	30	0.0333333
NODE_301421_length_199_cov_670.570000	22	52	368	1	30	0.0333333
NODE_301421_length_199_cov_670.570000	22	52	384	1	30	0.0333333
NODE_301421_length_199_cov_670.570000	22	52	391	1	30	0.0333333
NODE_301421_length_199_cov_670.570000	22	52	394	2	30	0.0666667
NODE_301421_length_199_cov_670.570000	22	52	396	1	30	0.0333333
NODE_301421_length_199_cov_670.570000	22	52	398	1	30	0.0333333
NODE_301421_length_199_cov_670.570000	22	52	401	1	30	0.0333333
NODE_301421_length_199_cov_670.570000	22	52	405	1	30	0.0333333
NODE_301421_length_199_cov_670.570000	22	52	410	1	30	0.0333333
NODE_301421_length_199_cov_670.570000	22	52	415	1	30	0.0333333
NODE_301421_length_199_cov_670.570000	22	52	420	2	30	0.0666667
NODE_301421_length_199_cov_670.570000	25	105	262	1	80	0.0125000
NODE_301421_length_199_cov_670.570000	25	105	287	1	80	0.0125000
NODE_301421_length_199_cov_670.570000	25	105	290	1	80	0.0125000
NODE_301421_length_199_cov_670.570000	25	105	311	1	80	0.0125000
NODE_301421_length_199_cov_670.570000	25	105	315	1	80	0.0125000
NODE_301421_length_199_cov_670.570000	25	105	322	1	80	0.0125000
NODE_301421_length_199_cov_670.570000	25	105	333	2	80	0.0250000
NODE_301421_length_199_cov_670.570000	25	105	345	1	80	0.0125000
NODE_301421_length_199_cov_670.570000	25	105	346	1	80	0.0125000
NODE_301421_length_199_cov_670.570000	25	105	352	1	80	0.0125000
NODE_301421_length_199_cov_670.570000	25	105	359	1	80	0.0125000
NODE_301421_length_199_cov_670.570000	25	105	361	1	80	0.0125000
NODE_301421_length_199_cov_670.570000	25	105	366	1	80	0.0125000
NODE_301421_length_199_cov_670.570000	25	105	368	1	80	0.0125000
NODE_301421_length_199_cov_670.570000	25	105	384	1	80	0.0125000
NODE_301421_length_199_cov_670.570000	25	105	391	1	80	0.0125000
NODE_301421_length_199_cov_670.570000	25	105	394	2	80	0.0250000
NODE_301421_length_199_cov_670.570000	25	105	396	1	80	0.0125000
NODE_301421_length_199_cov_670.570000	25	105	398	1	80	0.0125000
NODE_301421_length_199_cov_670.570000	25	105	401	1	80	0.0125000
NODE_301421_length_199_cov_670.570000	25	105	405	1	80	0.0125000
NODE_301421_length_199_cov_670.570000	25	105	410	1	80	0.0125000
NODE_301421_length_199_cov_670.570000	25	105	415	1	80	0.0125000
NODE_301421_length_199_cov_670.570000	25	105	420	2	80	0.0250000
NODE_301421_length_199_cov_670.570000	25	105	424	1	80	0.0125000
NODE_301421_length_199_cov_670.570000	25	105	430	1	80	0.0125000
NODE_301421_length_199_cov_670.570000	25	105	432	1	80	0.0125000
NODE_301421_length_199_cov_670.570000	25	105	437	1	80	0.0125000
NODE_301421_length_199_cov_670.570000	25	105	443	1	80	0.0125000
NODE_301421_length_199_cov_670.570000	25	105	449	3	80	0.0375000
NODE_301421_length_199_cov_670.570000	25	105	454	1	80	0.0125000
NODE_301421_length_199_cov_670.570000	25	105	456	1	80	0.0125000
NODE_301421_length_199_cov_670.570000	25	105	458	1	80	0.0125000
NODE_301421_length_199_cov_670.570000	25	105	459	1	80	0.0125000
NODE_301421_length_199_cov_670.570000	25	105	460	1	80	0.0125000
NODE_301421_length_199_cov_670.570000	25	105	462	1	80	0.0125000
NODE_301421_length_199_cov_670.570000	25	105	464	2	80	0.0250000
NODE_301421_length_199_cov_670.570000	25	105	465	2	80	0.0250000
NODE_301421_length_199_cov_670.570000	25	105	472	1	80	0.0125000
NODE_301421_length_199_cov_670.570000	25	105	474	1	80	0.0125000
NODE_301421_length_199_cov_670.570000	25	105	476	2	80	0.0250000
NODE_301421_length_199_cov_670.570000	25	105	478	1	80	0.0125000
NODE_301421_length_199_cov_670.570000	25	105	479	1	80	0.0125000
NODE_301421_length_199_cov_670.570000	25	105	482	2	80	0.0250000
NODE_301421_length_199_cov_670.570000	25	105	484	6	80	0.0750000
NODE_301421_length_199_cov_670.570000	25	105	487	2	80	0.0250000
NODE_301421_length_199_cov_670.570000	25	105	489	1	80	0.0125000
NODE_301421_length_199_cov_670.570000	25	105	491	2	80	0.0250000
NODE_301421_length_199_cov_670.570000	25	105	493	1	80	0.0125000
NODE_301421_length_199_cov_670.570000	25	105	497	1	80	0.0125000
NODE_301421_length_199_cov_670.570000	25	105	501	1	80	0.0125000
NODE_301421_length_199_cov_670.570000	25	105	503	13	80	0.1625000
NODE_301430_length_199_cov_215.860000	3	75	2	14	72	0.1944444
NODE_301430_length_199_cov_215.860000	3	75	7	1	72	0.0138889
NODE_301430_length_199_cov_215.860000	3	75	12	1	72	0.0138889
NODE_301430_length_199_cov_215.860000	3	75	14	3	72	0.0416667
NODE_301430_length_199_cov_215.860000	3	75	25	1	72	0.0138889
NODE_301430_length_199_cov_215.860000	3	75	26	2	72	0.0277778
NODE_301430_length_199_cov_215.860000	3	75	29	2	72	0.0277778
NODE_301430_length_199_cov_215.860000	3	75	31	1	72	0.0138889
NODE_301430_length_199_cov_215.860000	3	75	35	1	72	0.0138889
NODE_301430_length_199_cov_215.860000	3	75	37	3	72	0.0416667
NODE_301430_length_199_cov_215.860000	3	75	39	2	72	0.0277778
NODE_301430_length_199_cov_215.860000	3	75	41	1	72	0.0138889
NODE_301430_length_199_cov_215.860000	3	75	43	4	72	0.0555556
NODE_301430_length_199_cov_215.860000	3	75	51	1	72	0.0138889
NODE_301430_length_199_cov_215.860000	3	75	53	1	72	0.0138889
NODE_301430_length_199_cov_215.860000	3	75	55	3	72	0.0416667
NODE_301430_length_199_cov_215.860000	3	75	63	2	72	0.0277778
NODE_301430_length_199_cov_215.860000	3	75	65	1	72	0.0138889
NODE_301430_length_199_cov_215.860000	3	75	67	1	72	0.0138889
NODE_301430_length_199_cov_215.860000	3	75	71	1	72	0.0138889
NODE_301430_length_199_cov_215.860000	3	75	73	1	72	0.0138889
NODE_301430_length_199_cov_215.860000	3	75	77	1	72	0.0138889
NODE_301430_length_199_cov_215.860000	3	75	81	1	72	0.0138889
NODE_301430_length_199_cov_215.860000	3	75	82	4	72	0.0555556
NODE_301430_length_199_cov_215.860000	3	75	84	3	72	0.0416667
NODE_301430_length_199_cov_215.860000	3	75	86	1	72	0.0138889
NODE_301430_length_199_cov_215.860000	3	75	88	2	72	0.0277778
NODE_301430_length_199_cov_215.860000	3	75	90	6	72	0.0833333
NODE_301430_length_199_cov_215.860000	3	75	92	7	72	0.0972222
NODE_301430_length_199_cov_215.860000	48	128	58	1	80	0.0125000
NODE_301430_length_199_cov_215.860000	48	128	64	1	80	0.0125000
NODE_301430_length_199_cov_215.860000	48	128	66	2	80	0.0250000
NODE_301430_length_199_cov_215.860000	48	128	68	5	80	0.0625000
NODE_301430_length_199_cov_215.860000	48	128	70	2	80	0.0250000
NODE_301430_length_199_cov_215.860000	48	128	71	1	80	0.0125000
NODE_301430_length_199_cov_215.860000	48	128	72	1	80	0.0125000
NODE_301430_length_199_cov_215.860000	48	128	73	1	80	0.0125000
NODE_301430_length_199_cov_215.860000	48	128	77	1	80	0.0125000
NODE_301430_length_199_cov_215.860000	48	128	78	1	80	0.0125000
NODE_301430_length_199_cov_215.860000	48	128	81	1	80	0.0125000
NODE_301430_length_199_cov_215.860000	48	128	82	6	80	0.0750000
NODE_301430_length_199_cov_215.860000	48	128	84	6	80	0.0750000
NODE_301430_length_199_cov_215.860000	48	128	86	1	80	0.0125000
NODE_301430_length_199_cov_215.860000	48	128	88	2	80	0.0250000
NODE_301430_length_199_cov_215.860000	48	128	90	9	80	0.1125000
NODE_301430_length_199_cov_215.860000	48	128	92	16	80	0.2000000
NODE_301430_length_199_cov_215.860000	48	128	94	9	80	0.1125000
NODE_301430_length_199_cov_215.860000	48	128	96	14	80	0.1750000
NODE_301432_length_199_cov_206.800000	120	199	0	13	79	0.1645570
NODE_301432_length_199_cov_206.800000	120	199	6	66	79	0.8354430
NODE_301441_length_199_cov_131.120000	97	177	0	80	80	1.0000000
NODE_301448_length_199_cov_97.490000	4	77	6	3	73	0.0410959
NODE_301448_length_199_cov_97.490000	4	77	9	1	73	0.0136986
NODE_301448_length_199_cov_97.490000	4	77	15	3	73	0.0410959
NODE_301448_length_199_cov_97.490000	4	77	21	1	73	0.0136986
NODE_301448_length_199_cov_97.490000	4	77	22	4	73	0.0547945
NODE_301448_length_199_cov_97.490000	4	77	24	1	73	0.0136986
NODE_301448_length_199_cov_97.490000	4	77	25	1	73	0.0136986
NODE_301448_length_199_cov_97.490000	4	77	38	1	73	0.0136986
NODE_301448_length_199_cov_97.490000	4	77	39	1	73	0.0136986
NODE_301448_length_199_cov_97.490000	4	77	45	1	73	0.0136986
NODE_301448_length_199_cov_97.490000	4	77	47	3	73	0.0410959
NODE_301448_length_199_cov_97.490000	4	77	49	1	73	0.0136986
NODE_301448_length_199_cov_97.490000	4	77	50	1	73	0.0136986
NODE_301448_length_199_cov_97.490000	4	77	54	2	73	0.0273973
NODE_301448_length_199_cov_97.490000	4	77	57	1	73	0.0136986
NODE_301448_length_199_cov_97.490000	4	77	59	1	73	0.0136986
NODE_301448_length_199_cov_97.490000	4	77	63	1	73	0.0136986
NODE_301448_length_199_cov_97.490000	4	77	67	1	73	0.0136986
NODE_301448_length_199_cov_97.490000	4	77	69	1	73	0.0136986
NODE_301448_length_199_cov_97.490000	4	77	79	1	73	0.0136986
NODE_301448_length_199_cov_97.490000	4	77	86	1	73	0.0136986
NODE_301448_length_199_cov_97.490000	4	77	94	1	73	0.0136986
NODE_301448_length_199_cov_97.490000	4	77	99	2	73	0.0273973
NODE_301448_length_199_cov_97.490000	4	77	101	1	73	0.0136986
NODE_301448_length_199_cov_97.490000	4	77	106	1	73	0.0136986
NODE_301448_length_199_cov_97.490000	4	77	109	1	73	0.0136986
NODE_301448_length_199_cov_97.490000	4	77	111	3	73	0.0410959
NODE_301448_length_199_cov_97.490000	4	77	119	10	73	0.1369863
NODE_301448_length_199_cov_97.490000	4	77	125	2	73	0.0273973
NODE_301448_length_199_cov_97.490000	4	77	127	2	73	0.0273973
NODE_301448_length_199_cov_97.490000	4	77	131	1	73	0.0136986
NODE_301448_length_199_cov_97.490000	4	77	133	4	73	0.0547945
NODE_301448_length_199_cov_97.490000	4	77	137	1	73	0.0136986
NODE_301448_length_199_cov_97.490000	4	77	140	1	73	0.0136986
NODE_301448_length_199_cov_97.490000	4	77	142	7	73	0.0958904
NODE_301448_length_199_cov_97.490000	4	77	146	3	73	0.0410959
NODE_301448_length_199_cov_97.490000	4	77	150	1	73	0.0136986
NODE_301448_length_199_cov_97.490000	4	77	154	1	73	0.0136986
NODE_301449_length_199_cov_96.090000	91	171	23	6	80	0.0750000
NODE_301449_length_199_cov_96.090000	91	171	25	1	80	0.0125000
NODE_301449_length_199_cov_96.090000	91	171	28	2	80	0.0250000
NODE_301449_length_199_cov_96.090000	91	171	30	10	80	0.1250000
NODE_301449_length_199_cov_96.090000	91	171	32	4	80	0.0500000
NODE_301449_length_199_cov_96.090000	91	171	34	10	80	0.1250000
NODE_301449_length_199_cov_96.090000	91	171	36	1	80	0.0125000
NODE_301449_length_199_cov_96.090000	91	171	37	2	80	0.0250000
NODE_301449_length_199_cov_96.090000	91	171	39	7	80	0.0875000
NODE_301449_length_199_cov_96.090000	91	171	41	1	80	0.0125000
NODE_301449_length_199_cov_96.090000	91	171	42	1	80	0.0125000
NODE_301449_length_199_cov_96.090000	91	171	43	9	80	0.1125000
NODE_301449_length_199_cov_96.090000	91	171	47	9	80	0.1125000
NODE_301449_length_199_cov_96.090000	91	171	49	17	80	0.2125000
NODE_301455_length_199_cov_84.060000	44	75	22	6	31	0.1935484
NODE_301455_length_199_cov_84.060000	44	75	24	11	31	0.3548387
NODE_301455_length_199_cov_84.060000	44	75	26	14	31	0.4516129
NODE_301456_length_199_cov_83.220000	0	64	0	64	64	1.0000000
NODE_301459_length_199_cov_80.390000	15	98	63	1	83	0.0120482
NODE_301459_length_199_cov_80.390000	15	98	64	4	83	0.0481928
NODE_301459_length_199_cov_80.390000	15	98	68	2	83	0.0240964
NODE_301459_length_199_cov_80.390000	15	98	70	4	83	0.0481928
NODE_301459_length_199_cov_80.390000	15	98	71	2	83	0.0240964
NODE_301459_length_199_cov_80.390000	15	98	72	1	83	0.0120482
NODE_301459_length_199_cov_80.390000	15	98	74	4	83	0.0481928
NODE_301459_length_199_cov_80.390000	15	98	78	4	83	0.0481928
NODE_301459_length_199_cov_80.390000	15	98	80	6	83	0.0722892
NODE_301459_length_199_cov_80.390000	15	98	82	55	83	0.6626506
NODE_301469_length_199_cov_63.420000	128	194	4	3	66	0.0454545
NODE_301469_length_199_cov_63.420000	128	194	8	1	66	0.0151515
NODE_301469_length_199_cov_63.420000	128	194	10	2	66	0.0303030
NODE_301469_length_199_cov_63.420000	128	194	14	1	66	0.0151515
NODE_301469_length_199_cov_63.420000	128	194	18	1	66	0.0151515
NODE_301469_length_199_cov_63.420000	128	194	19	1	66	0.0151515
NODE_301469_length_199_cov_63.420000	128	194	21	1	66	0.0151515
NODE_301469_length_199_cov_63.420000	128	194	23	1	66	0.0151515
NODE_301469_length_199_cov_63.420000	128	194	29	1	66	0.0151515
NODE_301469_length_199_cov_63.420000	128	194	31	1	66	0.0151515
NODE_301469_length_199_cov_63.420000	128	194	33	1	66	0.0151515
NODE_301469_length_199_cov_63.420000	128	194	39	2	66	0.0303030
NODE_301469_length_199_cov_63.420000	128	194	41	1	66	0.0151515
NODE_301469_length_199_cov_63.420000	128	194	43	6	66	0.0909091
NODE_301469_length_199_cov_63.420000	128	194	45	3	66	0.0454545
NODE_301469_length_199_cov_63.420000	128	194	47	1	66	0.0151515
NODE_301469_length_199_cov_63.420000	128	194	57	1	66	0.0151515
NODE_301469_length_199_cov_63.420000	128	194	69	1	66	0.0151515
NODE_301469_length_199_cov_63.420000	128	194	70	2	66	0.0303030
NODE_301469_length_199_cov_63.420000	128	194	74	3	66	0.0454545
NODE_301469_length_199_cov_63.420000	128	194	77	4	66	0.0606061
NODE_301469_length_199_cov_63.420000	128	194	79	1	66	0.0151515
NODE_301469_length_199_cov_63.420000	128	194	82	1	66	0.0151515
NODE_301469_length_199_cov_63.420000	128	194	86	2	66	0.0303030
NODE_301469_length_199_cov_63.420000	128	194	88	1	66	0.0151515
NODE_301469_length_199_cov_63.420000	128	194	90	2	66	0.0303030
NODE_301469_length_199_cov_63.420000	128	194	98	1	66	0.0151515
NODE_301469_length_199_cov_63.420000	128	194	106	1	66	0.0151515
NODE_301469_length_199_cov_63.420000	128	194	107	2	66	0.0303030
NODE_301469_length_199_cov_63.420000	128	194	109	2	66	0.0303030
NODE_301469_length_199_cov_63.420000	128	194	113	4	66	0.0606061
NODE_301469_length_199_cov_63.420000	128	194	115	1	66	0.0151515
NODE_301469_length_199_cov_63.420000	128	194	121	3	66	0.0454545
NODE_301469_length_199_cov_63.420000	128	194	123	1	66	0.0151515
NODE_301469_length_199_cov_63.420000	128	194	125	1	66	0.0151515
NODE_301469_length_199_cov_63.420000	128	194	129	1	66	0.0151515
NODE_301469_length_199_cov_63.420000	128	194	131	2	66	0.0303030
NODE_301469_length_199_cov_63.420000	128	194	133	1	66	0.0151515
NODE_301469_length_199_cov_63.420000	128	194	138	1	66	0.0151515
NODE_301477_length_199_cov_58.660000	18	85	0	21	67	0.3134328
NODE_301477_length_199_cov_58.660000	18	85	1	2	67	0.0298507
NODE_301477_length_199_cov_58.660000	18	85	2	44	67	0.6567164
NODE_301484_length_199_cov_50.350000	102	183	0	81	81	1.0000000
NODE_301485_length_199_cov_49.630000	5	47	4	42	42	1.0000000
NODE_301485_length_199_cov_49.630000	100	163	18	23	63	0.3650794
NODE_301485_length_199_cov_49.630000	100	163	22	40	63	0.6349207
NODE_301485_length_199_cov_49.630000	100	163	18	23	63	0.3650794
NODE_301485_length_199_cov_49.630000	100	163	22	40	63	0.6349207
NODE_301485_length_199_cov_49.630000	100	163	18	23	63	0.3650794
NODE_301485_length_199_cov_49.630000	100	163	22	40	63	0.6349207
NODE_301485_length_199_cov_49.630000	136	185	0	20	49	0.4081633
NODE_301485_length_199_cov_49.630000	136	185	18	25	49	0.5102041
NODE_301485_length_199_cov_49.630000	136	185	22	4	49	0.0816327
NODE_301485_length_199_cov_49.630000	153	199	0	34	46	0.7391304
NODE_301485_length_199_cov_49.630000	153	199	18	12	46	0.2608696
NODE_301491_length_199_cov_40.000000	0	66	0	40	66	0.6060606
NODE_301491_length_199_cov_40.000000	0	66	2	17	66	0.2575758
NODE_301491_length_199_cov_40.000000	0	66	4	9	66	0.1363636
NODE_301491_length_199_cov_40.000000	34	114	0	6	80	0.0750000
NODE_301491_length_199_cov_40.000000	34	114	2	17	80	0.2125000
NODE_301491_length_199_cov_40.000000	34	114	4	57	80	0.7125000
NODE_301491_length_199_cov_40.000000	39	61	0	1	22	0.0454545
NODE_301491_length_199_cov_40.000000	39	61	2	17	22	0.7727273
NODE_301491_length_199_cov_40.000000	39	61	4	4	22	0.1818182
NODE_301498_length_199_cov_31.400000	3	77	0	17	74	0.2297297
NODE_301498_length_199_cov_31.400000	3	77	12	4	74	0.0540541
NODE_301498_length_199_cov_31.400000	3	77	18	1	74	0.0135135
NODE_301498_length_199_cov_31.400000	3	77	22	1	74	0.0135135
NODE_301498_length_199_cov_31.400000	3	77	28	11	74	0.1486486
NODE_301498_length_199_cov_31.400000	3	77	34	13	74	0.1756757
NODE_301498_length_199_cov_31.400000	3	77	36	27	74	0.3648649
NODE_301498_length_199_cov_31.400000	76	153	36	13	77	0.1688312
NODE_301498_length_199_cov_31.400000	76	153	40	64	77	0.8311688
NODE_301498_length_199_cov_31.400000	76	153	36	13	77	0.1688312
NODE_301498_length_199_cov_31.400000	76	153	40	64	77	0.8311688
NODE_301498_length_199_cov_31.400000	76	153	36	13	77	0.1688312
NODE_301498_length_199_cov_31.400000	76	153	40	64	77	0.8311688
NODE_301498_length_199_cov_31.400000	126	192	0	16	66	0.2424242
NODE_301498_length_199_cov_31.400000	126	192	5	1	66	0.0151515
NODE_301498_length_199_cov_31.400000	126	192	6	1	66	0.0151515
NODE_301498_length_199_cov_31.400000	126	192	12	5	66	0.0757576
NODE_301498_length_199_cov_31.400000	126	192	14	2	66	0.0303030
NODE_301498_length_199_cov_31.400000	126	192	26	3	66	0.0454545
NODE_301498_length_199_cov_31.400000	126	192	30	1	66	0.0151515
NODE_301498_length_199_cov_31.400000	126	192	36	1	66	0.0151515
NODE_301498_length_199_cov_31.400000	126	192	40	36	66	0.5454546
NODE_301498_length_199_cov_31.400000	129	199	0	23	70	0.3285714
NODE_301498_length_199_cov_31.400000	129	199	5	1	70	0.0142857
NODE_301498_length_199_cov_31.400000	129	199	6	1	70	0.0142857
NODE_301498_length_199_cov_31.400000	129	199	12	5	70	0.0714286
NODE_301498_length_199_cov_31.400000	129	199	14	2	70	0.0285714
NODE_301498_length_199_cov_31.400000	129	199	26	3	70	0.0428571
NODE_301498_length_199_cov_31.400000	129	199	30	1	70	0.0142857
NODE_301498_length_199_cov_31.400000	129	199	36	1	70	0.0142857
NODE_301498_length_199_cov_31.400000	129	199	40	33	70	0.4714286
NODE_301498_length_199_cov_31.400000	131	199	0	23	68	0.3382353
NODE_301498_length_199_cov_31.400000	131	199	5	1	68	0.0147059
NODE_301498_length_199_cov_31.400000	131	199	6	1	68	0.0147059
NODE_301498_length_199_cov_31.400000	131	199	12	5	68	0.0735294
NODE_301498_length_199_cov_31.400000	131	199	14	2	68	0.0294118
NODE_301498_length_199_cov_31.400000	131	199	26	3	68	0.0441176
NODE_301498_length_199_cov_31.400000	131	199	30	1	68	0.0147059
NODE_301498_length_199_cov_31.400000	131	199	36	1	68	0.0147059
NODE_301498_length_199_cov_31.400000	131	199	40	31	68	0.4558823
NODE_301500_length_199_cov_30.140000	118	198	1	80	80	1.0000000
NODE_301500_length_199_cov_30.140000	118	198	1	80	80	1.0000000
NODE_301500_length_199_cov_30.140000	118	198	1	80	80	1.0000000
NODE_301500_length_199_cov_30.140000	118	198	1	80	80	1.0000000
NODE_301500_length_199_cov_30.140000	118	198	1	80	80	1.0000000
NODE_301500_length_199_cov_30.140000	127	198	1	71	71	1.0000000
NODE_301581_length_197_cov_41.265306	0	70	0	70	70	1.0000000
NODE_301611_length_196_cov_101.855670	72	136	88	4	64	0.0625000
NODE_301611_length_196_cov_101.855670	72	136	90	2	64	0.0312500
NODE_301611_length_196_cov_101.855670	72	136	92	2	64	0.0312500
NODE_301611_length_196_cov_101.855670	72	136	94	5	64	0.0781250
NODE_301611_length_196_cov_101.855670	72	136	96	2	64	0.0312500
NODE_301611_length_196_cov_101.855670	72	136	98	1	64	0.0156250
NODE_301611_length_196_cov_101.855670	72	136	99	1	64	0.0156250
NODE_301611_length_196_cov_101.855670	72	136	103	3	64	0.0468750
NODE_301611_length_196_cov_101.855670	72	136	105	3	64	0.0468750
NODE_301611_length_196_cov_101.855670	72	136	107	3	64	0.0468750
NODE_301611_length_196_cov_101.855670	72	136	108	38	64	0.5937500
NODE_301611_length_196_cov_101.855670	72	136	88	4	64	0.0625000
NODE_301611_length_196_cov_101.855670	72	136	90	2	64	0.0312500
NODE_301611_length_196_cov_101.855670	72	136	92	2	64	0.0312500
NODE_301611_length_196_cov_101.855670	72	136	94	5	64	0.0781250
NODE_301611_length_196_cov_101.855670	72	136	96	2	64	0.0312500
NODE_301611_length_196_cov_101.855670	72	136	98	1	64	0.0156250
NODE_301611_length_196_cov_101.855670	72	136	99	1	64	0.0156250
NODE_301611_length_196_cov_101.855670	72	136	103	3	64	0.0468750
NODE_301611_length_196_cov_101.855670	72	136	105	3	64	0.0468750
NODE_301611_length_196_cov_101.855670	72	136	107	3	64	0.0468750
NODE_301611_length_196_cov_101.855670	72	136	108	38	64	0.5937500
NODE_301611_length_196_cov_101.855670	109	169	14	2	60	0.0333333
NODE_301611_length_196_cov_101.855670	109	169	16	6	60	0.1000000
NODE_301611_length_196_cov_101.855670	109	169	17	2	60	0.0333333
NODE_301611_length_196_cov_101.855670	109	169	24	1	60	0.0166667
NODE_301611_length_196_cov_101.855670	109	169	26	1	60	0.0166667
NODE_301611_length_196_cov_101.855670	109	169	36	5	60	0.0833333
NODE_301611_length_196_cov_101.855670	109	169	41	1	60	0.0166667
NODE_301611_length_196_cov_101.855670	109	169	45	1	60	0.0166667
NODE_301611_length_196_cov_101.855670	109	169	47	3	60	0.0500000
NODE_301611_length_196_cov_101.855670	109	169	51	1	60	0.0166667
NODE_301611_length_196_cov_101.855670	109	169	52	1	60	0.0166667
NODE_301611_length_196_cov_101.855670	109	169	58	1	60	0.0166667
NODE_301611_length_196_cov_101.855670	109	169	60	3	60	0.0500000
NODE_301611_length_196_cov_101.855670	109	169	64	1	60	0.0166667
NODE_301611_length_196_cov_101.855670	109	169	66	1	60	0.0166667
NODE_301611_length_196_cov_101.855670	109	169	74	1	60	0.0166667
NODE_301611_length_196_cov_101.855670	109	169	78	2	60	0.0333333
NODE_301611_length_196_cov_101.855670	109	169	88	4	60	0.0666667
NODE_301611_length_196_cov_101.855670	109	169	90	2	60	0.0333333
NODE_301611_length_196_cov_101.855670	109	169	92	2	60	0.0333333
NODE_301611_length_196_cov_101.855670	109	169	94	5	60	0.0833333
NODE_301611_length_196_cov_101.855670	109	169	96	2	60	0.0333333
NODE_301611_length_196_cov_101.855670	109	169	98	1	60	0.0166667
NODE_301611_length_196_cov_101.855670	109	169	99	1	60	0.0166667
NODE_301611_length_196_cov_101.855670	109	169	103	3	60	0.0500000
NODE_301611_length_196_cov_101.855670	109	169	105	3	60	0.0500000
NODE_301611_length_196_cov_101.855670	109	169	107	3	60	0.0500000
NODE_301611_length_196_cov_101.855670	109	169	108	1	60	0.0166667
NODE_301613_length_196_cov_100.618557	129	196	6	1	67	0.0149254
NODE_301613_length_196_cov_100.618557	129	196	8	1	67	0.0149254
NODE_301613_length_196_cov_100.618557	129	196	10	1	67	0.0149254
NODE_301613_length_196_cov_100.618557	129	196	14	1	67	0.0149254
NODE_301613_length_196_cov_100.618557	129	196	18	1	67	0.0149254
NODE_301613_length_196_cov_100.618557	129	196	20	3	67	0.0447761
NODE_301613_length_196_cov_100.618557	129	196	24	2	67	0.0298507
NODE_301613_length_196_cov_100.618557	129	196	26	3	67	0.0447761
NODE_301613_length_196_cov_100.618557	129	196	28	3	67	0.0447761
NODE_301613_length_196_cov_100.618557	129	196	30	4	67	0.0597015
NODE_301613_length_196_cov_100.618557	129	196	31	2	67	0.0298507
NODE_301613_length_196_cov_100.618557	129	196	33	9	67	0.1343284
NODE_301613_length_196_cov_100.618557	129	196	37	2	67	0.0298507
NODE_301613_length_196_cov_100.618557	129	196	40	2	67	0.0298507
NODE_301613_length_196_cov_100.618557	129	196	43	1	67	0.0149254
NODE_301613_length_196_cov_100.618557	129	196	45	1	67	0.0149254
NODE_301613_length_196_cov_100.618557	129	196	47	2	67	0.0298507
NODE_301613_length_196_cov_100.618557	129	196	49	2	67	0.0298507
NODE_301613_length_196_cov_100.618557	129	196	53	1	67	0.0149254
NODE_301613_length_196_cov_100.618557	129	196	54	1	67	0.0149254
NODE_301613_length_196_cov_100.618557	129	196	56	4	67	0.0597015
NODE_301613_length_196_cov_100.618557	129	196	57	4	67	0.0597015
NODE_301613_length_196_cov_100.618557	129	196	58	16	67	0.2388060
NODE_301618_length_196_cov_67.268041	8	88	4	1	80	0.0125000
NODE_301618_length_196_cov_67.268041	8	88	8	4	80	0.0500000
NODE_301618_length_196_cov_67.268041	8	88	11	1	80	0.0125000
NODE_301618_length_196_cov_67.268041	8	88	15	3	80	0.0375000
NODE_301618_length_196_cov_67.268041	8	88	17	3	80	0.0375000
NODE_301618_length_196_cov_67.268041	8	88	18	3	80	0.0375000
NODE_301618_length_196_cov_67.268041	8	88	19	7	80	0.0875000
NODE_301618_length_196_cov_67.268041	8	88	27	10	80	0.1250000
NODE_301618_length_196_cov_67.268041	8	88	29	2	80	0.0250000
NODE_301618_length_196_cov_67.268041	8	88	31	4	80	0.0500000
NODE_301618_length_196_cov_67.268041	8	88	33	5	80	0.0625000
NODE_301618_length_196_cov_67.268041	8	88	42	1	80	0.0125000
NODE_301618_length_196_cov_67.268041	8	88	47	4	80	0.0500000
NODE_301618_length_196_cov_67.268041	8	88	48	1	80	0.0125000
NODE_301618_length_196_cov_67.268041	8	88	50	1	80	0.0125000
NODE_301618_length_196_cov_67.268041	8	88	52	2	80	0.0250000
NODE_301618_length_196_cov_67.268041	8	88	54	1	80	0.0125000
NODE_301618_length_196_cov_67.268041	8	88	58	6	80	0.0750000
NODE_301618_length_196_cov_67.268041	8	88	64	4	80	0.0500000
NODE_301618_length_196_cov_67.268041	8	88	65	9	80	0.1125000
NODE_301618_length_196_cov_67.268041	8	88	66	8	80	0.1000000
NODE_301618_length_196_cov_67.268041	61	124	58	6	63	0.0952381
NODE_301618_length_196_cov_67.268041	61	124	59	1	63	0.0158730
NODE_301618_length_196_cov_67.268041	61	124	61	1	63	0.0158730
NODE_301618_length_196_cov_67.268041	61	124	64	4	63	0.0634921
NODE_301618_length_196_cov_67.268041	61	124	65	43	63	0.6825397
NODE_301618_length_196_cov_67.268041	61	124	66	8	63	0.1269841
NODE_301629_length_196_cov_40.195876	101	184	2	28	83	0.3373494
NODE_301629_length_196_cov_40.195876	101	184	4	13	83	0.1566265
NODE_301629_length_196_cov_40.195876	101	184	6	42	83	0.5060241
NODE_301704_length_194_cov_63.252632	12	78	14	10	66	0.1515152
NODE_301704_length_194_cov_63.252632	12	78	16	2	66	0.0303030
NODE_301704_length_194_cov_63.252632	12	78	22	3	66	0.0454545
NODE_301704_length_194_cov_63.252632	12	78	65	3	66	0.0454545
NODE_301704_length_194_cov_63.252632	12	78	76	3	66	0.0454545
NODE_301704_length_194_cov_63.252632	12	78	80	13	66	0.1969697
NODE_301704_length_194_cov_63.252632	12	78	84	2	66	0.0303030
NODE_301704_length_194_cov_63.252632	12	78	86	3	66	0.0454545
NODE_301704_length_194_cov_63.252632	12	78	88	6	66	0.0909091
NODE_301704_length_194_cov_63.252632	12	78	96	1	66	0.0151515
NODE_301704_length_194_cov_63.252632	12	78	97	1	66	0.0151515
NODE_301704_length_194_cov_63.252632	12	78	103	1	66	0.0151515
NODE_301704_length_194_cov_63.252632	12	78	107	1	66	0.0151515
NODE_301704_length_194_cov_63.252632	12	78	109	2	66	0.0303030
NODE_301704_length_194_cov_63.252632	12	78	111	2	66	0.0303030
NODE_301704_length_194_cov_63.252632	12	78	115	1	66	0.0151515
NODE_301704_length_194_cov_63.252632	12	78	116	1	66	0.0151515
NODE_301704_length_194_cov_63.252632	12	78	118	1	66	0.0151515
NODE_301704_length_194_cov_63.252632	12	78	122	3	66	0.0454545
NODE_301704_length_194_cov_63.252632	12	78	127	2	66	0.0303030
NODE_301704_length_194_cov_63.252632	12	78	131	3	66	0.0454545
NODE_301704_length_194_cov_63.252632	12	78	135	2	66	0.0303030
NODE_301704_length_194_cov_63.252632	51	112	88	6	61	0.0983607
NODE_301704_length_194_cov_63.252632	51	112	96	1	61	0.0163934
NODE_301704_length_194_cov_63.252632	51	112	97	1	61	0.0163934
NODE_301704_length_194_cov_63.252632	51	112	103	1	61	0.0163934
NODE_301704_length_194_cov_63.252632	51	112	107	1	61	0.0163934
NODE_301704_length_194_cov_63.252632	51	112	109	2	61	0.0327869
NODE_301704_length_194_cov_63.252632	51	112	111	2	61	0.0327869
NODE_301704_length_194_cov_63.252632	51	112	115	1	61	0.0163934
NODE_301704_length_194_cov_63.252632	51	112	116	1	61	0.0163934
NODE_301704_length_194_cov_63.252632	51	112	118	1	61	0.0163934
NODE_301704_length_194_cov_63.252632	51	112	122	3	61	0.0491803
NODE_301704_length_194_cov_63.252632	51	112	127	2	61	0.0327869
NODE_301704_length_194_cov_63.252632	51	112	131	3	61	0.0491803
NODE_301704_length_194_cov_63.252632	51	112	135	6	61	0.0983607
NODE_301704_length_194_cov_63.252632	51	112	137	30	61	0.4918033
NODE_301704_length_194_cov_63.252632	51	99	88	6	48	0.1250000
NODE_301704_length_194_cov_63.252632	51	99	96	1	48	0.0208333
NODE_301704_length_194_cov_63.252632	51	99	97	1	48	0.0208333
NODE_301704_length_194_cov_63.252632	51	99	103	1	48	0.0208333
NODE_301704_length_194_cov_63.252632	51	99	107	1	48	0.0208333
NODE_301704_length_194_cov_63.252632	51	99	109	2	48	0.0416667
NODE_301704_length_194_cov_63.252632	51	99	111	2	48	0.0416667
NODE_301704_length_194_cov_63.252632	51	99	115	1	48	0.0208333
NODE_301704_length_194_cov_63.252632	51	99	116	1	48	0.0208333
NODE_301704_length_194_cov_63.252632	51	99	118	1	48	0.0208333
NODE_301704_length_194_cov_63.252632	51	99	122	3	48	0.0625000
NODE_301704_length_194_cov_63.252632	51	99	127	2	48	0.0416667
NODE_301704_length_194_cov_63.252632	51	99	131	3	48	0.0625000
NODE_301704_length_194_cov_63.252632	51	99	135	6	48	0.1250000
NODE_301704_length_194_cov_63.252632	51	99	137	17	48	0.3541667
NODE_301704_length_194_cov_63.252632	51	112	88	6	61	0.0983607
NODE_301704_length_194_cov_63.252632	51	112	96	1	61	0.0163934
NODE_301704_length_194_cov_63.252632	51	112	97	1	61	0.0163934
NODE_301704_length_194_cov_63.252632	51	112	103	1	61	0.0163934
NODE_301704_length_194_cov_63.252632	51	112	107	1	61	0.0163934
NODE_301704_length_194_cov_63.252632	51	112	109	2	61	0.0327869
NODE_301704_length_194_cov_63.252632	51	112	111	2	61	0.0327869
NODE_301704_length_194_cov_63.252632	51	112	115	1	61	0.0163934
NODE_301704_length_194_cov_63.252632	51	112	116	1	61	0.0163934
NODE_301704_length_194_cov_63.252632	51	112	118	1	61	0.0163934
NODE_301704_length_194_cov_63.252632	51	112	122	3	61	0.0491803
NODE_301704_length_194_cov_63.252632	51	112	127	2	61	0.0327869
NODE_301704_length_194_cov_63.252632	51	112	131	3	61	0.0491803
NODE_301704_length_194_cov_63.252632	51	112	135	6	61	0.0983607
NODE_301704_length_194_cov_63.252632	51	112	137	30	61	0.4918033
NODE_301708_length_194_cov_35.010526	95	162	12	1	67	0.0149254
NODE_301708_length_194_cov_35.010526	95	162	14	1	67	0.0149254
NODE_301708_length_194_cov_35.010526	95	162	16	6	67	0.0895522
NODE_301708_length_194_cov_35.010526	95	162	21	2	67	0.0298507
NODE_301708_length_194_cov_35.010526	95	162	23	3	67	0.0447761
NODE_301708_length_194_cov_35.010526	95	162	24	2	67	0.0298507
NODE_301708_length_194_cov_35.010526	95	162	26	8	67	0.1194030
NODE_301708_length_194_cov_35.010526	95	162	28	4	67	0.0597015
NODE_301708_length_194_cov_35.010526	95	162	30	40	67	0.5970149
NODE_301708_length_194_cov_35.010526	95	162	12	1	67	0.0149254
NODE_301708_length_194_cov_35.010526	95	162	14	1	67	0.0149254
NODE_301708_length_194_cov_35.010526	95	162	16	6	67	0.0895522
NODE_301708_length_194_cov_35.010526	95	162	21	2	67	0.0298507
NODE_301708_length_194_cov_35.010526	95	162	23	3	67	0.0447761
NODE_301708_length_194_cov_35.010526	95	162	24	2	67	0.0298507
NODE_301708_length_194_cov_35.010526	95	162	26	8	67	0.1194030
NODE_301708_length_194_cov_35.010526	95	162	28	4	67	0.0597015
NODE_301708_length_194_cov_35.010526	95	162	30	40	67	0.5970149
NODE_301708_length_194_cov_35.010526	135	184	0	9	49	0.1836735
NODE_301708_length_194_cov_35.010526	135	184	4	8	49	0.1632653
NODE_301708_length_194_cov_35.010526	135	184	8	5	49	0.1020408
NODE_301708_length_194_cov_35.010526	135	184	12	1	49	0.0204082
NODE_301708_length_194_cov_35.010526	135	184	14	1	49	0.0204082
NODE_301708_length_194_cov_35.010526	135	184	16	6	49	0.1224490
NODE_301708_length_194_cov_35.010526	135	184	21	2	49	0.0408163
NODE_301708_length_194_cov_35.010526	135	184	23	3	49	0.0612245
NODE_301708_length_194_cov_35.010526	135	184	24	2	49	0.0408163
NODE_301708_length_194_cov_35.010526	135	184	26	8	49	0.1632653
NODE_301708_length_194_cov_35.010526	135	184	28	4	49	0.0816327
NODE_301714_length_194_cov_9.978947	153	194	0	41	41	1.0000000
NODE_301727_length_193_cov_117.170213	21	93	11	6	72	0.0833333
NODE_301727_length_193_cov_117.170213	21	93	12	9	72	0.1250000
NODE_301727_length_193_cov_117.170213	21	93	18	2	72	0.0277778
NODE_301727_length_193_cov_117.170213	21	93	22	1	72	0.0138889
NODE_301727_length_193_cov_117.170213	21	93	24	1	72	0.0138889
NODE_301727_length_193_cov_117.170213	21	93	26	1	72	0.0138889
NODE_301727_length_193_cov_117.170213	21	93	30	2	72	0.0277778
NODE_301727_length_193_cov_117.170213	21	93	34	1	72	0.0138889
NODE_301727_length_193_cov_117.170213	21	93	35	1	72	0.0138889
NODE_301727_length_193_cov_117.170213	21	93	36	1	72	0.0138889
NODE_301727_length_193_cov_117.170213	21	93	38	3	72	0.0416667
NODE_301727_length_193_cov_117.170213	21	93	43	2	72	0.0277778
NODE_301727_length_193_cov_117.170213	21	93	54	1	72	0.0138889
NODE_301727_length_193_cov_117.170213	21	93	56	1	72	0.0138889
NODE_301727_length_193_cov_117.170213	21	93	58	1	72	0.0138889
NODE_301727_length_193_cov_117.170213	21	93	62	6	72	0.0833333
NODE_301727_length_193_cov_117.170213	21	93	66	2	72	0.0277778
NODE_301727_length_193_cov_117.170213	21	93	72	2	72	0.0277778
NODE_301727_length_193_cov_117.170213	21	93	74	4	72	0.0555556
NODE_301727_length_193_cov_117.170213	21	93	76	3	72	0.0416667
NODE_301727_length_193_cov_117.170213	21	93	78	3	72	0.0416667
NODE_301727_length_193_cov_117.170213	21	93	80	1	72	0.0138889
NODE_301727_length_193_cov_117.170213	21	93	82	2	72	0.0277778
NODE_301727_length_193_cov_117.170213	21	93	84	4	72	0.0555556
NODE_301727_length_193_cov_117.170213	21	93	88	12	72	0.1666667
NODE_301727_length_193_cov_117.170213	41	121	30	2	80	0.0250000
NODE_301727_length_193_cov_117.170213	41	121	34	1	80	0.0125000
NODE_301727_length_193_cov_117.170213	41	121	35	1	80	0.0125000
NODE_301727_length_193_cov_117.170213	41	121	36	1	80	0.0125000
NODE_301727_length_193_cov_117.170213	41	121	38	3	80	0.0375000
NODE_301727_length_193_cov_117.170213	41	121	43	2	80	0.0250000
NODE_301727_length_193_cov_117.170213	41	121	54	1	80	0.0125000
NODE_301727_length_193_cov_117.170213	41	121	56	1	80	0.0125000
NODE_301727_length_193_cov_117.170213	41	121	58	1	80	0.0125000
NODE_301727_length_193_cov_117.170213	41	121	62	6	80	0.0750000
NODE_301727_length_193_cov_117.170213	41	121	66	2	80	0.0250000
NODE_301727_length_193_cov_117.170213	41	121	72	2	80	0.0250000
NODE_301727_length_193_cov_117.170213	41	121	74	4	80	0.0500000
NODE_301727_length_193_cov_117.170213	41	121	76	3	80	0.0375000
NODE_301727_length_193_cov_117.170213	41	121	78	3	80	0.0375000
NODE_301727_length_193_cov_117.170213	41	121	80	8	80	0.1000000
NODE_301727_length_193_cov_117.170213	41	121	82	3	80	0.0375000
NODE_301727_length_193_cov_117.170213	41	121	84	4	80	0.0500000
NODE_301727_length_193_cov_117.170213	41	121	86	4	80	0.0500000
NODE_301727_length_193_cov_117.170213	41	121	88	28	80	0.3500000
NODE_301729_length_193_cov_54.734043	108	188	2	4	80	0.0500000
NODE_301729_length_193_cov_54.734043	108	188	4	8	80	0.1000000
NODE_301729_length_193_cov_54.734043	108	188	10	1	80	0.0125000
NODE_301729_length_193_cov_54.734043	108	188	12	1	80	0.0125000
NODE_301729_length_193_cov_54.734043	108	188	14	13	80	0.1625000
NODE_301729_length_193_cov_54.734043	108	188	16	34	80	0.4250000
NODE_301729_length_193_cov_54.734043	108	188	18	19	80	0.2375000
NODE_301729_length_193_cov_54.734043	161	183	4	7	22	0.3181818
NODE_301729_length_193_cov_54.734043	161	183	10	1	22	0.0454545
NODE_301729_length_193_cov_54.734043	161	183	12	1	22	0.0454545
NODE_301729_length_193_cov_54.734043	161	183	14	13	22	0.5909091
NODE_301735_length_193_cov_30.638298	108	188	18	3	80	0.0375000
NODE_301735_length_193_cov_30.638298	108	188	19	1	80	0.0125000
NODE_301735_length_193_cov_30.638298	108	188	21	1	80	0.0125000
NODE_301735_length_193_cov_30.638298	108	188	22	1	80	0.0125000
NODE_301735_length_193_cov_30.638298	108	188	24	2	80	0.0250000
NODE_301735_length_193_cov_30.638298	108	188	26	1	80	0.0125000
NODE_301735_length_193_cov_30.638298	108	188	35	2	80	0.0250000
NODE_301735_length_193_cov_30.638298	108	188	37	4	80	0.0500000
NODE_301735_length_193_cov_30.638298	108	188	47	2	80	0.0250000
NODE_301735_length_193_cov_30.638298	108	188	49	1	80	0.0125000
NODE_301735_length_193_cov_30.638298	108	188	51	1	80	0.0125000
NODE_301735_length_193_cov_30.638298	108	188	52	4	80	0.0500000
NODE_301735_length_193_cov_30.638298	108	188	54	3	80	0.0375000
NODE_301735_length_193_cov_30.638298	108	188	56	8	80	0.1000000
NODE_301735_length_193_cov_30.638298	108	188	58	2	80	0.0250000
NODE_301735_length_193_cov_30.638298	108	188	59	5	80	0.0625000
NODE_301735_length_193_cov_30.638298	108	188	60	16	80	0.2000000
NODE_301735_length_193_cov_30.638298	108	188	62	20	80	0.2500000
NODE_301735_length_193_cov_30.638298	108	188	66	3	80	0.0375000
NODE_301735_length_193_cov_30.638298	161	183	22	1	22	0.0454545
NODE_301735_length_193_cov_30.638298	161	183	24	2	22	0.0909091
NODE_301735_length_193_cov_30.638298	161	183	26	1	22	0.0454545
NODE_301735_length_193_cov_30.638298	161	183	35	2	22	0.0909091
NODE_301735_length_193_cov_30.638298	161	183	37	4	22	0.1818182
NODE_301735_length_193_cov_30.638298	161	183	47	2	22	0.0909091
NODE_301735_length_193_cov_30.638298	161	183	49	1	22	0.0454545
NODE_301735_length_193_cov_30.638298	161	183	51	1	22	0.0454545
NODE_301735_length_193_cov_30.638298	161	183	52	4	22	0.1818182
NODE_301735_length_193_cov_30.638298	161	183	54	3	22	0.1363636
NODE_301735_length_193_cov_30.638298	161	183	56	1	22	0.0454545
NODE_301737_length_193_cov_29.968085	0	45	5	10	45	0.2222222
NODE_301737_length_193_cov_29.968085	0	45	12	10	45	0.2222222
NODE_301737_length_193_cov_29.968085	0	45	14	9	45	0.2000000
NODE_301737_length_193_cov_29.968085	0	45	20	8	45	0.1777778
NODE_301737_length_193_cov_29.968085	0	45	22	1	45	0.0222222
NODE_301737_length_193_cov_29.968085	0	45	28	1	45	0.0222222
NODE_301737_length_193_cov_29.968085	0	45	33	3	45	0.0666667
NODE_301737_length_193_cov_29.968085	0	45	35	1	45	0.0222222
NODE_301737_length_193_cov_29.968085	0	45	37	1	45	0.0222222
NODE_301737_length_193_cov_29.968085	0	45	38	1	45	0.0222222
NODE_301737_length_193_cov_29.968085	8	57	5	2	49	0.0408163
NODE_301737_length_193_cov_29.968085	8	57	12	10	49	0.2040816
NODE_301737_length_193_cov_29.968085	8	57	14	9	49	0.1836735
NODE_301737_length_193_cov_29.968085	8	57	20	8	49	0.1632653
NODE_301737_length_193_cov_29.968085	8	57	22	1	49	0.0204082
NODE_301737_length_193_cov_29.968085	8	57	28	1	49	0.0204082
NODE_301737_length_193_cov_29.968085	8	57	33	3	49	0.0612245
NODE_301737_length_193_cov_29.968085	8	57	35	1	49	0.0204082
NODE_301737_length_193_cov_29.968085	8	57	37	1	49	0.0204082
NODE_301737_length_193_cov_29.968085	8	57	38	3	49	0.0612245
NODE_301737_length_193_cov_29.968085	8	57	62	1	49	0.0204082
NODE_301737_length_193_cov_29.968085	8	57	63	1	49	0.0204082
NODE_301737_length_193_cov_29.968085	8	57	64	1	49	0.0204082
NODE_301737_length_193_cov_29.968085	8	57	74	5	49	0.1020408
NODE_301737_length_193_cov_29.968085	8	57	76	2	49	0.0408163
NODE_301737_length_193_cov_29.968085	30	98	20	7	68	0.1029412
NODE_301737_length_193_cov_29.968085	30	98	22	1	68	0.0147059
NODE_301737_length_193_cov_29.968085	30	98	28	1	68	0.0147059
NODE_301737_length_193_cov_29.968085	30	98	33	3	68	0.0441176
NODE_301737_length_193_cov_29.968085	30	98	35	1	68	0.0147059
NODE_301737_length_193_cov_29.968085	30	98	37	1	68	0.0147059
NODE_301737_length_193_cov_29.968085	30	98	38	3	68	0.0441176
NODE_301737_length_193_cov_29.968085	30	98	62	1	68	0.0147059
NODE_301737_length_193_cov_29.968085	30	98	63	1	68	0.0147059
NODE_301737_length_193_cov_29.968085	30	98	64	1	68	0.0147059
NODE_301737_length_193_cov_29.968085	30	98	74	5	68	0.0735294
NODE_301737_length_193_cov_29.968085	30	98	76	3	68	0.0441176
NODE_301737_length_193_cov_29.968085	30	98	82	12	68	0.1764706
NODE_301737_length_193_cov_29.968085	30	98	88	3	68	0.0441176
NODE_301737_length_193_cov_29.968085	30	98	90	1	68	0.0147059
NODE_301737_length_193_cov_29.968085	30	98	94	6	68	0.0882353
NODE_301737_length_193_cov_29.968085	30	98	96	18	68	0.2647059
NODE_301737_length_193_cov_29.968085	30	98	20	7	68	0.1029412
NODE_301737_length_193_cov_29.968085	30	98	22	1	68	0.0147059
NODE_301737_length_193_cov_29.968085	30	98	28	1	68	0.0147059
NODE_301737_length_193_cov_29.968085	30	98	33	3	68	0.0441176
NODE_301737_length_193_cov_29.968085	30	98	35	1	68	0.0147059
NODE_301737_length_193_cov_29.968085	30	98	37	1	68	0.0147059
NODE_301737_length_193_cov_29.968085	30	98	38	3	68	0.0441176
NODE_301737_length_193_cov_29.968085	30	98	62	1	68	0.0147059
NODE_301737_length_193_cov_29.968085	30	98	63	1	68	0.0147059
NODE_301737_length_193_cov_29.968085	30	98	64	1	68	0.0147059
NODE_301737_length_193_cov_29.968085	30	98	74	5	68	0.0735294
NODE_301737_length_193_cov_29.968085	30	98	76	3	68	0.0441176
NODE_301737_length_193_cov_29.968085	30	98	82	12	68	0.1764706
NODE_301737_length_193_cov_29.968085	30	98	88	3	68	0.0441176
NODE_301737_length_193_cov_29.968085	30	98	90	1	68	0.0147059
NODE_301737_length_193_cov_29.968085	30	98	94	6	68	0.0882353
NODE_301737_length_193_cov_29.968085	30	98	96	18	68	0.2647059
NODE_301737_length_193_cov_29.968085	30	98	20	7	68	0.1029412
NODE_301737_length_193_cov_29.968085	30	98	22	1	68	0.0147059
NODE_301737_length_193_cov_29.968085	30	98	28	1	68	0.0147059
NODE_301737_length_193_cov_29.968085	30	98	33	3	68	0.0441176
NODE_301737_length_193_cov_29.968085	30	98	35	1	68	0.0147059
NODE_301737_length_193_cov_29.968085	30	98	37	1	68	0.0147059
NODE_301737_length_193_cov_29.968085	30	98	38	3	68	0.0441176
NODE_301737_length_193_cov_29.968085	30	98	62	1	68	0.0147059
NODE_301737_length_193_cov_29.968085	30	98	63	1	68	0.0147059
NODE_301737_length_193_cov_29.968085	30	98	64	1	68	0.0147059
NODE_301737_length_193_cov_29.968085	30	98	74	5	68	0.0735294
NODE_301737_length_193_cov_29.968085	30	98	76	3	68	0.0441176
NODE_301737_length_193_cov_29.968085	30	98	82	12	68	0.1764706
NODE_301737_length_193_cov_29.968085	30	98	88	3	68	0.0441176
NODE_301737_length_193_cov_29.968085	30	98	90	1	68	0.0147059
NODE_301737_length_193_cov_29.968085	30	98	94	6	68	0.0882353
NODE_301737_length_193_cov_29.968085	30	98	96	18	68	0.2647059
NODE_301737_length_193_cov_29.968085	146	188	7	3	42	0.0714286
NODE_301737_length_193_cov_29.968085	146	188	11	5	42	0.1190476
NODE_301737_length_193_cov_29.968085	146	188	21	2	42	0.0476190
NODE_301737_length_193_cov_29.968085	146	188	31	7	42	0.1666667
NODE_301737_length_193_cov_29.968085	146	188	33	6	42	0.1428571
NODE_301737_length_193_cov_29.968085	146	188	35	1	42	0.0238095
NODE_301737_length_193_cov_29.968085	146	188	37	18	42	0.4285714
NODE_301776_length_192_cov_160.258065	0	76	8	1	76	0.0131579
NODE_301776_length_192_cov_160.258065	0	76	12	1	76	0.0131579
NODE_301776_length_192_cov_160.258065	0	76	16	2	76	0.0263158
NODE_301776_length_192_cov_160.258065	0	76	18	1	76	0.0131579
NODE_301776_length_192_cov_160.258065	0	76	20	2	76	0.0263158
NODE_301776_length_192_cov_160.258065	0	76	25	1	76	0.0131579
NODE_301776_length_192_cov_160.258065	0	76	27	1	76	0.0131579
NODE_301776_length_192_cov_160.258065	0	76	29	1	76	0.0131579
NODE_301776_length_192_cov_160.258065	0	76	35	1	76	0.0131579
NODE_301776_length_192_cov_160.258065	0	76	39	1	76	0.0131579
NODE_301776_length_192_cov_160.258065	0	76	43	1	76	0.0131579
NODE_301776_length_192_cov_160.258065	0	76	46	9	76	0.1184211
NODE_301776_length_192_cov_160.258065	0	76	48	3	76	0.0394737
NODE_301776_length_192_cov_160.258065	0	76	54	6	76	0.0789474
NODE_301776_length_192_cov_160.258065	0	76	56	1	76	0.0131579
NODE_301776_length_192_cov_160.258065	0	76	58	4	76	0.0526316
NODE_301776_length_192_cov_160.258065	0	76	60	1	76	0.0131579
NODE_301776_length_192_cov_160.258065	0	76	62	1	76	0.0131579
NODE_301776_length_192_cov_160.258065	0	76	68	2	76	0.0263158
NODE_301776_length_192_cov_160.258065	0	76	70	3	76	0.0394737
NODE_301776_length_192_cov_160.258065	0	76	74	1	76	0.0131579
NODE_301776_length_192_cov_160.258065	0	76	80	2	76	0.0263158
NODE_301776_length_192_cov_160.258065	0	76	82	3	76	0.0394737
NODE_301776_length_192_cov_160.258065	0	76	84	1	76	0.0131579
NODE_301776_length_192_cov_160.258065	0	76	88	1	76	0.0131579
NODE_301776_length_192_cov_160.258065	0	76	90	1	76	0.0131579
NODE_301776_length_192_cov_160.258065	0	76	100	1	76	0.0131579
NODE_301776_length_192_cov_160.258065	0	76	101	1	76	0.0131579
NODE_301776_length_192_cov_160.258065	0	76	109	1	76	0.0131579
NODE_301776_length_192_cov_160.258065	0	76	114	1	76	0.0131579
NODE_301776_length_192_cov_160.258065	0	76	116	3	76	0.0394737
NODE_301776_length_192_cov_160.258065	0	76	118	1	76	0.0131579
NODE_301776_length_192_cov_160.258065	0	76	120	1	76	0.0131579
NODE_301776_length_192_cov_160.258065	0	76	126	1	76	0.0131579
NODE_301776_length_192_cov_160.258065	0	76	128	3	76	0.0394737
NODE_301776_length_192_cov_160.258065	0	76	136	1	76	0.0131579
NODE_301776_length_192_cov_160.258065	0	76	142	1	76	0.0131579
NODE_301776_length_192_cov_160.258065	0	76	152	2	76	0.0263158
NODE_301776_length_192_cov_160.258065	0	76	156	4	76	0.0526316
NODE_301776_length_192_cov_160.258065	0	76	163	1	76	0.0131579
NODE_301776_length_192_cov_160.258065	0	76	168	2	76	0.0263158
NODE_301825_length_191_cov_92.913043	81	144	6	63	63	1.0000000
NODE_301855_length_190_cov_112.285714	8	91	0	83	83	1.0000000
NODE_301859_length_190_cov_41.373626	92	172	14	7	80	0.0875000
NODE_301859_length_190_cov_41.373626	92	172	15	6	80	0.0750000
NODE_301859_length_190_cov_41.373626	92	172	17	6	80	0.0750000
NODE_301859_length_190_cov_41.373626	92	172	19	2	80	0.0250000
NODE_301859_length_190_cov_41.373626	92	172	20	2	80	0.0250000
NODE_301859_length_190_cov_41.373626	92	172	24	1	80	0.0125000
NODE_301859_length_190_cov_41.373626	92	172	25	5	80	0.0625000
NODE_301859_length_190_cov_41.373626	92	172	28	2	80	0.0250000
NODE_301859_length_190_cov_41.373626	92	172	30	8	80	0.1000000
NODE_301859_length_190_cov_41.373626	92	172	32	1	80	0.0125000
NODE_301859_length_190_cov_41.373626	92	172	35	5	80	0.0625000
NODE_301859_length_190_cov_41.373626	92	172	36	13	80	0.1625000
NODE_301859_length_190_cov_41.373626	92	172	38	1	80	0.0125000
NODE_301859_length_190_cov_41.373626	92	172	42	1	80	0.0125000
NODE_301859_length_190_cov_41.373626	92	172	44	6	80	0.0750000
NODE_301859_length_190_cov_41.373626	92	172	46	14	80	0.1750000
NODE_301859_length_190_cov_41.373626	145	190	0	11	45	0.2444444
NODE_301859_length_190_cov_41.373626	145	190	4	1	45	0.0222222
NODE_301859_length_190_cov_41.373626	145	190	8	1	45	0.0222222
NODE_301859_length_190_cov_41.373626	145	190	10	1	45	0.0222222
NODE_301859_length_190_cov_41.373626	145	190	12	3	45	0.0666667
NODE_301859_length_190_cov_41.373626	145	190	14	8	45	0.1777778
NODE_301859_length_190_cov_41.373626	145	190	15	6	45	0.1333333
NODE_301859_length_190_cov_41.373626	145	190	17	6	45	0.1333333
NODE_301859_length_190_cov_41.373626	145	190	19	2	45	0.0444444
NODE_301859_length_190_cov_41.373626	145	190	20	2	45	0.0444444
NODE_301859_length_190_cov_41.373626	145	190	24	1	45	0.0222222
NODE_301859_length_190_cov_41.373626	145	190	25	3	45	0.0666667
NODE_301880_length_189_cov_234.500000	19	88	0	39	69	0.5652174
NODE_301880_length_189_cov_234.500000	19	88	2	30	69	0.4347826
NODE_301882_length_189_cov_192.211111	134	186	0	1	52	0.0192308
NODE_301882_length_189_cov_192.211111	134	186	2	1	52	0.0192308
NODE_301882_length_189_cov_192.211111	134	186	4	7	52	0.1346154
NODE_301882_length_189_cov_192.211111	134	186	8	1	52	0.0192308
NODE_301882_length_189_cov_192.211111	134	186	14	3	52	0.0576923
NODE_301882_length_189_cov_192.211111	134	186	19	3	52	0.0576923
NODE_301882_length_189_cov_192.211111	134	186	20	6	52	0.1153846
NODE_301882_length_189_cov_192.211111	134	186	21	1	52	0.0192308
NODE_301882_length_189_cov_192.211111	134	186	26	2	52	0.0384615
NODE_301882_length_189_cov_192.211111	134	186	28	4	52	0.0769231
NODE_301882_length_189_cov_192.211111	134	186	29	1	52	0.0192308
NODE_301882_length_189_cov_192.211111	134	186	30	10	52	0.1923077
NODE_301882_length_189_cov_192.211111	134	186	32	7	52	0.1346154
NODE_301882_length_189_cov_192.211111	134	186	34	2	52	0.0384615
NODE_301882_length_189_cov_192.211111	134	186	40	2	52	0.0384615
NODE_301882_length_189_cov_192.211111	134	186	43	1	52	0.0192308
NODE_301885_length_189_cov_70.600000	19	88	0	69	69	1.0000000
NODE_301885_length_189_cov_70.600000	72	156	0	84	84	1.0000000
NODE_301886_length_189_cov_63.455556	70	150	91	1	80	0.0125000
NODE_301886_length_189_cov_63.455556	70	150	94	1	80	0.0125000
NODE_301886_length_189_cov_63.455556	70	150	95	1	80	0.0125000
NODE_301886_length_189_cov_63.455556	70	150	97	1	80	0.0125000
NODE_301886_length_189_cov_63.455556	70	150	111	4	80	0.0500000
NODE_301886_length_189_cov_63.455556	70	150	113	3	80	0.0375000
NODE_301886_length_189_cov_63.455556	70	150	121	1	80	0.0125000
NODE_301886_length_189_cov_63.455556	70	150	123	3	80	0.0375000
NODE_301886_length_189_cov_63.455556	70	150	125	2	80	0.0250000
NODE_301886_length_189_cov_63.455556	70	150	127	2	80	0.0250000
NODE_301886_length_189_cov_63.455556	70	150	129	2	80	0.0250000
NODE_301886_length_189_cov_63.455556	70	150	131	1	80	0.0125000
NODE_301886_length_189_cov_63.455556	70	150	153	1	80	0.0125000
NODE_301886_length_189_cov_63.455556	70	150	155	1	80	0.0125000
NODE_301886_length_189_cov_63.455556	70	150	166	2	80	0.0250000
NODE_301886_length_189_cov_63.455556	70	150	168	3	80	0.0375000
NODE_301886_length_189_cov_63.455556	70	150	172	3	80	0.0375000
NODE_301886_length_189_cov_63.455556	70	150	175	1	80	0.0125000
NODE_301886_length_189_cov_63.455556	70	150	177	1	80	0.0125000
NODE_301886_length_189_cov_63.455556	70	150	179	1	80	0.0125000
NODE_301886_length_189_cov_63.455556	70	150	181	1	80	0.0125000
NODE_301886_length_189_cov_63.455556	70	150	183	1	80	0.0125000
NODE_301886_length_189_cov_63.455556	70	150	187	1	80	0.0125000
NODE_301886_length_189_cov_63.455556	70	150	190	1	80	0.0125000
NODE_301886_length_189_cov_63.455556	70	150	191	2	80	0.0250000
NODE_301886_length_189_cov_63.455556	70	150	195	1	80	0.0125000
NODE_301886_length_189_cov_63.455556	70	150	201	4	80	0.0500000
NODE_301886_length_189_cov_63.455556	70	150	203	2	80	0.0250000
NODE_301886_length_189_cov_63.455556	70	150	205	2	80	0.0250000
NODE_301886_length_189_cov_63.455556	70	150	206	2	80	0.0250000
NODE_301886_length_189_cov_63.455556	70	150	207	1	80	0.0125000
NODE_301886_length_189_cov_63.455556	70	150	210	2	80	0.0250000
NODE_301886_length_189_cov_63.455556	70	150	211	8	80	0.1000000
NODE_301886_length_189_cov_63.455556	70	150	213	17	80	0.2125000
NODE_301886_length_189_cov_63.455556	70	141	113	2	71	0.0281690
NODE_301886_length_189_cov_63.455556	70	141	121	1	71	0.0140845
NODE_301886_length_189_cov_63.455556	70	141	123	3	71	0.0422535
NODE_301886_length_189_cov_63.455556	70	141	125	2	71	0.0281690
NODE_301886_length_189_cov_63.455556	70	141	127	2	71	0.0281690
NODE_301886_length_189_cov_63.455556	70	141	129	2	71	0.0281690
NODE_301886_length_189_cov_63.455556	70	141	131	1	71	0.0140845
NODE_301886_length_189_cov_63.455556	70	141	153	1	71	0.0140845
NODE_301886_length_189_cov_63.455556	70	141	155	1	71	0.0140845
NODE_301886_length_189_cov_63.455556	70	141	166	2	71	0.0281690
NODE_301886_length_189_cov_63.455556	70	141	168	3	71	0.0422535
NODE_301886_length_189_cov_63.455556	70	141	172	3	71	0.0422535
NODE_301886_length_189_cov_63.455556	70	141	175	1	71	0.0140845
NODE_301886_length_189_cov_63.455556	70	141	177	1	71	0.0140845
NODE_301886_length_189_cov_63.455556	70	141	179	1	71	0.0140845
NODE_301886_length_189_cov_63.455556	70	141	181	1	71	0.0140845
NODE_301886_length_189_cov_63.455556	70	141	183	1	71	0.0140845
NODE_301886_length_189_cov_63.455556	70	141	187	1	71	0.0140845
NODE_301886_length_189_cov_63.455556	70	141	190	1	71	0.0140845
NODE_301886_length_189_cov_63.455556	70	141	191	2	71	0.0281690
NODE_301886_length_189_cov_63.455556	70	141	195	1	71	0.0140845
NODE_301886_length_189_cov_63.455556	70	141	201	4	71	0.0563380
NODE_301886_length_189_cov_63.455556	70	141	203	2	71	0.0281690
NODE_301886_length_189_cov_63.455556	70	141	205	2	71	0.0281690
NODE_301886_length_189_cov_63.455556	70	141	206	2	71	0.0281690
NODE_301886_length_189_cov_63.455556	70	141	207	1	71	0.0140845
NODE_301886_length_189_cov_63.455556	70	141	210	2	71	0.0281690
NODE_301886_length_189_cov_63.455556	70	141	211	8	71	0.1126761
NODE_301886_length_189_cov_63.455556	70	141	213	17	71	0.2394366
NODE_301891_length_189_cov_43.600000	0	73	14	1	73	0.0136986
NODE_301891_length_189_cov_43.600000	0	73	19	3	73	0.0410959
NODE_301891_length_189_cov_43.600000	0	73	21	2	73	0.0273973
NODE_301891_length_189_cov_43.600000	0	73	24	1	73	0.0136986
NODE_301891_length_189_cov_43.600000	0	73	26	1	73	0.0136986
NODE_301891_length_189_cov_43.600000	0	73	30	7	73	0.0958904
NODE_301891_length_189_cov_43.600000	0	73	33	2	73	0.0273973
NODE_301891_length_189_cov_43.600000	0	73	34	1	73	0.0136986
NODE_301891_length_189_cov_43.600000	0	73	38	2	73	0.0273973
NODE_301891_length_189_cov_43.600000	0	73	42	3	73	0.0410959
NODE_301891_length_189_cov_43.600000	0	73	44	4	73	0.0547945
NODE_301891_length_189_cov_43.600000	0	73	46	2	73	0.0273973
NODE_301891_length_189_cov_43.600000	0	73	48	2	73	0.0273973
NODE_301891_length_189_cov_43.600000	0	73	49	1	73	0.0136986
NODE_301891_length_189_cov_43.600000	0	73	50	7	73	0.0958904
NODE_301891_length_189_cov_43.600000	0	73	54	4	73	0.0547945
NODE_301891_length_189_cov_43.600000	0	73	58	2	73	0.0273973
NODE_301891_length_189_cov_43.600000	0	73	59	1	73	0.0136986
NODE_301891_length_189_cov_43.600000	0	73	61	2	73	0.0273973
NODE_301891_length_189_cov_43.600000	0	73	63	2	73	0.0273973
NODE_301891_length_189_cov_43.600000	0	73	66	9	73	0.1232877
NODE_301891_length_189_cov_43.600000	0	73	68	2	73	0.0273973
NODE_301891_length_189_cov_43.600000	0	73	70	1	73	0.0136986
NODE_301891_length_189_cov_43.600000	0	73	72	1	73	0.0136986
NODE_301891_length_189_cov_43.600000	0	73	77	10	73	0.1369863
NODE_301940_length_188_cov_2021.561798	108	188	19	2	80	0.0250000
NODE_301940_length_188_cov_2021.561798	108	188	40	1	80	0.0125000
NODE_301940_length_188_cov_2021.561798	108	188	46	1	80	0.0125000
NODE_301940_length_188_cov_2021.561798	108	188	55	1	80	0.0125000
NODE_301940_length_188_cov_2021.561798	108	188	68	1	80	0.0125000
NODE_301940_length_188_cov_2021.561798	108	188	131	2	80	0.0250000
NODE_301940_length_188_cov_2021.561798	108	188	132	1	80	0.0125000
NODE_301940_length_188_cov_2021.561798	108	188	138	1	80	0.0125000
NODE_301940_length_188_cov_2021.561798	108	188	151	1	80	0.0125000
NODE_301940_length_188_cov_2021.561798	108	188	159	1	80	0.0125000
NODE_301940_length_188_cov_2021.561798	108	188	165	1	80	0.0125000
NODE_301940_length_188_cov_2021.561798	108	188	168	3	80	0.0375000
NODE_301940_length_188_cov_2021.561798	108	188	170	1	80	0.0125000
NODE_301940_length_188_cov_2021.561798	108	188	172	1	80	0.0125000
NODE_301940_length_188_cov_2021.561798	108	188	176	1	80	0.0125000
NODE_301940_length_188_cov_2021.561798	108	188	177	3	80	0.0375000
NODE_301940_length_188_cov_2021.561798	108	188	178	1	80	0.0125000
NODE_301940_length_188_cov_2021.561798	108	188	182	1	80	0.0125000
NODE_301940_length_188_cov_2021.561798	108	188	200	3	80	0.0375000
NODE_301940_length_188_cov_2021.561798	108	188	206	1	80	0.0125000
NODE_301940_length_188_cov_2021.561798	108	188	218	1	80	0.0125000
NODE_301940_length_188_cov_2021.561798	108	188	220	1	80	0.0125000
NODE_301940_length_188_cov_2021.561798	108	188	223	1	80	0.0125000
NODE_301940_length_188_cov_2021.561798	108	188	228	1	80	0.0125000
NODE_301940_length_188_cov_2021.561798	108	188	230	2	80	0.0250000
NODE_301940_length_188_cov_2021.561798	108	188	233	1	80	0.0125000
NODE_301940_length_188_cov_2021.561798	108	188	239	1	80	0.0125000
NODE_301940_length_188_cov_2021.561798	108	188	244	1	80	0.0125000
NODE_301940_length_188_cov_2021.561798	108	188	245	1	80	0.0125000
NODE_301940_length_188_cov_2021.561798	108	188	247	1	80	0.0125000
NODE_301940_length_188_cov_2021.561798	108	188	249	1	80	0.0125000
NODE_301940_length_188_cov_2021.561798	108	188	258	1	80	0.0125000
NODE_301940_length_188_cov_2021.561798	108	188	263	1	80	0.0125000
NODE_301940_length_188_cov_2021.561798	108	188	267	1	80	0.0125000
NODE_301940_length_188_cov_2021.561798	108	188	273	1	80	0.0125000
NODE_301940_length_188_cov_2021.561798	108	188	285	3	80	0.0375000
NODE_301940_length_188_cov_2021.561798	108	188	287	2	80	0.0250000
NODE_301940_length_188_cov_2021.561798	108	188	292	1	80	0.0125000
NODE_301940_length_188_cov_2021.561798	108	188	294	1	80	0.0125000
NODE_301940_length_188_cov_2021.561798	108	188	296	1	80	0.0125000
NODE_301940_length_188_cov_2021.561798	108	188	298	1	80	0.0125000
NODE_301940_length_188_cov_2021.561798	108	188	299	1	80	0.0125000
NODE_301940_length_188_cov_2021.561798	108	188	301	1	80	0.0125000
NODE_301940_length_188_cov_2021.561798	108	188	305	1	80	0.0125000
NODE_301940_length_188_cov_2021.561798	108	188	308	1	80	0.0125000
NODE_301940_length_188_cov_2021.561798	108	188	314	1	80	0.0125000
NODE_301940_length_188_cov_2021.561798	108	188	316	3	80	0.0375000
NODE_301940_length_188_cov_2021.561798	108	188	318	1	80	0.0125000
NODE_301940_length_188_cov_2021.561798	108	188	320	3	80	0.0375000
NODE_301940_length_188_cov_2021.561798	108	188	323	1	80	0.0125000
NODE_301940_length_188_cov_2021.561798	108	188	327	1	80	0.0125000
NODE_301940_length_188_cov_2021.561798	108	188	328	7	80	0.0875000
NODE_301940_length_188_cov_2021.561798	108	188	330	5	80	0.0625000
NODE_301940_length_188_cov_2021.561798	108	188	332	1	80	0.0125000
NODE_301940_length_188_cov_2021.561798	161	183	68	1	22	0.0454545
NODE_301940_length_188_cov_2021.561798	161	183	131	2	22	0.0909091
NODE_301940_length_188_cov_2021.561798	161	183	132	1	22	0.0454545
NODE_301940_length_188_cov_2021.561798	161	183	138	1	22	0.0454545
NODE_301940_length_188_cov_2021.561798	161	183	151	1	22	0.0454545
NODE_301940_length_188_cov_2021.561798	161	183	159	1	22	0.0454545
NODE_301940_length_188_cov_2021.561798	161	183	165	1	22	0.0454545
NODE_301940_length_188_cov_2021.561798	161	183	168	3	22	0.1363636
NODE_301940_length_188_cov_2021.561798	161	183	170	1	22	0.0454545
NODE_301940_length_188_cov_2021.561798	161	183	172	1	22	0.0454545
NODE_301940_length_188_cov_2021.561798	161	183	176	1	22	0.0454545
NODE_301940_length_188_cov_2021.561798	161	183	177	3	22	0.1363636
NODE_301940_length_188_cov_2021.561798	161	183	178	1	22	0.0454545
NODE_301940_length_188_cov_2021.561798	161	183	182	1	22	0.0454545
NODE_301940_length_188_cov_2021.561798	161	183	200	3	22	0.1363636
NODE_301952_length_188_cov_37.988764	0	50	6	10	50	0.2000000
NODE_301952_length_188_cov_37.988764	0	50	8	11	50	0.2200000
NODE_301952_length_188_cov_37.988764	0	50	12	5	50	0.1000000
NODE_301952_length_188_cov_37.988764	0	50	14	10	50	0.2000000
NODE_301952_length_188_cov_37.988764	0	50	16	5	50	0.1000000
NODE_301952_length_188_cov_37.988764	0	50	18	1	50	0.0200000
NODE_301952_length_188_cov_37.988764	0	50	20	4	50	0.0800000
NODE_301952_length_188_cov_37.988764	0	50	22	3	50	0.0600000
NODE_301952_length_188_cov_37.988764	0	50	24	1	50	0.0200000
NODE_301980_length_187_cov_71.170455	124	155	14	3	31	0.0967742
NODE_301980_length_187_cov_71.170455	124	155	16	19	31	0.6129032
NODE_301980_length_187_cov_71.170455	124	155	22	9	31	0.2903226
NODE_301981_length_187_cov_56.000000	72	136	118	3	64	0.0468750
NODE_301981_length_187_cov_56.000000	72	136	122	2	64	0.0312500
NODE_301981_length_187_cov_56.000000	72	136	123	1	64	0.0156250
NODE_301981_length_187_cov_56.000000	72	136	125	3	64	0.0468750
NODE_301981_length_187_cov_56.000000	72	136	129	1	64	0.0156250
NODE_301981_length_187_cov_56.000000	72	136	135	1	64	0.0156250
NODE_301981_length_187_cov_56.000000	72	136	142	1	64	0.0156250
NODE_301981_length_187_cov_56.000000	72	136	143	2	64	0.0312500
NODE_301981_length_187_cov_56.000000	72	136	144	2	64	0.0312500
NODE_301981_length_187_cov_56.000000	72	136	146	2	64	0.0312500
NODE_301981_length_187_cov_56.000000	72	136	147	1	64	0.0156250
NODE_301981_length_187_cov_56.000000	72	136	148	2	64	0.0312500
NODE_301981_length_187_cov_56.000000	72	136	152	5	64	0.0781250
NODE_301981_length_187_cov_56.000000	72	136	153	3	64	0.0468750
NODE_301981_length_187_cov_56.000000	72	136	154	2	64	0.0312500
NODE_301981_length_187_cov_56.000000	72	136	155	22	64	0.3437500
NODE_301981_length_187_cov_56.000000	72	136	156	11	64	0.1718750
NODE_301981_length_187_cov_56.000000	72	136	118	3	64	0.0468750
NODE_301981_length_187_cov_56.000000	72	136	122	2	64	0.0312500
NODE_301981_length_187_cov_56.000000	72	136	123	1	64	0.0156250
NODE_301981_length_187_cov_56.000000	72	136	125	3	64	0.0468750
NODE_301981_length_187_cov_56.000000	72	136	129	1	64	0.0156250
NODE_301981_length_187_cov_56.000000	72	136	135	1	64	0.0156250
NODE_301981_length_187_cov_56.000000	72	136	142	1	64	0.0156250
NODE_301981_length_187_cov_56.000000	72	136	143	2	64	0.0312500
NODE_301981_length_187_cov_56.000000	72	136	144	2	64	0.0312500
NODE_301981_length_187_cov_56.000000	72	136	146	2	64	0.0312500
NODE_301981_length_187_cov_56.000000	72	136	147	1	64	0.0156250
NODE_301981_length_187_cov_56.000000	72	136	148	2	64	0.0312500
NODE_301981_length_187_cov_56.000000	72	136	152	5	64	0.0781250
NODE_301981_length_187_cov_56.000000	72	136	153	3	64	0.0468750
NODE_301981_length_187_cov_56.000000	72	136	154	2	64	0.0312500
NODE_301981_length_187_cov_56.000000	72	136	155	22	64	0.3437500
NODE_301981_length_187_cov_56.000000	72	136	156	11	64	0.1718750
NODE_301981_length_187_cov_56.000000	109	175	35	1	66	0.0151515
NODE_301981_length_187_cov_56.000000	109	175	37	2	66	0.0303030
NODE_301981_length_187_cov_56.000000	109	175	39	1	66	0.0151515
NODE_301981_length_187_cov_56.000000	109	175	40	2	66	0.0303030
NODE_301981_length_187_cov_56.000000	109	175	42	1	66	0.0151515
NODE_301981_length_187_cov_56.000000	109	175	44	1	66	0.0151515
NODE_301981_length_187_cov_56.000000	109	175	45	4	66	0.0606061
NODE_301981_length_187_cov_56.000000	109	175	49	4	66	0.0606061
NODE_301981_length_187_cov_56.000000	109	175	51	1	66	0.0151515
NODE_301981_length_187_cov_56.000000	109	175	55	1	66	0.0151515
NODE_301981_length_187_cov_56.000000	109	175	63	1	66	0.0151515
NODE_301981_length_187_cov_56.000000	109	175	67	1	66	0.0151515
NODE_301981_length_187_cov_56.000000	109	175	69	3	66	0.0454545
NODE_301981_length_187_cov_56.000000	109	175	76	1	66	0.0151515
NODE_301981_length_187_cov_56.000000	109	175	78	1	66	0.0151515
NODE_301981_length_187_cov_56.000000	109	175	82	1	66	0.0151515
NODE_301981_length_187_cov_56.000000	109	175	84	2	66	0.0303030
NODE_301981_length_187_cov_56.000000	109	175	97	1	66	0.0151515
NODE_301981_length_187_cov_56.000000	109	175	103	1	66	0.0151515
NODE_301981_length_187_cov_56.000000	109	175	109	1	66	0.0151515
NODE_301981_length_187_cov_56.000000	109	175	111	1	66	0.0151515
NODE_301981_length_187_cov_56.000000	109	175	113	2	66	0.0303030
NODE_301981_length_187_cov_56.000000	109	175	114	4	66	0.0606061
NODE_301981_length_187_cov_56.000000	109	175	116	1	66	0.0151515
NODE_301981_length_187_cov_56.000000	109	175	118	3	66	0.0454545
NODE_301981_length_187_cov_56.000000	109	175	122	2	66	0.0303030
NODE_301981_length_187_cov_56.000000	109	175	123	1	66	0.0151515
NODE_301981_length_187_cov_56.000000	109	175	125	3	66	0.0454545
NODE_301981_length_187_cov_56.000000	109	175	129	1	66	0.0151515
NODE_301981_length_187_cov_56.000000	109	175	135	1	66	0.0151515
NODE_301981_length_187_cov_56.000000	109	175	143	2	66	0.0303030
NODE_301981_length_187_cov_56.000000	109	175	144	1	66	0.0151515
NODE_301981_length_187_cov_56.000000	109	175	146	2	66	0.0303030
NODE_301981_length_187_cov_56.000000	109	175	147	1	66	0.0151515
NODE_301981_length_187_cov_56.000000	109	175	153	3	66	0.0454545
NODE_301981_length_187_cov_56.000000	109	175	155	7	66	0.1060606
NODE_301981_length_187_cov_56.000000	109	180	23	1	71	0.0140845
NODE_301981_length_187_cov_56.000000	109	180	29	1	71	0.0140845
NODE_301981_length_187_cov_56.000000	109	180	31	1	71	0.0140845
NODE_301981_length_187_cov_56.000000	109	180	32	1	71	0.0140845
NODE_301981_length_187_cov_56.000000	109	180	35	2	71	0.0281690
NODE_301981_length_187_cov_56.000000	109	180	37	2	71	0.0281690
NODE_301981_length_187_cov_56.000000	109	180	39	1	71	0.0140845
NODE_301981_length_187_cov_56.000000	109	180	40	2	71	0.0281690
NODE_301981_length_187_cov_56.000000	109	180	42	1	71	0.0140845
NODE_301981_length_187_cov_56.000000	109	180	44	1	71	0.0140845
NODE_301981_length_187_cov_56.000000	109	180	45	4	71	0.0563380
NODE_301981_length_187_cov_56.000000	109	180	49	4	71	0.0563380
NODE_301981_length_187_cov_56.000000	109	180	51	1	71	0.0140845
NODE_301981_length_187_cov_56.000000	109	180	55	1	71	0.0140845
NODE_301981_length_187_cov_56.000000	109	180	63	1	71	0.0140845
NODE_301981_length_187_cov_56.000000	109	180	67	1	71	0.0140845
NODE_301981_length_187_cov_56.000000	109	180	69	3	71	0.0422535
NODE_301981_length_187_cov_56.000000	109	180	76	1	71	0.0140845
NODE_301981_length_187_cov_56.000000	109	180	78	1	71	0.0140845
NODE_301981_length_187_cov_56.000000	109	180	82	1	71	0.0140845
NODE_301981_length_187_cov_56.000000	109	180	84	2	71	0.0281690
NODE_301981_length_187_cov_56.000000	109	180	97	1	71	0.0140845
NODE_301981_length_187_cov_56.000000	109	180	103	1	71	0.0140845
NODE_301981_length_187_cov_56.000000	109	180	109	1	71	0.0140845
NODE_301981_length_187_cov_56.000000	109	180	111	1	71	0.0140845
NODE_301981_length_187_cov_56.000000	109	180	113	2	71	0.0281690
NODE_301981_length_187_cov_56.000000	109	180	114	4	71	0.0563380
NODE_301981_length_187_cov_56.000000	109	180	116	1	71	0.0140845
NODE_301981_length_187_cov_56.000000	109	180	118	3	71	0.0422535
NODE_301981_length_187_cov_56.000000	109	180	122	2	71	0.0281690
NODE_301981_length_187_cov_56.000000	109	180	123	1	71	0.0140845
NODE_301981_length_187_cov_56.000000	109	180	125	3	71	0.0422535
NODE_301981_length_187_cov_56.000000	109	180	129	1	71	0.0140845
NODE_301981_length_187_cov_56.000000	109	180	135	1	71	0.0140845
NODE_301981_length_187_cov_56.000000	109	180	143	2	71	0.0281690
NODE_301981_length_187_cov_56.000000	109	180	144	1	71	0.0140845
NODE_301981_length_187_cov_56.000000	109	180	146	2	71	0.0281690
NODE_301981_length_187_cov_56.000000	109	180	147	1	71	0.0140845
NODE_301981_length_187_cov_56.000000	109	180	153	3	71	0.0422535
NODE_301981_length_187_cov_56.000000	109	180	155	7	71	0.0985916
NODE_301986_length_187_cov_37.397727	4	57	2	20	53	0.3773585
NODE_301986_length_187_cov_37.397727	4	57	8	4	53	0.0754717
NODE_301986_length_187_cov_37.397727	4	57	10	2	53	0.0377358
NODE_301986_length_187_cov_37.397727	4	57	14	2	53	0.0377358
NODE_301986_length_187_cov_37.397727	4	57	16	1	53	0.0188679
NODE_301986_length_187_cov_37.397727	4	57	18	2	53	0.0377358
NODE_301986_length_187_cov_37.397727	4	57	20	4	53	0.0754717
NODE_301986_length_187_cov_37.397727	4	57	23	1	53	0.0188679
NODE_301986_length_187_cov_37.397727	4	57	24	1	53	0.0188679
NODE_301986_length_187_cov_37.397727	4	57	26	1	53	0.0188679
NODE_301986_length_187_cov_37.397727	4	57	32	2	53	0.0377358
NODE_301986_length_187_cov_37.397727	4	57	36	1	53	0.0188679
NODE_301986_length_187_cov_37.397727	4	57	38	2	53	0.0377358
NODE_301986_length_187_cov_37.397727	4	57	40	1	53	0.0188679
NODE_301986_length_187_cov_37.397727	4	57	46	3	53	0.0566038
NODE_301986_length_187_cov_37.397727	4	57	50	2	53	0.0377358
NODE_301986_length_187_cov_37.397727	4	57	52	1	53	0.0188679
NODE_301986_length_187_cov_37.397727	4	57	54	1	53	0.0188679
NODE_301986_length_187_cov_37.397727	4	57	71	1	53	0.0188679
NODE_301986_length_187_cov_37.397727	4	57	73	1	53	0.0188679
NODE_301986_length_187_cov_37.397727	12	78	2	12	66	0.1818182
NODE_301986_length_187_cov_37.397727	12	78	8	4	66	0.0606061
NODE_301986_length_187_cov_37.397727	12	78	10	2	66	0.0303030
NODE_301986_length_187_cov_37.397727	12	78	14	2	66	0.0303030
NODE_301986_length_187_cov_37.397727	12	78	16	1	66	0.0151515
NODE_301986_length_187_cov_37.397727	12	78	18	2	66	0.0303030
NODE_301986_length_187_cov_37.397727	12	78	20	4	66	0.0606061
NODE_301986_length_187_cov_37.397727	12	78	23	1	66	0.0151515
NODE_301986_length_187_cov_37.397727	12	78	24	1	66	0.0151515
NODE_301986_length_187_cov_37.397727	12	78	26	1	66	0.0151515
NODE_301986_length_187_cov_37.397727	12	78	32	2	66	0.0303030
NODE_301986_length_187_cov_37.397727	12	78	36	1	66	0.0151515
NODE_301986_length_187_cov_37.397727	12	78	38	2	66	0.0303030
NODE_301986_length_187_cov_37.397727	12	78	40	1	66	0.0151515
NODE_301986_length_187_cov_37.397727	12	78	46	3	66	0.0454545
NODE_301986_length_187_cov_37.397727	12	78	50	2	66	0.0303030
NODE_301986_length_187_cov_37.397727	12	78	52	1	66	0.0151515
NODE_301986_length_187_cov_37.397727	12	78	54	1	66	0.0151515
NODE_301986_length_187_cov_37.397727	12	78	71	1	66	0.0151515
NODE_301986_length_187_cov_37.397727	12	78	73	1	66	0.0151515
NODE_301986_length_187_cov_37.397727	12	78	74	1	66	0.0151515
NODE_301986_length_187_cov_37.397727	12	78	76	1	66	0.0151515
NODE_301986_length_187_cov_37.397727	12	78	84	1	66	0.0151515
NODE_301986_length_187_cov_37.397727	12	78	87	1	66	0.0151515
NODE_301986_length_187_cov_37.397727	12	78	89	1	66	0.0151515
NODE_301986_length_187_cov_37.397727	12	78	91	2	66	0.0303030
NODE_301986_length_187_cov_37.397727	12	78	94	1	66	0.0151515
NODE_301986_length_187_cov_37.397727	12	78	98	2	66	0.0303030
NODE_301986_length_187_cov_37.397727	12	78	99	1	66	0.0151515
NODE_301986_length_187_cov_37.397727	12	78	102	1	66	0.0151515
NODE_301986_length_187_cov_37.397727	12	78	103	2	66	0.0303030
NODE_301986_length_187_cov_37.397727	12	78	104	2	66	0.0303030
NODE_301986_length_187_cov_37.397727	12	78	108	5	66	0.0757576
NODE_301986_length_187_cov_37.397727	51	112	50	2	61	0.0327869
NODE_301986_length_187_cov_37.397727	51	112	52	1	61	0.0163934
NODE_301986_length_187_cov_37.397727	51	112	54	1	61	0.0163934
NODE_301986_length_187_cov_37.397727	51	112	71	1	61	0.0163934
NODE_301986_length_187_cov_37.397727	51	112	73	1	61	0.0163934
NODE_301986_length_187_cov_37.397727	51	112	74	1	61	0.0163934
NODE_301986_length_187_cov_37.397727	51	112	76	1	61	0.0163934
NODE_301986_length_187_cov_37.397727	51	112	84	1	61	0.0163934
NODE_301986_length_187_cov_37.397727	51	112	87	1	61	0.0163934
NODE_301986_length_187_cov_37.397727	51	112	89	1	61	0.0163934
NODE_301986_length_187_cov_37.397727	51	112	91	2	61	0.0327869
NODE_301986_length_187_cov_37.397727	51	112	94	1	61	0.0163934
NODE_301986_length_187_cov_37.397727	51	112	98	2	61	0.0327869
NODE_301986_length_187_cov_37.397727	51	112	99	1	61	0.0163934
NODE_301986_length_187_cov_37.397727	51	112	100	1	61	0.0163934
NODE_301986_length_187_cov_37.397727	51	112	102	3	61	0.0491803
NODE_301986_length_187_cov_37.397727	51	112	103	2	61	0.0327869
NODE_301986_length_187_cov_37.397727	51	112	104	3	61	0.0491803
NODE_301986_length_187_cov_37.397727	51	112	106	5	61	0.0819672
NODE_301986_length_187_cov_37.397727	51	112	108	30	61	0.4918033
NODE_301986_length_187_cov_37.397727	51	114	50	2	63	0.0317460
NODE_301986_length_187_cov_37.397727	51	114	52	1	63	0.0158730
NODE_301986_length_187_cov_37.397727	51	114	54	1	63	0.0158730
NODE_301986_length_187_cov_37.397727	51	114	71	1	63	0.0158730
NODE_301986_length_187_cov_37.397727	51	114	73	1	63	0.0158730
NODE_301986_length_187_cov_37.397727	51	114	74	1	63	0.0158730
NODE_301986_length_187_cov_37.397727	51	114	76	1	63	0.0158730
NODE_301986_length_187_cov_37.397727	51	114	84	1	63	0.0158730
NODE_301986_length_187_cov_37.397727	51	114	87	1	63	0.0158730
NODE_301986_length_187_cov_37.397727	51	114	89	1	63	0.0158730
NODE_301986_length_187_cov_37.397727	51	114	91	2	63	0.0317460
NODE_301986_length_187_cov_37.397727	51	114	94	1	63	0.0158730
NODE_301986_length_187_cov_37.397727	51	114	98	3	63	0.0476190
NODE_301986_length_187_cov_37.397727	51	114	99	1	63	0.0158730
NODE_301986_length_187_cov_37.397727	51	114	100	2	63	0.0317460
NODE_301986_length_187_cov_37.397727	51	114	102	3	63	0.0476190
NODE_301986_length_187_cov_37.397727	51	114	103	2	63	0.0317460
NODE_301986_length_187_cov_37.397727	51	114	104	3	63	0.0476190
NODE_301986_length_187_cov_37.397727	51	114	106	5	63	0.0793651
NODE_301986_length_187_cov_37.397727	51	114	108	30	63	0.4761905
NODE_302020_length_186_cov_309.620690	20	104	2	84	84	1.0000000
NODE_302021_length_186_cov_295.505747	57	115	79	1	58	0.0172414
NODE_302021_length_186_cov_295.505747	57	115	81	3	58	0.0517241
NODE_302021_length_186_cov_295.505747	57	115	85	2	58	0.0344828
NODE_302021_length_186_cov_295.505747	57	115	89	8	58	0.1379310
NODE_302021_length_186_cov_295.505747	57	115	91	9	58	0.1551724
NODE_302021_length_186_cov_295.505747	57	115	93	1	58	0.0172414
NODE_302021_length_186_cov_295.505747	57	115	95	11	58	0.1896552
NODE_302021_length_186_cov_295.505747	57	115	97	23	58	0.3965517
NODE_302021_length_186_cov_295.505747	101	168	24	1	67	0.0149254
NODE_302021_length_186_cov_295.505747	101	168	25	2	67	0.0298507
NODE_302021_length_186_cov_295.505747	101	168	27	2	67	0.0298507
NODE_302021_length_186_cov_295.505747	101	168	40	1	67	0.0149254
NODE_302021_length_186_cov_295.505747	101	168	41	3	67	0.0447761
NODE_302021_length_186_cov_295.505747	101	168	43	4	67	0.0597015
NODE_302021_length_186_cov_295.505747	101	168	46	8	67	0.1194030
NODE_302021_length_186_cov_295.505747	101	168	50	1	67	0.0149254
NODE_302021_length_186_cov_295.505747	101	168	52	2	67	0.0298507
NODE_302021_length_186_cov_295.505747	101	168	54	4	67	0.0597015
NODE_302021_length_186_cov_295.505747	101	168	58	1	67	0.0149254
NODE_302021_length_186_cov_295.505747	101	168	68	1	67	0.0149254
NODE_302021_length_186_cov_295.505747	101	168	70	11	67	0.1641791
NODE_302021_length_186_cov_295.505747	101	168	80	2	67	0.0298507
NODE_302021_length_186_cov_295.505747	101	168	84	1	67	0.0149254
NODE_302021_length_186_cov_295.505747	101	168	86	6	67	0.0895522
NODE_302021_length_186_cov_295.505747	101	168	87	2	67	0.0298507
NODE_302021_length_186_cov_295.505747	101	168	88	1	67	0.0149254
NODE_302021_length_186_cov_295.505747	101	168	91	4	67	0.0597015
NODE_302021_length_186_cov_295.505747	101	168	95	5	67	0.0746269
NODE_302021_length_186_cov_295.505747	101	168	97	5	67	0.0746269
NODE_302025_length_186_cov_61.344828	38	118	44	1	80	0.0125000
NODE_302025_length_186_cov_61.344828	38	118	48	4	80	0.0500000
NODE_302025_length_186_cov_61.344828	38	118	50	3	80	0.0375000
NODE_302025_length_186_cov_61.344828	38	118	58	3	80	0.0375000
NODE_302025_length_186_cov_61.344828	38	118	60	2	80	0.0250000
NODE_302025_length_186_cov_61.344828	38	118	63	1	80	0.0125000
NODE_302025_length_186_cov_61.344828	38	118	64	4	80	0.0500000
NODE_302025_length_186_cov_61.344828	38	118	68	2	80	0.0250000
NODE_302025_length_186_cov_61.344828	38	118	70	2	80	0.0250000
NODE_302025_length_186_cov_61.344828	38	118	75	1	80	0.0125000
NODE_302025_length_186_cov_61.344828	38	118	78	1	80	0.0125000
NODE_302025_length_186_cov_61.344828	38	118	82	7	80	0.0875000
NODE_302025_length_186_cov_61.344828	38	118	84	2	80	0.0250000
NODE_302025_length_186_cov_61.344828	38	118	86	2	80	0.0250000
NODE_302025_length_186_cov_61.344828	38	118	88	9	80	0.1125000
NODE_302025_length_186_cov_61.344828	38	118	90	1	80	0.0125000
NODE_302025_length_186_cov_61.344828	38	118	91	1	80	0.0125000
NODE_302025_length_186_cov_61.344828	38	118	92	34	80	0.4250000
NODE_302025_length_186_cov_61.344828	91	171	22	6	80	0.0750000
NODE_302025_length_186_cov_61.344828	91	171	24	2	80	0.0250000
NODE_302025_length_186_cov_61.344828	91	171	28	1	80	0.0125000
NODE_302025_length_186_cov_61.344828	91	171	40	1	80	0.0125000
NODE_302025_length_186_cov_61.344828	91	171	50	1	80	0.0125000
NODE_302025_length_186_cov_61.344828	91	171	52	1	80	0.0125000
NODE_302025_length_186_cov_61.344828	91	171	56	5	80	0.0625000
NODE_302025_length_186_cov_61.344828	91	171	58	3	80	0.0375000
NODE_302025_length_186_cov_61.344828	91	171	64	2	80	0.0250000
NODE_302025_length_186_cov_61.344828	91	171	70	1	80	0.0125000
NODE_302025_length_186_cov_61.344828	91	171	72	3	80	0.0375000
NODE_302025_length_186_cov_61.344828	91	171	76	3	80	0.0375000
NODE_302025_length_186_cov_61.344828	91	171	78	2	80	0.0250000
NODE_302025_length_186_cov_61.344828	91	171	82	13	80	0.1625000
NODE_302025_length_186_cov_61.344828	91	171	86	11	80	0.1375000
NODE_302025_length_186_cov_61.344828	91	171	88	8	80	0.1000000
NODE_302025_length_186_cov_61.344828	91	171	91	1	80	0.0125000
NODE_302025_length_186_cov_61.344828	91	171	92	16	80	0.2000000
NODE_302201_length_182_cov_127.759036	6	52	8	5	46	0.1086956
NODE_302201_length_182_cov_127.759036	6	52	9	3	46	0.0652174
NODE_302201_length_182_cov_127.759036	6	52	16	5	46	0.1086956
NODE_302201_length_182_cov_127.759036	6	52	18	4	46	0.0869565
NODE_302201_length_182_cov_127.759036	6	52	22	2	46	0.0434783
NODE_302201_length_182_cov_127.759036	6	52	24	1	46	0.0217391
NODE_302201_length_182_cov_127.759036	6	52	26	3	46	0.0652174
NODE_302201_length_182_cov_127.759036	6	52	30	1	46	0.0217391
NODE_302201_length_182_cov_127.759036	6	52	32	1	46	0.0217391
NODE_302201_length_182_cov_127.759036	6	52	34	3	46	0.0652174
NODE_302201_length_182_cov_127.759036	6	52	36	1	46	0.0217391
NODE_302201_length_182_cov_127.759036	6	52	38	9	46	0.1956522
NODE_302201_length_182_cov_127.759036	6	52	40	7	46	0.1521739
NODE_302201_length_182_cov_127.759036	6	52	42	1	46	0.0217391
NODE_302201_length_182_cov_127.759036	59	105	75	2	46	0.0434783
NODE_302201_length_182_cov_127.759036	59	105	81	1	46	0.0217391
NODE_302201_length_182_cov_127.759036	59	105	89	1	46	0.0217391
NODE_302201_length_182_cov_127.759036	59	105	95	5	46	0.1086956
NODE_302201_length_182_cov_127.759036	59	105	99	7	46	0.1521739
NODE_302201_length_182_cov_127.759036	59	105	101	2	46	0.0434783
NODE_302201_length_182_cov_127.759036	59	105	103	28	46	0.6086956
NODE_302214_length_182_cov_29.421687	5	35	0	4	30	0.1333333
NODE_302214_length_182_cov_29.421687	5	35	4	11	30	0.3666667
NODE_302214_length_182_cov_29.421687	5	35	6	10	30	0.3333333
NODE_302214_length_182_cov_29.421687	5	35	12	5	30	0.1666667
NODE_302214_length_182_cov_29.421687	8	88	0	1	80	0.0125000
NODE_302214_length_182_cov_29.421687	8	88	4	11	80	0.1375000
NODE_302214_length_182_cov_29.421687	8	88	6	10	80	0.1250000
NODE_302214_length_182_cov_29.421687	8	88	12	30	80	0.3750000
NODE_302214_length_182_cov_29.421687	8	88	14	28	80	0.3500000
NODE_302236_length_181_cov_141.195122	1	60	0	59	59	1.0000000
NODE_302236_length_181_cov_141.195122	34	60	0	26	26	1.0000000
NODE_302236_length_181_cov_141.195122	114	145	0	31	31	1.0000000
NODE_302285_length_180_cov_102.567901	6	75	66	2	69	0.0289855
NODE_302285_length_180_cov_102.567901	6	75	68	1	69	0.0144928
NODE_302285_length_180_cov_102.567901	6	75	70	3	69	0.0434783
NODE_302285_length_180_cov_102.567901	6	75	73	1	69	0.0144928
NODE_302285_length_180_cov_102.567901	6	75	75	2	69	0.0289855
NODE_302285_length_180_cov_102.567901	6	75	80	3	69	0.0434783
NODE_302285_length_180_cov_102.567901	6	75	92	1	69	0.0144928
NODE_302285_length_180_cov_102.567901	6	75	94	2	69	0.0289855
NODE_302285_length_180_cov_102.567901	6	75	98	1	69	0.0144928
NODE_302285_length_180_cov_102.567901	6	75	100	1	69	0.0144928
NODE_302285_length_180_cov_102.567901	6	75	101	2	69	0.0289855
NODE_302285_length_180_cov_102.567901	6	75	103	3	69	0.0434783
NODE_302285_length_180_cov_102.567901	6	75	113	1	69	0.0144928
NODE_302285_length_180_cov_102.567901	6	75	123	1	69	0.0144928
NODE_302285_length_180_cov_102.567901	6	75	131	1	69	0.0144928
NODE_302285_length_180_cov_102.567901	6	75	133	2	69	0.0289855
NODE_302285_length_180_cov_102.567901	6	75	135	1	69	0.0144928
NODE_302285_length_180_cov_102.567901	6	75	140	1	69	0.0144928
NODE_302285_length_180_cov_102.567901	6	75	151	1	69	0.0144928
NODE_302285_length_180_cov_102.567901	6	75	152	1	69	0.0144928
NODE_302285_length_180_cov_102.567901	6	75	158	1	69	0.0144928
NODE_302285_length_180_cov_102.567901	6	75	161	1	69	0.0144928
NODE_302285_length_180_cov_102.567901	6	75	187	1	69	0.0144928
NODE_302285_length_180_cov_102.567901	6	75	202	1	69	0.0144928
NODE_302285_length_180_cov_102.567901	6	75	214	1	69	0.0144928
NODE_302285_length_180_cov_102.567901	6	75	220	1	69	0.0144928
NODE_302285_length_180_cov_102.567901	6	75	222	3	69	0.0434783
NODE_302285_length_180_cov_102.567901	6	75	228	1	69	0.0144928
NODE_302285_length_180_cov_102.567901	6	75	230	1	69	0.0144928
NODE_302285_length_180_cov_102.567901	6	75	234	1	69	0.0144928
NODE_302285_length_180_cov_102.567901	6	75	238	1	69	0.0144928
NODE_302285_length_180_cov_102.567901	6	75	242	2	69	0.0289855
NODE_302285_length_180_cov_102.567901	6	75	246	4	69	0.0579710
NODE_302285_length_180_cov_102.567901	6	75	256	2	69	0.0289855
NODE_302285_length_180_cov_102.567901	6	75	260	1	69	0.0144928
NODE_302285_length_180_cov_102.567901	6	75	269	2	69	0.0289855
NODE_302285_length_180_cov_102.567901	6	75	277	1	69	0.0144928
NODE_302285_length_180_cov_102.567901	6	75	279	2	69	0.0289855
NODE_302285_length_180_cov_102.567901	6	75	288	1	69	0.0144928
NODE_302285_length_180_cov_102.567901	6	75	290	2	69	0.0289855
NODE_302285_length_180_cov_102.567901	6	75	294	1	69	0.0144928
NODE_302285_length_180_cov_102.567901	6	75	300	1	69	0.0144928
NODE_302285_length_180_cov_102.567901	6	75	304	1	69	0.0144928
NODE_302285_length_180_cov_102.567901	6	75	308	2	69	0.0289855
NODE_302285_length_180_cov_102.567901	6	75	310	3	69	0.0434783
NODE_302363_length_178_cov_93.620253	81	112	18	1	31	0.0322581
NODE_302363_length_178_cov_93.620253	81	112	20	30	31	0.9677419
NODE_302365_length_178_cov_62.696203	0	78	6	2	78	0.0256410
NODE_302365_length_178_cov_62.696203	0	78	10	2	78	0.0256410
NODE_302365_length_178_cov_62.696203	0	78	12	8	78	0.1025641
NODE_302365_length_178_cov_62.696203	0	78	14	9	78	0.1153846
NODE_302365_length_178_cov_62.696203	0	78	28	3	78	0.0384615
NODE_302365_length_178_cov_62.696203	0	78	30	2	78	0.0256410
NODE_302365_length_178_cov_62.696203	0	78	32	3	78	0.0384615
NODE_302365_length_178_cov_62.696203	0	78	34	1	78	0.0128205
NODE_302365_length_178_cov_62.696203	0	78	40	2	78	0.0256410
NODE_302365_length_178_cov_62.696203	0	78	42	8	78	0.1025641
NODE_302365_length_178_cov_62.696203	0	78	46	1	78	0.0128205
NODE_302365_length_178_cov_62.696203	0	78	48	9	78	0.1153846
NODE_302365_length_178_cov_62.696203	0	78	54	4	78	0.0512821
NODE_302365_length_178_cov_62.696203	0	78	56	24	78	0.3076923
NODE_302365_length_178_cov_62.696203	51	131	30	4	80	0.0500000
NODE_302365_length_178_cov_62.696203	51	131	33	1	80	0.0125000
NODE_302365_length_178_cov_62.696203	51	131	40	6	80	0.0750000
NODE_302365_length_178_cov_62.696203	51	131	44	4	80	0.0500000
NODE_302365_length_178_cov_62.696203	51	131	48	3	80	0.0375000
NODE_302365_length_178_cov_62.696203	51	131	52	1	80	0.0125000
NODE_302365_length_178_cov_62.696203	51	131	54	7	80	0.0875000
NODE_302365_length_178_cov_62.696203	51	131	56	54	80	0.6750000
NODE_302477_length_175_cov_116.684211	42	122	2	80	80	1.0000000
NODE_302477_length_175_cov_116.684211	95	175	0	48	80	0.6000000
NODE_302477_length_175_cov_116.684211	95	175	2	32	80	0.4000000
NODE_302482_length_175_cov_61.000000	81	121	230	1	40	0.0250000
NODE_302482_length_175_cov_61.000000	81	121	234	1	40	0.0250000
NODE_302482_length_175_cov_61.000000	81	121	240	5	40	0.1250000
NODE_302482_length_175_cov_61.000000	81	121	242	2	40	0.0500000
NODE_302482_length_175_cov_61.000000	81	121	244	2	40	0.0500000
NODE_302482_length_175_cov_61.000000	81	121	246	1	40	0.0250000
NODE_302482_length_175_cov_61.000000	81	121	252	1	40	0.0250000
NODE_302482_length_175_cov_61.000000	81	121	254	1	40	0.0250000
NODE_302482_length_175_cov_61.000000	81	121	256	2	40	0.0500000
NODE_302482_length_175_cov_61.000000	81	121	258	1	40	0.0250000
NODE_302482_length_175_cov_61.000000	81	121	262	23	40	0.5750000
NODE_302538_length_174_cov_173.893333	53	93	198	1	40	0.0250000
NODE_302538_length_174_cov_173.893333	53	93	200	5	40	0.1250000
NODE_302538_length_174_cov_173.893333	53	93	202	1	40	0.0250000
NODE_302538_length_174_cov_173.893333	53	93	206	1	40	0.0250000
NODE_302538_length_174_cov_173.893333	53	93	208	1	40	0.0250000
NODE_302538_length_174_cov_173.893333	53	93	212	1	40	0.0250000
NODE_302538_length_174_cov_173.893333	53	93	213	1	40	0.0250000
NODE_302538_length_174_cov_173.893333	53	93	215	1	40	0.0250000
NODE_302538_length_174_cov_173.893333	53	93	220	1	40	0.0250000
NODE_302538_length_174_cov_173.893333	53	93	222	2	40	0.0500000
NODE_302538_length_174_cov_173.893333	53	93	224	2	40	0.0500000
NODE_302538_length_174_cov_173.893333	53	93	228	4	40	0.1000000
NODE_302538_length_174_cov_173.893333	53	93	229	1	40	0.0250000
NODE_302538_length_174_cov_173.893333	53	93	230	18	40	0.4500000
NODE_302543_length_174_cov_50.346667	91	161	10	2	70	0.0285714
NODE_302543_length_174_cov_50.346667	91	161	15	2	70	0.0285714
NODE_302543_length_174_cov_50.346667	91	161	17	4	70	0.0571429
NODE_302543_length_174_cov_50.346667	91	161	19	6	70	0.0857143
NODE_302543_length_174_cov_50.346667	91	161	23	1	70	0.0142857
NODE_302543_length_174_cov_50.346667	91	161	26	1	70	0.0142857
NODE_302543_length_174_cov_50.346667	91	161	32	1	70	0.0142857
NODE_302543_length_174_cov_50.346667	91	161	36	2	70	0.0285714
NODE_302543_length_174_cov_50.346667	91	161	38	4	70	0.0571429
NODE_302543_length_174_cov_50.346667	91	161	42	3	70	0.0428571
NODE_302543_length_174_cov_50.346667	91	161	44	1	70	0.0142857
NODE_302543_length_174_cov_50.346667	91	161	50	1	70	0.0142857
NODE_302543_length_174_cov_50.346667	91	161	52	1	70	0.0142857
NODE_302543_length_174_cov_50.346667	91	161	54	11	70	0.1571429
NODE_302543_length_174_cov_50.346667	91	161	56	1	70	0.0142857
NODE_302543_length_174_cov_50.346667	91	161	58	2	70	0.0285714
NODE_302543_length_174_cov_50.346667	91	161	62	4	70	0.0571429
NODE_302543_length_174_cov_50.346667	91	161	68	1	70	0.0142857
NODE_302543_length_174_cov_50.346667	91	161	74	2	70	0.0285714
NODE_302543_length_174_cov_50.346667	91	161	75	9	70	0.1285714
NODE_302543_length_174_cov_50.346667	91	161	76	11	70	0.1571429
NODE_302590_length_173_cov_184.351351	62	126	278	1	64	0.0156250
NODE_302590_length_173_cov_184.351351	62	126	280	1	64	0.0156250
NODE_302590_length_173_cov_184.351351	62	126	281	1	64	0.0156250
NODE_302590_length_173_cov_184.351351	62	126	284	1	64	0.0156250
NODE_302590_length_173_cov_184.351351	62	126	298	1	64	0.0156250
NODE_302590_length_173_cov_184.351351	62	126	300	1	64	0.0156250
NODE_302590_length_173_cov_184.351351	62	126	306	1	64	0.0156250
NODE_302590_length_173_cov_184.351351	62	126	307	1	64	0.0156250
NODE_302590_length_173_cov_184.351351	62	126	317	2	64	0.0312500
NODE_302590_length_173_cov_184.351351	62	126	321	1	64	0.0156250
NODE_302590_length_173_cov_184.351351	62	126	322	1	64	0.0156250
NODE_302590_length_173_cov_184.351351	62	126	328	2	64	0.0312500
NODE_302590_length_173_cov_184.351351	62	126	330	2	64	0.0312500
NODE_302590_length_173_cov_184.351351	62	126	340	1	64	0.0156250
NODE_302590_length_173_cov_184.351351	62	126	345	2	64	0.0312500
NODE_302590_length_173_cov_184.351351	62	126	349	1	64	0.0156250
NODE_302590_length_173_cov_184.351351	62	126	353	6	64	0.0937500
NODE_302590_length_173_cov_184.351351	62	126	354	1	64	0.0156250
NODE_302590_length_173_cov_184.351351	62	126	355	2	64	0.0312500
NODE_302590_length_173_cov_184.351351	62	126	357	1	64	0.0156250
NODE_302590_length_173_cov_184.351351	62	126	359	22	64	0.3437500
NODE_302590_length_173_cov_184.351351	62	126	360	12	64	0.1875000
NODE_302590_length_173_cov_184.351351	62	126	278	1	64	0.0156250
NODE_302590_length_173_cov_184.351351	62	126	280	1	64	0.0156250
NODE_302590_length_173_cov_184.351351	62	126	281	1	64	0.0156250
NODE_302590_length_173_cov_184.351351	62	126	284	1	64	0.0156250
NODE_302590_length_173_cov_184.351351	62	126	298	1	64	0.0156250
NODE_302590_length_173_cov_184.351351	62	126	300	1	64	0.0156250
NODE_302590_length_173_cov_184.351351	62	126	306	1	64	0.0156250
NODE_302590_length_173_cov_184.351351	62	126	307	1	64	0.0156250
NODE_302590_length_173_cov_184.351351	62	126	317	2	64	0.0312500
NODE_302590_length_173_cov_184.351351	62	126	321	1	64	0.0156250
NODE_302590_length_173_cov_184.351351	62	126	322	1	64	0.0156250
NODE_302590_length_173_cov_184.351351	62	126	328	2	64	0.0312500
NODE_302590_length_173_cov_184.351351	62	126	330	2	64	0.0312500
NODE_302590_length_173_cov_184.351351	62	126	340	1	64	0.0156250
NODE_302590_length_173_cov_184.351351	62	126	345	2	64	0.0312500
NODE_302590_length_173_cov_184.351351	62	126	349	1	64	0.0156250
NODE_302590_length_173_cov_184.351351	62	126	353	6	64	0.0937500
NODE_302590_length_173_cov_184.351351	62	126	354	1	64	0.0156250
NODE_302590_length_173_cov_184.351351	62	126	355	2	64	0.0312500
NODE_302590_length_173_cov_184.351351	62	126	357	1	64	0.0156250
NODE_302590_length_173_cov_184.351351	62	126	359	22	64	0.3437500
NODE_302590_length_173_cov_184.351351	62	126	360	12	64	0.1875000
NODE_302590_length_173_cov_184.351351	62	126	278	1	64	0.0156250
NODE_302590_length_173_cov_184.351351	62	126	280	1	64	0.0156250
NODE_302590_length_173_cov_184.351351	62	126	281	1	64	0.0156250
NODE_302590_length_173_cov_184.351351	62	126	284	1	64	0.0156250
NODE_302590_length_173_cov_184.351351	62	126	298	1	64	0.0156250
NODE_302590_length_173_cov_184.351351	62	126	300	1	64	0.0156250
NODE_302590_length_173_cov_184.351351	62	126	306	1	64	0.0156250
NODE_302590_length_173_cov_184.351351	62	126	307	1	64	0.0156250
NODE_302590_length_173_cov_184.351351	62	126	317	2	64	0.0312500
NODE_302590_length_173_cov_184.351351	62	126	321	1	64	0.0156250
NODE_302590_length_173_cov_184.351351	62	126	322	1	64	0.0156250
NODE_302590_length_173_cov_184.351351	62	126	328	2	64	0.0312500
NODE_302590_length_173_cov_184.351351	62	126	330	2	64	0.0312500
NODE_302590_length_173_cov_184.351351	62	126	340	1	64	0.0156250
NODE_302590_length_173_cov_184.351351	62	126	345	2	64	0.0312500
NODE_302590_length_173_cov_184.351351	62	126	349	1	64	0.0156250
NODE_302590_length_173_cov_184.351351	62	126	353	6	64	0.0937500
NODE_302590_length_173_cov_184.351351	62	126	354	1	64	0.0156250
NODE_302590_length_173_cov_184.351351	62	126	355	2	64	0.0312500
NODE_302590_length_173_cov_184.351351	62	126	357	1	64	0.0156250
NODE_302590_length_173_cov_184.351351	62	126	359	22	64	0.3437500
NODE_302590_length_173_cov_184.351351	62	126	360	12	64	0.1875000
NODE_302590_length_173_cov_184.351351	62	126	278	1	64	0.0156250
NODE_302590_length_173_cov_184.351351	62	126	280	1	64	0.0156250
NODE_302590_length_173_cov_184.351351	62	126	281	1	64	0.0156250
NODE_302590_length_173_cov_184.351351	62	126	284	1	64	0.0156250
NODE_302590_length_173_cov_184.351351	62	126	298	1	64	0.0156250
NODE_302590_length_173_cov_184.351351	62	126	300	1	64	0.0156250
NODE_302590_length_173_cov_184.351351	62	126	306	1	64	0.0156250
NODE_302590_length_173_cov_184.351351	62	126	307	1	64	0.0156250
NODE_302590_length_173_cov_184.351351	62	126	317	2	64	0.0312500
NODE_302590_length_173_cov_184.351351	62	126	321	1	64	0.0156250
NODE_302590_length_173_cov_184.351351	62	126	322	1	64	0.0156250
NODE_302590_length_173_cov_184.351351	62	126	328	2	64	0.0312500
NODE_302590_length_173_cov_184.351351	62	126	330	2	64	0.0312500
NODE_302590_length_173_cov_184.351351	62	126	340	1	64	0.0156250
NODE_302590_length_173_cov_184.351351	62	126	345	2	64	0.0312500
NODE_302590_length_173_cov_184.351351	62	126	349	1	64	0.0156250
NODE_302590_length_173_cov_184.351351	62	126	353	6	64	0.0937500
NODE_302590_length_173_cov_184.351351	62	126	354	1	64	0.0156250
NODE_302590_length_173_cov_184.351351	62	126	355	2	64	0.0312500
NODE_302590_length_173_cov_184.351351	62	126	357	1	64	0.0156250
NODE_302590_length_173_cov_184.351351	62	126	359	22	64	0.3437500
NODE_302590_length_173_cov_184.351351	62	126	360	12	64	0.1875000
NODE_302590_length_173_cov_184.351351	99	165	69	4	66	0.0606061
NODE_302590_length_173_cov_184.351351	99	165	80	1	66	0.0151515
NODE_302590_length_173_cov_184.351351	99	165	81	1	66	0.0151515
NODE_302590_length_173_cov_184.351351	99	165	84	1	66	0.0151515
NODE_302590_length_173_cov_184.351351	99	165	88	1	66	0.0151515
NODE_302590_length_173_cov_184.351351	99	165	105	1	66	0.0151515
NODE_302590_length_173_cov_184.351351	99	165	108	1	66	0.0151515
NODE_302590_length_173_cov_184.351351	99	165	112	2	66	0.0303030
NODE_302590_length_173_cov_184.351351	99	165	122	1	66	0.0151515
NODE_302590_length_173_cov_184.351351	99	165	124	2	66	0.0303030
NODE_302590_length_173_cov_184.351351	99	165	128	1	66	0.0151515
NODE_302590_length_173_cov_184.351351	99	165	134	1	66	0.0151515
NODE_302590_length_173_cov_184.351351	99	165	139	3	66	0.0454545
NODE_302590_length_173_cov_184.351351	99	165	145	1	66	0.0151515
NODE_302590_length_173_cov_184.351351	99	165	155	2	66	0.0303030
NODE_302590_length_173_cov_184.351351	99	165	161	1	66	0.0151515
NODE_302590_length_173_cov_184.351351	99	165	167	1	66	0.0151515
NODE_302590_length_173_cov_184.351351	99	165	173	1	66	0.0151515
NODE_302590_length_173_cov_184.351351	99	165	180	2	66	0.0303030
NODE_302590_length_173_cov_184.351351	99	165	192	1	66	0.0151515
NODE_302590_length_173_cov_184.351351	99	165	196	1	66	0.0151515
NODE_302590_length_173_cov_184.351351	99	165	205	1	66	0.0151515
NODE_302590_length_173_cov_184.351351	99	165	206	2	66	0.0303030
NODE_302590_length_173_cov_184.351351	99	165	208	1	66	0.0151515
NODE_302590_length_173_cov_184.351351	99	165	222	1	66	0.0151515
NODE_302590_length_173_cov_184.351351	99	165	232	1	66	0.0151515
NODE_302590_length_173_cov_184.351351	99	165	244	2	66	0.0303030
NODE_302590_length_173_cov_184.351351	99	165	252	1	66	0.0151515
NODE_302590_length_173_cov_184.351351	99	165	278	1	66	0.0151515
NODE_302590_length_173_cov_184.351351	99	165	280	1	66	0.0151515
NODE_302590_length_173_cov_184.351351	99	165	281	1	66	0.0151515
NODE_302590_length_173_cov_184.351351	99	165	284	1	66	0.0151515
NODE_302590_length_173_cov_184.351351	99	165	298	1	66	0.0151515
NODE_302590_length_173_cov_184.351351	99	165	300	1	66	0.0151515
NODE_302590_length_173_cov_184.351351	99	165	306	1	66	0.0151515
NODE_302590_length_173_cov_184.351351	99	165	307	1	66	0.0151515
NODE_302590_length_173_cov_184.351351	99	165	317	2	66	0.0303030
NODE_302590_length_173_cov_184.351351	99	165	321	1	66	0.0151515
NODE_302590_length_173_cov_184.351351	99	165	322	1	66	0.0151515
NODE_302590_length_173_cov_184.351351	99	165	328	2	66	0.0303030
NODE_302590_length_173_cov_184.351351	99	165	330	2	66	0.0303030
NODE_302590_length_173_cov_184.351351	99	165	340	1	66	0.0151515
NODE_302590_length_173_cov_184.351351	99	165	345	2	66	0.0303030
NODE_302590_length_173_cov_184.351351	99	165	349	1	66	0.0151515
NODE_302590_length_173_cov_184.351351	99	165	354	1	66	0.0151515
NODE_302590_length_173_cov_184.351351	99	165	357	1	66	0.0151515
NODE_302590_length_173_cov_184.351351	99	165	359	5	66	0.0757576
NODE_302590_length_173_cov_184.351351	99	170	42	1	71	0.0140845
NODE_302590_length_173_cov_184.351351	99	170	62	1	71	0.0140845
NODE_302590_length_173_cov_184.351351	99	170	66	1	71	0.0140845
NODE_302590_length_173_cov_184.351351	99	170	68	1	71	0.0140845
NODE_302590_length_173_cov_184.351351	99	170	69	5	71	0.0704225
NODE_302590_length_173_cov_184.351351	99	170	80	1	71	0.0140845
NODE_302590_length_173_cov_184.351351	99	170	81	1	71	0.0140845
NODE_302590_length_173_cov_184.351351	99	170	84	1	71	0.0140845
NODE_302590_length_173_cov_184.351351	99	170	88	1	71	0.0140845
NODE_302590_length_173_cov_184.351351	99	170	105	1	71	0.0140845
NODE_302590_length_173_cov_184.351351	99	170	108	1	71	0.0140845
NODE_302590_length_173_cov_184.351351	99	170	112	2	71	0.0281690
NODE_302590_length_173_cov_184.351351	99	170	122	1	71	0.0140845
NODE_302590_length_173_cov_184.351351	99	170	124	2	71	0.0281690
NODE_302590_length_173_cov_184.351351	99	170	128	1	71	0.0140845
NODE_302590_length_173_cov_184.351351	99	170	134	1	71	0.0140845
NODE_302590_length_173_cov_184.351351	99	170	139	3	71	0.0422535
NODE_302590_length_173_cov_184.351351	99	170	145	1	71	0.0140845
NODE_302590_length_173_cov_184.351351	99	170	155	2	71	0.0281690
NODE_302590_length_173_cov_184.351351	99	170	161	1	71	0.0140845
NODE_302590_length_173_cov_184.351351	99	170	167	1	71	0.0140845
NODE_302590_length_173_cov_184.351351	99	170	173	1	71	0.0140845
NODE_302590_length_173_cov_184.351351	99	170	180	2	71	0.0281690
NODE_302590_length_173_cov_184.351351	99	170	192	1	71	0.0140845
NODE_302590_length_173_cov_184.351351	99	170	196	1	71	0.0140845
NODE_302590_length_173_cov_184.351351	99	170	205	1	71	0.0140845
NODE_302590_length_173_cov_184.351351	99	170	206	2	71	0.0281690
NODE_302590_length_173_cov_184.351351	99	170	208	1	71	0.0140845
NODE_302590_length_173_cov_184.351351	99	170	222	1	71	0.0140845
NODE_302590_length_173_cov_184.351351	99	170	232	1	71	0.0140845
NODE_302590_length_173_cov_184.351351	99	170	244	2	71	0.0281690
NODE_302590_length_173_cov_184.351351	99	170	252	1	71	0.0140845
NODE_302590_length_173_cov_184.351351	99	170	278	1	71	0.0140845
NODE_302590_length_173_cov_184.351351	99	170	280	1	71	0.0140845
NODE_302590_length_173_cov_184.351351	99	170	281	1	71	0.0140845
NODE_302590_length_173_cov_184.351351	99	170	284	1	71	0.0140845
NODE_302590_length_173_cov_184.351351	99	170	298	1	71	0.0140845
NODE_302590_length_173_cov_184.351351	99	170	300	1	71	0.0140845
NODE_302590_length_173_cov_184.351351	99	170	306	1	71	0.0140845
NODE_302590_length_173_cov_184.351351	99	170	307	1	71	0.0140845
NODE_302590_length_173_cov_184.351351	99	170	317	2	71	0.0281690
NODE_302590_length_173_cov_184.351351	99	170	321	1	71	0.0140845
NODE_302590_length_173_cov_184.351351	99	170	322	1	71	0.0140845
NODE_302590_length_173_cov_184.351351	99	170	328	2	71	0.0281690
NODE_302590_length_173_cov_184.351351	99	170	330	2	71	0.0281690
NODE_302590_length_173_cov_184.351351	99	170	340	1	71	0.0140845
NODE_302590_length_173_cov_184.351351	99	170	345	2	71	0.0281690
NODE_302590_length_173_cov_184.351351	99	170	349	1	71	0.0140845
NODE_302590_length_173_cov_184.351351	99	170	354	1	71	0.0140845
NODE_302590_length_173_cov_184.351351	99	170	357	1	71	0.0140845
NODE_302590_length_173_cov_184.351351	99	170	359	5	71	0.0704225
NODE_302590_length_173_cov_184.351351	115	173	16	1	58	0.0172414
NODE_302590_length_173_cov_184.351351	115	173	29	1	58	0.0172414
NODE_302590_length_173_cov_184.351351	115	173	34	1	58	0.0172414
NODE_302590_length_173_cov_184.351351	115	173	42	1	58	0.0172414
NODE_302590_length_173_cov_184.351351	115	173	62	1	58	0.0172414
NODE_302590_length_173_cov_184.351351	115	173	66	1	58	0.0172414
NODE_302590_length_173_cov_184.351351	115	173	68	1	58	0.0172414
NODE_302590_length_173_cov_184.351351	115	173	69	5	58	0.0862069
NODE_302590_length_173_cov_184.351351	115	173	80	1	58	0.0172414
NODE_302590_length_173_cov_184.351351	115	173	81	1	58	0.0172414
NODE_302590_length_173_cov_184.351351	115	173	84	1	58	0.0172414
NODE_302590_length_173_cov_184.351351	115	173	88	1	58	0.0172414
NODE_302590_length_173_cov_184.351351	115	173	105	1	58	0.0172414
NODE_302590_length_173_cov_184.351351	115	173	108	1	58	0.0172414
NODE_302590_length_173_cov_184.351351	115	173	112	2	58	0.0344828
NODE_302590_length_173_cov_184.351351	115	173	122	1	58	0.0172414
NODE_302590_length_173_cov_184.351351	115	173	124	2	58	0.0344828
NODE_302590_length_173_cov_184.351351	115	173	128	1	58	0.0172414
NODE_302590_length_173_cov_184.351351	115	173	134	1	58	0.0172414
NODE_302590_length_173_cov_184.351351	115	173	139	3	58	0.0517241
NODE_302590_length_173_cov_184.351351	115	173	145	1	58	0.0172414
NODE_302590_length_173_cov_184.351351	115	173	155	2	58	0.0344828
NODE_302590_length_173_cov_184.351351	115	173	161	1	58	0.0172414
NODE_302590_length_173_cov_184.351351	115	173	167	1	58	0.0172414
NODE_302590_length_173_cov_184.351351	115	173	173	1	58	0.0172414
NODE_302590_length_173_cov_184.351351	115	173	180	2	58	0.0344828
NODE_302590_length_173_cov_184.351351	115	173	192	1	58	0.0172414
NODE_302590_length_173_cov_184.351351	115	173	196	1	58	0.0172414
NODE_302590_length_173_cov_184.351351	115	173	205	1	58	0.0172414
NODE_302590_length_173_cov_184.351351	115	173	206	2	58	0.0344828
NODE_302590_length_173_cov_184.351351	115	173	208	1	58	0.0172414
NODE_302590_length_173_cov_184.351351	115	173	222	1	58	0.0172414
NODE_302590_length_173_cov_184.351351	115	173	232	1	58	0.0172414
NODE_302590_length_173_cov_184.351351	115	173	244	2	58	0.0344828
NODE_302590_length_173_cov_184.351351	115	173	252	1	58	0.0172414
NODE_302590_length_173_cov_184.351351	115	173	278	1	58	0.0172414
NODE_302590_length_173_cov_184.351351	115	173	280	1	58	0.0172414
NODE_302590_length_173_cov_184.351351	115	173	281	1	58	0.0172414
NODE_302590_length_173_cov_184.351351	115	173	284	1	58	0.0172414
NODE_302590_length_173_cov_184.351351	115	173	298	1	58	0.0172414
NODE_302590_length_173_cov_184.351351	115	173	300	1	58	0.0172414
NODE_302590_length_173_cov_184.351351	115	173	306	1	58	0.0172414
NODE_302590_length_173_cov_184.351351	115	173	307	1	58	0.0172414
NODE_302590_length_173_cov_184.351351	115	173	317	2	58	0.0344828
NODE_302590_length_173_cov_184.351351	115	173	321	1	58	0.0172414
NODE_302596_length_173_cov_58.472973	0	78	0	9	78	0.1153846
NODE_302596_length_173_cov_58.472973	0	78	2	4	78	0.0512821
NODE_302596_length_173_cov_58.472973	0	78	4	4	78	0.0512821
NODE_302596_length_173_cov_58.472973	0	78	6	6	78	0.0769231
NODE_302596_length_173_cov_58.472973	0	78	7	4	78	0.0512821
NODE_302596_length_173_cov_58.472973	0	78	9	9	78	0.1153846
NODE_302596_length_173_cov_58.472973	0	78	11	3	78	0.0384615
NODE_302596_length_173_cov_58.472973	0	78	14	1	78	0.0128205
NODE_302596_length_173_cov_58.472973	0	78	15	6	78	0.0769231
NODE_302596_length_173_cov_58.472973	0	78	20	1	78	0.0128205
NODE_302596_length_173_cov_58.472973	0	78	26	5	78	0.0641026
NODE_302596_length_173_cov_58.472973	0	78	30	2	78	0.0256410
NODE_302596_length_173_cov_58.472973	0	78	32	1	78	0.0128205
NODE_302596_length_173_cov_58.472973	0	78	34	2	78	0.0256410
NODE_302596_length_173_cov_58.472973	0	78	36	1	78	0.0128205
NODE_302596_length_173_cov_58.472973	0	78	38	1	78	0.0128205
NODE_302596_length_173_cov_58.472973	0	78	42	3	78	0.0384615
NODE_302596_length_173_cov_58.472973	0	78	44	1	78	0.0128205
NODE_302596_length_173_cov_58.472973	0	78	46	1	78	0.0128205
NODE_302596_length_173_cov_58.472973	0	78	50	2	78	0.0256410
NODE_302596_length_173_cov_58.472973	0	78	54	12	78	0.1538462
NODE_302597_length_173_cov_57.148649	101	142	101	1	41	0.0243902
NODE_302597_length_173_cov_57.148649	101	142	103	4	41	0.0975610
NODE_302597_length_173_cov_57.148649	101	142	109	1	41	0.0243902
NODE_302597_length_173_cov_57.148649	101	142	111	1	41	0.0243902
NODE_302597_length_173_cov_57.148649	101	142	117	2	41	0.0487805
NODE_302597_length_173_cov_57.148649	101	142	118	1	41	0.0243902
NODE_302597_length_173_cov_57.148649	101	142	124	1	41	0.0243902
NODE_302597_length_173_cov_57.148649	101	142	126	2	41	0.0487805
NODE_302597_length_173_cov_57.148649	101	142	130	3	41	0.0731707
NODE_302597_length_173_cov_57.148649	101	142	132	1	41	0.0243902
NODE_302597_length_173_cov_57.148649	101	142	134	1	41	0.0243902
NODE_302597_length_173_cov_57.148649	101	142	136	3	41	0.0731707
NODE_302597_length_173_cov_57.148649	101	142	139	2	41	0.0487805
NODE_302597_length_173_cov_57.148649	101	142	143	4	41	0.0975610
NODE_302597_length_173_cov_57.148649	101	142	147	1	41	0.0243902
NODE_302597_length_173_cov_57.148649	101	142	151	1	41	0.0243902
NODE_302597_length_173_cov_57.148649	101	142	152	1	41	0.0243902
NODE_302597_length_173_cov_57.148649	101	142	156	6	41	0.1463415
NODE_302597_length_173_cov_57.148649	101	142	160	2	41	0.0487805
NODE_302597_length_173_cov_57.148649	101	142	164	2	41	0.0487805
NODE_302597_length_173_cov_57.148649	101	142	166	1	41	0.0243902
NODE_302597_length_173_cov_57.148649	109	173	19	1	64	0.0156250
NODE_302597_length_173_cov_57.148649	109	173	32	3	64	0.0468750
NODE_302597_length_173_cov_57.148649	109	173	34	1	64	0.0156250
NODE_302597_length_173_cov_57.148649	109	173	36	1	64	0.0156250
NODE_302597_length_173_cov_57.148649	109	173	41	2	64	0.0312500
NODE_302597_length_173_cov_57.148649	109	173	42	1	64	0.0156250
NODE_302597_length_173_cov_57.148649	109	173	45	1	64	0.0156250
NODE_302597_length_173_cov_57.148649	109	173	49	2	64	0.0312500
NODE_302597_length_173_cov_57.148649	109	173	50	1	64	0.0156250
NODE_302597_length_173_cov_57.148649	109	173	58	1	64	0.0156250
NODE_302597_length_173_cov_57.148649	109	173	62	2	64	0.0312500
NODE_302597_length_173_cov_57.148649	109	173	63	1	64	0.0156250
NODE_302597_length_173_cov_57.148649	109	173	68	1	64	0.0156250
NODE_302597_length_173_cov_57.148649	109	173	73	3	64	0.0468750
NODE_302597_length_173_cov_57.148649	109	173	77	1	64	0.0156250
NODE_302597_length_173_cov_57.148649	109	173	81	2	64	0.0312500
NODE_302597_length_173_cov_57.148649	109	173	87	1	64	0.0156250
NODE_302597_length_173_cov_57.148649	109	173	93	5	64	0.0781250
NODE_302597_length_173_cov_57.148649	109	173	99	1	64	0.0156250
NODE_302597_length_173_cov_57.148649	109	173	101	1	64	0.0156250
NODE_302597_length_173_cov_57.148649	109	173	103	4	64	0.0625000
NODE_302597_length_173_cov_57.148649	109	173	109	1	64	0.0156250
NODE_302597_length_173_cov_57.148649	109	173	111	1	64	0.0156250
NODE_302597_length_173_cov_57.148649	109	173	117	2	64	0.0312500
NODE_302597_length_173_cov_57.148649	109	173	118	1	64	0.0156250
NODE_302597_length_173_cov_57.148649	109	173	124	1	64	0.0156250
NODE_302597_length_173_cov_57.148649	109	173	126	2	64	0.0312500
NODE_302597_length_173_cov_57.148649	109	173	130	3	64	0.0468750
NODE_302597_length_173_cov_57.148649	109	173	132	1	64	0.0156250
NODE_302597_length_173_cov_57.148649	109	173	134	1	64	0.0156250
NODE_302597_length_173_cov_57.148649	109	173	136	3	64	0.0468750
NODE_302597_length_173_cov_57.148649	109	173	139	2	64	0.0312500
NODE_302597_length_173_cov_57.148649	109	173	143	4	64	0.0625000
NODE_302597_length_173_cov_57.148649	109	173	147	1	64	0.0156250
NODE_302597_length_173_cov_57.148649	109	173	151	1	64	0.0156250
NODE_302597_length_173_cov_57.148649	109	173	152	1	64	0.0156250
NODE_302597_length_173_cov_57.148649	109	173	156	3	64	0.0468750
NODE_302686_length_171_cov_218.666667	12	90	4	1	78	0.0128205
NODE_302686_length_171_cov_218.666667	12	90	8	1	78	0.0128205
NODE_302686_length_171_cov_218.666667	12	90	12	16	78	0.2051282
NODE_302686_length_171_cov_218.666667	12	90	19	1	78	0.0128205
NODE_302686_length_171_cov_218.666667	12	90	22	5	78	0.0641026
NODE_302686_length_171_cov_218.666667	12	90	28	3	78	0.0384615
NODE_302686_length_171_cov_218.666667	12	90	30	5	78	0.0641026
NODE_302686_length_171_cov_218.666667	12	90	32	3	78	0.0384615
NODE_302686_length_171_cov_218.666667	12	90	36	2	78	0.0256410
NODE_302686_length_171_cov_218.666667	12	90	38	2	78	0.0256410
NODE_302686_length_171_cov_218.666667	12	90	42	39	78	0.5000000
NODE_302686_length_171_cov_218.666667	12	90	4	1	78	0.0128205
NODE_302686_length_171_cov_218.666667	12	90	8	1	78	0.0128205
NODE_302686_length_171_cov_218.666667	12	90	12	16	78	0.2051282
NODE_302686_length_171_cov_218.666667	12	90	19	1	78	0.0128205
NODE_302686_length_171_cov_218.666667	12	90	22	5	78	0.0641026
NODE_302686_length_171_cov_218.666667	12	90	28	3	78	0.0384615
NODE_302686_length_171_cov_218.666667	12	90	30	5	78	0.0641026
NODE_302686_length_171_cov_218.666667	12	90	32	3	78	0.0384615
NODE_302686_length_171_cov_218.666667	12	90	36	2	78	0.0256410
NODE_302686_length_171_cov_218.666667	12	90	38	2	78	0.0256410
NODE_302686_length_171_cov_218.666667	12	90	42	39	78	0.5000000
NODE_302686_length_171_cov_218.666667	21	90	12	9	69	0.1304348
NODE_302686_length_171_cov_218.666667	21	90	19	1	69	0.0144928
NODE_302686_length_171_cov_218.666667	21	90	22	5	69	0.0724638
NODE_302686_length_171_cov_218.666667	21	90	28	3	69	0.0434783
NODE_302686_length_171_cov_218.666667	21	90	30	5	69	0.0724638
NODE_302686_length_171_cov_218.666667	21	90	32	3	69	0.0434783
NODE_302686_length_171_cov_218.666667	21	90	36	2	69	0.0289855
NODE_302686_length_171_cov_218.666667	21	90	38	2	69	0.0289855
NODE_302686_length_171_cov_218.666667	21	90	42	39	69	0.5652174
NODE_302689_length_171_cov_110.194444	81	161	0	12	80	0.1500000
NODE_302689_length_171_cov_110.194444	81	161	2	25	80	0.3125000
NODE_302689_length_171_cov_110.194444	81	161	4	43	80	0.5375000
NODE_302689_length_171_cov_110.194444	81	152	0	3	71	0.0422535
NODE_302689_length_171_cov_110.194444	81	152	2	25	71	0.3521127
NODE_302689_length_171_cov_110.194444	81	152	4	43	71	0.6056338
NODE_302691_length_171_cov_86.013889	106	171	0	8	65	0.1230769
NODE_302691_length_171_cov_86.013889	106	171	3	5	65	0.0769231
NODE_302691_length_171_cov_86.013889	106	171	6	9	65	0.1384615
NODE_302691_length_171_cov_86.013889	106	171	10	11	65	0.1692308
NODE_302691_length_171_cov_86.013889	106	171	12	32	65	0.4923077
NODE_302697_length_171_cov_46.430556	0	59	16	3	59	0.0508475
NODE_302697_length_171_cov_46.430556	0	59	18	3	59	0.0508475
NODE_302697_length_171_cov_46.430556	0	59	22	1	59	0.0169492
NODE_302697_length_171_cov_46.430556	0	59	25	1	59	0.0169492
NODE_302697_length_171_cov_46.430556	0	59	27	1	59	0.0169492
NODE_302697_length_171_cov_46.430556	0	59	29	1	59	0.0169492
NODE_302697_length_171_cov_46.430556	0	59	32	3	59	0.0508475
NODE_302697_length_171_cov_46.430556	0	59	34	1	59	0.0169492
NODE_302697_length_171_cov_46.430556	0	59	36	1	59	0.0169492
NODE_302697_length_171_cov_46.430556	0	59	38	2	59	0.0338983
NODE_302697_length_171_cov_46.430556	0	59	40	2	59	0.0338983
NODE_302697_length_171_cov_46.430556	0	59	42	1	59	0.0169492
NODE_302697_length_171_cov_46.430556	0	59	43	1	59	0.0169492
NODE_302697_length_171_cov_46.430556	0	59	44	1	59	0.0169492
NODE_302697_length_171_cov_46.430556	0	59	50	1	59	0.0169492
NODE_302697_length_171_cov_46.430556	0	59	54	3	59	0.0508475
NODE_302697_length_171_cov_46.430556	0	59	58	3	59	0.0508475
NODE_302697_length_171_cov_46.430556	0	59	62	1	59	0.0169492
NODE_302697_length_171_cov_46.430556	0	59	70	2	59	0.0338983
NODE_302697_length_171_cov_46.430556	0	59	76	1	59	0.0169492
NODE_302697_length_171_cov_46.430556	0	59	78	1	59	0.0169492
NODE_302697_length_171_cov_46.430556	0	59	81	1	59	0.0169492
NODE_302697_length_171_cov_46.430556	0	59	83	1	59	0.0169492
NODE_302697_length_171_cov_46.430556	0	59	87	1	59	0.0169492
NODE_302697_length_171_cov_46.430556	0	59	89	1	59	0.0169492
NODE_302697_length_171_cov_46.430556	0	59	93	1	59	0.0169492
NODE_302697_length_171_cov_46.430556	0	59	95	1	59	0.0169492
NODE_302697_length_171_cov_46.430556	0	59	97	1	59	0.0169492
NODE_302697_length_171_cov_46.430556	0	59	99	1	59	0.0169492
NODE_302697_length_171_cov_46.430556	0	59	104	4	59	0.0677966
NODE_302697_length_171_cov_46.430556	0	59	106	6	59	0.1016949
NODE_302697_length_171_cov_46.430556	0	59	108	2	59	0.0338983
NODE_302697_length_171_cov_46.430556	0	59	112	1	59	0.0169492
NODE_302697_length_171_cov_46.430556	0	59	116	4	59	0.0677966
NODE_302697_length_171_cov_46.430556	32	98	76	1	66	0.0151515
NODE_302697_length_171_cov_46.430556	32	98	78	1	66	0.0151515
NODE_302697_length_171_cov_46.430556	32	98	81	1	66	0.0151515
NODE_302697_length_171_cov_46.430556	32	98	83	1	66	0.0151515
NODE_302697_length_171_cov_46.430556	32	98	87	1	66	0.0151515
NODE_302697_length_171_cov_46.430556	32	98	89	1	66	0.0151515
NODE_302697_length_171_cov_46.430556	32	98	93	1	66	0.0151515
NODE_302697_length_171_cov_46.430556	32	98	95	1	66	0.0151515
NODE_302697_length_171_cov_46.430556	32	98	97	1	66	0.0151515
NODE_302697_length_171_cov_46.430556	32	98	99	1	66	0.0151515
NODE_302697_length_171_cov_46.430556	32	98	104	4	66	0.0606061
NODE_302697_length_171_cov_46.430556	32	98	106	6	66	0.0909091
NODE_302697_length_171_cov_46.430556	32	98	108	2	66	0.0303030
NODE_302697_length_171_cov_46.430556	32	98	112	1	66	0.0151515
NODE_302697_length_171_cov_46.430556	32	98	116	6	66	0.0909091
NODE_302697_length_171_cov_46.430556	32	98	118	2	66	0.0303030
NODE_302697_length_171_cov_46.430556	32	98	120	1	66	0.0151515
NODE_302697_length_171_cov_46.430556	32	98	122	34	66	0.5151515
NODE_302700_length_171_cov_40.069444	13	87	0	74	74	1.0000000
NODE_302702_length_171_cov_33.319444	84	158	2	15	74	0.2027027
NODE_302702_length_171_cov_33.319444	84	158	4	36	74	0.4864865
NODE_302702_length_171_cov_33.319444	84	158	8	23	74	0.3108108
NODE_302764_length_170_cov_217.422535	10	90	28	1	80	0.0125000
NODE_302764_length_170_cov_217.422535	10	90	29	1	80	0.0125000
NODE_302764_length_170_cov_217.422535	10	90	30	1	80	0.0125000
NODE_302764_length_170_cov_217.422535	10	90	32	1	80	0.0125000
NODE_302764_length_170_cov_217.422535	10	90	34	1	80	0.0125000
NODE_302764_length_170_cov_217.422535	10	90	36	3	80	0.0375000
NODE_302764_length_170_cov_217.422535	10	90	37	3	80	0.0375000
NODE_302764_length_170_cov_217.422535	10	90	38	1	80	0.0125000
NODE_302764_length_170_cov_217.422535	10	90	44	1	80	0.0125000
NODE_302764_length_170_cov_217.422535	10	90	45	1	80	0.0125000
NODE_302764_length_170_cov_217.422535	10	90	51	2	80	0.0250000
NODE_302764_length_170_cov_217.422535	10	90	53	2	80	0.0250000
NODE_302764_length_170_cov_217.422535	10	90	62	1	80	0.0125000
NODE_302764_length_170_cov_217.422535	10	90	65	1	80	0.0125000
NODE_302764_length_170_cov_217.422535	10	90	73	3	80	0.0375000
NODE_302764_length_170_cov_217.422535	10	90	77	1	80	0.0125000
NODE_302764_length_170_cov_217.422535	10	90	79	3	80	0.0375000
NODE_302764_length_170_cov_217.422535	10	90	81	1	80	0.0125000
NODE_302764_length_170_cov_217.422535	10	90	82	1	80	0.0125000
NODE_302764_length_170_cov_217.422535	10	90	86	2	80	0.0250000
NODE_302764_length_170_cov_217.422535	10	90	90	1	80	0.0125000
NODE_302764_length_170_cov_217.422535	10	90	118	1	80	0.0125000
NODE_302764_length_170_cov_217.422535	10	90	120	1	80	0.0125000
NODE_302764_length_170_cov_217.422535	10	90	124	1	80	0.0125000
NODE_302764_length_170_cov_217.422535	10	90	125	1	80	0.0125000
NODE_302764_length_170_cov_217.422535	10	90	127	1	80	0.0125000
NODE_302764_length_170_cov_217.422535	10	90	133	1	80	0.0125000
NODE_302764_length_170_cov_217.422535	10	90	134	3	80	0.0375000
NODE_302764_length_170_cov_217.422535	10	90	136	1	80	0.0125000
NODE_302764_length_170_cov_217.422535	10	90	148	2	80	0.0250000
NODE_302764_length_170_cov_217.422535	10	90	152	3	80	0.0375000
NODE_302764_length_170_cov_217.422535	10	90	154	1	80	0.0125000
NODE_302764_length_170_cov_217.422535	10	90	156	1	80	0.0125000
NODE_302764_length_170_cov_217.422535	10	90	164	3	80	0.0375000
NODE_302764_length_170_cov_217.422535	10	90	168	1	80	0.0125000
NODE_302764_length_170_cov_217.422535	10	90	174	4	80	0.0500000
NODE_302764_length_170_cov_217.422535	10	90	176	23	80	0.2875000
NODE_302764_length_170_cov_217.422535	10	90	28	1	80	0.0125000
NODE_302764_length_170_cov_217.422535	10	90	29	1	80	0.0125000
NODE_302764_length_170_cov_217.422535	10	90	30	1	80	0.0125000
NODE_302764_length_170_cov_217.422535	10	90	32	1	80	0.0125000
NODE_302764_length_170_cov_217.422535	10	90	34	1	80	0.0125000
NODE_302764_length_170_cov_217.422535	10	90	36	3	80	0.0375000
NODE_302764_length_170_cov_217.422535	10	90	37	3	80	0.0375000
NODE_302764_length_170_cov_217.422535	10	90	38	1	80	0.0125000
NODE_302764_length_170_cov_217.422535	10	90	44	1	80	0.0125000
NODE_302764_length_170_cov_217.422535	10	90	45	1	80	0.0125000
NODE_302764_length_170_cov_217.422535	10	90	51	2	80	0.0250000
NODE_302764_length_170_cov_217.422535	10	90	53	2	80	0.0250000
NODE_302764_length_170_cov_217.422535	10	90	62	1	80	0.0125000
NODE_302764_length_170_cov_217.422535	10	90	65	1	80	0.0125000
NODE_302764_length_170_cov_217.422535	10	90	73	3	80	0.0375000
NODE_302764_length_170_cov_217.422535	10	90	77	1	80	0.0125000
NODE_302764_length_170_cov_217.422535	10	90	79	3	80	0.0375000
NODE_302764_length_170_cov_217.422535	10	90	81	1	80	0.0125000
NODE_302764_length_170_cov_217.422535	10	90	82	1	80	0.0125000
NODE_302764_length_170_cov_217.422535	10	90	86	2	80	0.0250000
NODE_302764_length_170_cov_217.422535	10	90	90	1	80	0.0125000
NODE_302764_length_170_cov_217.422535	10	90	118	1	80	0.0125000
NODE_302764_length_170_cov_217.422535	10	90	120	1	80	0.0125000
NODE_302764_length_170_cov_217.422535	10	90	124	1	80	0.0125000
NODE_302764_length_170_cov_217.422535	10	90	125	1	80	0.0125000
NODE_302764_length_170_cov_217.422535	10	90	127	1	80	0.0125000
NODE_302764_length_170_cov_217.422535	10	90	133	1	80	0.0125000
NODE_302764_length_170_cov_217.422535	10	90	134	3	80	0.0375000
NODE_302764_length_170_cov_217.422535	10	90	136	1	80	0.0125000
NODE_302764_length_170_cov_217.422535	10	90	148	2	80	0.0250000
NODE_302764_length_170_cov_217.422535	10	90	152	3	80	0.0375000
NODE_302764_length_170_cov_217.422535	10	90	154	1	80	0.0125000
NODE_302764_length_170_cov_217.422535	10	90	156	1	80	0.0125000
NODE_302764_length_170_cov_217.422535	10	90	164	3	80	0.0375000
NODE_302764_length_170_cov_217.422535	10	90	168	1	80	0.0125000
NODE_302764_length_170_cov_217.422535	10	90	174	4	80	0.0500000
NODE_302764_length_170_cov_217.422535	10	90	176	23	80	0.2875000
NODE_302764_length_170_cov_217.422535	10	90	28	1	80	0.0125000
NODE_302764_length_170_cov_217.422535	10	90	29	1	80	0.0125000
NODE_302764_length_170_cov_217.422535	10	90	30	1	80	0.0125000
NODE_302764_length_170_cov_217.422535	10	90	32	1	80	0.0125000
NODE_302764_length_170_cov_217.422535	10	90	34	1	80	0.0125000
NODE_302764_length_170_cov_217.422535	10	90	36	3	80	0.0375000
NODE_302764_length_170_cov_217.422535	10	90	37	3	80	0.0375000
NODE_302764_length_170_cov_217.422535	10	90	38	1	80	0.0125000
NODE_302764_length_170_cov_217.422535	10	90	44	1	80	0.0125000
NODE_302764_length_170_cov_217.422535	10	90	45	1	80	0.0125000
NODE_302764_length_170_cov_217.422535	10	90	51	2	80	0.0250000
NODE_302764_length_170_cov_217.422535	10	90	53	2	80	0.0250000
NODE_302764_length_170_cov_217.422535	10	90	62	1	80	0.0125000
NODE_302764_length_170_cov_217.422535	10	90	65	1	80	0.0125000
NODE_302764_length_170_cov_217.422535	10	90	73	3	80	0.0375000
NODE_302764_length_170_cov_217.422535	10	90	77	1	80	0.0125000
NODE_302764_length_170_cov_217.422535	10	90	79	3	80	0.0375000
NODE_302764_length_170_cov_217.422535	10	90	81	1	80	0.0125000
NODE_302764_length_170_cov_217.422535	10	90	82	1	80	0.0125000
NODE_302764_length_170_cov_217.422535	10	90	86	2	80	0.0250000
NODE_302764_length_170_cov_217.422535	10	90	90	1	80	0.0125000
NODE_302764_length_170_cov_217.422535	10	90	118	1	80	0.0125000
NODE_302764_length_170_cov_217.422535	10	90	120	1	80	0.0125000
NODE_302764_length_170_cov_217.422535	10	90	124	1	80	0.0125000
NODE_302764_length_170_cov_217.422535	10	90	125	1	80	0.0125000
NODE_302764_length_170_cov_217.422535	10	90	127	1	80	0.0125000
NODE_302764_length_170_cov_217.422535	10	90	133	1	80	0.0125000
NODE_302764_length_170_cov_217.422535	10	90	134	3	80	0.0375000
NODE_302764_length_170_cov_217.422535	10	90	136	1	80	0.0125000
NODE_302764_length_170_cov_217.422535	10	90	148	2	80	0.0250000
NODE_302764_length_170_cov_217.422535	10	90	152	3	80	0.0375000
NODE_302764_length_170_cov_217.422535	10	90	154	1	80	0.0125000
NODE_302764_length_170_cov_217.422535	10	90	156	1	80	0.0125000
NODE_302764_length_170_cov_217.422535	10	90	164	3	80	0.0375000
NODE_302764_length_170_cov_217.422535	10	90	168	1	80	0.0125000
NODE_302764_length_170_cov_217.422535	10	90	174	4	80	0.0500000
NODE_302764_length_170_cov_217.422535	10	90	176	23	80	0.2875000
NODE_302764_length_170_cov_217.422535	10	90	28	1	80	0.0125000
NODE_302764_length_170_cov_217.422535	10	90	29	1	80	0.0125000
NODE_302764_length_170_cov_217.422535	10	90	30	1	80	0.0125000
NODE_302764_length_170_cov_217.422535	10	90	32	1	80	0.0125000
NODE_302764_length_170_cov_217.422535	10	90	34	1	80	0.0125000
NODE_302764_length_170_cov_217.422535	10	90	36	3	80	0.0375000
NODE_302764_length_170_cov_217.422535	10	90	37	3	80	0.0375000
NODE_302764_length_170_cov_217.422535	10	90	38	1	80	0.0125000
NODE_302764_length_170_cov_217.422535	10	90	44	1	80	0.0125000
NODE_302764_length_170_cov_217.422535	10	90	45	1	80	0.0125000
NODE_302764_length_170_cov_217.422535	10	90	51	2	80	0.0250000
NODE_302764_length_170_cov_217.422535	10	90	53	2	80	0.0250000
NODE_302764_length_170_cov_217.422535	10	90	62	1	80	0.0125000
NODE_302764_length_170_cov_217.422535	10	90	65	1	80	0.0125000
NODE_302764_length_170_cov_217.422535	10	90	73	3	80	0.0375000
NODE_302764_length_170_cov_217.422535	10	90	77	1	80	0.0125000
NODE_302764_length_170_cov_217.422535	10	90	79	3	80	0.0375000
NODE_302764_length_170_cov_217.422535	10	90	81	1	80	0.0125000
NODE_302764_length_170_cov_217.422535	10	90	82	1	80	0.0125000
NODE_302764_length_170_cov_217.422535	10	90	86	2	80	0.0250000
NODE_302764_length_170_cov_217.422535	10	90	90	1	80	0.0125000
NODE_302764_length_170_cov_217.422535	10	90	118	1	80	0.0125000
NODE_302764_length_170_cov_217.422535	10	90	120	1	80	0.0125000
NODE_302764_length_170_cov_217.422535	10	90	124	1	80	0.0125000
NODE_302764_length_170_cov_217.422535	10	90	125	1	80	0.0125000
NODE_302764_length_170_cov_217.422535	10	90	127	1	80	0.0125000
NODE_302764_length_170_cov_217.422535	10	90	133	1	80	0.0125000
NODE_302764_length_170_cov_217.422535	10	90	134	3	80	0.0375000
NODE_302764_length_170_cov_217.422535	10	90	136	1	80	0.0125000
NODE_302764_length_170_cov_217.422535	10	90	148	2	80	0.0250000
NODE_302764_length_170_cov_217.422535	10	90	152	3	80	0.0375000
NODE_302764_length_170_cov_217.422535	10	90	154	1	80	0.0125000
NODE_302764_length_170_cov_217.422535	10	90	156	1	80	0.0125000
NODE_302764_length_170_cov_217.422535	10	90	164	3	80	0.0375000
NODE_302764_length_170_cov_217.422535	10	90	168	1	80	0.0125000
NODE_302764_length_170_cov_217.422535	10	90	174	4	80	0.0500000
NODE_302764_length_170_cov_217.422535	10	90	176	23	80	0.2875000
NODE_302764_length_170_cov_217.422535	10	90	28	1	80	0.0125000
NODE_302764_length_170_cov_217.422535	10	90	29	1	80	0.0125000
NODE_302764_length_170_cov_217.422535	10	90	30	1	80	0.0125000
NODE_302764_length_170_cov_217.422535	10	90	32	1	80	0.0125000
NODE_302764_length_170_cov_217.422535	10	90	34	1	80	0.0125000
NODE_302764_length_170_cov_217.422535	10	90	36	3	80	0.0375000
NODE_302764_length_170_cov_217.422535	10	90	37	3	80	0.0375000
NODE_302764_length_170_cov_217.422535	10	90	38	1	80	0.0125000
NODE_302764_length_170_cov_217.422535	10	90	44	1	80	0.0125000
NODE_302764_length_170_cov_217.422535	10	90	45	1	80	0.0125000
NODE_302764_length_170_cov_217.422535	10	90	51	2	80	0.0250000
NODE_302764_length_170_cov_217.422535	10	90	53	2	80	0.0250000
NODE_302764_length_170_cov_217.422535	10	90	62	1	80	0.0125000
NODE_302764_length_170_cov_217.422535	10	90	65	1	80	0.0125000
NODE_302764_length_170_cov_217.422535	10	90	73	3	80	0.0375000
NODE_302764_length_170_cov_217.422535	10	90	77	1	80	0.0125000
NODE_302764_length_170_cov_217.422535	10	90	79	3	80	0.0375000
NODE_302764_length_170_cov_217.422535	10	90	81	1	80	0.0125000
NODE_302764_length_170_cov_217.422535	10	90	82	1	80	0.0125000
NODE_302764_length_170_cov_217.422535	10	90	86	2	80	0.0250000
NODE_302764_length_170_cov_217.422535	10	90	90	1	80	0.0125000
NODE_302764_length_170_cov_217.422535	10	90	118	1	80	0.0125000
NODE_302764_length_170_cov_217.422535	10	90	120	1	80	0.0125000
NODE_302764_length_170_cov_217.422535	10	90	124	1	80	0.0125000
NODE_302764_length_170_cov_217.422535	10	90	125	1	80	0.0125000
NODE_302764_length_170_cov_217.422535	10	90	127	1	80	0.0125000
NODE_302764_length_170_cov_217.422535	10	90	133	1	80	0.0125000
NODE_302764_length_170_cov_217.422535	10	90	134	3	80	0.0375000
NODE_302764_length_170_cov_217.422535	10	90	136	1	80	0.0125000
NODE_302764_length_170_cov_217.422535	10	90	148	2	80	0.0250000
NODE_302764_length_170_cov_217.422535	10	90	152	3	80	0.0375000
NODE_302764_length_170_cov_217.422535	10	90	154	1	80	0.0125000
NODE_302764_length_170_cov_217.422535	10	90	156	1	80	0.0125000
NODE_302764_length_170_cov_217.422535	10	90	164	3	80	0.0375000
NODE_302764_length_170_cov_217.422535	10	90	168	1	80	0.0125000
NODE_302764_length_170_cov_217.422535	10	90	174	4	80	0.0500000
NODE_302764_length_170_cov_217.422535	10	90	176	23	80	0.2875000
NODE_302764_length_170_cov_217.422535	19	90	37	2	71	0.0281690
NODE_302764_length_170_cov_217.422535	19	90	38	1	71	0.0140845
NODE_302764_length_170_cov_217.422535	19	90	44	1	71	0.0140845
NODE_302764_length_170_cov_217.422535	19	90	45	1	71	0.0140845
NODE_302764_length_170_cov_217.422535	19	90	51	2	71	0.0281690
NODE_302764_length_170_cov_217.422535	19	90	53	2	71	0.0281690
NODE_302764_length_170_cov_217.422535	19	90	62	1	71	0.0140845
NODE_302764_length_170_cov_217.422535	19	90	65	1	71	0.0140845
NODE_302764_length_170_cov_217.422535	19	90	73	3	71	0.0422535
NODE_302764_length_170_cov_217.422535	19	90	77	1	71	0.0140845
NODE_302764_length_170_cov_217.422535	19	90	79	3	71	0.0422535
NODE_302764_length_170_cov_217.422535	19	90	81	1	71	0.0140845
NODE_302764_length_170_cov_217.422535	19	90	82	1	71	0.0140845
NODE_302764_length_170_cov_217.422535	19	90	86	2	71	0.0281690
NODE_302764_length_170_cov_217.422535	19	90	90	1	71	0.0140845
NODE_302764_length_170_cov_217.422535	19	90	118	1	71	0.0140845
NODE_302764_length_170_cov_217.422535	19	90	120	1	71	0.0140845
NODE_302764_length_170_cov_217.422535	19	90	124	1	71	0.0140845
NODE_302764_length_170_cov_217.422535	19	90	125	1	71	0.0140845
NODE_302764_length_170_cov_217.422535	19	90	127	1	71	0.0140845
NODE_302764_length_170_cov_217.422535	19	90	133	1	71	0.0140845
NODE_302764_length_170_cov_217.422535	19	90	134	3	71	0.0422535
NODE_302764_length_170_cov_217.422535	19	90	136	1	71	0.0140845
NODE_302764_length_170_cov_217.422535	19	90	148	2	71	0.0281690
NODE_302764_length_170_cov_217.422535	19	90	152	3	71	0.0422535
NODE_302764_length_170_cov_217.422535	19	90	154	1	71	0.0140845
NODE_302764_length_170_cov_217.422535	19	90	156	1	71	0.0140845
NODE_302764_length_170_cov_217.422535	19	90	164	3	71	0.0422535
NODE_302764_length_170_cov_217.422535	19	90	168	1	71	0.0140845
NODE_302764_length_170_cov_217.422535	19	90	174	4	71	0.0563380
NODE_302764_length_170_cov_217.422535	19	90	176	23	71	0.3239437
NODE_302764_length_170_cov_217.422535	63	126	151	1	63	0.0158730
NODE_302764_length_170_cov_217.422535	63	126	153	2	63	0.0317460
NODE_302764_length_170_cov_217.422535	63	126	155	2	63	0.0317460
NODE_302764_length_170_cov_217.422535	63	126	161	1	63	0.0158730
NODE_302764_length_170_cov_217.422535	63	126	165	3	63	0.0476190
NODE_302764_length_170_cov_217.422535	63	126	169	6	63	0.0952381
NODE_302764_length_170_cov_217.422535	63	126	171	1	63	0.0158730
NODE_302764_length_170_cov_217.422535	63	126	174	4	63	0.0634921
NODE_302764_length_170_cov_217.422535	63	126	175	4	63	0.0634921
NODE_302764_length_170_cov_217.422535	63	126	176	39	63	0.6190476
NODE_302764_length_170_cov_217.422535	63	126	151	1	63	0.0158730
NODE_302764_length_170_cov_217.422535	63	126	153	2	63	0.0317460
NODE_302764_length_170_cov_217.422535	63	126	155	2	63	0.0317460
NODE_302764_length_170_cov_217.422535	63	126	161	1	63	0.0158730
NODE_302764_length_170_cov_217.422535	63	126	165	3	63	0.0476190
NODE_302764_length_170_cov_217.422535	63	126	169	6	63	0.0952381
NODE_302764_length_170_cov_217.422535	63	126	171	1	63	0.0158730
NODE_302764_length_170_cov_217.422535	63	126	174	4	63	0.0634921
NODE_302764_length_170_cov_217.422535	63	126	175	4	63	0.0634921
NODE_302764_length_170_cov_217.422535	63	126	176	39	63	0.6190476
NODE_302768_length_170_cov_102.816901	23	86	47	2	63	0.0317460
NODE_302768_length_170_cov_102.816901	23	86	51	7	63	0.1111111
NODE_302768_length_170_cov_102.816901	23	86	52	5	63	0.0793651
NODE_302768_length_170_cov_102.816901	23	86	56	1	63	0.0158730
NODE_302768_length_170_cov_102.816901	23	86	58	6	63	0.0952381
NODE_302768_length_170_cov_102.816901	23	86	60	1	63	0.0158730
NODE_302768_length_170_cov_102.816901	23	86	62	7	63	0.1111111
NODE_302768_length_170_cov_102.816901	23	86	64	12	63	0.1904762
NODE_302768_length_170_cov_102.816901	23	86	66	2	63	0.0317460
NODE_302768_length_170_cov_102.816901	23	86	68	20	63	0.3174603
NODE_302806_length_169_cov_47.757143	70	150	48	1	80	0.0125000
NODE_302806_length_169_cov_47.757143	70	150	58	2	80	0.0250000
NODE_302806_length_169_cov_47.757143	70	150	64	3	80	0.0375000
NODE_302806_length_169_cov_47.757143	70	150	78	7	80	0.0875000
NODE_302806_length_169_cov_47.757143	70	150	84	4	80	0.0500000
NODE_302806_length_169_cov_47.757143	70	150	86	6	80	0.0750000
NODE_302806_length_169_cov_47.757143	70	150	88	1	80	0.0125000
NODE_302806_length_169_cov_47.757143	70	150	92	3	80	0.0375000
NODE_302806_length_169_cov_47.757143	70	150	93	11	80	0.1375000
NODE_302806_length_169_cov_47.757143	70	150	94	42	80	0.5250000
NODE_302869_length_168_cov_10.391304	66	99	0	33	33	1.0000000
NODE_302869_length_168_cov_10.391304	135	168	0	33	33	1.0000000
NODE_302966_length_166_cov_401.149254	31	109	70	2	78	0.0256410
NODE_302966_length_166_cov_401.149254	31	109	78	1	78	0.0128205
NODE_302966_length_166_cov_401.149254	31	109	82	1	78	0.0128205
NODE_302966_length_166_cov_401.149254	31	109	86	1	78	0.0128205
NODE_302966_length_166_cov_401.149254	31	109	88	1	78	0.0128205
NODE_302966_length_166_cov_401.149254	31	109	92	1	78	0.0128205
NODE_302966_length_166_cov_401.149254	31	109	113	1	78	0.0128205
NODE_302966_length_166_cov_401.149254	31	109	120	1	78	0.0128205
NODE_302966_length_166_cov_401.149254	31	109	124	1	78	0.0128205
NODE_302966_length_166_cov_401.149254	31	109	126	1	78	0.0128205
NODE_302966_length_166_cov_401.149254	31	109	130	1	78	0.0128205
NODE_302966_length_166_cov_401.149254	31	109	151	1	78	0.0128205
NODE_302966_length_166_cov_401.149254	31	109	152	1	78	0.0128205
NODE_302966_length_166_cov_401.149254	31	109	160	1	78	0.0128205
NODE_302966_length_166_cov_401.149254	31	109	164	1	78	0.0128205
NODE_302966_length_166_cov_401.149254	31	109	172	2	78	0.0256410
NODE_302966_length_166_cov_401.149254	31	109	180	1	78	0.0128205
NODE_302966_length_166_cov_401.149254	31	109	182	1	78	0.0128205
NODE_302966_length_166_cov_401.149254	31	109	188	2	78	0.0256410
NODE_302966_length_166_cov_401.149254	31	109	190	1	78	0.0128205
NODE_302966_length_166_cov_401.149254	31	109	192	2	78	0.0256410
NODE_302966_length_166_cov_401.149254	31	109	197	2	78	0.0256410
NODE_302966_length_166_cov_401.149254	31	109	206	1	78	0.0128205
NODE_302966_length_166_cov_401.149254	31	109	208	2	78	0.0256410
NODE_302966_length_166_cov_401.149254	31	109	211	1	78	0.0128205
NODE_302966_length_166_cov_401.149254	31	109	212	1	78	0.0128205
NODE_302966_length_166_cov_401.149254	31	109	213	6	78	0.0769231
NODE_302966_length_166_cov_401.149254	31	109	214	2	78	0.0256410
NODE_302966_length_166_cov_401.149254	31	109	215	24	78	0.3076923
NODE_302966_length_166_cov_401.149254	31	109	216	2	78	0.0256410
NODE_302966_length_166_cov_401.149254	31	109	217	12	78	0.1538462
NODE_302966_length_166_cov_401.149254	82	157	53	1	75	0.0133333
NODE_302966_length_166_cov_401.149254	82	157	54	3	75	0.0400000
NODE_302966_length_166_cov_401.149254	82	157	56	1	75	0.0133333
NODE_302966_length_166_cov_401.149254	82	157	58	1	75	0.0133333
NODE_302966_length_166_cov_401.149254	82	157	65	1	75	0.0133333
NODE_302966_length_166_cov_401.149254	82	157	67	1	75	0.0133333
NODE_302966_length_166_cov_401.149254	82	157	75	1	75	0.0133333
NODE_302966_length_166_cov_401.149254	82	157	77	1	75	0.0133333
NODE_302966_length_166_cov_401.149254	82	157	86	1	75	0.0133333
NODE_302966_length_166_cov_401.149254	82	157	91	1	75	0.0133333
NODE_302966_length_166_cov_401.149254	82	157	95	1	75	0.0133333
NODE_302966_length_166_cov_401.149254	82	157	99	1	75	0.0133333
NODE_302966_length_166_cov_401.149254	82	157	101	1	75	0.0133333
NODE_302966_length_166_cov_401.149254	82	157	112	1	75	0.0133333
NODE_302966_length_166_cov_401.149254	82	157	118	1	75	0.0133333
NODE_302966_length_166_cov_401.149254	82	157	122	2	75	0.0266667
NODE_302966_length_166_cov_401.149254	82	157	128	1	75	0.0133333
NODE_302966_length_166_cov_401.149254	82	157	130	1	75	0.0133333
NODE_302966_length_166_cov_401.149254	82	157	135	2	75	0.0266667
NODE_302966_length_166_cov_401.149254	82	157	136	1	75	0.0133333
NODE_302966_length_166_cov_401.149254	82	157	138	1	75	0.0133333
NODE_302966_length_166_cov_401.149254	82	157	151	2	75	0.0266667
NODE_302966_length_166_cov_401.149254	82	157	154	1	75	0.0133333
NODE_302966_length_166_cov_401.149254	82	157	160	1	75	0.0133333
NODE_302966_length_166_cov_401.149254	82	157	164	2	75	0.0266667
NODE_302966_length_166_cov_401.149254	82	157	168	2	75	0.0266667
NODE_302966_length_166_cov_401.149254	82	157	170	1	75	0.0133333
NODE_302966_length_166_cov_401.149254	82	157	176	1	75	0.0133333
NODE_302966_length_166_cov_401.149254	82	157	177	1	75	0.0133333
NODE_302966_length_166_cov_401.149254	82	157	181	2	75	0.0266667
NODE_302966_length_166_cov_401.149254	82	157	189	2	75	0.0266667
NODE_302966_length_166_cov_401.149254	82	157	197	2	75	0.0266667
NODE_302966_length_166_cov_401.149254	82	157	203	5	75	0.0666667
NODE_302966_length_166_cov_401.149254	82	157	211	2	75	0.0266667
NODE_302966_length_166_cov_401.149254	82	157	213	6	75	0.0800000
NODE_302966_length_166_cov_401.149254	82	157	215	20	75	0.2666667
NODE_302974_length_166_cov_123.223881	46	97	6	51	51	1.0000000
NODE_303071_length_164_cov_154.076923	0	75	0	2	75	0.0266667
NODE_303071_length_164_cov_154.076923	0	75	1	5	75	0.0666667
NODE_303071_length_164_cov_154.076923	0	75	2	42	75	0.5600000
NODE_303071_length_164_cov_154.076923	0	75	4	7	75	0.0933333
NODE_303071_length_164_cov_154.076923	0	75	6	19	75	0.2533333
NODE_303071_length_164_cov_154.076923	48	128	2	1	80	0.0125000
NODE_303071_length_164_cov_154.076923	48	128	4	7	80	0.0875000
NODE_303071_length_164_cov_154.076923	48	128	6	72	80	0.9000000
NODE_303074_length_164_cov_69.369231	0	64	4	11	64	0.1718750
NODE_303074_length_164_cov_69.369231	0	64	6	21	64	0.3281250
NODE_303074_length_164_cov_69.369231	0	64	10	32	64	0.5000000
NODE_303079_length_164_cov_43.923077	36	100	82	14	64	0.2187500
NODE_303079_length_164_cov_43.923077	36	100	88	4	64	0.0625000
NODE_303079_length_164_cov_43.923077	36	100	100	5	64	0.0781250
NODE_303079_length_164_cov_43.923077	36	100	102	1	64	0.0156250
NODE_303079_length_164_cov_43.923077	36	100	104	40	64	0.6250000
NODE_303079_length_164_cov_43.923077	36	100	82	14	64	0.2187500
NODE_303079_length_164_cov_43.923077	36	100	88	4	64	0.0625000
NODE_303079_length_164_cov_43.923077	36	100	100	5	64	0.0781250
NODE_303079_length_164_cov_43.923077	36	100	102	1	64	0.0156250
NODE_303079_length_164_cov_43.923077	36	100	104	40	64	0.6250000
NODE_303079_length_164_cov_43.923077	73	153	55	1	80	0.0125000
NODE_303079_length_164_cov_43.923077	73	153	61	4	80	0.0500000
NODE_303079_length_164_cov_43.923077	73	153	69	2	80	0.0250000
NODE_303079_length_164_cov_43.923077	73	153	74	15	80	0.1875000
NODE_303079_length_164_cov_43.923077	73	153	86	12	80	0.1500000
NODE_303079_length_164_cov_43.923077	73	153	92	1	80	0.0125000
NODE_303079_length_164_cov_43.923077	73	153	96	4	80	0.0500000
NODE_303079_length_164_cov_43.923077	73	153	97	5	80	0.0625000
NODE_303079_length_164_cov_43.923077	73	153	100	7	80	0.0875000
NODE_303079_length_164_cov_43.923077	73	153	102	1	80	0.0125000
NODE_303079_length_164_cov_43.923077	73	153	104	28	80	0.3500000
NODE_303079_length_164_cov_43.923077	73	153	55	1	80	0.0125000
NODE_303079_length_164_cov_43.923077	73	153	61	4	80	0.0500000
NODE_303079_length_164_cov_43.923077	73	153	69	2	80	0.0250000
NODE_303079_length_164_cov_43.923077	73	153	74	15	80	0.1875000
NODE_303079_length_164_cov_43.923077	73	153	86	12	80	0.1500000
NODE_303079_length_164_cov_43.923077	73	153	92	1	80	0.0125000
NODE_303079_length_164_cov_43.923077	73	153	96	4	80	0.0500000
NODE_303079_length_164_cov_43.923077	73	153	97	5	80	0.0625000
NODE_303079_length_164_cov_43.923077	73	153	100	7	80	0.0875000
NODE_303079_length_164_cov_43.923077	73	153	102	1	80	0.0125000
NODE_303079_length_164_cov_43.923077	73	153	104	28	80	0.3500000
NODE_303079_length_164_cov_43.923077	73	153	55	1	80	0.0125000
NODE_303079_length_164_cov_43.923077	73	153	61	4	80	0.0500000
NODE_303079_length_164_cov_43.923077	73	153	69	2	80	0.0250000
NODE_303079_length_164_cov_43.923077	73	153	74	15	80	0.1875000
NODE_303079_length_164_cov_43.923077	73	153	86	12	80	0.1500000
NODE_303079_length_164_cov_43.923077	73	153	92	1	80	0.0125000
NODE_303079_length_164_cov_43.923077	73	153	96	4	80	0.0500000
NODE_303079_length_164_cov_43.923077	73	153	97	5	80	0.0625000
NODE_303079_length_164_cov_43.923077	73	153	100	7	80	0.0875000
NODE_303079_length_164_cov_43.923077	73	153	102	1	80	0.0125000
NODE_303079_length_164_cov_43.923077	73	153	104	28	80	0.3500000
NODE_303079_length_164_cov_43.923077	73	153	55	1	80	0.0125000
NODE_303079_length_164_cov_43.923077	73	153	61	4	80	0.0500000
NODE_303079_length_164_cov_43.923077	73	153	69	2	80	0.0250000
NODE_303079_length_164_cov_43.923077	73	153	74	15	80	0.1875000
NODE_303079_length_164_cov_43.923077	73	153	86	12	80	0.1500000
NODE_303079_length_164_cov_43.923077	73	153	92	1	80	0.0125000
NODE_303079_length_164_cov_43.923077	73	153	96	4	80	0.0500000
NODE_303079_length_164_cov_43.923077	73	153	97	5	80	0.0625000
NODE_303079_length_164_cov_43.923077	73	153	100	7	80	0.0875000
NODE_303079_length_164_cov_43.923077	73	153	102	1	80	0.0125000
NODE_303079_length_164_cov_43.923077	73	153	104	28	80	0.3500000
NODE_303079_length_164_cov_43.923077	73	153	55	1	80	0.0125000
NODE_303079_length_164_cov_43.923077	73	153	61	4	80	0.0500000
NODE_303079_length_164_cov_43.923077	73	153	69	2	80	0.0250000
NODE_303079_length_164_cov_43.923077	73	153	74	15	80	0.1875000
NODE_303079_length_164_cov_43.923077	73	153	86	12	80	0.1500000
NODE_303079_length_164_cov_43.923077	73	153	92	1	80	0.0125000
NODE_303079_length_164_cov_43.923077	73	153	96	4	80	0.0500000
NODE_303079_length_164_cov_43.923077	73	153	97	5	80	0.0625000
NODE_303079_length_164_cov_43.923077	73	153	100	7	80	0.0875000
NODE_303079_length_164_cov_43.923077	73	153	102	1	80	0.0125000
NODE_303079_length_164_cov_43.923077	73	153	104	28	80	0.3500000
NODE_303079_length_164_cov_43.923077	73	144	74	13	71	0.1830986
NODE_303079_length_164_cov_43.923077	73	144	86	12	71	0.1690141
NODE_303079_length_164_cov_43.923077	73	144	92	1	71	0.0140845
NODE_303079_length_164_cov_43.923077	73	144	96	4	71	0.0563380
NODE_303079_length_164_cov_43.923077	73	144	97	5	71	0.0704225
NODE_303079_length_164_cov_43.923077	73	144	100	7	71	0.0985916
NODE_303079_length_164_cov_43.923077	73	144	102	1	71	0.0140845
NODE_303079_length_164_cov_43.923077	73	144	104	28	71	0.3943662
NODE_303135_length_163_cov_480.593750	0	40	7	1	40	0.0250000
NODE_303135_length_163_cov_480.593750	0	40	10	1	40	0.0250000
NODE_303135_length_163_cov_480.593750	0	40	16	1	40	0.0250000
NODE_303135_length_163_cov_480.593750	0	40	17	1	40	0.0250000
NODE_303135_length_163_cov_480.593750	0	40	19	3	40	0.0750000
NODE_303135_length_163_cov_480.593750	0	40	25	1	40	0.0250000
NODE_303135_length_163_cov_480.593750	0	40	27	2	40	0.0500000
NODE_303135_length_163_cov_480.593750	0	40	29	2	40	0.0500000
NODE_303135_length_163_cov_480.593750	0	40	30	1	40	0.0250000
NODE_303135_length_163_cov_480.593750	0	40	32	6	40	0.1500000
NODE_303135_length_163_cov_480.593750	0	40	34	1	40	0.0250000
NODE_303135_length_163_cov_480.593750	0	40	38	1	40	0.0250000
NODE_303135_length_163_cov_480.593750	0	40	42	5	40	0.1250000
NODE_303135_length_163_cov_480.593750	0	40	44	5	40	0.1250000
NODE_303135_length_163_cov_480.593750	0	40	46	2	40	0.0500000
NODE_303135_length_163_cov_480.593750	0	40	54	5	40	0.1250000
NODE_303135_length_163_cov_480.593750	0	40	56	2	40	0.0500000
NODE_303136_length_163_cov_368.000000	24	96	10	1	72	0.0138889
NODE_303136_length_163_cov_368.000000	24	96	12	71	72	0.9861111
NODE_303138_length_163_cov_319.843750	0	68	18	1	68	0.0147059
NODE_303138_length_163_cov_319.843750	0	68	22	5	68	0.0735294
NODE_303138_length_163_cov_319.843750	0	68	26	6	68	0.0882353
NODE_303138_length_163_cov_319.843750	0	68	28	1	68	0.0147059
NODE_303138_length_163_cov_319.843750	0	68	36	9	68	0.1323529
NODE_303138_length_163_cov_319.843750	0	68	40	1	68	0.0147059
NODE_303138_length_163_cov_319.843750	0	68	42	2	68	0.0294118
NODE_303138_length_163_cov_319.843750	0	68	46	3	68	0.0441176
NODE_303138_length_163_cov_319.843750	0	68	48	1	68	0.0147059
NODE_303138_length_163_cov_319.843750	0	68	50	1	68	0.0147059
NODE_303138_length_163_cov_319.843750	0	68	52	8	68	0.1176471
NODE_303138_length_163_cov_319.843750	0	68	58	5	68	0.0735294
NODE_303138_length_163_cov_319.843750	0	68	62	17	68	0.2500000
NODE_303138_length_163_cov_319.843750	0	68	64	8	68	0.1176471
NODE_303139_length_163_cov_198.078125	34	109	99	2	75	0.0266667
NODE_303139_length_163_cov_198.078125	34	109	102	2	75	0.0266667
NODE_303139_length_163_cov_198.078125	34	109	104	2	75	0.0266667
NODE_303139_length_163_cov_198.078125	34	109	112	1	75	0.0133333
NODE_303139_length_163_cov_198.078125	34	109	118	2	75	0.0266667
NODE_303139_length_163_cov_198.078125	34	109	119	2	75	0.0266667
NODE_303139_length_163_cov_198.078125	34	109	121	4	75	0.0533333
NODE_303139_length_163_cov_198.078125	34	109	124	3	75	0.0400000
NODE_303139_length_163_cov_198.078125	34	109	128	3	75	0.0400000
NODE_303139_length_163_cov_198.078125	34	109	129	1	75	0.0133333
NODE_303139_length_163_cov_198.078125	34	109	143	1	75	0.0133333
NODE_303139_length_163_cov_198.078125	34	109	144	1	75	0.0133333
NODE_303139_length_163_cov_198.078125	34	109	145	4	75	0.0533333
NODE_303139_length_163_cov_198.078125	34	109	147	47	75	0.6266667
NODE_303139_length_163_cov_198.078125	34	114	99	2	80	0.0250000
NODE_303139_length_163_cov_198.078125	34	114	102	2	80	0.0250000
NODE_303139_length_163_cov_198.078125	34	114	104	2	80	0.0250000
NODE_303139_length_163_cov_198.078125	34	114	112	1	80	0.0125000
NODE_303139_length_163_cov_198.078125	34	114	118	2	80	0.0250000
NODE_303139_length_163_cov_198.078125	34	114	119	2	80	0.0250000
NODE_303139_length_163_cov_198.078125	34	114	121	4	80	0.0500000
NODE_303139_length_163_cov_198.078125	34	114	124	3	80	0.0375000
NODE_303139_length_163_cov_198.078125	34	114	128	3	80	0.0375000
NODE_303139_length_163_cov_198.078125	34	114	129	1	80	0.0125000
NODE_303139_length_163_cov_198.078125	34	114	141	3	80	0.0375000
NODE_303139_length_163_cov_198.078125	34	114	143	3	80	0.0375000
NODE_303139_length_163_cov_198.078125	34	114	144	1	80	0.0125000
NODE_303139_length_163_cov_198.078125	34	114	145	4	80	0.0500000
NODE_303139_length_163_cov_198.078125	34	114	147	47	80	0.5875000
NODE_303139_length_163_cov_198.078125	35	110	99	1	75	0.0133333
NODE_303139_length_163_cov_198.078125	35	110	102	2	75	0.0266667
NODE_303139_length_163_cov_198.078125	35	110	104	2	75	0.0266667
NODE_303139_length_163_cov_198.078125	35	110	112	1	75	0.0133333
NODE_303139_length_163_cov_198.078125	35	110	118	2	75	0.0266667
NODE_303139_length_163_cov_198.078125	35	110	119	2	75	0.0266667
NODE_303139_length_163_cov_198.078125	35	110	121	4	75	0.0533333
NODE_303139_length_163_cov_198.078125	35	110	124	3	75	0.0400000
NODE_303139_length_163_cov_198.078125	35	110	128	3	75	0.0400000
NODE_303139_length_163_cov_198.078125	35	110	129	1	75	0.0133333
NODE_303139_length_163_cov_198.078125	35	110	143	2	75	0.0266667
NODE_303139_length_163_cov_198.078125	35	110	144	1	75	0.0133333
NODE_303139_length_163_cov_198.078125	35	110	145	4	75	0.0533333
NODE_303139_length_163_cov_198.078125	35	110	147	47	75	0.6266667
NODE_303139_length_163_cov_198.078125	87	163	8	2	76	0.0263158
NODE_303139_length_163_cov_198.078125	87	163	37	5	76	0.0657895
NODE_303139_length_163_cov_198.078125	87	163	49	1	76	0.0131579
NODE_303139_length_163_cov_198.078125	87	163	50	2	76	0.0263158
NODE_303139_length_163_cov_198.078125	87	163	52	1	76	0.0131579
NODE_303139_length_163_cov_198.078125	87	163	54	1	76	0.0131579
NODE_303139_length_163_cov_198.078125	87	163	61	1	76	0.0131579
NODE_303139_length_163_cov_198.078125	87	163	76	1	76	0.0131579
NODE_303139_length_163_cov_198.078125	87	163	80	3	76	0.0394737
NODE_303139_length_163_cov_198.078125	87	163	82	3	76	0.0394737
NODE_303139_length_163_cov_198.078125	87	163	90	3	76	0.0394737
NODE_303139_length_163_cov_198.078125	87	163	94	1	76	0.0131579
NODE_303139_length_163_cov_198.078125	87	163	113	3	76	0.0394737
NODE_303139_length_163_cov_198.078125	87	163	123	1	76	0.0131579
NODE_303139_length_163_cov_198.078125	87	163	124	2	76	0.0263158
NODE_303139_length_163_cov_198.078125	87	163	127	12	76	0.1578947
NODE_303139_length_163_cov_198.078125	87	163	129	1	76	0.0131579
NODE_303139_length_163_cov_198.078125	87	163	132	1	76	0.0131579
NODE_303139_length_163_cov_198.078125	87	163	133	2	76	0.0263158
NODE_303139_length_163_cov_198.078125	87	163	137	2	76	0.0263158
NODE_303139_length_163_cov_198.078125	87	163	141	4	76	0.0526316
NODE_303139_length_163_cov_198.078125	87	163	143	3	76	0.0394737
NODE_303139_length_163_cov_198.078125	87	163	147	21	76	0.2763158
NODE_303139_length_163_cov_198.078125	87	163	8	2	76	0.0263158
NODE_303139_length_163_cov_198.078125	87	163	37	5	76	0.0657895
NODE_303139_length_163_cov_198.078125	87	163	49	1	76	0.0131579
NODE_303139_length_163_cov_198.078125	87	163	50	2	76	0.0263158
NODE_303139_length_163_cov_198.078125	87	163	52	1	76	0.0131579
NODE_303139_length_163_cov_198.078125	87	163	54	1	76	0.0131579
NODE_303139_length_163_cov_198.078125	87	163	61	1	76	0.0131579
NODE_303139_length_163_cov_198.078125	87	163	76	1	76	0.0131579
NODE_303139_length_163_cov_198.078125	87	163	80	3	76	0.0394737
NODE_303139_length_163_cov_198.078125	87	163	82	3	76	0.0394737
NODE_303139_length_163_cov_198.078125	87	163	90	3	76	0.0394737
NODE_303139_length_163_cov_198.078125	87	163	94	1	76	0.0131579
NODE_303139_length_163_cov_198.078125	87	163	113	3	76	0.0394737
NODE_303139_length_163_cov_198.078125	87	163	123	1	76	0.0131579
NODE_303139_length_163_cov_198.078125	87	163	124	2	76	0.0263158
NODE_303139_length_163_cov_198.078125	87	163	127	12	76	0.1578947
NODE_303139_length_163_cov_198.078125	87	163	129	1	76	0.0131579
NODE_303139_length_163_cov_198.078125	87	163	132	1	76	0.0131579
NODE_303139_length_163_cov_198.078125	87	163	133	2	76	0.0263158
NODE_303139_length_163_cov_198.078125	87	163	137	2	76	0.0263158
NODE_303139_length_163_cov_198.078125	87	163	141	4	76	0.0526316
NODE_303139_length_163_cov_198.078125	87	163	143	3	76	0.0394737
NODE_303139_length_163_cov_198.078125	87	163	147	21	76	0.2763158
NODE_303139_length_163_cov_198.078125	87	163	8	2	76	0.0263158
NODE_303139_length_163_cov_198.078125	87	163	37	5	76	0.0657895
NODE_303139_length_163_cov_198.078125	87	163	49	1	76	0.0131579
NODE_303139_length_163_cov_198.078125	87	163	50	2	76	0.0263158
NODE_303139_length_163_cov_198.078125	87	163	52	1	76	0.0131579
NODE_303139_length_163_cov_198.078125	87	163	54	1	76	0.0131579
NODE_303139_length_163_cov_198.078125	87	163	61	1	76	0.0131579
NODE_303139_length_163_cov_198.078125	87	163	76	1	76	0.0131579
NODE_303139_length_163_cov_198.078125	87	163	80	3	76	0.0394737
NODE_303139_length_163_cov_198.078125	87	163	82	3	76	0.0394737
NODE_303139_length_163_cov_198.078125	87	163	90	3	76	0.0394737
NODE_303139_length_163_cov_198.078125	87	163	94	1	76	0.0131579
NODE_303139_length_163_cov_198.078125	87	163	113	3	76	0.0394737
NODE_303139_length_163_cov_198.078125	87	163	123	1	76	0.0131579
NODE_303139_length_163_cov_198.078125	87	163	124	2	76	0.0263158
NODE_303139_length_163_cov_198.078125	87	163	127	12	76	0.1578947
NODE_303139_length_163_cov_198.078125	87	163	129	1	76	0.0131579
NODE_303139_length_163_cov_198.078125	87	163	132	1	76	0.0131579
NODE_303139_length_163_cov_198.078125	87	163	133	2	76	0.0263158
NODE_303139_length_163_cov_198.078125	87	163	137	2	76	0.0263158
NODE_303139_length_163_cov_198.078125	87	163	141	4	76	0.0526316
NODE_303139_length_163_cov_198.078125	87	163	143	3	76	0.0394737
NODE_303139_length_163_cov_198.078125	87	163	147	21	76	0.2763158
NODE_303231_length_162_cov_421.047619	7	56	49	2	49	0.0408163
NODE_303231_length_162_cov_421.047619	7	56	51	1	49	0.0204082
NODE_303231_length_162_cov_421.047619	7	56	57	1	49	0.0204082
NODE_303231_length_162_cov_421.047619	7	56	58	1	49	0.0204082
NODE_303231_length_162_cov_421.047619	7	56	61	1	49	0.0204082
NODE_303231_length_162_cov_421.047619	7	56	68	1	49	0.0204082
NODE_303231_length_162_cov_421.047619	7	56	84	1	49	0.0204082
NODE_303231_length_162_cov_421.047619	7	56	94	1	49	0.0204082
NODE_303231_length_162_cov_421.047619	7	56	100	1	49	0.0204082
NODE_303231_length_162_cov_421.047619	7	56	106	1	49	0.0204082
NODE_303231_length_162_cov_421.047619	7	56	110	1	49	0.0204082
NODE_303231_length_162_cov_421.047619	7	56	114	1	49	0.0204082
NODE_303231_length_162_cov_421.047619	7	56	125	2	49	0.0408163
NODE_303231_length_162_cov_421.047619	7	56	127	1	49	0.0204082
NODE_303231_length_162_cov_421.047619	7	56	133	1	49	0.0204082
NODE_303231_length_162_cov_421.047619	7	56	156	1	49	0.0204082
NODE_303231_length_162_cov_421.047619	7	56	162	2	49	0.0408163
NODE_303231_length_162_cov_421.047619	7	56	171	1	49	0.0204082
NODE_303231_length_162_cov_421.047619	7	56	181	1	49	0.0204082
NODE_303231_length_162_cov_421.047619	7	56	189	2	49	0.0408163
NODE_303231_length_162_cov_421.047619	7	56	195	2	49	0.0408163
NODE_303231_length_162_cov_421.047619	7	56	203	1	49	0.0204082
NODE_303231_length_162_cov_421.047619	7	56	207	1	49	0.0204082
NODE_303231_length_162_cov_421.047619	7	56	215	1	49	0.0204082
NODE_303231_length_162_cov_421.047619	7	56	219	1	49	0.0204082
NODE_303231_length_162_cov_421.047619	7	56	244	2	49	0.0408163
NODE_303231_length_162_cov_421.047619	7	56	258	2	49	0.0408163
NODE_303231_length_162_cov_421.047619	7	56	270	1	49	0.0204082
NODE_303231_length_162_cov_421.047619	7	56	278	1	49	0.0204082
NODE_303231_length_162_cov_421.047619	7	56	283	1	49	0.0204082
NODE_303231_length_162_cov_421.047619	7	56	295	1	49	0.0204082
NODE_303231_length_162_cov_421.047619	7	56	299	1	49	0.0204082
NODE_303231_length_162_cov_421.047619	7	56	305	1	49	0.0204082
NODE_303231_length_162_cov_421.047619	7	56	309	1	49	0.0204082
NODE_303231_length_162_cov_421.047619	7	56	317	1	49	0.0204082
NODE_303231_length_162_cov_421.047619	7	56	323	1	49	0.0204082
NODE_303231_length_162_cov_421.047619	7	56	337	1	49	0.0204082
NODE_303231_length_162_cov_421.047619	7	56	339	2	49	0.0408163
NODE_303231_length_162_cov_421.047619	7	56	343	2	49	0.0408163
NODE_303231_length_162_cov_421.047619	7	56	345	1	49	0.0204082
NODE_303231_length_162_cov_421.047619	29	90	189	2	61	0.0327869
NODE_303231_length_162_cov_421.047619	29	90	195	2	61	0.0327869
NODE_303231_length_162_cov_421.047619	29	90	203	1	61	0.0163934
NODE_303231_length_162_cov_421.047619	29	90	207	1	61	0.0163934
NODE_303231_length_162_cov_421.047619	29	90	215	1	61	0.0163934
NODE_303231_length_162_cov_421.047619	29	90	219	1	61	0.0163934
NODE_303231_length_162_cov_421.047619	29	90	244	2	61	0.0327869
NODE_303231_length_162_cov_421.047619	29	90	258	2	61	0.0327869
NODE_303231_length_162_cov_421.047619	29	90	270	1	61	0.0163934
NODE_303231_length_162_cov_421.047619	29	90	278	1	61	0.0163934
NODE_303231_length_162_cov_421.047619	29	90	283	1	61	0.0163934
NODE_303231_length_162_cov_421.047619	29	90	295	1	61	0.0163934
NODE_303231_length_162_cov_421.047619	29	90	299	1	61	0.0163934
NODE_303231_length_162_cov_421.047619	29	90	305	1	61	0.0163934
NODE_303231_length_162_cov_421.047619	29	90	309	1	61	0.0163934
NODE_303231_length_162_cov_421.047619	29	90	317	1	61	0.0163934
NODE_303231_length_162_cov_421.047619	29	90	323	1	61	0.0163934
NODE_303231_length_162_cov_421.047619	29	90	337	1	61	0.0163934
NODE_303231_length_162_cov_421.047619	29	90	339	2	61	0.0327869
NODE_303231_length_162_cov_421.047619	29	90	343	2	61	0.0327869
NODE_303231_length_162_cov_421.047619	29	90	345	2	61	0.0327869
NODE_303231_length_162_cov_421.047619	29	90	347	33	61	0.5409836
NODE_303231_length_162_cov_421.047619	29	92	189	2	63	0.0317460
NODE_303231_length_162_cov_421.047619	29	92	195	2	63	0.0317460
NODE_303231_length_162_cov_421.047619	29	92	203	1	63	0.0158730
NODE_303231_length_162_cov_421.047619	29	92	207	1	63	0.0158730
NODE_303231_length_162_cov_421.047619	29	92	215	1	63	0.0158730
NODE_303231_length_162_cov_421.047619	29	92	219	1	63	0.0158730
NODE_303231_length_162_cov_421.047619	29	92	244	2	63	0.0317460
NODE_303231_length_162_cov_421.047619	29	92	258	2	63	0.0317460
NODE_303231_length_162_cov_421.047619	29	92	270	1	63	0.0158730
NODE_303231_length_162_cov_421.047619	29	92	278	1	63	0.0158730
NODE_303231_length_162_cov_421.047619	29	92	283	1	63	0.0158730
NODE_303231_length_162_cov_421.047619	29	92	295	1	63	0.0158730
NODE_303231_length_162_cov_421.047619	29	92	299	1	63	0.0158730
NODE_303231_length_162_cov_421.047619	29	92	305	1	63	0.0158730
NODE_303231_length_162_cov_421.047619	29	92	309	1	63	0.0158730
NODE_303231_length_162_cov_421.047619	29	92	317	1	63	0.0158730
NODE_303231_length_162_cov_421.047619	29	92	323	1	63	0.0158730
NODE_303231_length_162_cov_421.047619	29	92	337	1	63	0.0158730
NODE_303231_length_162_cov_421.047619	29	92	339	2	63	0.0317460
NODE_303231_length_162_cov_421.047619	29	92	343	2	63	0.0317460
NODE_303231_length_162_cov_421.047619	29	92	345	2	63	0.0317460
NODE_303231_length_162_cov_421.047619	29	92	347	35	63	0.5555556
NODE_303231_length_162_cov_421.047619	29	92	189	2	63	0.0317460
NODE_303231_length_162_cov_421.047619	29	92	195	2	63	0.0317460
NODE_303231_length_162_cov_421.047619	29	92	203	1	63	0.0158730
NODE_303231_length_162_cov_421.047619	29	92	207	1	63	0.0158730
NODE_303231_length_162_cov_421.047619	29	92	215	1	63	0.0158730
NODE_303231_length_162_cov_421.047619	29	92	219	1	63	0.0158730
NODE_303231_length_162_cov_421.047619	29	92	244	2	63	0.0317460
NODE_303231_length_162_cov_421.047619	29	92	258	2	63	0.0317460
NODE_303231_length_162_cov_421.047619	29	92	270	1	63	0.0158730
NODE_303231_length_162_cov_421.047619	29	92	278	1	63	0.0158730
NODE_303231_length_162_cov_421.047619	29	92	283	1	63	0.0158730
NODE_303231_length_162_cov_421.047619	29	92	295	1	63	0.0158730
NODE_303231_length_162_cov_421.047619	29	92	299	1	63	0.0158730
NODE_303231_length_162_cov_421.047619	29	92	305	1	63	0.0158730
NODE_303231_length_162_cov_421.047619	29	92	309	1	63	0.0158730
NODE_303231_length_162_cov_421.047619	29	92	317	1	63	0.0158730
NODE_303231_length_162_cov_421.047619	29	92	323	1	63	0.0158730
NODE_303231_length_162_cov_421.047619	29	92	337	1	63	0.0158730
NODE_303231_length_162_cov_421.047619	29	92	339	2	63	0.0317460
NODE_303231_length_162_cov_421.047619	29	92	343	2	63	0.0317460
NODE_303231_length_162_cov_421.047619	29	92	345	2	63	0.0317460
NODE_303231_length_162_cov_421.047619	29	92	347	35	63	0.5555556
NODE_303231_length_162_cov_421.047619	29	92	189	2	63	0.0317460
NODE_303231_length_162_cov_421.047619	29	92	195	2	63	0.0317460
NODE_303231_length_162_cov_421.047619	29	92	203	1	63	0.0158730
NODE_303231_length_162_cov_421.047619	29	92	207	1	63	0.0158730
NODE_303231_length_162_cov_421.047619	29	92	215	1	63	0.0158730
NODE_303231_length_162_cov_421.047619	29	92	219	1	63	0.0158730
NODE_303231_length_162_cov_421.047619	29	92	244	2	63	0.0317460
NODE_303231_length_162_cov_421.047619	29	92	258	2	63	0.0317460
NODE_303231_length_162_cov_421.047619	29	92	270	1	63	0.0158730
NODE_303231_length_162_cov_421.047619	29	92	278	1	63	0.0158730
NODE_303231_length_162_cov_421.047619	29	92	283	1	63	0.0158730
NODE_303231_length_162_cov_421.047619	29	92	295	1	63	0.0158730
NODE_303231_length_162_cov_421.047619	29	92	299	1	63	0.0158730
NODE_303231_length_162_cov_421.047619	29	92	305	1	63	0.0158730
NODE_303231_length_162_cov_421.047619	29	92	309	1	63	0.0158730
NODE_303231_length_162_cov_421.047619	29	92	317	1	63	0.0158730
NODE_303231_length_162_cov_421.047619	29	92	323	1	63	0.0158730
NODE_303231_length_162_cov_421.047619	29	92	337	1	63	0.0158730
NODE_303231_length_162_cov_421.047619	29	92	339	2	63	0.0317460
NODE_303231_length_162_cov_421.047619	29	92	343	2	63	0.0317460
NODE_303231_length_162_cov_421.047619	29	92	345	2	63	0.0317460
NODE_303231_length_162_cov_421.047619	29	92	347	35	63	0.5555556
NODE_303250_length_162_cov_45.380952	63	127	32	6	64	0.0937500
NODE_303250_length_162_cov_45.380952	63	127	34	58	64	0.9062500
NODE_303250_length_162_cov_45.380952	63	127	32	6	64	0.0937500
NODE_303250_length_162_cov_45.380952	63	127	34	58	64	0.9062500
NODE_303250_length_162_cov_45.380952	100	162	2	1	62	0.0161290
NODE_303250_length_162_cov_45.380952	100	162	4	1	62	0.0161290
NODE_303250_length_162_cov_45.380952	100	162	6	14	62	0.2258064
NODE_303250_length_162_cov_45.380952	100	162	10	9	62	0.1451613
NODE_303250_length_162_cov_45.380952	100	162	13	1	62	0.0161290
NODE_303250_length_162_cov_45.380952	100	162	16	2	62	0.0322581
NODE_303250_length_162_cov_45.380952	100	162	22	1	62	0.0161290
NODE_303250_length_162_cov_45.380952	100	162	28	1	62	0.0161290
NODE_303250_length_162_cov_45.380952	100	162	32	11	62	0.1774193
NODE_303250_length_162_cov_45.380952	100	162	34	21	62	0.3387097
NODE_303301_length_161_cov_1483.177419	51	131	72	2	80	0.0250000
NODE_303301_length_161_cov_1483.177419	51	131	78	9	80	0.1125000
NODE_303301_length_161_cov_1483.177419	51	131	82	4	80	0.0500000
NODE_303301_length_161_cov_1483.177419	51	131	84	2	80	0.0250000
NODE_303301_length_161_cov_1483.177419	51	131	86	1	80	0.0125000
NODE_303301_length_161_cov_1483.177419	51	131	88	4	80	0.0500000
NODE_303301_length_161_cov_1483.177419	51	131	90	4	80	0.0500000
NODE_303301_length_161_cov_1483.177419	51	131	92	1	80	0.0125000
NODE_303301_length_161_cov_1483.177419	51	131	94	4	80	0.0500000
NODE_303301_length_161_cov_1483.177419	51	131	96	1	80	0.0125000
NODE_303301_length_161_cov_1483.177419	51	131	98	4	80	0.0500000
NODE_303301_length_161_cov_1483.177419	51	131	100	44	80	0.5500000
NODE_303301_length_161_cov_1483.177419	104	161	10	1	57	0.0175439
NODE_303301_length_161_cov_1483.177419	104	161	14	1	57	0.0175439
NODE_303301_length_161_cov_1483.177419	104	161	22	4	57	0.0701754
NODE_303301_length_161_cov_1483.177419	104	161	24	2	57	0.0350877
NODE_303301_length_161_cov_1483.177419	104	161	32	2	57	0.0350877
NODE_303301_length_161_cov_1483.177419	104	161	36	1	57	0.0175439
NODE_303301_length_161_cov_1483.177419	104	161	38	1	57	0.0175439
NODE_303301_length_161_cov_1483.177419	104	161	40	3	57	0.0526316
NODE_303301_length_161_cov_1483.177419	104	161	44	1	57	0.0175439
NODE_303301_length_161_cov_1483.177419	104	161	46	4	57	0.0701754
NODE_303301_length_161_cov_1483.177419	104	161	50	3	57	0.0526316
NODE_303301_length_161_cov_1483.177419	104	161	52	1	57	0.0175439
NODE_303301_length_161_cov_1483.177419	104	161	60	1	57	0.0175439
NODE_303301_length_161_cov_1483.177419	104	161	62	1	57	0.0175439
NODE_303301_length_161_cov_1483.177419	104	161	66	1	57	0.0175439
NODE_303301_length_161_cov_1483.177419	104	161	70	2	57	0.0350877
NODE_303301_length_161_cov_1483.177419	104	161	78	10	57	0.1754386
NODE_303301_length_161_cov_1483.177419	104	161	82	2	57	0.0350877
NODE_303301_length_161_cov_1483.177419	104	161	84	1	57	0.0175439
NODE_303301_length_161_cov_1483.177419	104	161	86	1	57	0.0175439
NODE_303301_length_161_cov_1483.177419	104	161	88	3	57	0.0526316
NODE_303301_length_161_cov_1483.177419	104	161	90	3	57	0.0526316
NODE_303301_length_161_cov_1483.177419	104	161	92	1	57	0.0175439
NODE_303301_length_161_cov_1483.177419	104	161	94	3	57	0.0526316
NODE_303301_length_161_cov_1483.177419	104	161	96	1	57	0.0175439
NODE_303301_length_161_cov_1483.177419	104	161	98	3	57	0.0526316
NODE_303312_length_161_cov_71.500000	33	110	0	9	77	0.1168831
NODE_303312_length_161_cov_71.500000	33	110	2	68	77	0.8831169
NODE_303312_length_161_cov_71.500000	33	110	0	9	77	0.1168831
NODE_303312_length_161_cov_71.500000	33	110	2	68	77	0.8831169
NODE_303312_length_161_cov_71.500000	33	110	0	9	77	0.1168831
NODE_303312_length_161_cov_71.500000	33	110	2	68	77	0.8831169
NODE_303312_length_161_cov_71.500000	33	110	0	9	77	0.1168831
NODE_303312_length_161_cov_71.500000	33	110	2	68	77	0.8831169
NODE_303312_length_161_cov_71.500000	83	149	0	39	66	0.5909091
NODE_303312_length_161_cov_71.500000	83	149	2	27	66	0.4090909
NODE_303312_length_161_cov_71.500000	83	161	0	51	78	0.6538461
NODE_303312_length_161_cov_71.500000	83	161	2	27	78	0.3461539
NODE_303312_length_161_cov_71.500000	86	161	0	51	75	0.6800000
NODE_303312_length_161_cov_71.500000	86	161	2	24	75	0.3200000
NODE_303312_length_161_cov_71.500000	86	161	0	51	75	0.6800000
NODE_303312_length_161_cov_71.500000	86	161	2	24	75	0.3200000
NODE_303312_length_161_cov_71.500000	88	161	0	51	73	0.6986302
NODE_303312_length_161_cov_71.500000	88	161	2	22	73	0.3013699
NODE_303321_length_161_cov_29.758065	0	80	0	10	80	0.1250000
NODE_303321_length_161_cov_29.758065	0	80	2	1	80	0.0125000
NODE_303321_length_161_cov_29.758065	0	80	6	4	80	0.0500000
NODE_303321_length_161_cov_29.758065	0	80	10	4	80	0.0500000
NODE_303321_length_161_cov_29.758065	0	80	14	5	80	0.0625000
NODE_303321_length_161_cov_29.758065	0	80	16	2	80	0.0250000
NODE_303321_length_161_cov_29.758065	0	80	18	7	80	0.0875000
NODE_303321_length_161_cov_29.758065	0	80	20	2	80	0.0250000
NODE_303321_length_161_cov_29.758065	0	80	22	16	80	0.2000000
NODE_303321_length_161_cov_29.758065	0	80	24	3	80	0.0375000
NODE_303321_length_161_cov_29.758065	0	80	26	26	80	0.3250000
NODE_303381_length_160_cov_143.573770	45	125	8	3	80	0.0375000
NODE_303381_length_160_cov_143.573770	45	125	10	5	80	0.0625000
NODE_303381_length_160_cov_143.573770	45	125	12	72	80	0.9000000
NODE_303381_length_160_cov_143.573770	93	160	0	12	67	0.1791045
NODE_303381_length_160_cov_143.573770	93	160	4	14	67	0.2089552
NODE_303381_length_160_cov_143.573770	93	160	6	3	67	0.0447761
NODE_303381_length_160_cov_143.573770	93	160	8	9	67	0.1343284
NODE_303381_length_160_cov_143.573770	93	160	10	5	67	0.0746269
NODE_303381_length_160_cov_143.573770	93	160	12	24	67	0.3582090
NODE_303381_length_160_cov_143.573770	98	120	10	3	22	0.1363636
NODE_303381_length_160_cov_143.573770	98	120	12	19	22	0.8636364
NODE_303388_length_160_cov_58.245902	0	45	0	2	45	0.0444444
NODE_303388_length_160_cov_58.245902	0	45	2	6	45	0.1333333
NODE_303388_length_160_cov_58.245902	0	45	4	10	45	0.2222222
NODE_303388_length_160_cov_58.245902	0	45	6	3	45	0.0666667
NODE_303388_length_160_cov_58.245902	0	45	8	3	45	0.0666667
NODE_303388_length_160_cov_58.245902	0	45	10	10	45	0.2222222
NODE_303388_length_160_cov_58.245902	0	45	16	1	45	0.0222222
NODE_303388_length_160_cov_58.245902	0	45	18	6	45	0.1333333
NODE_303388_length_160_cov_58.245902	0	45	20	4	45	0.0888889
NODE_303431_length_159_cov_182.016667	71	156	0	10	85	0.1176471
NODE_303431_length_159_cov_182.016667	71	156	6	2	85	0.0235294
NODE_303431_length_159_cov_182.016667	71	156	12	1	85	0.0117647
NODE_303431_length_159_cov_182.016667	71	156	14	3	85	0.0352941
NODE_303431_length_159_cov_182.016667	71	156	16	4	85	0.0470588
NODE_303431_length_159_cov_182.016667	71	156	18	3	85	0.0352941
NODE_303431_length_159_cov_182.016667	71	156	20	62	85	0.7294118
NODE_303431_length_159_cov_182.016667	71	156	0	10	85	0.1176471
NODE_303431_length_159_cov_182.016667	71	156	6	2	85	0.0235294
NODE_303431_length_159_cov_182.016667	71	156	12	1	85	0.0117647
NODE_303431_length_159_cov_182.016667	71	156	14	3	85	0.0352941
NODE_303431_length_159_cov_182.016667	71	156	16	4	85	0.0470588
NODE_303431_length_159_cov_182.016667	71	156	18	3	85	0.0352941
NODE_303431_length_159_cov_182.016667	71	156	20	62	85	0.7294118
NODE_303431_length_159_cov_182.016667	71	156	0	10	85	0.1176471
NODE_303431_length_159_cov_182.016667	71	156	6	2	85	0.0235294
NODE_303431_length_159_cov_182.016667	71	156	12	1	85	0.0117647
NODE_303431_length_159_cov_182.016667	71	156	14	3	85	0.0352941
NODE_303431_length_159_cov_182.016667	71	156	16	4	85	0.0470588
NODE_303431_length_159_cov_182.016667	71	156	18	3	85	0.0352941
NODE_303431_length_159_cov_182.016667	71	156	20	62	85	0.7294118
NODE_303440_length_159_cov_85.750000	0	43	2	2	43	0.0465116
NODE_303440_length_159_cov_85.750000	0	43	4	1	43	0.0232558
NODE_303440_length_159_cov_85.750000	0	43	6	1	43	0.0232558
NODE_303440_length_159_cov_85.750000	0	43	8	8	43	0.1860465
NODE_303440_length_159_cov_85.750000	0	43	27	1	43	0.0232558
NODE_303440_length_159_cov_85.750000	0	43	29	2	43	0.0465116
NODE_303440_length_159_cov_85.750000	0	43	31	3	43	0.0697674
NODE_303440_length_159_cov_85.750000	0	43	33	1	43	0.0232558
NODE_303440_length_159_cov_85.750000	0	43	35	2	43	0.0465116
NODE_303440_length_159_cov_85.750000	0	43	46	1	43	0.0232558
NODE_303440_length_159_cov_85.750000	0	43	55	1	43	0.0232558
NODE_303440_length_159_cov_85.750000	0	43	64	1	43	0.0232558
NODE_303440_length_159_cov_85.750000	0	43	66	1	43	0.0232558
NODE_303440_length_159_cov_85.750000	0	43	68	3	43	0.0697674
NODE_303440_length_159_cov_85.750000	0	43	72	3	43	0.0697674
NODE_303440_length_159_cov_85.750000	0	43	74	1	43	0.0232558
NODE_303440_length_159_cov_85.750000	0	43	76	1	43	0.0232558
NODE_303440_length_159_cov_85.750000	0	43	82	2	43	0.0465116
NODE_303440_length_159_cov_85.750000	0	43	83	2	43	0.0465116
NODE_303440_length_159_cov_85.750000	0	43	85	6	43	0.1395349
NODE_303440_length_159_cov_85.750000	16	97	31	2	81	0.0246914
NODE_303440_length_159_cov_85.750000	16	97	33	1	81	0.0123457
NODE_303440_length_159_cov_85.750000	16	97	35	2	81	0.0246914
NODE_303440_length_159_cov_85.750000	16	97	46	1	81	0.0123457
NODE_303440_length_159_cov_85.750000	16	97	55	1	81	0.0123457
NODE_303440_length_159_cov_85.750000	16	97	64	1	81	0.0123457
NODE_303440_length_159_cov_85.750000	16	97	66	1	81	0.0123457
NODE_303440_length_159_cov_85.750000	16	97	68	3	81	0.0370370
NODE_303440_length_159_cov_85.750000	16	97	72	3	81	0.0370370
NODE_303440_length_159_cov_85.750000	16	97	74	1	81	0.0123457
NODE_303440_length_159_cov_85.750000	16	97	76	1	81	0.0123457
NODE_303440_length_159_cov_85.750000	16	97	82	2	81	0.0246914
NODE_303440_length_159_cov_85.750000	16	97	83	2	81	0.0246914
NODE_303440_length_159_cov_85.750000	16	97	85	41	81	0.5061728
NODE_303440_length_159_cov_85.750000	16	97	86	19	81	0.2345679
NODE_303440_length_159_cov_85.750000	65	145	45	1	80	0.0125000
NODE_303440_length_159_cov_85.750000	65	145	56	3	80	0.0375000
NODE_303440_length_159_cov_85.750000	65	145	57	3	80	0.0375000
NODE_303440_length_159_cov_85.750000	65	145	59	1	80	0.0125000
NODE_303440_length_159_cov_85.750000	65	145	61	1	80	0.0125000
NODE_303440_length_159_cov_85.750000	65	145	63	6	80	0.0750000
NODE_303440_length_159_cov_85.750000	65	145	65	1	80	0.0125000
NODE_303440_length_159_cov_85.750000	65	145	69	1	80	0.0125000
NODE_303440_length_159_cov_85.750000	65	145	71	6	80	0.0750000
NODE_303440_length_159_cov_85.750000	65	145	73	3	80	0.0375000
NODE_303440_length_159_cov_85.750000	65	145	75	5	80	0.0625000
NODE_303440_length_159_cov_85.750000	65	145	76	1	80	0.0125000
NODE_303440_length_159_cov_85.750000	65	145	78	3	80	0.0375000
NODE_303440_length_159_cov_85.750000	65	145	80	6	80	0.0750000
NODE_303440_length_159_cov_85.750000	65	145	82	3	80	0.0375000
NODE_303440_length_159_cov_85.750000	65	145	84	1	80	0.0125000
NODE_303440_length_159_cov_85.750000	65	145	85	13	80	0.1625000
NODE_303440_length_159_cov_85.750000	65	145	86	22	80	0.2750000
NODE_303440_length_159_cov_85.750000	70	92	85	8	22	0.3636364
NODE_303440_length_159_cov_85.750000	70	92	86	14	22	0.6363636
NODE_303546_length_158_cov_119.813559	34	77	10	2	43	0.0465116
NODE_303546_length_158_cov_119.813559	34	77	12	2	43	0.0465116
NODE_303546_length_158_cov_119.813559	34	77	14	6	43	0.1395349
NODE_303546_length_158_cov_119.813559	34	77	18	1	43	0.0232558
NODE_303546_length_158_cov_119.813559	34	77	20	1	43	0.0232558
NODE_303546_length_158_cov_119.813559	34	77	21	1	43	0.0232558
NODE_303546_length_158_cov_119.813559	34	77	22	20	43	0.4651163
NODE_303546_length_158_cov_119.813559	34	77	23	10	43	0.2325581
NODE_303546_length_158_cov_119.813559	78	113	23	6	35	0.1714286
NODE_303546_length_158_cov_119.813559	78	113	24	29	35	0.8285714
NODE_303546_length_158_cov_119.813559	123	158	2	13	35	0.3714286
NODE_303546_length_158_cov_119.813559	123	158	4	6	35	0.1714286
NODE_303546_length_158_cov_119.813559	123	158	8	3	35	0.0857143
NODE_303546_length_158_cov_119.813559	123	158	14	13	35	0.3714286
NODE_303552_length_158_cov_70.135593	5	82	10	40	77	0.5194805
NODE_303552_length_158_cov_70.135593	5	82	12	37	77	0.4805195
NODE_303552_length_158_cov_70.135593	5	82	10	40	77	0.5194805
NODE_303552_length_158_cov_70.135593	5	82	12	37	77	0.4805195
NODE_303552_length_158_cov_70.135593	81	155	2	12	74	0.1621622
NODE_303552_length_158_cov_70.135593	81	155	4	2	74	0.0270270
NODE_303552_length_158_cov_70.135593	81	155	5	1	74	0.0135135
NODE_303552_length_158_cov_70.135593	81	155	6	9	74	0.1216216
NODE_303552_length_158_cov_70.135593	81	155	8	7	74	0.0945946
NODE_303552_length_158_cov_70.135593	81	155	10	7	74	0.0945946
NODE_303552_length_158_cov_70.135593	81	155	12	36	74	0.4864865
NODE_303555_length_158_cov_63.559322	80	151	4	6	71	0.0845070
NODE_303555_length_158_cov_63.559322	80	151	6	5	71	0.0704225
NODE_303555_length_158_cov_63.559322	80	151	8	6	71	0.0845070
NODE_303555_length_158_cov_63.559322	80	151	12	5	71	0.0704225
NODE_303555_length_158_cov_63.559322	80	151	14	1	71	0.0140845
NODE_303555_length_158_cov_63.559322	80	151	24	5	71	0.0704225
NODE_303555_length_158_cov_63.559322	80	151	26	1	71	0.0140845
NODE_303555_length_158_cov_63.559322	80	151	28	1	71	0.0140845
NODE_303555_length_158_cov_63.559322	80	151	32	2	71	0.0281690
NODE_303555_length_158_cov_63.559322	80	151	34	2	71	0.0281690
NODE_303555_length_158_cov_63.559322	80	151	36	8	71	0.1126761
NODE_303555_length_158_cov_63.559322	80	151	38	29	71	0.4084507
NODE_303556_length_158_cov_61.203390	2	66	78	1	64	0.0156250
NODE_303556_length_158_cov_61.203390	2	66	86	2	64	0.0312500
NODE_303556_length_158_cov_61.203390	2	66	107	1	64	0.0156250
NODE_303556_length_158_cov_61.203390	2	66	116	1	64	0.0156250
NODE_303556_length_158_cov_61.203390	2	66	125	4	64	0.0625000
NODE_303556_length_158_cov_61.203390	2	66	127	1	64	0.0156250
NODE_303556_length_158_cov_61.203390	2	66	134	1	64	0.0156250
NODE_303556_length_158_cov_61.203390	2	66	140	1	64	0.0156250
NODE_303556_length_158_cov_61.203390	2	66	152	2	64	0.0312500
NODE_303556_length_158_cov_61.203390	2	66	156	1	64	0.0156250
NODE_303556_length_158_cov_61.203390	2	66	157	1	64	0.0156250
NODE_303556_length_158_cov_61.203390	2	66	169	1	64	0.0156250
NODE_303556_length_158_cov_61.203390	2	66	177	2	64	0.0312500
NODE_303556_length_158_cov_61.203390	2	66	195	2	64	0.0312500
NODE_303556_length_158_cov_61.203390	2	66	199	1	64	0.0156250
NODE_303556_length_158_cov_61.203390	2	66	203	1	64	0.0156250
NODE_303556_length_158_cov_61.203390	2	66	205	1	64	0.0156250
NODE_303556_length_158_cov_61.203390	2	66	209	1	64	0.0156250
NODE_303556_length_158_cov_61.203390	2	66	213	1	64	0.0156250
NODE_303556_length_158_cov_61.203390	2	66	221	1	64	0.0156250
NODE_303556_length_158_cov_61.203390	2	66	231	1	64	0.0156250
NODE_303556_length_158_cov_61.203390	2	66	235	3	64	0.0468750
NODE_303556_length_158_cov_61.203390	2	66	243	2	64	0.0312500
NODE_303556_length_158_cov_61.203390	2	66	244	1	64	0.0156250
NODE_303556_length_158_cov_61.203390	2	66	252	1	64	0.0156250
NODE_303556_length_158_cov_61.203390	2	66	261	1	64	0.0156250
NODE_303556_length_158_cov_61.203390	2	66	263	2	64	0.0312500
NODE_303556_length_158_cov_61.203390	2	66	271	1	64	0.0156250
NODE_303556_length_158_cov_61.203390	2	66	273	2	64	0.0312500
NODE_303556_length_158_cov_61.203390	2	66	284	1	64	0.0156250
NODE_303556_length_158_cov_61.203390	2	66	290	1	64	0.0156250
NODE_303556_length_158_cov_61.203390	2	66	296	3	64	0.0468750
NODE_303556_length_158_cov_61.203390	2	66	300	1	64	0.0156250
NODE_303556_length_158_cov_61.203390	2	66	302	5	64	0.0781250
NODE_303556_length_158_cov_61.203390	2	66	310	2	64	0.0312500
NODE_303556_length_158_cov_61.203390	2	66	313	5	64	0.0781250
NODE_303556_length_158_cov_61.203390	2	66	314	5	64	0.0781250
NODE_303556_length_158_cov_61.203390	2	66	78	1	64	0.0156250
NODE_303556_length_158_cov_61.203390	2	66	86	2	64	0.0312500
NODE_303556_length_158_cov_61.203390	2	66	107	1	64	0.0156250
NODE_303556_length_158_cov_61.203390	2	66	116	1	64	0.0156250
NODE_303556_length_158_cov_61.203390	2	66	125	4	64	0.0625000
NODE_303556_length_158_cov_61.203390	2	66	127	1	64	0.0156250
NODE_303556_length_158_cov_61.203390	2	66	134	1	64	0.0156250
NODE_303556_length_158_cov_61.203390	2	66	140	1	64	0.0156250
NODE_303556_length_158_cov_61.203390	2	66	152	2	64	0.0312500
NODE_303556_length_158_cov_61.203390	2	66	156	1	64	0.0156250
NODE_303556_length_158_cov_61.203390	2	66	157	1	64	0.0156250
NODE_303556_length_158_cov_61.203390	2	66	169	1	64	0.0156250
NODE_303556_length_158_cov_61.203390	2	66	177	2	64	0.0312500
NODE_303556_length_158_cov_61.203390	2	66	195	2	64	0.0312500
NODE_303556_length_158_cov_61.203390	2	66	199	1	64	0.0156250
NODE_303556_length_158_cov_61.203390	2	66	203	1	64	0.0156250
NODE_303556_length_158_cov_61.203390	2	66	205	1	64	0.0156250
NODE_303556_length_158_cov_61.203390	2	66	209	1	64	0.0156250
NODE_303556_length_158_cov_61.203390	2	66	213	1	64	0.0156250
NODE_303556_length_158_cov_61.203390	2	66	221	1	64	0.0156250
NODE_303556_length_158_cov_61.203390	2	66	231	1	64	0.0156250
NODE_303556_length_158_cov_61.203390	2	66	235	3	64	0.0468750
NODE_303556_length_158_cov_61.203390	2	66	243	2	64	0.0312500
NODE_303556_length_158_cov_61.203390	2	66	244	1	64	0.0156250
NODE_303556_length_158_cov_61.203390	2	66	252	1	64	0.0156250
NODE_303556_length_158_cov_61.203390	2	66	261	1	64	0.0156250
NODE_303556_length_158_cov_61.203390	2	66	263	2	64	0.0312500
NODE_303556_length_158_cov_61.203390	2	66	271	1	64	0.0156250
NODE_303556_length_158_cov_61.203390	2	66	273	2	64	0.0312500
NODE_303556_length_158_cov_61.203390	2	66	284	1	64	0.0156250
NODE_303556_length_158_cov_61.203390	2	66	290	1	64	0.0156250
NODE_303556_length_158_cov_61.203390	2	66	296	3	64	0.0468750
NODE_303556_length_158_cov_61.203390	2	66	300	1	64	0.0156250
NODE_303556_length_158_cov_61.203390	2	66	302	5	64	0.0781250
NODE_303556_length_158_cov_61.203390	2	66	310	2	64	0.0312500
NODE_303556_length_158_cov_61.203390	2	66	313	5	64	0.0781250
NODE_303556_length_158_cov_61.203390	2	66	314	5	64	0.0781250
NODE_303556_length_158_cov_61.203390	2	66	78	1	64	0.0156250
NODE_303556_length_158_cov_61.203390	2	66	86	2	64	0.0312500
NODE_303556_length_158_cov_61.203390	2	66	107	1	64	0.0156250
NODE_303556_length_158_cov_61.203390	2	66	116	1	64	0.0156250
NODE_303556_length_158_cov_61.203390	2	66	125	4	64	0.0625000
NODE_303556_length_158_cov_61.203390	2	66	127	1	64	0.0156250
NODE_303556_length_158_cov_61.203390	2	66	134	1	64	0.0156250
NODE_303556_length_158_cov_61.203390	2	66	140	1	64	0.0156250
NODE_303556_length_158_cov_61.203390	2	66	152	2	64	0.0312500
NODE_303556_length_158_cov_61.203390	2	66	156	1	64	0.0156250
NODE_303556_length_158_cov_61.203390	2	66	157	1	64	0.0156250
NODE_303556_length_158_cov_61.203390	2	66	169	1	64	0.0156250
NODE_303556_length_158_cov_61.203390	2	66	177	2	64	0.0312500
NODE_303556_length_158_cov_61.203390	2	66	195	2	64	0.0312500
NODE_303556_length_158_cov_61.203390	2	66	199	1	64	0.0156250
NODE_303556_length_158_cov_61.203390	2	66	203	1	64	0.0156250
NODE_303556_length_158_cov_61.203390	2	66	205	1	64	0.0156250
NODE_303556_length_158_cov_61.203390	2	66	209	1	64	0.0156250
NODE_303556_length_158_cov_61.203390	2	66	213	1	64	0.0156250
NODE_303556_length_158_cov_61.203390	2	66	221	1	64	0.0156250
NODE_303556_length_158_cov_61.203390	2	66	231	1	64	0.0156250
NODE_303556_length_158_cov_61.203390	2	66	235	3	64	0.0468750
NODE_303556_length_158_cov_61.203390	2	66	243	2	64	0.0312500
NODE_303556_length_158_cov_61.203390	2	66	244	1	64	0.0156250
NODE_303556_length_158_cov_61.203390	2	66	252	1	64	0.0156250
NODE_303556_length_158_cov_61.203390	2	66	261	1	64	0.0156250
NODE_303556_length_158_cov_61.203390	2	66	263	2	64	0.0312500
NODE_303556_length_158_cov_61.203390	2	66	271	1	64	0.0156250
NODE_303556_length_158_cov_61.203390	2	66	273	2	64	0.0312500
NODE_303556_length_158_cov_61.203390	2	66	284	1	64	0.0156250
NODE_303556_length_158_cov_61.203390	2	66	290	1	64	0.0156250
NODE_303556_length_158_cov_61.203390	2	66	296	3	64	0.0468750
NODE_303556_length_158_cov_61.203390	2	66	300	1	64	0.0156250
NODE_303556_length_158_cov_61.203390	2	66	302	5	64	0.0781250
NODE_303556_length_158_cov_61.203390	2	66	310	2	64	0.0312500
NODE_303556_length_158_cov_61.203390	2	66	313	5	64	0.0781250
NODE_303556_length_158_cov_61.203390	2	66	314	5	64	0.0781250
NODE_303556_length_158_cov_61.203390	39	119	223	1	80	0.0125000
NODE_303556_length_158_cov_61.203390	39	119	225	1	80	0.0125000
NODE_303556_length_158_cov_61.203390	39	119	231	2	80	0.0250000
NODE_303556_length_158_cov_61.203390	39	119	240	1	80	0.0125000
NODE_303556_length_158_cov_61.203390	39	119	262	2	80	0.0250000
NODE_303556_length_158_cov_61.203390	39	119	263	1	80	0.0125000
NODE_303556_length_158_cov_61.203390	39	119	271	1	80	0.0125000
NODE_303556_length_158_cov_61.203390	39	119	272	1	80	0.0125000
NODE_303556_length_158_cov_61.203390	39	119	273	2	80	0.0250000
NODE_303556_length_158_cov_61.203390	39	119	282	2	80	0.0250000
NODE_303556_length_158_cov_61.203390	39	119	284	1	80	0.0125000
NODE_303556_length_158_cov_61.203390	39	119	290	3	80	0.0375000
NODE_303556_length_158_cov_61.203390	39	119	294	2	80	0.0250000
NODE_303556_length_158_cov_61.203390	39	119	296	4	80	0.0500000
NODE_303556_length_158_cov_61.203390	39	119	300	1	80	0.0125000
NODE_303556_length_158_cov_61.203390	39	119	302	5	80	0.0625000
NODE_303556_length_158_cov_61.203390	39	119	308	1	80	0.0125000
NODE_303556_length_158_cov_61.203390	39	119	310	2	80	0.0250000
NODE_303556_length_158_cov_61.203390	39	119	312	15	80	0.1875000
NODE_303556_length_158_cov_61.203390	39	119	313	27	80	0.3375000
NODE_303556_length_158_cov_61.203390	39	119	314	5	80	0.0625000
NODE_303563_length_158_cov_40.271186	43	107	74	3	64	0.0468750
NODE_303563_length_158_cov_40.271186	43	107	82	2	64	0.0312500
NODE_303563_length_158_cov_40.271186	43	107	83	1	64	0.0156250
NODE_303563_length_158_cov_40.271186	43	107	84	7	64	0.1093750
NODE_303563_length_158_cov_40.271186	43	107	86	51	64	0.7968750
NODE_303563_length_158_cov_40.271186	80	151	20	2	71	0.0281690
NODE_303563_length_158_cov_40.271186	80	151	24	1	71	0.0140845
NODE_303563_length_158_cov_40.271186	80	151	32	1	71	0.0140845
NODE_303563_length_158_cov_40.271186	80	151	34	5	71	0.0704225
NODE_303563_length_158_cov_40.271186	80	151	42	13	71	0.1830986
NODE_303563_length_158_cov_40.271186	80	151	46	1	71	0.0140845
NODE_303563_length_158_cov_40.271186	80	151	48	2	71	0.0281690
NODE_303563_length_158_cov_40.271186	80	151	52	3	71	0.0422535
NODE_303563_length_158_cov_40.271186	80	151	60	1	71	0.0140845
NODE_303563_length_158_cov_40.271186	80	151	66	4	71	0.0563380
NODE_303563_length_158_cov_40.271186	80	151	72	7	71	0.0985916
NODE_303563_length_158_cov_40.271186	80	151	78	2	71	0.0281690
NODE_303563_length_158_cov_40.271186	80	151	80	2	71	0.0281690
NODE_303563_length_158_cov_40.271186	80	151	83	1	71	0.0140845
NODE_303563_length_158_cov_40.271186	80	151	84	3	71	0.0422535
NODE_303563_length_158_cov_40.271186	80	151	86	23	71	0.3239437
NODE_303566_length_158_cov_29.661017	0	61	0	61	61	1.0000000
NODE_303566_length_158_cov_29.661017	34	64	0	30	30	1.0000000
NODE_303605_length_157_cov_1488.586207	57	138	34	1	81	0.0123457
NODE_303605_length_157_cov_1488.586207	57	138	38	1	81	0.0123457
NODE_303605_length_157_cov_1488.586207	57	138	40	2	81	0.0246914
NODE_303605_length_157_cov_1488.586207	57	138	42	1	81	0.0123457
NODE_303605_length_157_cov_1488.586207	57	138	46	1	81	0.0123457
NODE_303605_length_157_cov_1488.586207	57	138	52	1	81	0.0123457
NODE_303605_length_157_cov_1488.586207	57	138	58	1	81	0.0123457
NODE_303605_length_157_cov_1488.586207	57	138	60	5	81	0.0617284
NODE_303605_length_157_cov_1488.586207	57	138	62	4	81	0.0493827
NODE_303605_length_157_cov_1488.586207	57	138	64	1	81	0.0123457
NODE_303605_length_157_cov_1488.586207	57	138	66	8	81	0.0987654
NODE_303605_length_157_cov_1488.586207	57	138	68	1	81	0.0123457
NODE_303605_length_157_cov_1488.586207	57	138	72	4	81	0.0493827
NODE_303605_length_157_cov_1488.586207	57	138	74	2	81	0.0246914
NODE_303605_length_157_cov_1488.586207	57	138	76	1	81	0.0123457
NODE_303605_length_157_cov_1488.586207	57	138	78	47	81	0.5802469
NODE_303605_length_157_cov_1488.586207	111	157	2	6	46	0.1304348
NODE_303605_length_157_cov_1488.586207	111	157	10	1	46	0.0217391
NODE_303605_length_157_cov_1488.586207	111	157	12	2	46	0.0434783
NODE_303605_length_157_cov_1488.586207	111	157	14	1	46	0.0217391
NODE_303605_length_157_cov_1488.586207	111	157	20	1	46	0.0217391
NODE_303605_length_157_cov_1488.586207	111	157	22	3	46	0.0652174
NODE_303605_length_157_cov_1488.586207	111	157	24	1	46	0.0217391
NODE_303605_length_157_cov_1488.586207	111	157	26	2	46	0.0434783
NODE_303605_length_157_cov_1488.586207	111	157	28	2	46	0.0434783
NODE_303605_length_157_cov_1488.586207	111	157	34	1	46	0.0217391
NODE_303605_length_157_cov_1488.586207	111	157	38	1	46	0.0217391
NODE_303605_length_157_cov_1488.586207	111	157	40	2	46	0.0434783
NODE_303605_length_157_cov_1488.586207	111	157	42	1	46	0.0217391
NODE_303605_length_157_cov_1488.586207	111	157	46	1	46	0.0217391
NODE_303605_length_157_cov_1488.586207	111	157	52	1	46	0.0217391
NODE_303605_length_157_cov_1488.586207	111	157	58	1	46	0.0217391
NODE_303605_length_157_cov_1488.586207	111	157	60	5	46	0.1086956
NODE_303605_length_157_cov_1488.586207	111	157	62	4	46	0.0869565
NODE_303605_length_157_cov_1488.586207	111	157	64	1	46	0.0217391
NODE_303605_length_157_cov_1488.586207	111	157	66	8	46	0.1739130
NODE_303605_length_157_cov_1488.586207	111	157	68	1	46	0.0217391
NODE_303606_length_157_cov_295.896552	32	78	40	3	46	0.0652174
NODE_303606_length_157_cov_295.896552	32	78	42	8	46	0.1739130
NODE_303606_length_157_cov_295.896552	32	78	44	3	46	0.0652174
NODE_303606_length_157_cov_295.896552	32	78	48	1	46	0.0217391
NODE_303606_length_157_cov_295.896552	32	78	50	1	46	0.0217391
NODE_303606_length_157_cov_295.896552	32	78	52	1	46	0.0217391
NODE_303606_length_157_cov_295.896552	32	78	54	4	46	0.0869565
NODE_303606_length_157_cov_295.896552	32	78	58	25	46	0.5434783
NODE_303608_length_157_cov_161.689655	0	59	2	7	59	0.1186441
NODE_303608_length_157_cov_161.689655	0	59	9	22	59	0.3728814
NODE_303608_length_157_cov_161.689655	0	59	11	30	59	0.5084746
NODE_303608_length_157_cov_161.689655	0	59	2	7	59	0.1186441
NODE_303608_length_157_cov_161.689655	0	59	9	22	59	0.3728814
NODE_303608_length_157_cov_161.689655	0	59	11	30	59	0.5084746
NODE_303608_length_157_cov_161.689655	55	135	10	22	80	0.2750000
NODE_303608_length_157_cov_161.689655	55	135	11	51	80	0.6375000
NODE_303608_length_157_cov_161.689655	55	135	12	7	80	0.0875000
NODE_303608_length_157_cov_161.689655	55	135	10	22	80	0.2750000
NODE_303608_length_157_cov_161.689655	55	135	11	51	80	0.6375000
NODE_303608_length_157_cov_161.689655	55	135	12	7	80	0.0875000
NODE_303608_length_157_cov_161.689655	108	157	2	10	49	0.2040816
NODE_303608_length_157_cov_161.689655	108	157	9	1	49	0.0204082
NODE_303608_length_157_cov_161.689655	108	157	10	33	49	0.6734694
NODE_303608_length_157_cov_161.689655	108	157	12	5	49	0.1020408
NODE_303608_length_157_cov_161.689655	113	157	2	10	44	0.2272727
NODE_303608_length_157_cov_161.689655	113	157	9	1	44	0.0227273
NODE_303608_length_157_cov_161.689655	113	157	10	33	44	0.7500000
NODE_303677_length_156_cov_100.491228	0	41	0	8	41	0.1951219
NODE_303677_length_156_cov_100.491228	0	41	2	9	41	0.2195122
NODE_303677_length_156_cov_100.491228	0	41	4	4	41	0.0975610
NODE_303677_length_156_cov_100.491228	0	41	6	20	41	0.4878049
NODE_303677_length_156_cov_100.491228	21	94	6	28	73	0.3835616
NODE_303677_length_156_cov_100.491228	21	94	8	1	73	0.0136986
NODE_303677_length_156_cov_100.491228	21	94	10	44	73	0.6027398
NODE_303688_length_156_cov_37.368421	24	81	0	1	57	0.0175439
NODE_303688_length_156_cov_37.368421	24	81	6	2	57	0.0350877
NODE_303688_length_156_cov_37.368421	24	81	8	4	57	0.0701754
NODE_303688_length_156_cov_37.368421	24	81	10	11	57	0.1929825
NODE_303688_length_156_cov_37.368421	24	81	12	6	57	0.1052632
NODE_303688_length_156_cov_37.368421	24	81	14	2	57	0.0350877
NODE_303688_length_156_cov_37.368421	24	81	16	1	57	0.0175439
NODE_303688_length_156_cov_37.368421	24	81	18	30	57	0.5263158
NODE_303688_length_156_cov_37.368421	54	134	14	17	80	0.2125000
NODE_303688_length_156_cov_37.368421	54	134	18	63	80	0.7875000
NODE_303700_length_156_cov_9.543860	2	48	0	46	46	1.0000000
NODE_303700_length_156_cov_9.543860	59	105	0	46	46	1.0000000
NODE_303752_length_155_cov_56.750000	27	102	2	75	75	1.0000000
NODE_303752_length_155_cov_56.750000	80	155	0	5	75	0.0666667
NODE_303752_length_155_cov_56.750000	80	155	2	70	75	0.9333333
NODE_304022_length_153_cov_0.944444	5	48	0	43	43	1.0000000
NODE_304022_length_153_cov_0.944444	37	86	0	49	49	1.0000000
NODE_304022_length_153_cov_0.944444	59	102	0	43	43	1.0000000
NODE_304022_length_153_cov_0.944444	91	140	0	49	49	1.0000000
NODE_304022_length_153_cov_0.944444	113	153	0	40	40	1.0000000
NODE_304027_length_152_cov_195.396226	9	89	3	40	80	0.5000000
NODE_304027_length_152_cov_195.396226	9	89	7	40	80	0.5000000
NODE_304027_length_152_cov_195.396226	9	89	3	40	80	0.5000000
NODE_304027_length_152_cov_195.396226	9	89	7	40	80	0.5000000
NODE_304027_length_152_cov_195.396226	85	149	6	2	64	0.0312500
NODE_304027_length_152_cov_195.396226	85	149	7	62	64	0.9687500
NODE_304027_length_152_cov_195.396226	85	152	2	1	67	0.0149254
NODE_304027_length_152_cov_195.396226	85	152	6	4	67	0.0597015
NODE_304027_length_152_cov_195.396226	85	152	7	62	67	0.9253731
NODE_304027_length_152_cov_195.396226	85	152	2	1	67	0.0149254
NODE_304027_length_152_cov_195.396226	85	152	6	4	67	0.0597015
NODE_304027_length_152_cov_195.396226	85	152	7	62	67	0.9253731
NODE_304027_length_152_cov_195.396226	85	152	2	1	67	0.0149254
NODE_304027_length_152_cov_195.396226	85	152	6	4	67	0.0597015
NODE_304027_length_152_cov_195.396226	85	152	7	62	67	0.9253731
NODE_304030_length_152_cov_68.094340	99	150	2	51	51	1.0000000
NODE_304112_length_151_cov_541.615385	19	88	16	2	69	0.0289855
NODE_304112_length_151_cov_541.615385	19	88	18	5	69	0.0724638
NODE_304112_length_151_cov_541.615385	19	88	22	6	69	0.0869565
NODE_304112_length_151_cov_541.615385	19	88	23	1	69	0.0144928
NODE_304112_length_151_cov_541.615385	19	88	24	5	69	0.0724638
NODE_304112_length_151_cov_541.615385	19	88	27	1	69	0.0144928
NODE_304112_length_151_cov_541.615385	19	88	28	2	69	0.0289855
NODE_304112_length_151_cov_541.615385	19	88	32	1	69	0.0144928
NODE_304112_length_151_cov_541.615385	19	88	34	46	69	0.6666667
NODE_304112_length_151_cov_541.615385	72	149	0	3	77	0.0389610
NODE_304112_length_151_cov_541.615385	72	149	2	1	77	0.0129870
NODE_304112_length_151_cov_541.615385	72	149	6	9	77	0.1168831
NODE_304112_length_151_cov_541.615385	72	149	8	4	77	0.0519481
NODE_304112_length_151_cov_541.615385	72	149	12	3	77	0.0389610
NODE_304112_length_151_cov_541.615385	72	149	14	3	77	0.0389610
NODE_304112_length_151_cov_541.615385	72	149	18	6	77	0.0779221
NODE_304112_length_151_cov_541.615385	72	149	20	4	77	0.0519481
NODE_304112_length_151_cov_541.615385	72	149	24	1	77	0.0129870
NODE_304112_length_151_cov_541.615385	72	149	26	1	77	0.0129870
NODE_304112_length_151_cov_541.615385	72	149	28	2	77	0.0259740
NODE_304112_length_151_cov_541.615385	72	149	30	4	77	0.0519481
NODE_304112_length_151_cov_541.615385	72	149	33	1	77	0.0129870
NODE_304112_length_151_cov_541.615385	72	149	34	35	77	0.4545455
NODE_304229_length_150_cov_88.647059	51	102	12	51	51	1.0000000
NODE_304472_length_148_cov_34.183673	23	99	12	4	76	0.0526316
NODE_304472_length_148_cov_34.183673	23	99	14	2	76	0.0263158
NODE_304472_length_148_cov_34.183673	23	99	16	1	76	0.0131579
NODE_304472_length_148_cov_34.183673	23	99	18	3	76	0.0394737
NODE_304472_length_148_cov_34.183673	23	99	21	1	76	0.0131579
NODE_304472_length_148_cov_34.183673	23	99	23	2	76	0.0263158
NODE_304472_length_148_cov_34.183673	23	99	27	2	76	0.0263158
NODE_304472_length_148_cov_34.183673	23	99	29	61	76	0.8026316
NODE_304570_length_147_cov_472.354167	0	55	6	1	55	0.0181818
NODE_304570_length_147_cov_472.354167	0	55	8	2	55	0.0363636
NODE_304570_length_147_cov_472.354167	0	55	13	1	55	0.0181818
NODE_304570_length_147_cov_472.354167	0	55	16	1	55	0.0181818
NODE_304570_length_147_cov_472.354167	0	55	18	2	55	0.0363636
NODE_304570_length_147_cov_472.354167	0	55	20	5	55	0.0909091
NODE_304570_length_147_cov_472.354167	0	55	22	1	55	0.0181818
NODE_304570_length_147_cov_472.354167	0	55	25	1	55	0.0181818
NODE_304570_length_147_cov_472.354167	0	55	31	1	55	0.0181818
NODE_304570_length_147_cov_472.354167	0	55	43	1	55	0.0181818
NODE_304570_length_147_cov_472.354167	0	55	44	1	55	0.0181818
NODE_304570_length_147_cov_472.354167	0	55	50	4	55	0.0727273
NODE_304570_length_147_cov_472.354167	0	55	51	1	55	0.0181818
NODE_304570_length_147_cov_472.354167	0	55	53	2	55	0.0363636
NODE_304570_length_147_cov_472.354167	0	55	55	1	55	0.0181818
NODE_304570_length_147_cov_472.354167	0	55	57	3	55	0.0545455
NODE_304570_length_147_cov_472.354167	0	55	61	2	55	0.0363636
NODE_304570_length_147_cov_472.354167	0	55	65	2	55	0.0363636
NODE_304570_length_147_cov_472.354167	0	55	67	4	55	0.0727273
NODE_304570_length_147_cov_472.354167	0	55	69	1	55	0.0181818
NODE_304570_length_147_cov_472.354167	0	55	71	18	55	0.3272727
NODE_304570_length_147_cov_472.354167	12	89	22	1	77	0.0129870
NODE_304570_length_147_cov_472.354167	12	89	25	1	77	0.0129870
NODE_304570_length_147_cov_472.354167	12	89	31	1	77	0.0129870
NODE_304570_length_147_cov_472.354167	12	89	43	1	77	0.0129870
NODE_304570_length_147_cov_472.354167	12	89	44	1	77	0.0129870
NODE_304570_length_147_cov_472.354167	12	89	50	4	77	0.0519481
NODE_304570_length_147_cov_472.354167	12	89	51	1	77	0.0129870
NODE_304570_length_147_cov_472.354167	12	89	53	2	77	0.0259740
NODE_304570_length_147_cov_472.354167	12	89	55	1	77	0.0129870
NODE_304570_length_147_cov_472.354167	12	89	57	3	77	0.0389610
NODE_304570_length_147_cov_472.354167	12	89	61	2	77	0.0259740
NODE_304570_length_147_cov_472.354167	12	89	65	2	77	0.0259740
NODE_304570_length_147_cov_472.354167	12	89	67	4	77	0.0519481
NODE_304570_length_147_cov_472.354167	12	89	69	1	77	0.0129870
NODE_304570_length_147_cov_472.354167	12	89	71	51	77	0.6623377
NODE_304570_length_147_cov_472.354167	12	89	72	1	77	0.0129870
NODE_304570_length_147_cov_472.354167	65	137	26	3	72	0.0416667
NODE_304570_length_147_cov_472.354167	65	137	30	1	72	0.0138889
NODE_304570_length_147_cov_472.354167	65	137	32	2	72	0.0277778
NODE_304570_length_147_cov_472.354167	65	137	35	1	72	0.0138889
NODE_304570_length_147_cov_472.354167	65	137	36	2	72	0.0277778
NODE_304570_length_147_cov_472.354167	65	137	38	2	72	0.0277778
NODE_304570_length_147_cov_472.354167	65	137	40	1	72	0.0138889
NODE_304570_length_147_cov_472.354167	65	137	44	2	72	0.0277778
NODE_304570_length_147_cov_472.354167	65	137	46	5	72	0.0694444
NODE_304570_length_147_cov_472.354167	65	137	50	1	72	0.0138889
NODE_304570_length_147_cov_472.354167	65	137	52	2	72	0.0277778
NODE_304570_length_147_cov_472.354167	65	137	54	3	72	0.0416667
NODE_304570_length_147_cov_472.354167	65	137	55	1	72	0.0138889
NODE_304570_length_147_cov_472.354167	65	137	58	1	72	0.0138889
NODE_304570_length_147_cov_472.354167	65	137	62	2	72	0.0277778
NODE_304570_length_147_cov_472.354167	65	137	66	2	72	0.0277778
NODE_304570_length_147_cov_472.354167	65	137	68	1	72	0.0138889
NODE_304570_length_147_cov_472.354167	65	137	70	3	72	0.0416667
NODE_304570_length_147_cov_472.354167	65	137	71	23	72	0.3194444
NODE_304570_length_147_cov_472.354167	65	137	72	14	72	0.1944444
NODE_304572_length_147_cov_229.729167	7	56	26	1	49	0.0204082
NODE_304572_length_147_cov_229.729167	7	56	34	1	49	0.0204082
NODE_304572_length_147_cov_229.729167	7	56	45	1	49	0.0204082
NODE_304572_length_147_cov_229.729167	7	56	47	1	49	0.0204082
NODE_304572_length_147_cov_229.729167	7	56	48	3	49	0.0612245
NODE_304572_length_147_cov_229.729167	7	56	52	2	49	0.0408163
NODE_304572_length_147_cov_229.729167	7	56	58	2	49	0.0408163
NODE_304572_length_147_cov_229.729167	7	56	77	1	49	0.0204082
NODE_304572_length_147_cov_229.729167	7	56	82	4	49	0.0816327
NODE_304572_length_147_cov_229.729167	7	56	90	1	49	0.0204082
NODE_304572_length_147_cov_229.729167	7	56	98	1	49	0.0204082
NODE_304572_length_147_cov_229.729167	7	56	104	2	49	0.0408163
NODE_304572_length_147_cov_229.729167	7	56	110	3	49	0.0612245
NODE_304572_length_147_cov_229.729167	7	56	114	4	49	0.0816327
NODE_304572_length_147_cov_229.729167	7	56	116	1	49	0.0204082
NODE_304572_length_147_cov_229.729167	7	56	122	2	49	0.0408163
NODE_304572_length_147_cov_229.729167	7	56	126	2	49	0.0408163
NODE_304572_length_147_cov_229.729167	7	56	134	5	49	0.1020408
NODE_304572_length_147_cov_229.729167	7	56	136	12	49	0.2448980
NODE_304572_length_147_cov_229.729167	29	93	110	1	64	0.0156250
NODE_304572_length_147_cov_229.729167	29	93	114	4	64	0.0625000
NODE_304572_length_147_cov_229.729167	29	93	116	1	64	0.0156250
NODE_304572_length_147_cov_229.729167	29	93	122	2	64	0.0312500
NODE_304572_length_147_cov_229.729167	29	93	126	2	64	0.0312500
NODE_304572_length_147_cov_229.729167	29	93	134	5	64	0.0781250
NODE_304572_length_147_cov_229.729167	29	93	136	49	64	0.7656250
NODE_304572_length_147_cov_229.729167	29	93	110	1	64	0.0156250
NODE_304572_length_147_cov_229.729167	29	93	114	4	64	0.0625000
NODE_304572_length_147_cov_229.729167	29	93	116	1	64	0.0156250
NODE_304572_length_147_cov_229.729167	29	93	122	2	64	0.0312500
NODE_304572_length_147_cov_229.729167	29	93	126	2	64	0.0312500
NODE_304572_length_147_cov_229.729167	29	93	134	5	64	0.0781250
NODE_304572_length_147_cov_229.729167	29	93	136	49	64	0.7656250
NODE_304572_length_147_cov_229.729167	29	93	110	1	64	0.0156250
NODE_304572_length_147_cov_229.729167	29	93	114	4	64	0.0625000
NODE_304572_length_147_cov_229.729167	29	93	116	1	64	0.0156250
NODE_304572_length_147_cov_229.729167	29	93	122	2	64	0.0312500
NODE_304572_length_147_cov_229.729167	29	93	126	2	64	0.0312500
NODE_304572_length_147_cov_229.729167	29	93	134	5	64	0.0781250
NODE_304572_length_147_cov_229.729167	29	93	136	49	64	0.7656250
NODE_304573_length_147_cov_213.770833	37	117	0	80	80	1.0000000
NODE_304573_length_147_cov_213.770833	90	146	0	56	56	1.0000000
NODE_304697_length_146_cov_182.893617	1	60	0	5	59	0.0847458
NODE_304697_length_146_cov_182.893617	1	60	2	24	59	0.4067796
NODE_304697_length_146_cov_182.893617	1	60	4	30	59	0.5084746
NODE_304697_length_146_cov_182.893617	34	60	4	26	26	1.0000000
NODE_304697_length_146_cov_182.893617	113	144	0	16	31	0.5161290
NODE_304697_length_146_cov_182.893617	113	144	2	8	31	0.2580645
NODE_304697_length_146_cov_182.893617	113	144	4	7	31	0.2258064
NODE_304698_length_146_cov_152.808511	0	69	0	69	69	1.0000000
NODE_304698_length_146_cov_152.808511	42	122	0	80	80	1.0000000
NODE_304703_length_146_cov_89.808511	0	53	0	53	53	1.0000000
NODE_304703_length_146_cov_89.808511	26	106	0	80	80	1.0000000
NODE_304703_length_146_cov_89.808511	74	146	0	72	72	1.0000000
NODE_304703_length_146_cov_89.808511	79	101	0	22	22	1.0000000
NODE_304707_length_146_cov_57.446809	44	124	0	80	80	1.0000000
NODE_304708_length_146_cov_54.106383	0	69	0	69	69	1.0000000
NODE_304708_length_146_cov_54.106383	42	122	0	80	80	1.0000000
NODE_304710_length_146_cov_46.765957	3	83	8	12	80	0.1500000
NODE_304710_length_146_cov_46.765957	3	83	10	9	80	0.1125000
NODE_304710_length_146_cov_46.765957	3	83	12	18	80	0.2250000
NODE_304710_length_146_cov_46.765957	3	83	13	1	80	0.0125000
NODE_304710_length_146_cov_46.765957	3	83	14	3	80	0.0375000
NODE_304710_length_146_cov_46.765957	3	83	16	37	80	0.4625000
NODE_304710_length_146_cov_46.765957	3	83	8	12	80	0.1500000
NODE_304710_length_146_cov_46.765957	3	83	10	9	80	0.1125000
NODE_304710_length_146_cov_46.765957	3	83	12	18	80	0.2250000
NODE_304710_length_146_cov_46.765957	3	83	13	1	80	0.0125000
NODE_304710_length_146_cov_46.765957	3	83	14	3	80	0.0375000
NODE_304710_length_146_cov_46.765957	3	83	16	37	80	0.4625000
NODE_304710_length_146_cov_46.765957	3	83	8	12	80	0.1500000
NODE_304710_length_146_cov_46.765957	3	83	10	9	80	0.1125000
NODE_304710_length_146_cov_46.765957	3	83	12	18	80	0.2250000
NODE_304710_length_146_cov_46.765957	3	83	13	1	80	0.0125000
NODE_304710_length_146_cov_46.765957	3	83	14	3	80	0.0375000
NODE_304710_length_146_cov_46.765957	3	83	16	37	80	0.4625000
NODE_304710_length_146_cov_46.765957	3	83	8	12	80	0.1500000
NODE_304710_length_146_cov_46.765957	3	83	10	9	80	0.1125000
NODE_304710_length_146_cov_46.765957	3	83	12	18	80	0.2250000
NODE_304710_length_146_cov_46.765957	3	83	13	1	80	0.0125000
NODE_304710_length_146_cov_46.765957	3	83	14	3	80	0.0375000
NODE_304710_length_146_cov_46.765957	3	83	16	37	80	0.4625000
NODE_304710_length_146_cov_46.765957	3	83	8	12	80	0.1500000
NODE_304710_length_146_cov_46.765957	3	83	10	9	80	0.1125000
NODE_304710_length_146_cov_46.765957	3	83	12	18	80	0.2250000
NODE_304710_length_146_cov_46.765957	3	83	13	1	80	0.0125000
NODE_304710_length_146_cov_46.765957	3	83	14	3	80	0.0375000
NODE_304710_length_146_cov_46.765957	3	83	16	37	80	0.4625000
NODE_304710_length_146_cov_46.765957	12	83	8	3	71	0.0422535
NODE_304710_length_146_cov_46.765957	12	83	10	9	71	0.1267606
NODE_304710_length_146_cov_46.765957	12	83	12	18	71	0.2535211
NODE_304710_length_146_cov_46.765957	12	83	13	1	71	0.0140845
NODE_304710_length_146_cov_46.765957	12	83	14	3	71	0.0422535
NODE_304710_length_146_cov_46.765957	12	83	16	37	71	0.5211267
NODE_304710_length_146_cov_46.765957	56	136	0	3	80	0.0375000
NODE_304710_length_146_cov_46.765957	56	136	2	8	80	0.1000000
NODE_304710_length_146_cov_46.765957	56	136	4	3	80	0.0375000
NODE_304710_length_146_cov_46.765957	56	136	12	2	80	0.0250000
NODE_304710_length_146_cov_46.765957	56	136	13	1	80	0.0125000
NODE_304710_length_146_cov_46.765957	56	136	14	13	80	0.1625000
NODE_304710_length_146_cov_46.765957	56	136	16	50	80	0.6250000
NODE_304710_length_146_cov_46.765957	56	136	0	3	80	0.0375000
NODE_304710_length_146_cov_46.765957	56	136	2	8	80	0.1000000
NODE_304710_length_146_cov_46.765957	56	136	4	3	80	0.0375000
NODE_304710_length_146_cov_46.765957	56	136	12	2	80	0.0250000
NODE_304710_length_146_cov_46.765957	56	136	13	1	80	0.0125000
NODE_304710_length_146_cov_46.765957	56	136	14	13	80	0.1625000
NODE_304710_length_146_cov_46.765957	56	136	16	50	80	0.6250000
NODE_304711_length_146_cov_44.021277	0	69	0	69	69	1.0000000
NODE_304711_length_146_cov_44.021277	42	122	0	80	80	1.0000000
NODE_304798_length_145_cov_1385.413043	0	69	44	1	69	0.0144928
NODE_304798_length_145_cov_1385.413043	0	69	62	1	69	0.0144928
NODE_304798_length_145_cov_1385.413043	0	69	72	1	69	0.0144928
NODE_304798_length_145_cov_1385.413043	0	69	75	3	69	0.0434783
NODE_304798_length_145_cov_1385.413043	0	69	83	1	69	0.0144928
NODE_304798_length_145_cov_1385.413043	0	69	87	1	69	0.0144928
NODE_304798_length_145_cov_1385.413043	0	69	92	1	69	0.0144928
NODE_304798_length_145_cov_1385.413043	0	69	94	1	69	0.0144928
NODE_304798_length_145_cov_1385.413043	0	69	98	2	69	0.0289855
NODE_304798_length_145_cov_1385.413043	0	69	108	1	69	0.0144928
NODE_304798_length_145_cov_1385.413043	0	69	113	1	69	0.0144928
NODE_304798_length_145_cov_1385.413043	0	69	139	1	69	0.0144928
NODE_304798_length_145_cov_1385.413043	0	69	146	1	69	0.0144928
NODE_304798_length_145_cov_1385.413043	0	69	149	1	69	0.0144928
NODE_304798_length_145_cov_1385.413043	0	69	159	1	69	0.0144928
NODE_304798_length_145_cov_1385.413043	0	69	163	1	69	0.0144928
NODE_304798_length_145_cov_1385.413043	0	69	185	1	69	0.0144928
NODE_304798_length_145_cov_1385.413043	0	69	187	1	69	0.0144928
NODE_304798_length_145_cov_1385.413043	0	69	189	1	69	0.0144928
NODE_304798_length_145_cov_1385.413043	0	69	195	1	69	0.0144928
NODE_304798_length_145_cov_1385.413043	0	69	197	2	69	0.0289855
NODE_304798_length_145_cov_1385.413043	0	69	199	1	69	0.0144928
NODE_304798_length_145_cov_1385.413043	0	69	205	1	69	0.0144928
NODE_304798_length_145_cov_1385.413043	0	69	215	1	69	0.0144928
NODE_304798_length_145_cov_1385.413043	0	69	217	1	69	0.0144928
NODE_304798_length_145_cov_1385.413043	0	69	231	2	69	0.0289855
NODE_304798_length_145_cov_1385.413043	0	69	243	1	69	0.0144928
NODE_304798_length_145_cov_1385.413043	0	69	248	1	69	0.0144928
NODE_304798_length_145_cov_1385.413043	0	69	256	1	69	0.0144928
NODE_304798_length_145_cov_1385.413043	0	69	258	1	69	0.0144928
NODE_304798_length_145_cov_1385.413043	0	69	263	2	69	0.0289855
NODE_304798_length_145_cov_1385.413043	0	69	267	1	69	0.0144928
NODE_304798_length_145_cov_1385.413043	0	69	279	1	69	0.0144928
NODE_304798_length_145_cov_1385.413043	0	69	283	1	69	0.0144928
NODE_304798_length_145_cov_1385.413043	0	69	297	1	69	0.0144928
NODE_304798_length_145_cov_1385.413043	0	69	301	1	69	0.0144928
NODE_304798_length_145_cov_1385.413043	0	69	305	1	69	0.0144928
NODE_304798_length_145_cov_1385.413043	0	69	309	23	69	0.3333333
NODE_304798_length_145_cov_1385.413043	0	69	310	3	69	0.0434783
NODE_304798_length_145_cov_1385.413043	42	122	192	1	80	0.0125000
NODE_304798_length_145_cov_1385.413043	42	122	203	1	80	0.0125000
NODE_304798_length_145_cov_1385.413043	42	122	213	1	80	0.0125000
NODE_304798_length_145_cov_1385.413043	42	122	223	1	80	0.0125000
NODE_304798_length_145_cov_1385.413043	42	122	225	1	80	0.0125000
NODE_304798_length_145_cov_1385.413043	42	122	227	1	80	0.0125000
NODE_304798_length_145_cov_1385.413043	42	122	233	1	80	0.0125000
NODE_304798_length_145_cov_1385.413043	42	122	241	1	80	0.0125000
NODE_304798_length_145_cov_1385.413043	42	122	243	1	80	0.0125000
NODE_304798_length_145_cov_1385.413043	42	122	263	1	80	0.0125000
NODE_304798_length_145_cov_1385.413043	42	122	267	1	80	0.0125000
NODE_304798_length_145_cov_1385.413043	42	122	269	1	80	0.0125000
NODE_304798_length_145_cov_1385.413043	42	122	279	1	80	0.0125000
NODE_304798_length_145_cov_1385.413043	42	122	285	1	80	0.0125000
NODE_304798_length_145_cov_1385.413043	42	122	293	2	80	0.0250000
NODE_304798_length_145_cov_1385.413043	42	122	301	3	80	0.0375000
NODE_304798_length_145_cov_1385.413043	42	122	305	1	80	0.0125000
NODE_304798_length_145_cov_1385.413043	42	122	307	1	80	0.0125000
NODE_304798_length_145_cov_1385.413043	42	122	309	56	80	0.7000000
NODE_304798_length_145_cov_1385.413043	42	122	310	3	80	0.0375000
NODE_304799_length_145_cov_880.369565	56	120	188	1	64	0.0156250
NODE_304799_length_145_cov_880.369565	56	120	189	1	64	0.0156250
NODE_304799_length_145_cov_880.369565	56	120	191	2	64	0.0312500
NODE_304799_length_145_cov_880.369565	56	120	193	1	64	0.0156250
NODE_304799_length_145_cov_880.369565	56	120	200	1	64	0.0156250
NODE_304799_length_145_cov_880.369565	56	120	204	1	64	0.0156250
NODE_304799_length_145_cov_880.369565	56	120	213	1	64	0.0156250
NODE_304799_length_145_cov_880.369565	56	120	225	1	64	0.0156250
NODE_304799_length_145_cov_880.369565	56	120	232	1	64	0.0156250
NODE_304799_length_145_cov_880.369565	56	120	241	1	64	0.0156250
NODE_304799_length_145_cov_880.369565	56	120	243	1	64	0.0156250
NODE_304799_length_145_cov_880.369565	56	120	259	1	64	0.0156250
NODE_304799_length_145_cov_880.369565	56	120	263	1	64	0.0156250
NODE_304799_length_145_cov_880.369565	56	120	265	1	64	0.0156250
NODE_304799_length_145_cov_880.369565	56	120	266	1	64	0.0156250
NODE_304799_length_145_cov_880.369565	56	120	270	1	64	0.0156250
NODE_304799_length_145_cov_880.369565	56	120	272	2	64	0.0312500
NODE_304799_length_145_cov_880.369565	56	120	274	1	64	0.0156250
NODE_304799_length_145_cov_880.369565	56	120	275	3	64	0.0468750
NODE_304799_length_145_cov_880.369565	56	120	276	41	64	0.6406250
NODE_304799_length_145_cov_880.369565	56	120	188	1	64	0.0156250
NODE_304799_length_145_cov_880.369565	56	120	189	1	64	0.0156250
NODE_304799_length_145_cov_880.369565	56	120	191	2	64	0.0312500
NODE_304799_length_145_cov_880.369565	56	120	193	1	64	0.0156250
NODE_304799_length_145_cov_880.369565	56	120	200	1	64	0.0156250
NODE_304799_length_145_cov_880.369565	56	120	204	1	64	0.0156250
NODE_304799_length_145_cov_880.369565	56	120	213	1	64	0.0156250
NODE_304799_length_145_cov_880.369565	56	120	225	1	64	0.0156250
NODE_304799_length_145_cov_880.369565	56	120	232	1	64	0.0156250
NODE_304799_length_145_cov_880.369565	56	120	241	1	64	0.0156250
NODE_304799_length_145_cov_880.369565	56	120	243	1	64	0.0156250
NODE_304799_length_145_cov_880.369565	56	120	259	1	64	0.0156250
NODE_304799_length_145_cov_880.369565	56	120	263	1	64	0.0156250
NODE_304799_length_145_cov_880.369565	56	120	265	1	64	0.0156250
NODE_304799_length_145_cov_880.369565	56	120	266	1	64	0.0156250
NODE_304799_length_145_cov_880.369565	56	120	270	1	64	0.0156250
NODE_304799_length_145_cov_880.369565	56	120	272	2	64	0.0312500
NODE_304799_length_145_cov_880.369565	56	120	274	1	64	0.0156250
NODE_304799_length_145_cov_880.369565	56	120	275	3	64	0.0468750
NODE_304799_length_145_cov_880.369565	56	120	276	41	64	0.6406250
NODE_304799_length_145_cov_880.369565	56	120	188	1	64	0.0156250
NODE_304799_length_145_cov_880.369565	56	120	189	1	64	0.0156250
NODE_304799_length_145_cov_880.369565	56	120	191	2	64	0.0312500
NODE_304799_length_145_cov_880.369565	56	120	193	1	64	0.0156250
NODE_304799_length_145_cov_880.369565	56	120	200	1	64	0.0156250
NODE_304799_length_145_cov_880.369565	56	120	204	1	64	0.0156250
NODE_304799_length_145_cov_880.369565	56	120	213	1	64	0.0156250
NODE_304799_length_145_cov_880.369565	56	120	225	1	64	0.0156250
NODE_304799_length_145_cov_880.369565	56	120	232	1	64	0.0156250
NODE_304799_length_145_cov_880.369565	56	120	241	1	64	0.0156250
NODE_304799_length_145_cov_880.369565	56	120	243	1	64	0.0156250
NODE_304799_length_145_cov_880.369565	56	120	259	1	64	0.0156250
NODE_304799_length_145_cov_880.369565	56	120	263	1	64	0.0156250
NODE_304799_length_145_cov_880.369565	56	120	265	1	64	0.0156250
NODE_304799_length_145_cov_880.369565	56	120	266	1	64	0.0156250
NODE_304799_length_145_cov_880.369565	56	120	270	1	64	0.0156250
NODE_304799_length_145_cov_880.369565	56	120	272	2	64	0.0312500
NODE_304799_length_145_cov_880.369565	56	120	274	1	64	0.0156250
NODE_304799_length_145_cov_880.369565	56	120	275	3	64	0.0468750
NODE_304799_length_145_cov_880.369565	56	120	276	41	64	0.6406250
NODE_304799_length_145_cov_880.369565	93	142	17	1	49	0.0204082
NODE_304799_length_145_cov_880.369565	93	142	26	2	49	0.0408163
NODE_304799_length_145_cov_880.369565	93	142	32	1	49	0.0204082
NODE_304799_length_145_cov_880.369565	93	142	38	1	49	0.0204082
NODE_304799_length_145_cov_880.369565	93	142	40	1	49	0.0204082
NODE_304799_length_145_cov_880.369565	93	142	56	1	49	0.0204082
NODE_304799_length_145_cov_880.369565	93	142	62	1	49	0.0204082
NODE_304799_length_145_cov_880.369565	93	142	64	3	49	0.0612245
NODE_304799_length_145_cov_880.369565	93	142	74	1	49	0.0204082
NODE_304799_length_145_cov_880.369565	93	142	96	1	49	0.0204082
NODE_304799_length_145_cov_880.369565	93	142	109	1	49	0.0204082
NODE_304799_length_145_cov_880.369565	93	142	112	1	49	0.0204082
NODE_304799_length_145_cov_880.369565	93	142	130	1	49	0.0204082
NODE_304799_length_145_cov_880.369565	93	142	136	1	49	0.0204082
NODE_304799_length_145_cov_880.369565	93	142	147	2	49	0.0408163
NODE_304799_length_145_cov_880.369565	93	142	155	1	49	0.0204082
NODE_304799_length_145_cov_880.369565	93	142	165	1	49	0.0204082
NODE_304799_length_145_cov_880.369565	93	142	167	1	49	0.0204082
NODE_304799_length_145_cov_880.369565	93	142	188	1	49	0.0204082
NODE_304799_length_145_cov_880.369565	93	142	189	1	49	0.0204082
NODE_304799_length_145_cov_880.369565	93	142	191	2	49	0.0408163
NODE_304799_length_145_cov_880.369565	93	142	193	1	49	0.0204082
NODE_304799_length_145_cov_880.369565	93	142	200	1	49	0.0204082
NODE_304799_length_145_cov_880.369565	93	142	204	1	49	0.0204082
NODE_304799_length_145_cov_880.369565	93	142	213	1	49	0.0204082
NODE_304799_length_145_cov_880.369565	93	142	225	1	49	0.0204082
NODE_304799_length_145_cov_880.369565	93	142	232	1	49	0.0204082
NODE_304799_length_145_cov_880.369565	93	142	241	1	49	0.0204082
NODE_304799_length_145_cov_880.369565	93	142	243	1	49	0.0204082
NODE_304799_length_145_cov_880.369565	93	142	259	1	49	0.0204082
NODE_304799_length_145_cov_880.369565	93	142	263	1	49	0.0204082
NODE_304799_length_145_cov_880.369565	93	142	265	1	49	0.0204082
NODE_304799_length_145_cov_880.369565	93	142	266	1	49	0.0204082
NODE_304799_length_145_cov_880.369565	93	142	270	1	49	0.0204082
NODE_304799_length_145_cov_880.369565	93	142	272	2	49	0.0408163
NODE_304799_length_145_cov_880.369565	93	142	274	1	49	0.0204082
NODE_304799_length_145_cov_880.369565	93	142	275	3	49	0.0612245
NODE_304799_length_145_cov_880.369565	93	142	276	4	49	0.0816327
NODE_304923_length_144_cov_46.155556	1	81	1	1	80	0.0125000
NODE_304923_length_144_cov_46.155556	1	81	3	2	80	0.0250000
NODE_304923_length_144_cov_46.155556	1	81	5	3	80	0.0375000
NODE_304923_length_144_cov_46.155556	1	81	10	1	80	0.0125000
NODE_304923_length_144_cov_46.155556	1	81	11	8	80	0.1000000
NODE_304923_length_144_cov_46.155556	1	81	15	1	80	0.0125000
NODE_304923_length_144_cov_46.155556	1	81	17	1	80	0.0125000
NODE_304923_length_144_cov_46.155556	1	81	18	2	80	0.0250000
NODE_304923_length_144_cov_46.155556	1	81	20	6	80	0.0750000
NODE_304923_length_144_cov_46.155556	1	81	22	7	80	0.0875000
NODE_304923_length_144_cov_46.155556	1	81	24	2	80	0.0250000
NODE_304923_length_144_cov_46.155556	1	81	28	46	80	0.5750000
NODE_305208_length_142_cov_244.488372	0	52	0	3	52	0.0576923
NODE_305208_length_142_cov_244.488372	0	52	4	5	52	0.0961538
NODE_305208_length_142_cov_244.488372	0	52	12	2	52	0.0384615
NODE_305208_length_142_cov_244.488372	0	52	16	2	52	0.0384615
NODE_305208_length_142_cov_244.488372	0	52	20	2	52	0.0384615
NODE_305208_length_142_cov_244.488372	0	52	24	3	52	0.0576923
NODE_305208_length_142_cov_244.488372	0	52	25	1	52	0.0192308
NODE_305208_length_142_cov_244.488372	0	52	26	6	52	0.1153846
NODE_305208_length_142_cov_244.488372	0	52	28	1	52	0.0192308
NODE_305208_length_142_cov_244.488372	0	52	30	2	52	0.0384615
NODE_305208_length_142_cov_244.488372	0	52	32	12	52	0.2307692
NODE_305208_length_142_cov_244.488372	0	52	33	2	52	0.0384615
NODE_305208_length_142_cov_244.488372	0	52	34	11	52	0.2115385
NODE_305229_length_142_cov_46.976744	1	65	2	3	64	0.0468750
NODE_305229_length_142_cov_46.976744	1	65	4	7	64	0.1093750
NODE_305229_length_142_cov_46.976744	1	65	12	5	64	0.0781250
NODE_305229_length_142_cov_46.976744	1	65	14	1	64	0.0156250
NODE_305229_length_142_cov_46.976744	1	65	22	1	64	0.0156250
NODE_305229_length_142_cov_46.976744	1	65	28	2	64	0.0312500
NODE_305229_length_142_cov_46.976744	1	65	32	1	64	0.0156250
NODE_305229_length_142_cov_46.976744	1	65	42	1	64	0.0156250
NODE_305229_length_142_cov_46.976744	1	65	49	1	64	0.0156250
NODE_305229_length_142_cov_46.976744	1	65	50	1	64	0.0156250
NODE_305229_length_142_cov_46.976744	1	65	54	41	64	0.6406250
NODE_305229_length_142_cov_46.976744	1	65	2	3	64	0.0468750
NODE_305229_length_142_cov_46.976744	1	65	4	7	64	0.1093750
NODE_305229_length_142_cov_46.976744	1	65	12	5	64	0.0781250
NODE_305229_length_142_cov_46.976744	1	65	14	1	64	0.0156250
NODE_305229_length_142_cov_46.976744	1	65	22	1	64	0.0156250
NODE_305229_length_142_cov_46.976744	1	65	28	2	64	0.0312500
NODE_305229_length_142_cov_46.976744	1	65	32	1	64	0.0156250
NODE_305229_length_142_cov_46.976744	1	65	42	1	64	0.0156250
NODE_305229_length_142_cov_46.976744	1	65	49	1	64	0.0156250
NODE_305229_length_142_cov_46.976744	1	65	50	1	64	0.0156250
NODE_305229_length_142_cov_46.976744	1	65	54	41	64	0.6406250
NODE_305229_length_142_cov_46.976744	1	65	2	3	64	0.0468750
NODE_305229_length_142_cov_46.976744	1	65	4	7	64	0.1093750
NODE_305229_length_142_cov_46.976744	1	65	12	5	64	0.0781250
NODE_305229_length_142_cov_46.976744	1	65	14	1	64	0.0156250
NODE_305229_length_142_cov_46.976744	1	65	22	1	64	0.0156250
NODE_305229_length_142_cov_46.976744	1	65	28	2	64	0.0312500
NODE_305229_length_142_cov_46.976744	1	65	32	1	64	0.0156250
NODE_305229_length_142_cov_46.976744	1	65	42	1	64	0.0156250
NODE_305229_length_142_cov_46.976744	1	65	49	1	64	0.0156250
NODE_305229_length_142_cov_46.976744	1	65	50	1	64	0.0156250
NODE_305229_length_142_cov_46.976744	1	65	54	41	64	0.6406250
NODE_305230_length_142_cov_45.000000	0	69	0	69	69	1.0000000
NODE_305385_length_141_cov_178.785714	58	118	111	1	60	0.0166667
NODE_305385_length_141_cov_178.785714	58	118	117	2	60	0.0333333
NODE_305385_length_141_cov_178.785714	58	118	121	2	60	0.0333333
NODE_305385_length_141_cov_178.785714	58	118	127	1	60	0.0166667
NODE_305385_length_141_cov_178.785714	58	118	129	2	60	0.0333333
NODE_305385_length_141_cov_178.785714	58	118	131	3	60	0.0500000
NODE_305385_length_141_cov_178.785714	58	118	134	1	60	0.0166667
NODE_305385_length_141_cov_178.785714	58	118	136	2	60	0.0333333
NODE_305385_length_141_cov_178.785714	58	118	138	1	60	0.0166667
NODE_305385_length_141_cov_178.785714	58	118	140	1	60	0.0166667
NODE_305385_length_141_cov_178.785714	58	118	141	4	60	0.0666667
NODE_305385_length_141_cov_178.785714	58	118	142	40	60	0.6666667
NODE_305398_length_141_cov_62.285714	26	106	0	80	80	1.0000000
NODE_305398_length_141_cov_62.285714	26	106	0	80	80	1.0000000
NODE_305398_length_141_cov_62.285714	26	97	0	71	71	1.0000000
NODE_305402_length_141_cov_41.142857	26	97	0	71	71	1.0000000
NODE_305600_length_140_cov_60.439024	8	88	0	12	80	0.1500000
NODE_305600_length_140_cov_60.439024	8	88	2	1	80	0.0125000
NODE_305600_length_140_cov_60.439024	8	88	6	4	80	0.0500000
NODE_305600_length_140_cov_60.439024	8	88	8	8	80	0.1000000
NODE_305600_length_140_cov_60.439024	8	88	10	55	80	0.6875000
NODE_305600_length_140_cov_60.439024	8	88	0	12	80	0.1500000
NODE_305600_length_140_cov_60.439024	8	88	2	1	80	0.0125000
NODE_305600_length_140_cov_60.439024	8	88	6	4	80	0.0500000
NODE_305600_length_140_cov_60.439024	8	88	8	8	80	0.1000000
NODE_305600_length_140_cov_60.439024	8	88	10	55	80	0.6875000
NODE_305600_length_140_cov_60.439024	8	88	0	12	80	0.1500000
NODE_305600_length_140_cov_60.439024	8	88	2	1	80	0.0125000
NODE_305600_length_140_cov_60.439024	8	88	6	4	80	0.0500000
NODE_305600_length_140_cov_60.439024	8	88	8	8	80	0.1000000
NODE_305600_length_140_cov_60.439024	8	88	10	55	80	0.6875000
NODE_305600_length_140_cov_60.439024	8	88	0	12	80	0.1500000
NODE_305600_length_140_cov_60.439024	8	88	2	1	80	0.0125000
NODE_305600_length_140_cov_60.439024	8	88	6	4	80	0.0500000
NODE_305600_length_140_cov_60.439024	8	88	8	8	80	0.1000000
NODE_305600_length_140_cov_60.439024	8	88	10	55	80	0.6875000
NODE_305600_length_140_cov_60.439024	8	88	0	12	80	0.1500000
NODE_305600_length_140_cov_60.439024	8	88	2	1	80	0.0125000
NODE_305600_length_140_cov_60.439024	8	88	6	4	80	0.0500000
NODE_305600_length_140_cov_60.439024	8	88	8	8	80	0.1000000
NODE_305600_length_140_cov_60.439024	8	88	10	55	80	0.6875000
NODE_305616_length_140_cov_35.146341	22	102	0	80	80	1.0000000
NODE_305616_length_140_cov_35.146341	75	105	0	30	30	1.0000000
NODE_305618_length_140_cov_34.048780	0	77	0	15	77	0.1948052
NODE_305618_length_140_cov_34.048780	0	77	2	62	77	0.8051948
NODE_305618_length_140_cov_34.048780	0	77	0	15	77	0.1948052
NODE_305618_length_140_cov_34.048780	0	77	2	62	77	0.8051948
NODE_305618_length_140_cov_34.048780	50	130	0	17	80	0.2125000
NODE_305618_length_140_cov_34.048780	50	130	2	63	80	0.7875000
NODE_305618_length_140_cov_34.048780	50	130	0	17	80	0.2125000
NODE_305618_length_140_cov_34.048780	50	130	2	63	80	0.7875000
NODE_305618_length_140_cov_34.048780	55	130	0	17	75	0.2266667
NODE_305618_length_140_cov_34.048780	55	130	2	58	75	0.7733333
NODE_305619_length_140_cov_19.926829	44	118	0	74	74	1.0000000
NODE_305783_length_139_cov_29.700000	0	40	0	40	40	1.0000000
NODE_305783_length_139_cov_29.700000	0	40	0	40	40	1.0000000
NODE_305783_length_139_cov_29.700000	13	93	0	80	80	1.0000000
NODE_305783_length_139_cov_29.700000	13	93	0	80	80	1.0000000
NODE_305783_length_139_cov_29.700000	13	93	0	80	80	1.0000000
NODE_305783_length_139_cov_29.700000	13	93	0	80	80	1.0000000
NODE_305783_length_139_cov_29.700000	13	93	0	80	80	1.0000000
NODE_305783_length_139_cov_29.700000	13	84	0	71	71	1.0000000
NODE_305936_length_138_cov_1475.615385	30	97	80	1	67	0.0149254
NODE_305936_length_138_cov_1475.615385	30	97	82	4	67	0.0597015
NODE_305936_length_138_cov_1475.615385	30	97	92	62	67	0.9253731
NODE_305936_length_138_cov_1475.615385	70	138	24	1	68	0.0147059
NODE_305936_length_138_cov_1475.615385	70	138	32	1	68	0.0147059
NODE_305936_length_138_cov_1475.615385	70	138	39	1	68	0.0147059
NODE_305936_length_138_cov_1475.615385	70	138	42	1	68	0.0147059
NODE_305936_length_138_cov_1475.615385	70	138	48	2	68	0.0294118
NODE_305936_length_138_cov_1475.615385	70	138	50	1	68	0.0147059
NODE_305936_length_138_cov_1475.615385	70	138	52	2	68	0.0294118
NODE_305936_length_138_cov_1475.615385	70	138	60	1	68	0.0147059
NODE_305936_length_138_cov_1475.615385	70	138	62	1	68	0.0147059
NODE_305936_length_138_cov_1475.615385	70	138	66	1	68	0.0147059
NODE_305936_length_138_cov_1475.615385	70	138	67	2	68	0.0294118
NODE_305936_length_138_cov_1475.615385	70	138	71	2	68	0.0294118
NODE_305936_length_138_cov_1475.615385	70	138	77	4	68	0.0588235
NODE_305936_length_138_cov_1475.615385	70	138	80	2	68	0.0294118
NODE_305936_length_138_cov_1475.615385	70	138	84	2	68	0.0294118
NODE_305936_length_138_cov_1475.615385	70	138	86	4	68	0.0588235
NODE_305936_length_138_cov_1475.615385	70	138	92	40	68	0.5882353
NODE_305963_length_138_cov_29.564103	11	91	0	9	80	0.1125000
NODE_305963_length_138_cov_29.564103	11	91	2	12	80	0.1500000
NODE_305963_length_138_cov_29.564103	11	91	8	59	80	0.7375000
NODE_305963_length_138_cov_29.564103	11	91	0	9	80	0.1125000
NODE_305963_length_138_cov_29.564103	11	91	2	12	80	0.1500000
NODE_305963_length_138_cov_29.564103	11	91	8	59	80	0.7375000
NODE_305963_length_138_cov_29.564103	64	128	0	3	64	0.0468750
NODE_305963_length_138_cov_29.564103	64	128	2	2	64	0.0312500
NODE_305963_length_138_cov_29.564103	64	128	8	59	64	0.9218750
NODE_305963_length_138_cov_29.564103	64	128	0	3	64	0.0468750
NODE_305963_length_138_cov_29.564103	64	128	2	2	64	0.0312500
NODE_305963_length_138_cov_29.564103	64	128	8	59	64	0.9218750
NODE_306081_length_137_cov_185.684211	20	104	28	7	84	0.0833333
NODE_306081_length_137_cov_185.684211	20	104	30	77	84	0.9166667
NODE_306092_length_137_cov_58.289474	76	106	62	2	30	0.0666667
NODE_306092_length_137_cov_58.289474	76	106	66	1	30	0.0333333
NODE_306092_length_137_cov_58.289474	76	106	68	27	30	0.9000000
NODE_306099_length_137_cov_36.473684	31	111	26	80	80	1.0000000
NODE_306208_length_136_cov_1257.621622	27	107	101	1	80	0.0125000
NODE_306208_length_136_cov_1257.621622	27	107	103	1	80	0.0125000
NODE_306208_length_136_cov_1257.621622	27	107	107	1	80	0.0125000
NODE_306208_length_136_cov_1257.621622	27	107	108	2	80	0.0250000
NODE_306208_length_136_cov_1257.621622	27	107	110	75	80	0.9375000
NODE_306209_length_136_cov_769.594595	0	69	2	10	69	0.1449275
NODE_306209_length_136_cov_769.594595	0	69	4	59	69	0.8550724
NODE_306222_length_136_cov_128.324324	39	119	6	80	80	1.0000000
NODE_306227_length_136_cov_90.783784	10	86	0	76	76	1.0000000
NODE_306227_length_136_cov_90.783784	59	136	0	77	77	1.0000000
NODE_306368_length_135_cov_2144.166667	0	73	24	1	73	0.0136986
NODE_306368_length_135_cov_2144.166667	0	73	28	1	73	0.0136986
NODE_306368_length_135_cov_2144.166667	0	73	32	1	73	0.0136986
NODE_306368_length_135_cov_2144.166667	0	73	42	1	73	0.0136986
NODE_306368_length_135_cov_2144.166667	0	73	49	1	73	0.0136986
NODE_306368_length_135_cov_2144.166667	0	73	51	1	73	0.0136986
NODE_306368_length_135_cov_2144.166667	0	73	65	1	73	0.0136986
NODE_306368_length_135_cov_2144.166667	0	73	71	1	73	0.0136986
NODE_306368_length_135_cov_2144.166667	0	73	87	1	73	0.0136986
NODE_306368_length_135_cov_2144.166667	0	73	103	2	73	0.0273973
NODE_306368_length_135_cov_2144.166667	0	73	121	1	73	0.0136986
NODE_306368_length_135_cov_2144.166667	0	73	125	1	73	0.0136986
NODE_306368_length_135_cov_2144.166667	0	73	131	1	73	0.0136986
NODE_306368_length_135_cov_2144.166667	0	73	135	1	73	0.0136986
NODE_306368_length_135_cov_2144.166667	0	73	136	1	73	0.0136986
NODE_306368_length_135_cov_2144.166667	0	73	144	1	73	0.0136986
NODE_306368_length_135_cov_2144.166667	0	73	148	2	73	0.0273973
NODE_306368_length_135_cov_2144.166667	0	73	160	2	73	0.0273973
NODE_306368_length_135_cov_2144.166667	0	73	166	1	73	0.0136986
NODE_306368_length_135_cov_2144.166667	0	73	170	2	73	0.0273973
NODE_306368_length_135_cov_2144.166667	0	73	172	1	73	0.0136986
NODE_306368_length_135_cov_2144.166667	0	73	178	1	73	0.0136986
NODE_306368_length_135_cov_2144.166667	0	73	180	2	73	0.0273973
NODE_306368_length_135_cov_2144.166667	0	73	192	3	73	0.0410959
NODE_306368_length_135_cov_2144.166667	0	73	196	42	73	0.5753425
NODE_306368_length_135_cov_2144.166667	46	126	52	2	80	0.0250000
NODE_306368_length_135_cov_2144.166667	46	126	57	1	80	0.0125000
NODE_306368_length_135_cov_2144.166667	46	126	60	1	80	0.0125000
NODE_306368_length_135_cov_2144.166667	46	126	64	1	80	0.0125000
NODE_306368_length_135_cov_2144.166667	46	126	80	1	80	0.0125000
NODE_306368_length_135_cov_2144.166667	46	126	88	1	80	0.0125000
NODE_306368_length_135_cov_2144.166667	46	126	92	1	80	0.0125000
NODE_306368_length_135_cov_2144.166667	46	126	111	1	80	0.0125000
NODE_306368_length_135_cov_2144.166667	46	126	122	1	80	0.0125000
NODE_306368_length_135_cov_2144.166667	46	126	132	1	80	0.0125000
NODE_306368_length_135_cov_2144.166667	46	126	139	1	80	0.0125000
NODE_306368_length_135_cov_2144.166667	46	126	143	1	80	0.0125000
NODE_306368_length_135_cov_2144.166667	46	126	148	1	80	0.0125000
NODE_306368_length_135_cov_2144.166667	46	126	155	1	80	0.0125000
NODE_306368_length_135_cov_2144.166667	46	126	170	1	80	0.0125000
NODE_306368_length_135_cov_2144.166667	46	126	172	1	80	0.0125000
NODE_306368_length_135_cov_2144.166667	46	126	182	1	80	0.0125000
NODE_306368_length_135_cov_2144.166667	46	126	190	5	80	0.0625000
NODE_306368_length_135_cov_2144.166667	46	126	194	10	80	0.1250000
NODE_306368_length_135_cov_2144.166667	46	126	195	11	80	0.1375000
NODE_306368_length_135_cov_2144.166667	46	126	196	36	80	0.4500000
NODE_306368_length_135_cov_2144.166667	83	135	13	1	52	0.0192308
NODE_306368_length_135_cov_2144.166667	83	135	18	1	52	0.0192308
NODE_306368_length_135_cov_2144.166667	83	135	28	1	52	0.0192308
NODE_306368_length_135_cov_2144.166667	83	135	32	1	52	0.0192308
NODE_306368_length_135_cov_2144.166667	83	135	34	4	52	0.0769231
NODE_306368_length_135_cov_2144.166667	83	135	42	1	52	0.0192308
NODE_306368_length_135_cov_2144.166667	83	135	52	2	52	0.0384615
NODE_306368_length_135_cov_2144.166667	83	135	57	1	52	0.0192308
NODE_306368_length_135_cov_2144.166667	83	135	60	1	52	0.0192308
NODE_306368_length_135_cov_2144.166667	83	135	64	1	52	0.0192308
NODE_306368_length_135_cov_2144.166667	83	135	80	1	52	0.0192308
NODE_306368_length_135_cov_2144.166667	83	135	88	1	52	0.0192308
NODE_306368_length_135_cov_2144.166667	83	135	92	1	52	0.0192308
NODE_306368_length_135_cov_2144.166667	83	135	111	1	52	0.0192308
NODE_306368_length_135_cov_2144.166667	83	135	122	1	52	0.0192308
NODE_306368_length_135_cov_2144.166667	83	135	132	1	52	0.0192308
NODE_306368_length_135_cov_2144.166667	83	135	139	1	52	0.0192308
NODE_306368_length_135_cov_2144.166667	83	135	143	1	52	0.0192308
NODE_306368_length_135_cov_2144.166667	83	135	148	1	52	0.0192308
NODE_306368_length_135_cov_2144.166667	83	135	155	1	52	0.0192308
NODE_306368_length_135_cov_2144.166667	83	135	170	1	52	0.0192308
NODE_306368_length_135_cov_2144.166667	83	135	172	1	52	0.0192308
NODE_306368_length_135_cov_2144.166667	83	135	182	1	52	0.0192308
NODE_306368_length_135_cov_2144.166667	83	135	190	5	52	0.0961538
NODE_306368_length_135_cov_2144.166667	83	135	194	10	52	0.1923077
NODE_306368_length_135_cov_2144.166667	83	135	195	10	52	0.1923077
NODE_306370_length_135_cov_630.194444	0	76	16	2	76	0.0263158
NODE_306370_length_135_cov_630.194444	0	76	18	1	76	0.0131579
NODE_306370_length_135_cov_630.194444	0	76	30	1	76	0.0131579
NODE_306370_length_135_cov_630.194444	0	76	41	7	76	0.0921053
NODE_306370_length_135_cov_630.194444	0	76	51	1	76	0.0131579
NODE_306370_length_135_cov_630.194444	0	76	55	1	76	0.0131579
NODE_306370_length_135_cov_630.194444	0	76	58	1	76	0.0131579
NODE_306370_length_135_cov_630.194444	0	76	62	1	76	0.0131579
NODE_306370_length_135_cov_630.194444	0	76	67	1	76	0.0131579
NODE_306370_length_135_cov_630.194444	0	76	69	1	76	0.0131579
NODE_306370_length_135_cov_630.194444	0	76	75	2	76	0.0263158
NODE_306370_length_135_cov_630.194444	0	76	81	3	76	0.0394737
NODE_306370_length_135_cov_630.194444	0	76	83	4	76	0.0526316
NODE_306370_length_135_cov_630.194444	0	76	87	3	76	0.0394737
NODE_306370_length_135_cov_630.194444	0	76	89	47	76	0.6184211
NODE_306371_length_135_cov_540.611111	0	76	6	1	76	0.0131579
NODE_306371_length_135_cov_540.611111	0	76	8	2	76	0.0263158
NODE_306371_length_135_cov_540.611111	0	76	9	1	76	0.0131579
NODE_306371_length_135_cov_540.611111	0	76	18	2	76	0.0263158
NODE_306371_length_135_cov_540.611111	0	76	20	1	76	0.0131579
NODE_306371_length_135_cov_540.611111	0	76	24	1	76	0.0131579
NODE_306371_length_135_cov_540.611111	0	76	26	1	76	0.0131579
NODE_306371_length_135_cov_540.611111	0	76	28	1	76	0.0131579
NODE_306371_length_135_cov_540.611111	0	76	30	3	76	0.0394737
NODE_306371_length_135_cov_540.611111	0	76	42	1	76	0.0131579
NODE_306371_length_135_cov_540.611111	0	76	44	1	76	0.0131579
NODE_306371_length_135_cov_540.611111	0	76	46	1	76	0.0131579
NODE_306371_length_135_cov_540.611111	0	76	48	1	76	0.0131579
NODE_306371_length_135_cov_540.611111	0	76	50	10	76	0.1315790
NODE_306371_length_135_cov_540.611111	0	76	52	49	76	0.6447368
NODE_306373_length_135_cov_257.416667	36	88	14	52	52	1.0000000
NODE_306374_length_135_cov_239.638889	97	135	6	2	38	0.0526316
NODE_306374_length_135_cov_239.638889	97	135	10	6	38	0.1578947
NODE_306374_length_135_cov_239.638889	97	135	18	1	38	0.0263158
NODE_306374_length_135_cov_239.638889	97	135	30	1	38	0.0263158
NODE_306374_length_135_cov_239.638889	97	135	34	1	38	0.0263158
NODE_306374_length_135_cov_239.638889	97	135	36	4	38	0.1052632
NODE_306374_length_135_cov_239.638889	97	135	40	2	38	0.0526316
NODE_306374_length_135_cov_239.638889	97	135	42	1	38	0.0263158
NODE_306374_length_135_cov_239.638889	97	135	54	2	38	0.0526316
NODE_306374_length_135_cov_239.638889	97	135	58	2	38	0.0526316
NODE_306374_length_135_cov_239.638889	97	135	66	1	38	0.0263158
NODE_306374_length_135_cov_239.638889	97	135	72	7	38	0.1842105
NODE_306374_length_135_cov_239.638889	97	135	74	3	38	0.0789474
NODE_306374_length_135_cov_239.638889	97	135	76	5	38	0.1315790
NODE_306400_length_135_cov_35.055556	8	88	2	3	80	0.0375000
NODE_306400_length_135_cov_35.055556	8	88	8	4	80	0.0500000
NODE_306400_length_135_cov_35.055556	8	88	19	2	80	0.0250000
NODE_306400_length_135_cov_35.055556	8	88	21	6	80	0.0750000
NODE_306400_length_135_cov_35.055556	8	88	25	9	80	0.1125000
NODE_306400_length_135_cov_35.055556	8	88	28	56	80	0.7000000
NODE_306400_length_135_cov_35.055556	61	125	28	64	64	1.0000000
NODE_306400_length_135_cov_35.055556	61	125	28	64	64	1.0000000
NODE_306402_length_135_cov_31.805556	0	76	0	24	76	0.3157895
NODE_306402_length_135_cov_31.805556	0	76	2	52	76	0.6842105
NODE_306658_length_133_cov_140.411765	8	43	9	2	35	0.0571429
NODE_306658_length_133_cov_140.411765	8	43	11	3	35	0.0857143
NODE_306658_length_133_cov_140.411765	8	43	19	1	35	0.0285714
NODE_306658_length_133_cov_140.411765	8	43	23	5	35	0.1428571
NODE_306658_length_133_cov_140.411765	8	43	25	7	35	0.2000000
NODE_306658_length_133_cov_140.411765	8	43	29	17	35	0.4857143
NODE_306658_length_133_cov_140.411765	53	88	29	35	35	1.0000000
NODE_306658_length_133_cov_140.411765	98	133	3	2	35	0.0571429
NODE_306658_length_133_cov_140.411765	98	133	5	1	35	0.0285714
NODE_306658_length_133_cov_140.411765	98	133	9	2	35	0.0571429
NODE_306658_length_133_cov_140.411765	98	133	11	5	35	0.1428571
NODE_306658_length_133_cov_140.411765	98	133	13	2	35	0.0571429
NODE_306658_length_133_cov_140.411765	98	133	18	1	35	0.0285714
NODE_306658_length_133_cov_140.411765	98	133	19	3	35	0.0857143
NODE_306658_length_133_cov_140.411765	98	133	21	3	35	0.0857143
NODE_306658_length_133_cov_140.411765	98	133	23	4	35	0.1142857
NODE_306658_length_133_cov_140.411765	98	133	25	1	35	0.0285714
NODE_306658_length_133_cov_140.411765	98	133	29	11	35	0.3142857
NODE_306661_length_133_cov_109.441176	63	129	6	4	66	0.0606061
NODE_306661_length_133_cov_109.441176	63	129	8	7	66	0.1060606
NODE_306661_length_133_cov_109.441176	63	129	10	5	66	0.0757576
NODE_306661_length_133_cov_109.441176	63	129	12	50	66	0.7575758
NODE_306812_length_132_cov_114.151515	2	44	0	1	42	0.0238095
NODE_306812_length_132_cov_114.151515	2	44	2	11	42	0.2619048
NODE_306812_length_132_cov_114.151515	2	44	4	2	42	0.0476190
NODE_306812_length_132_cov_114.151515	2	44	11	1	42	0.0238095
NODE_306812_length_132_cov_114.151515	2	44	12	27	42	0.6428571
NODE_306812_length_132_cov_114.151515	4	44	2	10	40	0.2500000
NODE_306812_length_132_cov_114.151515	4	44	4	2	40	0.0500000
NODE_306812_length_132_cov_114.151515	4	44	11	1	40	0.0250000
NODE_306812_length_132_cov_114.151515	4	44	12	27	40	0.6750000
NODE_306812_length_132_cov_114.151515	17	83	12	66	66	1.0000000
NODE_306812_length_132_cov_114.151515	17	88	12	71	71	1.0000000
NODE_306824_length_132_cov_61.636364	3	76	0	2	73	0.0273973
NODE_306824_length_132_cov_61.636364	3	76	2	1	73	0.0136986
NODE_306824_length_132_cov_61.636364	3	76	4	16	73	0.2191781
NODE_306824_length_132_cov_61.636364	3	76	8	3	73	0.0410959
NODE_306824_length_132_cov_61.636364	3	76	10	51	73	0.6986302
NODE_306824_length_132_cov_61.636364	49	130	6	8	81	0.0987654
NODE_306824_length_132_cov_61.636364	49	130	8	14	81	0.1728395
NODE_306824_length_132_cov_61.636364	49	130	10	59	81	0.7283950
NODE_306824_length_132_cov_61.636364	103	125	6	3	22	0.1363636
NODE_306824_length_132_cov_61.636364	103	125	8	14	22	0.6363636
NODE_306824_length_132_cov_61.636364	103	125	10	5	22	0.2272727
NODE_306834_length_132_cov_33.393939	2	83	0	81	81	1.0000000
NODE_306834_length_132_cov_33.393939	7	29	0	22	22	1.0000000
NODE_306834_length_132_cov_33.393939	56	129	0	73	73	1.0000000
NODE_306965_length_131_cov_810.000000	0	60	10	1	60	0.0166667
NODE_306965_length_131_cov_810.000000	0	60	14	1	60	0.0166667
NODE_306965_length_131_cov_810.000000	0	60	26	2	60	0.0333333
NODE_306965_length_131_cov_810.000000	0	60	42	1	60	0.0166667
NODE_306965_length_131_cov_810.000000	0	60	46	1	60	0.0166667
NODE_306965_length_131_cov_810.000000	0	60	55	3	60	0.0500000
NODE_306965_length_131_cov_810.000000	0	60	57	1	60	0.0166667
NODE_306965_length_131_cov_810.000000	0	60	61	1	60	0.0166667
NODE_306965_length_131_cov_810.000000	0	60	65	1	60	0.0166667
NODE_306965_length_131_cov_810.000000	0	60	69	2	60	0.0333333
NODE_306965_length_131_cov_810.000000	0	60	73	2	60	0.0333333
NODE_306965_length_131_cov_810.000000	0	60	81	1	60	0.0166667
NODE_306965_length_131_cov_810.000000	0	60	95	1	60	0.0166667
NODE_306965_length_131_cov_810.000000	0	60	97	1	60	0.0166667
NODE_306965_length_131_cov_810.000000	0	60	104	2	60	0.0333333
NODE_306965_length_131_cov_810.000000	0	60	106	2	60	0.0333333
NODE_306965_length_131_cov_810.000000	0	60	114	1	60	0.0166667
NODE_306965_length_131_cov_810.000000	0	60	118	1	60	0.0166667
NODE_306965_length_131_cov_810.000000	0	60	120	2	60	0.0333333
NODE_306965_length_131_cov_810.000000	0	60	122	1	60	0.0166667
NODE_306965_length_131_cov_810.000000	0	60	134	32	60	0.5333334
NODE_306965_length_131_cov_810.000000	33	97	134	64	64	1.0000000
NODE_306965_length_131_cov_810.000000	33	97	134	64	64	1.0000000
NODE_306965_length_131_cov_810.000000	33	97	134	64	64	1.0000000
NODE_306985_length_131_cov_149.187500	25	105	64	2	80	0.0250000
NODE_306985_length_131_cov_149.187500	25	105	65	2	80	0.0250000
NODE_306985_length_131_cov_149.187500	25	105	67	29	80	0.3625000
NODE_306985_length_131_cov_149.187500	25	105	68	47	80	0.5875000
NODE_306985_length_131_cov_149.187500	78	131	9	2	53	0.0377358
NODE_306985_length_131_cov_149.187500	78	131	10	1	53	0.0188679
NODE_306985_length_131_cov_149.187500	78	131	16	2	53	0.0377358
NODE_306985_length_131_cov_149.187500	78	131	20	1	53	0.0188679
NODE_306985_length_131_cov_149.187500	78	131	22	1	53	0.0188679
NODE_306985_length_131_cov_149.187500	78	131	24	1	53	0.0188679
NODE_306985_length_131_cov_149.187500	78	131	26	1	53	0.0188679
NODE_306985_length_131_cov_149.187500	78	131	28	1	53	0.0188679
NODE_306985_length_131_cov_149.187500	78	131	30	1	53	0.0188679
NODE_306985_length_131_cov_149.187500	78	131	36	1	53	0.0188679
NODE_306985_length_131_cov_149.187500	78	131	38	1	53	0.0188679
NODE_306985_length_131_cov_149.187500	78	131	50	1	53	0.0188679
NODE_306985_length_131_cov_149.187500	78	131	56	4	53	0.0754717
NODE_306985_length_131_cov_149.187500	78	131	58	1	53	0.0188679
NODE_306985_length_131_cov_149.187500	78	131	61	1	53	0.0188679
NODE_306985_length_131_cov_149.187500	78	131	63	4	53	0.0754717
NODE_306985_length_131_cov_149.187500	78	131	65	4	53	0.0754717
NODE_306985_length_131_cov_149.187500	78	131	67	25	53	0.4716981
NODE_307121_length_130_cov_319.806452	54	126	2	2	72	0.0277778
NODE_307121_length_130_cov_319.806452	54	126	4	1	72	0.0138889
NODE_307121_length_130_cov_319.806452	54	126	6	7	72	0.0972222
NODE_307121_length_130_cov_319.806452	54	126	11	3	72	0.0416667
NODE_307121_length_130_cov_319.806452	54	126	12	2	72	0.0277778
NODE_307121_length_130_cov_319.806452	54	126	14	2	72	0.0277778
NODE_307121_length_130_cov_319.806452	54	126	16	2	72	0.0277778
NODE_307121_length_130_cov_319.806452	54	126	18	1	72	0.0138889
NODE_307121_length_130_cov_319.806452	54	126	20	52	72	0.7222222
NODE_307132_length_130_cov_153.516129	82	113	0	31	31	1.0000000
NODE_307140_length_130_cov_79.064516	0	53	4	2	53	0.0377358
NODE_307140_length_130_cov_79.064516	0	53	6	3	53	0.0566038
NODE_307140_length_130_cov_79.064516	0	53	10	1	53	0.0188679
NODE_307140_length_130_cov_79.064516	0	53	12	1	53	0.0188679
NODE_307140_length_130_cov_79.064516	0	53	16	3	53	0.0566038
NODE_307140_length_130_cov_79.064516	0	53	20	2	53	0.0377358
NODE_307140_length_130_cov_79.064516	0	53	22	1	53	0.0188679
NODE_307140_length_130_cov_79.064516	0	53	24	2	53	0.0377358
NODE_307140_length_130_cov_79.064516	0	53	26	1	53	0.0188679
NODE_307140_length_130_cov_79.064516	0	53	31	6	53	0.1132075
NODE_307140_length_130_cov_79.064516	0	53	33	2	53	0.0377358
NODE_307140_length_130_cov_79.064516	0	53	35	3	53	0.0566038
NODE_307140_length_130_cov_79.064516	0	53	36	1	53	0.0188679
NODE_307140_length_130_cov_79.064516	0	53	40	25	53	0.4716981
NODE_307140_length_130_cov_79.064516	26	56	35	1	30	0.0333333
NODE_307140_length_130_cov_79.064516	26	56	36	1	30	0.0333333
NODE_307140_length_130_cov_79.064516	26	56	40	28	30	0.9333333
NODE_307270_length_129_cov_1851.133333	0	45	0	4	45	0.0888889
NODE_307270_length_129_cov_1851.133333	0	45	4	3	45	0.0666667
NODE_307270_length_129_cov_1851.133333	0	45	8	2	45	0.0444444
NODE_307270_length_129_cov_1851.133333	0	45	12	3	45	0.0666667
NODE_307270_length_129_cov_1851.133333	0	45	20	3	45	0.0666667
NODE_307270_length_129_cov_1851.133333	0	45	24	2	45	0.0444444
NODE_307270_length_129_cov_1851.133333	0	45	26	2	45	0.0444444
NODE_307270_length_129_cov_1851.133333	0	45	28	5	45	0.1111111
NODE_307270_length_129_cov_1851.133333	0	45	30	21	45	0.4666667
NODE_307270_length_129_cov_1851.133333	18	98	26	1	80	0.0125000
NODE_307270_length_129_cov_1851.133333	18	98	28	5	80	0.0625000
NODE_307270_length_129_cov_1851.133333	18	98	30	74	80	0.9250000
NODE_307285_length_129_cov_186.500000	0	78	0	5	78	0.0641026
NODE_307285_length_129_cov_186.500000	0	78	2	2	78	0.0256410
NODE_307285_length_129_cov_186.500000	0	78	4	1	78	0.0128205
NODE_307285_length_129_cov_186.500000	0	78	8	5	78	0.0641026
NODE_307285_length_129_cov_186.500000	0	78	10	5	78	0.0641026
NODE_307285_length_129_cov_186.500000	0	78	12	60	78	0.7692308
NODE_307285_length_129_cov_186.500000	53	129	0	1	76	0.0131579
NODE_307285_length_129_cov_186.500000	53	129	2	2	76	0.0263158
NODE_307285_length_129_cov_186.500000	53	129	4	6	76	0.0789474
NODE_307285_length_129_cov_186.500000	53	129	8	3	76	0.0394737
NODE_307285_length_129_cov_186.500000	53	129	12	64	76	0.8421053
NODE_307287_length_129_cov_165.466667	36	111	20	7	75	0.0933333
NODE_307287_length_129_cov_165.466667	36	111	22	68	75	0.9066667
NODE_307287_length_129_cov_165.466667	84	113	18	2	29	0.0689655
NODE_307287_length_129_cov_165.466667	84	113	20	7	29	0.2413793
NODE_307287_length_129_cov_165.466667	84	113	22	20	29	0.6896552
NODE_307292_length_129_cov_90.366667	0	48	0	16	48	0.3333333
NODE_307292_length_129_cov_90.366667	0	48	2	11	48	0.2291667
NODE_307292_length_129_cov_90.366667	0	48	6	21	48	0.4375000
NODE_307292_length_129_cov_90.366667	0	48	0	16	48	0.3333333
NODE_307292_length_129_cov_90.366667	0	48	2	11	48	0.2291667
NODE_307292_length_129_cov_90.366667	0	48	6	21	48	0.4375000
NODE_307292_length_129_cov_90.366667	0	48	0	16	48	0.3333333
NODE_307292_length_129_cov_90.366667	0	48	2	11	48	0.2291667
NODE_307292_length_129_cov_90.366667	0	48	6	21	48	0.4375000
NODE_307292_length_129_cov_90.366667	21	101	2	6	80	0.0750000
NODE_307292_length_129_cov_90.366667	21	101	6	74	80	0.9250000
NODE_307442_length_128_cov_2621.517241	3	83	28	1	80	0.0125000
NODE_307442_length_128_cov_2621.517241	3	83	34	1	80	0.0125000
NODE_307442_length_128_cov_2621.517241	3	83	36	1	80	0.0125000
NODE_307442_length_128_cov_2621.517241	3	83	50	1	80	0.0125000
NODE_307442_length_128_cov_2621.517241	3	83	52	1	80	0.0125000
NODE_307442_length_128_cov_2621.517241	3	83	58	1	80	0.0125000
NODE_307442_length_128_cov_2621.517241	3	83	82	1	80	0.0125000
NODE_307442_length_128_cov_2621.517241	3	83	88	1	80	0.0125000
NODE_307442_length_128_cov_2621.517241	3	83	100	1	80	0.0125000
NODE_307442_length_128_cov_2621.517241	3	83	110	1	80	0.0125000
NODE_307442_length_128_cov_2621.517241	3	83	114	2	80	0.0250000
NODE_307442_length_128_cov_2621.517241	3	83	116	6	80	0.0750000
NODE_307442_length_128_cov_2621.517241	3	83	118	62	80	0.7750000
NODE_307442_length_128_cov_2621.517241	8	30	58	1	22	0.0454545
NODE_307442_length_128_cov_2621.517241	8	30	82	1	22	0.0454545
NODE_307442_length_128_cov_2621.517241	8	30	88	1	22	0.0454545
NODE_307442_length_128_cov_2621.517241	8	30	100	1	22	0.0454545
NODE_307442_length_128_cov_2621.517241	8	30	110	1	22	0.0454545
NODE_307442_length_128_cov_2621.517241	8	30	114	2	22	0.0909091
NODE_307442_length_128_cov_2621.517241	8	30	116	6	22	0.2727273
NODE_307442_length_128_cov_2621.517241	8	30	118	9	22	0.4090909
NODE_307442_length_128_cov_2621.517241	56	128	12	1	72	0.0138889
NODE_307442_length_128_cov_2621.517241	56	128	16	2	72	0.0277778
NODE_307442_length_128_cov_2621.517241	56	128	18	1	72	0.0138889
NODE_307442_length_128_cov_2621.517241	56	128	26	5	72	0.0694444
NODE_307442_length_128_cov_2621.517241	56	128	28	1	72	0.0138889
NODE_307442_length_128_cov_2621.517241	56	128	32	2	72	0.0277778
NODE_307442_length_128_cov_2621.517241	56	128	36	1	72	0.0138889
NODE_307442_length_128_cov_2621.517241	56	128	59	1	72	0.0138889
NODE_307442_length_128_cov_2621.517241	56	128	68	2	72	0.0277778
NODE_307442_length_128_cov_2621.517241	56	128	74	1	72	0.0138889
NODE_307442_length_128_cov_2621.517241	56	128	82	2	72	0.0277778
NODE_307442_length_128_cov_2621.517241	56	128	90	1	72	0.0138889
NODE_307442_length_128_cov_2621.517241	56	128	100	1	72	0.0138889
NODE_307442_length_128_cov_2621.517241	56	128	112	2	72	0.0277778
NODE_307442_length_128_cov_2621.517241	56	128	116	3	72	0.0416667
NODE_307442_length_128_cov_2621.517241	56	128	118	46	72	0.6388889
NODE_307443_length_128_cov_1604.275862	58	127	4	3	69	0.0434783
NODE_307443_length_128_cov_1604.275862	58	127	6	9	69	0.1304348
NODE_307443_length_128_cov_1604.275862	58	127	10	9	69	0.1304348
NODE_307443_length_128_cov_1604.275862	58	127	12	1	69	0.0144928
NODE_307443_length_128_cov_1604.275862	58	127	16	47	69	0.6811594
NODE_307458_length_128_cov_79.034483	43	123	16	80	80	1.0000000
NODE_307464_length_128_cov_61.793103	5	85	0	14	80	0.1750000
NODE_307464_length_128_cov_61.793103	5	85	6	66	80	0.8250000
NODE_307549_length_127_cov_1879.785714	21	101	112	1	80	0.0125000
NODE_307549_length_127_cov_1879.785714	21	101	116	1	80	0.0125000
NODE_307549_length_127_cov_1879.785714	21	101	128	1	80	0.0125000
NODE_307549_length_127_cov_1879.785714	21	101	129	1	80	0.0125000
NODE_307549_length_127_cov_1879.785714	21	101	130	76	80	0.9500000
NODE_307549_length_127_cov_1879.785714	74	127	7	1	53	0.0188679
NODE_307549_length_127_cov_1879.785714	74	127	8	1	53	0.0188679
NODE_307549_length_127_cov_1879.785714	74	127	15	1	53	0.0188679
NODE_307549_length_127_cov_1879.785714	74	127	21	1	53	0.0188679
NODE_307549_length_127_cov_1879.785714	74	127	25	1	53	0.0188679
NODE_307549_length_127_cov_1879.785714	74	127	28	2	53	0.0377358
NODE_307549_length_127_cov_1879.785714	74	127	34	1	53	0.0188679
NODE_307549_length_127_cov_1879.785714	74	127	36	1	53	0.0188679
NODE_307549_length_127_cov_1879.785714	74	127	46	2	53	0.0377358
NODE_307549_length_127_cov_1879.785714	74	127	58	1	53	0.0188679
NODE_307549_length_127_cov_1879.785714	74	127	60	1	53	0.0188679
NODE_307549_length_127_cov_1879.785714	74	127	75	1	53	0.0188679
NODE_307549_length_127_cov_1879.785714	74	127	85	1	53	0.0188679
NODE_307549_length_127_cov_1879.785714	74	127	88	1	53	0.0188679
NODE_307549_length_127_cov_1879.785714	74	127	90	1	53	0.0188679
NODE_307549_length_127_cov_1879.785714	74	127	102	1	53	0.0188679
NODE_307549_length_127_cov_1879.785714	74	127	104	1	53	0.0188679
NODE_307549_length_127_cov_1879.785714	74	127	114	2	53	0.0377358
NODE_307549_length_127_cov_1879.785714	74	127	120	2	53	0.0377358
NODE_307549_length_127_cov_1879.785714	74	127	121	1	53	0.0188679
NODE_307549_length_127_cov_1879.785714	74	127	129	2	53	0.0377358
NODE_307549_length_127_cov_1879.785714	74	127	130	27	53	0.5094340
NODE_307583_length_127_cov_66.142857	38	118	0	80	80	1.0000000
NODE_307583_length_127_cov_66.142857	47	118	0	71	71	1.0000000
NODE_307590_length_127_cov_38.285714	12	86	2	74	74	1.0000000
NODE_307596_length_127_cov_30.607143	21	93	0	72	72	1.0000000
NODE_307662_length_126_cov_936.777778	24	96	14	72	72	1.0000000
NODE_307675_length_126_cov_147.185185	2	66	7	5	64	0.0781250
NODE_307675_length_126_cov_147.185185	2	66	14	1	64	0.0156250
NODE_307675_length_126_cov_147.185185	2	66	15	17	64	0.2656250
NODE_307675_length_126_cov_147.185185	2	66	16	41	64	0.6406250
NODE_307675_length_126_cov_147.185185	2	66	7	5	64	0.0781250
NODE_307675_length_126_cov_147.185185	2	66	14	1	64	0.0156250
NODE_307675_length_126_cov_147.185185	2	66	15	17	64	0.2656250
NODE_307675_length_126_cov_147.185185	2	66	16	41	64	0.6406250
NODE_307675_length_126_cov_147.185185	2	66	7	5	64	0.0781250
NODE_307675_length_126_cov_147.185185	2	66	14	1	64	0.0156250
NODE_307675_length_126_cov_147.185185	2	66	15	17	64	0.2656250
NODE_307675_length_126_cov_147.185185	2	66	16	41	64	0.6406250
NODE_307675_length_126_cov_147.185185	39	99	15	8	60	0.1333333
NODE_307675_length_126_cov_147.185185	39	99	16	52	60	0.8666667
NODE_307675_length_126_cov_147.185185	55	99	15	8	44	0.1818182
NODE_307675_length_126_cov_147.185185	55	99	16	36	44	0.8181818
NODE_307684_length_126_cov_82.518519	44	75	0	31	31	1.0000000
NODE_307793_length_125_cov_656.807692	19	99	70	2	80	0.0250000
NODE_307793_length_125_cov_656.807692	19	99	73	1	80	0.0125000
NODE_307793_length_125_cov_656.807692	19	99	80	77	80	0.9625000
NODE_307806_length_125_cov_143.615385	52	125	0	5	73	0.0684932
NODE_307806_length_125_cov_143.615385	52	125	2	7	73	0.0958904
NODE_307806_length_125_cov_143.615385	52	125	4	9	73	0.1232877
NODE_307806_length_125_cov_143.615385	52	125	6	52	73	0.7123288
NODE_307810_length_125_cov_131.923077	3	52	8	4	49	0.0816327
NODE_307810_length_125_cov_131.923077	3	52	12	1	49	0.0204082
NODE_307810_length_125_cov_131.923077	3	52	14	1	49	0.0204082
NODE_307810_length_125_cov_131.923077	3	52	16	5	49	0.1020408
NODE_307810_length_125_cov_131.923077	3	52	20	1	49	0.0204082
NODE_307810_length_125_cov_131.923077	3	52	26	4	49	0.0816327
NODE_307810_length_125_cov_131.923077	3	52	28	1	49	0.0204082
NODE_307810_length_125_cov_131.923077	3	52	34	32	49	0.6530612
NODE_307810_length_125_cov_131.923077	25	89	34	64	64	1.0000000
NODE_307810_length_125_cov_131.923077	25	89	34	64	64	1.0000000
NODE_307816_length_125_cov_102.500000	0	56	0	2	56	0.0357143
NODE_307816_length_125_cov_102.500000	0	56	4	10	56	0.1785714
NODE_307816_length_125_cov_102.500000	0	56	12	2	56	0.0357143
NODE_307816_length_125_cov_102.500000	0	56	16	1	56	0.0178571
NODE_307816_length_125_cov_102.500000	0	56	22	41	56	0.7321429
NODE_307816_length_125_cov_102.500000	7	56	4	5	49	0.1020408
NODE_307816_length_125_cov_102.500000	7	56	12	2	49	0.0408163
NODE_307816_length_125_cov_102.500000	7	56	16	1	49	0.0204082
NODE_307816_length_125_cov_102.500000	7	56	22	41	49	0.8367347
NODE_307816_length_125_cov_102.500000	29	114	12	7	85	0.0823529
NODE_307816_length_125_cov_102.500000	29	114	16	4	85	0.0470588
NODE_307816_length_125_cov_102.500000	29	114	22	74	85	0.8705882
NODE_307816_length_125_cov_102.500000	29	114	12	7	85	0.0823529
NODE_307816_length_125_cov_102.500000	29	114	16	4	85	0.0470588
NODE_307816_length_125_cov_102.500000	29	114	22	74	85	0.8705882
NODE_307816_length_125_cov_102.500000	29	114	12	7	85	0.0823529
NODE_307816_length_125_cov_102.500000	29	114	16	4	85	0.0470588
NODE_307816_length_125_cov_102.500000	29	114	22	74	85	0.8705882
NODE_307839_length_125_cov_28.115385	17	90	20	1	73	0.0136986
NODE_307839_length_125_cov_28.115385	17	90	24	2	73	0.0273973
NODE_307839_length_125_cov_28.115385	17	90	26	3	73	0.0410959
NODE_307839_length_125_cov_28.115385	17	90	30	67	73	0.9178082
NODE_307839_length_125_cov_28.115385	57	98	30	41	41	1.0000000
NODE_307906_length_124_cov_945.680000	0	73	4	3	73	0.0410959
NODE_307906_length_124_cov_945.680000	0	73	8	1	73	0.0136986
NODE_307906_length_124_cov_945.680000	0	73	12	1	73	0.0136986
NODE_307906_length_124_cov_945.680000	0	73	14	5	73	0.0684932
NODE_307906_length_124_cov_945.680000	0	73	16	1	73	0.0136986
NODE_307906_length_124_cov_945.680000	0	73	22	2	73	0.0273973
NODE_307906_length_124_cov_945.680000	0	73	26	4	73	0.0547945
NODE_307906_length_124_cov_945.680000	0	73	28	3	73	0.0410959
NODE_307906_length_124_cov_945.680000	0	73	30	53	73	0.7260274
NODE_307906_length_124_cov_945.680000	53	124	2	1	71	0.0140845
NODE_307906_length_124_cov_945.680000	53	124	4	1	71	0.0140845
NODE_307906_length_124_cov_945.680000	53	124	6	2	71	0.0281690
NODE_307906_length_124_cov_945.680000	53	124	8	1	71	0.0140845
NODE_307906_length_124_cov_945.680000	53	124	10	1	71	0.0140845
NODE_307906_length_124_cov_945.680000	53	124	18	3	71	0.0422535
NODE_307906_length_124_cov_945.680000	53	124	20	1	71	0.0140845
NODE_307906_length_124_cov_945.680000	53	124	22	1	71	0.0140845
NODE_307906_length_124_cov_945.680000	53	124	24	1	71	0.0140845
NODE_307906_length_124_cov_945.680000	53	124	26	4	71	0.0563380
NODE_307906_length_124_cov_945.680000	53	124	28	2	71	0.0281690
NODE_307906_length_124_cov_945.680000	53	124	30	53	71	0.7464789
NODE_308023_length_123_cov_1186.083333	0	76	2	6	76	0.0789474
NODE_308023_length_123_cov_1186.083333	0	76	12	2	76	0.0263158
NODE_308023_length_123_cov_1186.083333	0	76	14	2	76	0.0263158
NODE_308023_length_123_cov_1186.083333	0	76	32	3	76	0.0394737
NODE_308023_length_123_cov_1186.083333	0	76	39	1	76	0.0131579
NODE_308023_length_123_cov_1186.083333	0	76	40	62	76	0.8157895
NODE_308023_length_123_cov_1186.083333	0	76	2	6	76	0.0789474
NODE_308023_length_123_cov_1186.083333	0	76	12	2	76	0.0263158
NODE_308023_length_123_cov_1186.083333	0	76	14	2	76	0.0263158
NODE_308023_length_123_cov_1186.083333	0	76	32	3	76	0.0394737
NODE_308023_length_123_cov_1186.083333	0	76	39	1	76	0.0131579
NODE_308023_length_123_cov_1186.083333	0	76	40	62	76	0.8157895
NODE_308023_length_123_cov_1186.083333	0	76	2	6	76	0.0789474
NODE_308023_length_123_cov_1186.083333	0	76	12	2	76	0.0263158
NODE_308023_length_123_cov_1186.083333	0	76	14	2	76	0.0263158
NODE_308023_length_123_cov_1186.083333	0	76	32	3	76	0.0394737
NODE_308023_length_123_cov_1186.083333	0	76	39	1	76	0.0131579
NODE_308023_length_123_cov_1186.083333	0	76	40	62	76	0.8157895
NODE_308023_length_123_cov_1186.083333	0	76	2	6	76	0.0789474
NODE_308023_length_123_cov_1186.083333	0	76	12	2	76	0.0263158
NODE_308023_length_123_cov_1186.083333	0	76	14	2	76	0.0263158
NODE_308023_length_123_cov_1186.083333	0	76	32	3	76	0.0394737
NODE_308023_length_123_cov_1186.083333	0	76	39	1	76	0.0131579
NODE_308023_length_123_cov_1186.083333	0	76	40	62	76	0.8157895
NODE_308023_length_123_cov_1186.083333	49	123	16	1	74	0.0135135
NODE_308023_length_123_cov_1186.083333	49	123	30	1	74	0.0135135
NODE_308023_length_123_cov_1186.083333	49	123	32	1	74	0.0135135
NODE_308023_length_123_cov_1186.083333	49	123	37	1	74	0.0135135
NODE_308023_length_123_cov_1186.083333	49	123	39	8	74	0.1081081
NODE_308023_length_123_cov_1186.083333	49	123	40	62	74	0.8378378
NODE_308023_length_123_cov_1186.083333	49	123	16	1	74	0.0135135
NODE_308023_length_123_cov_1186.083333	49	123	30	1	74	0.0135135
NODE_308023_length_123_cov_1186.083333	49	123	32	1	74	0.0135135
NODE_308023_length_123_cov_1186.083333	49	123	37	1	74	0.0135135
NODE_308023_length_123_cov_1186.083333	49	123	39	8	74	0.1081081
NODE_308023_length_123_cov_1186.083333	49	123	40	62	74	0.8378378
NODE_308023_length_123_cov_1186.083333	49	123	16	1	74	0.0135135
NODE_308023_length_123_cov_1186.083333	49	123	30	1	74	0.0135135
NODE_308023_length_123_cov_1186.083333	49	123	32	1	74	0.0135135
NODE_308023_length_123_cov_1186.083333	49	123	37	1	74	0.0135135
NODE_308023_length_123_cov_1186.083333	49	123	39	8	74	0.1081081
NODE_308023_length_123_cov_1186.083333	49	123	40	62	74	0.8378378
NODE_308024_length_123_cov_963.500000	19	88	10	69	69	1.0000000
NODE_308037_length_123_cov_181.291667	0	47	0	13	47	0.2765957
NODE_308037_length_123_cov_181.291667	0	47	2	34	47	0.7234042
NODE_308037_length_123_cov_181.291667	24	100	2	76	76	1.0000000
NODE_308057_length_123_cov_55.375000	52	123	4	4	71	0.0563380
NODE_308057_length_123_cov_55.375000	52	123	6	2	71	0.0281690
NODE_308057_length_123_cov_55.375000	52	123	10	2	71	0.0281690
NODE_308057_length_123_cov_55.375000	52	123	11	2	71	0.0281690
NODE_308057_length_123_cov_55.375000	52	123	13	13	71	0.1830986
NODE_308057_length_123_cov_55.375000	52	123	14	48	71	0.6760563
NODE_308057_length_123_cov_55.375000	52	123	4	4	71	0.0563380
NODE_308057_length_123_cov_55.375000	52	123	6	2	71	0.0281690
NODE_308057_length_123_cov_55.375000	52	123	10	2	71	0.0281690
NODE_308057_length_123_cov_55.375000	52	123	11	2	71	0.0281690
NODE_308057_length_123_cov_55.375000	52	123	13	13	71	0.1830986
NODE_308057_length_123_cov_55.375000	52	123	14	48	71	0.6760563
NODE_308057_length_123_cov_55.375000	61	123	4	4	62	0.0645161
NODE_308057_length_123_cov_55.375000	61	123	6	2	62	0.0322581
NODE_308057_length_123_cov_55.375000	61	123	10	2	62	0.0322581
NODE_308057_length_123_cov_55.375000	61	123	11	2	62	0.0322581
NODE_308057_length_123_cov_55.375000	61	123	13	13	62	0.2096774
NODE_308057_length_123_cov_55.375000	61	123	14	39	62	0.6290323
NODE_308068_length_123_cov_40.958333	9	89	16	7	80	0.0875000
NODE_308068_length_123_cov_40.958333	9	89	24	1	80	0.0125000
NODE_308068_length_123_cov_40.958333	9	89	27	54	80	0.6750000
NODE_308068_length_123_cov_40.958333	9	89	28	18	80	0.2250000
NODE_308068_length_123_cov_40.958333	9	89	16	7	80	0.0875000
NODE_308068_length_123_cov_40.958333	9	89	24	1	80	0.0125000
NODE_308068_length_123_cov_40.958333	9	89	27	54	80	0.6750000
NODE_308068_length_123_cov_40.958333	9	89	28	18	80	0.2250000
NODE_308068_length_123_cov_40.958333	9	89	16	7	80	0.0875000
NODE_308068_length_123_cov_40.958333	9	89	24	1	80	0.0125000
NODE_308068_length_123_cov_40.958333	9	89	27	54	80	0.6750000
NODE_308068_length_123_cov_40.958333	9	89	28	18	80	0.2250000
NODE_308068_length_123_cov_40.958333	9	89	16	7	80	0.0875000
NODE_308068_length_123_cov_40.958333	9	89	24	1	80	0.0125000
NODE_308068_length_123_cov_40.958333	9	89	27	54	80	0.6750000
NODE_308068_length_123_cov_40.958333	9	89	28	18	80	0.2250000
NODE_308068_length_123_cov_40.958333	9	89	16	7	80	0.0875000
NODE_308068_length_123_cov_40.958333	9	89	24	1	80	0.0125000
NODE_308068_length_123_cov_40.958333	9	89	27	54	80	0.6750000
NODE_308068_length_123_cov_40.958333	9	89	28	18	80	0.2250000
NODE_308068_length_123_cov_40.958333	9	80	16	7	71	0.0985916
NODE_308068_length_123_cov_40.958333	9	80	24	1	71	0.0140845
NODE_308068_length_123_cov_40.958333	9	80	27	45	71	0.6338028
NODE_308068_length_123_cov_40.958333	9	80	28	18	71	0.2535211
NODE_308180_length_122_cov_111.043478	8	88	2	7	80	0.0875000
NODE_308180_length_122_cov_111.043478	8	88	4	73	80	0.9125000
NODE_308180_length_122_cov_111.043478	8	88	2	7	80	0.0875000
NODE_308180_length_122_cov_111.043478	8	88	4	73	80	0.9125000
NODE_308184_length_122_cov_67.565217	0	50	0	1	50	0.0200000
NODE_308184_length_122_cov_67.565217	0	50	2	49	50	0.9800000
NODE_308184_length_122_cov_67.565217	0	50	0	1	50	0.0200000
NODE_308184_length_122_cov_67.565217	0	50	2	49	50	0.9800000
NODE_308184_length_122_cov_67.565217	23	103	2	80	80	1.0000000
NODE_308184_length_122_cov_67.565217	23	103	2	80	80	1.0000000
NODE_308184_length_122_cov_67.565217	23	103	2	80	80	1.0000000
NODE_308184_length_122_cov_67.565217	23	103	2	80	80	1.0000000
NODE_308184_length_122_cov_67.565217	23	103	2	80	80	1.0000000
NODE_308184_length_122_cov_67.565217	23	94	2	71	71	1.0000000
NODE_308188_length_122_cov_58.826087	28	99	2	71	71	1.0000000
NODE_308188_length_122_cov_58.826087	33	99	2	66	66	1.0000000
NODE_308188_length_122_cov_58.826087	72	122	2	50	50	1.0000000
NODE_308188_length_122_cov_58.826087	72	122	2	50	50	1.0000000
NODE_308198_length_122_cov_38.173913	12	93	4	81	81	1.0000000
NODE_308257_length_121_cov_159.318182	24	55	4	31	31	1.0000000
NODE_308260_length_121_cov_120.181818	20	100	10	80	80	1.0000000
NODE_308260_length_121_cov_120.181818	20	95	10	75	75	1.0000000
NODE_308260_length_121_cov_120.181818	20	100	10	80	80	1.0000000
NODE_308260_length_121_cov_120.181818	29	100	10	71	71	1.0000000
NODE_308273_length_121_cov_54.181818	7	70	0	7	63	0.1111111
NODE_308273_length_121_cov_54.181818	7	70	2	56	63	0.8888889
NODE_308273_length_121_cov_54.181818	7	70	0	7	63	0.1111111
NODE_308273_length_121_cov_54.181818	7	70	2	56	63	0.8888889
NODE_308273_length_121_cov_54.181818	7	70	0	7	63	0.1111111
NODE_308273_length_121_cov_54.181818	7	70	2	56	63	0.8888889
NODE_308273_length_121_cov_54.181818	9	70	0	5	61	0.0819672
NODE_308273_length_121_cov_54.181818	9	70	2	56	61	0.9180328
NODE_308273_length_121_cov_54.181818	43	109	2	66	66	1.0000000
NODE_308273_length_121_cov_54.181818	43	121	0	10	78	0.1282051
NODE_308273_length_121_cov_54.181818	43	121	2	68	78	0.8717949
NODE_308273_length_121_cov_54.181818	64	117	0	6	53	0.1132075
NODE_308273_length_121_cov_54.181818	64	117	2	47	53	0.8867925
NODE_308317_length_120_cov_1404.619048	0	64	6	2	64	0.0312500
NODE_308317_length_120_cov_1404.619048	0	64	11	1	64	0.0156250
NODE_308317_length_120_cov_1404.619048	0	64	24	1	64	0.0156250
NODE_308317_length_120_cov_1404.619048	0	64	28	1	64	0.0156250
NODE_308317_length_120_cov_1404.619048	0	64	30	1	64	0.0156250
NODE_308317_length_120_cov_1404.619048	0	64	36	1	64	0.0156250
NODE_308317_length_120_cov_1404.619048	0	64	40	4	64	0.0625000
NODE_308317_length_120_cov_1404.619048	0	64	42	2	64	0.0312500
NODE_308317_length_120_cov_1404.619048	0	64	46	1	64	0.0156250
NODE_308317_length_120_cov_1404.619048	0	64	48	1	64	0.0156250
NODE_308317_length_120_cov_1404.619048	0	64	52	49	64	0.7656250
NODE_308317_length_120_cov_1404.619048	45	117	20	1	72	0.0138889
NODE_308317_length_120_cov_1404.619048	45	117	22	1	72	0.0138889
NODE_308317_length_120_cov_1404.619048	45	117	24	1	72	0.0138889
NODE_308317_length_120_cov_1404.619048	45	117	26	1	72	0.0138889
NODE_308317_length_120_cov_1404.619048	45	117	28	1	72	0.0138889
NODE_308317_length_120_cov_1404.619048	45	117	30	1	72	0.0138889
NODE_308317_length_120_cov_1404.619048	45	117	32	1	72	0.0138889
NODE_308317_length_120_cov_1404.619048	45	117	36	1	72	0.0138889
NODE_308317_length_120_cov_1404.619048	45	117	50	1	72	0.0138889
NODE_308317_length_120_cov_1404.619048	45	117	52	63	72	0.8750000
NODE_308318_length_120_cov_1138.428571	19	99	6	80	80	1.0000000
NODE_308318_length_120_cov_1138.428571	72	120	0	5	48	0.1041667
NODE_308318_length_120_cov_1138.428571	72	120	2	1	48	0.0208333
NODE_308318_length_120_cov_1138.428571	72	120	4	6	48	0.1250000
NODE_308318_length_120_cov_1138.428571	72	120	6	36	48	0.7500000
NODE_308357_length_120_cov_54.666667	0	69	0	69	69	1.0000000
NODE_308357_length_120_cov_54.666667	0	69	0	69	69	1.0000000
NODE_308357_length_120_cov_54.666667	0	69	0	69	69	1.0000000
NODE_308357_length_120_cov_54.666667	42	108	0	66	66	1.0000000
NODE_308357_length_120_cov_54.666667	53	120	0	67	67	1.0000000
NODE_308357_length_120_cov_54.666667	53	120	0	67	67	1.0000000
NODE_308487_length_118_cov_1211.578947	49	116	0	67	67	1.0000000
NODE_308488_length_118_cov_1157.157895	4	70	0	4	66	0.0606061
NODE_308488_length_118_cov_1157.157895	4	70	4	2	66	0.0303030
NODE_308488_length_118_cov_1157.157895	4	70	12	60	66	0.9090909
NODE_308500_length_118_cov_218.210526	0	63	4	3	63	0.0476190
NODE_308500_length_118_cov_218.210526	0	63	14	1	63	0.0158730
NODE_308500_length_118_cov_218.210526	0	63	16	2	63	0.0317460
NODE_308500_length_118_cov_218.210526	0	63	18	1	63	0.0158730
NODE_308500_length_118_cov_218.210526	0	63	20	2	63	0.0317460
NODE_308500_length_118_cov_218.210526	0	63	25	1	63	0.0158730
NODE_308500_length_118_cov_218.210526	0	63	26	1	63	0.0158730
NODE_308500_length_118_cov_218.210526	0	63	28	4	63	0.0634921
NODE_308500_length_118_cov_218.210526	0	63	30	48	63	0.7619048
NODE_308500_length_118_cov_218.210526	35	115	10	2	80	0.0250000
NODE_308500_length_118_cov_218.210526	35	115	16	1	80	0.0125000
NODE_308500_length_118_cov_218.210526	35	115	26	7	80	0.0875000
NODE_308500_length_118_cov_218.210526	35	115	28	1	80	0.0125000
NODE_308500_length_118_cov_218.210526	35	115	30	69	80	0.8625000
NODE_308504_length_118_cov_161.052632	4	70	0	10	66	0.1515152
NODE_308504_length_118_cov_161.052632	4	70	4	56	66	0.8484849
NODE_308572_length_117_cov_338.555556	7	70	20	2	63	0.0317460
NODE_308572_length_117_cov_338.555556	7	70	22	4	63	0.0634921
NODE_308572_length_117_cov_338.555556	7	70	26	57	63	0.9047619
NODE_308572_length_117_cov_338.555556	7	70	20	2	63	0.0317460
NODE_308572_length_117_cov_338.555556	7	70	22	4	63	0.0634921
NODE_308572_length_117_cov_338.555556	7	70	26	57	63	0.9047619
NODE_308572_length_117_cov_338.555556	7	70	20	2	63	0.0317460
NODE_308572_length_117_cov_338.555556	7	70	22	4	63	0.0634921
NODE_308572_length_117_cov_338.555556	7	70	26	57	63	0.9047619
NODE_308572_length_117_cov_338.555556	9	70	22	4	61	0.0655738
NODE_308572_length_117_cov_338.555556	9	70	26	57	61	0.9344262
NODE_308572_length_117_cov_338.555556	43	109	24	3	66	0.0454545
NODE_308572_length_117_cov_338.555556	43	109	26	63	66	0.9545454
NODE_308572_length_117_cov_338.555556	43	114	18	2	71	0.0281690
NODE_308572_length_117_cov_338.555556	43	114	24	6	71	0.0845070
NODE_308572_length_117_cov_338.555556	43	114	26	63	71	0.8873239
NODE_308572_length_117_cov_338.555556	64	117	16	3	53	0.0566038
NODE_308572_length_117_cov_338.555556	64	117	18	2	53	0.0377358
NODE_308572_length_117_cov_338.555556	64	117	24	6	53	0.1132075
NODE_308572_length_117_cov_338.555556	64	117	26	42	53	0.7924528
NODE_308654_length_116_cov_1897.470588	0	77	4	2	77	0.0259740
NODE_308654_length_116_cov_1897.470588	0	77	6	2	77	0.0259740
NODE_308654_length_116_cov_1897.470588	0	77	8	5	77	0.0649351
NODE_308654_length_116_cov_1897.470588	0	77	10	2	77	0.0259740
NODE_308654_length_116_cov_1897.470588	0	77	12	2	77	0.0259740
NODE_308654_length_116_cov_1897.470588	0	77	16	1	77	0.0129870
NODE_308654_length_116_cov_1897.470588	0	77	20	63	77	0.8181818
NODE_308654_length_116_cov_1897.470588	34	111	8	2	77	0.0259740
NODE_308654_length_116_cov_1897.470588	34	111	10	1	77	0.0129870
NODE_308654_length_116_cov_1897.470588	34	111	14	1	77	0.0129870
NODE_308654_length_116_cov_1897.470588	34	111	17	2	77	0.0259740
NODE_308654_length_116_cov_1897.470588	34	111	18	1	77	0.0129870
NODE_308654_length_116_cov_1897.470588	34	111	20	70	77	0.9090909
NODE_308668_length_116_cov_438.529412	15	95	2	80	80	1.0000000
NODE_308668_length_116_cov_438.529412	68	116	0	13	48	0.2708333
NODE_308668_length_116_cov_438.529412	68	116	2	35	48	0.7291667
NODE_308701_length_116_cov_93.235294	52	116	2	1	64	0.0156250
NODE_308701_length_116_cov_93.235294	52	116	4	1	64	0.0156250
NODE_308701_length_116_cov_93.235294	52	116	8	4	64	0.0625000
NODE_308701_length_116_cov_93.235294	52	116	12	1	64	0.0156250
NODE_308701_length_116_cov_93.235294	52	116	14	4	64	0.0625000
NODE_308701_length_116_cov_93.235294	52	116	16	53	64	0.8281250
NODE_308722_length_116_cov_46.882353	6	66	6	2	60	0.0333333
NODE_308722_length_116_cov_46.882353	6	66	8	1	60	0.0166667
NODE_308722_length_116_cov_46.882353	6	66	10	1	60	0.0166667
NODE_308722_length_116_cov_46.882353	6	66	12	3	60	0.0500000
NODE_308722_length_116_cov_46.882353	6	66	14	1	60	0.0166667
NODE_308722_length_116_cov_46.882353	6	66	16	52	60	0.8666667
NODE_308727_length_116_cov_38.352941	20	100	0	80	80	1.0000000
NODE_308746_length_115_cov_1012.625000	31	114	15	1	83	0.0120482
NODE_308746_length_115_cov_1012.625000	31	114	17	2	83	0.0240964
NODE_308746_length_115_cov_1012.625000	31	114	19	1	83	0.0120482
NODE_308746_length_115_cov_1012.625000	31	114	21	2	83	0.0240964
NODE_308746_length_115_cov_1012.625000	31	114	24	2	83	0.0240964
NODE_308746_length_115_cov_1012.625000	31	114	29	75	83	0.9036145
NODE_308750_length_115_cov_776.625000	9	92	1	1	83	0.0120482
NODE_308750_length_115_cov_776.625000	9	92	6	82	83	0.9879518
NODE_308752_length_115_cov_623.937500	0	74	2	3	74	0.0405405
NODE_308752_length_115_cov_623.937500	0	74	6	3	74	0.0405405
NODE_308752_length_115_cov_623.937500	0	74	8	1	74	0.0135135
NODE_308752_length_115_cov_623.937500	0	74	10	67	74	0.9054054
NODE_308782_length_115_cov_144.812500	4	73	2	3	69	0.0434783
NODE_308782_length_115_cov_144.812500	4	73	4	66	69	0.9565217
NODE_308806_length_115_cov_65.187500	16	76	26	60	60	1.0000000
NODE_308846_length_114_cov_819.466667	40	114	0	2	74	0.0270270
NODE_308846_length_114_cov_819.466667	40	114	12	2	74	0.0270270
NODE_308846_length_114_cov_819.466667	40	114	14	4	74	0.0540541
NODE_308846_length_114_cov_819.466667	40	114	26	2	74	0.0270270
NODE_308846_length_114_cov_819.466667	40	114	28	64	74	0.8648649
NODE_308846_length_114_cov_819.466667	40	114	0	2	74	0.0270270
NODE_308846_length_114_cov_819.466667	40	114	12	2	74	0.0270270
NODE_308846_length_114_cov_819.466667	40	114	14	4	74	0.0540541
NODE_308846_length_114_cov_819.466667	40	114	26	2	74	0.0270270
NODE_308846_length_114_cov_819.466667	40	114	28	64	74	0.8648649
NODE_308846_length_114_cov_819.466667	49	114	0	2	65	0.0307692
NODE_308846_length_114_cov_819.466667	49	114	12	2	65	0.0307692
NODE_308846_length_114_cov_819.466667	49	114	14	4	65	0.0615385
NODE_308846_length_114_cov_819.466667	49	114	26	2	65	0.0307692
NODE_308846_length_114_cov_819.466667	49	114	28	55	65	0.8461539
NODE_308866_length_114_cov_285.666667	0	78	4	1	78	0.0128205
NODE_308866_length_114_cov_285.666667	0	78	6	2	78	0.0256410
NODE_308866_length_114_cov_285.666667	0	78	7	1	78	0.0128205
NODE_308866_length_114_cov_285.666667	0	78	8	7	78	0.0897436
NODE_308866_length_114_cov_285.666667	0	78	10	67	78	0.8589743
NODE_308866_length_114_cov_285.666667	51	114	4	5	63	0.0793651
NODE_308866_length_114_cov_285.666667	51	114	6	2	63	0.0317460
NODE_308866_length_114_cov_285.666667	51	114	8	1	63	0.0158730
NODE_308866_length_114_cov_285.666667	51	114	9	1	63	0.0158730
NODE_308866_length_114_cov_285.666667	51	114	10	54	63	0.8571429
NODE_308886_length_114_cov_83.600000	51	82	0	31	31	1.0000000
NODE_308891_length_114_cov_67.666667	40	90	0	50	50	1.0000000
NODE_308939_length_113_cov_446.214286	5	82	0	77	77	1.0000000
NODE_308939_length_113_cov_446.214286	5	82	0	77	77	1.0000000
NODE_308967_length_113_cov_160.071429	0	64	2	2	64	0.0312500
NODE_308967_length_113_cov_160.071429	0	64	4	3	64	0.0468750
NODE_308967_length_113_cov_160.071429	0	64	6	59	64	0.9218750
NODE_308967_length_113_cov_160.071429	0	64	2	2	64	0.0312500
NODE_308967_length_113_cov_160.071429	0	64	4	3	64	0.0468750
NODE_308967_length_113_cov_160.071429	0	64	6	59	64	0.9218750
NODE_308967_length_113_cov_160.071429	37	103	6	66	66	1.0000000
NODE_308967_length_113_cov_160.071429	37	108	6	71	71	1.0000000
NODE_309037_length_112_cov_963.384615	43	112	0	69	69	1.0000000
NODE_309044_length_112_cov_653.615385	7	78	0	71	71	1.0000000
NODE_309044_length_112_cov_653.615385	12	78	0	66	66	1.0000000
NODE_309044_length_112_cov_653.615385	51	112	0	61	61	1.0000000
NODE_309044_length_112_cov_653.615385	51	112	0	61	61	1.0000000
NODE_309067_length_112_cov_219.538462	0	62	0	62	62	1.0000000
NODE_309067_length_112_cov_219.538462	0	57	0	57	57	1.0000000
NODE_309067_length_112_cov_219.538462	0	62	0	62	62	1.0000000
NODE_309067_length_112_cov_219.538462	0	59	0	59	59	1.0000000
NODE_309067_length_112_cov_219.538462	35	112	0	77	77	1.0000000
NODE_309067_length_112_cov_219.538462	35	112	0	77	77	1.0000000
NODE_309067_length_112_cov_219.538462	35	112	0	77	77	1.0000000
NODE_309078_length_112_cov_160.307692	0	69	2	69	69	1.0000000
NODE_309079_length_112_cov_134.846154	11	91	2	80	80	1.0000000
NODE_309079_length_112_cov_134.846154	11	91	2	80	80	1.0000000
NODE_309079_length_112_cov_134.846154	64	112	2	48	48	1.0000000
NODE_309079_length_112_cov_134.846154	64	112	2	48	48	1.0000000
NODE_309079_length_112_cov_134.846154	64	112	2	48	48	1.0000000
NODE_309092_length_112_cov_84.384615	10	90	0	80	80	1.0000000
NODE_309097_length_112_cov_72.769231	36	100	16	64	64	1.0000000
NODE_309106_length_112_cov_35.307692	13	76	0	63	63	1.0000000
NODE_309123_length_111_cov_1107.833333	0	52	0	4	52	0.0769231
NODE_309123_length_111_cov_1107.833333	0	52	4	48	52	0.9230769
NODE_309123_length_111_cov_1107.833333	0	52	0	4	52	0.0769231
NODE_309123_length_111_cov_1107.833333	0	52	4	48	52	0.9230769
NODE_309123_length_111_cov_1107.833333	0	52	0	4	52	0.0769231
NODE_309123_length_111_cov_1107.833333	0	52	4	48	52	0.9230769
NODE_309123_length_111_cov_1107.833333	0	52	0	4	52	0.0769231
NODE_309123_length_111_cov_1107.833333	0	52	4	48	52	0.9230769
NODE_309123_length_111_cov_1107.833333	25	105	4	80	80	1.0000000
NODE_309123_length_111_cov_1107.833333	25	105	4	80	80	1.0000000
NODE_309123_length_111_cov_1107.833333	25	105	4	80	80	1.0000000
NODE_309123_length_111_cov_1107.833333	25	105	4	80	80	1.0000000
NODE_309123_length_111_cov_1107.833333	25	105	4	80	80	1.0000000
NODE_309123_length_111_cov_1107.833333	25	105	4	80	80	1.0000000
NODE_309126_length_111_cov_827.500000	3	74	22	71	71	1.0000000
NODE_309126_length_111_cov_827.500000	8	74	22	66	66	1.0000000
NODE_309126_length_111_cov_827.500000	47	111	10	2	64	0.0312500
NODE_309126_length_111_cov_827.500000	47	111	14	3	64	0.0468750
NODE_309126_length_111_cov_827.500000	47	111	18	2	64	0.0312500
NODE_309126_length_111_cov_827.500000	47	111	20	2	64	0.0312500
NODE_309126_length_111_cov_827.500000	47	111	22	55	64	0.8593750
NODE_309126_length_111_cov_827.500000	47	111	10	2	64	0.0312500
NODE_309126_length_111_cov_827.500000	47	111	14	3	64	0.0468750
NODE_309126_length_111_cov_827.500000	47	111	18	2	64	0.0312500
NODE_309126_length_111_cov_827.500000	47	111	20	2	64	0.0312500
NODE_309126_length_111_cov_827.500000	47	111	22	55	64	0.8593750
NODE_309126_length_111_cov_827.500000	47	111	10	2	64	0.0312500
NODE_309126_length_111_cov_827.500000	47	111	14	3	64	0.0468750
NODE_309126_length_111_cov_827.500000	47	111	18	2	64	0.0312500
NODE_309126_length_111_cov_827.500000	47	111	20	2	64	0.0312500
NODE_309126_length_111_cov_827.500000	47	111	22	55	64	0.8593750
NODE_309129_length_111_cov_726.833333	12	89	0	77	77	1.0000000
NODE_309129_length_111_cov_726.833333	12	89	0	77	77	1.0000000
NODE_309129_length_111_cov_726.833333	62	111	0	49	49	1.0000000
NODE_309129_length_111_cov_726.833333	67	111	0	44	44	1.0000000
NODE_309131_length_111_cov_692.416667	31	111	2	1	80	0.0125000
NODE_309131_length_111_cov_692.416667	31	111	20	79	80	0.9875000
NODE_309149_length_111_cov_241.750000	30	97	0	67	67	1.0000000
NODE_309160_length_111_cov_169.416667	21	102	0	81	81	1.0000000
NODE_309200_length_110_cov_554.909091	1	28	8	1	27	0.0370370
NODE_309200_length_110_cov_554.909091	1	28	10	26	27	0.9629630
NODE_309200_length_110_cov_554.909091	1	81	8	1	80	0.0125000
NODE_309200_length_110_cov_554.909091	1	81	10	79	80	0.9875000
NODE_309202_length_110_cov_537.545455	0	75	0	75	75	1.0000000
NODE_309202_length_110_cov_537.545455	53	107	0	54	54	1.0000000
NODE_309235_length_110_cov_91.636364	19	54	2	35	35	1.0000000
NODE_309235_length_110_cov_91.636364	64	107	2	43	43	1.0000000
NODE_309239_length_110_cov_80.272727	19	54	4	35	35	1.0000000
NODE_309239_length_110_cov_80.272727	64	99	4	35	35	1.0000000
NODE_309241_length_110_cov_78.363636	19	54	0	35	35	1.0000000
NODE_309241_length_110_cov_78.363636	64	107	0	43	43	1.0000000
NODE_309245_length_110_cov_68.727273	11	46	4	35	35	1.0000000
NODE_309245_length_110_cov_68.727273	56	91	4	35	35	1.0000000
NODE_309252_length_110_cov_44.545455	5	57	0	52	52	1.0000000
NODE_309263_length_109_cov_1364.100000	29	98	2	69	69	1.0000000
NODE_309275_length_109_cov_689.800000	12	86	4	74	74	1.0000000
NODE_309309_length_109_cov_250.800000	4	66	0	62	62	1.0000000
NODE_309311_length_109_cov_242.000000	29	98	0	69	69	1.0000000
NODE_309326_length_109_cov_139.000000	26	106	8	80	80	1.0000000
NODE_309345_length_109_cov_84.500000	33	93	16	60	60	1.0000000
NODE_309349_length_109_cov_75.300000	0	65	0	1	65	0.0153846
NODE_309349_length_109_cov_75.300000	0	65	6	1	65	0.0153846
NODE_309349_length_109_cov_75.300000	0	65	8	63	65	0.9692308
NODE_309384_length_108_cov_1542.666667	28	108	0	6	80	0.0750000
NODE_309384_length_108_cov_1542.666667	28	108	2	74	80	0.9250000
NODE_309391_length_108_cov_987.666667	5	85	2	80	80	1.0000000
NODE_309391_length_108_cov_987.666667	5	85	2	80	80	1.0000000
NODE_309391_length_108_cov_987.666667	5	85	2	80	80	1.0000000
NODE_309391_length_108_cov_987.666667	5	85	2	80	80	1.0000000
NODE_309391_length_108_cov_987.666667	5	85	2	80	80	1.0000000
NODE_309391_length_108_cov_987.666667	58	108	2	50	50	1.0000000
NODE_309391_length_108_cov_987.666667	58	108	2	50	50	1.0000000
NODE_309395_length_108_cov_841.666667	1	65	0	64	64	1.0000000
NODE_309395_length_108_cov_841.666667	1	65	0	64	64	1.0000000
NODE_309395_length_108_cov_841.666667	1	65	0	64	64	1.0000000
NODE_309433_length_108_cov_213.333333	22	81	6	59	59	1.0000000
NODE_309433_length_108_cov_213.333333	55	81	6	26	26	1.0000000
NODE_309464_length_108_cov_107.888889	11	82	0	71	71	1.0000000
NODE_309464_length_108_cov_107.888889	16	82	0	66	66	1.0000000
NODE_309464_length_108_cov_107.888889	55	108	0	53	53	1.0000000
NODE_309464_length_108_cov_107.888889	55	108	0	53	53	1.0000000
NODE_309464_length_108_cov_107.888889	55	108	0	53	53	1.0000000
NODE_309472_length_108_cov_76.444444	13	76	0	63	63	1.0000000
NODE_309479_length_108_cov_51.000000	0	53	0	53	53	1.0000000
NODE_309479_length_108_cov_51.000000	0	53	0	53	53	1.0000000
NODE_309479_length_108_cov_51.000000	0	53	0	53	53	1.0000000
NODE_309479_length_108_cov_51.000000	26	106	0	80	80	1.0000000
NODE_309479_length_108_cov_51.000000	26	106	0	80	80	1.0000000
NODE_309479_length_108_cov_51.000000	26	106	0	80	80	1.0000000
NODE_309479_length_108_cov_51.000000	26	106	0	80	80	1.0000000
NODE_309479_length_108_cov_51.000000	26	106	0	80	80	1.0000000
NODE_309479_length_108_cov_51.000000	26	97	0	71	71	1.0000000
NODE_309490_length_108_cov_31.111111	11	82	0	71	71	1.0000000
NODE_309490_length_108_cov_31.111111	16	82	0	66	66	1.0000000
NODE_309490_length_108_cov_31.111111	55	108	0	53	53	1.0000000
NODE_309490_length_108_cov_31.111111	55	108	0	53	53	1.0000000
NODE_309490_length_108_cov_31.111111	55	108	0	53	53	1.0000000
NODE_309530_length_107_cov_608.250000	0	64	0	64	64	1.0000000
NODE_309530_length_107_cov_608.250000	53	103	0	50	50	1.0000000
NODE_309551_length_107_cov_303.250000	0	56	0	1	56	0.0178571
NODE_309551_length_107_cov_303.250000	0	56	4	55	56	0.9821429
NODE_309551_length_107_cov_303.250000	29	99	4	70	70	1.0000000
NODE_309657_length_106_cov_522.571429	10	90	0	80	80	1.0000000
NODE_309657_length_106_cov_522.571429	10	90	0	80	80	1.0000000
NODE_309657_length_106_cov_522.571429	10	90	0	80	80	1.0000000
NODE_309657_length_106_cov_522.571429	10	90	0	80	80	1.0000000
NODE_309657_length_106_cov_522.571429	10	90	0	80	80	1.0000000
NODE_309657_length_106_cov_522.571429	19	90	0	71	71	1.0000000
NODE_309696_length_106_cov_161.857143	7	78	0	71	71	1.0000000
NODE_309696_length_106_cov_161.857143	51	106	0	55	55	1.0000000
NODE_309707_length_106_cov_130.714286	0	76	0	76	76	1.0000000
NODE_309714_length_106_cov_108.000000	0	76	0	76	76	1.0000000
NODE_309717_length_106_cov_102.142857	0	62	0	62	62	1.0000000
NODE_309717_length_106_cov_102.142857	35	106	0	71	71	1.0000000
NODE_309717_length_106_cov_102.142857	35	106	0	71	71	1.0000000
NODE_309747_length_106_cov_39.428571	0	76	0	76	76	1.0000000
NODE_309761_length_106_cov_30.857143	0	70	0	3	70	0.0428571
NODE_309761_length_106_cov_30.857143	0	70	4	67	70	0.9571428
NODE_309761_length_106_cov_30.857143	0	70	0	3	70	0.0428571
NODE_309761_length_106_cov_30.857143	0	70	4	67	70	0.9571428
NODE_309761_length_106_cov_30.857143	0	70	0	3	70	0.0428571
NODE_309761_length_106_cov_30.857143	0	70	4	67	70	0.9571428
NODE_309761_length_106_cov_30.857143	43	92	4	49	49	1.0000000
NODE_309761_length_106_cov_30.857143	53	106	4	53	53	1.0000000
NODE_309761_length_106_cov_30.857143	53	106	4	53	53	1.0000000
NODE_309775_length_105_cov_2054.666667	31	105	0	74	74	1.0000000
NODE_309775_length_105_cov_2054.666667	31	105	0	74	74	1.0000000
NODE_309775_length_105_cov_2054.666667	31	105	0	74	74	1.0000000
NODE_309775_length_105_cov_2054.666667	31	105	0	74	74	1.0000000
NODE_309788_length_105_cov_830.833333	30	105	0	75	75	1.0000000
NODE_309789_length_105_cov_825.500000	0	77	0	77	77	1.0000000
NODE_309789_length_105_cov_825.500000	0	77	0	77	77	1.0000000
NODE_309789_length_105_cov_825.500000	50	99	0	49	49	1.0000000
NODE_309789_length_105_cov_825.500000	55	105	0	50	50	1.0000000
NODE_309815_length_105_cov_231.333333	0	54	2	54	54	1.0000000
NODE_309815_length_105_cov_231.333333	27	99	2	72	72	1.0000000
NODE_309842_length_105_cov_85.333333	14	94	4	80	80	1.0000000
NODE_309842_length_105_cov_85.333333	67	89	4	22	22	1.0000000
NODE_309855_length_105_cov_61.833333	23	103	2	80	80	1.0000000
NODE_309867_length_105_cov_40.666667	6	66	0	60	60	1.0000000
NODE_309925_length_104_cov_1016.000000	0	78	0	78	78	1.0000000
NODE_309925_length_104_cov_1016.000000	53	99	0	46	46	1.0000000
NODE_309935_length_104_cov_791.200000	0	67	0	67	67	1.0000000
NODE_309935_length_104_cov_791.200000	0	67	0	67	67	1.0000000
NODE_309935_length_104_cov_791.200000	40	104	0	64	64	1.0000000
NODE_309938_length_104_cov_574.200000	21	101	0	80	80	1.0000000
NODE_309938_length_104_cov_574.200000	21	101	0	80	80	1.0000000
NODE_309938_length_104_cov_574.200000	21	101	0	80	80	1.0000000
NODE_309938_length_104_cov_574.200000	21	101	0	80	80	1.0000000
NODE_309938_length_104_cov_574.200000	21	101	0	80	80	1.0000000
NODE_309938_length_104_cov_574.200000	21	92	0	71	71	1.0000000
NODE_309940_length_104_cov_547.400000	10	87	0	77	77	1.0000000
NODE_309940_length_104_cov_547.400000	10	87	0	77	77	1.0000000
NODE_310020_length_104_cov_46.800000	42	104	0	62	62	1.0000000
NODE_310054_length_103_cov_2267.000000	0	54	0	54	54	1.0000000
NODE_310054_length_103_cov_2267.000000	27	100	0	73	73	1.0000000
NODE_310082_length_103_cov_890.000000	6	70	0	64	64	1.0000000
NODE_310082_length_103_cov_890.000000	6	70	0	64	64	1.0000000
NODE_310082_length_103_cov_890.000000	6	70	0	64	64	1.0000000
NODE_310082_length_103_cov_890.000000	43	103	0	60	60	1.0000000
NODE_310082_length_103_cov_890.000000	59	103	0	44	44	1.0000000
NODE_310090_length_103_cov_768.500000	7	78	0	71	71	1.0000000
NODE_310090_length_103_cov_768.500000	12	78	0	66	66	1.0000000
NODE_310090_length_103_cov_768.500000	51	99	0	48	48	1.0000000
NODE_310090_length_103_cov_768.500000	51	99	0	48	48	1.0000000
NODE_310090_length_103_cov_768.500000	51	99	0	48	48	1.0000000
NODE_310091_length_103_cov_751.000000	0	71	0	71	71	1.0000000
NODE_310091_length_103_cov_751.000000	0	71	0	71	71	1.0000000
NODE_310091_length_103_cov_751.000000	44	93	0	49	49	1.0000000
NODE_310094_length_103_cov_678.000000	10	74	0	64	64	1.0000000
NODE_310094_length_103_cov_678.000000	10	74	0	64	64	1.0000000
NODE_310094_length_103_cov_678.000000	10	74	0	64	64	1.0000000
NODE_310094_length_103_cov_678.000000	47	96	0	49	49	1.0000000
NODE_310103_length_103_cov_462.750000	19	99	0	80	80	1.0000000
NODE_310116_length_103_cov_300.250000	0	63	0	63	63	1.0000000
NODE_310147_length_103_cov_103.250000	4	47	0	43	43	1.0000000
NODE_310152_length_103_cov_80.250000	36	99	0	63	63	1.0000000
NODE_310153_length_103_cov_76.500000	4	63	0	59	59	1.0000000
NODE_310160_length_103_cov_42.000000	0	78	0	78	78	1.0000000
NODE_310160_length_103_cov_42.000000	7	78	0	71	71	1.0000000
NODE_310160_length_103_cov_42.000000	12	78	0	66	66	1.0000000
NODE_310160_length_103_cov_42.000000	51	99	0	48	48	1.0000000
NODE_310160_length_103_cov_42.000000	51	99	0	48	48	1.0000000
NODE_310160_length_103_cov_42.000000	51	99	0	48	48	1.0000000
NODE_310211_length_102_cov_2033.666667	0	48	0	48	48	1.0000000
NODE_310211_length_102_cov_2033.666667	21	101	0	80	80	1.0000000
NODE_310227_length_102_cov_1028.333333	52	102	0	50	50	1.0000000
NODE_310230_length_102_cov_987.666667	15	98	0	83	83	1.0000000
NODE_310231_length_102_cov_934.000000	12	95	0	83	83	1.0000000
NODE_310246_length_102_cov_685.666667	0	73	0	73	73	1.0000000
NODE_310247_length_102_cov_646.666667	15	89	0	74	74	1.0000000
NODE_310269_length_102_cov_250.000000	12	72	0	60	60	1.0000000
NODE_310273_length_102_cov_216.333333	4	70	0	66	66	1.0000000
NODE_310273_length_102_cov_216.333333	4	70	0	66	66	1.0000000
NODE_310273_length_102_cov_216.333333	4	70	0	66	66	1.0000000
NODE_310273_length_102_cov_216.333333	43	92	0	49	49	1.0000000
NODE_310273_length_102_cov_216.333333	57	102	0	45	45	1.0000000
NODE_310287_length_102_cov_152.333333	0	63	0	63	63	1.0000000
NODE_310295_length_102_cov_124.333333	0	70	0	70	70	1.0000000
NODE_310302_length_102_cov_106.333333	0	78	0	78	78	1.0000000
NODE_310302_length_102_cov_106.333333	7	78	0	71	71	1.0000000
NODE_310302_length_102_cov_106.333333	12	78	0	66	66	1.0000000
NODE_310302_length_102_cov_106.333333	51	102	0	51	51	1.0000000
NODE_310302_length_102_cov_106.333333	51	102	0	51	51	1.0000000
NODE_310302_length_102_cov_106.333333	51	102	0	51	51	1.0000000
NODE_310316_length_102_cov_74.333333	31	99	0	68	68	1.0000000
NODE_310321_length_102_cov_71.000000	11	91	0	80	80	1.0000000
NODE_310336_length_102_cov_32.666667	0	65	0	65	65	1.0000000
NODE_310336_length_102_cov_32.666667	38	99	0	61	61	1.0000000
NODE_310405_length_101_cov_2217.000000	0	43	0	43	43	1.0000000
NODE_310405_length_101_cov_2217.000000	23	96	0	73	73	1.0000000
NODE_310464_length_101_cov_740.500000	2	66	0	64	64	1.0000000
NODE_310464_length_101_cov_740.500000	2	66	0	64	64	1.0000000
NODE_310464_length_101_cov_740.500000	2	66	0	64	64	1.0000000
NODE_310464_length_101_cov_740.500000	39	101	0	62	62	1.0000000
NODE_310464_length_101_cov_740.500000	55	101	0	46	46	1.0000000
NODE_310469_length_101_cov_701.000000	0	62	0	62	62	1.0000000
NODE_310469_length_101_cov_701.000000	35	99	0	64	64	1.0000000
NODE_310469_length_101_cov_701.000000	35	99	0	64	64	1.0000000
NODE_310469_length_101_cov_701.000000	35	99	0	64	64	1.0000000
NODE_310471_length_101_cov_679.000000	2	76	0	74	74	1.0000000
NODE_310500_length_101_cov_374.500000	2	50	0	48	48	1.0000000
NODE_310500_length_101_cov_374.500000	2	50	0	48	48	1.0000000
NODE_310500_length_101_cov_374.500000	2	50	0	48	48	1.0000000
NODE_310500_length_101_cov_374.500000	23	89	0	66	66	1.0000000
NODE_310500_length_101_cov_374.500000	23	94	0	71	71	1.0000000
NODE_310516_length_101_cov_294.000000	4	52	0	48	48	1.0000000
NODE_310516_length_101_cov_294.000000	4	52	0	48	48	1.0000000
NODE_310516_length_101_cov_294.000000	4	52	0	48	48	1.0000000
NODE_310516_length_101_cov_294.000000	25	91	0	66	66	1.0000000
NODE_310516_length_101_cov_294.000000	25	96	0	71	71	1.0000000
NODE_310529_length_101_cov_230.500000	2	76	0	74	74	1.0000000
NODE_310529_length_101_cov_230.500000	2	76	0	74	74	1.0000000
NODE_310529_length_101_cov_230.500000	2	76	0	74	74	1.0000000
NODE_310529_length_101_cov_230.500000	49	101	0	52	52	1.0000000
NODE_310529_length_101_cov_230.500000	55	101	0	46	46	1.0000000
NODE_310550_length_101_cov_157.000000	13	72	0	59	59	1.0000000
NODE_310550_length_101_cov_157.000000	46	72	0	26	26	1.0000000
NODE_310565_length_101_cov_134.500000	2	37	0	35	35	1.0000000
NODE_310685_length_100_cov_1883.000000	32	100	0	68	68	1.0000000
NODE_310685_length_100_cov_1883.000000	32	100	0	68	68	1.0000000
NODE_310685_length_100_cov_1883.000000	32	99	0	67	67	1.0000000
NODE_310685_length_100_cov_1883.000000	32	100	0	68	68	1.0000000
NODE_310704_length_100_cov_1310.000000	0	42	0	42	42	1.0000000
NODE_310704_length_100_cov_1310.000000	1	42	0	41	41	1.0000000
NODE_310704_length_100_cov_1310.000000	38	100	0	62	62	1.0000000
NODE_310704_length_100_cov_1310.000000	38	95	0	57	57	1.0000000
NODE_310704_length_100_cov_1310.000000	38	100	0	62	62	1.0000000
NODE_310704_length_100_cov_1310.000000	38	100	0	62	62	1.0000000
NODE_310708_length_100_cov_1239.000000	1	48	0	47	47	1.0000000
NODE_310740_length_100_cov_694.000000	0	62	0	62	62	1.0000000
NODE_310740_length_100_cov_694.000000	0	62	0	62	62	1.0000000
NODE_310740_length_100_cov_694.000000	35	100	0	65	65	1.0000000
NODE_310748_length_100_cov_602.000000	0	57	0	57	57	1.0000000
NODE_310750_length_100_cov_590.000000	0	58	0	58	58	1.0000000
NODE_310798_length_100_cov_274.000000	1	67	0	66	66	1.0000000
NODE_310798_length_100_cov_274.000000	1	67	0	66	66	1.0000000
NODE_310798_length_100_cov_274.000000	1	67	0	66	66	1.0000000
NODE_310798_length_100_cov_274.000000	40	100	0	60	60	1.0000000
NODE_310798_length_100_cov_274.000000	54	100	0	46	46	1.0000000
NODE_310808_length_100_cov_217.000000	4	75	0	71	71	1.0000000
NODE_310808_length_100_cov_217.000000	9	75	0	66	66	1.0000000
NODE_310808_length_100_cov_217.000000	48	99	0	51	51	1.0000000
NODE_310808_length_100_cov_217.000000	48	99	0	51	51	1.0000000
NODE_310808_length_100_cov_217.000000	48	99	0	51	51	1.0000000
NODE_310810_length_100_cov_209.000000	1	44	0	43	43	1.0000000
NODE_310810_length_100_cov_209.000000	40	100	0	60	60	1.0000000
NODE_310810_length_100_cov_209.000000	40	100	0	60	60	1.0000000
NODE_310819_length_100_cov_185.000000	0	46	0	46	46	1.0000000
NODE_310819_length_100_cov_185.000000	9	58	0	49	49	1.0000000
NODE_310819_length_100_cov_185.000000	31	99	0	68	68	1.0000000
NODE_310819_length_100_cov_185.000000	31	99	0	68	68	1.0000000
NODE_310819_length_100_cov_185.000000	31	99	0	68	68	1.0000000
NODE_310828_length_100_cov_164.000000	9	92	0	83	83	1.0000000
NODE_310837_length_100_cov_152.000000	11	91	0	80	80	1.0000000
NODE_310837_length_100_cov_152.000000	11	91	0	80	80	1.0000000
NODE_310837_length_100_cov_152.000000	11	91	0	80	80	1.0000000
NODE_310837_length_100_cov_152.000000	11	91	0	80	80	1.0000000
NODE_310837_length_100_cov_152.000000	11	91	0	80	80	1.0000000
NODE_310839_length_100_cov_150.000000	0	54	0	54	54	1.0000000
NODE_310839_length_100_cov_150.000000	0	54	0	54	54	1.0000000
NODE_310839_length_100_cov_150.000000	27	100	0	73	73	1.0000000
NODE_310839_length_100_cov_150.000000	27	100	0	73	73	1.0000000
NODE_310840_length_100_cov_148.000000	2	82	0	80	80	1.0000000
NODE_310841_length_100_cov_148.000000	0	71	0	71	71	1.0000000
NODE_310841_length_100_cov_148.000000	0	71	0	71	71	1.0000000
NODE_310841_length_100_cov_148.000000	0	62	0	62	62	1.0000000
NODE_310876_length_100_cov_71.000000	0	75	0	75	75	1.0000000
NODE_310876_length_100_cov_71.000000	4	75	0	71	71	1.0000000
NODE_310876_length_100_cov_71.000000	9	75	0	66	66	1.0000000
NODE_310876_length_100_cov_71.000000	48	100	0	52	52	1.0000000
NODE_310876_length_100_cov_71.000000	48	100	0	52	52	1.0000000
NODE_310876_length_100_cov_71.000000	48	100	0	52	52	1.0000000
NODE_310896_length_100_cov_41.000000	0	75	0	75	75	1.0000000
NODE_310896_length_100_cov_41.000000	4	75	0	71	71	1.0000000
NODE_310896_length_100_cov_41.000000	9	75	0	66	66	1.0000000
NODE_310896_length_100_cov_41.000000	48	99	0	51	51	1.0000000
NODE_310896_length_100_cov_41.000000	48	99	0	51	51	1.0000000
NODE_310896_length_100_cov_41.000000	48	99	0	51	51	1.0000000
NODE_310904_length_100_cov_30.000000	1	42	0	41	41	1.0000000
