NODE_1_length_25698_cov_36.651041	315	395	0	80	80	1.0000000
NODE_1_length_25698_cov_36.651041	368	403	0	29	35	0.8285714
NODE_1_length_25698_cov_36.651041	368	403	6	4	35	0.1142857
NODE_1_length_25698_cov_36.651041	368	403	7	1	35	0.0285714
NODE_1_length_25698_cov_36.651041	368	403	22	1	35	0.0285714
NODE_1_length_25698_cov_36.651041	24448	24494	0	19	46	0.4130435
NODE_1_length_25698_cov_36.651041	24448	24494	6	1	46	0.0217391
NODE_1_length_25698_cov_36.651041	24448	24494	8	26	46	0.5652174
NODE_2_length_24307_cov_15.119712	2613	2689	0	13	76	0.1710526
NODE_2_length_24307_cov_15.119712	2613	2689	2	63	76	0.8289474
NODE_2_length_24307_cov_15.119712	2662	2716	0	8	54	0.1481481
NODE_2_length_24307_cov_15.119712	2662	2716	2	46	54	0.8518519
NODE_2_length_24307_cov_15.119712	11257	11320	0	63	63	1.0000000
NODE_2_length_24307_cov_15.119712	20621	20701	0	80	80	1.0000000
NODE_2_length_24307_cov_15.119712	20674	20754	0	66	80	0.8250000
NODE_2_length_24307_cov_15.119712	20674	20754	2	14	80	0.1750000
NODE_7_length_12349_cov_28.144571	12251	12310	2	59	59	1.0000000
NODE_7_length_12349_cov_28.144571	12284	12310	2	26	26	1.0000000
NODE_10_length_11096_cov_14.154679	6455	6535	0	80	80	1.0000000
NODE_10_length_11096_cov_14.154679	6508	6588	0	80	80	1.0000000
NODE_10_length_11096_cov_14.154679	6584	6664	0	80	80	1.0000000
NODE_10_length_11096_cov_14.154679	6637	6717	0	32	80	0.4000000
NODE_10_length_11096_cov_14.154679	6637	6717	2	48	80	0.6000000
NODE_10_length_11096_cov_14.154679	7182	7229	224	1	47	0.0212766
NODE_10_length_11096_cov_14.154679	7182	7229	227	5	47	0.1063830
NODE_10_length_11096_cov_14.154679	7182	7229	228	1	47	0.0212766
NODE_10_length_11096_cov_14.154679	7182	7229	229	2	47	0.0425532
NODE_10_length_11096_cov_14.154679	7182	7229	230	1	47	0.0212766
NODE_10_length_11096_cov_14.154679	7182	7229	232	1	47	0.0212766
NODE_10_length_11096_cov_14.154679	7182	7229	234	1	47	0.0212766
NODE_10_length_11096_cov_14.154679	7182	7229	236	1	47	0.0212766
NODE_10_length_11096_cov_14.154679	7182	7229	237	1	47	0.0212766
NODE_10_length_11096_cov_14.154679	7182	7229	240	1	47	0.0212766
NODE_10_length_11096_cov_14.154679	7182	7229	241	1	47	0.0212766
NODE_10_length_11096_cov_14.154679	7182	7229	242	4	47	0.0851064
NODE_10_length_11096_cov_14.154679	7182	7229	249	1	47	0.0212766
NODE_10_length_11096_cov_14.154679	7182	7229	250	1	47	0.0212766
NODE_10_length_11096_cov_14.154679	7182	7229	251	1	47	0.0212766
NODE_10_length_11096_cov_14.154679	7182	7229	256	1	47	0.0212766
NODE_10_length_11096_cov_14.154679	7182	7229	267	1	47	0.0212766
NODE_10_length_11096_cov_14.154679	7182	7229	275	1	47	0.0212766
NODE_10_length_11096_cov_14.154679	7182	7229	277	1	47	0.0212766
NODE_10_length_11096_cov_14.154679	7182	7229	279	1	47	0.0212766
NODE_10_length_11096_cov_14.154679	7182	7229	280	1	47	0.0212766
NODE_10_length_11096_cov_14.154679	7182	7229	281	1	47	0.0212766
NODE_10_length_11096_cov_14.154679	7182	7229	283	1	47	0.0212766
NODE_10_length_11096_cov_14.154679	7182	7229	284	1	47	0.0212766
NODE_10_length_11096_cov_14.154679	7182	7229	285	1	47	0.0212766
NODE_10_length_11096_cov_14.154679	7182	7229	286	1	47	0.0212766
NODE_10_length_11096_cov_14.154679	7182	7229	297	1	47	0.0212766
NODE_10_length_11096_cov_14.154679	7182	7229	299	1	47	0.0212766
NODE_10_length_11096_cov_14.154679	7182	7229	301	1	47	0.0212766
NODE_10_length_11096_cov_14.154679	7182	7229	302	1	47	0.0212766
NODE_10_length_11096_cov_14.154679	7182	7229	303	2	47	0.0425532
NODE_10_length_11096_cov_14.154679	7182	7229	304	2	47	0.0425532
NODE_10_length_11096_cov_14.154679	7182	7229	305	1	47	0.0212766
NODE_10_length_11096_cov_14.154679	7182	7229	307	1	47	0.0212766
NODE_10_length_11096_cov_14.154679	7182	7229	309	1	47	0.0212766
NODE_10_length_11096_cov_14.154679	7182	7229	313	1	47	0.0212766
NODE_10_length_11096_cov_14.154679	7182	7229	314	1	47	0.0212766
NODE_10_length_11096_cov_14.154679	7218	7282	127	1	64	0.0156250
NODE_10_length_11096_cov_14.154679	7218	7282	129	2	64	0.0312500
NODE_10_length_11096_cov_14.154679	7218	7282	130	2	64	0.0312500
NODE_10_length_11096_cov_14.154679	7218	7282	132	14	64	0.2187500
NODE_10_length_11096_cov_14.154679	7218	7282	133	1	64	0.0156250
NODE_10_length_11096_cov_14.154679	7218	7282	137	1	64	0.0156250
NODE_10_length_11096_cov_14.154679	7218	7282	147	1	64	0.0156250
NODE_10_length_11096_cov_14.154679	7218	7282	148	3	64	0.0468750
NODE_10_length_11096_cov_14.154679	7218	7282	152	1	64	0.0156250
NODE_10_length_11096_cov_14.154679	7218	7282	153	1	64	0.0156250
NODE_10_length_11096_cov_14.154679	7218	7282	155	1	64	0.0156250
NODE_10_length_11096_cov_14.154679	7218	7282	162	1	64	0.0156250
NODE_10_length_11096_cov_14.154679	7218	7282	163	1	64	0.0156250
NODE_10_length_11096_cov_14.154679	7218	7282	165	1	64	0.0156250
NODE_10_length_11096_cov_14.154679	7218	7282	172	1	64	0.0156250
NODE_10_length_11096_cov_14.154679	7218	7282	174	1	64	0.0156250
NODE_10_length_11096_cov_14.154679	7218	7282	176	2	64	0.0312500
NODE_10_length_11096_cov_14.154679	7218	7282	181	1	64	0.0156250
NODE_10_length_11096_cov_14.154679	7218	7282	186	1	64	0.0156250
NODE_10_length_11096_cov_14.154679	7218	7282	187	2	64	0.0312500
NODE_10_length_11096_cov_14.154679	7218	7282	199	2	64	0.0312500
NODE_10_length_11096_cov_14.154679	7218	7282	200	2	64	0.0312500
NODE_10_length_11096_cov_14.154679	7218	7282	201	2	64	0.0312500
NODE_10_length_11096_cov_14.154679	7218	7282	202	1	64	0.0156250
NODE_10_length_11096_cov_14.154679	7218	7282	203	1	64	0.0156250
NODE_10_length_11096_cov_14.154679	7218	7282	207	1	64	0.0156250
NODE_10_length_11096_cov_14.154679	7218	7282	208	1	64	0.0156250
NODE_10_length_11096_cov_14.154679	7218	7282	211	1	64	0.0156250
NODE_10_length_11096_cov_14.154679	7218	7282	218	1	64	0.0156250
NODE_10_length_11096_cov_14.154679	7218	7282	222	1	64	0.0156250
NODE_10_length_11096_cov_14.154679	7218	7282	224	1	64	0.0156250
NODE_10_length_11096_cov_14.154679	7218	7282	225	1	64	0.0156250
NODE_10_length_11096_cov_14.154679	7218	7282	227	5	64	0.0781250
NODE_10_length_11096_cov_14.154679	7218	7282	228	1	64	0.0156250
NODE_10_length_11096_cov_14.154679	7218	7282	229	2	64	0.0312500
NODE_10_length_11096_cov_14.154679	7218	7282	230	1	64	0.0156250
NODE_10_length_11096_cov_14.154679	7218	7282	232	1	64	0.0156250
NODE_13_length_10749_cov_34.330235	3589	3669	0	80	80	1.0000000
NODE_13_length_10749_cov_34.330235	3642	3722	0	80	80	1.0000000
NODE_13_length_10749_cov_34.330235	3718	3798	0	80	80	1.0000000
NODE_13_length_10749_cov_34.330235	3771	3851	0	80	80	1.0000000
NODE_14_length_10557_cov_50.055938	423	503	0	80	80	1.0000000
NODE_14_length_10557_cov_50.055938	476	556	0	80	80	1.0000000
NODE_14_length_10557_cov_50.055938	1625	1696	2	24	71	0.3380282
NODE_14_length_10557_cov_50.055938	1625	1696	4	47	71	0.6619718
NODE_14_length_10557_cov_50.055938	1678	1733	2	30	55	0.5454546
NODE_14_length_10557_cov_50.055938	1678	1733	4	25	55	0.4545455
NODE_14_length_10557_cov_50.055938	2428	2488	18	5	60	0.0833333
NODE_14_length_10557_cov_50.055938	2428	2488	20	23	60	0.3833333
NODE_14_length_10557_cov_50.055938	2428	2488	22	32	60	0.5333334
NODE_17_length_10101_cov_12.236253	923	966	0	1	43	0.0232558
NODE_17_length_10101_cov_12.236253	923	966	2	11	43	0.2558140
NODE_17_length_10101_cov_12.236253	923	966	4	31	43	0.7209302
NODE_17_length_10101_cov_12.236253	943	1007	4	64	64	1.0000000
NODE_17_length_10101_cov_12.236253	1715	1795	0	51	80	0.6375000
NODE_17_length_10101_cov_12.236253	1715	1795	2	1	80	0.0125000
NODE_17_length_10101_cov_12.236253	1715	1795	5	5	80	0.0625000
NODE_17_length_10101_cov_12.236253	1715	1795	7	23	80	0.2875000
NODE_17_length_10101_cov_12.236253	1768	1820	0	49	52	0.9423077
NODE_17_length_10101_cov_12.236253	1768	1820	4	2	52	0.0384615
NODE_17_length_10101_cov_12.236253	1768	1820	5	1	52	0.0192308
NODE_20_length_9442_cov_109.961147	2108	2188	0	1	80	0.0125000
NODE_20_length_9442_cov_109.961147	2108	2188	2	1	80	0.0125000
NODE_20_length_9442_cov_109.961147	2108	2188	4	4	80	0.0500000
NODE_20_length_9442_cov_109.961147	2108	2188	6	3	80	0.0375000
NODE_20_length_9442_cov_109.961147	2108	2188	8	18	80	0.2250000
NODE_20_length_9442_cov_109.961147	2108	2188	10	4	80	0.0500000
NODE_20_length_9442_cov_109.961147	2108	2188	16	35	80	0.4375000
NODE_20_length_9442_cov_109.961147	2108	2188	18	14	80	0.1750000
NODE_20_length_9442_cov_109.961147	2161	2241	4	17	80	0.2125000
NODE_20_length_9442_cov_109.961147	2161	2241	6	9	80	0.1125000
NODE_20_length_9442_cov_109.961147	2161	2241	12	7	80	0.0875000
NODE_20_length_9442_cov_109.961147	2161	2241	14	12	80	0.1500000
NODE_20_length_9442_cov_109.961147	2161	2241	16	26	80	0.3250000
NODE_20_length_9442_cov_109.961147	2161	2241	18	9	80	0.1125000
NODE_21_length_9414_cov_34.165217	2363	2443	54	1	80	0.0125000
NODE_21_length_9414_cov_34.165217	2363	2443	58	3	80	0.0375000
NODE_21_length_9414_cov_34.165217	2363	2443	64	6	80	0.0750000
NODE_21_length_9414_cov_34.165217	2363	2443	66	8	80	0.1000000
NODE_21_length_9414_cov_34.165217	2363	2443	68	11	80	0.1375000
NODE_21_length_9414_cov_34.165217	2363	2443	70	6	80	0.0750000
NODE_21_length_9414_cov_34.165217	2363	2443	74	4	80	0.0500000
NODE_21_length_9414_cov_34.165217	2363	2443	76	18	80	0.2250000
NODE_21_length_9414_cov_34.165217	2363	2443	78	12	80	0.1500000
NODE_21_length_9414_cov_34.165217	2363	2443	80	8	80	0.1000000
NODE_21_length_9414_cov_34.165217	2363	2443	82	3	80	0.0375000
NODE_21_length_9414_cov_34.165217	2416	2484	4	6	68	0.0882353
NODE_21_length_9414_cov_34.165217	2416	2484	6	1	68	0.0147059
NODE_21_length_9414_cov_34.165217	2416	2484	9	1	68	0.0147059
NODE_21_length_9414_cov_34.165217	2416	2484	16	2	68	0.0294118
NODE_21_length_9414_cov_34.165217	2416	2484	17	1	68	0.0147059
NODE_21_length_9414_cov_34.165217	2416	2484	18	7	68	0.1029412
NODE_21_length_9414_cov_34.165217	2416	2484	33	1	68	0.0147059
NODE_21_length_9414_cov_34.165217	2416	2484	34	1	68	0.0147059
NODE_21_length_9414_cov_34.165217	2416	2484	36	6	68	0.0882353
NODE_21_length_9414_cov_34.165217	2416	2484	38	5	68	0.0735294
NODE_21_length_9414_cov_34.165217	2416	2484	40	6	68	0.0882353
NODE_21_length_9414_cov_34.165217	2416	2484	42	1	68	0.0147059
NODE_21_length_9414_cov_34.165217	2416	2484	48	3	68	0.0441176
NODE_21_length_9414_cov_34.165217	2416	2484	54	1	68	0.0147059
NODE_21_length_9414_cov_34.165217	2416	2484	58	3	68	0.0441176
NODE_21_length_9414_cov_34.165217	2416	2484	64	6	68	0.0882353
NODE_21_length_9414_cov_34.165217	2416	2484	66	5	68	0.0735294
NODE_21_length_9414_cov_34.165217	2416	2484	68	10	68	0.1470588
NODE_21_length_9414_cov_34.165217	2416	2484	74	2	68	0.0294118
NODE_21_length_9414_cov_34.165217	5899	5975	48	3	76	0.0394737
NODE_21_length_9414_cov_34.165217	5899	5975	50	2	76	0.0263158
NODE_21_length_9414_cov_34.165217	5899	5975	52	17	76	0.2236842
NODE_21_length_9414_cov_34.165217	5899	5975	53	4	76	0.0526316
NODE_21_length_9414_cov_34.165217	5899	5975	54	17	76	0.2236842
NODE_21_length_9414_cov_34.165217	5899	5975	55	2	76	0.0263158
NODE_21_length_9414_cov_34.165217	5899	5975	56	1	76	0.0131579
NODE_21_length_9414_cov_34.165217	5899	5975	58	2	76	0.0263158
NODE_21_length_9414_cov_34.165217	5899	5975	60	1	76	0.0131579
NODE_21_length_9414_cov_34.165217	5899	5975	61	3	76	0.0394737
NODE_21_length_9414_cov_34.165217	5899	5975	62	4	76	0.0526316
NODE_21_length_9414_cov_34.165217	5899	5975	63	1	76	0.0131579
NODE_21_length_9414_cov_34.165217	5899	5975	64	3	76	0.0394737
NODE_21_length_9414_cov_34.165217	5899	5975	66	10	76	0.1315790
NODE_21_length_9414_cov_34.165217	5899	5975	68	6	76	0.0789474
NODE_24_length_9168_cov_47.407542	470	550	24	2	80	0.0250000
NODE_24_length_9168_cov_47.407542	470	550	26	5	80	0.0625000
NODE_24_length_9168_cov_47.407542	470	550	28	15	80	0.1875000
NODE_24_length_9168_cov_47.407542	470	550	30	4	80	0.0500000
NODE_24_length_9168_cov_47.407542	470	550	32	23	80	0.2875000
NODE_24_length_9168_cov_47.407542	470	550	34	14	80	0.1750000
NODE_24_length_9168_cov_47.407542	470	550	35	1	80	0.0125000
NODE_24_length_9168_cov_47.407542	470	550	36	15	80	0.1875000
NODE_24_length_9168_cov_47.407542	470	550	40	1	80	0.0125000
NODE_24_length_9168_cov_47.407542	523	603	12	20	80	0.2500000
NODE_24_length_9168_cov_47.407542	523	603	16	3	80	0.0375000
NODE_24_length_9168_cov_47.407542	523	603	18	13	80	0.1625000
NODE_24_length_9168_cov_47.407542	523	603	20	10	80	0.1250000
NODE_24_length_9168_cov_47.407542	523	603	22	5	80	0.0625000
NODE_24_length_9168_cov_47.407542	523	603	24	4	80	0.0500000
NODE_24_length_9168_cov_47.407542	523	603	26	5	80	0.0625000
NODE_24_length_9168_cov_47.407542	523	603	28	5	80	0.0625000
NODE_24_length_9168_cov_47.407542	523	603	30	4	80	0.0500000
NODE_24_length_9168_cov_47.407542	523	603	32	4	80	0.0500000
NODE_24_length_9168_cov_47.407542	523	603	35	1	80	0.0125000
NODE_24_length_9168_cov_47.407542	523	603	36	6	80	0.0750000
NODE_27_length_9108_cov_47.430347	4786	4866	204	2	80	0.0250000
NODE_27_length_9108_cov_47.430347	4786	4866	209	2	80	0.0250000
NODE_27_length_9108_cov_47.430347	4786	4866	211	1	80	0.0125000
NODE_27_length_9108_cov_47.430347	4786	4866	212	2	80	0.0250000
NODE_27_length_9108_cov_47.430347	4786	4866	213	1	80	0.0125000
NODE_27_length_9108_cov_47.430347	4786	4866	216	1	80	0.0125000
NODE_27_length_9108_cov_47.430347	4786	4866	218	3	80	0.0375000
NODE_27_length_9108_cov_47.430347	4786	4866	219	2	80	0.0250000
NODE_27_length_9108_cov_47.430347	4786	4866	220	7	80	0.0875000
NODE_27_length_9108_cov_47.430347	4786	4866	221	2	80	0.0250000
NODE_27_length_9108_cov_47.430347	4786	4866	222	1	80	0.0125000
NODE_27_length_9108_cov_47.430347	4786	4866	223	3	80	0.0375000
NODE_27_length_9108_cov_47.430347	4786	4866	225	1	80	0.0125000
NODE_27_length_9108_cov_47.430347	4786	4866	226	5	80	0.0625000
NODE_27_length_9108_cov_47.430347	4786	4866	228	1	80	0.0125000
NODE_27_length_9108_cov_47.430347	4786	4866	230	1	80	0.0125000
NODE_27_length_9108_cov_47.430347	4786	4866	232	1	80	0.0125000
NODE_27_length_9108_cov_47.430347	4786	4866	234	2	80	0.0250000
NODE_27_length_9108_cov_47.430347	4786	4866	236	1	80	0.0125000
NODE_27_length_9108_cov_47.430347	4786	4866	239	1	80	0.0125000
NODE_27_length_9108_cov_47.430347	4786	4866	240	2	80	0.0250000
NODE_27_length_9108_cov_47.430347	4786	4866	242	1	80	0.0125000
NODE_27_length_9108_cov_47.430347	4786	4866	244	2	80	0.0250000
NODE_27_length_9108_cov_47.430347	4786	4866	245	1	80	0.0125000
NODE_27_length_9108_cov_47.430347	4786	4866	246	1	80	0.0125000
NODE_27_length_9108_cov_47.430347	4786	4866	247	1	80	0.0125000
NODE_27_length_9108_cov_47.430347	4786	4866	248	7	80	0.0875000
NODE_27_length_9108_cov_47.430347	4786	4866	249	1	80	0.0125000
NODE_27_length_9108_cov_47.430347	4786	4866	250	5	80	0.0625000
NODE_27_length_9108_cov_47.430347	4786	4866	251	1	80	0.0125000
NODE_27_length_9108_cov_47.430347	4786	4866	252	2	80	0.0250000
NODE_27_length_9108_cov_47.430347	4786	4866	253	2	80	0.0250000
NODE_27_length_9108_cov_47.430347	4786	4866	254	4	80	0.0500000
NODE_27_length_9108_cov_47.430347	4786	4866	255	1	80	0.0125000
NODE_27_length_9108_cov_47.430347	4786	4866	256	1	80	0.0125000
NODE_27_length_9108_cov_47.430347	4786	4866	257	2	80	0.0250000
NODE_27_length_9108_cov_47.430347	4786	4866	259	2	80	0.0250000
NODE_27_length_9108_cov_47.430347	4786	4866	261	2	80	0.0250000
NODE_27_length_9108_cov_47.430347	4786	4866	264	1	80	0.0125000
NODE_27_length_9108_cov_47.430347	4786	4866	265	1	80	0.0125000
NODE_27_length_9108_cov_47.430347	4839	4902	239	1	63	0.0158730
NODE_27_length_9108_cov_47.430347	4839	4902	242	1	63	0.0158730
NODE_27_length_9108_cov_47.430347	4839	4902	244	2	63	0.0317460
NODE_27_length_9108_cov_47.430347	4839	4902	245	1	63	0.0158730
NODE_27_length_9108_cov_47.430347	4839	4902	246	6	63	0.0952381
NODE_27_length_9108_cov_47.430347	4839	4902	247	1	63	0.0158730
NODE_27_length_9108_cov_47.430347	4839	4902	248	3	63	0.0476190
NODE_27_length_9108_cov_47.430347	4839	4902	249	1	63	0.0158730
NODE_27_length_9108_cov_47.430347	4839	4902	250	6	63	0.0952381
NODE_27_length_9108_cov_47.430347	4839	4902	251	1	63	0.0158730
NODE_27_length_9108_cov_47.430347	4839	4902	252	3	63	0.0476190
NODE_27_length_9108_cov_47.430347	4839	4902	253	3	63	0.0476190
NODE_27_length_9108_cov_47.430347	4839	4902	254	5	63	0.0793651
NODE_27_length_9108_cov_47.430347	4839	4902	255	1	63	0.0158730
NODE_27_length_9108_cov_47.430347	4839	4902	257	2	63	0.0317460
NODE_27_length_9108_cov_47.430347	4839	4902	258	1	63	0.0158730
NODE_27_length_9108_cov_47.430347	4839	4902	259	1	63	0.0158730
NODE_27_length_9108_cov_47.430347	4839	4902	260	1	63	0.0158730
NODE_27_length_9108_cov_47.430347	4839	4902	261	1	63	0.0158730
NODE_27_length_9108_cov_47.430347	4839	4902	262	1	63	0.0158730
NODE_27_length_9108_cov_47.430347	4839	4902	264	3	63	0.0476190
NODE_27_length_9108_cov_47.430347	4839	4902	265	2	63	0.0317460
NODE_27_length_9108_cov_47.430347	4839	4902	266	2	63	0.0317460
NODE_27_length_9108_cov_47.430347	4839	4902	268	2	63	0.0317460
NODE_27_length_9108_cov_47.430347	4839	4902	269	1	63	0.0158730
NODE_27_length_9108_cov_47.430347	4839	4902	270	4	63	0.0634921
NODE_27_length_9108_cov_47.430347	4839	4902	271	1	63	0.0158730
NODE_27_length_9108_cov_47.430347	4839	4902	272	3	63	0.0476190
NODE_27_length_9108_cov_47.430347	4839	4902	274	2	63	0.0317460
NODE_27_length_9108_cov_47.430347	4839	4902	275	1	63	0.0158730
NODE_27_length_9108_cov_47.430347	4895	4963	189	1	68	0.0147059
NODE_27_length_9108_cov_47.430347	4895	4963	201	1	68	0.0147059
NODE_27_length_9108_cov_47.430347	4895	4963	202	6	68	0.0882353
NODE_27_length_9108_cov_47.430347	4895	4963	205	2	68	0.0294118
NODE_27_length_9108_cov_47.430347	4895	4963	207	1	68	0.0147059
NODE_27_length_9108_cov_47.430347	4895	4963	211	1	68	0.0147059
NODE_27_length_9108_cov_47.430347	4895	4963	217	1	68	0.0147059
NODE_27_length_9108_cov_47.430347	4895	4963	227	3	68	0.0441176
NODE_27_length_9108_cov_47.430347	4895	4963	229	1	68	0.0147059
NODE_27_length_9108_cov_47.430347	4895	4963	233	6	68	0.0882353
NODE_27_length_9108_cov_47.430347	4895	4963	234	1	68	0.0147059
NODE_27_length_9108_cov_47.430347	4895	4963	238	1	68	0.0147059
NODE_27_length_9108_cov_47.430347	4895	4963	239	1	68	0.0147059
NODE_27_length_9108_cov_47.430347	4895	4963	240	1	68	0.0147059
NODE_27_length_9108_cov_47.430347	4895	4963	246	1	68	0.0147059
NODE_27_length_9108_cov_47.430347	4895	4963	255	1	68	0.0147059
NODE_27_length_9108_cov_47.430347	4895	4963	260	1	68	0.0147059
NODE_27_length_9108_cov_47.430347	4895	4963	261	7	68	0.1029412
NODE_27_length_9108_cov_47.430347	4895	4963	262	1	68	0.0147059
NODE_27_length_9108_cov_47.430347	4895	4963	266	1	68	0.0147059
NODE_27_length_9108_cov_47.430347	4895	4963	267	5	68	0.0735294
NODE_27_length_9108_cov_47.430347	4895	4963	268	2	68	0.0294118
NODE_27_length_9108_cov_47.430347	4895	4963	269	10	68	0.1470588
NODE_27_length_9108_cov_47.430347	4895	4963	270	3	68	0.0441176
NODE_27_length_9108_cov_47.430347	4895	4963	271	1	68	0.0147059
NODE_27_length_9108_cov_47.430347	4895	4963	272	4	68	0.0588235
NODE_27_length_9108_cov_47.430347	4895	4963	273	2	68	0.0294118
NODE_27_length_9108_cov_47.430347	4895	4963	274	1	68	0.0147059
NODE_27_length_9108_cov_47.430347	4895	4963	275	1	68	0.0147059
NODE_27_length_9108_cov_47.430347	4936	5016	39	2	80	0.0250000
NODE_27_length_9108_cov_47.430347	4936	5016	43	1	80	0.0125000
NODE_27_length_9108_cov_47.430347	4936	5016	48	1	80	0.0125000
NODE_27_length_9108_cov_47.430347	4936	5016	50	1	80	0.0125000
NODE_27_length_9108_cov_47.430347	4936	5016	56	1	80	0.0125000
NODE_27_length_9108_cov_47.430347	4936	5016	60	1	80	0.0125000
NODE_27_length_9108_cov_47.430347	4936	5016	63	2	80	0.0250000
NODE_27_length_9108_cov_47.430347	4936	5016	67	1	80	0.0125000
NODE_27_length_9108_cov_47.430347	4936	5016	68	1	80	0.0125000
NODE_27_length_9108_cov_47.430347	4936	5016	72	1	80	0.0125000
NODE_27_length_9108_cov_47.430347	4936	5016	75	4	80	0.0500000
NODE_27_length_9108_cov_47.430347	4936	5016	81	1	80	0.0125000
NODE_27_length_9108_cov_47.430347	4936	5016	87	1	80	0.0125000
NODE_27_length_9108_cov_47.430347	4936	5016	94	2	80	0.0250000
NODE_27_length_9108_cov_47.430347	4936	5016	97	1	80	0.0125000
NODE_27_length_9108_cov_47.430347	4936	5016	100	1	80	0.0125000
NODE_27_length_9108_cov_47.430347	4936	5016	106	2	80	0.0250000
NODE_27_length_9108_cov_47.430347	4936	5016	109	1	80	0.0125000
NODE_27_length_9108_cov_47.430347	4936	5016	113	1	80	0.0125000
NODE_27_length_9108_cov_47.430347	4936	5016	119	2	80	0.0250000
NODE_27_length_9108_cov_47.430347	4936	5016	121	1	80	0.0125000
NODE_27_length_9108_cov_47.430347	4936	5016	125	1	80	0.0125000
NODE_27_length_9108_cov_47.430347	4936	5016	127	1	80	0.0125000
NODE_27_length_9108_cov_47.430347	4936	5016	130	2	80	0.0250000
NODE_27_length_9108_cov_47.430347	4936	5016	135	2	80	0.0250000
NODE_27_length_9108_cov_47.430347	4936	5016	142	1	80	0.0125000
NODE_27_length_9108_cov_47.430347	4936	5016	149	1	80	0.0125000
NODE_27_length_9108_cov_47.430347	4936	5016	150	1	80	0.0125000
NODE_27_length_9108_cov_47.430347	4936	5016	156	1	80	0.0125000
NODE_27_length_9108_cov_47.430347	4936	5016	159	2	80	0.0250000
NODE_27_length_9108_cov_47.430347	4936	5016	161	1	80	0.0125000
NODE_27_length_9108_cov_47.430347	4936	5016	167	1	80	0.0125000
NODE_27_length_9108_cov_47.430347	4936	5016	169	1	80	0.0125000
NODE_27_length_9108_cov_47.430347	4936	5016	170	1	80	0.0125000
NODE_27_length_9108_cov_47.430347	4936	5016	173	1	80	0.0125000
NODE_27_length_9108_cov_47.430347	4936	5016	175	1	80	0.0125000
NODE_27_length_9108_cov_47.430347	4936	5016	181	1	80	0.0125000
NODE_27_length_9108_cov_47.430347	4936	5016	183	2	80	0.0250000
NODE_27_length_9108_cov_47.430347	4936	5016	185	3	80	0.0375000
NODE_27_length_9108_cov_47.430347	4936	5016	189	1	80	0.0125000
NODE_27_length_9108_cov_47.430347	4936	5016	201	1	80	0.0125000
NODE_27_length_9108_cov_47.430347	4936	5016	202	6	80	0.0750000
NODE_27_length_9108_cov_47.430347	4936	5016	205	2	80	0.0250000
NODE_27_length_9108_cov_47.430347	4936	5016	207	1	80	0.0125000
NODE_27_length_9108_cov_47.430347	4936	5016	211	1	80	0.0125000
NODE_27_length_9108_cov_47.430347	4936	5016	217	1	80	0.0125000
NODE_27_length_9108_cov_47.430347	4936	5016	227	3	80	0.0375000
NODE_27_length_9108_cov_47.430347	4936	5016	229	1	80	0.0125000
NODE_27_length_9108_cov_47.430347	4936	5016	233	6	80	0.0750000
NODE_27_length_9108_cov_47.430347	4936	5016	234	1	80	0.0125000
NODE_27_length_9108_cov_47.430347	4936	5016	238	1	80	0.0125000
NODE_27_length_9108_cov_47.430347	4936	5016	239	1	80	0.0125000
NODE_27_length_9108_cov_47.430347	4936	5016	240	1	80	0.0125000
NODE_28_length_9108_cov_26.469974	44	120	0	76	76	1.0000000
NODE_28_length_9108_cov_26.469974	7711	7791	0	1	80	0.0125000
NODE_28_length_9108_cov_26.469974	7711	7791	15	1	80	0.0125000
NODE_28_length_9108_cov_26.469974	7711	7791	17	20	80	0.2500000
NODE_28_length_9108_cov_26.469974	7711	7791	18	1	80	0.0125000
NODE_28_length_9108_cov_26.469974	7711	7791	21	5	80	0.0625000
NODE_28_length_9108_cov_26.469974	7711	7791	23	1	80	0.0125000
NODE_28_length_9108_cov_26.469974	7711	7791	29	1	80	0.0125000
NODE_28_length_9108_cov_26.469974	7711	7791	36	1	80	0.0125000
NODE_28_length_9108_cov_26.469974	7711	7791	40	1	80	0.0125000
NODE_28_length_9108_cov_26.469974	7711	7791	42	3	80	0.0375000
NODE_28_length_9108_cov_26.469974	7711	7791	44	5	80	0.0625000
NODE_28_length_9108_cov_26.469974	7711	7791	45	1	80	0.0125000
NODE_28_length_9108_cov_26.469974	7711	7791	47	4	80	0.0500000
NODE_28_length_9108_cov_26.469974	7711	7791	51	2	80	0.0250000
NODE_28_length_9108_cov_26.469974	7711	7791	52	1	80	0.0125000
NODE_28_length_9108_cov_26.469974	7711	7791	54	3	80	0.0375000
NODE_28_length_9108_cov_26.469974	7711	7791	55	3	80	0.0375000
NODE_28_length_9108_cov_26.469974	7711	7791	57	2	80	0.0250000
NODE_28_length_9108_cov_26.469974	7711	7791	60	2	80	0.0250000
NODE_28_length_9108_cov_26.469974	7711	7791	64	1	80	0.0125000
NODE_28_length_9108_cov_26.469974	7711	7791	66	1	80	0.0125000
NODE_28_length_9108_cov_26.469974	7711	7791	67	1	80	0.0125000
NODE_28_length_9108_cov_26.469974	7711	7791	68	1	80	0.0125000
NODE_28_length_9108_cov_26.469974	7711	7791	72	2	80	0.0250000
NODE_28_length_9108_cov_26.469974	7711	7791	80	1	80	0.0125000
NODE_28_length_9108_cov_26.469974	7711	7791	82	2	80	0.0250000
NODE_28_length_9108_cov_26.469974	7711	7791	84	1	80	0.0125000
NODE_28_length_9108_cov_26.469974	7711	7791	86	4	80	0.0500000
NODE_28_length_9108_cov_26.469974	7711	7791	88	1	80	0.0125000
NODE_28_length_9108_cov_26.469974	7711	7791	89	1	80	0.0125000
NODE_28_length_9108_cov_26.469974	7711	7791	91	1	80	0.0125000
NODE_28_length_9108_cov_26.469974	7711	7791	93	2	80	0.0250000
NODE_28_length_9108_cov_26.469974	7711	7791	96	2	80	0.0250000
NODE_28_length_9108_cov_26.469974	7711	7791	99	1	80	0.0125000
NODE_28_length_9108_cov_26.469974	8144	8224	4	1	80	0.0125000
NODE_28_length_9108_cov_26.469974	8144	8224	18	2	80	0.0250000
NODE_28_length_9108_cov_26.469974	8144	8224	20	5	80	0.0625000
NODE_28_length_9108_cov_26.469974	8144	8224	22	1	80	0.0125000
NODE_28_length_9108_cov_26.469974	8144	8224	28	1	80	0.0125000
NODE_28_length_9108_cov_26.469974	8144	8224	30	3	80	0.0375000
NODE_28_length_9108_cov_26.469974	8144	8224	32	1	80	0.0125000
NODE_28_length_9108_cov_26.469974	8144	8224	34	1	80	0.0125000
NODE_28_length_9108_cov_26.469974	8144	8224	36	1	80	0.0125000
NODE_28_length_9108_cov_26.469974	8144	8224	37	1	80	0.0125000
NODE_28_length_9108_cov_26.469974	8144	8224	38	1	80	0.0125000
NODE_28_length_9108_cov_26.469974	8144	8224	40	2	80	0.0250000
NODE_28_length_9108_cov_26.469974	8144	8224	42	3	80	0.0375000
NODE_28_length_9108_cov_26.469974	8144	8224	50	1	80	0.0125000
NODE_28_length_9108_cov_26.469974	8144	8224	54	1	80	0.0125000
NODE_28_length_9108_cov_26.469974	8144	8224	56	1	80	0.0125000
NODE_28_length_9108_cov_26.469974	8144	8224	58	3	80	0.0375000
NODE_28_length_9108_cov_26.469974	8144	8224	60	6	80	0.0750000
NODE_28_length_9108_cov_26.469974	8144	8224	62	4	80	0.0500000
NODE_28_length_9108_cov_26.469974	8144	8224	64	2	80	0.0250000
NODE_28_length_9108_cov_26.469974	8144	8224	66	2	80	0.0250000
NODE_28_length_9108_cov_26.469974	8144	8224	68	2	80	0.0250000
NODE_28_length_9108_cov_26.469974	8144	8224	70	3	80	0.0375000
NODE_28_length_9108_cov_26.469974	8144	8224	72	5	80	0.0625000
NODE_28_length_9108_cov_26.469974	8144	8224	74	2	80	0.0250000
NODE_28_length_9108_cov_26.469974	8144	8224	77	2	80	0.0250000
NODE_28_length_9108_cov_26.469974	8144	8224	79	2	80	0.0250000
NODE_28_length_9108_cov_26.469974	8144	8224	80	2	80	0.0250000
NODE_28_length_9108_cov_26.469974	8144	8224	82	3	80	0.0375000
NODE_28_length_9108_cov_26.469974	8144	8224	85	1	80	0.0125000
NODE_28_length_9108_cov_26.469974	8144	8224	87	3	80	0.0375000
NODE_28_length_9108_cov_26.469974	8144	8224	89	1	80	0.0125000
NODE_28_length_9108_cov_26.469974	8144	8224	91	2	80	0.0250000
NODE_28_length_9108_cov_26.469974	8144	8224	92	2	80	0.0250000
NODE_28_length_9108_cov_26.469974	8144	8224	96	3	80	0.0375000
NODE_28_length_9108_cov_26.469974	8144	8224	100	2	80	0.0250000
NODE_28_length_9108_cov_26.469974	8144	8224	104	2	80	0.0250000
NODE_28_length_9108_cov_26.469974	8568	8648	0	10	80	0.1250000
NODE_28_length_9108_cov_26.469974	8568	8648	1	43	80	0.5375000
NODE_28_length_9108_cov_26.469974	8568	8648	5	27	80	0.3375000
NODE_28_length_9108_cov_26.469974	8621	8701	5	80	80	1.0000000
NODE_30_length_8743_cov_14.172721	7849	7929	122	1	80	0.0125000
NODE_30_length_8743_cov_14.172721	7849	7929	124	1	80	0.0125000
NODE_30_length_8743_cov_14.172721	7849	7929	125	1	80	0.0125000
NODE_30_length_8743_cov_14.172721	7849	7929	127	1	80	0.0125000
NODE_30_length_8743_cov_14.172721	7849	7929	131	1	80	0.0125000
NODE_30_length_8743_cov_14.172721	7849	7929	133	1	80	0.0125000
NODE_30_length_8743_cov_14.172721	7849	7929	141	1	80	0.0125000
NODE_30_length_8743_cov_14.172721	7849	7929	148	1	80	0.0125000
NODE_30_length_8743_cov_14.172721	7849	7929	150	1	80	0.0125000
NODE_30_length_8743_cov_14.172721	7849	7929	154	2	80	0.0250000
NODE_30_length_8743_cov_14.172721	7849	7929	156	2	80	0.0250000
NODE_30_length_8743_cov_14.172721	7849	7929	159	1	80	0.0125000
NODE_30_length_8743_cov_14.172721	7849	7929	161	1	80	0.0125000
NODE_30_length_8743_cov_14.172721	7849	7929	168	1	80	0.0125000
NODE_30_length_8743_cov_14.172721	7849	7929	169	1	80	0.0125000
NODE_30_length_8743_cov_14.172721	7849	7929	178	2	80	0.0250000
NODE_30_length_8743_cov_14.172721	7849	7929	180	3	80	0.0375000
NODE_30_length_8743_cov_14.172721	7849	7929	184	1	80	0.0125000
NODE_30_length_8743_cov_14.172721	7849	7929	186	1	80	0.0125000
NODE_30_length_8743_cov_14.172721	7849	7929	187	4	80	0.0500000
NODE_30_length_8743_cov_14.172721	7849	7929	189	7	80	0.0875000
NODE_30_length_8743_cov_14.172721	7849	7929	196	3	80	0.0375000
NODE_30_length_8743_cov_14.172721	7849	7929	198	3	80	0.0375000
NODE_30_length_8743_cov_14.172721	7849	7929	204	2	80	0.0250000
NODE_30_length_8743_cov_14.172721	7849	7929	205	4	80	0.0500000
NODE_30_length_8743_cov_14.172721	7849	7929	207	1	80	0.0125000
NODE_30_length_8743_cov_14.172721	7849	7929	208	4	80	0.0500000
NODE_30_length_8743_cov_14.172721	7849	7929	210	1	80	0.0125000
NODE_30_length_8743_cov_14.172721	7849	7929	212	1	80	0.0125000
NODE_30_length_8743_cov_14.172721	7849	7929	215	4	80	0.0500000
NODE_30_length_8743_cov_14.172721	7849	7929	225	1	80	0.0125000
NODE_30_length_8743_cov_14.172721	7849	7929	227	3	80	0.0375000
NODE_30_length_8743_cov_14.172721	7849	7929	229	1	80	0.0125000
NODE_30_length_8743_cov_14.172721	7849	7929	231	4	80	0.0500000
NODE_30_length_8743_cov_14.172721	7849	7929	233	8	80	0.1000000
NODE_30_length_8743_cov_14.172721	7849	7929	234	1	80	0.0125000
NODE_30_length_8743_cov_14.172721	7849	7929	239	2	80	0.0250000
NODE_30_length_8743_cov_14.172721	7849	7929	241	1	80	0.0125000
NODE_30_length_8743_cov_14.172721	7849	7929	243	1	80	0.0125000
NODE_30_length_8743_cov_14.172721	7902	7964	40	8	62	0.1290323
NODE_30_length_8743_cov_14.172721	7902	7964	43	1	62	0.0161290
NODE_30_length_8743_cov_14.172721	7902	7964	45	1	62	0.0161290
NODE_30_length_8743_cov_14.172721	7902	7964	49	1	62	0.0161290
NODE_30_length_8743_cov_14.172721	7902	7964	55	1	62	0.0161290
NODE_30_length_8743_cov_14.172721	7902	7964	59	1	62	0.0161290
NODE_30_length_8743_cov_14.172721	7902	7964	71	1	62	0.0161290
NODE_30_length_8743_cov_14.172721	7902	7964	74	1	62	0.0161290
NODE_30_length_8743_cov_14.172721	7902	7964	78	3	62	0.0483871
NODE_30_length_8743_cov_14.172721	7902	7964	79	1	62	0.0161290
NODE_30_length_8743_cov_14.172721	7902	7964	82	2	62	0.0322581
NODE_30_length_8743_cov_14.172721	7902	7964	84	1	62	0.0161290
NODE_30_length_8743_cov_14.172721	7902	7964	88	3	62	0.0483871
NODE_30_length_8743_cov_14.172721	7902	7964	92	5	62	0.0806452
NODE_30_length_8743_cov_14.172721	7902	7964	100	1	62	0.0161290
NODE_30_length_8743_cov_14.172721	7902	7964	106	1	62	0.0161290
NODE_30_length_8743_cov_14.172721	7902	7964	118	2	62	0.0322581
NODE_30_length_8743_cov_14.172721	7902	7964	122	2	62	0.0322581
NODE_30_length_8743_cov_14.172721	7902	7964	124	1	62	0.0161290
NODE_30_length_8743_cov_14.172721	7902	7964	125	1	62	0.0161290
NODE_30_length_8743_cov_14.172721	7902	7964	127	1	62	0.0161290
NODE_30_length_8743_cov_14.172721	7902	7964	131	1	62	0.0161290
NODE_30_length_8743_cov_14.172721	7902	7964	133	1	62	0.0161290
NODE_30_length_8743_cov_14.172721	7902	7964	141	1	62	0.0161290
NODE_30_length_8743_cov_14.172721	7902	7964	148	1	62	0.0161290
NODE_30_length_8743_cov_14.172721	7902	7964	150	1	62	0.0161290
NODE_30_length_8743_cov_14.172721	7902	7964	154	2	62	0.0322581
NODE_30_length_8743_cov_14.172721	7902	7964	156	2	62	0.0322581
NODE_30_length_8743_cov_14.172721	7902	7964	159	1	62	0.0161290
NODE_30_length_8743_cov_14.172721	7902	7964	161	1	62	0.0161290
NODE_30_length_8743_cov_14.172721	7902	7964	168	1	62	0.0161290
NODE_30_length_8743_cov_14.172721	7902	7964	169	1	62	0.0161290
NODE_30_length_8743_cov_14.172721	7902	7964	178	2	62	0.0322581
NODE_30_length_8743_cov_14.172721	7902	7964	180	3	62	0.0483871
NODE_30_length_8743_cov_14.172721	7902	7964	184	1	62	0.0161290
NODE_30_length_8743_cov_14.172721	7902	7964	186	1	62	0.0161290
NODE_30_length_8743_cov_14.172721	7902	7964	187	3	62	0.0483871
NODE_32_length_8707_cov_6.353044	8541	8621	10	12	80	0.1500000
NODE_32_length_8707_cov_6.353044	8541	8621	12	2	80	0.0250000
NODE_32_length_8707_cov_6.353044	8541	8621	17	3	80	0.0375000
NODE_32_length_8707_cov_6.353044	8541	8621	21	1	80	0.0125000
NODE_32_length_8707_cov_6.353044	8541	8621	27	3	80	0.0375000
NODE_32_length_8707_cov_6.353044	8541	8621	30	1	80	0.0125000
NODE_32_length_8707_cov_6.353044	8541	8621	31	25	80	0.3125000
NODE_32_length_8707_cov_6.353044	8541	8621	33	4	80	0.0500000
NODE_32_length_8707_cov_6.353044	8541	8621	35	2	80	0.0250000
NODE_32_length_8707_cov_6.353044	8541	8621	37	8	80	0.1000000
NODE_32_length_8707_cov_6.353044	8541	8621	39	19	80	0.2375000
NODE_32_length_8707_cov_6.353044	8541	8621	10	12	80	0.1500000
NODE_32_length_8707_cov_6.353044	8541	8621	12	2	80	0.0250000
NODE_32_length_8707_cov_6.353044	8541	8621	17	3	80	0.0375000
NODE_32_length_8707_cov_6.353044	8541	8621	21	1	80	0.0125000
NODE_32_length_8707_cov_6.353044	8541	8621	27	3	80	0.0375000
NODE_32_length_8707_cov_6.353044	8541	8621	30	1	80	0.0125000
NODE_32_length_8707_cov_6.353044	8541	8621	31	25	80	0.3125000
NODE_32_length_8707_cov_6.353044	8541	8621	33	4	80	0.0500000
NODE_32_length_8707_cov_6.353044	8541	8621	35	2	80	0.0250000
NODE_32_length_8707_cov_6.353044	8541	8621	37	8	80	0.1000000
NODE_32_length_8707_cov_6.353044	8541	8621	39	19	80	0.2375000
NODE_32_length_8707_cov_6.353044	8541	8621	10	12	80	0.1500000
NODE_32_length_8707_cov_6.353044	8541	8621	12	2	80	0.0250000
NODE_32_length_8707_cov_6.353044	8541	8621	17	3	80	0.0375000
NODE_32_length_8707_cov_6.353044	8541	8621	21	1	80	0.0125000
NODE_32_length_8707_cov_6.353044	8541	8621	27	3	80	0.0375000
NODE_32_length_8707_cov_6.353044	8541	8621	30	1	80	0.0125000
NODE_32_length_8707_cov_6.353044	8541	8621	31	25	80	0.3125000
NODE_32_length_8707_cov_6.353044	8541	8621	33	4	80	0.0500000
NODE_32_length_8707_cov_6.353044	8541	8621	35	2	80	0.0250000
NODE_32_length_8707_cov_6.353044	8541	8621	37	8	80	0.1000000
NODE_32_length_8707_cov_6.353044	8541	8621	39	19	80	0.2375000
NODE_32_length_8707_cov_6.353044	8594	8674	22	10	80	0.1250000
NODE_32_length_8707_cov_6.353044	8594	8674	26	3	80	0.0375000
NODE_32_length_8707_cov_6.353044	8594	8674	29	29	80	0.3625000
NODE_32_length_8707_cov_6.353044	8594	8674	35	13	80	0.1625000
NODE_32_length_8707_cov_6.353044	8594	8674	37	6	80	0.0750000
NODE_32_length_8707_cov_6.353044	8594	8674	39	19	80	0.2375000
NODE_32_length_8707_cov_6.353044	8594	8674	22	10	80	0.1250000
NODE_32_length_8707_cov_6.353044	8594	8674	26	3	80	0.0375000
NODE_32_length_8707_cov_6.353044	8594	8674	29	29	80	0.3625000
NODE_32_length_8707_cov_6.353044	8594	8674	35	13	80	0.1625000
NODE_32_length_8707_cov_6.353044	8594	8674	37	6	80	0.0750000
NODE_32_length_8707_cov_6.353044	8594	8674	39	19	80	0.2375000
NODE_32_length_8707_cov_6.353044	8594	8673	22	9	79	0.1139240
NODE_32_length_8707_cov_6.353044	8594	8673	26	3	79	0.0379747
NODE_32_length_8707_cov_6.353044	8594	8673	29	29	79	0.3670886
NODE_32_length_8707_cov_6.353044	8594	8673	35	13	79	0.1645570
NODE_32_length_8707_cov_6.353044	8594	8673	37	6	79	0.0759494
NODE_32_length_8707_cov_6.353044	8594	8673	39	19	79	0.2405063
NODE_32_length_8707_cov_6.353044	8599	8674	22	10	75	0.1333333
NODE_32_length_8707_cov_6.353044	8599	8674	26	3	75	0.0400000
NODE_32_length_8707_cov_6.353044	8599	8674	29	29	75	0.3866667
NODE_32_length_8707_cov_6.353044	8599	8674	35	13	75	0.1733333
NODE_32_length_8707_cov_6.353044	8599	8674	37	1	75	0.0133333
NODE_32_length_8707_cov_6.353044	8599	8674	39	19	75	0.2533333
NODE_38_length_8281_cov_13.025177	7108	7188	0	21	80	0.2625000
NODE_38_length_8281_cov_13.025177	7108	7188	2	53	80	0.6625000
NODE_38_length_8281_cov_13.025177	7108	7188	4	6	80	0.0750000
NODE_38_length_8281_cov_13.025177	7161	7199	0	32	38	0.8421053
NODE_38_length_8281_cov_13.025177	7161	7199	2	6	38	0.1578947
NODE_38_length_8281_cov_13.025177	7175	7255	0	80	80	1.0000000
NODE_38_length_8281_cov_13.025177	7228	7308	0	80	80	1.0000000
NODE_38_length_8281_cov_13.025177	7749	7829	1	80	80	1.0000000
NODE_38_length_8281_cov_13.025177	7802	7882	0	32	80	0.4000000
NODE_38_length_8281_cov_13.025177	7802	7882	1	48	80	0.6000000
NODE_38_length_8281_cov_13.025177	7878	7958	0	80	80	1.0000000
NODE_38_length_8281_cov_13.025177	7931	8011	0	80	80	1.0000000
NODE_39_length_8259_cov_60.011152	1424	1504	0	80	80	1.0000000
NODE_39_length_8259_cov_60.011152	1477	1549	0	72	72	1.0000000
NODE_40_length_8228_cov_17.079592	314	394	2	16	80	0.2000000
NODE_40_length_8228_cov_17.079592	314	394	4	26	80	0.3250000
NODE_40_length_8228_cov_17.079592	314	394	6	38	80	0.4750000
NODE_40_length_8228_cov_17.079592	367	447	0	5	80	0.0625000
NODE_40_length_8228_cov_17.079592	367	447	4	17	80	0.2125000
NODE_40_length_8228_cov_17.079592	367	447	6	58	80	0.7250000
NODE_40_length_8228_cov_17.079592	443	523	0	64	80	0.8000000
NODE_40_length_8228_cov_17.079592	443	523	2	7	80	0.0875000
NODE_40_length_8228_cov_17.079592	443	523	4	9	80	0.1125000
NODE_40_length_8228_cov_17.079592	496	576	0	11	80	0.1375000
NODE_40_length_8228_cov_17.079592	496	576	2	7	80	0.0875000
NODE_40_length_8228_cov_17.079592	496	576	4	11	80	0.1375000
NODE_40_length_8228_cov_17.079592	496	576	6	51	80	0.6375000
NODE_40_length_8228_cov_17.079592	3154	3217	130	1	63	0.0158730
NODE_40_length_8228_cov_17.079592	3154	3217	318	1	63	0.0158730
NODE_40_length_8228_cov_17.079592	3154	3217	329	1	63	0.0158730
NODE_40_length_8228_cov_17.079592	3154	3217	339	1	63	0.0158730
NODE_40_length_8228_cov_17.079592	3154	3217	343	1	63	0.0158730
NODE_40_length_8228_cov_17.079592	3154	3217	349	1	63	0.0158730
NODE_40_length_8228_cov_17.079592	3154	3217	354	1	63	0.0158730
NODE_40_length_8228_cov_17.079592	3154	3217	360	1	63	0.0158730
NODE_40_length_8228_cov_17.079592	3154	3217	375	1	63	0.0158730
NODE_40_length_8228_cov_17.079592	3154	3217	403	1	63	0.0158730
NODE_40_length_8228_cov_17.079592	3154	3217	409	1	63	0.0158730
NODE_40_length_8228_cov_17.079592	3154	3217	410	1	63	0.0158730
NODE_40_length_8228_cov_17.079592	3154	3217	420	1	63	0.0158730
NODE_40_length_8228_cov_17.079592	3154	3217	421	1	63	0.0158730
NODE_40_length_8228_cov_17.079592	3154	3217	433	1	63	0.0158730
NODE_40_length_8228_cov_17.079592	3154	3217	439	1	63	0.0158730
NODE_40_length_8228_cov_17.079592	3154	3217	441	1	63	0.0158730
NODE_40_length_8228_cov_17.079592	3154	3217	445	2	63	0.0317460
NODE_40_length_8228_cov_17.079592	3154	3217	449	1	63	0.0158730
NODE_40_length_8228_cov_17.079592	3154	3217	457	2	63	0.0317460
NODE_40_length_8228_cov_17.079592	3154	3217	463	1	63	0.0158730
NODE_40_length_8228_cov_17.079592	3154	3217	465	1	63	0.0158730
NODE_40_length_8228_cov_17.079592	3154	3217	469	1	63	0.0158730
NODE_40_length_8228_cov_17.079592	3154	3217	483	1	63	0.0158730
NODE_40_length_8228_cov_17.079592	3154	3217	489	1	63	0.0158730
NODE_40_length_8228_cov_17.079592	3154	3217	501	1	63	0.0158730
NODE_40_length_8228_cov_17.079592	3154	3217	515	1	63	0.0158730
NODE_40_length_8228_cov_17.079592	3154	3217	531	1	63	0.0158730
NODE_40_length_8228_cov_17.079592	3154	3217	557	1	63	0.0158730
NODE_40_length_8228_cov_17.079592	3154	3217	567	1	63	0.0158730
NODE_40_length_8228_cov_17.079592	3154	3217	573	1	63	0.0158730
NODE_40_length_8228_cov_17.079592	3154	3217	590	1	63	0.0158730
NODE_40_length_8228_cov_17.079592	3154	3217	594	1	63	0.0158730
NODE_40_length_8228_cov_17.079592	3154	3217	609	1	63	0.0158730
NODE_40_length_8228_cov_17.079592	3154	3217	613	1	63	0.0158730
NODE_40_length_8228_cov_17.079592	3154	3217	621	1	63	0.0158730
NODE_40_length_8228_cov_17.079592	3154	3217	627	1	63	0.0158730
NODE_40_length_8228_cov_17.079592	3154	3217	629	1	63	0.0158730
NODE_40_length_8228_cov_17.079592	3154	3217	631	1	63	0.0158730
NODE_40_length_8228_cov_17.079592	3154	3217	633	2	63	0.0317460
NODE_40_length_8228_cov_17.079592	3154	3217	635	2	63	0.0317460
NODE_40_length_8228_cov_17.079592	3154	3217	639	3	63	0.0476190
NODE_40_length_8228_cov_17.079592	3154	3217	640	2	63	0.0317460
NODE_40_length_8228_cov_17.079592	3154	3217	644	3	63	0.0476190
NODE_40_length_8228_cov_17.079592	3154	3217	646	1	63	0.0158730
NODE_40_length_8228_cov_17.079592	3154	3217	652	1	63	0.0158730
NODE_40_length_8228_cov_17.079592	3154	3217	653	8	63	0.1269841
NODE_43_length_8100_cov_32.115236	501	581	19	27	80	0.3375000
NODE_43_length_8100_cov_32.115236	501	581	21	1	80	0.0125000
NODE_43_length_8100_cov_32.115236	501	581	23	2	80	0.0250000
NODE_43_length_8100_cov_32.115236	501	581	24	15	80	0.1875000
NODE_43_length_8100_cov_32.115236	501	581	28	3	80	0.0375000
NODE_43_length_8100_cov_32.115236	501	581	31	7	80	0.0875000
NODE_43_length_8100_cov_32.115236	501	581	32	3	80	0.0375000
NODE_43_length_8100_cov_32.115236	501	581	33	3	80	0.0375000
NODE_43_length_8100_cov_32.115236	501	581	34	19	80	0.2375000
NODE_43_length_8100_cov_32.115236	554	634	8	2	80	0.0250000
NODE_43_length_8100_cov_32.115236	554	634	10	2	80	0.0250000
NODE_43_length_8100_cov_32.115236	554	634	12	12	80	0.1500000
NODE_43_length_8100_cov_32.115236	554	634	14	6	80	0.0750000
NODE_43_length_8100_cov_32.115236	554	634	17	4	80	0.0500000
NODE_43_length_8100_cov_32.115236	554	634	19	7	80	0.0875000
NODE_43_length_8100_cov_32.115236	554	634	21	12	80	0.1500000
NODE_43_length_8100_cov_32.115236	554	634	23	1	80	0.0125000
NODE_43_length_8100_cov_32.115236	554	634	24	16	80	0.2000000
NODE_43_length_8100_cov_32.115236	554	634	28	3	80	0.0375000
NODE_43_length_8100_cov_32.115236	554	634	32	3	80	0.0375000
NODE_43_length_8100_cov_32.115236	554	634	34	12	80	0.1500000
NODE_43_length_8100_cov_32.115236	1383	1463	0	80	80	1.0000000
NODE_43_length_8100_cov_32.115236	1436	1516	0	80	80	1.0000000
NODE_43_length_8100_cov_32.115236	3391	3462	253	1	71	0.0140845
NODE_43_length_8100_cov_32.115236	3391	3462	274	1	71	0.0140845
NODE_43_length_8100_cov_32.115236	3391	3462	276	1	71	0.0140845
NODE_43_length_8100_cov_32.115236	3391	3462	277	1	71	0.0140845
NODE_43_length_8100_cov_32.115236	3391	3462	279	1	71	0.0140845
NODE_43_length_8100_cov_32.115236	3391	3462	284	1	71	0.0140845
NODE_43_length_8100_cov_32.115236	3391	3462	300	1	71	0.0140845
NODE_43_length_8100_cov_32.115236	3391	3462	301	2	71	0.0281690
NODE_43_length_8100_cov_32.115236	3391	3462	310	2	71	0.0281690
NODE_43_length_8100_cov_32.115236	3391	3462	316	1	71	0.0140845
NODE_43_length_8100_cov_32.115236	3391	3462	318	1	71	0.0140845
NODE_43_length_8100_cov_32.115236	3391	3462	328	1	71	0.0140845
NODE_43_length_8100_cov_32.115236	3391	3462	334	1	71	0.0140845
NODE_43_length_8100_cov_32.115236	3391	3462	338	1	71	0.0140845
NODE_43_length_8100_cov_32.115236	3391	3462	345	1	71	0.0140845
NODE_43_length_8100_cov_32.115236	3391	3462	356	1	71	0.0140845
NODE_43_length_8100_cov_32.115236	3391	3462	357	1	71	0.0140845
NODE_43_length_8100_cov_32.115236	3391	3462	379	1	71	0.0140845
NODE_43_length_8100_cov_32.115236	3391	3462	386	1	71	0.0140845
NODE_43_length_8100_cov_32.115236	3391	3462	393	1	71	0.0140845
NODE_43_length_8100_cov_32.115236	3391	3462	397	1	71	0.0140845
NODE_43_length_8100_cov_32.115236	3391	3462	399	1	71	0.0140845
NODE_43_length_8100_cov_32.115236	3391	3462	403	2	71	0.0281690
NODE_43_length_8100_cov_32.115236	3391	3462	405	4	71	0.0563380
NODE_43_length_8100_cov_32.115236	3391	3462	409	1	71	0.0140845
NODE_43_length_8100_cov_32.115236	3391	3462	410	1	71	0.0140845
NODE_43_length_8100_cov_32.115236	3391	3462	411	1	71	0.0140845
NODE_43_length_8100_cov_32.115236	3391	3462	412	1	71	0.0140845
NODE_43_length_8100_cov_32.115236	3391	3462	413	1	71	0.0140845
NODE_43_length_8100_cov_32.115236	3391	3462	415	1	71	0.0140845
NODE_43_length_8100_cov_32.115236	3391	3462	416	1	71	0.0140845
NODE_43_length_8100_cov_32.115236	3391	3462	423	5	71	0.0704225
NODE_43_length_8100_cov_32.115236	3391	3462	426	1	71	0.0140845
NODE_43_length_8100_cov_32.115236	3391	3462	428	1	71	0.0140845
NODE_43_length_8100_cov_32.115236	3391	3462	430	2	71	0.0281690
NODE_43_length_8100_cov_32.115236	3391	3462	431	1	71	0.0140845
NODE_43_length_8100_cov_32.115236	3391	3462	434	2	71	0.0281690
NODE_43_length_8100_cov_32.115236	3391	3462	436	2	71	0.0281690
NODE_43_length_8100_cov_32.115236	3391	3462	438	3	71	0.0422535
NODE_43_length_8100_cov_32.115236	3391	3462	440	2	71	0.0281690
NODE_43_length_8100_cov_32.115236	3391	3462	441	1	71	0.0140845
NODE_43_length_8100_cov_32.115236	3391	3462	444	1	71	0.0140845
NODE_43_length_8100_cov_32.115236	3391	3462	446	2	71	0.0281690
NODE_43_length_8100_cov_32.115236	3391	3462	447	1	71	0.0140845
NODE_43_length_8100_cov_32.115236	3391	3462	448	1	71	0.0140845
NODE_43_length_8100_cov_32.115236	3391	3462	463	1	71	0.0140845
NODE_43_length_8100_cov_32.115236	3391	3462	465	1	71	0.0140845
NODE_43_length_8100_cov_32.115236	3391	3462	466	1	71	0.0140845
NODE_43_length_8100_cov_32.115236	3391	3462	467	3	71	0.0422535
NODE_43_length_8100_cov_32.115236	3391	3462	468	1	71	0.0140845
NODE_43_length_8100_cov_32.115236	3391	3462	470	2	71	0.0281690
NODE_43_length_8100_cov_32.115236	3435	3483	129	1	48	0.0208333
NODE_43_length_8100_cov_32.115236	3435	3483	132	1	48	0.0208333
NODE_43_length_8100_cov_32.115236	3435	3483	136	1	48	0.0208333
NODE_43_length_8100_cov_32.115236	3435	3483	138	1	48	0.0208333
NODE_43_length_8100_cov_32.115236	3435	3483	140	1	48	0.0208333
NODE_43_length_8100_cov_32.115236	3435	3483	141	2	48	0.0416667
NODE_43_length_8100_cov_32.115236	3435	3483	155	1	48	0.0208333
NODE_43_length_8100_cov_32.115236	3435	3483	160	1	48	0.0208333
NODE_43_length_8100_cov_32.115236	3435	3483	170	1	48	0.0208333
NODE_43_length_8100_cov_32.115236	3435	3483	173	1	48	0.0208333
NODE_43_length_8100_cov_32.115236	3435	3483	178	1	48	0.0208333
NODE_43_length_8100_cov_32.115236	3435	3483	180	1	48	0.0208333
NODE_43_length_8100_cov_32.115236	3435	3483	181	1	48	0.0208333
NODE_43_length_8100_cov_32.115236	3435	3483	190	1	48	0.0208333
NODE_43_length_8100_cov_32.115236	3435	3483	192	1	48	0.0208333
NODE_43_length_8100_cov_32.115236	3435	3483	206	1	48	0.0208333
NODE_43_length_8100_cov_32.115236	3435	3483	217	1	48	0.0208333
NODE_43_length_8100_cov_32.115236	3435	3483	221	1	48	0.0208333
NODE_43_length_8100_cov_32.115236	3435	3483	238	1	48	0.0208333
NODE_43_length_8100_cov_32.115236	3435	3483	246	1	48	0.0208333
NODE_43_length_8100_cov_32.115236	3435	3483	253	1	48	0.0208333
NODE_43_length_8100_cov_32.115236	3435	3483	274	1	48	0.0208333
NODE_43_length_8100_cov_32.115236	3435	3483	276	1	48	0.0208333
NODE_43_length_8100_cov_32.115236	3435	3483	277	1	48	0.0208333
NODE_43_length_8100_cov_32.115236	3435	3483	279	1	48	0.0208333
NODE_43_length_8100_cov_32.115236	3435	3483	284	1	48	0.0208333
NODE_43_length_8100_cov_32.115236	3435	3483	300	1	48	0.0208333
NODE_43_length_8100_cov_32.115236	3435	3483	301	2	48	0.0416667
NODE_43_length_8100_cov_32.115236	3435	3483	310	2	48	0.0416667
NODE_43_length_8100_cov_32.115236	3435	3483	316	1	48	0.0208333
NODE_43_length_8100_cov_32.115236	3435	3483	318	1	48	0.0208333
NODE_43_length_8100_cov_32.115236	3435	3483	328	1	48	0.0208333
NODE_43_length_8100_cov_32.115236	3435	3483	334	1	48	0.0208333
NODE_43_length_8100_cov_32.115236	3435	3483	338	1	48	0.0208333
NODE_43_length_8100_cov_32.115236	3435	3483	345	1	48	0.0208333
NODE_43_length_8100_cov_32.115236	3435	3483	356	1	48	0.0208333
NODE_43_length_8100_cov_32.115236	3435	3483	357	1	48	0.0208333
NODE_43_length_8100_cov_32.115236	3435	3483	379	1	48	0.0208333
NODE_43_length_8100_cov_32.115236	3435	3483	386	1	48	0.0208333
NODE_43_length_8100_cov_32.115236	3435	3483	393	1	48	0.0208333
NODE_43_length_8100_cov_32.115236	3435	3483	397	1	48	0.0208333
NODE_43_length_8100_cov_32.115236	3435	3483	399	1	48	0.0208333
NODE_43_length_8100_cov_32.115236	3435	3483	403	2	48	0.0416667
NODE_43_length_8100_cov_32.115236	3435	3483	405	1	48	0.0208333
NODE_46_length_7962_cov_31.622790	6281	6363	352	1	82	0.0121951
NODE_46_length_7962_cov_31.622790	6281	6363	353	1	82	0.0121951
NODE_46_length_7962_cov_31.622790	6281	6363	354	1	82	0.0121951
NODE_46_length_7962_cov_31.622790	6281	6363	355	1	82	0.0121951
NODE_46_length_7962_cov_31.622790	6281	6363	356	1	82	0.0121951
NODE_46_length_7962_cov_31.622790	6281	6363	358	1	82	0.0121951
NODE_46_length_7962_cov_31.622790	6281	6363	359	1	82	0.0121951
NODE_46_length_7962_cov_31.622790	6281	6363	362	2	82	0.0243902
NODE_46_length_7962_cov_31.622790	6281	6363	364	1	82	0.0121951
NODE_46_length_7962_cov_31.622790	6281	6363	365	1	82	0.0121951
NODE_46_length_7962_cov_31.622790	6281	6363	366	1	82	0.0121951
NODE_46_length_7962_cov_31.622790	6281	6363	370	1	82	0.0121951
NODE_46_length_7962_cov_31.622790	6281	6363	371	1	82	0.0121951
NODE_46_length_7962_cov_31.622790	6281	6363	383	1	82	0.0121951
NODE_46_length_7962_cov_31.622790	6281	6363	384	1	82	0.0121951
NODE_46_length_7962_cov_31.622790	6281	6363	385	1	82	0.0121951
NODE_46_length_7962_cov_31.622790	6281	6363	386	2	82	0.0243902
NODE_46_length_7962_cov_31.622790	6281	6363	394	2	82	0.0243902
NODE_46_length_7962_cov_31.622790	6281	6363	408	1	82	0.0121951
NODE_46_length_7962_cov_31.622790	6281	6363	410	1	82	0.0121951
NODE_46_length_7962_cov_31.622790	6281	6363	421	4	82	0.0487805
NODE_46_length_7962_cov_31.622790	6281	6363	422	1	82	0.0121951
NODE_46_length_7962_cov_31.622790	6281	6363	426	1	82	0.0121951
NODE_46_length_7962_cov_31.622790	6281	6363	428	1	82	0.0121951
NODE_46_length_7962_cov_31.622790	6281	6363	429	1	82	0.0121951
NODE_46_length_7962_cov_31.622790	6281	6363	430	1	82	0.0121951
NODE_46_length_7962_cov_31.622790	6281	6363	431	1	82	0.0121951
NODE_46_length_7962_cov_31.622790	6281	6363	435	1	82	0.0121951
NODE_46_length_7962_cov_31.622790	6281	6363	437	2	82	0.0243902
NODE_46_length_7962_cov_31.622790	6281	6363	438	4	82	0.0487805
NODE_46_length_7962_cov_31.622790	6281	6363	439	1	82	0.0121951
NODE_46_length_7962_cov_31.622790	6281	6363	440	4	82	0.0487805
NODE_46_length_7962_cov_31.622790	6281	6363	441	3	82	0.0365854
NODE_46_length_7962_cov_31.622790	6281	6363	442	3	82	0.0365854
NODE_46_length_7962_cov_31.622790	6281	6363	443	3	82	0.0365854
NODE_46_length_7962_cov_31.622790	6281	6363	444	1	82	0.0121951
NODE_46_length_7962_cov_31.622790	6281	6363	445	3	82	0.0365854
NODE_46_length_7962_cov_31.622790	6281	6363	446	2	82	0.0243902
NODE_46_length_7962_cov_31.622790	6281	6363	447	1	82	0.0121951
NODE_46_length_7962_cov_31.622790	6281	6363	449	3	82	0.0365854
NODE_46_length_7962_cov_31.622790	6281	6363	451	2	82	0.0243902
NODE_46_length_7962_cov_31.622790	6281	6363	452	2	82	0.0243902
NODE_46_length_7962_cov_31.622790	6281	6363	457	2	82	0.0243902
NODE_46_length_7962_cov_31.622790	6281	6363	459	1	82	0.0121951
NODE_46_length_7962_cov_31.622790	6281	6363	460	1	82	0.0121951
NODE_46_length_7962_cov_31.622790	6281	6363	463	3	82	0.0365854
NODE_46_length_7962_cov_31.622790	6281	6363	464	2	82	0.0243902
NODE_46_length_7962_cov_31.622790	6281	6363	465	3	82	0.0365854
NODE_46_length_7962_cov_31.622790	6281	6363	466	2	82	0.0243902
NODE_47_length_7944_cov_12.238496	348	419	52	1	71	0.0140845
NODE_47_length_7944_cov_12.238496	348	419	53	9	71	0.1267606
NODE_47_length_7944_cov_12.238496	348	419	55	16	71	0.2253521
NODE_47_length_7944_cov_12.238496	348	419	56	4	71	0.0563380
NODE_47_length_7944_cov_12.238496	348	419	60	22	71	0.3098592
NODE_47_length_7944_cov_12.238496	348	419	64	3	71	0.0422535
NODE_47_length_7944_cov_12.238496	348	419	65	9	71	0.1267606
NODE_47_length_7944_cov_12.238496	348	419	66	7	71	0.0985916
NODE_48_length_7919_cov_14.554859	2380	2460	0	30	80	0.3750000
NODE_48_length_7919_cov_14.554859	2380	2460	2	50	80	0.6250000
NODE_50_length_7830_cov_4.211098	0	52	0	20	52	0.3846154
NODE_50_length_7830_cov_4.211098	0	52	2	1	52	0.0192308
NODE_50_length_7830_cov_4.211098	0	52	4	10	52	0.1923077
NODE_50_length_7830_cov_4.211098	0	52	8	21	52	0.4038461
NODE_50_length_7830_cov_4.211098	30	105	4	1	75	0.0133333
NODE_50_length_7830_cov_4.211098	30	105	8	74	75	0.9866667
NODE_52_length_7779_cov_20.230859	7691	7771	0	80	80	1.0000000
NODE_52_length_7779_cov_20.230859	7691	7771	0	80	80	1.0000000
NODE_52_length_7779_cov_20.230859	7691	7761	0	70	70	1.0000000
NODE_52_length_7779_cov_20.230859	7744	7779	0	35	35	1.0000000
NODE_53_length_7765_cov_18.871119	254	322	36	2	68	0.0294118
NODE_53_length_7765_cov_18.871119	254	322	37	3	68	0.0441176
NODE_53_length_7765_cov_18.871119	254	322	40	1	68	0.0147059
NODE_53_length_7765_cov_18.871119	254	322	42	1	68	0.0147059
NODE_53_length_7765_cov_18.871119	254	322	45	1	68	0.0147059
NODE_53_length_7765_cov_18.871119	254	322	48	1	68	0.0147059
NODE_53_length_7765_cov_18.871119	254	322	51	1	68	0.0147059
NODE_53_length_7765_cov_18.871119	254	322	57	1	68	0.0147059
NODE_53_length_7765_cov_18.871119	254	322	61	1	68	0.0147059
NODE_53_length_7765_cov_18.871119	254	322	67	1	68	0.0147059
NODE_53_length_7765_cov_18.871119	254	322	71	1	68	0.0147059
NODE_53_length_7765_cov_18.871119	254	322	77	1	68	0.0147059
NODE_53_length_7765_cov_18.871119	254	322	81	1	68	0.0147059
NODE_53_length_7765_cov_18.871119	254	322	82	1	68	0.0147059
NODE_53_length_7765_cov_18.871119	254	322	85	1	68	0.0147059
NODE_53_length_7765_cov_18.871119	254	322	87	1	68	0.0147059
NODE_53_length_7765_cov_18.871119	254	322	89	2	68	0.0294118
NODE_53_length_7765_cov_18.871119	254	322	91	2	68	0.0294118
NODE_53_length_7765_cov_18.871119	254	322	93	1	68	0.0147059
NODE_53_length_7765_cov_18.871119	254	322	95	1	68	0.0147059
NODE_53_length_7765_cov_18.871119	254	322	98	1	68	0.0147059
NODE_53_length_7765_cov_18.871119	254	322	99	1	68	0.0147059
NODE_53_length_7765_cov_18.871119	254	322	100	2	68	0.0294118
NODE_53_length_7765_cov_18.871119	254	322	103	1	68	0.0147059
NODE_53_length_7765_cov_18.871119	254	322	105	4	68	0.0588235
NODE_53_length_7765_cov_18.871119	254	322	115	1	68	0.0147059
NODE_53_length_7765_cov_18.871119	254	322	116	1	68	0.0147059
NODE_53_length_7765_cov_18.871119	254	322	118	2	68	0.0294118
NODE_53_length_7765_cov_18.871119	254	322	120	1	68	0.0147059
NODE_53_length_7765_cov_18.871119	254	322	122	4	68	0.0588235
NODE_53_length_7765_cov_18.871119	254	322	123	14	68	0.2058824
NODE_53_length_7765_cov_18.871119	254	322	124	2	68	0.0294118
NODE_53_length_7765_cov_18.871119	254	322	125	1	68	0.0147059
NODE_53_length_7765_cov_18.871119	254	322	126	2	68	0.0294118
NODE_53_length_7765_cov_18.871119	254	322	127	4	68	0.0588235
NODE_53_length_7765_cov_18.871119	254	322	134	1	68	0.0147059
NODE_53_length_7765_cov_18.871119	254	322	141	1	68	0.0147059
NODE_53_length_7765_cov_18.871119	353	433	43	1	80	0.0125000
NODE_53_length_7765_cov_18.871119	353	433	45	2	80	0.0250000
NODE_53_length_7765_cov_18.871119	353	433	47	4	80	0.0500000
NODE_53_length_7765_cov_18.871119	353	433	51	1	80	0.0125000
NODE_53_length_7765_cov_18.871119	353	433	55	5	80	0.0625000
NODE_53_length_7765_cov_18.871119	353	433	57	1	80	0.0125000
NODE_53_length_7765_cov_18.871119	353	433	59	2	80	0.0250000
NODE_53_length_7765_cov_18.871119	353	433	61	3	80	0.0375000
NODE_53_length_7765_cov_18.871119	353	433	63	1	80	0.0125000
NODE_53_length_7765_cov_18.871119	353	433	65	1	80	0.0125000
NODE_53_length_7765_cov_18.871119	353	433	66	1	80	0.0125000
NODE_53_length_7765_cov_18.871119	353	433	69	2	80	0.0250000
NODE_53_length_7765_cov_18.871119	353	433	71	3	80	0.0375000
NODE_53_length_7765_cov_18.871119	353	433	75	1	80	0.0125000
NODE_53_length_7765_cov_18.871119	353	433	77	1	80	0.0125000
NODE_53_length_7765_cov_18.871119	353	433	79	3	80	0.0375000
NODE_53_length_7765_cov_18.871119	353	433	81	1	80	0.0125000
NODE_53_length_7765_cov_18.871119	353	433	84	1	80	0.0125000
NODE_53_length_7765_cov_18.871119	353	433	85	2	80	0.0250000
NODE_53_length_7765_cov_18.871119	353	433	87	2	80	0.0250000
NODE_53_length_7765_cov_18.871119	353	433	89	2	80	0.0250000
NODE_53_length_7765_cov_18.871119	353	433	91	1	80	0.0125000
NODE_53_length_7765_cov_18.871119	353	433	96	2	80	0.0250000
NODE_53_length_7765_cov_18.871119	353	433	101	4	80	0.0500000
NODE_53_length_7765_cov_18.871119	353	433	103	1	80	0.0125000
NODE_53_length_7765_cov_18.871119	353	433	105	1	80	0.0125000
NODE_53_length_7765_cov_18.871119	353	433	107	4	80	0.0500000
NODE_53_length_7765_cov_18.871119	353	433	116	1	80	0.0125000
NODE_53_length_7765_cov_18.871119	353	433	119	2	80	0.0250000
NODE_53_length_7765_cov_18.871119	353	433	133	1	80	0.0125000
NODE_53_length_7765_cov_18.871119	353	433	137	2	80	0.0250000
NODE_53_length_7765_cov_18.871119	353	433	139	1	80	0.0125000
NODE_53_length_7765_cov_18.871119	353	433	141	6	80	0.0750000
NODE_53_length_7765_cov_18.871119	353	433	143	3	80	0.0375000
NODE_53_length_7765_cov_18.871119	353	433	145	7	80	0.0875000
NODE_53_length_7765_cov_18.871119	353	433	146	1	80	0.0125000
NODE_53_length_7765_cov_18.871119	353	433	147	3	80	0.0375000
NODE_61_length_7411_cov_74.967314	2283	2347	0	64	64	1.0000000
NODE_61_length_7411_cov_74.967314	4725	4789	0	64	64	1.0000000
NODE_64_length_7305_cov_3.696087	971	1019	0	5	48	0.1041667
NODE_64_length_7305_cov_3.696087	971	1019	4	31	48	0.6458333
NODE_64_length_7305_cov_3.696087	971	1019	6	3	48	0.0625000
NODE_64_length_7305_cov_3.696087	971	1019	12	3	48	0.0625000
NODE_64_length_7305_cov_3.696087	971	1019	13	6	48	0.1250000
NODE_64_length_7305_cov_3.696087	7142	7190	0	13	48	0.2708333
NODE_64_length_7305_cov_3.696087	7142	7190	2	12	48	0.2500000
NODE_64_length_7305_cov_3.696087	7142	7190	4	23	48	0.4791667
NODE_66_length_7261_cov_12.433398	2313	2395	124	1	82	0.0121951
NODE_66_length_7261_cov_12.433398	2313	2395	126	1	82	0.0121951
NODE_66_length_7261_cov_12.433398	2313	2395	129	1	82	0.0121951
NODE_66_length_7261_cov_12.433398	2313	2395	131	4	82	0.0487805
NODE_66_length_7261_cov_12.433398	2313	2395	132	3	82	0.0365854
NODE_66_length_7261_cov_12.433398	2313	2395	133	1	82	0.0121951
NODE_66_length_7261_cov_12.433398	2313	2395	134	6	82	0.0731707
NODE_66_length_7261_cov_12.433398	2313	2395	135	5	82	0.0609756
NODE_66_length_7261_cov_12.433398	2313	2395	136	3	82	0.0365854
NODE_66_length_7261_cov_12.433398	2313	2395	137	4	82	0.0487805
NODE_66_length_7261_cov_12.433398	2313	2395	138	2	82	0.0243902
NODE_66_length_7261_cov_12.433398	2313	2395	139	1	82	0.0121951
NODE_66_length_7261_cov_12.433398	2313	2395	140	1	82	0.0121951
NODE_66_length_7261_cov_12.433398	2313	2395	143	2	82	0.0243902
NODE_66_length_7261_cov_12.433398	2313	2395	144	2	82	0.0243902
NODE_66_length_7261_cov_12.433398	2313	2395	145	2	82	0.0243902
NODE_66_length_7261_cov_12.433398	2313	2395	150	1	82	0.0121951
NODE_66_length_7261_cov_12.433398	2313	2395	153	3	82	0.0365854
NODE_66_length_7261_cov_12.433398	2313	2395	154	1	82	0.0121951
NODE_66_length_7261_cov_12.433398	2313	2395	155	3	82	0.0365854
NODE_66_length_7261_cov_12.433398	2313	2395	166	1	82	0.0121951
NODE_66_length_7261_cov_12.433398	2313	2395	167	1	82	0.0121951
NODE_66_length_7261_cov_12.433398	2313	2395	171	1	82	0.0121951
NODE_66_length_7261_cov_12.433398	2313	2395	173	2	82	0.0243902
NODE_66_length_7261_cov_12.433398	2313	2395	177	1	82	0.0121951
NODE_66_length_7261_cov_12.433398	2313	2395	181	1	82	0.0121951
NODE_66_length_7261_cov_12.433398	2313	2395	187	1	82	0.0121951
NODE_66_length_7261_cov_12.433398	2313	2395	191	1	82	0.0121951
NODE_66_length_7261_cov_12.433398	2313	2395	207	1	82	0.0121951
NODE_66_length_7261_cov_12.433398	2313	2395	209	1	82	0.0121951
NODE_66_length_7261_cov_12.433398	2313	2395	211	1	82	0.0121951
NODE_66_length_7261_cov_12.433398	2313	2395	214	1	82	0.0121951
NODE_66_length_7261_cov_12.433398	2313	2395	216	1	82	0.0121951
NODE_66_length_7261_cov_12.433398	2313	2395	218	1	82	0.0121951
NODE_66_length_7261_cov_12.433398	2313	2395	220	1	82	0.0121951
NODE_66_length_7261_cov_12.433398	2313	2395	222	1	82	0.0121951
NODE_66_length_7261_cov_12.433398	2313	2395	228	4	82	0.0487805
NODE_66_length_7261_cov_12.433398	2313	2395	229	3	82	0.0365854
NODE_66_length_7261_cov_12.433398	2313	2395	230	1	82	0.0121951
NODE_66_length_7261_cov_12.433398	2313	2395	231	1	82	0.0121951
NODE_66_length_7261_cov_12.433398	2313	2395	232	2	82	0.0243902
NODE_66_length_7261_cov_12.433398	2313	2395	235	1	82	0.0121951
NODE_66_length_7261_cov_12.433398	2313	2395	238	1	82	0.0121951
NODE_66_length_7261_cov_12.433398	2313	2395	242	1	82	0.0121951
NODE_66_length_7261_cov_12.433398	2313	2395	243	1	82	0.0121951
NODE_66_length_7261_cov_12.433398	2313	2395	244	1	82	0.0121951
NODE_66_length_7261_cov_12.433398	2313	2395	248	1	82	0.0121951
NODE_66_length_7261_cov_12.433398	2313	2395	254	1	82	0.0121951
NODE_73_length_7036_cov_65.961943	4375	4455	6	2	80	0.0250000
NODE_73_length_7036_cov_65.961943	4375	4455	8	7	80	0.0875000
NODE_73_length_7036_cov_65.961943	4375	4455	10	2	80	0.0250000
NODE_73_length_7036_cov_65.961943	4375	4455	11	12	80	0.1500000
NODE_73_length_7036_cov_65.961943	4375	4455	12	23	80	0.2875000
NODE_73_length_7036_cov_65.961943	4375	4455	14	6	80	0.0750000
NODE_73_length_7036_cov_65.961943	4375	4455	15	10	80	0.1250000
NODE_73_length_7036_cov_65.961943	4375	4455	16	18	80	0.2250000
NODE_73_length_7036_cov_65.961943	5538	5618	324	1	80	0.0125000
NODE_73_length_7036_cov_65.961943	5538	5618	326	1	80	0.0125000
NODE_73_length_7036_cov_65.961943	5538	5618	358	1	80	0.0125000
NODE_73_length_7036_cov_65.961943	5538	5618	359	1	80	0.0125000
NODE_73_length_7036_cov_65.961943	5538	5618	365	1	80	0.0125000
NODE_73_length_7036_cov_65.961943	5538	5618	370	1	80	0.0125000
NODE_73_length_7036_cov_65.961943	5538	5618	377	1	80	0.0125000
NODE_73_length_7036_cov_65.961943	5538	5618	400	1	80	0.0125000
NODE_73_length_7036_cov_65.961943	5538	5618	412	1	80	0.0125000
NODE_73_length_7036_cov_65.961943	5538	5618	434	1	80	0.0125000
NODE_73_length_7036_cov_65.961943	5538	5618	451	1	80	0.0125000
NODE_73_length_7036_cov_65.961943	5538	5618	462	1	80	0.0125000
NODE_73_length_7036_cov_65.961943	5538	5618	479	1	80	0.0125000
NODE_73_length_7036_cov_65.961943	5538	5618	491	1	80	0.0125000
NODE_73_length_7036_cov_65.961943	5538	5618	504	1	80	0.0125000
NODE_73_length_7036_cov_65.961943	5538	5618	508	1	80	0.0125000
NODE_73_length_7036_cov_65.961943	5538	5618	527	1	80	0.0125000
NODE_73_length_7036_cov_65.961943	5538	5618	529	1	80	0.0125000
NODE_73_length_7036_cov_65.961943	5538	5618	530	1	80	0.0125000
NODE_73_length_7036_cov_65.961943	5538	5618	544	1	80	0.0125000
NODE_73_length_7036_cov_65.961943	5538	5618	550	1	80	0.0125000
NODE_73_length_7036_cov_65.961943	5538	5618	556	1	80	0.0125000
NODE_73_length_7036_cov_65.961943	5538	5618	558	2	80	0.0250000
NODE_73_length_7036_cov_65.961943	5538	5618	562	1	80	0.0125000
NODE_73_length_7036_cov_65.961943	5538	5618	578	1	80	0.0125000
NODE_73_length_7036_cov_65.961943	5538	5618	582	1	80	0.0125000
NODE_73_length_7036_cov_65.961943	5538	5618	587	1	80	0.0125000
NODE_73_length_7036_cov_65.961943	5538	5618	601	1	80	0.0125000
NODE_73_length_7036_cov_65.961943	5538	5618	605	1	80	0.0125000
NODE_73_length_7036_cov_65.961943	5538	5618	616	2	80	0.0250000
NODE_73_length_7036_cov_65.961943	5538	5618	621	1	80	0.0125000
NODE_73_length_7036_cov_65.961943	5538	5618	625	1	80	0.0125000
NODE_73_length_7036_cov_65.961943	5538	5618	644	1	80	0.0125000
NODE_73_length_7036_cov_65.961943	5538	5618	666	1	80	0.0125000
NODE_73_length_7036_cov_65.961943	5538	5618	674	1	80	0.0125000
NODE_73_length_7036_cov_65.961943	5538	5618	678	1	80	0.0125000
NODE_73_length_7036_cov_65.961943	5538	5618	685	1	80	0.0125000
NODE_73_length_7036_cov_65.961943	5538	5618	695	1	80	0.0125000
NODE_73_length_7036_cov_65.961943	5538	5618	710	1	80	0.0125000
NODE_73_length_7036_cov_65.961943	5538	5618	717	1	80	0.0125000
NODE_73_length_7036_cov_65.961943	5538	5618	721	1	80	0.0125000
NODE_73_length_7036_cov_65.961943	5538	5618	726	1	80	0.0125000
NODE_73_length_7036_cov_65.961943	5538	5618	730	1	80	0.0125000
NODE_73_length_7036_cov_65.961943	5538	5618	731	1	80	0.0125000
NODE_73_length_7036_cov_65.961943	5538	5618	736	1	80	0.0125000
NODE_73_length_7036_cov_65.961943	5538	5618	737	1	80	0.0125000
NODE_73_length_7036_cov_65.961943	5538	5618	738	1	80	0.0125000
NODE_73_length_7036_cov_65.961943	5538	5618	750	1	80	0.0125000
NODE_73_length_7036_cov_65.961943	5538	5618	756	1	80	0.0125000
NODE_73_length_7036_cov_65.961943	5538	5618	758	1	80	0.0125000
NODE_73_length_7036_cov_65.961943	5538	5618	761	1	80	0.0125000
NODE_73_length_7036_cov_65.961943	5538	5618	768	1	80	0.0125000
NODE_73_length_7036_cov_65.961943	5538	5618	770	1	80	0.0125000
NODE_73_length_7036_cov_65.961943	5538	5618	787	1	80	0.0125000
NODE_73_length_7036_cov_65.961943	5538	5618	798	1	80	0.0125000
NODE_73_length_7036_cov_65.961943	5538	5618	810	1	80	0.0125000
NODE_73_length_7036_cov_65.961943	5538	5618	817	1	80	0.0125000
NODE_73_length_7036_cov_65.961943	5538	5618	819	1	80	0.0125000
NODE_73_length_7036_cov_65.961943	5538	5618	825	1	80	0.0125000
NODE_73_length_7036_cov_65.961943	5538	5618	831	1	80	0.0125000
NODE_73_length_7036_cov_65.961943	5538	5618	835	1	80	0.0125000
NODE_73_length_7036_cov_65.961943	5538	5618	845	1	80	0.0125000
NODE_73_length_7036_cov_65.961943	5538	5618	857	1	80	0.0125000
NODE_73_length_7036_cov_65.961943	5538	5618	864	1	80	0.0125000
NODE_73_length_7036_cov_65.961943	5538	5618	868	1	80	0.0125000
NODE_73_length_7036_cov_65.961943	5538	5618	874	1	80	0.0125000
NODE_73_length_7036_cov_65.961943	5538	5618	882	1	80	0.0125000
NODE_73_length_7036_cov_65.961943	5538	5618	883	1	80	0.0125000
NODE_73_length_7036_cov_65.961943	5538	5618	885	2	80	0.0250000
NODE_73_length_7036_cov_65.961943	5538	5618	890	1	80	0.0125000
NODE_73_length_7036_cov_65.961943	5538	5618	899	2	80	0.0250000
NODE_73_length_7036_cov_65.961943	5538	5618	900	1	80	0.0125000
NODE_73_length_7036_cov_65.961943	5538	5618	902	1	80	0.0125000
NODE_73_length_7036_cov_65.961943	5538	5618	907	2	80	0.0250000
NODE_73_length_7036_cov_65.961943	5538	5618	911	1	80	0.0125000
NODE_73_length_7036_cov_65.961943	5591	5666	768	1	75	0.0133333
NODE_73_length_7036_cov_65.961943	5591	5666	770	1	75	0.0133333
NODE_73_length_7036_cov_65.961943	5591	5666	787	1	75	0.0133333
NODE_73_length_7036_cov_65.961943	5591	5666	798	1	75	0.0133333
NODE_73_length_7036_cov_65.961943	5591	5666	810	1	75	0.0133333
NODE_73_length_7036_cov_65.961943	5591	5666	817	1	75	0.0133333
NODE_73_length_7036_cov_65.961943	5591	5666	819	1	75	0.0133333
NODE_73_length_7036_cov_65.961943	5591	5666	825	1	75	0.0133333
NODE_73_length_7036_cov_65.961943	5591	5666	831	1	75	0.0133333
NODE_73_length_7036_cov_65.961943	5591	5666	835	1	75	0.0133333
NODE_73_length_7036_cov_65.961943	5591	5666	845	1	75	0.0133333
NODE_73_length_7036_cov_65.961943	5591	5666	857	1	75	0.0133333
NODE_73_length_7036_cov_65.961943	5591	5666	864	1	75	0.0133333
NODE_73_length_7036_cov_65.961943	5591	5666	868	1	75	0.0133333
NODE_73_length_7036_cov_65.961943	5591	5666	874	1	75	0.0133333
NODE_73_length_7036_cov_65.961943	5591	5666	882	1	75	0.0133333
NODE_73_length_7036_cov_65.961943	5591	5666	883	1	75	0.0133333
NODE_73_length_7036_cov_65.961943	5591	5666	885	2	75	0.0266667
NODE_73_length_7036_cov_65.961943	5591	5666	890	1	75	0.0133333
NODE_73_length_7036_cov_65.961943	5591	5666	899	2	75	0.0266667
NODE_73_length_7036_cov_65.961943	5591	5666	900	1	75	0.0133333
NODE_73_length_7036_cov_65.961943	5591	5666	902	1	75	0.0133333
NODE_73_length_7036_cov_65.961943	5591	5666	907	2	75	0.0266667
NODE_73_length_7036_cov_65.961943	5591	5666	911	1	75	0.0133333
NODE_73_length_7036_cov_65.961943	5591	5666	914	1	75	0.0133333
NODE_73_length_7036_cov_65.961943	5591	5666	916	1	75	0.0133333
NODE_73_length_7036_cov_65.961943	5591	5666	926	1	75	0.0133333
NODE_73_length_7036_cov_65.961943	5591	5666	934	1	75	0.0133333
NODE_73_length_7036_cov_65.961943	5591	5666	950	1	75	0.0133333
NODE_73_length_7036_cov_65.961943	5591	5666	957	1	75	0.0133333
NODE_73_length_7036_cov_65.961943	5591	5666	965	1	75	0.0133333
NODE_73_length_7036_cov_65.961943	5591	5666	967	1	75	0.0133333
NODE_73_length_7036_cov_65.961943	5591	5666	970	1	75	0.0133333
NODE_73_length_7036_cov_65.961943	5591	5666	971	1	75	0.0133333
NODE_73_length_7036_cov_65.961943	5591	5666	975	1	75	0.0133333
NODE_73_length_7036_cov_65.961943	5591	5666	979	1	75	0.0133333
NODE_73_length_7036_cov_65.961943	5591	5666	980	2	75	0.0266667
NODE_73_length_7036_cov_65.961943	5591	5666	981	1	75	0.0133333
NODE_73_length_7036_cov_65.961943	5591	5666	982	1	75	0.0133333
NODE_73_length_7036_cov_65.961943	5591	5666	983	1	75	0.0133333
NODE_73_length_7036_cov_65.961943	5591	5666	984	1	75	0.0133333
NODE_73_length_7036_cov_65.961943	5591	5666	985	1	75	0.0133333
NODE_73_length_7036_cov_65.961943	5591	5666	986	1	75	0.0133333
NODE_73_length_7036_cov_65.961943	5591	5666	987	1	75	0.0133333
NODE_73_length_7036_cov_65.961943	5591	5666	988	2	75	0.0266667
NODE_73_length_7036_cov_65.961943	5591	5666	991	1	75	0.0133333
NODE_73_length_7036_cov_65.961943	5591	5666	993	2	75	0.0266667
NODE_73_length_7036_cov_65.961943	5591	5666	995	1	75	0.0133333
NODE_73_length_7036_cov_65.961943	5591	5666	996	1	75	0.0133333
NODE_73_length_7036_cov_65.961943	5591	5666	997	1	75	0.0133333
NODE_73_length_7036_cov_65.961943	5591	5666	1008	1	75	0.0133333
NODE_73_length_7036_cov_65.961943	5591	5666	1013	1	75	0.0133333
NODE_73_length_7036_cov_65.961943	5591	5666	1017	1	75	0.0133333
NODE_73_length_7036_cov_65.961943	5591	5666	1036	1	75	0.0133333
NODE_73_length_7036_cov_65.961943	5591	5666	1045	1	75	0.0133333
NODE_73_length_7036_cov_65.961943	5591	5666	1070	1	75	0.0133333
NODE_73_length_7036_cov_65.961943	5591	5666	1072	1	75	0.0133333
NODE_73_length_7036_cov_65.961943	5591	5666	1082	1	75	0.0133333
NODE_73_length_7036_cov_65.961943	5591	5666	1087	1	75	0.0133333
NODE_73_length_7036_cov_65.961943	5591	5666	1099	1	75	0.0133333
NODE_73_length_7036_cov_65.961943	5591	5666	1100	1	75	0.0133333
NODE_73_length_7036_cov_65.961943	5591	5666	1107	1	75	0.0133333
NODE_73_length_7036_cov_65.961943	5591	5666	1130	1	75	0.0133333
NODE_73_length_7036_cov_65.961943	5591	5666	1144	1	75	0.0133333
NODE_73_length_7036_cov_65.961943	5591	5666	1151	1	75	0.0133333
NODE_73_length_7036_cov_65.961943	5591	5666	1159	1	75	0.0133333
NODE_73_length_7036_cov_65.961943	5591	5666	1167	2	75	0.0266667
NODE_73_length_7036_cov_65.961943	5591	5666	1171	1	75	0.0133333
NODE_73_length_7036_cov_65.961943	5690	5746	1273	1	56	0.0178571
NODE_73_length_7036_cov_65.961943	5690	5746	1274	1	56	0.0178571
NODE_73_length_7036_cov_65.961943	5690	5746	1275	1	56	0.0178571
NODE_73_length_7036_cov_65.961943	5690	5746	1297	1	56	0.0178571
NODE_73_length_7036_cov_65.961943	5690	5746	1298	1	56	0.0178571
NODE_73_length_7036_cov_65.961943	5690	5746	1302	1	56	0.0178571
NODE_73_length_7036_cov_65.961943	5690	5746	1305	1	56	0.0178571
NODE_73_length_7036_cov_65.961943	5690	5746	1310	1	56	0.0178571
NODE_73_length_7036_cov_65.961943	5690	5746	1311	1	56	0.0178571
NODE_73_length_7036_cov_65.961943	5690	5746	1312	2	56	0.0357143
NODE_73_length_7036_cov_65.961943	5690	5746	1313	1	56	0.0178571
NODE_73_length_7036_cov_65.961943	5690	5746	1314	1	56	0.0178571
NODE_73_length_7036_cov_65.961943	5690	5746	1315	1	56	0.0178571
NODE_73_length_7036_cov_65.961943	5690	5746	1316	1	56	0.0178571
NODE_73_length_7036_cov_65.961943	5690	5746	1320	1	56	0.0178571
NODE_73_length_7036_cov_65.961943	5690	5746	1324	1	56	0.0178571
NODE_73_length_7036_cov_65.961943	5690	5746	1331	1	56	0.0178571
NODE_73_length_7036_cov_65.961943	5690	5746	1344	1	56	0.0178571
NODE_73_length_7036_cov_65.961943	5690	5746	1345	1	56	0.0178571
NODE_73_length_7036_cov_65.961943	5690	5746	1347	2	56	0.0357143
NODE_73_length_7036_cov_65.961943	5690	5746	1349	2	56	0.0357143
NODE_73_length_7036_cov_65.961943	5690	5746	1351	2	56	0.0357143
NODE_73_length_7036_cov_65.961943	5690	5746	1354	1	56	0.0178571
NODE_73_length_7036_cov_65.961943	5690	5746	1355	1	56	0.0178571
NODE_73_length_7036_cov_65.961943	5690	5746	1356	2	56	0.0357143
NODE_73_length_7036_cov_65.961943	5690	5746	1360	2	56	0.0357143
NODE_73_length_7036_cov_65.961943	5690	5746	1363	1	56	0.0178571
NODE_73_length_7036_cov_65.961943	5690	5746	1364	2	56	0.0357143
NODE_73_length_7036_cov_65.961943	5690	5746	1365	1	56	0.0178571
NODE_73_length_7036_cov_65.961943	5690	5746	1366	2	56	0.0357143
NODE_73_length_7036_cov_65.961943	5690	5746	1367	1	56	0.0178571
NODE_73_length_7036_cov_65.961943	5690	5746	1368	1	56	0.0178571
NODE_73_length_7036_cov_65.961943	5690	5746	1371	1	56	0.0178571
NODE_73_length_7036_cov_65.961943	5690	5746	1373	1	56	0.0178571
NODE_73_length_7036_cov_65.961943	5690	5746	1374	2	56	0.0357143
NODE_73_length_7036_cov_65.961943	5690	5746	1381	1	56	0.0178571
NODE_73_length_7036_cov_65.961943	5690	5746	1383	1	56	0.0178571
NODE_73_length_7036_cov_65.961943	5690	5746	1385	1	56	0.0178571
NODE_73_length_7036_cov_65.961943	5690	5746	1388	1	56	0.0178571
NODE_73_length_7036_cov_65.961943	5690	5746	1389	1	56	0.0178571
NODE_73_length_7036_cov_65.961943	5690	5746	1395	1	56	0.0178571
NODE_73_length_7036_cov_65.961943	5690	5746	1405	1	56	0.0178571
NODE_73_length_7036_cov_65.961943	5690	5746	1413	1	56	0.0178571
NODE_73_length_7036_cov_65.961943	5690	5746	1417	1	56	0.0178571
NODE_73_length_7036_cov_65.961943	5690	5746	1421	1	56	0.0178571
NODE_73_length_7036_cov_65.961943	5690	5746	1426	1	56	0.0178571
NODE_73_length_7036_cov_65.961943	5690	5746	1430	1	56	0.0178571
NODE_73_length_7036_cov_65.961943	6373	6453	0	62	80	0.7750000
NODE_73_length_7036_cov_65.961943	6373	6453	2	18	80	0.2250000
NODE_73_length_7036_cov_65.961943	6426	6506	0	9	80	0.1125000
NODE_73_length_7036_cov_65.961943	6426	6506	2	71	80	0.8875000
NODE_74_length_6974_cov_16.058327	976	1056	6	47	80	0.5875000
NODE_74_length_6974_cov_16.058327	976	1056	8	13	80	0.1625000
NODE_74_length_6974_cov_16.058327	976	1056	10	20	80	0.2500000
NODE_74_length_6974_cov_16.058327	1029	1109	4	12	80	0.1500000
NODE_74_length_6974_cov_16.058327	1029	1109	6	33	80	0.4125000
NODE_74_length_6974_cov_16.058327	1029	1109	8	21	80	0.2625000
NODE_74_length_6974_cov_16.058327	1029	1109	10	14	80	0.1750000
NODE_80_length_6826_cov_10.483574	4462	4542	0	10	80	0.1250000
NODE_80_length_6826_cov_10.483574	4462	4542	14	3	80	0.0375000
NODE_80_length_6826_cov_10.483574	4462	4542	20	1	80	0.0125000
NODE_80_length_6826_cov_10.483574	4462	4542	22	1	80	0.0125000
NODE_80_length_6826_cov_10.483574	4462	4542	23	10	80	0.1250000
NODE_80_length_6826_cov_10.483574	4462	4542	25	1	80	0.0125000
NODE_80_length_6826_cov_10.483574	4462	4542	27	4	80	0.0500000
NODE_80_length_6826_cov_10.483574	4462	4542	28	10	80	0.1250000
NODE_80_length_6826_cov_10.483574	4462	4542	29	2	80	0.0250000
NODE_80_length_6826_cov_10.483574	4462	4542	31	6	80	0.0750000
NODE_80_length_6826_cov_10.483574	4462	4542	33	2	80	0.0250000
NODE_80_length_6826_cov_10.483574	4462	4542	35	8	80	0.1000000
NODE_80_length_6826_cov_10.483574	4462	4542	37	9	80	0.1125000
NODE_80_length_6826_cov_10.483574	4462	4542	39	1	80	0.0125000
NODE_80_length_6826_cov_10.483574	4462	4542	41	2	80	0.0250000
NODE_80_length_6826_cov_10.483574	4462	4542	45	2	80	0.0250000
NODE_80_length_6826_cov_10.483574	4462	4542	49	2	80	0.0250000
NODE_80_length_6826_cov_10.483574	4462	4542	51	1	80	0.0125000
NODE_80_length_6826_cov_10.483574	4462	4542	53	2	80	0.0250000
NODE_80_length_6826_cov_10.483574	4462	4542	55	1	80	0.0125000
NODE_80_length_6826_cov_10.483574	4462	4542	56	2	80	0.0250000
NODE_80_length_6826_cov_10.483574	4515	4595	35	5	80	0.0625000
NODE_80_length_6826_cov_10.483574	4515	4595	37	9	80	0.1125000
NODE_80_length_6826_cov_10.483574	4515	4595	39	1	80	0.0125000
NODE_80_length_6826_cov_10.483574	4515	4595	41	2	80	0.0250000
NODE_80_length_6826_cov_10.483574	4515	4595	45	2	80	0.0250000
NODE_80_length_6826_cov_10.483574	4515	4595	49	2	80	0.0250000
NODE_80_length_6826_cov_10.483574	4515	4595	51	1	80	0.0125000
NODE_80_length_6826_cov_10.483574	4515	4595	53	2	80	0.0250000
NODE_80_length_6826_cov_10.483574	4515	4595	55	1	80	0.0125000
NODE_80_length_6826_cov_10.483574	4515	4595	56	6	80	0.0750000
NODE_80_length_6826_cov_10.483574	4515	4595	58	4	80	0.0500000
NODE_80_length_6826_cov_10.483574	4515	4595	59	3	80	0.0375000
NODE_80_length_6826_cov_10.483574	4515	4595	63	3	80	0.0375000
NODE_80_length_6826_cov_10.483574	4515	4595	66	3	80	0.0375000
NODE_80_length_6826_cov_10.483574	4515	4595	67	6	80	0.0750000
NODE_80_length_6826_cov_10.483574	4515	4595	69	9	80	0.1125000
NODE_80_length_6826_cov_10.483574	4515	4595	70	2	80	0.0250000
NODE_80_length_6826_cov_10.483574	4515	4595	71	4	80	0.0500000
NODE_80_length_6826_cov_10.483574	4515	4595	73	15	80	0.1875000
NODE_81_length_6816_cov_2.820753	6726	6801	0	75	75	1.0000000
NODE_81_length_6816_cov_2.820753	6774	6816	0	42	42	1.0000000
NODE_84_length_6744_cov_6.222272	5	85	0	15	80	0.1875000
NODE_84_length_6744_cov_6.222272	5	85	2	65	80	0.8125000
NODE_84_length_6744_cov_6.222272	58	138	0	4	80	0.0500000
NODE_84_length_6744_cov_6.222272	58	138	2	76	80	0.9500000
NODE_84_length_6744_cov_6.222272	6650	6730	0	70	80	0.8750000
NODE_84_length_6744_cov_6.222272	6650	6730	4	10	80	0.1250000
NODE_84_length_6744_cov_6.222272	6703	6744	0	41	41	1.0000000
NODE_86_length_6733_cov_88.965029	3141	3221	0	80	80	1.0000000
NODE_86_length_6733_cov_88.965029	3194	3274	0	80	80	1.0000000
NODE_86_length_6733_cov_88.965029	3270	3350	0	80	80	1.0000000
NODE_86_length_6733_cov_88.965029	3323	3403	0	80	80	1.0000000
NODE_90_length_6627_cov_9.440564	350	430	0	80	80	1.0000000
NODE_90_length_6627_cov_9.440564	403	483	0	80	80	1.0000000
NODE_95_length_6507_cov_95.786049	171	247	0	71	76	0.9342105
NODE_95_length_6507_cov_95.786049	171	247	2	3	76	0.0394737
NODE_95_length_6507_cov_95.786049	171	247	4	1	76	0.0131579
NODE_95_length_6507_cov_95.786049	171	247	21	1	76	0.0131579
NODE_96_length_6497_cov_2.677399	366	436	5	2	70	0.0285714
NODE_96_length_6497_cov_2.677399	366	436	7	13	70	0.1857143
NODE_96_length_6497_cov_2.677399	366	436	9	8	70	0.1142857
NODE_96_length_6497_cov_2.677399	366	436	11	45	70	0.6428571
NODE_96_length_6497_cov_2.677399	366	436	12	2	70	0.0285714
NODE_96_length_6497_cov_2.677399	409	444	0	1	35	0.0285714
NODE_96_length_6497_cov_2.677399	409	444	4	1	35	0.0285714
NODE_96_length_6497_cov_2.677399	409	444	5	8	35	0.2285714
NODE_96_length_6497_cov_2.677399	409	444	7	13	35	0.3714286
NODE_96_length_6497_cov_2.677399	409	444	9	8	35	0.2285714
NODE_96_length_6497_cov_2.677399	409	444	11	4	35	0.1142857
NODE_97_length_6450_cov_26.108172	5024	5104	2	10	80	0.1250000
NODE_97_length_6450_cov_26.108172	5024	5104	4	38	80	0.4750000
NODE_97_length_6450_cov_26.108172	5024	5104	6	6	80	0.0750000
NODE_97_length_6450_cov_26.108172	5024	5104	8	26	80	0.3250000
NODE_109_length_6171_cov_36.061100	3743	3813	36	4	70	0.0571429
NODE_109_length_6171_cov_36.061100	3743	3813	40	2	70	0.0285714
NODE_109_length_6171_cov_36.061100	3743	3813	44	1	70	0.0142857
NODE_109_length_6171_cov_36.061100	3743	3813	46	1	70	0.0142857
NODE_109_length_6171_cov_36.061100	3743	3813	48	2	70	0.0285714
NODE_109_length_6171_cov_36.061100	3743	3813	52	3	70	0.0428571
NODE_109_length_6171_cov_36.061100	3743	3813	54	2	70	0.0285714
NODE_109_length_6171_cov_36.061100	3743	3813	58	8	70	0.1142857
NODE_109_length_6171_cov_36.061100	3743	3813	60	11	70	0.1571429
NODE_109_length_6171_cov_36.061100	3743	3813	78	2	70	0.0285714
NODE_109_length_6171_cov_36.061100	3743	3813	79	3	70	0.0428571
NODE_109_length_6171_cov_36.061100	3743	3813	83	5	70	0.0714286
NODE_109_length_6171_cov_36.061100	3743	3813	85	2	70	0.0285714
NODE_109_length_6171_cov_36.061100	3743	3813	87	8	70	0.1142857
NODE_109_length_6171_cov_36.061100	3743	3813	90	1	70	0.0142857
NODE_109_length_6171_cov_36.061100	3743	3813	95	1	70	0.0142857
NODE_109_length_6171_cov_36.061100	3743	3813	97	1	70	0.0142857
NODE_109_length_6171_cov_36.061100	3743	3813	103	1	70	0.0142857
NODE_109_length_6171_cov_36.061100	3743	3813	107	8	70	0.1142857
NODE_109_length_6171_cov_36.061100	3743	3813	109	4	70	0.0571429
NODE_109_length_6171_cov_36.061100	3798	3851	79	1	53	0.0188679
NODE_109_length_6171_cov_36.061100	3798	3851	80	3	53	0.0566038
NODE_109_length_6171_cov_36.061100	3798	3851	82	1	53	0.0188679
NODE_109_length_6171_cov_36.061100	3798	3851	84	2	53	0.0377358
NODE_109_length_6171_cov_36.061100	3798	3851	87	1	53	0.0188679
NODE_109_length_6171_cov_36.061100	3798	3851	88	1	53	0.0188679
NODE_109_length_6171_cov_36.061100	3798	3851	89	4	53	0.0754717
NODE_109_length_6171_cov_36.061100	3798	3851	91	2	53	0.0377358
NODE_109_length_6171_cov_36.061100	3798	3851	93	1	53	0.0188679
NODE_109_length_6171_cov_36.061100	3798	3851	95	1	53	0.0188679
NODE_109_length_6171_cov_36.061100	3798	3851	97	1	53	0.0188679
NODE_109_length_6171_cov_36.061100	3798	3851	101	1	53	0.0188679
NODE_109_length_6171_cov_36.061100	3798	3851	102	1	53	0.0188679
NODE_109_length_6171_cov_36.061100	3798	3851	103	1	53	0.0188679
NODE_109_length_6171_cov_36.061100	3798	3851	104	1	53	0.0188679
NODE_109_length_6171_cov_36.061100	3798	3851	106	1	53	0.0188679
NODE_109_length_6171_cov_36.061100	3798	3851	107	8	53	0.1509434
NODE_109_length_6171_cov_36.061100	3798	3851	109	4	53	0.0754717
NODE_109_length_6171_cov_36.061100	3798	3851	110	4	53	0.0754717
NODE_109_length_6171_cov_36.061100	3798	3851	114	2	53	0.0377358
NODE_109_length_6171_cov_36.061100	3798	3851	115	2	53	0.0377358
NODE_109_length_6171_cov_36.061100	3798	3851	116	4	53	0.0754717
NODE_109_length_6171_cov_36.061100	3798	3851	118	2	53	0.0377358
NODE_109_length_6171_cov_36.061100	3798	3851	120	3	53	0.0566038
NODE_109_length_6171_cov_36.061100	3798	3851	122	1	53	0.0188679
NODE_109_length_6171_cov_36.061100	4552	4596	525	2	44	0.0454545
NODE_109_length_6171_cov_36.061100	4552	4596	526	1	44	0.0227273
NODE_109_length_6171_cov_36.061100	4552	4596	527	2	44	0.0454545
NODE_109_length_6171_cov_36.061100	4552	4596	528	2	44	0.0454545
NODE_109_length_6171_cov_36.061100	4552	4596	530	1	44	0.0227273
NODE_109_length_6171_cov_36.061100	4552	4596	531	2	44	0.0454545
NODE_109_length_6171_cov_36.061100	4552	4596	534	1	44	0.0227273
NODE_109_length_6171_cov_36.061100	4552	4596	535	2	44	0.0454545
NODE_109_length_6171_cov_36.061100	4552	4596	536	2	44	0.0454545
NODE_109_length_6171_cov_36.061100	4552	4596	537	2	44	0.0454545
NODE_109_length_6171_cov_36.061100	4552	4596	538	3	44	0.0681818
NODE_109_length_6171_cov_36.061100	4552	4596	539	3	44	0.0681818
NODE_109_length_6171_cov_36.061100	4552	4596	541	1	44	0.0227273
NODE_109_length_6171_cov_36.061100	4552	4596	544	2	44	0.0454545
NODE_109_length_6171_cov_36.061100	4552	4596	546	1	44	0.0227273
NODE_109_length_6171_cov_36.061100	4552	4596	547	1	44	0.0227273
NODE_109_length_6171_cov_36.061100	4552	4596	548	1	44	0.0227273
NODE_109_length_6171_cov_36.061100	4552	4596	552	1	44	0.0227273
NODE_109_length_6171_cov_36.061100	4552	4596	556	1	44	0.0227273
NODE_109_length_6171_cov_36.061100	4552	4596	559	3	44	0.0681818
NODE_109_length_6171_cov_36.061100	4552	4596	561	2	44	0.0454545
NODE_109_length_6171_cov_36.061100	4552	4596	562	3	44	0.0681818
NODE_109_length_6171_cov_36.061100	4552	4596	566	1	44	0.0227273
NODE_109_length_6171_cov_36.061100	4552	4596	567	1	44	0.0227273
NODE_109_length_6171_cov_36.061100	4552	4596	569	1	44	0.0227273
NODE_109_length_6171_cov_36.061100	4552	4596	572	1	44	0.0227273
NODE_109_length_6171_cov_36.061100	4552	4596	576	1	44	0.0227273
NODE_109_length_6171_cov_36.061100	4569	4649	535	1	80	0.0125000
NODE_109_length_6171_cov_36.061100	4569	4649	537	1	80	0.0125000
NODE_109_length_6171_cov_36.061100	4569	4649	538	3	80	0.0375000
NODE_109_length_6171_cov_36.061100	4569	4649	539	1	80	0.0125000
NODE_109_length_6171_cov_36.061100	4569	4649	541	1	80	0.0125000
NODE_109_length_6171_cov_36.061100	4569	4649	544	2	80	0.0250000
NODE_109_length_6171_cov_36.061100	4569	4649	546	1	80	0.0125000
NODE_109_length_6171_cov_36.061100	4569	4649	547	1	80	0.0125000
NODE_109_length_6171_cov_36.061100	4569	4649	548	1	80	0.0125000
NODE_109_length_6171_cov_36.061100	4569	4649	551	2	80	0.0250000
NODE_109_length_6171_cov_36.061100	4569	4649	552	1	80	0.0125000
NODE_109_length_6171_cov_36.061100	4569	4649	555	3	80	0.0375000
NODE_109_length_6171_cov_36.061100	4569	4649	556	1	80	0.0125000
NODE_109_length_6171_cov_36.061100	4569	4649	557	2	80	0.0250000
NODE_109_length_6171_cov_36.061100	4569	4649	558	3	80	0.0375000
NODE_109_length_6171_cov_36.061100	4569	4649	559	4	80	0.0500000
NODE_109_length_6171_cov_36.061100	4569	4649	560	3	80	0.0375000
NODE_109_length_6171_cov_36.061100	4569	4649	561	2	80	0.0250000
NODE_109_length_6171_cov_36.061100	4569	4649	562	7	80	0.0875000
NODE_109_length_6171_cov_36.061100	4569	4649	563	1	80	0.0125000
NODE_109_length_6171_cov_36.061100	4569	4649	564	5	80	0.0625000
NODE_109_length_6171_cov_36.061100	4569	4649	565	3	80	0.0375000
NODE_109_length_6171_cov_36.061100	4569	4649	566	9	80	0.1125000
NODE_109_length_6171_cov_36.061100	4569	4649	567	3	80	0.0375000
NODE_109_length_6171_cov_36.061100	4569	4649	568	1	80	0.0125000
NODE_109_length_6171_cov_36.061100	4569	4649	569	3	80	0.0375000
NODE_109_length_6171_cov_36.061100	4569	4649	570	3	80	0.0375000
NODE_109_length_6171_cov_36.061100	4569	4649	571	1	80	0.0125000
NODE_109_length_6171_cov_36.061100	4569	4649	572	1	80	0.0125000
NODE_109_length_6171_cov_36.061100	4569	4649	573	1	80	0.0125000
NODE_109_length_6171_cov_36.061100	4569	4649	574	3	80	0.0375000
NODE_109_length_6171_cov_36.061100	4569	4649	576	2	80	0.0250000
NODE_109_length_6171_cov_36.061100	4569	4649	579	3	80	0.0375000
NODE_109_length_6171_cov_36.061100	4569	4649	582	1	80	0.0125000
NODE_109_length_6171_cov_36.061100	5742	5788	0	7	46	0.1521739
NODE_109_length_6171_cov_36.061100	5742	5788	2	39	46	0.8478261
NODE_109_length_6171_cov_36.061100	5761	5841	0	12	80	0.1500000
NODE_109_length_6171_cov_36.061100	5761	5841	2	68	80	0.8500000
NODE_110_length_6148_cov_58.915358	5602	5682	0	80	80	1.0000000
NODE_110_length_6148_cov_58.915358	5655	5735	0	80	80	1.0000000
NODE_112_length_6026_cov_17.775772	4124	4204	2	46	80	0.5750000
NODE_112_length_6026_cov_17.775772	4124	4204	6	27	80	0.3375000
NODE_112_length_6026_cov_17.775772	4124	4204	7	7	80	0.0875000
NODE_112_length_6026_cov_17.775772	4177	4257	5	34	80	0.4250000
NODE_112_length_6026_cov_17.775772	4177	4257	6	26	80	0.3250000
NODE_112_length_6026_cov_17.775772	4177	4257	7	20	80	0.2500000
NODE_112_length_6026_cov_17.775772	4253	4333	5	14	80	0.1750000
NODE_112_length_6026_cov_17.775772	4253	4333	7	8	80	0.1000000
NODE_112_length_6026_cov_17.775772	4253	4333	11	13	80	0.1625000
NODE_112_length_6026_cov_17.775772	4253	4333	13	9	80	0.1125000
NODE_112_length_6026_cov_17.775772	4253	4333	15	7	80	0.0875000
NODE_112_length_6026_cov_17.775772	4253	4333	23	3	80	0.0375000
NODE_112_length_6026_cov_17.775772	4253	4333	25	13	80	0.1625000
NODE_112_length_6026_cov_17.775772	4253	4333	29	13	80	0.1625000
NODE_112_length_6026_cov_17.775772	4306	4386	23	1	80	0.0125000
NODE_112_length_6026_cov_17.775772	4306	4386	25	13	80	0.1625000
NODE_112_length_6026_cov_17.775772	4306	4386	26	6	80	0.0750000
NODE_112_length_6026_cov_17.775772	4306	4386	28	7	80	0.0875000
NODE_112_length_6026_cov_17.775772	4306	4386	29	14	80	0.1750000
NODE_112_length_6026_cov_17.775772	4306	4386	30	25	80	0.3125000
NODE_112_length_6026_cov_17.775772	4306	4386	33	13	80	0.1625000
NODE_112_length_6026_cov_17.775772	4306	4386	34	1	80	0.0125000
NODE_124_length_5810_cov_24.750657	2064	2144	0	57	80	0.7125000
NODE_124_length_5810_cov_24.750657	2064	2144	2	15	80	0.1875000
NODE_124_length_5810_cov_24.750657	2064	2144	4	8	80	0.1000000
NODE_124_length_5810_cov_24.750657	2117	2194	0	77	77	1.0000000
NODE_127_length_5771_cov_10.854549	2814	2883	2	69	69	1.0000000
NODE_128_length_5769_cov_6.878483	5701	5731	0	27	30	0.9000000
NODE_128_length_5769_cov_6.878483	5701	5731	4	3	30	0.1000000
NODE_133_length_5728_cov_16.351039	63	134	14	11	71	0.1549296
NODE_133_length_5728_cov_16.351039	63	134	16	60	71	0.8450704
NODE_133_length_5728_cov_16.351039	2960	3040	2	18	80	0.2250000
NODE_133_length_5728_cov_16.351039	2960	3040	4	16	80	0.2000000
NODE_133_length_5728_cov_16.351039	2960	3040	10	7	80	0.0875000
NODE_133_length_5728_cov_16.351039	2960	3040	12	4	80	0.0500000
NODE_133_length_5728_cov_16.351039	2960	3040	14	8	80	0.1000000
NODE_133_length_5728_cov_16.351039	2960	3040	16	5	80	0.0625000
NODE_133_length_5728_cov_16.351039	2960	3040	18	6	80	0.0750000
NODE_133_length_5728_cov_16.351039	2960	3040	20	4	80	0.0500000
NODE_133_length_5728_cov_16.351039	2960	3040	21	7	80	0.0875000
NODE_133_length_5728_cov_16.351039	2960	3040	22	1	80	0.0125000
NODE_133_length_5728_cov_16.351039	2960	3040	24	4	80	0.0500000
NODE_133_length_5728_cov_16.351039	5106	5172	89	1	66	0.0151515
NODE_133_length_5728_cov_16.351039	5106	5172	90	3	66	0.0454545
NODE_133_length_5728_cov_16.351039	5106	5172	91	4	66	0.0606061
NODE_133_length_5728_cov_16.351039	5106	5172	93	2	66	0.0303030
NODE_133_length_5728_cov_16.351039	5106	5172	94	1	66	0.0151515
NODE_133_length_5728_cov_16.351039	5106	5172	95	2	66	0.0303030
NODE_133_length_5728_cov_16.351039	5106	5172	105	1	66	0.0151515
NODE_133_length_5728_cov_16.351039	5106	5172	106	4	66	0.0606061
NODE_133_length_5728_cov_16.351039	5106	5172	114	6	66	0.0909091
NODE_133_length_5728_cov_16.351039	5106	5172	116	2	66	0.0303030
NODE_133_length_5728_cov_16.351039	5106	5172	118	4	66	0.0606061
NODE_133_length_5728_cov_16.351039	5106	5172	120	1	66	0.0151515
NODE_133_length_5728_cov_16.351039	5106	5172	121	1	66	0.0151515
NODE_133_length_5728_cov_16.351039	5106	5172	122	2	66	0.0303030
NODE_133_length_5728_cov_16.351039	5106	5172	124	2	66	0.0303030
NODE_133_length_5728_cov_16.351039	5106	5172	128	3	66	0.0454545
NODE_133_length_5728_cov_16.351039	5106	5172	130	3	66	0.0454545
NODE_133_length_5728_cov_16.351039	5106	5172	132	2	66	0.0303030
NODE_133_length_5728_cov_16.351039	5106	5172	134	1	66	0.0151515
NODE_133_length_5728_cov_16.351039	5106	5172	141	1	66	0.0151515
NODE_133_length_5728_cov_16.351039	5106	5172	143	1	66	0.0151515
NODE_133_length_5728_cov_16.351039	5106	5172	148	1	66	0.0151515
NODE_133_length_5728_cov_16.351039	5106	5172	152	2	66	0.0303030
NODE_133_length_5728_cov_16.351039	5106	5172	154	4	66	0.0606061
NODE_133_length_5728_cov_16.351039	5106	5172	159	1	66	0.0151515
NODE_133_length_5728_cov_16.351039	5106	5172	165	1	66	0.0151515
NODE_133_length_5728_cov_16.351039	5106	5172	169	1	66	0.0151515
NODE_133_length_5728_cov_16.351039	5106	5172	171	1	66	0.0151515
NODE_133_length_5728_cov_16.351039	5106	5172	172	2	66	0.0303030
NODE_133_length_5728_cov_16.351039	5106	5172	177	1	66	0.0151515
NODE_133_length_5728_cov_16.351039	5106	5172	178	1	66	0.0151515
NODE_133_length_5728_cov_16.351039	5106	5172	183	3	66	0.0454545
NODE_133_length_5728_cov_16.351039	5106	5172	184	1	66	0.0151515
NODE_133_length_5728_cov_16.351039	5145	5225	128	1	80	0.0125000
NODE_133_length_5728_cov_16.351039	5145	5225	130	3	80	0.0375000
NODE_133_length_5728_cov_16.351039	5145	5225	132	1	80	0.0125000
NODE_133_length_5728_cov_16.351039	5145	5225	134	1	80	0.0125000
NODE_133_length_5728_cov_16.351039	5145	5225	141	1	80	0.0125000
NODE_133_length_5728_cov_16.351039	5145	5225	143	1	80	0.0125000
NODE_133_length_5728_cov_16.351039	5145	5225	148	1	80	0.0125000
NODE_133_length_5728_cov_16.351039	5145	5225	152	2	80	0.0250000
NODE_133_length_5728_cov_16.351039	5145	5225	154	4	80	0.0500000
NODE_133_length_5728_cov_16.351039	5145	5225	159	1	80	0.0125000
NODE_133_length_5728_cov_16.351039	5145	5225	165	1	80	0.0125000
NODE_133_length_5728_cov_16.351039	5145	5225	169	1	80	0.0125000
NODE_133_length_5728_cov_16.351039	5145	5225	171	1	80	0.0125000
NODE_133_length_5728_cov_16.351039	5145	5225	172	2	80	0.0250000
NODE_133_length_5728_cov_16.351039	5145	5225	177	1	80	0.0125000
NODE_133_length_5728_cov_16.351039	5145	5225	178	1	80	0.0125000
NODE_133_length_5728_cov_16.351039	5145	5225	183	3	80	0.0375000
NODE_133_length_5728_cov_16.351039	5145	5225	184	2	80	0.0250000
NODE_133_length_5728_cov_16.351039	5145	5225	186	1	80	0.0125000
NODE_133_length_5728_cov_16.351039	5145	5225	187	1	80	0.0125000
NODE_133_length_5728_cov_16.351039	5145	5225	188	1	80	0.0125000
NODE_133_length_5728_cov_16.351039	5145	5225	189	7	80	0.0875000
NODE_133_length_5728_cov_16.351039	5145	5225	191	3	80	0.0375000
NODE_133_length_5728_cov_16.351039	5145	5225	194	2	80	0.0250000
NODE_133_length_5728_cov_16.351039	5145	5225	196	1	80	0.0125000
NODE_133_length_5728_cov_16.351039	5145	5225	197	1	80	0.0125000
NODE_133_length_5728_cov_16.351039	5145	5225	203	1	80	0.0125000
NODE_133_length_5728_cov_16.351039	5145	5225	206	1	80	0.0125000
NODE_133_length_5728_cov_16.351039	5145	5225	207	1	80	0.0125000
NODE_133_length_5728_cov_16.351039	5145	5225	213	1	80	0.0125000
NODE_133_length_5728_cov_16.351039	5145	5225	215	2	80	0.0250000
NODE_133_length_5728_cov_16.351039	5145	5225	216	2	80	0.0250000
NODE_133_length_5728_cov_16.351039	5145	5225	218	5	80	0.0625000
NODE_133_length_5728_cov_16.351039	5145	5225	219	1	80	0.0125000
NODE_133_length_5728_cov_16.351039	5145	5225	220	4	80	0.0500000
NODE_133_length_5728_cov_16.351039	5145	5225	221	5	80	0.0625000
NODE_133_length_5728_cov_16.351039	5145	5225	222	1	80	0.0125000
NODE_133_length_5728_cov_16.351039	5145	5225	223	2	80	0.0250000
NODE_133_length_5728_cov_16.351039	5145	5225	225	2	80	0.0250000
NODE_133_length_5728_cov_16.351039	5145	5225	226	1	80	0.0125000
NODE_133_length_5728_cov_16.351039	5145	5225	227	1	80	0.0125000
NODE_133_length_5728_cov_16.351039	5145	5225	228	2	80	0.0250000
NODE_133_length_5728_cov_16.351039	5145	5225	229	2	80	0.0250000
NODE_133_length_5728_cov_16.351039	5145	5225	232	1	80	0.0125000
NODE_137_length_5696_cov_20.656244	179	258	0	15	79	0.1898734
NODE_137_length_5696_cov_20.656244	179	258	2	64	79	0.8101266
NODE_137_length_5696_cov_20.656244	231	311	0	68	80	0.8500000
NODE_137_length_5696_cov_20.656244	231	311	2	12	80	0.1500000
NODE_137_length_5696_cov_20.656244	307	387	0	80	80	1.0000000
NODE_137_length_5696_cov_20.656244	360	440	0	80	80	1.0000000
NODE_137_length_5696_cov_20.656244	5100	5180	0	80	80	1.0000000
NODE_137_length_5696_cov_20.656244	5153	5233	0	80	80	1.0000000
NODE_137_length_5696_cov_20.656244	5280	5360	1	32	80	0.4000000
NODE_137_length_5696_cov_20.656244	5280	5360	6	1	80	0.0125000
NODE_137_length_5696_cov_20.656244	5280	5360	7	21	80	0.2625000
NODE_137_length_5696_cov_20.656244	5280	5360	9	26	80	0.3250000
NODE_137_length_5696_cov_20.656244	5333	5413	7	15	80	0.1875000
NODE_137_length_5696_cov_20.656244	5333	5413	9	65	80	0.8125000
NODE_139_length_5681_cov_68.065030	253	333	10	27	80	0.3375000
NODE_139_length_5681_cov_68.065030	253	333	17	13	80	0.1625000
NODE_139_length_5681_cov_68.065030	253	333	18	40	80	0.5000000
NODE_139_length_5681_cov_68.065030	306	386	0	9	80	0.1125000
NODE_139_length_5681_cov_68.065030	306	386	9	6	80	0.0750000
NODE_139_length_5681_cov_68.065030	306	386	16	23	80	0.2875000
NODE_139_length_5681_cov_68.065030	306	386	17	28	80	0.3500000
NODE_139_length_5681_cov_68.065030	306	386	18	14	80	0.1750000
NODE_139_length_5681_cov_68.065030	4762	4842	87	4	80	0.0500000
NODE_139_length_5681_cov_68.065030	4762	4842	88	1	80	0.0125000
NODE_139_length_5681_cov_68.065030	4762	4842	90	1	80	0.0125000
NODE_139_length_5681_cov_68.065030	4762	4842	105	4	80	0.0500000
NODE_139_length_5681_cov_68.065030	4762	4842	109	5	80	0.0625000
NODE_139_length_5681_cov_68.065030	4762	4842	113	2	80	0.0250000
NODE_139_length_5681_cov_68.065030	4762	4842	124	1	80	0.0125000
NODE_139_length_5681_cov_68.065030	4762	4842	126	3	80	0.0375000
NODE_139_length_5681_cov_68.065030	4762	4842	128	5	80	0.0625000
NODE_139_length_5681_cov_68.065030	4762	4842	130	1	80	0.0125000
NODE_139_length_5681_cov_68.065030	4762	4842	132	4	80	0.0500000
NODE_139_length_5681_cov_68.065030	4762	4842	133	6	80	0.0750000
NODE_139_length_5681_cov_68.065030	4762	4842	136	4	80	0.0500000
NODE_139_length_5681_cov_68.065030	4762	4842	137	5	80	0.0625000
NODE_139_length_5681_cov_68.065030	4762	4842	139	1	80	0.0125000
NODE_139_length_5681_cov_68.065030	4762	4842	146	1	80	0.0125000
NODE_139_length_5681_cov_68.065030	4762	4842	148	1	80	0.0125000
NODE_139_length_5681_cov_68.065030	4762	4842	150	2	80	0.0250000
NODE_139_length_5681_cov_68.065030	4762	4842	152	3	80	0.0375000
NODE_139_length_5681_cov_68.065030	4762	4842	154	1	80	0.0125000
NODE_139_length_5681_cov_68.065030	4762	4842	155	5	80	0.0625000
NODE_139_length_5681_cov_68.065030	4762	4842	157	6	80	0.0750000
NODE_139_length_5681_cov_68.065030	4762	4842	158	2	80	0.0250000
NODE_139_length_5681_cov_68.065030	4762	4842	159	2	80	0.0250000
NODE_139_length_5681_cov_68.065030	4762	4842	160	3	80	0.0375000
NODE_139_length_5681_cov_68.065030	4762	4842	161	3	80	0.0375000
NODE_139_length_5681_cov_68.065030	4762	4842	162	1	80	0.0125000
NODE_139_length_5681_cov_68.065030	4762	4842	163	3	80	0.0375000
NODE_139_length_5681_cov_68.065030	4762	4842	87	4	80	0.0500000
NODE_139_length_5681_cov_68.065030	4762	4842	88	1	80	0.0125000
NODE_139_length_5681_cov_68.065030	4762	4842	90	1	80	0.0125000
NODE_139_length_5681_cov_68.065030	4762	4842	105	4	80	0.0500000
NODE_139_length_5681_cov_68.065030	4762	4842	109	5	80	0.0625000
NODE_139_length_5681_cov_68.065030	4762	4842	113	2	80	0.0250000
NODE_139_length_5681_cov_68.065030	4762	4842	124	1	80	0.0125000
NODE_139_length_5681_cov_68.065030	4762	4842	126	3	80	0.0375000
NODE_139_length_5681_cov_68.065030	4762	4842	128	5	80	0.0625000
NODE_139_length_5681_cov_68.065030	4762	4842	130	1	80	0.0125000
NODE_139_length_5681_cov_68.065030	4762	4842	132	4	80	0.0500000
NODE_139_length_5681_cov_68.065030	4762	4842	133	6	80	0.0750000
NODE_139_length_5681_cov_68.065030	4762	4842	136	4	80	0.0500000
NODE_139_length_5681_cov_68.065030	4762	4842	137	5	80	0.0625000
NODE_139_length_5681_cov_68.065030	4762	4842	139	1	80	0.0125000
NODE_139_length_5681_cov_68.065030	4762	4842	146	1	80	0.0125000
NODE_139_length_5681_cov_68.065030	4762	4842	148	1	80	0.0125000
NODE_139_length_5681_cov_68.065030	4762	4842	150	2	80	0.0250000
NODE_139_length_5681_cov_68.065030	4762	4842	152	3	80	0.0375000
NODE_139_length_5681_cov_68.065030	4762	4842	154	1	80	0.0125000
NODE_139_length_5681_cov_68.065030	4762	4842	155	5	80	0.0625000
NODE_139_length_5681_cov_68.065030	4762	4842	157	6	80	0.0750000
NODE_139_length_5681_cov_68.065030	4762	4842	158	2	80	0.0250000
NODE_139_length_5681_cov_68.065030	4762	4842	159	2	80	0.0250000
NODE_139_length_5681_cov_68.065030	4762	4842	160	3	80	0.0375000
NODE_139_length_5681_cov_68.065030	4762	4842	161	3	80	0.0375000
NODE_139_length_5681_cov_68.065030	4762	4842	162	1	80	0.0125000
NODE_139_length_5681_cov_68.065030	4762	4842	163	3	80	0.0375000
NODE_139_length_5681_cov_68.065030	4762	4842	87	4	80	0.0500000
NODE_139_length_5681_cov_68.065030	4762	4842	88	1	80	0.0125000
NODE_139_length_5681_cov_68.065030	4762	4842	90	1	80	0.0125000
NODE_139_length_5681_cov_68.065030	4762	4842	105	4	80	0.0500000
NODE_139_length_5681_cov_68.065030	4762	4842	109	5	80	0.0625000
NODE_139_length_5681_cov_68.065030	4762	4842	113	2	80	0.0250000
NODE_139_length_5681_cov_68.065030	4762	4842	124	1	80	0.0125000
NODE_139_length_5681_cov_68.065030	4762	4842	126	3	80	0.0375000
NODE_139_length_5681_cov_68.065030	4762	4842	128	5	80	0.0625000
NODE_139_length_5681_cov_68.065030	4762	4842	130	1	80	0.0125000
NODE_139_length_5681_cov_68.065030	4762	4842	132	4	80	0.0500000
NODE_139_length_5681_cov_68.065030	4762	4842	133	6	80	0.0750000
NODE_139_length_5681_cov_68.065030	4762	4842	136	4	80	0.0500000
NODE_139_length_5681_cov_68.065030	4762	4842	137	5	80	0.0625000
NODE_139_length_5681_cov_68.065030	4762	4842	139	1	80	0.0125000
NODE_139_length_5681_cov_68.065030	4762	4842	146	1	80	0.0125000
NODE_139_length_5681_cov_68.065030	4762	4842	148	1	80	0.0125000
NODE_139_length_5681_cov_68.065030	4762	4842	150	2	80	0.0250000
NODE_139_length_5681_cov_68.065030	4762	4842	152	3	80	0.0375000
NODE_139_length_5681_cov_68.065030	4762	4842	154	1	80	0.0125000
NODE_139_length_5681_cov_68.065030	4762	4842	155	5	80	0.0625000
NODE_139_length_5681_cov_68.065030	4762	4842	157	6	80	0.0750000
NODE_139_length_5681_cov_68.065030	4762	4842	158	2	80	0.0250000
NODE_139_length_5681_cov_68.065030	4762	4842	159	2	80	0.0250000
NODE_139_length_5681_cov_68.065030	4762	4842	160	3	80	0.0375000
NODE_139_length_5681_cov_68.065030	4762	4842	161	3	80	0.0375000
NODE_139_length_5681_cov_68.065030	4762	4842	162	1	80	0.0125000
NODE_139_length_5681_cov_68.065030	4762	4842	163	3	80	0.0375000
NODE_139_length_5681_cov_68.065030	4762	4842	87	4	80	0.0500000
NODE_139_length_5681_cov_68.065030	4762	4842	88	1	80	0.0125000
NODE_139_length_5681_cov_68.065030	4762	4842	90	1	80	0.0125000
NODE_139_length_5681_cov_68.065030	4762	4842	105	4	80	0.0500000
NODE_139_length_5681_cov_68.065030	4762	4842	109	5	80	0.0625000
NODE_139_length_5681_cov_68.065030	4762	4842	113	2	80	0.0250000
NODE_139_length_5681_cov_68.065030	4762	4842	124	1	80	0.0125000
NODE_139_length_5681_cov_68.065030	4762	4842	126	3	80	0.0375000
NODE_139_length_5681_cov_68.065030	4762	4842	128	5	80	0.0625000
NODE_139_length_5681_cov_68.065030	4762	4842	130	1	80	0.0125000
NODE_139_length_5681_cov_68.065030	4762	4842	132	4	80	0.0500000
NODE_139_length_5681_cov_68.065030	4762	4842	133	6	80	0.0750000
NODE_139_length_5681_cov_68.065030	4762	4842	136	4	80	0.0500000
NODE_139_length_5681_cov_68.065030	4762	4842	137	5	80	0.0625000
NODE_139_length_5681_cov_68.065030	4762	4842	139	1	80	0.0125000
NODE_139_length_5681_cov_68.065030	4762	4842	146	1	80	0.0125000
NODE_139_length_5681_cov_68.065030	4762	4842	148	1	80	0.0125000
NODE_139_length_5681_cov_68.065030	4762	4842	150	2	80	0.0250000
NODE_139_length_5681_cov_68.065030	4762	4842	152	3	80	0.0375000
NODE_139_length_5681_cov_68.065030	4762	4842	154	1	80	0.0125000
NODE_139_length_5681_cov_68.065030	4762	4842	155	5	80	0.0625000
NODE_139_length_5681_cov_68.065030	4762	4842	157	6	80	0.0750000
NODE_139_length_5681_cov_68.065030	4762	4842	158	2	80	0.0250000
NODE_139_length_5681_cov_68.065030	4762	4842	159	2	80	0.0250000
NODE_139_length_5681_cov_68.065030	4762	4842	160	3	80	0.0375000
NODE_139_length_5681_cov_68.065030	4762	4842	161	3	80	0.0375000
NODE_139_length_5681_cov_68.065030	4762	4842	162	1	80	0.0125000
NODE_139_length_5681_cov_68.065030	4762	4842	163	3	80	0.0375000
NODE_139_length_5681_cov_68.065030	4762	4842	87	4	80	0.0500000
NODE_139_length_5681_cov_68.065030	4762	4842	88	1	80	0.0125000
NODE_139_length_5681_cov_68.065030	4762	4842	90	1	80	0.0125000
NODE_139_length_5681_cov_68.065030	4762	4842	105	4	80	0.0500000
NODE_139_length_5681_cov_68.065030	4762	4842	109	5	80	0.0625000
NODE_139_length_5681_cov_68.065030	4762	4842	113	2	80	0.0250000
NODE_139_length_5681_cov_68.065030	4762	4842	124	1	80	0.0125000
NODE_139_length_5681_cov_68.065030	4762	4842	126	3	80	0.0375000
NODE_139_length_5681_cov_68.065030	4762	4842	128	5	80	0.0625000
NODE_139_length_5681_cov_68.065030	4762	4842	130	1	80	0.0125000
NODE_139_length_5681_cov_68.065030	4762	4842	132	4	80	0.0500000
NODE_139_length_5681_cov_68.065030	4762	4842	133	6	80	0.0750000
NODE_139_length_5681_cov_68.065030	4762	4842	136	4	80	0.0500000
NODE_139_length_5681_cov_68.065030	4762	4842	137	5	80	0.0625000
NODE_139_length_5681_cov_68.065030	4762	4842	139	1	80	0.0125000
NODE_139_length_5681_cov_68.065030	4762	4842	146	1	80	0.0125000
NODE_139_length_5681_cov_68.065030	4762	4842	148	1	80	0.0125000
NODE_139_length_5681_cov_68.065030	4762	4842	150	2	80	0.0250000
NODE_139_length_5681_cov_68.065030	4762	4842	152	3	80	0.0375000
NODE_139_length_5681_cov_68.065030	4762	4842	154	1	80	0.0125000
NODE_139_length_5681_cov_68.065030	4762	4842	155	5	80	0.0625000
NODE_139_length_5681_cov_68.065030	4762	4842	157	6	80	0.0750000
NODE_139_length_5681_cov_68.065030	4762	4842	158	2	80	0.0250000
NODE_139_length_5681_cov_68.065030	4762	4842	159	2	80	0.0250000
NODE_139_length_5681_cov_68.065030	4762	4842	160	3	80	0.0375000
NODE_139_length_5681_cov_68.065030	4762	4842	161	3	80	0.0375000
NODE_139_length_5681_cov_68.065030	4762	4842	162	1	80	0.0125000
NODE_139_length_5681_cov_68.065030	4762	4842	163	3	80	0.0375000
NODE_139_length_5681_cov_68.065030	4762	4842	87	4	80	0.0500000
NODE_139_length_5681_cov_68.065030	4762	4842	88	1	80	0.0125000
NODE_139_length_5681_cov_68.065030	4762	4842	90	1	80	0.0125000
NODE_139_length_5681_cov_68.065030	4762	4842	105	4	80	0.0500000
NODE_139_length_5681_cov_68.065030	4762	4842	109	5	80	0.0625000
NODE_139_length_5681_cov_68.065030	4762	4842	113	2	80	0.0250000
NODE_139_length_5681_cov_68.065030	4762	4842	124	1	80	0.0125000
NODE_139_length_5681_cov_68.065030	4762	4842	126	3	80	0.0375000
NODE_139_length_5681_cov_68.065030	4762	4842	128	5	80	0.0625000
NODE_139_length_5681_cov_68.065030	4762	4842	130	1	80	0.0125000
NODE_139_length_5681_cov_68.065030	4762	4842	132	4	80	0.0500000
NODE_139_length_5681_cov_68.065030	4762	4842	133	6	80	0.0750000
NODE_139_length_5681_cov_68.065030	4762	4842	136	4	80	0.0500000
NODE_139_length_5681_cov_68.065030	4762	4842	137	5	80	0.0625000
NODE_139_length_5681_cov_68.065030	4762	4842	139	1	80	0.0125000
NODE_139_length_5681_cov_68.065030	4762	4842	146	1	80	0.0125000
NODE_139_length_5681_cov_68.065030	4762	4842	148	1	80	0.0125000
NODE_139_length_5681_cov_68.065030	4762	4842	150	2	80	0.0250000
NODE_139_length_5681_cov_68.065030	4762	4842	152	3	80	0.0375000
NODE_139_length_5681_cov_68.065030	4762	4842	154	1	80	0.0125000
NODE_139_length_5681_cov_68.065030	4762	4842	155	5	80	0.0625000
NODE_139_length_5681_cov_68.065030	4762	4842	157	6	80	0.0750000
NODE_139_length_5681_cov_68.065030	4762	4842	158	2	80	0.0250000
NODE_139_length_5681_cov_68.065030	4762	4842	159	2	80	0.0250000
NODE_139_length_5681_cov_68.065030	4762	4842	160	3	80	0.0375000
NODE_139_length_5681_cov_68.065030	4762	4842	161	3	80	0.0375000
NODE_139_length_5681_cov_68.065030	4762	4842	162	1	80	0.0125000
NODE_139_length_5681_cov_68.065030	4762	4842	163	3	80	0.0375000
NODE_139_length_5681_cov_68.065030	4769	4839	87	1	70	0.0142857
NODE_139_length_5681_cov_68.065030	4769	4839	88	1	70	0.0142857
NODE_139_length_5681_cov_68.065030	4769	4839	90	1	70	0.0142857
NODE_139_length_5681_cov_68.065030	4769	4839	105	4	70	0.0571429
NODE_139_length_5681_cov_68.065030	4769	4839	109	5	70	0.0714286
NODE_139_length_5681_cov_68.065030	4769	4839	113	2	70	0.0285714
NODE_139_length_5681_cov_68.065030	4769	4839	124	1	70	0.0142857
NODE_139_length_5681_cov_68.065030	4769	4839	126	3	70	0.0428571
NODE_139_length_5681_cov_68.065030	4769	4839	128	5	70	0.0714286
NODE_139_length_5681_cov_68.065030	4769	4839	130	1	70	0.0142857
NODE_139_length_5681_cov_68.065030	4769	4839	132	3	70	0.0428571
NODE_139_length_5681_cov_68.065030	4769	4839	136	4	70	0.0571429
NODE_139_length_5681_cov_68.065030	4769	4839	137	5	70	0.0714286
NODE_139_length_5681_cov_68.065030	4769	4839	139	1	70	0.0142857
NODE_139_length_5681_cov_68.065030	4769	4839	146	1	70	0.0142857
NODE_139_length_5681_cov_68.065030	4769	4839	148	1	70	0.0142857
NODE_139_length_5681_cov_68.065030	4769	4839	150	2	70	0.0285714
NODE_139_length_5681_cov_68.065030	4769	4839	152	3	70	0.0428571
NODE_139_length_5681_cov_68.065030	4769	4839	154	1	70	0.0142857
NODE_139_length_5681_cov_68.065030	4769	4839	155	5	70	0.0714286
NODE_139_length_5681_cov_68.065030	4769	4839	157	6	70	0.0857143
NODE_139_length_5681_cov_68.065030	4769	4839	158	2	70	0.0285714
NODE_139_length_5681_cov_68.065030	4769	4839	159	2	70	0.0285714
NODE_139_length_5681_cov_68.065030	4769	4839	160	3	70	0.0428571
NODE_139_length_5681_cov_68.065030	4769	4839	161	3	70	0.0428571
NODE_139_length_5681_cov_68.065030	4769	4839	162	1	70	0.0142857
NODE_139_length_5681_cov_68.065030	4769	4839	163	3	70	0.0428571
NODE_139_length_5681_cov_68.065030	4771	4842	87	4	71	0.0563380
NODE_139_length_5681_cov_68.065030	4771	4842	88	1	71	0.0140845
NODE_139_length_5681_cov_68.065030	4771	4842	90	1	71	0.0140845
NODE_139_length_5681_cov_68.065030	4771	4842	105	4	71	0.0563380
NODE_139_length_5681_cov_68.065030	4771	4842	109	5	71	0.0704225
NODE_139_length_5681_cov_68.065030	4771	4842	113	2	71	0.0281690
NODE_139_length_5681_cov_68.065030	4771	4842	124	1	71	0.0140845
NODE_139_length_5681_cov_68.065030	4771	4842	126	3	71	0.0422535
NODE_139_length_5681_cov_68.065030	4771	4842	128	5	71	0.0704225
NODE_139_length_5681_cov_68.065030	4771	4842	130	1	71	0.0140845
NODE_139_length_5681_cov_68.065030	4771	4842	132	1	71	0.0140845
NODE_139_length_5681_cov_68.065030	4771	4842	136	4	71	0.0563380
NODE_139_length_5681_cov_68.065030	4771	4842	137	5	71	0.0704225
NODE_139_length_5681_cov_68.065030	4771	4842	139	1	71	0.0140845
NODE_139_length_5681_cov_68.065030	4771	4842	146	1	71	0.0140845
NODE_139_length_5681_cov_68.065030	4771	4842	148	1	71	0.0140845
NODE_139_length_5681_cov_68.065030	4771	4842	150	2	71	0.0281690
NODE_139_length_5681_cov_68.065030	4771	4842	152	3	71	0.0422535
NODE_139_length_5681_cov_68.065030	4771	4842	154	1	71	0.0140845
NODE_139_length_5681_cov_68.065030	4771	4842	155	5	71	0.0704225
NODE_139_length_5681_cov_68.065030	4771	4842	157	6	71	0.0845070
NODE_139_length_5681_cov_68.065030	4771	4842	158	2	71	0.0281690
NODE_139_length_5681_cov_68.065030	4771	4842	159	2	71	0.0281690
NODE_139_length_5681_cov_68.065030	4771	4842	160	3	71	0.0422535
NODE_139_length_5681_cov_68.065030	4771	4842	161	3	71	0.0422535
NODE_139_length_5681_cov_68.065030	4771	4842	162	1	71	0.0140845
NODE_139_length_5681_cov_68.065030	4771	4842	163	3	71	0.0422535
NODE_139_length_5681_cov_68.065030	4815	4895	44	22	80	0.2750000
NODE_139_length_5681_cov_68.065030	4815	4895	45	9	80	0.1125000
NODE_139_length_5681_cov_68.065030	4815	4895	46	1	80	0.0125000
NODE_139_length_5681_cov_68.065030	4815	4895	48	3	80	0.0375000
NODE_139_length_5681_cov_68.065030	4815	4895	54	1	80	0.0125000
NODE_139_length_5681_cov_68.065030	4815	4895	55	5	80	0.0625000
NODE_139_length_5681_cov_68.065030	4815	4895	81	7	80	0.0875000
NODE_139_length_5681_cov_68.065030	4815	4895	83	5	80	0.0625000
NODE_139_length_5681_cov_68.065030	4815	4895	87	4	80	0.0500000
NODE_139_length_5681_cov_68.065030	4815	4895	88	1	80	0.0125000
NODE_139_length_5681_cov_68.065030	4815	4895	90	1	80	0.0125000
NODE_139_length_5681_cov_68.065030	4815	4895	105	4	80	0.0500000
NODE_139_length_5681_cov_68.065030	4815	4895	109	5	80	0.0625000
NODE_139_length_5681_cov_68.065030	4815	4895	113	2	80	0.0250000
NODE_139_length_5681_cov_68.065030	4815	4895	124	1	80	0.0125000
NODE_139_length_5681_cov_68.065030	4815	4895	126	3	80	0.0375000
NODE_139_length_5681_cov_68.065030	4815	4895	128	5	80	0.0625000
NODE_139_length_5681_cov_68.065030	4815	4895	130	1	80	0.0125000
NODE_139_length_5681_cov_68.065030	4815	4895	44	22	80	0.2750000
NODE_139_length_5681_cov_68.065030	4815	4895	45	9	80	0.1125000
NODE_139_length_5681_cov_68.065030	4815	4895	46	1	80	0.0125000
NODE_139_length_5681_cov_68.065030	4815	4895	48	3	80	0.0375000
NODE_139_length_5681_cov_68.065030	4815	4895	54	1	80	0.0125000
NODE_139_length_5681_cov_68.065030	4815	4895	55	5	80	0.0625000
NODE_139_length_5681_cov_68.065030	4815	4895	81	7	80	0.0875000
NODE_139_length_5681_cov_68.065030	4815	4895	83	5	80	0.0625000
NODE_139_length_5681_cov_68.065030	4815	4895	87	4	80	0.0500000
NODE_139_length_5681_cov_68.065030	4815	4895	88	1	80	0.0125000
NODE_139_length_5681_cov_68.065030	4815	4895	90	1	80	0.0125000
NODE_139_length_5681_cov_68.065030	4815	4895	105	4	80	0.0500000
NODE_139_length_5681_cov_68.065030	4815	4895	109	5	80	0.0625000
NODE_139_length_5681_cov_68.065030	4815	4895	113	2	80	0.0250000
NODE_139_length_5681_cov_68.065030	4815	4895	124	1	80	0.0125000
NODE_139_length_5681_cov_68.065030	4815	4895	126	3	80	0.0375000
NODE_139_length_5681_cov_68.065030	4815	4895	128	5	80	0.0625000
NODE_139_length_5681_cov_68.065030	4815	4895	130	1	80	0.0125000
NODE_139_length_5681_cov_68.065030	4815	4895	44	22	80	0.2750000
NODE_139_length_5681_cov_68.065030	4815	4895	45	9	80	0.1125000
NODE_139_length_5681_cov_68.065030	4815	4895	46	1	80	0.0125000
NODE_139_length_5681_cov_68.065030	4815	4895	48	3	80	0.0375000
NODE_139_length_5681_cov_68.065030	4815	4895	54	1	80	0.0125000
NODE_139_length_5681_cov_68.065030	4815	4895	55	5	80	0.0625000
NODE_139_length_5681_cov_68.065030	4815	4895	81	7	80	0.0875000
NODE_139_length_5681_cov_68.065030	4815	4895	83	5	80	0.0625000
NODE_139_length_5681_cov_68.065030	4815	4895	87	4	80	0.0500000
NODE_139_length_5681_cov_68.065030	4815	4895	88	1	80	0.0125000
NODE_139_length_5681_cov_68.065030	4815	4895	90	1	80	0.0125000
NODE_139_length_5681_cov_68.065030	4815	4895	105	4	80	0.0500000
NODE_139_length_5681_cov_68.065030	4815	4895	109	5	80	0.0625000
NODE_139_length_5681_cov_68.065030	4815	4895	113	2	80	0.0250000
NODE_139_length_5681_cov_68.065030	4815	4895	124	1	80	0.0125000
NODE_139_length_5681_cov_68.065030	4815	4895	126	3	80	0.0375000
NODE_139_length_5681_cov_68.065030	4815	4895	128	5	80	0.0625000
NODE_139_length_5681_cov_68.065030	4815	4895	130	1	80	0.0125000
NODE_139_length_5681_cov_68.065030	4815	4895	44	22	80	0.2750000
NODE_139_length_5681_cov_68.065030	4815	4895	45	9	80	0.1125000
NODE_139_length_5681_cov_68.065030	4815	4895	46	1	80	0.0125000
NODE_139_length_5681_cov_68.065030	4815	4895	48	3	80	0.0375000
NODE_139_length_5681_cov_68.065030	4815	4895	54	1	80	0.0125000
NODE_139_length_5681_cov_68.065030	4815	4895	55	5	80	0.0625000
NODE_139_length_5681_cov_68.065030	4815	4895	81	7	80	0.0875000
NODE_139_length_5681_cov_68.065030	4815	4895	83	5	80	0.0625000
NODE_139_length_5681_cov_68.065030	4815	4895	87	4	80	0.0500000
NODE_139_length_5681_cov_68.065030	4815	4895	88	1	80	0.0125000
NODE_139_length_5681_cov_68.065030	4815	4895	90	1	80	0.0125000
NODE_139_length_5681_cov_68.065030	4815	4895	105	4	80	0.0500000
NODE_139_length_5681_cov_68.065030	4815	4895	109	5	80	0.0625000
NODE_139_length_5681_cov_68.065030	4815	4895	113	2	80	0.0250000
NODE_139_length_5681_cov_68.065030	4815	4895	124	1	80	0.0125000
NODE_139_length_5681_cov_68.065030	4815	4895	126	3	80	0.0375000
NODE_139_length_5681_cov_68.065030	4815	4895	128	5	80	0.0625000
NODE_139_length_5681_cov_68.065030	4815	4895	130	1	80	0.0125000
NODE_139_length_5681_cov_68.065030	4815	4895	44	22	80	0.2750000
NODE_139_length_5681_cov_68.065030	4815	4895	45	9	80	0.1125000
NODE_139_length_5681_cov_68.065030	4815	4895	46	1	80	0.0125000
NODE_139_length_5681_cov_68.065030	4815	4895	48	3	80	0.0375000
NODE_139_length_5681_cov_68.065030	4815	4895	54	1	80	0.0125000
NODE_139_length_5681_cov_68.065030	4815	4895	55	5	80	0.0625000
NODE_139_length_5681_cov_68.065030	4815	4895	81	7	80	0.0875000
NODE_139_length_5681_cov_68.065030	4815	4895	83	5	80	0.0625000
NODE_139_length_5681_cov_68.065030	4815	4895	87	4	80	0.0500000
NODE_139_length_5681_cov_68.065030	4815	4895	88	1	80	0.0125000
NODE_139_length_5681_cov_68.065030	4815	4895	90	1	80	0.0125000
NODE_139_length_5681_cov_68.065030	4815	4895	105	4	80	0.0500000
NODE_139_length_5681_cov_68.065030	4815	4895	109	5	80	0.0625000
NODE_139_length_5681_cov_68.065030	4815	4895	113	2	80	0.0250000
NODE_139_length_5681_cov_68.065030	4815	4895	124	1	80	0.0125000
NODE_139_length_5681_cov_68.065030	4815	4895	126	3	80	0.0375000
NODE_139_length_5681_cov_68.065030	4815	4895	128	5	80	0.0625000
NODE_139_length_5681_cov_68.065030	4815	4895	130	1	80	0.0125000
NODE_139_length_5681_cov_68.065030	4815	4895	44	22	80	0.2750000
NODE_139_length_5681_cov_68.065030	4815	4895	45	9	80	0.1125000
NODE_139_length_5681_cov_68.065030	4815	4895	46	1	80	0.0125000
NODE_139_length_5681_cov_68.065030	4815	4895	48	3	80	0.0375000
NODE_139_length_5681_cov_68.065030	4815	4895	54	1	80	0.0125000
NODE_139_length_5681_cov_68.065030	4815	4895	55	5	80	0.0625000
NODE_139_length_5681_cov_68.065030	4815	4895	81	7	80	0.0875000
NODE_139_length_5681_cov_68.065030	4815	4895	83	5	80	0.0625000
NODE_139_length_5681_cov_68.065030	4815	4895	87	4	80	0.0500000
NODE_139_length_5681_cov_68.065030	4815	4895	88	1	80	0.0125000
NODE_139_length_5681_cov_68.065030	4815	4895	90	1	80	0.0125000
NODE_139_length_5681_cov_68.065030	4815	4895	105	4	80	0.0500000
NODE_139_length_5681_cov_68.065030	4815	4895	109	5	80	0.0625000
NODE_139_length_5681_cov_68.065030	4815	4895	113	2	80	0.0250000
NODE_139_length_5681_cov_68.065030	4815	4895	124	1	80	0.0125000
NODE_139_length_5681_cov_68.065030	4815	4895	126	3	80	0.0375000
NODE_139_length_5681_cov_68.065030	4815	4895	128	5	80	0.0625000
NODE_139_length_5681_cov_68.065030	4815	4895	130	1	80	0.0125000
NODE_139_length_5681_cov_68.065030	4891	4971	2	20	80	0.2500000
NODE_139_length_5681_cov_68.065030	4891	4971	4	14	80	0.1750000
NODE_139_length_5681_cov_68.065030	4891	4971	6	1	80	0.0125000
NODE_139_length_5681_cov_68.065030	4891	4971	7	15	80	0.1875000
NODE_139_length_5681_cov_68.065030	4891	4971	12	1	80	0.0125000
NODE_139_length_5681_cov_68.065030	4891	4971	17	5	80	0.0625000
NODE_139_length_5681_cov_68.065030	4891	4971	18	2	80	0.0250000
NODE_139_length_5681_cov_68.065030	4891	4971	19	7	80	0.0875000
NODE_139_length_5681_cov_68.065030	4891	4971	23	1	80	0.0125000
NODE_139_length_5681_cov_68.065030	4891	4971	24	2	80	0.0250000
NODE_139_length_5681_cov_68.065030	4891	4971	25	6	80	0.0750000
NODE_139_length_5681_cov_68.065030	4891	4971	43	1	80	0.0125000
NODE_139_length_5681_cov_68.065030	4891	4971	45	5	80	0.0625000
NODE_139_length_5681_cov_68.065030	4944	5007	0	36	63	0.5714286
NODE_139_length_5681_cov_68.065030	4944	5007	2	20	63	0.3174603
NODE_139_length_5681_cov_68.065030	4944	5007	4	7	63	0.1111111
NODE_139_length_5681_cov_68.065030	4944	5024	0	53	80	0.6625000
NODE_139_length_5681_cov_68.065030	4944	5024	2	20	80	0.2500000
NODE_139_length_5681_cov_68.065030	4944	5024	4	7	80	0.0875000
NODE_140_length_5677_cov_21.613482	1792	1863	16	1	71	0.0140845
NODE_140_length_5677_cov_21.613482	1792	1863	17	3	71	0.0422535
NODE_140_length_5677_cov_21.613482	1792	1863	18	10	71	0.1408451
NODE_140_length_5677_cov_21.613482	1792	1863	19	11	71	0.1549296
NODE_140_length_5677_cov_21.613482	1792	1863	20	4	71	0.0563380
NODE_140_length_5677_cov_21.613482	1792	1863	21	6	71	0.0845070
NODE_140_length_5677_cov_21.613482	1792	1863	22	3	71	0.0422535
NODE_140_length_5677_cov_21.613482	1792	1863	23	2	71	0.0281690
NODE_140_length_5677_cov_21.613482	1792	1863	24	7	71	0.0985916
NODE_140_length_5677_cov_21.613482	1792	1863	26	4	71	0.0563380
NODE_140_length_5677_cov_21.613482	1792	1863	28	1	71	0.0140845
NODE_140_length_5677_cov_21.613482	1792	1863	30	15	71	0.2112676
NODE_140_length_5677_cov_21.613482	1792	1863	32	2	71	0.0281690
NODE_140_length_5677_cov_21.613482	1792	1863	34	2	71	0.0281690
NODE_140_length_5677_cov_21.613482	1845	1916	28	12	71	0.1690141
NODE_140_length_5677_cov_21.613482	1845	1916	30	21	71	0.2957746
NODE_140_length_5677_cov_21.613482	1845	1916	32	2	71	0.0281690
NODE_140_length_5677_cov_21.613482	1845	1916	34	4	71	0.0563380
NODE_140_length_5677_cov_21.613482	1845	1916	36	2	71	0.0281690
NODE_140_length_5677_cov_21.613482	1845	1916	38	1	71	0.0140845
NODE_140_length_5677_cov_21.613482	1845	1916	40	10	71	0.1408451
NODE_140_length_5677_cov_21.613482	1845	1916	42	17	71	0.2394366
NODE_140_length_5677_cov_21.613482	1845	1916	44	2	71	0.0281690
NODE_142_length_5631_cov_25.927332	96	176	10	5	80	0.0625000
NODE_142_length_5631_cov_25.927332	96	176	12	3	80	0.0375000
NODE_142_length_5631_cov_25.927332	96	176	16	1	80	0.0125000
NODE_142_length_5631_cov_25.927332	96	176	20	16	80	0.2000000
NODE_142_length_5631_cov_25.927332	96	176	22	28	80	0.3500000
NODE_142_length_5631_cov_25.927332	96	176	24	6	80	0.0750000
NODE_142_length_5631_cov_25.927332	96	176	25	21	80	0.2625000
NODE_142_length_5631_cov_25.927332	149	229	9	25	80	0.3125000
NODE_142_length_5631_cov_25.927332	149	229	11	2	80	0.0250000
NODE_142_length_5631_cov_25.927332	149	229	15	17	80	0.2125000
NODE_142_length_5631_cov_25.927332	149	229	16	6	80	0.0750000
NODE_142_length_5631_cov_25.927332	149	229	17	2	80	0.0250000
NODE_142_length_5631_cov_25.927332	149	229	22	20	80	0.2500000
NODE_142_length_5631_cov_25.927332	149	229	24	1	80	0.0125000
NODE_142_length_5631_cov_25.927332	149	229	25	7	80	0.0875000
NODE_146_length_5588_cov_40.961377	2793	2873	21	3	80	0.0375000
NODE_146_length_5588_cov_40.961377	2793	2873	23	10	80	0.1250000
NODE_146_length_5588_cov_40.961377	2793	2873	25	7	80	0.0875000
NODE_146_length_5588_cov_40.961377	2793	2873	27	13	80	0.1625000
NODE_146_length_5588_cov_40.961377	2793	2873	29	13	80	0.1625000
NODE_146_length_5588_cov_40.961377	2793	2873	32	13	80	0.1625000
NODE_146_length_5588_cov_40.961377	2793	2873	33	8	80	0.1000000
NODE_146_length_5588_cov_40.961377	2793	2873	34	1	80	0.0125000
NODE_146_length_5588_cov_40.961377	2793	2873	35	8	80	0.1000000
NODE_146_length_5588_cov_40.961377	2793	2873	36	4	80	0.0500000
NODE_146_length_5588_cov_40.961377	2846	2926	4	5	80	0.0625000
NODE_146_length_5588_cov_40.961377	2846	2926	9	1	80	0.0125000
NODE_146_length_5588_cov_40.961377	2846	2926	10	12	80	0.1500000
NODE_146_length_5588_cov_40.961377	2846	2926	14	2	80	0.0250000
NODE_146_length_5588_cov_40.961377	2846	2926	16	10	80	0.1250000
NODE_146_length_5588_cov_40.961377	2846	2926	18	20	80	0.2500000
NODE_146_length_5588_cov_40.961377	2846	2926	21	3	80	0.0375000
NODE_146_length_5588_cov_40.961377	2846	2926	22	2	80	0.0250000
NODE_146_length_5588_cov_40.961377	2846	2926	23	5	80	0.0625000
NODE_146_length_5588_cov_40.961377	2846	2926	25	7	80	0.0875000
NODE_146_length_5588_cov_40.961377	2846	2926	29	4	80	0.0500000
NODE_146_length_5588_cov_40.961377	2846	2926	32	9	80	0.1125000
NODE_146_length_5588_cov_40.961377	2922	3002	2	19	80	0.2375000
NODE_146_length_5588_cov_40.961377	2922	3002	4	12	80	0.1500000
NODE_146_length_5588_cov_40.961377	2922	3002	8	16	80	0.2000000
NODE_146_length_5588_cov_40.961377	2922	3002	10	3	80	0.0375000
NODE_146_length_5588_cov_40.961377	2922	3002	12	6	80	0.0750000
NODE_146_length_5588_cov_40.961377	2922	3002	13	3	80	0.0375000
NODE_146_length_5588_cov_40.961377	2922	3002	14	1	80	0.0125000
NODE_146_length_5588_cov_40.961377	2922	3002	19	1	80	0.0125000
NODE_146_length_5588_cov_40.961377	2922	3002	20	1	80	0.0125000
NODE_146_length_5588_cov_40.961377	2922	3002	26	2	80	0.0250000
NODE_146_length_5588_cov_40.961377	2922	3002	30	7	80	0.0875000
NODE_146_length_5588_cov_40.961377	2922	3002	32	2	80	0.0250000
NODE_146_length_5588_cov_40.961377	2922	3002	34	7	80	0.0875000
NODE_146_length_5588_cov_40.961377	2975	3055	12	3	80	0.0375000
NODE_146_length_5588_cov_40.961377	2975	3055	13	3	80	0.0375000
NODE_146_length_5588_cov_40.961377	2975	3055	14	1	80	0.0125000
NODE_146_length_5588_cov_40.961377	2975	3055	19	1	80	0.0125000
NODE_146_length_5588_cov_40.961377	2975	3055	20	1	80	0.0125000
NODE_146_length_5588_cov_40.961377	2975	3055	26	2	80	0.0250000
NODE_146_length_5588_cov_40.961377	2975	3055	30	7	80	0.0875000
NODE_146_length_5588_cov_40.961377	2975	3055	31	18	80	0.2250000
NODE_146_length_5588_cov_40.961377	2975	3055	32	21	80	0.2625000
NODE_146_length_5588_cov_40.961377	2975	3055	34	10	80	0.1250000
NODE_146_length_5588_cov_40.961377	2975	3055	35	1	80	0.0125000
NODE_146_length_5588_cov_40.961377	2975	3055	36	3	80	0.0375000
NODE_146_length_5588_cov_40.961377	2975	3055	38	2	80	0.0250000
NODE_146_length_5588_cov_40.961377	2975	3055	39	5	80	0.0625000
NODE_146_length_5588_cov_40.961377	2975	3055	41	2	80	0.0250000
NODE_149_length_5578_cov_5.173389	331	411	2	5	80	0.0625000
NODE_149_length_5578_cov_5.173389	331	411	4	71	80	0.8875000
NODE_149_length_5578_cov_5.173389	331	411	7	4	80	0.0500000
NODE_149_length_5578_cov_5.173389	388	464	3	8	76	0.1052632
NODE_149_length_5578_cov_5.173389	388	464	4	19	76	0.2500000
NODE_149_length_5578_cov_5.173389	388	464	5	24	76	0.3157895
NODE_149_length_5578_cov_5.173389	388	464	7	25	76	0.3289474
NODE_150_length_5572_cov_79.124246	1555	1627	38	3	72	0.0416667
NODE_150_length_5572_cov_79.124246	1555	1627	39	1	72	0.0138889
NODE_150_length_5572_cov_79.124246	1555	1627	40	4	72	0.0555556
NODE_150_length_5572_cov_79.124246	1555	1627	42	7	72	0.0972222
NODE_150_length_5572_cov_79.124246	1555	1627	43	1	72	0.0138889
NODE_150_length_5572_cov_79.124246	1555	1627	44	4	72	0.0555556
NODE_150_length_5572_cov_79.124246	1555	1627	45	1	72	0.0138889
NODE_150_length_5572_cov_79.124246	1555	1627	47	2	72	0.0277778
NODE_150_length_5572_cov_79.124246	1555	1627	48	1	72	0.0138889
NODE_150_length_5572_cov_79.124246	1555	1627	49	2	72	0.0277778
NODE_150_length_5572_cov_79.124246	1555	1627	50	5	72	0.0694444
NODE_150_length_5572_cov_79.124246	1555	1627	52	2	72	0.0277778
NODE_150_length_5572_cov_79.124246	1555	1627	57	3	72	0.0416667
NODE_150_length_5572_cov_79.124246	1555	1627	59	2	72	0.0277778
NODE_150_length_5572_cov_79.124246	1555	1627	64	1	72	0.0138889
NODE_150_length_5572_cov_79.124246	1555	1627	73	1	72	0.0138889
NODE_150_length_5572_cov_79.124246	1555	1627	78	2	72	0.0277778
NODE_150_length_5572_cov_79.124246	1555	1627	85	1	72	0.0138889
NODE_150_length_5572_cov_79.124246	1555	1627	90	1	72	0.0138889
NODE_150_length_5572_cov_79.124246	1555	1627	98	1	72	0.0138889
NODE_150_length_5572_cov_79.124246	1555	1627	106	1	72	0.0138889
NODE_150_length_5572_cov_79.124246	1555	1627	111	1	72	0.0138889
NODE_150_length_5572_cov_79.124246	1555	1627	112	2	72	0.0277778
NODE_150_length_5572_cov_79.124246	1555	1627	114	1	72	0.0138889
NODE_150_length_5572_cov_79.124246	1555	1627	125	1	72	0.0138889
NODE_150_length_5572_cov_79.124246	1555	1627	132	1	72	0.0138889
NODE_150_length_5572_cov_79.124246	1555	1627	153	1	72	0.0138889
NODE_150_length_5572_cov_79.124246	1555	1627	155	1	72	0.0138889
NODE_150_length_5572_cov_79.124246	1555	1627	159	1	72	0.0138889
NODE_150_length_5572_cov_79.124246	1555	1627	164	1	72	0.0138889
NODE_150_length_5572_cov_79.124246	1555	1627	174	1	72	0.0138889
NODE_150_length_5572_cov_79.124246	1555	1627	188	1	72	0.0138889
NODE_150_length_5572_cov_79.124246	1555	1627	194	1	72	0.0138889
NODE_150_length_5572_cov_79.124246	1555	1627	195	1	72	0.0138889
NODE_150_length_5572_cov_79.124246	1555	1627	206	1	72	0.0138889
NODE_150_length_5572_cov_79.124246	1555	1627	213	1	72	0.0138889
NODE_150_length_5572_cov_79.124246	1555	1627	219	1	72	0.0138889
NODE_150_length_5572_cov_79.124246	1555	1627	249	3	72	0.0416667
NODE_150_length_5572_cov_79.124246	1555	1627	252	1	72	0.0138889
NODE_150_length_5572_cov_79.124246	1555	1627	258	1	72	0.0138889
NODE_150_length_5572_cov_79.124246	1555	1627	265	1	72	0.0138889
NODE_150_length_5572_cov_79.124246	1555	1627	269	1	72	0.0138889
NODE_150_length_5572_cov_79.124246	1555	1627	274	1	72	0.0138889
NODE_150_length_5572_cov_79.124246	1555	1627	288	1	72	0.0138889
NODE_150_length_5572_cov_79.124246	1603	1680	112	1	77	0.0129870
NODE_150_length_5572_cov_79.124246	1603	1680	114	1	77	0.0129870
NODE_150_length_5572_cov_79.124246	1603	1680	125	1	77	0.0129870
NODE_150_length_5572_cov_79.124246	1603	1680	132	1	77	0.0129870
NODE_150_length_5572_cov_79.124246	1603	1680	153	1	77	0.0129870
NODE_150_length_5572_cov_79.124246	1603	1680	155	1	77	0.0129870
NODE_150_length_5572_cov_79.124246	1603	1680	159	1	77	0.0129870
NODE_150_length_5572_cov_79.124246	1603	1680	164	1	77	0.0129870
NODE_150_length_5572_cov_79.124246	1603	1680	174	1	77	0.0129870
NODE_150_length_5572_cov_79.124246	1603	1680	188	1	77	0.0129870
NODE_150_length_5572_cov_79.124246	1603	1680	194	1	77	0.0129870
NODE_150_length_5572_cov_79.124246	1603	1680	195	1	77	0.0129870
NODE_150_length_5572_cov_79.124246	1603	1680	206	1	77	0.0129870
NODE_150_length_5572_cov_79.124246	1603	1680	213	1	77	0.0129870
NODE_150_length_5572_cov_79.124246	1603	1680	219	1	77	0.0129870
NODE_150_length_5572_cov_79.124246	1603	1680	249	3	77	0.0389610
NODE_150_length_5572_cov_79.124246	1603	1680	252	1	77	0.0129870
NODE_150_length_5572_cov_79.124246	1603	1680	258	1	77	0.0129870
NODE_150_length_5572_cov_79.124246	1603	1680	265	1	77	0.0129870
NODE_150_length_5572_cov_79.124246	1603	1680	269	1	77	0.0129870
NODE_150_length_5572_cov_79.124246	1603	1680	274	1	77	0.0129870
NODE_150_length_5572_cov_79.124246	1603	1680	288	1	77	0.0129870
NODE_150_length_5572_cov_79.124246	1603	1680	292	1	77	0.0129870
NODE_150_length_5572_cov_79.124246	1603	1680	295	1	77	0.0129870
NODE_150_length_5572_cov_79.124246	1603	1680	297	1	77	0.0129870
NODE_150_length_5572_cov_79.124246	1603	1680	300	2	77	0.0259740
NODE_150_length_5572_cov_79.124246	1603	1680	306	1	77	0.0129870
NODE_150_length_5572_cov_79.124246	1603	1680	322	1	77	0.0129870
NODE_150_length_5572_cov_79.124246	1603	1680	326	1	77	0.0129870
NODE_150_length_5572_cov_79.124246	1603	1680	337	1	77	0.0129870
NODE_150_length_5572_cov_79.124246	1603	1680	355	1	77	0.0129870
NODE_150_length_5572_cov_79.124246	1603	1680	374	1	77	0.0129870
NODE_150_length_5572_cov_79.124246	1603	1680	379	1	77	0.0129870
NODE_150_length_5572_cov_79.124246	1603	1680	385	2	77	0.0259740
NODE_150_length_5572_cov_79.124246	1603	1680	395	1	77	0.0129870
NODE_150_length_5572_cov_79.124246	1603	1680	413	1	77	0.0129870
NODE_150_length_5572_cov_79.124246	1603	1680	433	1	77	0.0129870
NODE_150_length_5572_cov_79.124246	1603	1680	452	1	77	0.0129870
NODE_150_length_5572_cov_79.124246	1603	1680	475	1	77	0.0129870
NODE_150_length_5572_cov_79.124246	1603	1680	477	1	77	0.0129870
NODE_150_length_5572_cov_79.124246	1603	1680	510	1	77	0.0129870
NODE_150_length_5572_cov_79.124246	1603	1680	542	1	77	0.0129870
NODE_150_length_5572_cov_79.124246	1603	1680	546	1	77	0.0129870
NODE_150_length_5572_cov_79.124246	1603	1680	559	1	77	0.0129870
NODE_150_length_5572_cov_79.124246	1603	1680	573	1	77	0.0129870
NODE_150_length_5572_cov_79.124246	1603	1680	620	1	77	0.0129870
NODE_150_length_5572_cov_79.124246	1603	1680	633	1	77	0.0129870
NODE_150_length_5572_cov_79.124246	1603	1680	653	1	77	0.0129870
NODE_150_length_5572_cov_79.124246	1603	1680	666	2	77	0.0259740
NODE_150_length_5572_cov_79.124246	1603	1680	673	1	77	0.0129870
NODE_150_length_5572_cov_79.124246	1603	1680	679	1	77	0.0129870
NODE_150_length_5572_cov_79.124246	1603	1680	690	1	77	0.0129870
NODE_150_length_5572_cov_79.124246	1603	1680	703	2	77	0.0259740
NODE_150_length_5572_cov_79.124246	1603	1680	735	1	77	0.0129870
NODE_150_length_5572_cov_79.124246	1603	1680	747	1	77	0.0129870
NODE_150_length_5572_cov_79.124246	1603	1680	757	2	77	0.0259740
NODE_150_length_5572_cov_79.124246	1603	1680	767	1	77	0.0129870
NODE_150_length_5572_cov_79.124246	1603	1680	774	1	77	0.0129870
NODE_150_length_5572_cov_79.124246	1603	1680	813	1	77	0.0129870
NODE_150_length_5572_cov_79.124246	1603	1680	818	1	77	0.0129870
NODE_150_length_5572_cov_79.124246	1603	1680	827	1	77	0.0129870
NODE_150_length_5572_cov_79.124246	1603	1680	842	1	77	0.0129870
NODE_150_length_5572_cov_79.124246	1603	1680	863	1	77	0.0129870
NODE_150_length_5572_cov_79.124246	1603	1680	875	1	77	0.0129870
NODE_150_length_5572_cov_79.124246	1603	1680	897	1	77	0.0129870
NODE_150_length_5572_cov_79.124246	1603	1680	914	1	77	0.0129870
NODE_150_length_5572_cov_79.124246	1603	1680	920	1	77	0.0129870
NODE_150_length_5572_cov_79.124246	1603	1680	959	1	77	0.0129870
NODE_150_length_5572_cov_79.124246	1603	1680	971	1	77	0.0129870
NODE_150_length_5572_cov_79.124246	1603	1680	988	1	77	0.0129870
NODE_150_length_5572_cov_79.124246	1637	1717	374	1	80	0.0125000
NODE_150_length_5572_cov_79.124246	1637	1717	379	1	80	0.0125000
NODE_150_length_5572_cov_79.124246	1637	1717	385	2	80	0.0250000
NODE_150_length_5572_cov_79.124246	1637	1717	395	1	80	0.0125000
NODE_150_length_5572_cov_79.124246	1637	1717	413	1	80	0.0125000
NODE_150_length_5572_cov_79.124246	1637	1717	433	1	80	0.0125000
NODE_150_length_5572_cov_79.124246	1637	1717	452	1	80	0.0125000
NODE_150_length_5572_cov_79.124246	1637	1717	475	1	80	0.0125000
NODE_150_length_5572_cov_79.124246	1637	1717	477	1	80	0.0125000
NODE_150_length_5572_cov_79.124246	1637	1717	510	1	80	0.0125000
NODE_150_length_5572_cov_79.124246	1637	1717	542	1	80	0.0125000
NODE_150_length_5572_cov_79.124246	1637	1717	546	1	80	0.0125000
NODE_150_length_5572_cov_79.124246	1637	1717	559	1	80	0.0125000
NODE_150_length_5572_cov_79.124246	1637	1717	573	1	80	0.0125000
NODE_150_length_5572_cov_79.124246	1637	1717	620	1	80	0.0125000
NODE_150_length_5572_cov_79.124246	1637	1717	633	1	80	0.0125000
NODE_150_length_5572_cov_79.124246	1637	1717	653	1	80	0.0125000
NODE_150_length_5572_cov_79.124246	1637	1717	666	2	80	0.0250000
NODE_150_length_5572_cov_79.124246	1637	1717	673	1	80	0.0125000
NODE_150_length_5572_cov_79.124246	1637	1717	679	1	80	0.0125000
NODE_150_length_5572_cov_79.124246	1637	1717	690	1	80	0.0125000
NODE_150_length_5572_cov_79.124246	1637	1717	703	2	80	0.0250000
NODE_150_length_5572_cov_79.124246	1637	1717	735	1	80	0.0125000
NODE_150_length_5572_cov_79.124246	1637	1717	747	1	80	0.0125000
NODE_150_length_5572_cov_79.124246	1637	1717	757	2	80	0.0250000
NODE_150_length_5572_cov_79.124246	1637	1717	767	1	80	0.0125000
NODE_150_length_5572_cov_79.124246	1637	1717	774	1	80	0.0125000
NODE_150_length_5572_cov_79.124246	1637	1717	813	1	80	0.0125000
NODE_150_length_5572_cov_79.124246	1637	1717	818	1	80	0.0125000
NODE_150_length_5572_cov_79.124246	1637	1717	827	1	80	0.0125000
NODE_150_length_5572_cov_79.124246	1637	1717	842	1	80	0.0125000
NODE_150_length_5572_cov_79.124246	1637	1717	863	1	80	0.0125000
NODE_150_length_5572_cov_79.124246	1637	1717	875	1	80	0.0125000
NODE_150_length_5572_cov_79.124246	1637	1717	897	1	80	0.0125000
NODE_150_length_5572_cov_79.124246	1637	1717	914	1	80	0.0125000
NODE_150_length_5572_cov_79.124246	1637	1717	920	1	80	0.0125000
NODE_150_length_5572_cov_79.124246	1637	1717	959	1	80	0.0125000
NODE_150_length_5572_cov_79.124246	1637	1717	971	1	80	0.0125000
NODE_150_length_5572_cov_79.124246	1637	1717	988	1	80	0.0125000
NODE_150_length_5572_cov_79.124246	1637	1717	996	1	80	0.0125000
NODE_150_length_5572_cov_79.124246	1637	1717	1000	1	80	0.0125000
NODE_150_length_5572_cov_79.124246	1637	1717	1013	1	80	0.0125000
NODE_150_length_5572_cov_79.124246	1637	1717	1031	1	80	0.0125000
NODE_150_length_5572_cov_79.124246	1637	1717	1032	1	80	0.0125000
NODE_150_length_5572_cov_79.124246	1637	1717	1033	1	80	0.0125000
NODE_150_length_5572_cov_79.124246	1637	1717	1040	1	80	0.0125000
NODE_150_length_5572_cov_79.124246	1637	1717	1052	1	80	0.0125000
NODE_150_length_5572_cov_79.124246	1637	1717	1079	1	80	0.0125000
NODE_150_length_5572_cov_79.124246	1637	1717	1080	1	80	0.0125000
NODE_150_length_5572_cov_79.124246	1637	1717	1103	1	80	0.0125000
NODE_150_length_5572_cov_79.124246	1637	1717	1106	1	80	0.0125000
NODE_150_length_5572_cov_79.124246	1637	1717	1118	1	80	0.0125000
NODE_150_length_5572_cov_79.124246	1637	1717	1131	1	80	0.0125000
NODE_150_length_5572_cov_79.124246	1637	1717	1137	1	80	0.0125000
NODE_150_length_5572_cov_79.124246	1637	1717	1156	1	80	0.0125000
NODE_150_length_5572_cov_79.124246	1637	1717	1172	1	80	0.0125000
NODE_150_length_5572_cov_79.124246	1637	1717	1181	1	80	0.0125000
NODE_150_length_5572_cov_79.124246	1637	1717	1191	1	80	0.0125000
NODE_150_length_5572_cov_79.124246	1637	1717	1193	1	80	0.0125000
NODE_150_length_5572_cov_79.124246	1637	1717	1200	1	80	0.0125000
NODE_150_length_5572_cov_79.124246	1637	1717	1209	2	80	0.0250000
NODE_150_length_5572_cov_79.124246	1637	1717	1218	1	80	0.0125000
NODE_150_length_5572_cov_79.124246	1637	1717	1219	2	80	0.0250000
NODE_150_length_5572_cov_79.124246	1637	1717	1223	1	80	0.0125000
NODE_150_length_5572_cov_79.124246	1637	1717	1225	1	80	0.0125000
NODE_150_length_5572_cov_79.124246	1637	1717	1230	2	80	0.0250000
NODE_150_length_5572_cov_79.124246	1637	1717	1232	2	80	0.0250000
NODE_150_length_5572_cov_79.124246	1637	1717	1233	2	80	0.0250000
NODE_150_length_5572_cov_79.124246	1637	1717	1234	2	80	0.0250000
NODE_150_length_5572_cov_79.124246	1637	1717	1236	1	80	0.0125000
NODE_150_length_5572_cov_79.124246	1690	1770	739	1	80	0.0125000
NODE_150_length_5572_cov_79.124246	1690	1770	753	1	80	0.0125000
NODE_150_length_5572_cov_79.124246	1690	1770	806	1	80	0.0125000
NODE_150_length_5572_cov_79.124246	1690	1770	831	1	80	0.0125000
NODE_150_length_5572_cov_79.124246	1690	1770	858	1	80	0.0125000
NODE_150_length_5572_cov_79.124246	1690	1770	883	1	80	0.0125000
NODE_150_length_5572_cov_79.124246	1690	1770	903	1	80	0.0125000
NODE_150_length_5572_cov_79.124246	1690	1770	911	1	80	0.0125000
NODE_150_length_5572_cov_79.124246	1690	1770	928	1	80	0.0125000
NODE_150_length_5572_cov_79.124246	1690	1770	937	1	80	0.0125000
NODE_150_length_5572_cov_79.124246	1690	1770	964	1	80	0.0125000
NODE_150_length_5572_cov_79.124246	1690	1770	972	1	80	0.0125000
NODE_150_length_5572_cov_79.124246	1690	1770	988	1	80	0.0125000
NODE_150_length_5572_cov_79.124246	1690	1770	1028	1	80	0.0125000
NODE_150_length_5572_cov_79.124246	1690	1770	1033	1	80	0.0125000
NODE_150_length_5572_cov_79.124246	1690	1770	1036	1	80	0.0125000
NODE_150_length_5572_cov_79.124246	1690	1770	1042	1	80	0.0125000
NODE_150_length_5572_cov_79.124246	1690	1770	1050	1	80	0.0125000
NODE_150_length_5572_cov_79.124246	1690	1770	1055	1	80	0.0125000
NODE_150_length_5572_cov_79.124246	1690	1770	1057	2	80	0.0250000
NODE_150_length_5572_cov_79.124246	1690	1770	1066	1	80	0.0125000
NODE_150_length_5572_cov_79.124246	1690	1770	1074	1	80	0.0125000
NODE_150_length_5572_cov_79.124246	1690	1770	1090	1	80	0.0125000
NODE_150_length_5572_cov_79.124246	1690	1770	1092	1	80	0.0125000
NODE_150_length_5572_cov_79.124246	1690	1770	1098	1	80	0.0125000
NODE_150_length_5572_cov_79.124246	1690	1770	1103	1	80	0.0125000
NODE_150_length_5572_cov_79.124246	1690	1770	1106	1	80	0.0125000
NODE_150_length_5572_cov_79.124246	1690	1770	1118	1	80	0.0125000
NODE_150_length_5572_cov_79.124246	1690	1770	1131	1	80	0.0125000
NODE_150_length_5572_cov_79.124246	1690	1770	1136	1	80	0.0125000
NODE_150_length_5572_cov_79.124246	1690	1770	1137	1	80	0.0125000
NODE_150_length_5572_cov_79.124246	1690	1770	1141	1	80	0.0125000
NODE_150_length_5572_cov_79.124246	1690	1770	1146	1	80	0.0125000
NODE_150_length_5572_cov_79.124246	1690	1770	1156	1	80	0.0125000
NODE_150_length_5572_cov_79.124246	1690	1770	1159	1	80	0.0125000
NODE_150_length_5572_cov_79.124246	1690	1770	1160	1	80	0.0125000
NODE_150_length_5572_cov_79.124246	1690	1770	1167	1	80	0.0125000
NODE_150_length_5572_cov_79.124246	1690	1770	1172	1	80	0.0125000
NODE_150_length_5572_cov_79.124246	1690	1770	1181	1	80	0.0125000
NODE_150_length_5572_cov_79.124246	1690	1770	1182	1	80	0.0125000
NODE_150_length_5572_cov_79.124246	1690	1770	1184	1	80	0.0125000
NODE_150_length_5572_cov_79.124246	1690	1770	1186	1	80	0.0125000
NODE_150_length_5572_cov_79.124246	1690	1770	1191	1	80	0.0125000
NODE_150_length_5572_cov_79.124246	1690	1770	1193	1	80	0.0125000
NODE_150_length_5572_cov_79.124246	1690	1770	1197	1	80	0.0125000
NODE_150_length_5572_cov_79.124246	1690	1770	1200	1	80	0.0125000
NODE_150_length_5572_cov_79.124246	1690	1770	1203	1	80	0.0125000
NODE_150_length_5572_cov_79.124246	1690	1770	1209	2	80	0.0250000
NODE_150_length_5572_cov_79.124246	1690	1770	1211	1	80	0.0125000
NODE_150_length_5572_cov_79.124246	1690	1770	1216	1	80	0.0125000
NODE_150_length_5572_cov_79.124246	1690	1770	1217	1	80	0.0125000
NODE_150_length_5572_cov_79.124246	1690	1770	1218	1	80	0.0125000
NODE_150_length_5572_cov_79.124246	1690	1770	1219	2	80	0.0250000
NODE_150_length_5572_cov_79.124246	1690	1770	1220	1	80	0.0125000
NODE_150_length_5572_cov_79.124246	1690	1770	1222	2	80	0.0250000
NODE_150_length_5572_cov_79.124246	1690	1770	1223	1	80	0.0125000
NODE_150_length_5572_cov_79.124246	1690	1770	1225	1	80	0.0125000
NODE_150_length_5572_cov_79.124246	1690	1770	1227	2	80	0.0250000
NODE_150_length_5572_cov_79.124246	1690	1770	1229	2	80	0.0250000
NODE_150_length_5572_cov_79.124246	1690	1770	1230	3	80	0.0375000
NODE_150_length_5572_cov_79.124246	1690	1770	1231	1	80	0.0125000
NODE_150_length_5572_cov_79.124246	1690	1770	1232	2	80	0.0250000
NODE_150_length_5572_cov_79.124246	1690	1770	1233	3	80	0.0375000
NODE_150_length_5572_cov_79.124246	1690	1770	1234	2	80	0.0250000
NODE_150_length_5572_cov_79.124246	1690	1770	1235	1	80	0.0125000
NODE_150_length_5572_cov_79.124246	1690	1770	1236	1	80	0.0125000
NODE_150_length_5572_cov_79.124246	1690	1770	1237	1	80	0.0125000
NODE_150_length_5572_cov_79.124246	1690	1770	1238	1	80	0.0125000
NODE_150_length_5572_cov_79.124246	5130	5210	0	28	80	0.3500000
NODE_150_length_5572_cov_79.124246	5130	5210	4	52	80	0.6500000
NODE_150_length_5572_cov_79.124246	5183	5263	4	80	80	1.0000000
NODE_151_length_5557_cov_26.198241	341	414	0	73	73	1.0000000
NODE_151_length_5557_cov_26.198241	394	460	0	66	66	1.0000000
NODE_156_length_5500_cov_35.832438	81	161	0	50	80	0.6250000
NODE_156_length_5500_cov_35.832438	81	161	11	1	80	0.0125000
NODE_156_length_5500_cov_35.832438	81	161	15	12	80	0.1500000
NODE_156_length_5500_cov_35.832438	81	161	16	17	80	0.2125000
NODE_156_length_5500_cov_35.832438	134	214	15	10	80	0.1250000
NODE_156_length_5500_cov_35.832438	134	214	16	59	80	0.7375000
NODE_156_length_5500_cov_35.832438	134	214	18	11	80	0.1375000
NODE_159_length_5470_cov_5.987526	5180	5249	0	16	69	0.2318841
NODE_159_length_5470_cov_5.987526	5180	5249	2	5	69	0.0724638
NODE_159_length_5470_cov_5.987526	5180	5249	6	48	69	0.6956522
NODE_160_length_5434_cov_14.997751	541	621	0	5	80	0.0625000
NODE_160_length_5434_cov_14.997751	541	621	2	1	80	0.0125000
NODE_160_length_5434_cov_14.997751	541	621	4	74	80	0.9250000
NODE_160_length_5434_cov_14.997751	594	674	0	36	80	0.4500000
NODE_160_length_5434_cov_14.997751	594	674	2	14	80	0.1750000
NODE_160_length_5434_cov_14.997751	594	674	4	30	80	0.3750000
NODE_160_length_5434_cov_14.997751	2664	2744	0	80	80	1.0000000
NODE_160_length_5434_cov_14.997751	2717	2797	0	80	80	1.0000000
NODE_160_length_5434_cov_14.997751	3041	3093	0	10	52	0.1923077
NODE_160_length_5434_cov_14.997751	3041	3093	2	42	52	0.8076923
NODE_160_length_5434_cov_14.997751	3419	3467	4	48	48	1.0000000
NODE_161_length_5425_cov_15.812242	141	218	58	1	77	0.0129870
NODE_161_length_5425_cov_15.812242	141	218	60	1	77	0.0129870
NODE_161_length_5425_cov_15.812242	141	218	61	1	77	0.0129870
NODE_161_length_5425_cov_15.812242	141	218	62	1	77	0.0129870
NODE_161_length_5425_cov_15.812242	141	218	64	2	77	0.0259740
NODE_161_length_5425_cov_15.812242	141	218	65	1	77	0.0129870
NODE_161_length_5425_cov_15.812242	141	218	82	1	77	0.0129870
NODE_161_length_5425_cov_15.812242	141	218	83	6	77	0.0779221
NODE_161_length_5425_cov_15.812242	141	218	85	4	77	0.0519481
NODE_161_length_5425_cov_15.812242	141	218	92	5	77	0.0649351
NODE_161_length_5425_cov_15.812242	141	218	93	5	77	0.0649351
NODE_161_length_5425_cov_15.812242	141	218	94	1	77	0.0129870
NODE_161_length_5425_cov_15.812242	141	218	95	2	77	0.0259740
NODE_161_length_5425_cov_15.812242	141	218	96	1	77	0.0129870
NODE_161_length_5425_cov_15.812242	141	218	97	4	77	0.0519481
NODE_161_length_5425_cov_15.812242	141	218	98	1	77	0.0129870
NODE_161_length_5425_cov_15.812242	141	218	99	4	77	0.0519481
NODE_161_length_5425_cov_15.812242	141	218	101	2	77	0.0259740
NODE_161_length_5425_cov_15.812242	141	218	103	5	77	0.0649351
NODE_161_length_5425_cov_15.812242	141	218	107	1	77	0.0129870
NODE_161_length_5425_cov_15.812242	141	218	109	1	77	0.0129870
NODE_161_length_5425_cov_15.812242	141	218	111	4	77	0.0519481
NODE_161_length_5425_cov_15.812242	141	218	113	1	77	0.0129870
NODE_161_length_5425_cov_15.812242	141	218	115	3	77	0.0389610
NODE_161_length_5425_cov_15.812242	141	218	117	1	77	0.0129870
NODE_161_length_5425_cov_15.812242	141	218	118	2	77	0.0259740
NODE_161_length_5425_cov_15.812242	141	218	119	1	77	0.0129870
NODE_161_length_5425_cov_15.812242	141	218	120	2	77	0.0259740
NODE_161_length_5425_cov_15.812242	141	218	121	2	77	0.0259740
NODE_161_length_5425_cov_15.812242	141	218	126	3	77	0.0389610
NODE_161_length_5425_cov_15.812242	141	218	127	5	77	0.0649351
NODE_161_length_5425_cov_15.812242	141	218	130	2	77	0.0259740
NODE_161_length_5425_cov_15.812242	141	218	132	1	77	0.0129870
NODE_161_length_5425_cov_15.812242	841	921	3	4	80	0.0500000
NODE_161_length_5425_cov_15.812242	841	921	5	11	80	0.1375000
NODE_161_length_5425_cov_15.812242	841	921	6	3	80	0.0375000
NODE_161_length_5425_cov_15.812242	841	921	7	62	80	0.7750000
NODE_161_length_5425_cov_15.812242	894	974	0	12	80	0.1500000
NODE_161_length_5425_cov_15.812242	894	974	1	2	80	0.0250000
NODE_161_length_5425_cov_15.812242	894	974	3	16	80	0.2000000
NODE_161_length_5425_cov_15.812242	894	974	5	29	80	0.3625000
NODE_161_length_5425_cov_15.812242	894	974	7	21	80	0.2625000
NODE_163_length_5402_cov_5.397322	191	263	30	59	72	0.8194444
NODE_163_length_5402_cov_5.397322	191	263	34	13	72	0.1805556
NODE_163_length_5402_cov_5.397322	2305	2385	65	2	80	0.0250000
NODE_163_length_5402_cov_5.397322	2305	2385	72	2	80	0.0250000
NODE_163_length_5402_cov_5.397322	2305	2385	73	2	80	0.0250000
NODE_163_length_5402_cov_5.397322	2305	2385	74	1	80	0.0125000
NODE_163_length_5402_cov_5.397322	2305	2385	77	1	80	0.0125000
NODE_163_length_5402_cov_5.397322	2305	2385	79	7	80	0.0875000
NODE_163_length_5402_cov_5.397322	2305	2385	81	2	80	0.0250000
NODE_163_length_5402_cov_5.397322	2305	2385	83	1	80	0.0125000
NODE_163_length_5402_cov_5.397322	2305	2385	87	2	80	0.0250000
NODE_163_length_5402_cov_5.397322	2305	2385	89	9	80	0.1125000
NODE_163_length_5402_cov_5.397322	2305	2385	91	1	80	0.0125000
NODE_163_length_5402_cov_5.397322	2305	2385	93	3	80	0.0375000
NODE_163_length_5402_cov_5.397322	2305	2385	96	5	80	0.0625000
NODE_163_length_5402_cov_5.397322	2305	2385	97	22	80	0.2750000
NODE_163_length_5402_cov_5.397322	2305	2385	99	4	80	0.0500000
NODE_163_length_5402_cov_5.397322	2305	2385	101	3	80	0.0375000
NODE_163_length_5402_cov_5.397322	2305	2385	102	7	80	0.0875000
NODE_163_length_5402_cov_5.397322	2305	2385	103	4	80	0.0500000
NODE_163_length_5402_cov_5.397322	2305	2385	104	2	80	0.0250000
NODE_163_length_5402_cov_5.397322	2358	2438	49	1	80	0.0125000
NODE_163_length_5402_cov_5.397322	2358	2438	51	4	80	0.0500000
NODE_163_length_5402_cov_5.397322	2358	2438	52	9	80	0.1125000
NODE_163_length_5402_cov_5.397322	2358	2438	53	2	80	0.0250000
NODE_163_length_5402_cov_5.397322	2358	2438	54	3	80	0.0375000
NODE_163_length_5402_cov_5.397322	2358	2438	56	2	80	0.0250000
NODE_163_length_5402_cov_5.397322	2358	2438	62	1	80	0.0125000
NODE_163_length_5402_cov_5.397322	2358	2438	78	7	80	0.0875000
NODE_163_length_5402_cov_5.397322	2358	2438	80	3	80	0.0375000
NODE_163_length_5402_cov_5.397322	2358	2438	82	11	80	0.1375000
NODE_163_length_5402_cov_5.397322	2358	2438	84	5	80	0.0625000
NODE_163_length_5402_cov_5.397322	2358	2438	85	4	80	0.0500000
NODE_163_length_5402_cov_5.397322	2358	2438	86	1	80	0.0125000
NODE_163_length_5402_cov_5.397322	2358	2438	87	2	80	0.0250000
NODE_163_length_5402_cov_5.397322	2358	2438	89	9	80	0.1125000
NODE_163_length_5402_cov_5.397322	2358	2438	91	1	80	0.0125000
NODE_163_length_5402_cov_5.397322	2358	2438	93	3	80	0.0375000
NODE_163_length_5402_cov_5.397322	2358	2438	96	3	80	0.0375000
NODE_163_length_5402_cov_5.397322	2358	2438	101	3	80	0.0375000
NODE_163_length_5402_cov_5.397322	2358	2438	102	5	80	0.0625000
NODE_163_length_5402_cov_5.397322	2358	2438	103	1	80	0.0125000
NODE_164_length_5383_cov_15.680545	205	285	1	16	80	0.2000000
NODE_164_length_5383_cov_15.680545	205	285	3	46	80	0.5750000
NODE_164_length_5383_cov_15.680545	205	285	4	18	80	0.2250000
NODE_164_length_5383_cov_15.680545	258	317	0	26	59	0.4406780
NODE_164_length_5383_cov_15.680545	258	317	1	22	59	0.3728814
NODE_164_length_5383_cov_15.680545	258	317	3	11	59	0.1864407
NODE_164_length_5383_cov_15.680545	2042	2122	11	7	80	0.0875000
NODE_164_length_5383_cov_15.680545	2042	2122	13	20	80	0.2500000
NODE_164_length_5383_cov_15.680545	2042	2122	15	3	80	0.0375000
NODE_164_length_5383_cov_15.680545	2042	2122	18	1	80	0.0125000
NODE_164_length_5383_cov_15.680545	2042	2122	19	15	80	0.1875000
NODE_164_length_5383_cov_15.680545	2042	2122	20	5	80	0.0625000
NODE_164_length_5383_cov_15.680545	2042	2122	22	14	80	0.1750000
NODE_164_length_5383_cov_15.680545	2042	2122	24	15	80	0.1875000
NODE_164_length_5383_cov_15.680545	2095	2175	0	21	80	0.2625000
NODE_164_length_5383_cov_15.680545	2095	2175	2	1	80	0.0125000
NODE_164_length_5383_cov_15.680545	2095	2175	6	10	80	0.1250000
NODE_164_length_5383_cov_15.680545	2095	2175	7	3	80	0.0375000
NODE_164_length_5383_cov_15.680545	2095	2175	9	3	80	0.0375000
NODE_164_length_5383_cov_15.680545	2095	2175	10	8	80	0.1000000
NODE_164_length_5383_cov_15.680545	2095	2175	11	14	80	0.1750000
NODE_164_length_5383_cov_15.680545	2095	2175	13	20	80	0.2500000
NODE_165_length_5382_cov_16.894378	1301	1347	2	25	46	0.5434783
NODE_165_length_5382_cov_16.894378	1301	1347	4	9	46	0.1956522
NODE_165_length_5382_cov_16.894378	1301	1347	5	7	46	0.1521739
NODE_165_length_5382_cov_16.894378	1301	1347	7	3	46	0.0652174
NODE_165_length_5382_cov_16.894378	1301	1347	8	2	46	0.0434783
NODE_165_length_5382_cov_16.894378	5056	5082	79	1	26	0.0384615
NODE_165_length_5382_cov_16.894378	5056	5082	82	1	26	0.0384615
NODE_165_length_5382_cov_16.894378	5056	5082	86	3	26	0.1153846
NODE_165_length_5382_cov_16.894378	5056	5082	90	1	26	0.0384615
NODE_165_length_5382_cov_16.894378	5056	5082	94	1	26	0.0384615
NODE_165_length_5382_cov_16.894378	5056	5082	95	1	26	0.0384615
NODE_165_length_5382_cov_16.894378	5056	5082	98	1	26	0.0384615
NODE_165_length_5382_cov_16.894378	5056	5082	100	1	26	0.0384615
NODE_165_length_5382_cov_16.894378	5056	5082	102	1	26	0.0384615
NODE_165_length_5382_cov_16.894378	5056	5082	106	1	26	0.0384615
NODE_165_length_5382_cov_16.894378	5056	5082	113	1	26	0.0384615
NODE_165_length_5382_cov_16.894378	5056	5082	116	1	26	0.0384615
NODE_165_length_5382_cov_16.894378	5056	5082	123	2	26	0.0769231
NODE_165_length_5382_cov_16.894378	5056	5082	138	1	26	0.0384615
NODE_165_length_5382_cov_16.894378	5056	5082	140	1	26	0.0384615
NODE_165_length_5382_cov_16.894378	5056	5082	157	1	26	0.0384615
NODE_165_length_5382_cov_16.894378	5056	5082	160	1	26	0.0384615
NODE_165_length_5382_cov_16.894378	5056	5082	167	1	26	0.0384615
NODE_165_length_5382_cov_16.894378	5056	5082	173	1	26	0.0384615
NODE_165_length_5382_cov_16.894378	5056	5082	180	1	26	0.0384615
NODE_165_length_5382_cov_16.894378	5056	5082	192	1	26	0.0384615
NODE_165_length_5382_cov_16.894378	5056	5082	195	1	26	0.0384615
NODE_165_length_5382_cov_16.894378	5056	5082	213	1	26	0.0384615
NODE_165_length_5382_cov_16.894378	5056	5115	79	1	59	0.0169492
NODE_165_length_5382_cov_16.894378	5056	5115	82	1	59	0.0169492
NODE_165_length_5382_cov_16.894378	5056	5115	86	3	59	0.0508475
NODE_165_length_5382_cov_16.894378	5056	5115	90	1	59	0.0169492
NODE_165_length_5382_cov_16.894378	5056	5115	94	1	59	0.0169492
NODE_165_length_5382_cov_16.894378	5056	5115	95	1	59	0.0169492
NODE_165_length_5382_cov_16.894378	5056	5115	98	1	59	0.0169492
NODE_165_length_5382_cov_16.894378	5056	5115	100	1	59	0.0169492
NODE_165_length_5382_cov_16.894378	5056	5115	102	1	59	0.0169492
NODE_165_length_5382_cov_16.894378	5056	5115	106	1	59	0.0169492
NODE_165_length_5382_cov_16.894378	5056	5115	113	1	59	0.0169492
NODE_165_length_5382_cov_16.894378	5056	5115	116	1	59	0.0169492
NODE_165_length_5382_cov_16.894378	5056	5115	123	2	59	0.0338983
NODE_165_length_5382_cov_16.894378	5056	5115	138	1	59	0.0169492
NODE_165_length_5382_cov_16.894378	5056	5115	140	1	59	0.0169492
NODE_165_length_5382_cov_16.894378	5056	5115	157	1	59	0.0169492
NODE_165_length_5382_cov_16.894378	5056	5115	160	1	59	0.0169492
NODE_165_length_5382_cov_16.894378	5056	5115	167	1	59	0.0169492
NODE_165_length_5382_cov_16.894378	5056	5115	173	1	59	0.0169492
NODE_165_length_5382_cov_16.894378	5056	5115	180	1	59	0.0169492
NODE_165_length_5382_cov_16.894378	5056	5115	192	1	59	0.0169492
NODE_165_length_5382_cov_16.894378	5056	5115	195	1	59	0.0169492
NODE_165_length_5382_cov_16.894378	5056	5115	213	1	59	0.0169492
NODE_165_length_5382_cov_16.894378	5056	5115	220	1	59	0.0169492
NODE_165_length_5382_cov_16.894378	5056	5115	226	1	59	0.0169492
NODE_165_length_5382_cov_16.894378	5056	5115	239	3	59	0.0508475
NODE_165_length_5382_cov_16.894378	5056	5115	241	1	59	0.0169492
NODE_165_length_5382_cov_16.894378	5056	5115	245	1	59	0.0169492
NODE_165_length_5382_cov_16.894378	5056	5115	250	1	59	0.0169492
NODE_165_length_5382_cov_16.894378	5056	5115	257	1	59	0.0169492
NODE_165_length_5382_cov_16.894378	5056	5115	261	1	59	0.0169492
NODE_165_length_5382_cov_16.894378	5056	5115	263	1	59	0.0169492
NODE_165_length_5382_cov_16.894378	5056	5115	277	1	59	0.0169492
NODE_165_length_5382_cov_16.894378	5056	5115	279	1	59	0.0169492
NODE_165_length_5382_cov_16.894378	5056	5115	285	1	59	0.0169492
NODE_165_length_5382_cov_16.894378	5056	5115	289	1	59	0.0169492
NODE_165_length_5382_cov_16.894378	5056	5115	293	1	59	0.0169492
NODE_165_length_5382_cov_16.894378	5056	5115	294	1	59	0.0169492
NODE_165_length_5382_cov_16.894378	5056	5115	300	1	59	0.0169492
NODE_165_length_5382_cov_16.894378	5056	5115	304	1	59	0.0169492
NODE_165_length_5382_cov_16.894378	5056	5115	310	1	59	0.0169492
NODE_165_length_5382_cov_16.894378	5056	5115	317	1	59	0.0169492
NODE_165_length_5382_cov_16.894378	5056	5115	318	1	59	0.0169492
NODE_165_length_5382_cov_16.894378	5056	5115	324	1	59	0.0169492
NODE_165_length_5382_cov_16.894378	5056	5115	338	1	59	0.0169492
NODE_165_length_5382_cov_16.894378	5056	5115	340	1	59	0.0169492
NODE_165_length_5382_cov_16.894378	5056	5115	348	1	59	0.0169492
NODE_165_length_5382_cov_16.894378	5056	5115	349	1	59	0.0169492
NODE_165_length_5382_cov_16.894378	5056	5115	350	1	59	0.0169492
NODE_165_length_5382_cov_16.894378	5056	5115	358	1	59	0.0169492
NODE_165_length_5382_cov_16.894378	5056	5115	368	1	59	0.0169492
NODE_165_length_5382_cov_16.894378	5056	5115	378	1	59	0.0169492
NODE_165_length_5382_cov_16.894378	5056	5115	385	1	59	0.0169492
NODE_165_length_5382_cov_16.894378	5056	5115	387	1	59	0.0169492
NODE_167_length_5339_cov_28.708969	3375	3455	2	19	80	0.2375000
NODE_167_length_5339_cov_28.708969	3375	3455	4	8	80	0.1000000
NODE_167_length_5339_cov_28.708969	3375	3455	6	13	80	0.1625000
NODE_167_length_5339_cov_28.708969	3375	3455	8	1	80	0.0125000
NODE_167_length_5339_cov_28.708969	3375	3455	9	6	80	0.0750000
NODE_167_length_5339_cov_28.708969	3375	3455	11	31	80	0.3875000
NODE_167_length_5339_cov_28.708969	3375	3455	12	2	80	0.0250000
NODE_167_length_5339_cov_28.708969	3428	3508	11	25	80	0.3125000
NODE_167_length_5339_cov_28.708969	3428	3508	12	10	80	0.1250000
NODE_167_length_5339_cov_28.708969	3428	3508	13	1	80	0.0125000
NODE_167_length_5339_cov_28.708969	3428	3508	14	10	80	0.1250000
NODE_167_length_5339_cov_28.708969	3428	3508	16	28	80	0.3500000
NODE_167_length_5339_cov_28.708969	3428	3508	18	6	80	0.0750000
NODE_168_length_5336_cov_33.036471	3109	3189	54	17	80	0.2125000
NODE_168_length_5336_cov_33.036471	3109	3189	56	5	80	0.0625000
NODE_168_length_5336_cov_33.036471	3109	3189	62	1	80	0.0125000
NODE_168_length_5336_cov_33.036471	3109	3189	63	2	80	0.0250000
NODE_168_length_5336_cov_33.036471	3109	3189	65	14	80	0.1750000
NODE_168_length_5336_cov_33.036471	3109	3189	66	8	80	0.1000000
NODE_168_length_5336_cov_33.036471	3109	3189	68	1	80	0.0125000
NODE_168_length_5336_cov_33.036471	3109	3189	69	1	80	0.0125000
NODE_168_length_5336_cov_33.036471	3109	3189	70	18	80	0.2250000
NODE_168_length_5336_cov_33.036471	3109	3189	71	13	80	0.1625000
NODE_168_length_5336_cov_33.036471	3162	3242	0	7	80	0.0875000
NODE_168_length_5336_cov_33.036471	3162	3242	20	1	80	0.0125000
NODE_168_length_5336_cov_33.036471	3162	3242	22	15	80	0.1875000
NODE_168_length_5336_cov_33.036471	3162	3242	46	1	80	0.0125000
NODE_168_length_5336_cov_33.036471	3162	3242	48	9	80	0.1125000
NODE_168_length_5336_cov_33.036471	3162	3242	51	1	80	0.0125000
NODE_168_length_5336_cov_33.036471	3162	3242	57	4	80	0.0500000
NODE_168_length_5336_cov_33.036471	3162	3242	60	5	80	0.0625000
NODE_168_length_5336_cov_33.036471	3162	3242	63	11	80	0.1375000
NODE_168_length_5336_cov_33.036471	3162	3242	65	4	80	0.0500000
NODE_168_length_5336_cov_33.036471	3162	3242	66	8	80	0.1000000
NODE_168_length_5336_cov_33.036471	3162	3242	69	1	80	0.0125000
NODE_168_length_5336_cov_33.036471	3162	3242	70	7	80	0.0875000
NODE_168_length_5336_cov_33.036471	3162	3242	71	6	80	0.0750000
NODE_179_length_5269_cov_23.392650	1905	1985	0	61	80	0.7625000
NODE_179_length_5269_cov_23.392650	1905	1985	2	19	80	0.2375000
NODE_179_length_5269_cov_23.392650	1958	2038	0	20	80	0.2500000
NODE_179_length_5269_cov_23.392650	1958	2038	2	60	80	0.7500000
NODE_181_length_5207_cov_31.352780	4588	4668	0	80	80	1.0000000
NODE_181_length_5207_cov_31.352780	4641	4721	0	80	80	1.0000000
NODE_183_length_5193_cov_14.930506	4659	4739	0	30	80	0.3750000
NODE_183_length_5193_cov_14.930506	4659	4739	2	50	80	0.6250000
NODE_183_length_5193_cov_14.930506	4712	4792	0	32	80	0.4000000
NODE_183_length_5193_cov_14.930506	4712	4792	2	48	80	0.6000000
NODE_183_length_5193_cov_14.930506	4788	4868	0	29	80	0.3625000
NODE_183_length_5193_cov_14.930506	4788	4868	4	51	80	0.6375000
NODE_183_length_5193_cov_14.930506	4841	4921	4	80	80	1.0000000
NODE_186_length_5159_cov_261.593676	158	227	272	2	69	0.0289855
NODE_186_length_5159_cov_261.593676	158	227	275	1	69	0.0144928
NODE_186_length_5159_cov_261.593676	158	227	277	1	69	0.0144928
NODE_186_length_5159_cov_261.593676	158	227	278	4	69	0.0579710
NODE_186_length_5159_cov_261.593676	158	227	279	4	69	0.0579710
NODE_186_length_5159_cov_261.593676	158	227	280	5	69	0.0724638
NODE_186_length_5159_cov_261.593676	158	227	281	4	69	0.0579710
NODE_186_length_5159_cov_261.593676	158	227	282	4	69	0.0579710
NODE_186_length_5159_cov_261.593676	158	227	284	3	69	0.0434783
NODE_186_length_5159_cov_261.593676	158	227	285	3	69	0.0434783
NODE_186_length_5159_cov_261.593676	158	227	286	3	69	0.0434783
NODE_186_length_5159_cov_261.593676	158	227	287	4	69	0.0579710
NODE_186_length_5159_cov_261.593676	158	227	288	1	69	0.0144928
NODE_186_length_5159_cov_261.593676	158	227	289	2	69	0.0289855
NODE_186_length_5159_cov_261.593676	158	227	290	3	69	0.0434783
NODE_186_length_5159_cov_261.593676	158	227	293	2	69	0.0289855
NODE_186_length_5159_cov_261.593676	158	227	296	1	69	0.0144928
NODE_186_length_5159_cov_261.593676	158	227	297	2	69	0.0289855
NODE_186_length_5159_cov_261.593676	158	227	298	3	69	0.0434783
NODE_186_length_5159_cov_261.593676	158	227	299	1	69	0.0144928
NODE_186_length_5159_cov_261.593676	158	227	304	2	69	0.0289855
NODE_186_length_5159_cov_261.593676	158	227	306	2	69	0.0289855
NODE_186_length_5159_cov_261.593676	158	227	308	1	69	0.0144928
NODE_186_length_5159_cov_261.593676	158	227	311	1	69	0.0144928
NODE_186_length_5159_cov_261.593676	158	227	315	1	69	0.0144928
NODE_186_length_5159_cov_261.593676	158	227	319	2	69	0.0289855
NODE_186_length_5159_cov_261.593676	158	227	327	1	69	0.0144928
NODE_186_length_5159_cov_261.593676	158	227	328	1	69	0.0144928
NODE_186_length_5159_cov_261.593676	158	227	329	1	69	0.0144928
NODE_186_length_5159_cov_261.593676	158	227	331	1	69	0.0144928
NODE_186_length_5159_cov_261.593676	158	227	336	1	69	0.0144928
NODE_186_length_5159_cov_261.593676	158	227	337	2	69	0.0289855
NODE_189_length_5138_cov_31.467355	3004	3075	0	1	71	0.0140845
NODE_189_length_5138_cov_31.467355	3004	3075	2	5	71	0.0704225
NODE_189_length_5138_cov_31.467355	3004	3075	7	2	71	0.0281690
NODE_189_length_5138_cov_31.467355	3004	3075	11	2	71	0.0281690
NODE_189_length_5138_cov_31.467355	3004	3075	12	2	71	0.0281690
NODE_189_length_5138_cov_31.467355	3004	3075	14	7	71	0.0985916
NODE_189_length_5138_cov_31.467355	3004	3075	18	1	71	0.0140845
NODE_189_length_5138_cov_31.467355	3004	3075	20	2	71	0.0281690
NODE_189_length_5138_cov_31.467355	3004	3075	21	1	71	0.0140845
NODE_189_length_5138_cov_31.467355	3004	3075	22	4	71	0.0563380
NODE_189_length_5138_cov_31.467355	3004	3075	23	1	71	0.0140845
NODE_189_length_5138_cov_31.467355	3004	3075	25	1	71	0.0140845
NODE_189_length_5138_cov_31.467355	3004	3075	27	2	71	0.0281690
NODE_189_length_5138_cov_31.467355	3004	3075	28	2	71	0.0281690
NODE_189_length_5138_cov_31.467355	3004	3075	31	1	71	0.0140845
NODE_189_length_5138_cov_31.467355	3004	3075	33	1	71	0.0140845
NODE_189_length_5138_cov_31.467355	3004	3075	35	2	71	0.0281690
NODE_189_length_5138_cov_31.467355	3004	3075	37	1	71	0.0140845
NODE_189_length_5138_cov_31.467355	3004	3075	39	3	71	0.0422535
NODE_189_length_5138_cov_31.467355	3004	3075	41	1	71	0.0140845
NODE_189_length_5138_cov_31.467355	3004	3075	47	3	71	0.0422535
NODE_189_length_5138_cov_31.467355	3004	3075	49	1	71	0.0140845
NODE_189_length_5138_cov_31.467355	3004	3075	50	1	71	0.0140845
NODE_189_length_5138_cov_31.467355	3004	3075	56	1	71	0.0140845
NODE_189_length_5138_cov_31.467355	3004	3075	57	2	71	0.0281690
NODE_189_length_5138_cov_31.467355	3004	3075	59	2	71	0.0281690
NODE_189_length_5138_cov_31.467355	3004	3075	61	8	71	0.1126761
NODE_189_length_5138_cov_31.467355	3004	3075	67	3	71	0.0422535
NODE_189_length_5138_cov_31.467355	3004	3075	69	1	71	0.0140845
NODE_189_length_5138_cov_31.467355	3004	3075	71	2	71	0.0281690
NODE_189_length_5138_cov_31.467355	3004	3075	72	3	71	0.0422535
NODE_189_length_5138_cov_31.467355	3004	3075	74	1	71	0.0140845
NODE_189_length_5138_cov_31.467355	3004	3075	76	1	71	0.0140845
NODE_191_length_5126_cov_5.900935	731	811	2	33	80	0.4125000
NODE_191_length_5126_cov_5.900935	731	811	4	47	80	0.5875000
NODE_191_length_5126_cov_5.900935	784	864	0	52	80	0.6500000
NODE_191_length_5126_cov_5.900935	784	864	2	28	80	0.3500000
NODE_194_length_5102_cov_12.729962	367	447	2	27	80	0.3375000
NODE_194_length_5102_cov_12.729962	367	447	4	32	80	0.4000000
NODE_194_length_5102_cov_12.729962	367	447	6	2	80	0.0250000
NODE_194_length_5102_cov_12.729962	367	447	14	19	80	0.2375000
NODE_194_length_5102_cov_12.729962	420	500	4	8	80	0.1000000
NODE_194_length_5102_cov_12.729962	420	500	10	44	80	0.5500000
NODE_194_length_5102_cov_12.729962	420	500	14	28	80	0.3500000
NODE_194_length_5102_cov_12.729962	496	576	2	17	80	0.2125000
NODE_194_length_5102_cov_12.729962	496	576	10	7	80	0.0875000
NODE_194_length_5102_cov_12.729962	496	576	12	56	80	0.7000000
NODE_194_length_5102_cov_12.729962	549	629	0	41	80	0.5125000
NODE_194_length_5102_cov_12.729962	549	629	2	29	80	0.3625000
NODE_194_length_5102_cov_12.729962	549	629	12	10	80	0.1250000
NODE_196_length_5079_cov_5.580522	875	940	60	5	65	0.0769231
NODE_196_length_5079_cov_5.580522	875	940	62	11	65	0.1692308
NODE_196_length_5079_cov_5.580522	875	940	63	4	65	0.0615385
NODE_196_length_5079_cov_5.580522	875	940	64	5	65	0.0769231
NODE_196_length_5079_cov_5.580522	875	940	65	5	65	0.0769231
NODE_196_length_5079_cov_5.580522	875	940	66	7	65	0.1076923
NODE_196_length_5079_cov_5.580522	875	940	67	4	65	0.0615385
NODE_196_length_5079_cov_5.580522	875	940	68	3	65	0.0461538
NODE_196_length_5079_cov_5.580522	875	940	70	1	65	0.0153846
NODE_196_length_5079_cov_5.580522	875	940	75	2	65	0.0307692
NODE_196_length_5079_cov_5.580522	875	940	78	3	65	0.0461538
NODE_196_length_5079_cov_5.580522	875	940	80	1	65	0.0153846
NODE_196_length_5079_cov_5.580522	875	940	86	3	65	0.0461538
NODE_196_length_5079_cov_5.580522	875	940	87	4	65	0.0615385
NODE_196_length_5079_cov_5.580522	875	940	88	2	65	0.0307692
NODE_196_length_5079_cov_5.580522	875	940	91	3	65	0.0461538
NODE_196_length_5079_cov_5.580522	875	940	97	2	65	0.0307692
NODE_197_length_5057_cov_16.348729	2929	3000	120	1	71	0.0140845
NODE_197_length_5057_cov_16.348729	2929	3000	124	1	71	0.0140845
NODE_197_length_5057_cov_16.348729	2929	3000	133	1	71	0.0140845
NODE_197_length_5057_cov_16.348729	2929	3000	135	1	71	0.0140845
NODE_197_length_5057_cov_16.348729	2929	3000	136	1	71	0.0140845
NODE_197_length_5057_cov_16.348729	2929	3000	143	1	71	0.0140845
NODE_197_length_5057_cov_16.348729	2929	3000	145	1	71	0.0140845
NODE_197_length_5057_cov_16.348729	2929	3000	147	2	71	0.0281690
NODE_197_length_5057_cov_16.348729	2929	3000	153	1	71	0.0140845
NODE_197_length_5057_cov_16.348729	2929	3000	158	1	71	0.0140845
NODE_197_length_5057_cov_16.348729	2929	3000	159	1	71	0.0140845
NODE_197_length_5057_cov_16.348729	2929	3000	163	1	71	0.0140845
NODE_197_length_5057_cov_16.348729	2929	3000	174	1	71	0.0140845
NODE_197_length_5057_cov_16.348729	2929	3000	176	1	71	0.0140845
NODE_197_length_5057_cov_16.348729	2929	3000	186	2	71	0.0281690
NODE_197_length_5057_cov_16.348729	2929	3000	191	1	71	0.0140845
NODE_197_length_5057_cov_16.348729	2929	3000	200	2	71	0.0281690
NODE_197_length_5057_cov_16.348729	2929	3000	204	1	71	0.0140845
NODE_197_length_5057_cov_16.348729	2929	3000	218	1	71	0.0140845
NODE_197_length_5057_cov_16.348729	2929	3000	222	1	71	0.0140845
NODE_197_length_5057_cov_16.348729	2929	3000	230	1	71	0.0140845
NODE_197_length_5057_cov_16.348729	2929	3000	232	1	71	0.0140845
NODE_197_length_5057_cov_16.348729	2929	3000	234	1	71	0.0140845
NODE_197_length_5057_cov_16.348729	2929	3000	236	1	71	0.0140845
NODE_197_length_5057_cov_16.348729	2929	3000	238	1	71	0.0140845
NODE_197_length_5057_cov_16.348729	2929	3000	241	1	71	0.0140845
NODE_197_length_5057_cov_16.348729	2929	3000	242	1	71	0.0140845
NODE_197_length_5057_cov_16.348729	2929	3000	244	2	71	0.0281690
NODE_197_length_5057_cov_16.348729	2929	3000	253	1	71	0.0140845
NODE_197_length_5057_cov_16.348729	2929	3000	257	1	71	0.0140845
NODE_197_length_5057_cov_16.348729	2929	3000	258	1	71	0.0140845
NODE_197_length_5057_cov_16.348729	2929	3000	262	1	71	0.0140845
NODE_197_length_5057_cov_16.348729	2929	3000	269	1	71	0.0140845
NODE_197_length_5057_cov_16.348729	2929	3000	271	2	71	0.0281690
NODE_197_length_5057_cov_16.348729	2929	3000	272	3	71	0.0422535
NODE_197_length_5057_cov_16.348729	2929	3000	274	1	71	0.0140845
NODE_197_length_5057_cov_16.348729	2929	3000	276	1	71	0.0140845
NODE_197_length_5057_cov_16.348729	2929	3000	288	2	71	0.0281690
NODE_197_length_5057_cov_16.348729	2929	3000	290	1	71	0.0140845
NODE_197_length_5057_cov_16.348729	2929	3000	292	1	71	0.0140845
NODE_197_length_5057_cov_16.348729	2929	3000	296	1	71	0.0140845
NODE_197_length_5057_cov_16.348729	2929	3000	297	1	71	0.0140845
NODE_197_length_5057_cov_16.348729	2929	3000	298	1	71	0.0140845
NODE_197_length_5057_cov_16.348729	2929	3000	299	2	71	0.0281690
NODE_197_length_5057_cov_16.348729	2929	3000	301	2	71	0.0281690
NODE_197_length_5057_cov_16.348729	2929	3000	303	4	71	0.0563380
NODE_197_length_5057_cov_16.348729	2929	3000	305	3	71	0.0422535
NODE_197_length_5057_cov_16.348729	2929	3000	309	1	71	0.0140845
NODE_197_length_5057_cov_16.348729	2929	3000	312	3	71	0.0422535
NODE_197_length_5057_cov_16.348729	2929	3000	313	2	71	0.0281690
NODE_197_length_5057_cov_16.348729	2929	3000	317	2	71	0.0281690
NODE_197_length_5057_cov_16.348729	2929	3000	319	1	71	0.0140845
NODE_197_length_5057_cov_16.348729	2973	3012	288	2	39	0.0512821
NODE_197_length_5057_cov_16.348729	2973	3012	290	1	39	0.0256410
NODE_197_length_5057_cov_16.348729	2973	3012	292	1	39	0.0256410
NODE_197_length_5057_cov_16.348729	2973	3012	296	1	39	0.0256410
NODE_197_length_5057_cov_16.348729	2973	3012	297	1	39	0.0256410
NODE_197_length_5057_cov_16.348729	2973	3012	298	1	39	0.0256410
NODE_197_length_5057_cov_16.348729	2973	3012	299	2	39	0.0512821
NODE_197_length_5057_cov_16.348729	2973	3012	301	2	39	0.0512821
NODE_197_length_5057_cov_16.348729	2973	3012	303	4	39	0.1025641
NODE_197_length_5057_cov_16.348729	2973	3012	305	3	39	0.0769231
NODE_197_length_5057_cov_16.348729	2973	3012	309	1	39	0.0256410
NODE_197_length_5057_cov_16.348729	2973	3012	310	1	39	0.0256410
NODE_197_length_5057_cov_16.348729	2973	3012	312	3	39	0.0769231
NODE_197_length_5057_cov_16.348729	2973	3012	313	3	39	0.0769231
NODE_197_length_5057_cov_16.348729	2973	3012	317	2	39	0.0512821
NODE_197_length_5057_cov_16.348729	2973	3012	319	6	39	0.1538462
NODE_197_length_5057_cov_16.348729	2973	3012	321	2	39	0.0512821
NODE_197_length_5057_cov_16.348729	2973	3012	323	3	39	0.0769231
NODE_198_length_5053_cov_11.281994	791	834	0	3	43	0.0697674
NODE_198_length_5053_cov_11.281994	791	834	4	40	43	0.9302326
NODE_198_length_5053_cov_11.281994	807	887	4	80	80	1.0000000
NODE_198_length_5053_cov_11.281994	883	963	0	74	80	0.9250000
NODE_198_length_5053_cov_11.281994	883	963	4	6	80	0.0750000
NODE_198_length_5053_cov_11.281994	936	999	0	63	63	1.0000000
NODE_204_length_4906_cov_37.988350	3170	3251	13	1	81	0.0123457
NODE_204_length_4906_cov_37.988350	3170	3251	18	1	81	0.0123457
NODE_204_length_4906_cov_37.988350	3170	3251	24	2	81	0.0246914
NODE_204_length_4906_cov_37.988350	3170	3251	28	1	81	0.0123457
NODE_204_length_4906_cov_37.988350	3170	3251	30	1	81	0.0123457
NODE_204_length_4906_cov_37.988350	3170	3251	34	2	81	0.0246914
NODE_204_length_4906_cov_37.988350	3170	3251	38	3	81	0.0370370
NODE_204_length_4906_cov_37.988350	3170	3251	44	5	81	0.0617284
NODE_204_length_4906_cov_37.988350	3170	3251	46	2	81	0.0246914
NODE_204_length_4906_cov_37.988350	3170	3251	49	1	81	0.0123457
NODE_204_length_4906_cov_37.988350	3170	3251	51	2	81	0.0246914
NODE_204_length_4906_cov_37.988350	3170	3251	52	2	81	0.0246914
NODE_204_length_4906_cov_37.988350	3170	3251	55	1	81	0.0123457
NODE_204_length_4906_cov_37.988350	3170	3251	57	1	81	0.0123457
NODE_204_length_4906_cov_37.988350	3170	3251	60	1	81	0.0123457
NODE_204_length_4906_cov_37.988350	3170	3251	64	1	81	0.0123457
NODE_204_length_4906_cov_37.988350	3170	3251	66	2	81	0.0246914
NODE_204_length_4906_cov_37.988350	3170	3251	68	2	81	0.0246914
NODE_204_length_4906_cov_37.988350	3170	3251	70	4	81	0.0493827
NODE_204_length_4906_cov_37.988350	3170	3251	72	1	81	0.0123457
NODE_204_length_4906_cov_37.988350	3170	3251	74	6	81	0.0740741
NODE_204_length_4906_cov_37.988350	3170	3251	77	2	81	0.0246914
NODE_204_length_4906_cov_37.988350	3170	3251	81	1	81	0.0123457
NODE_204_length_4906_cov_37.988350	3170	3251	91	1	81	0.0123457
NODE_204_length_4906_cov_37.988350	3170	3251	92	1	81	0.0123457
NODE_204_length_4906_cov_37.988350	3170	3251	100	1	81	0.0123457
NODE_204_length_4906_cov_37.988350	3170	3251	102	2	81	0.0246914
NODE_204_length_4906_cov_37.988350	3170	3251	104	1	81	0.0123457
NODE_204_length_4906_cov_37.988350	3170	3251	106	2	81	0.0246914
NODE_204_length_4906_cov_37.988350	3170	3251	116	1	81	0.0123457
NODE_204_length_4906_cov_37.988350	3170	3251	117	1	81	0.0123457
NODE_204_length_4906_cov_37.988350	3170	3251	122	1	81	0.0123457
NODE_204_length_4906_cov_37.988350	3170	3251	125	1	81	0.0123457
NODE_204_length_4906_cov_37.988350	3170	3251	138	2	81	0.0246914
NODE_204_length_4906_cov_37.988350	3170	3251	140	1	81	0.0123457
NODE_204_length_4906_cov_37.988350	3170	3251	145	1	81	0.0123457
NODE_204_length_4906_cov_37.988350	3170	3251	147	1	81	0.0123457
NODE_204_length_4906_cov_37.988350	3170	3251	152	2	81	0.0246914
NODE_204_length_4906_cov_37.988350	3170	3251	155	1	81	0.0123457
NODE_204_length_4906_cov_37.988350	3170	3251	157	2	81	0.0246914
NODE_204_length_4906_cov_37.988350	3170	3251	159	1	81	0.0123457
NODE_204_length_4906_cov_37.988350	3170	3251	164	1	81	0.0123457
NODE_204_length_4906_cov_37.988350	3170	3251	169	1	81	0.0123457
NODE_204_length_4906_cov_37.988350	3170	3251	177	2	81	0.0246914
NODE_204_length_4906_cov_37.988350	3170	3251	179	1	81	0.0123457
NODE_204_length_4906_cov_37.988350	3170	3251	182	1	81	0.0123457
NODE_204_length_4906_cov_37.988350	3170	3251	189	1	81	0.0123457
NODE_204_length_4906_cov_37.988350	3170	3251	195	1	81	0.0123457
NODE_204_length_4906_cov_37.988350	3170	3251	199	1	81	0.0123457
NODE_204_length_4906_cov_37.988350	3170	3251	200	1	81	0.0123457
NODE_204_length_4906_cov_37.988350	3170	3251	204	1	81	0.0123457
NODE_204_length_4906_cov_37.988350	3170	3251	207	1	81	0.0123457
NODE_204_length_4906_cov_37.988350	3170	3251	210	1	81	0.0123457
NODE_205_length_4888_cov_60.162247	4029	4068	2	1	39	0.0256410
NODE_205_length_4888_cov_60.162247	4029	4068	7	7	39	0.1794872
NODE_205_length_4888_cov_60.162247	4029	4068	8	29	39	0.7435898
NODE_205_length_4888_cov_60.162247	4029	4068	9	2	39	0.0512821
NODE_205_length_4888_cov_60.162247	4041	4121	0	5	80	0.0625000
NODE_205_length_4888_cov_60.162247	4041	4121	8	75	80	0.9375000
NODE_207_length_4875_cov_63.035176	2905	2985	0	28	80	0.3500000
NODE_207_length_4875_cov_63.035176	2905	2985	2	52	80	0.6500000
NODE_207_length_4875_cov_63.035176	2958	3038	2	43	80	0.5375000
NODE_207_length_4875_cov_63.035176	2958	3038	8	1	80	0.0125000
NODE_207_length_4875_cov_63.035176	2958	3038	10	27	80	0.3375000
NODE_207_length_4875_cov_63.035176	2958	3038	12	9	80	0.1125000
NODE_208_length_4875_cov_8.996859	4683	4760	0	31	77	0.4025974
NODE_208_length_4875_cov_8.996859	4683	4760	2	30	77	0.3896104
NODE_208_length_4875_cov_8.996859	4683	4760	4	16	77	0.2077922
NODE_208_length_4875_cov_8.996859	4736	4813	0	8	77	0.1038961
NODE_208_length_4875_cov_8.996859	4736	4813	4	69	77	0.8961039
NODE_211_length_4827_cov_15.364636	1803	1865	33	2	62	0.0322581
NODE_211_length_4827_cov_15.364636	1803	1865	35	5	62	0.0806452
NODE_211_length_4827_cov_15.364636	1803	1865	36	7	62	0.1129032
NODE_211_length_4827_cov_15.364636	1803	1865	37	2	62	0.0322581
NODE_211_length_4827_cov_15.364636	1803	1865	38	7	62	0.1129032
NODE_211_length_4827_cov_15.364636	1803	1865	40	6	62	0.0967742
NODE_211_length_4827_cov_15.364636	1803	1865	41	3	62	0.0483871
NODE_211_length_4827_cov_15.364636	1803	1865	42	1	62	0.0161290
NODE_211_length_4827_cov_15.364636	1803	1865	43	4	62	0.0645161
NODE_211_length_4827_cov_15.364636	1803	1865	45	1	62	0.0161290
NODE_211_length_4827_cov_15.364636	1803	1865	47	1	62	0.0161290
NODE_211_length_4827_cov_15.364636	1803	1865	51	1	62	0.0161290
NODE_211_length_4827_cov_15.364636	1803	1865	57	1	62	0.0161290
NODE_211_length_4827_cov_15.364636	1803	1865	67	1	62	0.0161290
NODE_211_length_4827_cov_15.364636	1803	1865	69	1	62	0.0161290
NODE_211_length_4827_cov_15.364636	1803	1865	73	2	62	0.0322581
NODE_211_length_4827_cov_15.364636	1803	1865	75	1	62	0.0161290
NODE_211_length_4827_cov_15.364636	1803	1865	76	1	62	0.0161290
NODE_211_length_4827_cov_15.364636	1803	1865	82	1	62	0.0161290
NODE_211_length_4827_cov_15.364636	1803	1865	84	1	62	0.0161290
NODE_211_length_4827_cov_15.364636	1803	1865	86	1	62	0.0161290
NODE_211_length_4827_cov_15.364636	1803	1865	90	2	62	0.0322581
NODE_211_length_4827_cov_15.364636	1803	1865	92	2	62	0.0322581
NODE_211_length_4827_cov_15.364636	1803	1865	97	1	62	0.0161290
NODE_211_length_4827_cov_15.364636	1803	1865	99	1	62	0.0161290
NODE_211_length_4827_cov_15.364636	1803	1865	105	1	62	0.0161290
NODE_211_length_4827_cov_15.364636	1803	1865	107	1	62	0.0161290
NODE_211_length_4827_cov_15.364636	1803	1865	110	1	62	0.0161290
NODE_211_length_4827_cov_15.364636	1803	1865	112	3	62	0.0483871
NODE_211_length_4827_cov_15.364636	1899	1979	30	6	80	0.0750000
NODE_211_length_4827_cov_15.364636	1899	1979	32	5	80	0.0625000
NODE_211_length_4827_cov_15.364636	1899	1979	33	1	80	0.0125000
NODE_211_length_4827_cov_15.364636	1899	1979	34	3	80	0.0375000
NODE_211_length_4827_cov_15.364636	1899	1979	35	3	80	0.0375000
NODE_211_length_4827_cov_15.364636	1899	1979	36	9	80	0.1125000
NODE_211_length_4827_cov_15.364636	1899	1979	38	3	80	0.0375000
NODE_211_length_4827_cov_15.364636	1899	1979	40	10	80	0.1250000
NODE_211_length_4827_cov_15.364636	1899	1979	41	2	80	0.0250000
NODE_211_length_4827_cov_15.364636	1899	1979	43	2	80	0.0250000
NODE_211_length_4827_cov_15.364636	1899	1979	45	3	80	0.0375000
NODE_211_length_4827_cov_15.364636	1899	1979	46	2	80	0.0250000
NODE_211_length_4827_cov_15.364636	1899	1979	47	8	80	0.1000000
NODE_211_length_4827_cov_15.364636	1899	1979	49	8	80	0.1000000
NODE_211_length_4827_cov_15.364636	1899	1979	51	13	80	0.1625000
NODE_211_length_4827_cov_15.364636	1899	1979	53	2	80	0.0250000
NODE_211_length_4827_cov_15.364636	1952	1996	27	3	44	0.0681818
NODE_211_length_4827_cov_15.364636	1952	1996	29	4	44	0.0909091
NODE_211_length_4827_cov_15.364636	1952	1996	30	6	44	0.1363636
NODE_211_length_4827_cov_15.364636	1952	1996	31	2	44	0.0454545
NODE_211_length_4827_cov_15.364636	1952	1996	32	13	44	0.2954545
NODE_211_length_4827_cov_15.364636	1952	1996	33	1	44	0.0227273
NODE_211_length_4827_cov_15.364636	1952	1996	34	3	44	0.0681818
NODE_211_length_4827_cov_15.364636	1952	1996	35	3	44	0.0681818
NODE_211_length_4827_cov_15.364636	1952	1996	41	2	44	0.0454545
NODE_211_length_4827_cov_15.364636	1952	1996	43	2	44	0.0454545
NODE_211_length_4827_cov_15.364636	1952	1996	47	4	44	0.0909091
NODE_211_length_4827_cov_15.364636	1952	1996	49	1	44	0.0227273
NODE_212_length_4821_cov_10.856840	999	1061	2	3	62	0.0483871
NODE_212_length_4821_cov_10.856840	999	1061	4	30	62	0.4838710
NODE_212_length_4821_cov_10.856840	999	1061	6	27	62	0.4354839
NODE_212_length_4821_cov_10.856840	999	1061	7	2	62	0.0322581
NODE_213_length_4819_cov_16.363347	2392	2461	24	4	69	0.0579710
NODE_213_length_4819_cov_16.363347	2392	2461	32	24	69	0.3478261
NODE_213_length_4819_cov_16.363347	2392	2461	34	5	69	0.0724638
NODE_213_length_4819_cov_16.363347	2392	2461	36	1	69	0.0144928
NODE_213_length_4819_cov_16.363347	2392	2461	37	1	69	0.0144928
NODE_213_length_4819_cov_16.363347	2392	2461	38	34	69	0.4927536
NODE_217_length_4794_cov_14.912886	657	737	118	2	80	0.0250000
NODE_217_length_4794_cov_14.912886	657	737	120	3	80	0.0375000
NODE_217_length_4794_cov_14.912886	657	737	124	4	80	0.0500000
NODE_217_length_4794_cov_14.912886	657	737	128	2	80	0.0250000
NODE_217_length_4794_cov_14.912886	657	737	130	1	80	0.0125000
NODE_217_length_4794_cov_14.912886	657	737	134	1	80	0.0125000
NODE_217_length_4794_cov_14.912886	657	737	136	1	80	0.0125000
NODE_217_length_4794_cov_14.912886	657	737	138	2	80	0.0250000
NODE_217_length_4794_cov_14.912886	657	737	140	6	80	0.0750000
NODE_217_length_4794_cov_14.912886	657	737	148	3	80	0.0375000
NODE_217_length_4794_cov_14.912886	657	737	152	1	80	0.0125000
NODE_217_length_4794_cov_14.912886	657	737	158	2	80	0.0250000
NODE_217_length_4794_cov_14.912886	657	737	160	2	80	0.0250000
NODE_217_length_4794_cov_14.912886	657	737	162	2	80	0.0250000
NODE_217_length_4794_cov_14.912886	657	737	166	1	80	0.0125000
NODE_217_length_4794_cov_14.912886	657	737	168	1	80	0.0125000
NODE_217_length_4794_cov_14.912886	657	737	169	1	80	0.0125000
NODE_217_length_4794_cov_14.912886	657	737	171	5	80	0.0625000
NODE_217_length_4794_cov_14.912886	657	737	174	2	80	0.0250000
NODE_217_length_4794_cov_14.912886	657	737	175	1	80	0.0125000
NODE_217_length_4794_cov_14.912886	657	737	179	1	80	0.0125000
NODE_217_length_4794_cov_14.912886	657	737	180	3	80	0.0375000
NODE_217_length_4794_cov_14.912886	657	737	181	1	80	0.0125000
NODE_217_length_4794_cov_14.912886	657	737	182	1	80	0.0125000
NODE_217_length_4794_cov_14.912886	657	737	184	1	80	0.0125000
NODE_217_length_4794_cov_14.912886	657	737	186	2	80	0.0250000
NODE_217_length_4794_cov_14.912886	657	737	188	3	80	0.0375000
NODE_217_length_4794_cov_14.912886	657	737	189	1	80	0.0125000
NODE_217_length_4794_cov_14.912886	657	737	190	1	80	0.0125000
NODE_217_length_4794_cov_14.912886	657	737	192	2	80	0.0250000
NODE_217_length_4794_cov_14.912886	657	737	194	2	80	0.0250000
NODE_217_length_4794_cov_14.912886	657	737	199	2	80	0.0250000
NODE_217_length_4794_cov_14.912886	657	737	205	2	80	0.0250000
NODE_217_length_4794_cov_14.912886	657	737	207	3	80	0.0375000
NODE_217_length_4794_cov_14.912886	657	737	208	3	80	0.0375000
NODE_217_length_4794_cov_14.912886	657	737	209	2	80	0.0250000
NODE_217_length_4794_cov_14.912886	657	737	211	3	80	0.0375000
NODE_217_length_4794_cov_14.912886	657	737	212	4	80	0.0500000
NODE_217_length_4794_cov_14.912886	4240	4312	0	72	72	1.0000000
NODE_217_length_4794_cov_14.912886	4293	4312	0	19	19	1.0000000
NODE_217_length_4794_cov_14.912886	4345	4408	0	24	63	0.3809524
NODE_217_length_4794_cov_14.912886	4345	4408	1	8	63	0.1269841
NODE_217_length_4794_cov_14.912886	4345	4408	2	3	63	0.0476190
NODE_217_length_4794_cov_14.912886	4345	4408	3	28	63	0.4444444
NODE_218_length_4791_cov_16.126172	2438	2518	0	80	80	1.0000000
NODE_218_length_4791_cov_16.126172	2491	2571	0	80	80	1.0000000
NODE_218_length_4791_cov_16.126172	2567	2647	0	80	80	1.0000000
NODE_218_length_4791_cov_16.126172	2620	2700	0	80	80	1.0000000
NODE_218_length_4791_cov_16.126172	4607	4687	0	80	80	1.0000000
NODE_219_length_4790_cov_9.713494	2159	2239	39	15	80	0.1875000
NODE_219_length_4790_cov_9.713494	2159	2239	41	4	80	0.0500000
NODE_219_length_4790_cov_9.713494	2159	2239	42	1	80	0.0125000
NODE_219_length_4790_cov_9.713494	2159	2239	46	2	80	0.0250000
NODE_219_length_4790_cov_9.713494	2159	2239	49	2	80	0.0250000
NODE_219_length_4790_cov_9.713494	2159	2239	51	6	80	0.0750000
NODE_219_length_4790_cov_9.713494	2159	2239	52	4	80	0.0500000
NODE_219_length_4790_cov_9.713494	2159	2239	54	8	80	0.1000000
NODE_219_length_4790_cov_9.713494	2159	2239	55	1	80	0.0125000
NODE_219_length_4790_cov_9.713494	2159	2239	56	11	80	0.1375000
NODE_219_length_4790_cov_9.713494	2159	2239	57	9	80	0.1125000
NODE_219_length_4790_cov_9.713494	2159	2239	58	7	80	0.0875000
NODE_219_length_4790_cov_9.713494	2159	2239	61	5	80	0.0625000
NODE_219_length_4790_cov_9.713494	2159	2239	65	5	80	0.0625000
NODE_219_length_4790_cov_9.713494	4273	4353	10	10	80	0.1250000
NODE_219_length_4790_cov_9.713494	4273	4353	12	23	80	0.2875000
NODE_219_length_4790_cov_9.713494	4273	4353	14	47	80	0.5875000
NODE_219_length_4790_cov_9.713494	4273	4335	12	23	62	0.3709677
NODE_219_length_4790_cov_9.713494	4273	4335	14	39	62	0.6290323
NODE_219_length_4790_cov_9.713494	4326	4406	0	18	80	0.2250000
NODE_219_length_4790_cov_9.713494	4326	4406	2	16	80	0.2000000
NODE_219_length_4790_cov_9.713494	4326	4406	4	2	80	0.0250000
NODE_219_length_4790_cov_9.713494	4326	4406	6	1	80	0.0125000
NODE_219_length_4790_cov_9.713494	4326	4406	8	2	80	0.0250000
NODE_219_length_4790_cov_9.713494	4326	4406	9	5	80	0.0625000
NODE_219_length_4790_cov_9.713494	4326	4406	10	19	80	0.2375000
NODE_219_length_4790_cov_9.713494	4326	4406	14	17	80	0.2125000
NODE_221_length_4772_cov_10.560454	4281	4367	0	71	86	0.8255814
NODE_221_length_4772_cov_10.560454	4281	4367	5	10	86	0.1162791
NODE_221_length_4772_cov_10.560454	4281	4367	7	5	86	0.0581395
NODE_222_length_4770_cov_106.953543	2778	2858	78	1	80	0.0125000
NODE_222_length_4770_cov_106.953543	2778	2858	80	3	80	0.0375000
NODE_222_length_4770_cov_106.953543	2778	2858	81	1	80	0.0125000
NODE_222_length_4770_cov_106.953543	2778	2858	82	5	80	0.0625000
NODE_222_length_4770_cov_106.953543	2778	2858	83	1	80	0.0125000
NODE_222_length_4770_cov_106.953543	2778	2858	84	1	80	0.0125000
NODE_222_length_4770_cov_106.953543	2778	2858	85	8	80	0.1000000
NODE_222_length_4770_cov_106.953543	2778	2858	86	2	80	0.0250000
NODE_222_length_4770_cov_106.953543	2778	2858	87	14	80	0.1750000
NODE_222_length_4770_cov_106.953543	2778	2858	88	2	80	0.0250000
NODE_222_length_4770_cov_106.953543	2778	2858	89	3	80	0.0375000
NODE_222_length_4770_cov_106.953543	2778	2858	91	2	80	0.0250000
NODE_222_length_4770_cov_106.953543	2778	2858	92	2	80	0.0250000
NODE_222_length_4770_cov_106.953543	2778	2858	93	15	80	0.1875000
NODE_222_length_4770_cov_106.953543	2778	2858	94	1	80	0.0125000
NODE_222_length_4770_cov_106.953543	2778	2858	95	7	80	0.0875000
NODE_222_length_4770_cov_106.953543	2778	2858	97	7	80	0.0875000
NODE_222_length_4770_cov_106.953543	2778	2858	98	1	80	0.0125000
NODE_222_length_4770_cov_106.953543	2778	2858	99	4	80	0.0500000
NODE_222_length_4770_cov_106.953543	2831	2911	79	3	80	0.0375000
NODE_222_length_4770_cov_106.953543	2831	2911	81	4	80	0.0500000
NODE_222_length_4770_cov_106.953543	2831	2911	83	3	80	0.0375000
NODE_222_length_4770_cov_106.953543	2831	2911	85	12	80	0.1500000
NODE_222_length_4770_cov_106.953543	2831	2911	86	1	80	0.0125000
NODE_222_length_4770_cov_106.953543	2831	2911	87	13	80	0.1625000
NODE_222_length_4770_cov_106.953543	2831	2911	88	1	80	0.0125000
NODE_222_length_4770_cov_106.953543	2831	2911	89	1	80	0.0125000
NODE_222_length_4770_cov_106.953543	2831	2911	93	7	80	0.0875000
NODE_222_length_4770_cov_106.953543	2831	2911	94	1	80	0.0125000
NODE_222_length_4770_cov_106.953543	2831	2911	95	2	80	0.0250000
NODE_222_length_4770_cov_106.953543	2831	2911	96	3	80	0.0375000
NODE_222_length_4770_cov_106.953543	2831	2911	97	1	80	0.0125000
NODE_222_length_4770_cov_106.953543	2831	2911	98	2	80	0.0250000
NODE_222_length_4770_cov_106.953543	2831	2911	99	1	80	0.0125000
NODE_222_length_4770_cov_106.953543	2831	2911	100	1	80	0.0125000
NODE_222_length_4770_cov_106.953543	2831	2911	101	1	80	0.0125000
NODE_222_length_4770_cov_106.953543	2831	2911	102	1	80	0.0125000
NODE_222_length_4770_cov_106.953543	2831	2911	106	1	80	0.0125000
NODE_222_length_4770_cov_106.953543	2831	2911	109	2	80	0.0250000
NODE_222_length_4770_cov_106.953543	2831	2911	112	1	80	0.0125000
NODE_222_length_4770_cov_106.953543	2831	2911	115	3	80	0.0375000
NODE_222_length_4770_cov_106.953543	2831	2911	125	1	80	0.0125000
NODE_222_length_4770_cov_106.953543	2831	2911	130	1	80	0.0125000
NODE_222_length_4770_cov_106.953543	2831	2911	132	6	80	0.0750000
NODE_222_length_4770_cov_106.953543	2831	2911	133	1	80	0.0125000
NODE_222_length_4770_cov_106.953543	2831	2911	134	2	80	0.0250000
NODE_222_length_4770_cov_106.953543	2831	2911	135	2	80	0.0250000
NODE_222_length_4770_cov_106.953543	2831	2911	137	1	80	0.0125000
NODE_222_length_4770_cov_106.953543	2831	2911	139	1	80	0.0125000
NODE_222_length_4770_cov_106.953543	2907	2987	134	1	80	0.0125000
NODE_222_length_4770_cov_106.953543	2907	2987	135	3	80	0.0375000
NODE_222_length_4770_cov_106.953543	2907	2987	137	1	80	0.0125000
NODE_222_length_4770_cov_106.953543	2907	2987	139	1	80	0.0125000
NODE_222_length_4770_cov_106.953543	2907	2987	140	1	80	0.0125000
NODE_222_length_4770_cov_106.953543	2907	2987	144	2	80	0.0250000
NODE_222_length_4770_cov_106.953543	2907	2987	148	1	80	0.0125000
NODE_222_length_4770_cov_106.953543	2907	2987	149	1	80	0.0125000
NODE_222_length_4770_cov_106.953543	2907	2987	151	1	80	0.0125000
NODE_222_length_4770_cov_106.953543	2907	2987	156	3	80	0.0375000
NODE_222_length_4770_cov_106.953543	2907	2987	165	1	80	0.0125000
NODE_222_length_4770_cov_106.953543	2907	2987	171	1	80	0.0125000
NODE_222_length_4770_cov_106.953543	2907	2987	178	5	80	0.0625000
NODE_222_length_4770_cov_106.953543	2907	2987	179	1	80	0.0125000
NODE_222_length_4770_cov_106.953543	2907	2987	181	3	80	0.0375000
NODE_222_length_4770_cov_106.953543	2907	2987	182	1	80	0.0125000
NODE_222_length_4770_cov_106.953543	2907	2987	184	2	80	0.0250000
NODE_222_length_4770_cov_106.953543	2907	2987	186	1	80	0.0125000
NODE_222_length_4770_cov_106.953543	2907	2987	189	1	80	0.0125000
NODE_222_length_4770_cov_106.953543	2907	2987	197	1	80	0.0125000
NODE_222_length_4770_cov_106.953543	2907	2987	202	2	80	0.0250000
NODE_222_length_4770_cov_106.953543	2907	2987	203	2	80	0.0250000
NODE_222_length_4770_cov_106.953543	2907	2987	205	2	80	0.0250000
NODE_222_length_4770_cov_106.953543	2907	2987	206	3	80	0.0375000
NODE_222_length_4770_cov_106.953543	2907	2987	209	1	80	0.0125000
NODE_222_length_4770_cov_106.953543	2907	2987	217	1	80	0.0125000
NODE_222_length_4770_cov_106.953543	2907	2987	219	2	80	0.0250000
NODE_222_length_4770_cov_106.953543	2907	2987	224	1	80	0.0125000
NODE_222_length_4770_cov_106.953543	2907	2987	233	1	80	0.0125000
NODE_222_length_4770_cov_106.953543	2907	2987	235	3	80	0.0375000
NODE_222_length_4770_cov_106.953543	2907	2987	237	1	80	0.0125000
NODE_222_length_4770_cov_106.953543	2907	2987	239	1	80	0.0125000
NODE_222_length_4770_cov_106.953543	2907	2987	241	2	80	0.0250000
NODE_222_length_4770_cov_106.953543	2907	2987	243	1	80	0.0125000
NODE_222_length_4770_cov_106.953543	2907	2987	245	3	80	0.0375000
NODE_222_length_4770_cov_106.953543	2907	2987	252	3	80	0.0375000
NODE_222_length_4770_cov_106.953543	2907	2987	253	6	80	0.0750000
NODE_222_length_4770_cov_106.953543	2907	2987	254	2	80	0.0250000
NODE_222_length_4770_cov_106.953543	2907	2987	256	7	80	0.0875000
NODE_222_length_4770_cov_106.953543	2907	2987	257	1	80	0.0125000
NODE_222_length_4770_cov_106.953543	2907	2987	258	2	80	0.0250000
NODE_222_length_4770_cov_106.953543	2907	2987	260	1	80	0.0125000
NODE_222_length_4770_cov_106.953543	2960	3040	203	1	80	0.0125000
NODE_222_length_4770_cov_106.953543	2960	3040	205	2	80	0.0250000
NODE_222_length_4770_cov_106.953543	2960	3040	213	1	80	0.0125000
NODE_222_length_4770_cov_106.953543	2960	3040	215	1	80	0.0125000
NODE_222_length_4770_cov_106.953543	2960	3040	217	1	80	0.0125000
NODE_222_length_4770_cov_106.953543	2960	3040	219	1	80	0.0125000
NODE_222_length_4770_cov_106.953543	2960	3040	221	1	80	0.0125000
NODE_222_length_4770_cov_106.953543	2960	3040	223	1	80	0.0125000
NODE_222_length_4770_cov_106.953543	2960	3040	226	1	80	0.0125000
NODE_222_length_4770_cov_106.953543	2960	3040	228	1	80	0.0125000
NODE_222_length_4770_cov_106.953543	2960	3040	233	1	80	0.0125000
NODE_222_length_4770_cov_106.953543	2960	3040	235	1	80	0.0125000
NODE_222_length_4770_cov_106.953543	2960	3040	236	1	80	0.0125000
NODE_222_length_4770_cov_106.953543	2960	3040	237	1	80	0.0125000
NODE_222_length_4770_cov_106.953543	2960	3040	238	2	80	0.0250000
NODE_222_length_4770_cov_106.953543	2960	3040	239	3	80	0.0375000
NODE_222_length_4770_cov_106.953543	2960	3040	241	4	80	0.0500000
NODE_222_length_4770_cov_106.953543	2960	3040	242	2	80	0.0250000
NODE_222_length_4770_cov_106.953543	2960	3040	243	7	80	0.0875000
NODE_222_length_4770_cov_106.953543	2960	3040	244	1	80	0.0125000
NODE_222_length_4770_cov_106.953543	2960	3040	245	6	80	0.0750000
NODE_222_length_4770_cov_106.953543	2960	3040	246	1	80	0.0125000
NODE_222_length_4770_cov_106.953543	2960	3040	247	3	80	0.0375000
NODE_222_length_4770_cov_106.953543	2960	3040	250	1	80	0.0125000
NODE_222_length_4770_cov_106.953543	2960	3040	252	3	80	0.0375000
NODE_222_length_4770_cov_106.953543	2960	3040	253	6	80	0.0750000
NODE_222_length_4770_cov_106.953543	2960	3040	254	3	80	0.0375000
NODE_222_length_4770_cov_106.953543	2960	3040	256	9	80	0.1125000
NODE_222_length_4770_cov_106.953543	2960	3040	257	6	80	0.0750000
NODE_222_length_4770_cov_106.953543	2960	3040	258	3	80	0.0375000
NODE_222_length_4770_cov_106.953543	2960	3040	259	2	80	0.0250000
NODE_222_length_4770_cov_106.953543	2960	3040	260	1	80	0.0125000
NODE_222_length_4770_cov_106.953543	2960	3040	261	2	80	0.0250000
NODE_223_length_4768_cov_15.447205	1237	1317	50	1	80	0.0125000
NODE_223_length_4768_cov_15.447205	1237	1317	52	1	80	0.0125000
NODE_223_length_4768_cov_15.447205	1237	1317	55	3	80	0.0375000
NODE_223_length_4768_cov_15.447205	1237	1317	61	4	80	0.0500000
NODE_223_length_4768_cov_15.447205	1237	1317	68	1	80	0.0125000
NODE_223_length_4768_cov_15.447205	1237	1317	72	2	80	0.0250000
NODE_223_length_4768_cov_15.447205	1237	1317	74	4	80	0.0500000
NODE_223_length_4768_cov_15.447205	1237	1317	76	1	80	0.0125000
NODE_223_length_4768_cov_15.447205	1237	1317	82	9	80	0.1125000
NODE_223_length_4768_cov_15.447205	1237	1317	84	7	80	0.0875000
NODE_223_length_4768_cov_15.447205	1237	1317	85	2	80	0.0250000
NODE_223_length_4768_cov_15.447205	1237	1317	86	14	80	0.1750000
NODE_223_length_4768_cov_15.447205	1237	1317	87	2	80	0.0250000
NODE_223_length_4768_cov_15.447205	1237	1317	88	9	80	0.1125000
NODE_223_length_4768_cov_15.447205	1237	1317	90	5	80	0.0625000
NODE_223_length_4768_cov_15.447205	1237	1317	92	14	80	0.1750000
NODE_223_length_4768_cov_15.447205	1237	1317	94	1	80	0.0125000
NODE_228_length_4730_cov_30.142734	256	336	0	26	80	0.3250000
NODE_228_length_4730_cov_30.142734	256	336	2	29	80	0.3625000
NODE_228_length_4730_cov_30.142734	256	336	16	25	80	0.3125000
NODE_228_length_4730_cov_30.142734	309	389	0	2	80	0.0250000
NODE_228_length_4730_cov_30.142734	309	389	16	48	80	0.6000000
NODE_228_length_4730_cov_30.142734	309	389	17	13	80	0.1625000
NODE_228_length_4730_cov_30.142734	309	389	18	17	80	0.2125000
NODE_228_length_4730_cov_30.142734	4052	4132	2	36	80	0.4500000
NODE_228_length_4730_cov_30.142734	4052	4132	8	44	80	0.5500000
NODE_228_length_4730_cov_30.142734	4105	4185	0	11	80	0.1375000
NODE_228_length_4730_cov_30.142734	4105	4185	6	40	80	0.5000000
NODE_228_length_4730_cov_30.142734	4105	4185	8	29	80	0.3625000
NODE_231_length_4706_cov_25.522683	2181	2261	30	1	80	0.0125000
NODE_231_length_4706_cov_25.522683	2181	2261	31	1	80	0.0125000
NODE_231_length_4706_cov_25.522683	2181	2261	34	6	80	0.0750000
NODE_231_length_4706_cov_25.522683	2181	2261	38	3	80	0.0375000
NODE_231_length_4706_cov_25.522683	2181	2261	41	4	80	0.0500000
NODE_231_length_4706_cov_25.522683	2181	2261	43	3	80	0.0375000
NODE_231_length_4706_cov_25.522683	2181	2261	45	1	80	0.0125000
NODE_231_length_4706_cov_25.522683	2181	2261	49	1	80	0.0125000
NODE_231_length_4706_cov_25.522683	2181	2261	53	1	80	0.0125000
NODE_231_length_4706_cov_25.522683	2181	2261	56	2	80	0.0250000
NODE_231_length_4706_cov_25.522683	2181	2261	57	12	80	0.1500000
NODE_231_length_4706_cov_25.522683	2181	2261	59	1	80	0.0125000
NODE_231_length_4706_cov_25.522683	2181	2261	63	2	80	0.0250000
NODE_231_length_4706_cov_25.522683	2181	2261	68	1	80	0.0125000
NODE_231_length_4706_cov_25.522683	2181	2261	69	1	80	0.0125000
NODE_231_length_4706_cov_25.522683	2181	2261	71	1	80	0.0125000
NODE_231_length_4706_cov_25.522683	2181	2261	74	1	80	0.0125000
NODE_231_length_4706_cov_25.522683	2181	2261	76	2	80	0.0250000
NODE_231_length_4706_cov_25.522683	2181	2261	77	1	80	0.0125000
NODE_231_length_4706_cov_25.522683	2181	2261	85	1	80	0.0125000
NODE_231_length_4706_cov_25.522683	2181	2261	88	1	80	0.0125000
NODE_231_length_4706_cov_25.522683	2181	2261	90	1	80	0.0125000
NODE_231_length_4706_cov_25.522683	2181	2261	96	1	80	0.0125000
NODE_231_length_4706_cov_25.522683	2181	2261	99	1	80	0.0125000
NODE_231_length_4706_cov_25.522683	2181	2261	104	1	80	0.0125000
NODE_231_length_4706_cov_25.522683	2181	2261	109	1	80	0.0125000
NODE_231_length_4706_cov_25.522683	2181	2261	111	1	80	0.0125000
NODE_231_length_4706_cov_25.522683	2181	2261	113	1	80	0.0125000
NODE_231_length_4706_cov_25.522683	2181	2261	116	1	80	0.0125000
NODE_231_length_4706_cov_25.522683	2181	2261	126	1	80	0.0125000
NODE_231_length_4706_cov_25.522683	2181	2261	133	1	80	0.0125000
NODE_231_length_4706_cov_25.522683	2181	2261	139	1	80	0.0125000
NODE_231_length_4706_cov_25.522683	2181	2261	141	2	80	0.0250000
NODE_231_length_4706_cov_25.522683	2181	2261	149	1	80	0.0125000
NODE_231_length_4706_cov_25.522683	2181	2261	161	1	80	0.0125000
NODE_231_length_4706_cov_25.522683	2181	2261	163	1	80	0.0125000
NODE_231_length_4706_cov_25.522683	2181	2261	167	1	80	0.0125000
NODE_231_length_4706_cov_25.522683	2181	2261	169	1	80	0.0125000
NODE_231_length_4706_cov_25.522683	2181	2261	173	1	80	0.0125000
NODE_231_length_4706_cov_25.522683	2181	2261	175	1	80	0.0125000
NODE_231_length_4706_cov_25.522683	2181	2261	177	2	80	0.0250000
NODE_231_length_4706_cov_25.522683	2181	2261	188	2	80	0.0250000
NODE_231_length_4706_cov_25.522683	2181	2261	190	1	80	0.0125000
NODE_231_length_4706_cov_25.522683	2181	2261	195	1	80	0.0125000
NODE_231_length_4706_cov_25.522683	2181	2261	198	1	80	0.0125000
NODE_231_length_4706_cov_25.522683	2181	2261	201	1	80	0.0125000
NODE_231_length_4706_cov_25.522683	2181	2261	204	2	80	0.0250000
NODE_231_length_4706_cov_25.522683	2181	2261	206	2	80	0.0250000
NODE_231_length_4706_cov_25.522683	2181	2261	210	1	80	0.0125000
NODE_231_length_4706_cov_25.522683	2234	2288	0	2	54	0.0370370
NODE_231_length_4706_cov_25.522683	2234	2288	8	1	54	0.0185185
NODE_231_length_4706_cov_25.522683	2234	2288	10	14	54	0.2592593
NODE_231_length_4706_cov_25.522683	2234	2288	11	2	54	0.0370370
NODE_231_length_4706_cov_25.522683	2234	2288	14	1	54	0.0185185
NODE_231_length_4706_cov_25.522683	2234	2288	18	1	54	0.0185185
NODE_231_length_4706_cov_25.522683	2234	2288	22	2	54	0.0370370
NODE_231_length_4706_cov_25.522683	2234	2288	26	1	54	0.0185185
NODE_231_length_4706_cov_25.522683	2234	2288	30	4	54	0.0740741
NODE_231_length_4706_cov_25.522683	2234	2288	31	1	54	0.0185185
NODE_231_length_4706_cov_25.522683	2234	2288	34	6	54	0.1111111
NODE_231_length_4706_cov_25.522683	2234	2288	38	3	54	0.0555556
NODE_231_length_4706_cov_25.522683	2234	2288	41	4	54	0.0740741
NODE_231_length_4706_cov_25.522683	2234	2288	43	3	54	0.0555556
NODE_231_length_4706_cov_25.522683	2234	2288	45	1	54	0.0185185
NODE_231_length_4706_cov_25.522683	2234	2288	49	1	54	0.0185185
NODE_231_length_4706_cov_25.522683	2234	2288	53	1	54	0.0185185
NODE_231_length_4706_cov_25.522683	2234	2288	56	2	54	0.0370370
NODE_231_length_4706_cov_25.522683	2234	2288	57	4	54	0.0740741
NODE_231_length_4706_cov_25.522683	3943	4026	221	4	83	0.0481928
NODE_231_length_4706_cov_25.522683	3943	4026	222	5	83	0.0602410
NODE_231_length_4706_cov_25.522683	3943	4026	223	7	83	0.0843373
NODE_231_length_4706_cov_25.522683	3943	4026	224	1	83	0.0120482
NODE_231_length_4706_cov_25.522683	3943	4026	225	2	83	0.0240964
NODE_231_length_4706_cov_25.522683	3943	4026	226	2	83	0.0240964
NODE_231_length_4706_cov_25.522683	3943	4026	230	2	83	0.0240964
NODE_231_length_4706_cov_25.522683	3943	4026	231	2	83	0.0240964
NODE_231_length_4706_cov_25.522683	3943	4026	232	3	83	0.0361446
NODE_231_length_4706_cov_25.522683	3943	4026	233	1	83	0.0120482
NODE_231_length_4706_cov_25.522683	3943	4026	234	2	83	0.0240964
NODE_231_length_4706_cov_25.522683	3943	4026	235	1	83	0.0120482
NODE_231_length_4706_cov_25.522683	3943	4026	236	2	83	0.0240964
NODE_231_length_4706_cov_25.522683	3943	4026	237	1	83	0.0120482
NODE_231_length_4706_cov_25.522683	3943	4026	238	6	83	0.0722892
NODE_231_length_4706_cov_25.522683	3943	4026	239	4	83	0.0481928
NODE_231_length_4706_cov_25.522683	3943	4026	240	2	83	0.0240964
NODE_231_length_4706_cov_25.522683	3943	4026	244	4	83	0.0481928
NODE_231_length_4706_cov_25.522683	3943	4026	245	2	83	0.0240964
NODE_231_length_4706_cov_25.522683	3943	4026	248	1	83	0.0120482
NODE_231_length_4706_cov_25.522683	3943	4026	250	3	83	0.0361446
NODE_231_length_4706_cov_25.522683	3943	4026	254	2	83	0.0240964
NODE_231_length_4706_cov_25.522683	3943	4026	258	1	83	0.0120482
NODE_231_length_4706_cov_25.522683	3943	4026	261	1	83	0.0120482
NODE_231_length_4706_cov_25.522683	3943	4026	265	1	83	0.0120482
NODE_231_length_4706_cov_25.522683	3943	4026	266	2	83	0.0240964
NODE_231_length_4706_cov_25.522683	3943	4026	269	1	83	0.0120482
NODE_231_length_4706_cov_25.522683	3943	4026	271	2	83	0.0240964
NODE_231_length_4706_cov_25.522683	3943	4026	273	3	83	0.0361446
NODE_231_length_4706_cov_25.522683	3943	4026	274	2	83	0.0240964
NODE_231_length_4706_cov_25.522683	3943	4026	276	1	83	0.0120482
NODE_231_length_4706_cov_25.522683	3943	4026	280	1	83	0.0120482
NODE_231_length_4706_cov_25.522683	3943	4026	281	2	83	0.0240964
NODE_231_length_4706_cov_25.522683	3943	4026	283	2	83	0.0240964
NODE_231_length_4706_cov_25.522683	3943	4026	284	1	83	0.0120482
NODE_231_length_4706_cov_25.522683	3943	4026	285	1	83	0.0120482
NODE_231_length_4706_cov_25.522683	3943	4026	292	1	83	0.0120482
NODE_231_length_4706_cov_25.522683	3943	4026	293	1	83	0.0120482
NODE_231_length_4706_cov_25.522683	3943	4026	295	1	83	0.0120482
NODE_235_length_4693_cov_16.973008	374	454	6	2	80	0.0250000
NODE_235_length_4693_cov_16.973008	374	454	8	13	80	0.1625000
NODE_235_length_4693_cov_16.973008	374	454	10	14	80	0.1750000
NODE_235_length_4693_cov_16.973008	374	454	12	32	80	0.4000000
NODE_235_length_4693_cov_16.973008	374	454	14	19	80	0.2375000
NODE_235_length_4693_cov_16.973008	427	507	8	51	80	0.6375000
NODE_235_length_4693_cov_16.973008	427	507	10	29	80	0.3625000
NODE_240_length_4672_cov_39.029084	1391	1470	208	1	79	0.0126582
NODE_240_length_4672_cov_39.029084	1391	1470	224	1	79	0.0126582
NODE_240_length_4672_cov_39.029084	1391	1470	241	1	79	0.0126582
NODE_240_length_4672_cov_39.029084	1391	1470	252	1	79	0.0126582
NODE_240_length_4672_cov_39.029084	1391	1470	270	1	79	0.0126582
NODE_240_length_4672_cov_39.029084	1391	1470	272	1	79	0.0126582
NODE_240_length_4672_cov_39.029084	1391	1470	274	3	79	0.0379747
NODE_240_length_4672_cov_39.029084	1391	1470	276	1	79	0.0126582
NODE_240_length_4672_cov_39.029084	1391	1470	280	1	79	0.0126582
NODE_240_length_4672_cov_39.029084	1391	1470	288	1	79	0.0126582
NODE_240_length_4672_cov_39.029084	1391	1470	292	1	79	0.0126582
NODE_240_length_4672_cov_39.029084	1391	1470	296	1	79	0.0126582
NODE_240_length_4672_cov_39.029084	1391	1470	302	3	79	0.0379747
NODE_240_length_4672_cov_39.029084	1391	1470	305	3	79	0.0379747
NODE_240_length_4672_cov_39.029084	1391	1470	309	1	79	0.0126582
NODE_240_length_4672_cov_39.029084	1391	1470	313	1	79	0.0126582
NODE_240_length_4672_cov_39.029084	1391	1470	326	1	79	0.0126582
NODE_240_length_4672_cov_39.029084	1391	1470	350	1	79	0.0126582
NODE_240_length_4672_cov_39.029084	1391	1470	354	1	79	0.0126582
NODE_240_length_4672_cov_39.029084	1391	1470	361	1	79	0.0126582
NODE_240_length_4672_cov_39.029084	1391	1470	366	1	79	0.0126582
NODE_240_length_4672_cov_39.029084	1391	1470	369	1	79	0.0126582
NODE_240_length_4672_cov_39.029084	1391	1470	381	1	79	0.0126582
NODE_240_length_4672_cov_39.029084	1391	1470	389	1	79	0.0126582
NODE_240_length_4672_cov_39.029084	1391	1470	393	1	79	0.0126582
NODE_240_length_4672_cov_39.029084	1391	1470	408	1	79	0.0126582
NODE_240_length_4672_cov_39.029084	1391	1470	410	1	79	0.0126582
NODE_240_length_4672_cov_39.029084	1391	1470	437	1	79	0.0126582
NODE_240_length_4672_cov_39.029084	1391	1470	447	2	79	0.0253165
NODE_240_length_4672_cov_39.029084	1391	1470	457	1	79	0.0126582
NODE_240_length_4672_cov_39.029084	1391	1470	461	2	79	0.0253165
NODE_240_length_4672_cov_39.029084	1391	1470	463	1	79	0.0126582
NODE_240_length_4672_cov_39.029084	1391	1470	471	1	79	0.0126582
NODE_240_length_4672_cov_39.029084	1391	1470	477	1	79	0.0126582
NODE_240_length_4672_cov_39.029084	1391	1470	488	1	79	0.0126582
NODE_240_length_4672_cov_39.029084	1391	1470	492	1	79	0.0126582
NODE_240_length_4672_cov_39.029084	1391	1470	496	2	79	0.0253165
NODE_240_length_4672_cov_39.029084	1391	1470	498	1	79	0.0126582
NODE_240_length_4672_cov_39.029084	1391	1470	500	1	79	0.0126582
NODE_240_length_4672_cov_39.029084	1391	1470	514	1	79	0.0126582
NODE_240_length_4672_cov_39.029084	1391	1470	518	1	79	0.0126582
NODE_240_length_4672_cov_39.029084	1391	1470	528	1	79	0.0126582
NODE_240_length_4672_cov_39.029084	1391	1470	547	1	79	0.0126582
NODE_240_length_4672_cov_39.029084	1391	1470	548	1	79	0.0126582
NODE_240_length_4672_cov_39.029084	1391	1470	554	2	79	0.0253165
NODE_240_length_4672_cov_39.029084	1391	1470	556	4	79	0.0506329
NODE_240_length_4672_cov_39.029084	1391	1470	563	3	79	0.0379747
NODE_240_length_4672_cov_39.029084	1391	1470	564	1	79	0.0126582
NODE_240_length_4672_cov_39.029084	1391	1470	567	1	79	0.0126582
NODE_240_length_4672_cov_39.029084	1391	1470	569	2	79	0.0253165
NODE_240_length_4672_cov_39.029084	1391	1470	570	1	79	0.0126582
NODE_240_length_4672_cov_39.029084	1391	1470	572	1	79	0.0126582
NODE_240_length_4672_cov_39.029084	1391	1470	573	2	79	0.0253165
NODE_240_length_4672_cov_39.029084	1391	1470	574	1	79	0.0126582
NODE_240_length_4672_cov_39.029084	1391	1470	576	1	79	0.0126582
NODE_240_length_4672_cov_39.029084	1391	1470	577	2	79	0.0253165
NODE_240_length_4672_cov_39.029084	1391	1470	580	1	79	0.0126582
NODE_240_length_4672_cov_39.029084	1391	1470	582	3	79	0.0379747
NODE_240_length_4672_cov_39.029084	1391	1470	583	1	79	0.0126582
NODE_240_length_4672_cov_39.029084	1444	1523	274	1	79	0.0126582
NODE_240_length_4672_cov_39.029084	1444	1523	283	2	79	0.0253165
NODE_240_length_4672_cov_39.029084	1444	1523	286	1	79	0.0126582
NODE_240_length_4672_cov_39.029084	1444	1523	303	1	79	0.0126582
NODE_240_length_4672_cov_39.029084	1444	1523	311	1	79	0.0126582
NODE_240_length_4672_cov_39.029084	1444	1523	331	1	79	0.0126582
NODE_240_length_4672_cov_39.029084	1444	1523	347	1	79	0.0126582
NODE_240_length_4672_cov_39.029084	1444	1523	389	1	79	0.0126582
NODE_240_length_4672_cov_39.029084	1444	1523	396	1	79	0.0126582
NODE_240_length_4672_cov_39.029084	1444	1523	401	1	79	0.0126582
NODE_240_length_4672_cov_39.029084	1444	1523	405	1	79	0.0126582
NODE_240_length_4672_cov_39.029084	1444	1523	419	2	79	0.0253165
NODE_240_length_4672_cov_39.029084	1444	1523	426	1	79	0.0126582
NODE_240_length_4672_cov_39.029084	1444	1523	441	1	79	0.0126582
NODE_240_length_4672_cov_39.029084	1444	1523	448	1	79	0.0126582
NODE_240_length_4672_cov_39.029084	1444	1523	455	1	79	0.0126582
NODE_240_length_4672_cov_39.029084	1444	1523	463	1	79	0.0126582
NODE_240_length_4672_cov_39.029084	1444	1523	467	1	79	0.0126582
NODE_240_length_4672_cov_39.029084	1444	1523	469	1	79	0.0126582
NODE_240_length_4672_cov_39.029084	1444	1523	471	2	79	0.0253165
NODE_240_length_4672_cov_39.029084	1444	1523	473	1	79	0.0126582
NODE_240_length_4672_cov_39.029084	1444	1523	475	1	79	0.0126582
NODE_240_length_4672_cov_39.029084	1444	1523	484	2	79	0.0253165
NODE_240_length_4672_cov_39.029084	1444	1523	491	1	79	0.0126582
NODE_240_length_4672_cov_39.029084	1444	1523	492	1	79	0.0126582
NODE_240_length_4672_cov_39.029084	1444	1523	493	1	79	0.0126582
NODE_240_length_4672_cov_39.029084	1444	1523	499	3	79	0.0379747
NODE_240_length_4672_cov_39.029084	1444	1523	515	1	79	0.0126582
NODE_240_length_4672_cov_39.029084	1444	1523	520	2	79	0.0253165
NODE_240_length_4672_cov_39.029084	1444	1523	524	1	79	0.0126582
NODE_240_length_4672_cov_39.029084	1444	1523	528	1	79	0.0126582
NODE_240_length_4672_cov_39.029084	1444	1523	539	1	79	0.0126582
NODE_240_length_4672_cov_39.029084	1444	1523	540	1	79	0.0126582
NODE_240_length_4672_cov_39.029084	1444	1523	542	1	79	0.0126582
NODE_240_length_4672_cov_39.029084	1444	1523	546	2	79	0.0253165
NODE_240_length_4672_cov_39.029084	1444	1523	549	1	79	0.0126582
NODE_240_length_4672_cov_39.029084	1444	1523	550	1	79	0.0126582
NODE_240_length_4672_cov_39.029084	1444	1523	551	1	79	0.0126582
NODE_240_length_4672_cov_39.029084	1444	1523	552	1	79	0.0126582
NODE_240_length_4672_cov_39.029084	1444	1523	553	1	79	0.0126582
NODE_240_length_4672_cov_39.029084	1444	1523	554	3	79	0.0379747
NODE_240_length_4672_cov_39.029084	1444	1523	556	5	79	0.0632911
NODE_240_length_4672_cov_39.029084	1444	1523	558	2	79	0.0253165
NODE_240_length_4672_cov_39.029084	1444	1523	562	1	79	0.0126582
NODE_240_length_4672_cov_39.029084	1444	1523	563	3	79	0.0379747
NODE_240_length_4672_cov_39.029084	1444	1523	564	1	79	0.0126582
NODE_240_length_4672_cov_39.029084	1444	1523	567	1	79	0.0126582
NODE_240_length_4672_cov_39.029084	1444	1523	569	2	79	0.0253165
NODE_240_length_4672_cov_39.029084	1444	1523	570	1	79	0.0126582
NODE_240_length_4672_cov_39.029084	1444	1523	572	1	79	0.0126582
NODE_240_length_4672_cov_39.029084	1444	1523	573	2	79	0.0253165
NODE_240_length_4672_cov_39.029084	1444	1523	574	1	79	0.0126582
NODE_240_length_4672_cov_39.029084	1444	1523	576	1	79	0.0126582
NODE_240_length_4672_cov_39.029084	1444	1523	577	2	79	0.0253165
NODE_240_length_4672_cov_39.029084	1444	1523	580	1	79	0.0126582
NODE_240_length_4672_cov_39.029084	1444	1523	582	3	79	0.0379747
NODE_240_length_4672_cov_39.029084	1444	1523	583	1	79	0.0126582
NODE_246_length_4602_cov_17.281368	3106	3186	35	1	80	0.0125000
NODE_246_length_4602_cov_17.281368	3106	3186	45	13	80	0.1625000
NODE_246_length_4602_cov_17.281368	3106	3186	46	1	80	0.0125000
NODE_246_length_4602_cov_17.281368	3106	3186	47	7	80	0.0875000
NODE_246_length_4602_cov_17.281368	3106	3186	49	6	80	0.0750000
NODE_246_length_4602_cov_17.281368	3106	3186	55	1	80	0.0125000
NODE_246_length_4602_cov_17.281368	3106	3186	61	8	80	0.1000000
NODE_246_length_4602_cov_17.281368	3106	3186	63	2	80	0.0250000
NODE_246_length_4602_cov_17.281368	3106	3186	70	1	80	0.0125000
NODE_246_length_4602_cov_17.281368	3106	3186	71	4	80	0.0500000
NODE_246_length_4602_cov_17.281368	3106	3186	75	7	80	0.0875000
NODE_246_length_4602_cov_17.281368	3106	3186	76	3	80	0.0375000
NODE_246_length_4602_cov_17.281368	3106	3186	77	3	80	0.0375000
NODE_246_length_4602_cov_17.281368	3106	3186	78	1	80	0.0125000
NODE_246_length_4602_cov_17.281368	3106	3186	79	10	80	0.1250000
NODE_246_length_4602_cov_17.281368	3106	3186	81	5	80	0.0625000
NODE_246_length_4602_cov_17.281368	3106	3186	82	6	80	0.0750000
NODE_246_length_4602_cov_17.281368	3106	3186	85	1	80	0.0125000
NODE_246_length_4602_cov_17.281368	3159	3239	35	12	80	0.1500000
NODE_246_length_4602_cov_17.281368	3159	3239	37	2	80	0.0250000
NODE_246_length_4602_cov_17.281368	3159	3239	41	1	80	0.0125000
NODE_246_length_4602_cov_17.281368	3159	3239	47	5	80	0.0625000
NODE_246_length_4602_cov_17.281368	3159	3239	49	20	80	0.2500000
NODE_246_length_4602_cov_17.281368	3159	3239	58	2	80	0.0250000
NODE_246_length_4602_cov_17.281368	3159	3239	61	3	80	0.0375000
NODE_246_length_4602_cov_17.281368	3159	3239	63	2	80	0.0250000
NODE_246_length_4602_cov_17.281368	3159	3239	67	3	80	0.0375000
NODE_246_length_4602_cov_17.281368	3159	3239	74	1	80	0.0125000
NODE_246_length_4602_cov_17.281368	3159	3239	76	5	80	0.0625000
NODE_246_length_4602_cov_17.281368	3159	3239	77	1	80	0.0125000
NODE_246_length_4602_cov_17.281368	3159	3239	78	1	80	0.0125000
NODE_246_length_4602_cov_17.281368	3159	3239	79	10	80	0.1250000
NODE_246_length_4602_cov_17.281368	3159	3239	81	5	80	0.0625000
NODE_246_length_4602_cov_17.281368	3159	3239	82	6	80	0.0750000
NODE_246_length_4602_cov_17.281368	3159	3239	85	1	80	0.0125000
NODE_248_length_4587_cov_14.431150	1294	1370	233	1	76	0.0131579
NODE_248_length_4587_cov_14.431150	1294	1370	235	1	76	0.0131579
NODE_248_length_4587_cov_14.431150	1294	1370	237	1	76	0.0131579
NODE_248_length_4587_cov_14.431150	1294	1370	238	2	76	0.0263158
NODE_248_length_4587_cov_14.431150	1294	1370	239	2	76	0.0263158
NODE_248_length_4587_cov_14.431150	1294	1370	240	1	76	0.0131579
NODE_248_length_4587_cov_14.431150	1294	1370	251	1	76	0.0131579
NODE_248_length_4587_cov_14.431150	1294	1370	256	2	76	0.0263158
NODE_248_length_4587_cov_14.431150	1294	1370	261	1	76	0.0131579
NODE_248_length_4587_cov_14.431150	1294	1370	279	1	76	0.0131579
NODE_248_length_4587_cov_14.431150	1294	1370	281	2	76	0.0263158
NODE_248_length_4587_cov_14.431150	1294	1370	282	1	76	0.0131579
NODE_248_length_4587_cov_14.431150	1294	1370	283	2	76	0.0263158
NODE_248_length_4587_cov_14.431150	1294	1370	284	1	76	0.0131579
NODE_248_length_4587_cov_14.431150	1294	1370	287	1	76	0.0131579
NODE_248_length_4587_cov_14.431150	1294	1370	289	1	76	0.0131579
NODE_248_length_4587_cov_14.431150	1294	1370	294	1	76	0.0131579
NODE_248_length_4587_cov_14.431150	1294	1370	305	1	76	0.0131579
NODE_248_length_4587_cov_14.431150	1294	1370	309	1	76	0.0131579
NODE_248_length_4587_cov_14.431150	1294	1370	312	1	76	0.0131579
NODE_248_length_4587_cov_14.431150	1294	1370	318	1	76	0.0131579
NODE_248_length_4587_cov_14.431150	1294	1370	319	1	76	0.0131579
NODE_248_length_4587_cov_14.431150	1294	1370	328	1	76	0.0131579
NODE_248_length_4587_cov_14.431150	1294	1370	332	2	76	0.0263158
NODE_248_length_4587_cov_14.431150	1294	1370	336	2	76	0.0263158
NODE_248_length_4587_cov_14.431150	1294	1370	337	1	76	0.0131579
NODE_248_length_4587_cov_14.431150	1294	1370	338	1	76	0.0131579
NODE_248_length_4587_cov_14.431150	1294	1370	343	2	76	0.0263158
NODE_248_length_4587_cov_14.431150	1294	1370	344	2	76	0.0263158
NODE_248_length_4587_cov_14.431150	1294	1370	345	3	76	0.0394737
NODE_248_length_4587_cov_14.431150	1294	1370	347	3	76	0.0394737
NODE_248_length_4587_cov_14.431150	1294	1370	348	1	76	0.0131579
NODE_248_length_4587_cov_14.431150	1294	1370	349	1	76	0.0131579
NODE_248_length_4587_cov_14.431150	1294	1370	352	1	76	0.0131579
NODE_248_length_4587_cov_14.431150	1294	1370	359	2	76	0.0263158
NODE_248_length_4587_cov_14.431150	1294	1370	360	3	76	0.0394737
NODE_248_length_4587_cov_14.431150	1294	1370	361	2	76	0.0263158
NODE_248_length_4587_cov_14.431150	1294	1370	362	3	76	0.0394737
NODE_248_length_4587_cov_14.431150	1294	1370	363	1	76	0.0131579
NODE_248_length_4587_cov_14.431150	1294	1370	364	6	76	0.0789474
NODE_248_length_4587_cov_14.431150	1294	1370	365	3	76	0.0394737
NODE_248_length_4587_cov_14.431150	1294	1370	366	2	76	0.0263158
NODE_248_length_4587_cov_14.431150	1294	1370	372	1	76	0.0131579
NODE_248_length_4587_cov_14.431150	1294	1370	374	3	76	0.0394737
NODE_248_length_4587_cov_14.431150	1294	1370	375	1	76	0.0131579
NODE_248_length_4587_cov_14.431150	1294	1370	380	2	76	0.0263158
NODE_248_length_4587_cov_14.431150	1347	1427	316	2	80	0.0250000
NODE_248_length_4587_cov_14.431150	1347	1427	318	1	80	0.0125000
NODE_248_length_4587_cov_14.431150	1347	1427	321	1	80	0.0125000
NODE_248_length_4587_cov_14.431150	1347	1427	324	1	80	0.0125000
NODE_248_length_4587_cov_14.431150	1347	1427	332	1	80	0.0125000
NODE_248_length_4587_cov_14.431150	1347	1427	346	1	80	0.0125000
NODE_248_length_4587_cov_14.431150	1347	1427	356	1	80	0.0125000
NODE_248_length_4587_cov_14.431150	1347	1427	359	1	80	0.0125000
NODE_248_length_4587_cov_14.431150	1347	1427	360	3	80	0.0375000
NODE_248_length_4587_cov_14.431150	1347	1427	362	2	80	0.0250000
NODE_248_length_4587_cov_14.431150	1347	1427	364	6	80	0.0750000
NODE_248_length_4587_cov_14.431150	1347	1427	365	3	80	0.0375000
NODE_248_length_4587_cov_14.431150	1347	1427	366	2	80	0.0250000
NODE_248_length_4587_cov_14.431150	1347	1427	371	1	80	0.0125000
NODE_248_length_4587_cov_14.431150	1347	1427	372	1	80	0.0125000
NODE_248_length_4587_cov_14.431150	1347	1427	374	3	80	0.0375000
NODE_248_length_4587_cov_14.431150	1347	1427	375	1	80	0.0125000
NODE_248_length_4587_cov_14.431150	1347	1427	377	4	80	0.0500000
NODE_248_length_4587_cov_14.431150	1347	1427	378	1	80	0.0125000
NODE_248_length_4587_cov_14.431150	1347	1427	379	1	80	0.0125000
NODE_248_length_4587_cov_14.431150	1347	1427	380	6	80	0.0750000
NODE_248_length_4587_cov_14.431150	1347	1427	381	1	80	0.0125000
NODE_248_length_4587_cov_14.431150	1347	1427	382	4	80	0.0500000
NODE_248_length_4587_cov_14.431150	1347	1427	383	1	80	0.0125000
NODE_248_length_4587_cov_14.431150	1347	1427	384	1	80	0.0125000
NODE_248_length_4587_cov_14.431150	1347	1427	386	1	80	0.0125000
NODE_248_length_4587_cov_14.431150	1347	1427	388	1	80	0.0125000
NODE_248_length_4587_cov_14.431150	1347	1427	391	2	80	0.0250000
NODE_248_length_4587_cov_14.431150	1347	1427	393	3	80	0.0375000
NODE_248_length_4587_cov_14.431150	1347	1427	395	4	80	0.0500000
NODE_248_length_4587_cov_14.431150	1347	1427	396	1	80	0.0125000
NODE_248_length_4587_cov_14.431150	1347	1427	397	7	80	0.0875000
NODE_248_length_4587_cov_14.431150	1347	1427	398	2	80	0.0250000
NODE_248_length_4587_cov_14.431150	1347	1427	399	3	80	0.0375000
NODE_248_length_4587_cov_14.431150	1347	1427	400	1	80	0.0125000
NODE_248_length_4587_cov_14.431150	1347	1427	401	1	80	0.0125000
NODE_248_length_4587_cov_14.431150	1347	1427	402	1	80	0.0125000
NODE_248_length_4587_cov_14.431150	1347	1427	404	1	80	0.0125000
NODE_248_length_4587_cov_14.431150	1347	1427	405	1	80	0.0125000
NODE_248_length_4587_cov_14.431150	1347	1427	407	1	80	0.0125000
NODE_248_length_4587_cov_14.431150	1466	1533	162	1	67	0.0149254
NODE_248_length_4587_cov_14.431150	1466	1533	165	1	67	0.0149254
NODE_248_length_4587_cov_14.431150	1466	1533	171	1	67	0.0149254
NODE_248_length_4587_cov_14.431150	1466	1533	173	1	67	0.0149254
NODE_248_length_4587_cov_14.431150	1466	1533	178	2	67	0.0298507
NODE_248_length_4587_cov_14.431150	1466	1533	179	2	67	0.0298507
NODE_248_length_4587_cov_14.431150	1466	1533	181	4	67	0.0597015
NODE_248_length_4587_cov_14.431150	1466	1533	182	1	67	0.0149254
NODE_248_length_4587_cov_14.431150	1466	1533	183	1	67	0.0149254
NODE_248_length_4587_cov_14.431150	1466	1533	184	1	67	0.0149254
NODE_248_length_4587_cov_14.431150	1466	1533	185	1	67	0.0149254
NODE_248_length_4587_cov_14.431150	1466	1533	186	1	67	0.0149254
NODE_248_length_4587_cov_14.431150	1466	1533	188	5	67	0.0746269
NODE_248_length_4587_cov_14.431150	1466	1533	189	3	67	0.0447761
NODE_248_length_4587_cov_14.431150	1466	1533	190	4	67	0.0597015
NODE_248_length_4587_cov_14.431150	1466	1533	191	8	67	0.1194030
NODE_248_length_4587_cov_14.431150	1466	1533	192	2	67	0.0298507
NODE_248_length_4587_cov_14.431150	1466	1533	193	1	67	0.0149254
NODE_248_length_4587_cov_14.431150	1466	1533	196	1	67	0.0149254
NODE_248_length_4587_cov_14.431150	1466	1533	198	1	67	0.0149254
NODE_248_length_4587_cov_14.431150	1466	1533	199	2	67	0.0298507
NODE_248_length_4587_cov_14.431150	1466	1533	201	2	67	0.0298507
NODE_248_length_4587_cov_14.431150	1466	1533	204	3	67	0.0447761
NODE_248_length_4587_cov_14.431150	1466	1533	207	1	67	0.0149254
NODE_248_length_4587_cov_14.431150	1466	1533	209	2	67	0.0298507
NODE_248_length_4587_cov_14.431150	1466	1533	213	1	67	0.0149254
NODE_248_length_4587_cov_14.431150	1466	1533	214	1	67	0.0149254
NODE_248_length_4587_cov_14.431150	1466	1533	219	1	67	0.0149254
NODE_248_length_4587_cov_14.431150	1466	1533	220	1	67	0.0149254
NODE_248_length_4587_cov_14.431150	1466	1533	221	1	67	0.0149254
NODE_248_length_4587_cov_14.431150	1466	1533	225	1	67	0.0149254
NODE_248_length_4587_cov_14.431150	1466	1533	227	3	67	0.0447761
NODE_248_length_4587_cov_14.431150	1466	1533	229	2	67	0.0298507
NODE_248_length_4587_cov_14.431150	1466	1533	231	2	67	0.0298507
NODE_248_length_4587_cov_14.431150	1466	1533	236	1	67	0.0149254
NODE_248_length_4587_cov_14.431150	1466	1533	250	1	67	0.0149254
NODE_248_length_4587_cov_14.431150	4316	4382	463	1	66	0.0151515
NODE_248_length_4587_cov_14.431150	4316	4382	491	1	66	0.0151515
NODE_248_length_4587_cov_14.431150	4316	4382	506	1	66	0.0151515
NODE_248_length_4587_cov_14.431150	4316	4382	530	1	66	0.0151515
NODE_248_length_4587_cov_14.431150	4316	4382	541	1	66	0.0151515
NODE_248_length_4587_cov_14.431150	4316	4382	549	1	66	0.0151515
NODE_248_length_4587_cov_14.431150	4316	4382	575	1	66	0.0151515
NODE_248_length_4587_cov_14.431150	4316	4382	579	1	66	0.0151515
NODE_248_length_4587_cov_14.431150	4316	4382	585	1	66	0.0151515
NODE_248_length_4587_cov_14.431150	4316	4382	593	1	66	0.0151515
NODE_248_length_4587_cov_14.431150	4316	4382	596	1	66	0.0151515
NODE_248_length_4587_cov_14.431150	4316	4382	619	1	66	0.0151515
NODE_248_length_4587_cov_14.431150	4316	4382	641	1	66	0.0151515
NODE_248_length_4587_cov_14.431150	4316	4382	680	1	66	0.0151515
NODE_248_length_4587_cov_14.431150	4316	4382	685	1	66	0.0151515
NODE_248_length_4587_cov_14.431150	4316	4382	699	1	66	0.0151515
NODE_248_length_4587_cov_14.431150	4316	4382	708	1	66	0.0151515
NODE_248_length_4587_cov_14.431150	4316	4382	728	1	66	0.0151515
NODE_248_length_4587_cov_14.431150	4316	4382	734	1	66	0.0151515
NODE_248_length_4587_cov_14.431150	4316	4382	744	1	66	0.0151515
NODE_248_length_4587_cov_14.431150	4316	4382	750	1	66	0.0151515
NODE_248_length_4587_cov_14.431150	4316	4382	752	1	66	0.0151515
NODE_248_length_4587_cov_14.431150	4316	4382	754	1	66	0.0151515
NODE_248_length_4587_cov_14.431150	4316	4382	760	1	66	0.0151515
NODE_248_length_4587_cov_14.431150	4316	4382	761	1	66	0.0151515
NODE_248_length_4587_cov_14.431150	4316	4382	766	1	66	0.0151515
NODE_248_length_4587_cov_14.431150	4316	4382	774	1	66	0.0151515
NODE_248_length_4587_cov_14.431150	4316	4382	788	1	66	0.0151515
NODE_248_length_4587_cov_14.431150	4316	4382	799	1	66	0.0151515
NODE_248_length_4587_cov_14.431150	4316	4382	822	1	66	0.0151515
NODE_248_length_4587_cov_14.431150	4316	4382	836	1	66	0.0151515
NODE_248_length_4587_cov_14.431150	4316	4382	864	1	66	0.0151515
NODE_248_length_4587_cov_14.431150	4316	4382	866	1	66	0.0151515
NODE_248_length_4587_cov_14.431150	4316	4382	875	1	66	0.0151515
NODE_248_length_4587_cov_14.431150	4316	4382	881	2	66	0.0303030
NODE_248_length_4587_cov_14.431150	4316	4382	884	1	66	0.0151515
NODE_248_length_4587_cov_14.431150	4316	4382	887	1	66	0.0151515
NODE_248_length_4587_cov_14.431150	4316	4382	890	1	66	0.0151515
NODE_248_length_4587_cov_14.431150	4316	4382	902	1	66	0.0151515
NODE_248_length_4587_cov_14.431150	4316	4382	912	1	66	0.0151515
NODE_248_length_4587_cov_14.431150	4316	4382	914	1	66	0.0151515
NODE_248_length_4587_cov_14.431150	4316	4382	919	1	66	0.0151515
NODE_248_length_4587_cov_14.431150	4316	4382	920	2	66	0.0303030
NODE_248_length_4587_cov_14.431150	4316	4382	922	1	66	0.0151515
NODE_248_length_4587_cov_14.431150	4316	4382	925	1	66	0.0151515
NODE_248_length_4587_cov_14.431150	4316	4382	928	1	66	0.0151515
NODE_248_length_4587_cov_14.431150	4316	4382	929	3	66	0.0454545
NODE_248_length_4587_cov_14.431150	4316	4382	931	1	66	0.0151515
NODE_248_length_4587_cov_14.431150	4316	4382	932	3	66	0.0454545
NODE_248_length_4587_cov_14.431150	4316	4382	933	1	66	0.0151515
NODE_248_length_4587_cov_14.431150	4316	4382	934	2	66	0.0303030
NODE_248_length_4587_cov_14.431150	4316	4382	937	2	66	0.0303030
NODE_248_length_4587_cov_14.431150	4316	4382	940	1	66	0.0151515
NODE_248_length_4587_cov_14.431150	4316	4382	941	3	66	0.0454545
NODE_248_length_4587_cov_14.431150	4316	4382	942	2	66	0.0303030
NODE_248_length_4587_cov_14.431150	4355	4435	681	1	80	0.0125000
NODE_248_length_4587_cov_14.431150	4355	4435	686	1	80	0.0125000
NODE_248_length_4587_cov_14.431150	4355	4435	691	1	80	0.0125000
NODE_248_length_4587_cov_14.431150	4355	4435	707	1	80	0.0125000
NODE_248_length_4587_cov_14.431150	4355	4435	720	1	80	0.0125000
NODE_248_length_4587_cov_14.431150	4355	4435	734	1	80	0.0125000
NODE_248_length_4587_cov_14.431150	4355	4435	763	1	80	0.0125000
NODE_248_length_4587_cov_14.431150	4355	4435	774	1	80	0.0125000
NODE_248_length_4587_cov_14.431150	4355	4435	798	1	80	0.0125000
NODE_248_length_4587_cov_14.431150	4355	4435	811	1	80	0.0125000
NODE_248_length_4587_cov_14.431150	4355	4435	818	1	80	0.0125000
NODE_248_length_4587_cov_14.431150	4355	4435	826	2	80	0.0250000
NODE_248_length_4587_cov_14.431150	4355	4435	830	1	80	0.0125000
NODE_248_length_4587_cov_14.431150	4355	4435	834	1	80	0.0125000
NODE_248_length_4587_cov_14.431150	4355	4435	838	1	80	0.0125000
NODE_248_length_4587_cov_14.431150	4355	4435	850	1	80	0.0125000
NODE_248_length_4587_cov_14.431150	4355	4435	861	1	80	0.0125000
NODE_248_length_4587_cov_14.431150	4355	4435	902	3	80	0.0375000
NODE_248_length_4587_cov_14.431150	4355	4435	905	1	80	0.0125000
NODE_248_length_4587_cov_14.431150	4355	4435	906	1	80	0.0125000
NODE_248_length_4587_cov_14.431150	4355	4435	912	1	80	0.0125000
NODE_248_length_4587_cov_14.431150	4355	4435	913	1	80	0.0125000
NODE_248_length_4587_cov_14.431150	4355	4435	914	1	80	0.0125000
NODE_248_length_4587_cov_14.431150	4355	4435	918	1	80	0.0125000
NODE_248_length_4587_cov_14.431150	4355	4435	919	2	80	0.0250000
NODE_248_length_4587_cov_14.431150	4355	4435	920	2	80	0.0250000
NODE_248_length_4587_cov_14.431150	4355	4435	921	1	80	0.0125000
NODE_248_length_4587_cov_14.431150	4355	4435	922	2	80	0.0250000
NODE_248_length_4587_cov_14.431150	4355	4435	925	2	80	0.0250000
NODE_248_length_4587_cov_14.431150	4355	4435	928	1	80	0.0125000
NODE_248_length_4587_cov_14.431150	4355	4435	929	6	80	0.0750000
NODE_248_length_4587_cov_14.431150	4355	4435	930	2	80	0.0250000
NODE_248_length_4587_cov_14.431150	4355	4435	931	3	80	0.0375000
NODE_248_length_4587_cov_14.431150	4355	4435	932	5	80	0.0625000
NODE_248_length_4587_cov_14.431150	4355	4435	933	4	80	0.0500000
NODE_248_length_4587_cov_14.431150	4355	4435	934	3	80	0.0375000
NODE_248_length_4587_cov_14.431150	4355	4435	935	1	80	0.0125000
NODE_248_length_4587_cov_14.431150	4355	4435	936	1	80	0.0125000
NODE_248_length_4587_cov_14.431150	4355	4435	937	2	80	0.0250000
NODE_248_length_4587_cov_14.431150	4355	4435	940	2	80	0.0250000
NODE_248_length_4587_cov_14.431150	4355	4435	941	5	80	0.0625000
NODE_248_length_4587_cov_14.431150	4355	4435	942	7	80	0.0875000
NODE_248_length_4587_cov_14.431150	4355	4435	943	1	80	0.0125000
NODE_248_length_4587_cov_14.431150	4355	4435	945	1	80	0.0125000
NODE_249_length_4572_cov_50.244579	2406	2483	0	37	77	0.4805195
NODE_249_length_4572_cov_50.244579	2406	2483	2	40	77	0.5194805
NODE_249_length_4572_cov_50.244579	2406	2483	0	37	77	0.4805195
NODE_249_length_4572_cov_50.244579	2406	2483	2	40	77	0.5194805
NODE_251_length_4556_cov_14.556652	4229	4288	60	7	59	0.1186441
NODE_251_length_4556_cov_14.556652	4229	4288	63	1	59	0.0169492
NODE_251_length_4556_cov_14.556652	4229	4288	67	2	59	0.0338983
NODE_251_length_4556_cov_14.556652	4229	4288	71	11	59	0.1864407
NODE_251_length_4556_cov_14.556652	4229	4288	73	3	59	0.0508475
NODE_251_length_4556_cov_14.556652	4229	4288	76	1	59	0.0169492
NODE_251_length_4556_cov_14.556652	4229	4288	79	3	59	0.0508475
NODE_251_length_4556_cov_14.556652	4229	4288	81	3	59	0.0508475
NODE_251_length_4556_cov_14.556652	4229	4288	87	2	59	0.0338983
NODE_251_length_4556_cov_14.556652	4229	4288	89	1	59	0.0169492
NODE_251_length_4556_cov_14.556652	4229	4288	92	2	59	0.0338983
NODE_251_length_4556_cov_14.556652	4229	4288	93	10	59	0.1694915
NODE_251_length_4556_cov_14.556652	4229	4288	94	4	59	0.0677966
NODE_251_length_4556_cov_14.556652	4229	4288	95	5	59	0.0847458
NODE_251_length_4556_cov_14.556652	4229	4288	96	2	59	0.0338983
NODE_251_length_4556_cov_14.556652	4229	4288	97	1	59	0.0169492
NODE_251_length_4556_cov_14.556652	4229	4288	100	1	59	0.0169492
NODE_252_length_4550_cov_5.664120	3548	3628	2	38	80	0.4750000
NODE_252_length_4550_cov_5.664120	3548	3628	5	25	80	0.3125000
NODE_252_length_4550_cov_5.664120	3548	3628	6	5	80	0.0625000
NODE_252_length_4550_cov_5.664120	3548	3628	8	12	80	0.1500000
NODE_252_length_4550_cov_5.664120	3601	3681	5	10	80	0.1250000
NODE_252_length_4550_cov_5.664120	3601	3681	6	42	80	0.5250000
NODE_252_length_4550_cov_5.664120	3601	3681	8	28	80	0.3500000
NODE_253_length_4544_cov_10.690439	353	433	0	29	80	0.3625000
NODE_253_length_4544_cov_10.690439	353	433	2	28	80	0.3500000
NODE_253_length_4544_cov_10.690439	353	433	4	23	80	0.2875000
NODE_253_length_4544_cov_10.690439	406	486	2	11	80	0.1375000
NODE_253_length_4544_cov_10.690439	406	486	4	69	80	0.8625000
NODE_253_length_4544_cov_10.690439	4487	4544	0	55	57	0.9649123
NODE_253_length_4544_cov_10.690439	4487	4544	8	2	57	0.0350877
NODE_255_length_4535_cov_24.849188	675	755	0	80	80	1.0000000
NODE_255_length_4535_cov_24.849188	728	809	0	81	81	1.0000000
NODE_255_length_4535_cov_24.849188	1319	1399	0	50	80	0.6250000
NODE_255_length_4535_cov_24.849188	1319	1399	3	30	80	0.3750000
NODE_255_length_4535_cov_24.849188	1372	1452	3	45	80	0.5625000
NODE_255_length_4535_cov_24.849188	1372	1452	11	1	80	0.0125000
NODE_255_length_4535_cov_24.849188	1372	1452	12	1	80	0.0125000
NODE_255_length_4535_cov_24.849188	1372	1452	14	1	80	0.0125000
NODE_255_length_4535_cov_24.849188	1372	1452	18	1	80	0.0125000
NODE_255_length_4535_cov_24.849188	1372	1452	23	1	80	0.0125000
NODE_255_length_4535_cov_24.849188	1372	1452	25	1	80	0.0125000
NODE_255_length_4535_cov_24.849188	1372	1452	27	3	80	0.0375000
NODE_255_length_4535_cov_24.849188	1372	1452	30	3	80	0.0375000
NODE_255_length_4535_cov_24.849188	1372	1452	34	1	80	0.0125000
NODE_255_length_4535_cov_24.849188	1372	1452	35	1	80	0.0125000
NODE_255_length_4535_cov_24.849188	1372	1452	41	1	80	0.0125000
NODE_255_length_4535_cov_24.849188	1372	1452	47	1	80	0.0125000
NODE_255_length_4535_cov_24.849188	1372	1452	49	2	80	0.0250000
NODE_255_length_4535_cov_24.849188	1372	1452	57	1	80	0.0125000
NODE_255_length_4535_cov_24.849188	1372	1452	64	1	80	0.0125000
NODE_255_length_4535_cov_24.849188	1372	1452	70	1	80	0.0125000
NODE_255_length_4535_cov_24.849188	1372	1452	72	1	80	0.0125000
NODE_255_length_4535_cov_24.849188	1372	1452	73	7	80	0.0875000
NODE_255_length_4535_cov_24.849188	1372	1452	77	2	80	0.0250000
NODE_255_length_4535_cov_24.849188	1372	1452	80	1	80	0.0125000
NODE_255_length_4535_cov_24.849188	1372	1452	85	1	80	0.0125000
NODE_255_length_4535_cov_24.849188	1372	1452	93	1	80	0.0125000
NODE_255_length_4535_cov_24.849188	1372	1452	96	1	80	0.0125000
NODE_258_length_4528_cov_19.736509	4295	4366	0	68	71	0.9577465
NODE_258_length_4528_cov_19.736509	4295	4366	4	2	71	0.0281690
NODE_258_length_4528_cov_19.736509	4295	4366	9	1	71	0.0140845
NODE_259_length_4505_cov_10.409215	3166	3202	148	1	36	0.0277778
NODE_259_length_4505_cov_10.409215	3166	3202	150	4	36	0.1111111
NODE_259_length_4505_cov_10.409215	3166	3202	151	4	36	0.1111111
NODE_259_length_4505_cov_10.409215	3166	3202	152	3	36	0.0833333
NODE_259_length_4505_cov_10.409215	3166	3202	153	3	36	0.0833333
NODE_259_length_4505_cov_10.409215	3166	3202	154	1	36	0.0277778
NODE_259_length_4505_cov_10.409215	3166	3202	155	1	36	0.0277778
NODE_259_length_4505_cov_10.409215	3166	3202	156	1	36	0.0277778
NODE_259_length_4505_cov_10.409215	3166	3202	157	7	36	0.1944444
NODE_259_length_4505_cov_10.409215	3166	3202	159	3	36	0.0833333
NODE_259_length_4505_cov_10.409215	3166	3202	163	2	36	0.0555556
NODE_259_length_4505_cov_10.409215	3166	3202	164	2	36	0.0555556
NODE_259_length_4505_cov_10.409215	3166	3202	168	4	36	0.1111111
NODE_259_length_4505_cov_10.409215	3175	3255	122	4	80	0.0500000
NODE_259_length_4505_cov_10.409215	3175	3255	128	1	80	0.0125000
NODE_259_length_4505_cov_10.409215	3175	3255	136	1	80	0.0125000
NODE_259_length_4505_cov_10.409215	3175	3255	137	2	80	0.0250000
NODE_259_length_4505_cov_10.409215	3175	3255	139	3	80	0.0375000
NODE_259_length_4505_cov_10.409215	3175	3255	140	2	80	0.0250000
NODE_259_length_4505_cov_10.409215	3175	3255	141	1	80	0.0125000
NODE_259_length_4505_cov_10.409215	3175	3255	142	1	80	0.0125000
NODE_259_length_4505_cov_10.409215	3175	3255	143	1	80	0.0125000
NODE_259_length_4505_cov_10.409215	3175	3255	144	2	80	0.0250000
NODE_259_length_4505_cov_10.409215	3175	3255	151	11	80	0.1375000
NODE_259_length_4505_cov_10.409215	3175	3255	152	1	80	0.0125000
NODE_259_length_4505_cov_10.409215	3175	3255	153	7	80	0.0875000
NODE_259_length_4505_cov_10.409215	3175	3255	155	9	80	0.1125000
NODE_259_length_4505_cov_10.409215	3175	3255	156	1	80	0.0125000
NODE_259_length_4505_cov_10.409215	3175	3255	157	7	80	0.0875000
NODE_259_length_4505_cov_10.409215	3175	3255	159	3	80	0.0375000
NODE_259_length_4505_cov_10.409215	3175	3255	160	2	80	0.0250000
NODE_259_length_4505_cov_10.409215	3175	3255	161	1	80	0.0125000
NODE_259_length_4505_cov_10.409215	3175	3255	162	2	80	0.0250000
NODE_259_length_4505_cov_10.409215	3175	3255	163	8	80	0.1000000
NODE_259_length_4505_cov_10.409215	3175	3255	164	6	80	0.0750000
NODE_259_length_4505_cov_10.409215	3175	3255	168	4	80	0.0500000
NODE_260_length_4498_cov_8.216185	3161	3219	1	1	58	0.0172414
NODE_260_length_4498_cov_8.216185	3161	3219	2	10	58	0.1724138
NODE_260_length_4498_cov_8.216185	3161	3219	3	2	58	0.0344828
NODE_260_length_4498_cov_8.216185	3161	3219	6	28	58	0.4827586
NODE_260_length_4498_cov_8.216185	3161	3219	8	17	58	0.2931035
NODE_260_length_4498_cov_8.216185	4257	4314	0	57	57	1.0000000
NODE_263_length_4476_cov_29.825451	141	215	4	21	74	0.2837838
NODE_263_length_4476_cov_29.825451	141	215	8	43	74	0.5810811
NODE_263_length_4476_cov_29.825451	141	215	12	10	74	0.1351351
NODE_263_length_4476_cov_29.825451	1890	1970	88	1	80	0.0125000
NODE_263_length_4476_cov_29.825451	1890	1970	92	6	80	0.0750000
NODE_263_length_4476_cov_29.825451	1890	1970	94	10	80	0.1250000
NODE_263_length_4476_cov_29.825451	1890	1970	95	2	80	0.0250000
NODE_263_length_4476_cov_29.825451	1890	1970	96	5	80	0.0625000
NODE_263_length_4476_cov_29.825451	1890	1970	97	6	80	0.0750000
NODE_263_length_4476_cov_29.825451	1890	1970	98	2	80	0.0250000
NODE_263_length_4476_cov_29.825451	1890	1970	99	7	80	0.0875000
NODE_263_length_4476_cov_29.825451	1890	1970	100	3	80	0.0375000
NODE_263_length_4476_cov_29.825451	1890	1970	101	10	80	0.1250000
NODE_263_length_4476_cov_29.825451	1890	1970	102	6	80	0.0750000
NODE_263_length_4476_cov_29.825451	1890	1970	103	14	80	0.1750000
NODE_263_length_4476_cov_29.825451	1890	1970	104	3	80	0.0375000
NODE_263_length_4476_cov_29.825451	1890	1970	105	5	80	0.0625000
NODE_263_length_4476_cov_29.825451	1943	2023	56	4	80	0.0500000
NODE_263_length_4476_cov_29.825451	1943	2023	58	1	80	0.0125000
NODE_263_length_4476_cov_29.825451	1943	2023	62	1	80	0.0125000
NODE_263_length_4476_cov_29.825451	1943	2023	66	1	80	0.0125000
NODE_263_length_4476_cov_29.825451	1943	2023	70	1	80	0.0125000
NODE_263_length_4476_cov_29.825451	1943	2023	71	2	80	0.0250000
NODE_263_length_4476_cov_29.825451	1943	2023	72	1	80	0.0125000
NODE_263_length_4476_cov_29.825451	1943	2023	74	2	80	0.0250000
NODE_263_length_4476_cov_29.825451	1943	2023	76	8	80	0.1000000
NODE_263_length_4476_cov_29.825451	1943	2023	78	8	80	0.1000000
NODE_263_length_4476_cov_29.825451	1943	2023	88	6	80	0.0750000
NODE_263_length_4476_cov_29.825451	1943	2023	90	7	80	0.0875000
NODE_263_length_4476_cov_29.825451	1943	2023	91	5	80	0.0625000
NODE_263_length_4476_cov_29.825451	1943	2023	92	1	80	0.0125000
NODE_263_length_4476_cov_29.825451	1943	2023	93	1	80	0.0125000
NODE_263_length_4476_cov_29.825451	1943	2023	94	6	80	0.0750000
NODE_263_length_4476_cov_29.825451	1943	2023	95	6	80	0.0750000
NODE_263_length_4476_cov_29.825451	1943	2023	96	5	80	0.0625000
NODE_263_length_4476_cov_29.825451	1943	2023	97	5	80	0.0625000
NODE_263_length_4476_cov_29.825451	1943	2023	98	2	80	0.0250000
NODE_263_length_4476_cov_29.825451	1943	2023	99	2	80	0.0250000
NODE_263_length_4476_cov_29.825451	1943	2023	100	2	80	0.0250000
NODE_263_length_4476_cov_29.825451	1943	2023	101	3	80	0.0375000
NODE_264_length_4474_cov_17.051886	23	99	4	76	76	1.0000000
NODE_264_length_4474_cov_17.051886	23	98	4	75	75	1.0000000
NODE_264_length_4474_cov_17.051886	23	99	4	76	76	1.0000000
NODE_264_length_4474_cov_17.051886	32	99	4	67	67	1.0000000
NODE_264_length_4474_cov_17.051886	76	140	0	23	64	0.3593750
NODE_264_length_4474_cov_17.051886	76	140	4	41	64	0.6406250
NODE_264_length_4474_cov_17.051886	1528	1569	77	1	41	0.0243902
NODE_264_length_4474_cov_17.051886	1528	1569	82	2	41	0.0487805
NODE_264_length_4474_cov_17.051886	1528	1569	83	2	41	0.0487805
NODE_264_length_4474_cov_17.051886	1528	1569	85	3	41	0.0731707
NODE_264_length_4474_cov_17.051886	1528	1569	86	3	41	0.0731707
NODE_264_length_4474_cov_17.051886	1528	1569	98	1	41	0.0243902
NODE_264_length_4474_cov_17.051886	1528	1569	102	1	41	0.0243902
NODE_264_length_4474_cov_17.051886	1528	1569	106	2	41	0.0487805
NODE_264_length_4474_cov_17.051886	1528	1569	112	1	41	0.0243902
NODE_264_length_4474_cov_17.051886	1528	1569	115	1	41	0.0243902
NODE_264_length_4474_cov_17.051886	1528	1569	117	2	41	0.0487805
NODE_264_length_4474_cov_17.051886	1528	1569	125	1	41	0.0243902
NODE_264_length_4474_cov_17.051886	1528	1569	131	1	41	0.0243902
NODE_264_length_4474_cov_17.051886	1528	1569	133	1	41	0.0243902
NODE_264_length_4474_cov_17.051886	1528	1569	137	1	41	0.0243902
NODE_264_length_4474_cov_17.051886	1528	1569	142	1	41	0.0243902
NODE_264_length_4474_cov_17.051886	1528	1569	145	1	41	0.0243902
NODE_264_length_4474_cov_17.051886	1528	1569	149	1	41	0.0243902
NODE_264_length_4474_cov_17.051886	1528	1569	155	1	41	0.0243902
NODE_264_length_4474_cov_17.051886	1528	1569	159	1	41	0.0243902
NODE_264_length_4474_cov_17.051886	1528	1569	162	1	41	0.0243902
NODE_264_length_4474_cov_17.051886	1528	1569	164	1	41	0.0243902
NODE_264_length_4474_cov_17.051886	1528	1569	165	2	41	0.0487805
NODE_264_length_4474_cov_17.051886	1528	1569	166	2	41	0.0487805
NODE_264_length_4474_cov_17.051886	1528	1569	167	3	41	0.0731707
NODE_264_length_4474_cov_17.051886	1528	1569	168	1	41	0.0243902
NODE_264_length_4474_cov_17.051886	1528	1569	169	2	41	0.0487805
NODE_264_length_4474_cov_17.051886	1528	1569	172	1	41	0.0243902
NODE_264_length_4474_cov_17.051886	1536	1609	38	1	73	0.0136986
NODE_264_length_4474_cov_17.051886	1536	1609	40	1	73	0.0136986
NODE_264_length_4474_cov_17.051886	1536	1609	48	5	73	0.0684932
NODE_264_length_4474_cov_17.051886	1536	1609	52	7	73	0.0958904
NODE_264_length_4474_cov_17.051886	1536	1609	55	9	73	0.1232877
NODE_264_length_4474_cov_17.051886	1536	1609	57	1	73	0.0136986
NODE_264_length_4474_cov_17.051886	1536	1609	58	1	73	0.0136986
NODE_264_length_4474_cov_17.051886	1536	1609	60	1	73	0.0136986
NODE_264_length_4474_cov_17.051886	1536	1609	66	1	73	0.0136986
NODE_264_length_4474_cov_17.051886	1536	1609	67	1	73	0.0136986
NODE_264_length_4474_cov_17.051886	1536	1609	68	2	73	0.0273973
NODE_264_length_4474_cov_17.051886	1536	1609	69	4	73	0.0547945
NODE_264_length_4474_cov_17.051886	1536	1609	72	2	73	0.0273973
NODE_264_length_4474_cov_17.051886	1536	1609	77	5	73	0.0684932
NODE_264_length_4474_cov_17.051886	1536	1609	82	2	73	0.0273973
NODE_264_length_4474_cov_17.051886	1536	1609	83	2	73	0.0273973
NODE_264_length_4474_cov_17.051886	1536	1609	85	3	73	0.0410959
NODE_264_length_4474_cov_17.051886	1536	1609	86	3	73	0.0410959
NODE_264_length_4474_cov_17.051886	1536	1609	98	1	73	0.0136986
NODE_264_length_4474_cov_17.051886	1536	1609	102	1	73	0.0136986
NODE_264_length_4474_cov_17.051886	1536	1609	106	2	73	0.0273973
NODE_264_length_4474_cov_17.051886	1536	1609	112	1	73	0.0136986
NODE_264_length_4474_cov_17.051886	1536	1609	115	1	73	0.0136986
NODE_264_length_4474_cov_17.051886	1536	1609	117	2	73	0.0273973
NODE_264_length_4474_cov_17.051886	1536	1609	125	1	73	0.0136986
NODE_264_length_4474_cov_17.051886	1536	1609	131	1	73	0.0136986
NODE_264_length_4474_cov_17.051886	1536	1609	133	1	73	0.0136986
NODE_264_length_4474_cov_17.051886	1536	1609	137	1	73	0.0136986
NODE_264_length_4474_cov_17.051886	1536	1609	142	1	73	0.0136986
NODE_264_length_4474_cov_17.051886	1536	1609	145	1	73	0.0136986
NODE_264_length_4474_cov_17.051886	1536	1609	149	1	73	0.0136986
NODE_264_length_4474_cov_17.051886	1536	1609	155	1	73	0.0136986
NODE_264_length_4474_cov_17.051886	1536	1609	159	1	73	0.0136986
NODE_264_length_4474_cov_17.051886	1536	1609	162	1	73	0.0136986
NODE_264_length_4474_cov_17.051886	1536	1609	164	1	73	0.0136986
NODE_264_length_4474_cov_17.051886	1536	1609	165	2	73	0.0273973
NODE_264_length_4474_cov_17.051886	1536	1609	167	1	73	0.0136986
NODE_264_length_4474_cov_17.051886	1618	1643	0	18	25	0.7200000
NODE_264_length_4474_cov_17.051886	1618	1643	2	2	25	0.0800000
NODE_264_length_4474_cov_17.051886	1618	1643	10	1	25	0.0400000
NODE_264_length_4474_cov_17.051886	1618	1643	18	2	25	0.0800000
NODE_264_length_4474_cov_17.051886	1618	1643	22	1	25	0.0400000
NODE_264_length_4474_cov_17.051886	1618	1643	24	1	25	0.0400000
NODE_264_length_4474_cov_17.051886	1618	1696	0	71	78	0.9102564
NODE_264_length_4474_cov_17.051886	1618	1696	2	2	78	0.0256410
NODE_264_length_4474_cov_17.051886	1618	1696	10	1	78	0.0128205
NODE_264_length_4474_cov_17.051886	1618	1696	18	2	78	0.0256410
NODE_264_length_4474_cov_17.051886	1618	1696	22	1	78	0.0128205
NODE_264_length_4474_cov_17.051886	1618	1696	24	1	78	0.0128205
NODE_265_length_4474_cov_14.441829	282	362	0	80	80	1.0000000
NODE_265_length_4474_cov_14.441829	335	415	0	76	80	0.9500000
NODE_265_length_4474_cov_14.441829	335	415	12	1	80	0.0125000
NODE_265_length_4474_cov_14.441829	335	415	24	1	80	0.0125000
NODE_265_length_4474_cov_14.441829	335	415	45	1	80	0.0125000
NODE_265_length_4474_cov_14.441829	335	415	67	1	80	0.0125000
NODE_265_length_4474_cov_14.441829	1522	1575	0	6	53	0.1132075
NODE_265_length_4474_cov_14.441829	1522	1575	2	43	53	0.8113208
NODE_265_length_4474_cov_14.441829	1522	1575	23	2	53	0.0377358
NODE_265_length_4474_cov_14.441829	1522	1575	27	2	53	0.0377358
NODE_265_length_4474_cov_14.441829	1548	1623	0	6	75	0.0800000
NODE_265_length_4474_cov_14.441829	1548	1623	2	29	75	0.3866667
NODE_265_length_4474_cov_14.441829	1548	1623	4	14	75	0.1866667
NODE_265_length_4474_cov_14.441829	1548	1623	6	1	75	0.0133333
NODE_265_length_4474_cov_14.441829	1548	1623	10	2	75	0.0266667
NODE_265_length_4474_cov_14.441829	1548	1623	12	1	75	0.0133333
NODE_265_length_4474_cov_14.441829	1548	1623	14	4	75	0.0533333
NODE_265_length_4474_cov_14.441829	1548	1623	16	3	75	0.0400000
NODE_265_length_4474_cov_14.441829	1548	1623	18	7	75	0.0933333
NODE_265_length_4474_cov_14.441829	1548	1623	20	3	75	0.0400000
NODE_265_length_4474_cov_14.441829	1548	1623	24	4	75	0.0533333
NODE_265_length_4474_cov_14.441829	1548	1623	26	1	75	0.0133333
NODE_265_length_4474_cov_14.441829	3068	3121	4	5	53	0.0943396
NODE_265_length_4474_cov_14.441829	3068	3121	5	6	53	0.1132075
NODE_265_length_4474_cov_14.441829	3068	3121	6	2	53	0.0377358
NODE_265_length_4474_cov_14.441829	3068	3121	7	10	53	0.1886792
NODE_265_length_4474_cov_14.441829	3068	3121	8	2	53	0.0377358
NODE_265_length_4474_cov_14.441829	3068	3121	9	19	53	0.3584906
NODE_265_length_4474_cov_14.441829	3068	3121	11	9	53	0.1698113
NODE_268_length_4463_cov_7.023144	119	168	0	40	49	0.8163266
NODE_268_length_4463_cov_7.023144	119	168	2	1	49	0.0204082
NODE_268_length_4463_cov_7.023144	119	168	3	1	49	0.0204082
NODE_268_length_4463_cov_7.023144	119	168	6	3	49	0.0612245
NODE_268_length_4463_cov_7.023144	119	168	7	4	49	0.0816327
NODE_270_length_4453_cov_16.820395	3383	3463	112	1	80	0.0125000
NODE_270_length_4453_cov_16.820395	3383	3463	115	1	80	0.0125000
NODE_270_length_4453_cov_16.820395	3383	3463	119	1	80	0.0125000
NODE_270_length_4453_cov_16.820395	3383	3463	126	1	80	0.0125000
NODE_270_length_4453_cov_16.820395	3383	3463	132	1	80	0.0125000
NODE_270_length_4453_cov_16.820395	3383	3463	134	2	80	0.0250000
NODE_270_length_4453_cov_16.820395	3383	3463	140	1	80	0.0125000
NODE_270_length_4453_cov_16.820395	3383	3463	141	1	80	0.0125000
NODE_270_length_4453_cov_16.820395	3383	3463	145	2	80	0.0250000
NODE_270_length_4453_cov_16.820395	3383	3463	151	1	80	0.0125000
NODE_270_length_4453_cov_16.820395	3383	3463	154	1	80	0.0125000
NODE_270_length_4453_cov_16.820395	3383	3463	155	2	80	0.0250000
NODE_270_length_4453_cov_16.820395	3383	3463	157	1	80	0.0125000
NODE_270_length_4453_cov_16.820395	3383	3463	158	5	80	0.0625000
NODE_270_length_4453_cov_16.820395	3383	3463	160	4	80	0.0500000
NODE_270_length_4453_cov_16.820395	3383	3463	161	5	80	0.0625000
NODE_270_length_4453_cov_16.820395	3383	3463	163	3	80	0.0375000
NODE_270_length_4453_cov_16.820395	3383	3463	165	7	80	0.0875000
NODE_270_length_4453_cov_16.820395	3383	3463	167	1	80	0.0125000
NODE_270_length_4453_cov_16.820395	3383	3463	169	4	80	0.0500000
NODE_270_length_4453_cov_16.820395	3383	3463	171	3	80	0.0375000
NODE_270_length_4453_cov_16.820395	3383	3463	173	3	80	0.0375000
NODE_270_length_4453_cov_16.820395	3383	3463	175	3	80	0.0375000
NODE_270_length_4453_cov_16.820395	3383	3463	176	2	80	0.0250000
NODE_270_length_4453_cov_16.820395	3383	3463	177	1	80	0.0125000
NODE_270_length_4453_cov_16.820395	3383	3463	178	3	80	0.0375000
NODE_270_length_4453_cov_16.820395	3383	3463	180	1	80	0.0125000
NODE_270_length_4453_cov_16.820395	3383	3463	181	1	80	0.0125000
NODE_270_length_4453_cov_16.820395	3383	3463	182	4	80	0.0500000
NODE_270_length_4453_cov_16.820395	3383	3463	183	4	80	0.0500000
NODE_270_length_4453_cov_16.820395	3383	3463	184	2	80	0.0250000
NODE_270_length_4453_cov_16.820395	3383	3463	185	2	80	0.0250000
NODE_270_length_4453_cov_16.820395	3383	3463	186	2	80	0.0250000
NODE_270_length_4453_cov_16.820395	3383	3463	188	1	80	0.0125000
NODE_270_length_4453_cov_16.820395	3383	3463	190	1	80	0.0125000
NODE_270_length_4453_cov_16.820395	3383	3463	192	2	80	0.0250000
NODE_270_length_4453_cov_16.820395	3436	3496	59	1	60	0.0166667
NODE_270_length_4453_cov_16.820395	3436	3496	63	1	60	0.0166667
NODE_270_length_4453_cov_16.820395	3436	3496	66	1	60	0.0166667
NODE_270_length_4453_cov_16.820395	3436	3496	68	2	60	0.0333333
NODE_270_length_4453_cov_16.820395	3436	3496	70	1	60	0.0166667
NODE_270_length_4453_cov_16.820395	3436	3496	72	1	60	0.0166667
NODE_270_length_4453_cov_16.820395	3436	3496	74	1	60	0.0166667
NODE_270_length_4453_cov_16.820395	3436	3496	76	5	60	0.0833333
NODE_270_length_4453_cov_16.820395	3436	3496	79	3	60	0.0500000
NODE_270_length_4453_cov_16.820395	3436	3496	81	1	60	0.0166667
NODE_270_length_4453_cov_16.820395	3436	3496	85	3	60	0.0500000
NODE_270_length_4453_cov_16.820395	3436	3496	86	2	60	0.0333333
NODE_270_length_4453_cov_16.820395	3436	3496	90	1	60	0.0166667
NODE_270_length_4453_cov_16.820395	3436	3496	94	2	60	0.0333333
NODE_270_length_4453_cov_16.820395	3436	3496	97	1	60	0.0166667
NODE_270_length_4453_cov_16.820395	3436	3496	98	2	60	0.0333333
NODE_270_length_4453_cov_16.820395	3436	3496	100	4	60	0.0666667
NODE_270_length_4453_cov_16.820395	3436	3496	108	1	60	0.0166667
NODE_270_length_4453_cov_16.820395	3436	3496	112	1	60	0.0166667
NODE_270_length_4453_cov_16.820395	3436	3496	115	1	60	0.0166667
NODE_270_length_4453_cov_16.820395	3436	3496	119	1	60	0.0166667
NODE_270_length_4453_cov_16.820395	3436	3496	126	1	60	0.0166667
NODE_270_length_4453_cov_16.820395	3436	3496	132	1	60	0.0166667
NODE_270_length_4453_cov_16.820395	3436	3496	134	2	60	0.0333333
NODE_270_length_4453_cov_16.820395	3436	3496	140	1	60	0.0166667
NODE_270_length_4453_cov_16.820395	3436	3496	141	1	60	0.0166667
NODE_270_length_4453_cov_16.820395	3436	3496	145	2	60	0.0333333
NODE_270_length_4453_cov_16.820395	3436	3496	151	1	60	0.0166667
NODE_270_length_4453_cov_16.820395	3436	3496	154	1	60	0.0166667
NODE_270_length_4453_cov_16.820395	3436	3496	155	2	60	0.0333333
NODE_270_length_4453_cov_16.820395	3436	3496	157	1	60	0.0166667
NODE_270_length_4453_cov_16.820395	3436	3496	158	5	60	0.0833333
NODE_270_length_4453_cov_16.820395	3436	3496	160	4	60	0.0666667
NODE_270_length_4453_cov_16.820395	3436	3496	161	2	60	0.0333333
NODE_272_length_4436_cov_31.114595	2807	2871	22	5	64	0.0781250
NODE_272_length_4436_cov_31.114595	2807	2871	24	7	64	0.1093750
NODE_272_length_4436_cov_31.114595	2807	2871	26	5	64	0.0781250
NODE_272_length_4436_cov_31.114595	2807	2871	28	10	64	0.1562500
NODE_272_length_4436_cov_31.114595	2807	2871	30	1	64	0.0156250
NODE_272_length_4436_cov_31.114595	2807	2871	32	4	64	0.0625000
NODE_272_length_4436_cov_31.114595	2807	2871	34	1	64	0.0156250
NODE_272_length_4436_cov_31.114595	2807	2871	36	31	64	0.4843750
NODE_272_length_4436_cov_31.114595	2846	2906	1	7	60	0.1166667
NODE_272_length_4436_cov_31.114595	2846	2906	11	1	60	0.0166667
NODE_272_length_4436_cov_31.114595	2846	2906	13	1	60	0.0166667
NODE_272_length_4436_cov_31.114595	2846	2906	17	8	60	0.1333333
NODE_272_length_4436_cov_31.114595	2846	2906	18	12	60	0.2000000
NODE_272_length_4436_cov_31.114595	2846	2906	20	6	60	0.1000000
NODE_272_length_4436_cov_31.114595	2846	2906	22	5	60	0.0833333
NODE_272_length_4436_cov_31.114595	2846	2906	24	7	60	0.1166667
NODE_272_length_4436_cov_31.114595	2846	2906	26	5	60	0.0833333
NODE_272_length_4436_cov_31.114595	2846	2906	28	8	60	0.1333333
NODE_272_length_4436_cov_31.114595	2846	2898	13	1	52	0.0192308
NODE_272_length_4436_cov_31.114595	2846	2898	17	8	52	0.1538462
NODE_272_length_4436_cov_31.114595	2846	2898	18	12	52	0.2307692
NODE_272_length_4436_cov_31.114595	2846	2898	20	6	52	0.1153846
NODE_272_length_4436_cov_31.114595	2846	2898	22	5	52	0.0961538
NODE_272_length_4436_cov_31.114595	2846	2898	24	7	52	0.1346154
NODE_272_length_4436_cov_31.114595	2846	2898	26	5	52	0.0961538
NODE_272_length_4436_cov_31.114595	2846	2898	28	8	52	0.1538462
NODE_278_length_4391_cov_7.711323	66	141	4	75	75	1.0000000
NODE_278_length_4391_cov_7.711323	119	155	2	6	36	0.1666667
NODE_278_length_4391_cov_7.711323	119	155	4	30	36	0.8333333
NODE_279_length_4385_cov_6.067662	1556	1606	0	2	50	0.0400000
NODE_279_length_4385_cov_6.067662	1556	1606	2	1	50	0.0200000
NODE_279_length_4385_cov_6.067662	1556	1606	6	1	50	0.0200000
NODE_279_length_4385_cov_6.067662	1556	1606	14	23	50	0.4600000
NODE_279_length_4385_cov_6.067662	1556	1606	16	2	50	0.0400000
NODE_279_length_4385_cov_6.067662	1556	1606	18	1	50	0.0200000
NODE_279_length_4385_cov_6.067662	1556	1606	24	8	50	0.1600000
NODE_279_length_4385_cov_6.067662	1556	1606	25	3	50	0.0600000
NODE_279_length_4385_cov_6.067662	1556	1606	27	2	50	0.0400000
NODE_279_length_4385_cov_6.067662	1556	1606	29	5	50	0.1000000
NODE_279_length_4385_cov_6.067662	1556	1606	33	2	50	0.0400000
NODE_286_length_4331_cov_37.938800	1898	1978	18	33	80	0.4125000
NODE_286_length_4331_cov_37.938800	1898	1978	22	3	80	0.0375000
NODE_286_length_4331_cov_37.938800	1898	1978	23	1	80	0.0125000
NODE_286_length_4331_cov_37.938800	1898	1978	24	3	80	0.0375000
NODE_286_length_4331_cov_37.938800	1898	1978	26	15	80	0.1875000
NODE_286_length_4331_cov_37.938800	1898	1978	29	8	80	0.1000000
NODE_286_length_4331_cov_37.938800	1898	1978	32	2	80	0.0250000
NODE_286_length_4331_cov_37.938800	1898	1978	36	6	80	0.0750000
NODE_286_length_4331_cov_37.938800	1898	1978	38	1	80	0.0125000
NODE_286_length_4331_cov_37.938800	1898	1978	45	2	80	0.0250000
NODE_286_length_4331_cov_37.938800	1898	1978	46	2	80	0.0250000
NODE_286_length_4331_cov_37.938800	1898	1978	47	1	80	0.0125000
NODE_286_length_4331_cov_37.938800	1898	1978	48	3	80	0.0375000
NODE_286_length_4331_cov_37.938800	1951	2031	24	1	80	0.0125000
NODE_286_length_4331_cov_37.938800	1951	2031	26	1	80	0.0125000
NODE_286_length_4331_cov_37.938800	1951	2031	29	8	80	0.1000000
NODE_286_length_4331_cov_37.938800	1951	2031	32	2	80	0.0250000
NODE_286_length_4331_cov_37.938800	1951	2031	36	6	80	0.0750000
NODE_286_length_4331_cov_37.938800	1951	2031	38	1	80	0.0125000
NODE_286_length_4331_cov_37.938800	1951	2031	45	2	80	0.0250000
NODE_286_length_4331_cov_37.938800	1951	2031	46	2	80	0.0250000
NODE_286_length_4331_cov_37.938800	1951	2031	47	13	80	0.1625000
NODE_286_length_4331_cov_37.938800	1951	2031	48	7	80	0.0875000
NODE_286_length_4331_cov_37.938800	1951	2031	49	4	80	0.0500000
NODE_286_length_4331_cov_37.938800	1951	2031	50	1	80	0.0125000
NODE_286_length_4331_cov_37.938800	1951	2031	51	17	80	0.2125000
NODE_286_length_4331_cov_37.938800	1951	2031	54	1	80	0.0125000
NODE_286_length_4331_cov_37.938800	1951	2031	55	2	80	0.0250000
NODE_286_length_4331_cov_37.938800	1951	2031	56	1	80	0.0125000
NODE_286_length_4331_cov_37.938800	1951	2031	57	7	80	0.0875000
NODE_286_length_4331_cov_37.938800	1951	2031	65	2	80	0.0250000
NODE_286_length_4331_cov_37.938800	1951	2031	73	2	80	0.0250000
NODE_286_length_4331_cov_37.938800	2027	2107	65	2	80	0.0250000
NODE_286_length_4331_cov_37.938800	2027	2107	73	4	80	0.0500000
NODE_286_length_4331_cov_37.938800	2027	2107	75	12	80	0.1500000
NODE_286_length_4331_cov_37.938800	2027	2107	78	1	80	0.0125000
NODE_286_length_4331_cov_37.938800	2027	2107	84	5	80	0.0625000
NODE_286_length_4331_cov_37.938800	2027	2107	85	1	80	0.0125000
NODE_286_length_4331_cov_37.938800	2027	2107	92	1	80	0.0125000
NODE_286_length_4331_cov_37.938800	2027	2107	98	1	80	0.0125000
NODE_286_length_4331_cov_37.938800	2027	2107	100	1	80	0.0125000
NODE_286_length_4331_cov_37.938800	2027	2107	101	1	80	0.0125000
NODE_286_length_4331_cov_37.938800	2027	2107	116	1	80	0.0125000
NODE_286_length_4331_cov_37.938800	2027	2107	128	1	80	0.0125000
NODE_286_length_4331_cov_37.938800	2027	2107	129	1	80	0.0125000
NODE_286_length_4331_cov_37.938800	2027	2107	130	4	80	0.0500000
NODE_286_length_4331_cov_37.938800	2027	2107	131	1	80	0.0125000
NODE_286_length_4331_cov_37.938800	2027	2107	132	1	80	0.0125000
NODE_286_length_4331_cov_37.938800	2027	2107	149	1	80	0.0125000
NODE_286_length_4331_cov_37.938800	2027	2107	157	7	80	0.0875000
NODE_286_length_4331_cov_37.938800	2027	2107	163	1	80	0.0125000
NODE_286_length_4331_cov_37.938800	2027	2107	171	1	80	0.0125000
NODE_286_length_4331_cov_37.938800	2027	2107	172	3	80	0.0375000
NODE_286_length_4331_cov_37.938800	2027	2107	205	1	80	0.0125000
NODE_286_length_4331_cov_37.938800	2027	2107	208	2	80	0.0250000
NODE_286_length_4331_cov_37.938800	2027	2107	230	1	80	0.0125000
NODE_286_length_4331_cov_37.938800	2027	2107	235	2	80	0.0250000
NODE_286_length_4331_cov_37.938800	2027	2107	236	2	80	0.0250000
NODE_286_length_4331_cov_37.938800	2027	2107	237	1	80	0.0125000
NODE_286_length_4331_cov_37.938800	2027	2107	238	1	80	0.0125000
NODE_286_length_4331_cov_37.938800	2027	2107	239	4	80	0.0500000
NODE_286_length_4331_cov_37.938800	2027	2107	240	1	80	0.0125000
NODE_286_length_4331_cov_37.938800	2027	2107	241	6	80	0.0750000
NODE_286_length_4331_cov_37.938800	2027	2107	247	6	80	0.0750000
NODE_286_length_4331_cov_37.938800	2027	2107	249	2	80	0.0250000
NODE_286_length_4331_cov_37.938800	2080	2160	169	3	80	0.0375000
NODE_286_length_4331_cov_37.938800	2080	2160	171	1	80	0.0125000
NODE_286_length_4331_cov_37.938800	2080	2160	183	1	80	0.0125000
NODE_286_length_4331_cov_37.938800	2080	2160	185	3	80	0.0375000
NODE_286_length_4331_cov_37.938800	2080	2160	187	2	80	0.0250000
NODE_286_length_4331_cov_37.938800	2080	2160	195	2	80	0.0250000
NODE_286_length_4331_cov_37.938800	2080	2160	203	1	80	0.0125000
NODE_286_length_4331_cov_37.938800	2080	2160	208	1	80	0.0125000
NODE_286_length_4331_cov_37.938800	2080	2160	217	3	80	0.0375000
NODE_286_length_4331_cov_37.938800	2080	2160	220	10	80	0.1250000
NODE_286_length_4331_cov_37.938800	2080	2160	221	1	80	0.0125000
NODE_286_length_4331_cov_37.938800	2080	2160	222	9	80	0.1125000
NODE_286_length_4331_cov_37.938800	2080	2160	226	1	80	0.0125000
NODE_286_length_4331_cov_37.938800	2080	2160	227	5	80	0.0625000
NODE_286_length_4331_cov_37.938800	2080	2160	228	11	80	0.1375000
NODE_286_length_4331_cov_37.938800	2080	2160	230	1	80	0.0125000
NODE_286_length_4331_cov_37.938800	2080	2160	235	2	80	0.0250000
NODE_286_length_4331_cov_37.938800	2080	2160	236	2	80	0.0250000
NODE_286_length_4331_cov_37.938800	2080	2160	237	1	80	0.0125000
NODE_286_length_4331_cov_37.938800	2080	2160	238	1	80	0.0125000
NODE_286_length_4331_cov_37.938800	2080	2160	239	4	80	0.0500000
NODE_286_length_4331_cov_37.938800	2080	2160	240	1	80	0.0125000
NODE_286_length_4331_cov_37.938800	2080	2160	241	6	80	0.0750000
NODE_286_length_4331_cov_37.938800	2080	2160	247	6	80	0.0750000
NODE_286_length_4331_cov_37.938800	2080	2160	249	2	80	0.0250000
NODE_289_length_4320_cov_7.680881	442	522	2	57	80	0.7125000
NODE_289_length_4320_cov_7.680881	442	522	4	23	80	0.2875000
NODE_289_length_4320_cov_7.680881	495	575	0	16	80	0.2000000
NODE_289_length_4320_cov_7.680881	495	575	2	64	80	0.8000000
NODE_289_length_4320_cov_7.680881	571	651	0	80	80	1.0000000
NODE_289_length_4320_cov_7.680881	624	704	0	76	80	0.9500000
NODE_289_length_4320_cov_7.680881	624	704	2	4	80	0.0500000
NODE_290_length_4314_cov_5.311507	1436	1516	0	20	80	0.2500000
NODE_290_length_4314_cov_5.311507	1436	1516	2	60	80	0.7500000
NODE_290_length_4314_cov_5.311507	1489	1569	0	50	80	0.6250000
NODE_290_length_4314_cov_5.311507	1489	1569	1	1	80	0.0125000
NODE_290_length_4314_cov_5.311507	1489	1569	2	29	80	0.3625000
NODE_290_length_4314_cov_5.311507	3331	3400	0	47	69	0.6811594
NODE_290_length_4314_cov_5.311507	3331	3400	2	22	69	0.3188406
NODE_290_length_4314_cov_5.311507	3420	3482	6	5	62	0.0806452
NODE_290_length_4314_cov_5.311507	3420	3482	7	3	62	0.0483871
NODE_290_length_4314_cov_5.311507	3420	3482	17	1	62	0.0161290
NODE_290_length_4314_cov_5.311507	3420	3482	18	7	62	0.1129032
NODE_290_length_4314_cov_5.311507	3420	3482	19	17	62	0.2741936
NODE_290_length_4314_cov_5.311507	3420	3482	20	2	62	0.0322581
NODE_290_length_4314_cov_5.311507	3420	3482	21	27	62	0.4354839
NODE_292_length_4311_cov_8.733381	92	171	22	5	79	0.0632911
NODE_292_length_4311_cov_8.733381	92	171	24	2	79	0.0253165
NODE_292_length_4311_cov_8.733381	92	171	26	4	79	0.0506329
NODE_292_length_4311_cov_8.733381	92	171	28	3	79	0.0379747
NODE_292_length_4311_cov_8.733381	92	171	30	15	79	0.1898734
NODE_292_length_4311_cov_8.733381	92	171	32	8	79	0.1012658
NODE_292_length_4311_cov_8.733381	92	171	34	40	79	0.5063291
NODE_292_length_4311_cov_8.733381	92	171	36	2	79	0.0253165
NODE_292_length_4311_cov_8.733381	1925	2005	0	10	80	0.1250000
NODE_292_length_4311_cov_8.733381	1925	2005	8	19	80	0.2375000
NODE_292_length_4311_cov_8.733381	1925	2005	10	51	80	0.6375000
NODE_292_length_4311_cov_8.733381	1978	2058	2	15	80	0.1875000
NODE_292_length_4311_cov_8.733381	1978	2058	8	28	80	0.3500000
NODE_292_length_4311_cov_8.733381	1978	2058	10	37	80	0.4625000
NODE_294_length_4293_cov_3.809251	244	326	0	82	82	1.0000000
NODE_294_length_4293_cov_3.809251	301	394	0	60	93	0.6451613
NODE_294_length_4293_cov_3.809251	301	394	2	33	93	0.3548387
NODE_295_length_4284_cov_15.940263	3726	3806	0	80	80	1.0000000
NODE_295_length_4284_cov_15.940263	3779	3858	0	79	79	1.0000000
NODE_299_length_4277_cov_5.451173	3818	3898	4	39	80	0.4875000
NODE_299_length_4277_cov_5.451173	3818	3898	8	22	80	0.2750000
NODE_299_length_4277_cov_5.451173	3818	3898	9	4	80	0.0500000
NODE_299_length_4277_cov_5.451173	3818	3898	10	15	80	0.1875000
NODE_299_length_4277_cov_5.451173	3927	3995	5	17	68	0.2500000
NODE_299_length_4277_cov_5.451173	3927	3995	9	7	68	0.1029412
NODE_299_length_4277_cov_5.451173	3927	3995	11	22	68	0.3235294
NODE_299_length_4277_cov_5.451173	3927	3995	13	22	68	0.3235294
NODE_299_length_4277_cov_5.451173	3968	4048	0	4	80	0.0500000
NODE_299_length_4277_cov_5.451173	3968	4048	1	43	80	0.5375000
NODE_299_length_4277_cov_5.451173	3968	4048	5	23	80	0.2875000
NODE_299_length_4277_cov_5.451173	3968	4048	9	7	80	0.0875000
NODE_299_length_4277_cov_5.451173	3968	4048	11	3	80	0.0375000
NODE_300_length_4274_cov_18.943234	591	671	0	31	80	0.3875000
NODE_300_length_4274_cov_18.943234	591	671	1	36	80	0.4500000
NODE_300_length_4274_cov_18.943234	591	671	5	13	80	0.1625000
NODE_300_length_4274_cov_18.943234	644	724	0	80	80	1.0000000
NODE_301_length_4274_cov_16.160958	416	496	2	63	80	0.7875000
NODE_301_length_4274_cov_16.160958	416	496	4	17	80	0.2125000
NODE_301_length_4274_cov_16.160958	1034	1114	1	80	80	1.0000000
NODE_301_length_4274_cov_16.160958	1087	1167	0	22	80	0.2750000
NODE_301_length_4274_cov_16.160958	1087	1167	1	58	80	0.7250000
NODE_301_length_4274_cov_16.160958	1163	1243	1	80	80	1.0000000
NODE_301_length_4274_cov_16.160958	1216	1296	0	9	80	0.1125000
NODE_301_length_4274_cov_16.160958	1216	1296	1	71	80	0.8875000
NODE_301_length_4274_cov_16.160958	3411	3491	0	8	80	0.1000000
NODE_301_length_4274_cov_16.160958	3411	3491	1	5	80	0.0625000
NODE_301_length_4274_cov_16.160958	3411	3491	2	4	80	0.0500000
NODE_301_length_4274_cov_16.160958	3411	3491	6	40	80	0.5000000
NODE_301_length_4274_cov_16.160958	3411	3491	8	19	80	0.2375000
NODE_301_length_4274_cov_16.160958	3411	3491	12	2	80	0.0250000
NODE_301_length_4274_cov_16.160958	3411	3491	15	1	80	0.0125000
NODE_301_length_4274_cov_16.160958	3411	3491	16	1	80	0.0125000
NODE_302_length_4270_cov_14.045792	3835	3915	197	1	80	0.0125000
NODE_302_length_4270_cov_14.045792	3835	3915	201	1	80	0.0125000
NODE_302_length_4270_cov_14.045792	3835	3915	203	1	80	0.0125000
NODE_302_length_4270_cov_14.045792	3835	3915	205	1	80	0.0125000
NODE_302_length_4270_cov_14.045792	3835	3915	209	1	80	0.0125000
NODE_302_length_4270_cov_14.045792	3835	3915	211	2	80	0.0250000
NODE_302_length_4270_cov_14.045792	3835	3915	216	1	80	0.0125000
NODE_302_length_4270_cov_14.045792	3835	3915	218	1	80	0.0125000
NODE_302_length_4270_cov_14.045792	3835	3915	222	1	80	0.0125000
NODE_302_length_4270_cov_14.045792	3835	3915	228	1	80	0.0125000
NODE_302_length_4270_cov_14.045792	3835	3915	230	2	80	0.0250000
NODE_302_length_4270_cov_14.045792	3835	3915	231	3	80	0.0375000
NODE_302_length_4270_cov_14.045792	3835	3915	232	1	80	0.0125000
NODE_302_length_4270_cov_14.045792	3835	3915	233	2	80	0.0250000
NODE_302_length_4270_cov_14.045792	3835	3915	235	1	80	0.0125000
NODE_302_length_4270_cov_14.045792	3835	3915	236	1	80	0.0125000
NODE_302_length_4270_cov_14.045792	3835	3915	240	1	80	0.0125000
NODE_302_length_4270_cov_14.045792	3835	3915	244	2	80	0.0250000
NODE_302_length_4270_cov_14.045792	3835	3915	245	2	80	0.0250000
NODE_302_length_4270_cov_14.045792	3835	3915	249	1	80	0.0125000
NODE_302_length_4270_cov_14.045792	3835	3915	254	1	80	0.0125000
NODE_302_length_4270_cov_14.045792	3835	3915	255	4	80	0.0500000
NODE_302_length_4270_cov_14.045792	3835	3915	256	1	80	0.0125000
NODE_302_length_4270_cov_14.045792	3835	3915	259	4	80	0.0500000
NODE_302_length_4270_cov_14.045792	3835	3915	260	1	80	0.0125000
NODE_302_length_4270_cov_14.045792	3835	3915	261	3	80	0.0375000
NODE_302_length_4270_cov_14.045792	3835	3915	265	6	80	0.0750000
NODE_302_length_4270_cov_14.045792	3835	3915	267	2	80	0.0250000
NODE_302_length_4270_cov_14.045792	3835	3915	268	1	80	0.0125000
NODE_302_length_4270_cov_14.045792	3835	3915	269	1	80	0.0125000
NODE_302_length_4270_cov_14.045792	3835	3915	271	3	80	0.0375000
NODE_302_length_4270_cov_14.045792	3835	3915	272	1	80	0.0125000
NODE_302_length_4270_cov_14.045792	3835	3915	273	1	80	0.0125000
NODE_302_length_4270_cov_14.045792	3835	3915	274	1	80	0.0125000
NODE_302_length_4270_cov_14.045792	3835	3915	275	2	80	0.0250000
NODE_302_length_4270_cov_14.045792	3835	3915	276	2	80	0.0250000
NODE_302_length_4270_cov_14.045792	3835	3915	277	1	80	0.0125000
NODE_302_length_4270_cov_14.045792	3835	3915	278	5	80	0.0625000
NODE_302_length_4270_cov_14.045792	3835	3915	280	1	80	0.0125000
NODE_302_length_4270_cov_14.045792	3835	3915	281	4	80	0.0500000
NODE_302_length_4270_cov_14.045792	3835	3915	282	2	80	0.0250000
NODE_302_length_4270_cov_14.045792	3835	3915	283	5	80	0.0625000
NODE_302_length_4270_cov_14.045792	3835	3915	284	1	80	0.0125000
NODE_302_length_4270_cov_14.045792	3888	3968	234	3	80	0.0375000
NODE_302_length_4270_cov_14.045792	3888	3968	235	2	80	0.0250000
NODE_302_length_4270_cov_14.045792	3888	3968	236	1	80	0.0125000
NODE_302_length_4270_cov_14.045792	3888	3968	237	3	80	0.0375000
NODE_302_length_4270_cov_14.045792	3888	3968	239	3	80	0.0375000
NODE_302_length_4270_cov_14.045792	3888	3968	240	3	80	0.0375000
NODE_302_length_4270_cov_14.045792	3888	3968	241	2	80	0.0250000
NODE_302_length_4270_cov_14.045792	3888	3968	242	5	80	0.0625000
NODE_302_length_4270_cov_14.045792	3888	3968	243	2	80	0.0250000
NODE_302_length_4270_cov_14.045792	3888	3968	244	4	80	0.0500000
NODE_302_length_4270_cov_14.045792	3888	3968	245	5	80	0.0625000
NODE_302_length_4270_cov_14.045792	3888	3968	246	5	80	0.0625000
NODE_302_length_4270_cov_14.045792	3888	3968	247	3	80	0.0375000
NODE_302_length_4270_cov_14.045792	3888	3968	249	3	80	0.0375000
NODE_302_length_4270_cov_14.045792	3888	3968	253	1	80	0.0125000
NODE_302_length_4270_cov_14.045792	3888	3968	255	1	80	0.0125000
NODE_302_length_4270_cov_14.045792	3888	3968	262	1	80	0.0125000
NODE_302_length_4270_cov_14.045792	3888	3968	264	1	80	0.0125000
NODE_302_length_4270_cov_14.045792	3888	3968	266	1	80	0.0125000
NODE_302_length_4270_cov_14.045792	3888	3968	268	1	80	0.0125000
NODE_302_length_4270_cov_14.045792	3888	3968	271	3	80	0.0375000
NODE_302_length_4270_cov_14.045792	3888	3968	272	2	80	0.0250000
NODE_302_length_4270_cov_14.045792	3888	3968	275	2	80	0.0250000
NODE_302_length_4270_cov_14.045792	3888	3968	276	2	80	0.0250000
NODE_302_length_4270_cov_14.045792	3888	3968	277	1	80	0.0125000
NODE_302_length_4270_cov_14.045792	3888	3968	278	5	80	0.0625000
NODE_302_length_4270_cov_14.045792	3888	3968	280	2	80	0.0250000
NODE_302_length_4270_cov_14.045792	3888	3968	281	4	80	0.0500000
NODE_302_length_4270_cov_14.045792	3888	3968	282	3	80	0.0375000
NODE_302_length_4270_cov_14.045792	3888	3968	283	5	80	0.0625000
NODE_302_length_4270_cov_14.045792	3888	3968	284	1	80	0.0125000
NODE_303_length_4260_cov_24.780822	244	311	7	2	67	0.0298507
NODE_303_length_4260_cov_24.780822	244	311	9	10	67	0.1492537
NODE_303_length_4260_cov_24.780822	244	311	25	2	67	0.0298507
NODE_303_length_4260_cov_24.780822	244	311	32	4	67	0.0597015
NODE_303_length_4260_cov_24.780822	244	311	34	11	67	0.1641791
NODE_303_length_4260_cov_24.780822	244	311	35	2	67	0.0298507
NODE_303_length_4260_cov_24.780822	244	311	42	12	67	0.1791045
NODE_303_length_4260_cov_24.780822	244	311	44	24	67	0.3582090
NODE_303_length_4260_cov_24.780822	244	311	7	2	67	0.0298507
NODE_303_length_4260_cov_24.780822	244	311	9	10	67	0.1492537
NODE_303_length_4260_cov_24.780822	244	311	25	2	67	0.0298507
NODE_303_length_4260_cov_24.780822	244	311	32	4	67	0.0597015
NODE_303_length_4260_cov_24.780822	244	311	34	11	67	0.1641791
NODE_303_length_4260_cov_24.780822	244	311	35	2	67	0.0298507
NODE_303_length_4260_cov_24.780822	244	311	42	12	67	0.1791045
NODE_303_length_4260_cov_24.780822	244	311	44	24	67	0.3582090
NODE_303_length_4260_cov_24.780822	263	311	7	2	48	0.0416667
NODE_303_length_4260_cov_24.780822	263	311	9	10	48	0.2083333
NODE_303_length_4260_cov_24.780822	263	311	25	2	48	0.0416667
NODE_303_length_4260_cov_24.780822	263	311	32	4	48	0.0833333
NODE_303_length_4260_cov_24.780822	263	311	34	11	48	0.2291667
NODE_303_length_4260_cov_24.780822	263	311	35	2	48	0.0416667
NODE_303_length_4260_cov_24.780822	263	311	42	12	48	0.2500000
NODE_303_length_4260_cov_24.780822	263	311	44	5	48	0.1041667
NODE_303_length_4260_cov_24.780822	1605	1633	0	7	28	0.2500000
NODE_303_length_4260_cov_24.780822	1605	1633	2	15	28	0.5357143
NODE_303_length_4260_cov_24.780822	1605	1633	4	3	28	0.1071429
NODE_303_length_4260_cov_24.780822	1605	1633	6	2	28	0.0714286
NODE_303_length_4260_cov_24.780822	1605	1633	18	1	28	0.0357143
NODE_303_length_4260_cov_24.780822	1660	1699	29	3	39	0.0769231
NODE_303_length_4260_cov_24.780822	1660	1699	31	6	39	0.1538462
NODE_303_length_4260_cov_24.780822	1660	1699	33	1	39	0.0256410
NODE_303_length_4260_cov_24.780822	1660	1699	34	1	39	0.0256410
NODE_303_length_4260_cov_24.780822	1660	1699	36	1	39	0.0256410
NODE_303_length_4260_cov_24.780822	1660	1699	37	5	39	0.1282051
NODE_303_length_4260_cov_24.780822	1660	1699	39	2	39	0.0512821
NODE_303_length_4260_cov_24.780822	1660	1699	43	1	39	0.0256410
NODE_303_length_4260_cov_24.780822	1660	1699	46	1	39	0.0256410
NODE_303_length_4260_cov_24.780822	1660	1699	48	2	39	0.0512821
NODE_303_length_4260_cov_24.780822	1660	1699	50	2	39	0.0512821
NODE_303_length_4260_cov_24.780822	1660	1699	52	1	39	0.0256410
NODE_303_length_4260_cov_24.780822	1660	1699	55	1	39	0.0256410
NODE_303_length_4260_cov_24.780822	1660	1699	57	4	39	0.1025641
NODE_303_length_4260_cov_24.780822	1660	1699	60	1	39	0.0256410
NODE_303_length_4260_cov_24.780822	1660	1699	65	2	39	0.0512821
NODE_303_length_4260_cov_24.780822	1660	1699	66	3	39	0.0769231
NODE_303_length_4260_cov_24.780822	1660	1699	70	2	39	0.0512821
NODE_310_length_4207_cov_6.923564	3664	3722	9	2	58	0.0344828
NODE_310_length_4207_cov_6.923564	3664	3722	11	1	58	0.0172414
NODE_310_length_4207_cov_6.923564	3664	3722	13	7	58	0.1206897
NODE_310_length_4207_cov_6.923564	3664	3722	15	4	58	0.0689655
NODE_310_length_4207_cov_6.923564	3664	3722	17	16	58	0.2758621
NODE_310_length_4207_cov_6.923564	3664	3722	18	23	58	0.3965517
NODE_310_length_4207_cov_6.923564	3664	3722	20	5	58	0.0862069
NODE_310_length_4207_cov_6.923564	3695	3775	5	11	80	0.1375000
NODE_310_length_4207_cov_6.923564	3695	3775	6	18	80	0.2250000
NODE_310_length_4207_cov_6.923564	3695	3775	7	4	80	0.0500000
NODE_310_length_4207_cov_6.923564	3695	3775	9	20	80	0.2500000
NODE_310_length_4207_cov_6.923564	3695	3775	11	3	80	0.0375000
NODE_310_length_4207_cov_6.923564	3695	3775	13	7	80	0.0875000
NODE_310_length_4207_cov_6.923564	3695	3775	15	4	80	0.0500000
NODE_310_length_4207_cov_6.923564	3695	3775	17	13	80	0.1625000
NODE_311_length_4205_cov_6.121042	592	632	0	40	40	1.0000000
NODE_311_length_4205_cov_6.121042	605	685	0	80	80	1.0000000
NODE_311_length_4205_cov_6.121042	681	745	0	64	64	1.0000000
NODE_312_length_4196_cov_4.170857	340	420	0	18	80	0.2250000
NODE_312_length_4196_cov_4.170857	340	420	4	62	80	0.7750000
NODE_312_length_4196_cov_4.170857	393	473	0	71	80	0.8875000
NODE_312_length_4196_cov_4.170857	393	473	4	9	80	0.1125000
NODE_316_length_4179_cov_6.655882	1	65	2	1	64	0.0156250
NODE_316_length_4179_cov_6.655882	1	65	4	1	64	0.0156250
NODE_316_length_4179_cov_6.655882	1	65	6	2	64	0.0312500
NODE_316_length_4179_cov_6.655882	1	65	10	1	64	0.0156250
NODE_316_length_4179_cov_6.655882	1	65	14	1	64	0.0156250
NODE_316_length_4179_cov_6.655882	1	65	16	6	64	0.0937500
NODE_316_length_4179_cov_6.655882	1	65	22	13	64	0.2031250
NODE_316_length_4179_cov_6.655882	1	65	23	1	64	0.0156250
NODE_316_length_4179_cov_6.655882	1	65	24	9	64	0.1406250
NODE_316_length_4179_cov_6.655882	1	65	26	1	64	0.0156250
NODE_316_length_4179_cov_6.655882	1	65	28	28	64	0.4375000
NODE_316_length_4179_cov_6.655882	1087	1140	0	53	53	1.0000000
NODE_316_length_4179_cov_6.655882	1818	1898	0	22	80	0.2750000
NODE_316_length_4179_cov_6.655882	1818	1898	2	58	80	0.7250000
NODE_319_length_4150_cov_10.600099	2827	2849	18	22	22	1.0000000
NODE_319_length_4150_cov_10.600099	2973	3053	2	12	80	0.1500000
NODE_319_length_4150_cov_10.600099	2973	3053	6	11	80	0.1375000
NODE_319_length_4150_cov_10.600099	2973	3053	8	33	80	0.4125000
NODE_319_length_4150_cov_10.600099	2973	3053	10	24	80	0.3000000
NODE_319_length_4150_cov_10.600099	3026	3106	2	14	80	0.1750000
NODE_319_length_4150_cov_10.600099	3026	3106	4	20	80	0.2500000
NODE_319_length_4150_cov_10.600099	3026	3106	6	16	80	0.2000000
NODE_319_length_4150_cov_10.600099	3026	3106	8	3	80	0.0375000
NODE_319_length_4150_cov_10.600099	3026	3106	10	27	80	0.3375000
NODE_324_length_4119_cov_27.984328	2818	2898	104	1	80	0.0125000
NODE_324_length_4119_cov_27.984328	2818	2898	106	1	80	0.0125000
NODE_324_length_4119_cov_27.984328	2818	2898	110	1	80	0.0125000
NODE_324_length_4119_cov_27.984328	2818	2898	111	1	80	0.0125000
NODE_324_length_4119_cov_27.984328	2818	2898	115	3	80	0.0375000
NODE_324_length_4119_cov_27.984328	2818	2898	117	4	80	0.0500000
NODE_324_length_4119_cov_27.984328	2818	2898	119	2	80	0.0250000
NODE_324_length_4119_cov_27.984328	2818	2898	121	1	80	0.0125000
NODE_324_length_4119_cov_27.984328	2818	2898	125	1	80	0.0125000
NODE_324_length_4119_cov_27.984328	2818	2898	127	1	80	0.0125000
NODE_324_length_4119_cov_27.984328	2818	2898	129	1	80	0.0125000
NODE_324_length_4119_cov_27.984328	2818	2898	130	1	80	0.0125000
NODE_324_length_4119_cov_27.984328	2818	2898	131	1	80	0.0125000
NODE_324_length_4119_cov_27.984328	2818	2898	132	1	80	0.0125000
NODE_324_length_4119_cov_27.984328	2818	2898	136	2	80	0.0250000
NODE_324_length_4119_cov_27.984328	2818	2898	138	2	80	0.0250000
NODE_324_length_4119_cov_27.984328	2818	2898	140	3	80	0.0375000
NODE_324_length_4119_cov_27.984328	2818	2898	144	2	80	0.0250000
NODE_324_length_4119_cov_27.984328	2818	2898	146	4	80	0.0500000
NODE_324_length_4119_cov_27.984328	2818	2898	147	4	80	0.0500000
NODE_324_length_4119_cov_27.984328	2818	2898	148	3	80	0.0375000
NODE_324_length_4119_cov_27.984328	2818	2898	149	19	80	0.2375000
NODE_324_length_4119_cov_27.984328	2818	2898	150	5	80	0.0625000
NODE_324_length_4119_cov_27.984328	2818	2898	151	5	80	0.0625000
NODE_324_length_4119_cov_27.984328	2818	2898	152	2	80	0.0250000
NODE_324_length_4119_cov_27.984328	2818	2898	153	2	80	0.0250000
NODE_324_length_4119_cov_27.984328	2818	2898	154	5	80	0.0625000
NODE_324_length_4119_cov_27.984328	2818	2898	155	1	80	0.0125000
NODE_324_length_4119_cov_27.984328	2818	2898	157	1	80	0.0125000
NODE_325_length_4108_cov_14.755550	378	422	2	10	44	0.2272727
NODE_325_length_4108_cov_14.755550	378	422	4	17	44	0.3863636
NODE_325_length_4108_cov_14.755550	378	422	6	17	44	0.3863636
NODE_325_length_4108_cov_14.755550	3537	3617	0	55	80	0.6875000
NODE_325_length_4108_cov_14.755550	3537	3617	2	10	80	0.1250000
NODE_325_length_4108_cov_14.755550	3537	3617	4	15	80	0.1875000
NODE_325_length_4108_cov_14.755550	3590	3670	0	2	80	0.0250000
NODE_325_length_4108_cov_14.755550	3590	3670	2	10	80	0.1250000
NODE_325_length_4108_cov_14.755550	3590	3670	4	68	80	0.8500000
NODE_326_length_4107_cov_1.855539	207	287	0	60	80	0.7500000
NODE_326_length_4107_cov_1.855539	207	287	4	20	80	0.2500000
NODE_328_length_4096_cov_31.197648	379	459	2	14	80	0.1750000
NODE_328_length_4096_cov_31.197648	379	459	4	47	80	0.5875000
NODE_328_length_4096_cov_31.197648	379	459	6	19	80	0.2375000
NODE_328_length_4096_cov_31.197648	432	512	2	9	80	0.1125000
NODE_328_length_4096_cov_31.197648	432	512	4	21	80	0.2625000
NODE_328_length_4096_cov_31.197648	432	512	6	50	80	0.6250000
NODE_328_length_4096_cov_31.197648	3305	3385	0	80	80	1.0000000
NODE_328_length_4096_cov_31.197648	3358	3438	0	80	80	1.0000000
NODE_329_length_4081_cov_20.248870	3673	3753	2	13	80	0.1625000
NODE_329_length_4081_cov_20.248870	3673	3753	4	16	80	0.2000000
NODE_329_length_4081_cov_20.248870	3673	3753	6	51	80	0.6375000
NODE_329_length_4081_cov_20.248870	3726	3806	0	44	80	0.5500000
NODE_329_length_4081_cov_20.248870	3726	3806	4	25	80	0.3125000
NODE_329_length_4081_cov_20.248870	3726	3806	6	11	80	0.1375000
NODE_330_length_4076_cov_15.138044	1062	1142	0	21	80	0.2625000
NODE_330_length_4076_cov_15.138044	1062	1142	2	59	80	0.7375000
NODE_330_length_4076_cov_15.138044	1115	1195	0	44	80	0.5500000
NODE_330_length_4076_cov_15.138044	1115	1195	2	36	80	0.4500000
NODE_331_length_4069_cov_14.261209	3871	3936	0	5	65	0.0769231
NODE_331_length_4069_cov_14.261209	3871	3936	2	60	65	0.9230769
NODE_333_length_4050_cov_31.044039	1703	1783	0	4	80	0.0500000
NODE_333_length_4050_cov_31.044039	1703	1783	2	76	80	0.9500000
NODE_335_length_4021_cov_34.619072	379	459	4	29	80	0.3625000
NODE_335_length_4021_cov_34.619072	379	459	6	51	80	0.6375000
NODE_335_length_4021_cov_34.619072	432	512	0	17	80	0.2125000
NODE_335_length_4021_cov_34.619072	432	512	2	36	80	0.4500000
NODE_335_length_4021_cov_34.619072	432	512	6	27	80	0.3375000
NODE_336_length_4020_cov_5.130834	3455	3535	0	80	80	1.0000000
NODE_336_length_4020_cov_5.130834	3508	3588	0	80	80	1.0000000
NODE_339_length_4004_cov_9.718054	387	467	0	80	80	1.0000000
NODE_339_length_4004_cov_9.718054	440	520	0	80	80	1.0000000
NODE_339_length_4004_cov_9.718054	516	596	0	80	80	1.0000000
NODE_339_length_4004_cov_9.718054	569	649	0	80	80	1.0000000
NODE_341_length_3991_cov_18.617934	867	947	0	80	80	1.0000000
NODE_341_length_3991_cov_18.617934	920	1000	0	80	80	1.0000000
NODE_341_length_3991_cov_18.617934	996	1076	0	80	80	1.0000000
NODE_341_length_3991_cov_18.617934	1049	1124	0	75	75	1.0000000
NODE_348_length_3973_cov_6.906298	17	65	0	47	48	0.9791667
NODE_348_length_3973_cov_6.906298	17	65	2	1	48	0.0208333
NODE_348_length_3973_cov_6.906298	1945	1995	4	47	50	0.9400000
NODE_348_length_3973_cov_6.906298	1945	1995	6	3	50	0.0600000
NODE_350_length_3960_cov_6.246827	2673	2761	0	88	88	1.0000000
NODE_350_length_3960_cov_6.246827	3520	3600	0	69	80	0.8625000
NODE_350_length_3960_cov_6.246827	3520	3600	2	11	80	0.1375000
NODE_350_length_3960_cov_6.246827	3573	3653	0	80	80	1.0000000
NODE_353_length_3952_cov_8.805346	826	906	5	80	80	1.0000000
NODE_353_length_3952_cov_8.805346	879	959	0	22	80	0.2750000
NODE_353_length_3952_cov_8.805346	879	959	5	58	80	0.7250000
NODE_354_length_3928_cov_5.936798	2440	2521	0	81	81	1.0000000
NODE_354_length_3928_cov_5.936798	2493	2574	0	81	81	1.0000000
NODE_356_length_3923_cov_14.807793	3759	3800	2	41	41	1.0000000
NODE_358_length_3922_cov_7.609731	1493	1573	72	2	80	0.0250000
NODE_358_length_3922_cov_7.609731	1493	1573	76	1	80	0.0125000
NODE_358_length_3922_cov_7.609731	1493	1573	78	19	80	0.2375000
NODE_358_length_3922_cov_7.609731	1493	1573	80	16	80	0.2000000
NODE_358_length_3922_cov_7.609731	1493	1573	82	4	80	0.0500000
NODE_358_length_3922_cov_7.609731	1493	1573	84	2	80	0.0250000
NODE_358_length_3922_cov_7.609731	1493	1573	87	1	80	0.0125000
NODE_358_length_3922_cov_7.609731	1493	1573	88	4	80	0.0500000
NODE_358_length_3922_cov_7.609731	1493	1573	89	1	80	0.0125000
NODE_358_length_3922_cov_7.609731	1493	1573	90	2	80	0.0250000
NODE_358_length_3922_cov_7.609731	1493	1573	92	1	80	0.0125000
NODE_358_length_3922_cov_7.609731	1493	1573	94	6	80	0.0750000
NODE_358_length_3922_cov_7.609731	1493	1573	95	2	80	0.0250000
NODE_358_length_3922_cov_7.609731	1493	1573	96	9	80	0.1125000
NODE_358_length_3922_cov_7.609731	1493	1573	97	4	80	0.0500000
NODE_358_length_3922_cov_7.609731	1493	1573	98	2	80	0.0250000
NODE_358_length_3922_cov_7.609731	1493	1573	100	3	80	0.0375000
NODE_358_length_3922_cov_7.609731	1493	1573	102	1	80	0.0125000
NODE_358_length_3922_cov_7.609731	1546	1600	84	1	54	0.0185185
NODE_358_length_3922_cov_7.609731	1546	1600	85	1	54	0.0185185
NODE_358_length_3922_cov_7.609731	1546	1600	86	4	54	0.0740741
NODE_358_length_3922_cov_7.609731	1546	1600	87	1	54	0.0185185
NODE_358_length_3922_cov_7.609731	1546	1600	90	4	54	0.0740741
NODE_358_length_3922_cov_7.609731	1546	1600	92	5	54	0.0925926
NODE_358_length_3922_cov_7.609731	1546	1600	94	9	54	0.1666667
NODE_358_length_3922_cov_7.609731	1546	1600	95	6	54	0.1111111
NODE_358_length_3922_cov_7.609731	1546	1600	96	10	54	0.1851852
NODE_358_length_3922_cov_7.609731	1546	1600	97	4	54	0.0740741
NODE_358_length_3922_cov_7.609731	1546	1600	98	2	54	0.0370370
NODE_358_length_3922_cov_7.609731	1546	1600	100	3	54	0.0555556
NODE_358_length_3922_cov_7.609731	1546	1600	102	1	54	0.0185185
NODE_358_length_3922_cov_7.609731	1546	1600	103	2	54	0.0370370
NODE_358_length_3922_cov_7.609731	1546	1600	105	1	54	0.0185185
NODE_359_length_3921_cov_9.943223	2936	3016	221	1	80	0.0125000
NODE_359_length_3921_cov_9.943223	2936	3016	222	1	80	0.0125000
NODE_359_length_3921_cov_9.943223	2936	3016	224	1	80	0.0125000
NODE_359_length_3921_cov_9.943223	2936	3016	225	1	80	0.0125000
NODE_359_length_3921_cov_9.943223	2936	3016	227	3	80	0.0375000
NODE_359_length_3921_cov_9.943223	2936	3016	230	1	80	0.0125000
NODE_359_length_3921_cov_9.943223	2936	3016	231	3	80	0.0375000
NODE_359_length_3921_cov_9.943223	2936	3016	233	1	80	0.0125000
NODE_359_length_3921_cov_9.943223	2936	3016	234	1	80	0.0125000
NODE_359_length_3921_cov_9.943223	2936	3016	235	1	80	0.0125000
NODE_359_length_3921_cov_9.943223	2936	3016	237	6	80	0.0750000
NODE_359_length_3921_cov_9.943223	2936	3016	238	1	80	0.0125000
NODE_359_length_3921_cov_9.943223	2936	3016	239	1	80	0.0125000
NODE_359_length_3921_cov_9.943223	2936	3016	241	1	80	0.0125000
NODE_359_length_3921_cov_9.943223	2936	3016	243	1	80	0.0125000
NODE_359_length_3921_cov_9.943223	2936	3016	245	4	80	0.0500000
NODE_359_length_3921_cov_9.943223	2936	3016	246	1	80	0.0125000
NODE_359_length_3921_cov_9.943223	2936	3016	247	2	80	0.0250000
NODE_359_length_3921_cov_9.943223	2936	3016	249	3	80	0.0375000
NODE_359_length_3921_cov_9.943223	2936	3016	250	2	80	0.0250000
NODE_359_length_3921_cov_9.943223	2936	3016	251	1	80	0.0125000
NODE_359_length_3921_cov_9.943223	2936	3016	253	1	80	0.0125000
NODE_359_length_3921_cov_9.943223	2936	3016	254	1	80	0.0125000
NODE_359_length_3921_cov_9.943223	2936	3016	258	1	80	0.0125000
NODE_359_length_3921_cov_9.943223	2936	3016	261	3	80	0.0375000
NODE_359_length_3921_cov_9.943223	2936	3016	266	1	80	0.0125000
NODE_359_length_3921_cov_9.943223	2936	3016	268	1	80	0.0125000
NODE_359_length_3921_cov_9.943223	2936	3016	270	1	80	0.0125000
NODE_359_length_3921_cov_9.943223	2936	3016	273	1	80	0.0125000
NODE_359_length_3921_cov_9.943223	2936	3016	279	1	80	0.0125000
NODE_359_length_3921_cov_9.943223	2936	3016	281	6	80	0.0750000
NODE_359_length_3921_cov_9.943223	2936	3016	283	2	80	0.0250000
NODE_359_length_3921_cov_9.943223	2936	3016	285	1	80	0.0125000
NODE_359_length_3921_cov_9.943223	2936	3016	286	1	80	0.0125000
NODE_359_length_3921_cov_9.943223	2936	3016	287	1	80	0.0125000
NODE_359_length_3921_cov_9.943223	2936	3016	288	3	80	0.0375000
NODE_359_length_3921_cov_9.943223	2936	3016	289	6	80	0.0750000
NODE_359_length_3921_cov_9.943223	2936	3016	291	3	80	0.0375000
NODE_359_length_3921_cov_9.943223	2936	3016	292	3	80	0.0375000
NODE_359_length_3921_cov_9.943223	2936	3016	293	5	80	0.0625000
NODE_359_length_3921_cov_9.943223	2936	3016	294	1	80	0.0125000
NODE_359_length_3921_cov_9.943223	2989	3057	202	2	68	0.0294118
NODE_359_length_3921_cov_9.943223	2989	3057	209	1	68	0.0147059
NODE_359_length_3921_cov_9.943223	2989	3057	214	1	68	0.0147059
NODE_359_length_3921_cov_9.943223	2989	3057	217	1	68	0.0147059
NODE_359_length_3921_cov_9.943223	2989	3057	219	2	68	0.0294118
NODE_359_length_3921_cov_9.943223	2989	3057	221	1	68	0.0147059
NODE_359_length_3921_cov_9.943223	2989	3057	222	1	68	0.0147059
NODE_359_length_3921_cov_9.943223	2989	3057	224	1	68	0.0147059
NODE_359_length_3921_cov_9.943223	2989	3057	234	1	68	0.0147059
NODE_359_length_3921_cov_9.943223	2989	3057	236	1	68	0.0147059
NODE_359_length_3921_cov_9.943223	2989	3057	239	1	68	0.0147059
NODE_359_length_3921_cov_9.943223	2989	3057	241	1	68	0.0147059
NODE_359_length_3921_cov_9.943223	2989	3057	245	1	68	0.0147059
NODE_359_length_3921_cov_9.943223	2989	3057	247	4	68	0.0588235
NODE_359_length_3921_cov_9.943223	2989	3057	249	1	68	0.0147059
NODE_359_length_3921_cov_9.943223	2989	3057	257	1	68	0.0147059
NODE_359_length_3921_cov_9.943223	2989	3057	262	2	68	0.0294118
NODE_359_length_3921_cov_9.943223	2989	3057	264	1	68	0.0147059
NODE_359_length_3921_cov_9.943223	2989	3057	266	2	68	0.0294118
NODE_359_length_3921_cov_9.943223	2989	3057	269	2	68	0.0294118
NODE_359_length_3921_cov_9.943223	2989	3057	270	1	68	0.0147059
NODE_359_length_3921_cov_9.943223	2989	3057	271	3	68	0.0441176
NODE_359_length_3921_cov_9.943223	2989	3057	273	4	68	0.0588235
NODE_359_length_3921_cov_9.943223	2989	3057	275	1	68	0.0147059
NODE_359_length_3921_cov_9.943223	2989	3057	277	2	68	0.0294118
NODE_359_length_3921_cov_9.943223	2989	3057	279	2	68	0.0294118
NODE_359_length_3921_cov_9.943223	2989	3057	281	1	68	0.0147059
NODE_359_length_3921_cov_9.943223	2989	3057	283	2	68	0.0294118
NODE_359_length_3921_cov_9.943223	2989	3057	285	1	68	0.0147059
NODE_359_length_3921_cov_9.943223	2989	3057	286	1	68	0.0147059
NODE_359_length_3921_cov_9.943223	2989	3057	287	1	68	0.0147059
NODE_359_length_3921_cov_9.943223	2989	3057	288	3	68	0.0441176
NODE_359_length_3921_cov_9.943223	2989	3057	289	6	68	0.0882353
NODE_359_length_3921_cov_9.943223	2989	3057	291	3	68	0.0441176
NODE_359_length_3921_cov_9.943223	2989	3057	292	3	68	0.0441176
NODE_359_length_3921_cov_9.943223	2989	3057	293	5	68	0.0735294
NODE_359_length_3921_cov_9.943223	2989	3057	294	1	68	0.0147059
NODE_359_length_3921_cov_9.943223	3047	3066	173	1	19	0.0526316
NODE_359_length_3921_cov_9.943223	3047	3066	181	1	19	0.0526316
NODE_359_length_3921_cov_9.943223	3047	3066	182	1	19	0.0526316
NODE_359_length_3921_cov_9.943223	3047	3066	184	1	19	0.0526316
NODE_359_length_3921_cov_9.943223	3047	3066	190	2	19	0.1052632
NODE_359_length_3921_cov_9.943223	3047	3066	192	1	19	0.0526316
NODE_359_length_3921_cov_9.943223	3047	3066	201	1	19	0.0526316
NODE_359_length_3921_cov_9.943223	3047	3066	202	2	19	0.1052632
NODE_359_length_3921_cov_9.943223	3047	3066	203	1	19	0.0526316
NODE_359_length_3921_cov_9.943223	3047	3066	209	1	19	0.0526316
NODE_359_length_3921_cov_9.943223	3047	3066	214	1	19	0.0526316
NODE_359_length_3921_cov_9.943223	3047	3066	217	1	19	0.0526316
NODE_359_length_3921_cov_9.943223	3047	3066	219	2	19	0.1052632
NODE_359_length_3921_cov_9.943223	3047	3066	221	1	19	0.0526316
NODE_359_length_3921_cov_9.943223	3047	3066	222	1	19	0.0526316
NODE_359_length_3921_cov_9.943223	3047	3066	224	1	19	0.0526316
NODE_363_length_3898_cov_40.033167	3296	3370	35	5	74	0.0675676
NODE_363_length_3898_cov_40.033167	3296	3370	36	5	74	0.0675676
NODE_363_length_3898_cov_40.033167	3296	3370	38	1	74	0.0135135
NODE_363_length_3898_cov_40.033167	3296	3370	41	33	74	0.4459459
NODE_363_length_3898_cov_40.033167	3296	3370	43	22	74	0.2972973
NODE_363_length_3898_cov_40.033167	3296	3370	47	8	74	0.1081081
NODE_363_length_3898_cov_40.033167	3539	3619	4	14	80	0.1750000
NODE_363_length_3898_cov_40.033167	3539	3619	5	15	80	0.1875000
NODE_363_length_3898_cov_40.033167	3539	3619	6	23	80	0.2875000
NODE_363_length_3898_cov_40.033167	3539	3619	8	28	80	0.3500000
NODE_364_length_3898_cov_7.550145	668	748	0	80	80	1.0000000
NODE_364_length_3898_cov_7.550145	721	801	0	75	80	0.9375000
NODE_364_length_3898_cov_7.550145	721	801	10	1	80	0.0125000
NODE_364_length_3898_cov_7.550145	721	801	11	1	80	0.0125000
NODE_364_length_3898_cov_7.550145	721	801	13	1	80	0.0125000
NODE_364_length_3898_cov_7.550145	721	801	14	2	80	0.0250000
NODE_367_length_3882_cov_4.166006	3244	3324	2	28	80	0.3500000
NODE_367_length_3882_cov_4.166006	3244	3324	4	12	80	0.1500000
NODE_367_length_3882_cov_4.166006	3244	3324	6	34	80	0.4250000
NODE_367_length_3882_cov_4.166006	3244	3324	8	6	80	0.0750000
NODE_367_length_3882_cov_4.166006	3282	3324	4	2	42	0.0476190
NODE_367_length_3882_cov_4.166006	3282	3324	6	34	42	0.8095238
NODE_367_length_3882_cov_4.166006	3282	3324	8	6	42	0.1428571
NODE_367_length_3882_cov_4.166006	3297	3377	6	48	80	0.6000000
NODE_367_length_3882_cov_4.166006	3297	3377	8	32	80	0.4000000
NODE_367_length_3882_cov_4.166006	3297	3377	6	48	80	0.6000000
NODE_367_length_3882_cov_4.166006	3297	3377	8	32	80	0.4000000
NODE_367_length_3882_cov_4.166006	3373	3450	0	5	77	0.0649351
NODE_367_length_3882_cov_4.166006	3373	3450	2	45	77	0.5844156
NODE_367_length_3882_cov_4.166006	3373	3450	4	23	77	0.2987013
NODE_367_length_3882_cov_4.166006	3373	3450	6	4	77	0.0519481
NODE_374_length_3853_cov_18.816196	524	579	0	55	55	1.0000000
NODE_374_length_3853_cov_18.816196	559	639	0	80	80	1.0000000
NODE_379_length_3829_cov_12.697319	515	595	0	80	80	1.0000000
NODE_379_length_3829_cov_12.697319	568	648	0	80	80	1.0000000
NODE_379_length_3829_cov_12.697319	644	724	0	80	80	1.0000000
NODE_379_length_3829_cov_12.697319	697	777	0	80	80	1.0000000
NODE_381_length_3815_cov_17.218784	399	479	2	16	80	0.2000000
NODE_381_length_3815_cov_17.218784	399	479	4	64	80	0.8000000
NODE_381_length_3815_cov_17.218784	452	532	1	4	80	0.0500000
NODE_381_length_3815_cov_17.218784	452	532	3	2	80	0.0250000
NODE_381_length_3815_cov_17.218784	452	532	4	74	80	0.9250000
NODE_383_length_3812_cov_65.007272	840	903	49	1	63	0.0158730
NODE_383_length_3812_cov_65.007272	840	903	58	1	63	0.0158730
NODE_383_length_3812_cov_65.007272	840	903	69	1	63	0.0158730
NODE_383_length_3812_cov_65.007272	840	903	88	1	63	0.0158730
NODE_383_length_3812_cov_65.007272	840	903	90	1	63	0.0158730
NODE_383_length_3812_cov_65.007272	840	903	110	1	63	0.0158730
NODE_383_length_3812_cov_65.007272	840	903	117	1	63	0.0158730
NODE_383_length_3812_cov_65.007272	840	903	122	1	63	0.0158730
NODE_383_length_3812_cov_65.007272	840	903	124	1	63	0.0158730
NODE_383_length_3812_cov_65.007272	840	903	133	1	63	0.0158730
NODE_383_length_3812_cov_65.007272	840	903	135	1	63	0.0158730
NODE_383_length_3812_cov_65.007272	840	903	138	1	63	0.0158730
NODE_383_length_3812_cov_65.007272	840	903	141	1	63	0.0158730
NODE_383_length_3812_cov_65.007272	840	903	149	1	63	0.0158730
NODE_383_length_3812_cov_65.007272	840	903	151	1	63	0.0158730
NODE_383_length_3812_cov_65.007272	840	903	154	1	63	0.0158730
NODE_383_length_3812_cov_65.007272	840	903	160	1	63	0.0158730
NODE_383_length_3812_cov_65.007272	840	903	166	2	63	0.0317460
NODE_383_length_3812_cov_65.007272	840	903	172	1	63	0.0158730
NODE_383_length_3812_cov_65.007272	840	903	176	1	63	0.0158730
NODE_383_length_3812_cov_65.007272	840	903	186	1	63	0.0158730
NODE_383_length_3812_cov_65.007272	840	903	201	1	63	0.0158730
NODE_383_length_3812_cov_65.007272	840	903	211	1	63	0.0158730
NODE_383_length_3812_cov_65.007272	840	903	220	1	63	0.0158730
NODE_383_length_3812_cov_65.007272	840	903	223	1	63	0.0158730
NODE_383_length_3812_cov_65.007272	840	903	232	2	63	0.0317460
NODE_383_length_3812_cov_65.007272	840	903	254	1	63	0.0158730
NODE_383_length_3812_cov_65.007272	840	903	256	1	63	0.0158730
NODE_383_length_3812_cov_65.007272	840	903	268	1	63	0.0158730
NODE_383_length_3812_cov_65.007272	840	903	280	1	63	0.0158730
NODE_383_length_3812_cov_65.007272	840	903	290	1	63	0.0158730
NODE_383_length_3812_cov_65.007272	840	903	294	1	63	0.0158730
NODE_383_length_3812_cov_65.007272	840	903	300	1	63	0.0158730
NODE_383_length_3812_cov_65.007272	840	903	308	1	63	0.0158730
NODE_383_length_3812_cov_65.007272	840	903	311	1	63	0.0158730
NODE_383_length_3812_cov_65.007272	840	903	316	1	63	0.0158730
NODE_383_length_3812_cov_65.007272	840	903	323	1	63	0.0158730
NODE_383_length_3812_cov_65.007272	840	903	329	1	63	0.0158730
NODE_383_length_3812_cov_65.007272	840	903	337	1	63	0.0158730
NODE_383_length_3812_cov_65.007272	840	903	348	1	63	0.0158730
NODE_383_length_3812_cov_65.007272	840	903	351	1	63	0.0158730
NODE_383_length_3812_cov_65.007272	840	903	357	1	63	0.0158730
NODE_383_length_3812_cov_65.007272	840	903	360	1	63	0.0158730
NODE_383_length_3812_cov_65.007272	840	903	362	1	63	0.0158730
NODE_383_length_3812_cov_65.007272	840	903	371	1	63	0.0158730
NODE_383_length_3812_cov_65.007272	840	903	379	1	63	0.0158730
NODE_383_length_3812_cov_65.007272	840	903	381	1	63	0.0158730
NODE_383_length_3812_cov_65.007272	840	903	390	1	63	0.0158730
NODE_383_length_3812_cov_65.007272	840	903	396	1	63	0.0158730
NODE_383_length_3812_cov_65.007272	840	903	399	1	63	0.0158730
NODE_383_length_3812_cov_65.007272	840	903	404	1	63	0.0158730
NODE_383_length_3812_cov_65.007272	840	903	417	1	63	0.0158730
NODE_383_length_3812_cov_65.007272	840	903	420	1	63	0.0158730
NODE_383_length_3812_cov_65.007272	840	903	436	1	63	0.0158730
NODE_383_length_3812_cov_65.007272	840	903	445	1	63	0.0158730
NODE_383_length_3812_cov_65.007272	840	903	458	1	63	0.0158730
NODE_383_length_3812_cov_65.007272	840	903	467	1	63	0.0158730
NODE_383_length_3812_cov_65.007272	840	903	469	1	63	0.0158730
NODE_383_length_3812_cov_65.007272	840	903	479	1	63	0.0158730
NODE_383_length_3812_cov_65.007272	840	903	490	1	63	0.0158730
NODE_383_length_3812_cov_65.007272	840	903	504	1	63	0.0158730
NODE_384_length_3805_cov_9.533189	145	236	0	91	91	1.0000000
NODE_384_length_3805_cov_9.533189	209	279	0	70	70	1.0000000
NODE_386_length_3799_cov_10.046486	2944	3024	0	13	80	0.1625000
NODE_386_length_3799_cov_10.046486	2944	3024	2	23	80	0.2875000
NODE_386_length_3799_cov_10.046486	2944	3024	4	3	80	0.0375000
NODE_386_length_3799_cov_10.046486	2944	3024	6	34	80	0.4250000
NODE_386_length_3799_cov_10.046486	2944	3024	8	2	80	0.0250000
NODE_386_length_3799_cov_10.046486	2944	3024	10	1	80	0.0125000
NODE_386_length_3799_cov_10.046486	2944	3024	22	2	80	0.0250000
NODE_386_length_3799_cov_10.046486	2944	3024	24	2	80	0.0250000
NODE_386_length_3799_cov_10.046486	2997	3077	0	66	80	0.8250000
NODE_386_length_3799_cov_10.046486	2997	3077	2	14	80	0.1750000
NODE_388_length_3795_cov_13.724297	3350	3430	0	80	80	1.0000000
NODE_388_length_3795_cov_13.724297	3403	3483	0	66	80	0.8250000
NODE_388_length_3795_cov_13.724297	3403	3483	4	14	80	0.1750000
NODE_388_length_3795_cov_13.724297	3479	3562	4	42	83	0.5060241
NODE_388_length_3795_cov_13.724297	3479	3562	6	24	83	0.2891566
NODE_388_length_3795_cov_13.724297	3479	3562	8	17	83	0.2048193
NODE_388_length_3795_cov_13.724297	3479	3562	4	42	83	0.5060241
NODE_388_length_3795_cov_13.724297	3479	3562	6	24	83	0.2891566
NODE_388_length_3795_cov_13.724297	3479	3562	8	17	83	0.2048193
NODE_388_length_3795_cov_13.724297	3479	3552	4	42	73	0.5753425
NODE_388_length_3795_cov_13.724297	3479	3552	6	24	73	0.3287671
NODE_388_length_3795_cov_13.724297	3479	3552	8	7	73	0.0958904
NODE_388_length_3795_cov_13.724297	3535	3586	4	2	51	0.0392157
NODE_388_length_3795_cov_13.724297	3535	3586	6	26	51	0.5098040
NODE_388_length_3795_cov_13.724297	3535	3586	8	23	51	0.4509804
NODE_388_length_3795_cov_13.724297	3535	3584	4	2	49	0.0408163
NODE_388_length_3795_cov_13.724297	3535	3584	6	24	49	0.4897959
NODE_388_length_3795_cov_13.724297	3535	3584	8	23	49	0.4693878
NODE_388_length_3795_cov_13.724297	3698	3721	42	9	23	0.3913043
NODE_388_length_3795_cov_13.724297	3698	3721	44	1	23	0.0434783
NODE_388_length_3795_cov_13.724297	3698	3721	46	13	23	0.5652174
NODE_394_length_3774_cov_7.720544	538	595	11	1	57	0.0175439
NODE_394_length_3774_cov_7.720544	538	595	12	5	57	0.0877193
NODE_394_length_3774_cov_7.720544	538	595	14	3	57	0.0526316
NODE_394_length_3774_cov_7.720544	538	595	16	6	57	0.1052632
NODE_394_length_3774_cov_7.720544	538	595	17	1	57	0.0175439
NODE_394_length_3774_cov_7.720544	538	595	18	1	57	0.0175439
NODE_394_length_3774_cov_7.720544	538	595	20	4	57	0.0701754
NODE_394_length_3774_cov_7.720544	538	595	27	1	57	0.0175439
NODE_394_length_3774_cov_7.720544	538	595	28	21	57	0.3684210
NODE_394_length_3774_cov_7.720544	538	595	30	2	57	0.0350877
NODE_394_length_3774_cov_7.720544	538	595	32	11	57	0.1929825
NODE_394_length_3774_cov_7.720544	538	595	34	1	57	0.0175439
NODE_404_length_3747_cov_3.328947	2230	2292	0	3	62	0.0483871
NODE_404_length_3747_cov_3.328947	2230	2292	2	17	62	0.2741936
NODE_404_length_3747_cov_3.328947	2230	2292	8	42	62	0.6774194
NODE_406_length_3743_cov_38.767014	1354	1434	12	16	80	0.2000000
NODE_406_length_3743_cov_38.767014	1354	1434	14	13	80	0.1625000
NODE_406_length_3743_cov_38.767014	1354	1434	16	20	80	0.2500000
NODE_406_length_3743_cov_38.767014	1354	1434	18	31	80	0.3875000
NODE_406_length_3743_cov_38.767014	1407	1487	8	1	80	0.0125000
NODE_406_length_3743_cov_38.767014	1407	1487	10	40	80	0.5000000
NODE_406_length_3743_cov_38.767014	1407	1487	12	3	80	0.0375000
NODE_406_length_3743_cov_38.767014	1407	1487	16	2	80	0.0250000
NODE_406_length_3743_cov_38.767014	1407	1487	18	34	80	0.4250000
NODE_408_length_3733_cov_16.204458	186	249	0	10	63	0.1587302
NODE_408_length_3733_cov_16.204458	186	249	1	2	63	0.0317460
NODE_408_length_3733_cov_16.204458	186	249	2	9	63	0.1428571
NODE_408_length_3733_cov_16.204458	186	249	4	31	63	0.4920635
NODE_408_length_3733_cov_16.204458	186	249	5	1	63	0.0158730
NODE_408_length_3733_cov_16.204458	186	249	6	4	63	0.0634921
NODE_408_length_3733_cov_16.204458	186	249	7	1	63	0.0158730
NODE_408_length_3733_cov_16.204458	186	249	9	3	63	0.0476190
NODE_408_length_3733_cov_16.204458	186	249	13	2	63	0.0317460
NODE_413_length_3707_cov_56.575665	2387	2467	4	19	80	0.2375000
NODE_413_length_3707_cov_56.575665	2387	2467	5	22	80	0.2750000
NODE_413_length_3707_cov_56.575665	2387	2467	6	28	80	0.3500000
NODE_413_length_3707_cov_56.575665	2387	2467	7	11	80	0.1375000
NODE_413_length_3707_cov_56.575665	2440	2520	4	24	80	0.3000000
NODE_413_length_3707_cov_56.575665	2440	2520	6	23	80	0.2875000
NODE_413_length_3707_cov_56.575665	2440	2520	8	8	80	0.1000000
NODE_413_length_3707_cov_56.575665	2440	2520	10	12	80	0.1500000
NODE_413_length_3707_cov_56.575665	2440	2520	12	13	80	0.1625000
NODE_413_length_3707_cov_56.575665	2516	2596	4	6	80	0.0750000
NODE_413_length_3707_cov_56.575665	2516	2596	8	24	80	0.3000000
NODE_413_length_3707_cov_56.575665	2516	2596	10	2	80	0.0250000
NODE_413_length_3707_cov_56.575665	2516	2596	11	2	80	0.0250000
NODE_413_length_3707_cov_56.575665	2516	2596	12	46	80	0.5750000
NODE_413_length_3707_cov_56.575665	2569	2649	4	6	80	0.0750000
NODE_413_length_3707_cov_56.575665	2569	2649	8	66	80	0.8250000
NODE_413_length_3707_cov_56.575665	2569	2649	10	8	80	0.1000000
NODE_416_length_3690_cov_7.476190	723	792	0	34	69	0.4927536
NODE_416_length_3690_cov_7.476190	723	792	4	35	69	0.5072464
NODE_416_length_3690_cov_7.476190	776	855	0	79	79	1.0000000
NODE_419_length_3685_cov_7.011154	1966	2046	118	1	80	0.0125000
NODE_419_length_3685_cov_7.011154	1966	2046	120	2	80	0.0250000
NODE_419_length_3685_cov_7.011154	1966	2046	126	4	80	0.0500000
NODE_419_length_3685_cov_7.011154	1966	2046	128	1	80	0.0125000
NODE_419_length_3685_cov_7.011154	1966	2046	130	1	80	0.0125000
NODE_419_length_3685_cov_7.011154	1966	2046	132	2	80	0.0250000
NODE_419_length_3685_cov_7.011154	1966	2046	137	3	80	0.0375000
NODE_419_length_3685_cov_7.011154	1966	2046	139	1	80	0.0125000
NODE_419_length_3685_cov_7.011154	1966	2046	141	3	80	0.0375000
NODE_419_length_3685_cov_7.011154	1966	2046	142	5	80	0.0625000
NODE_419_length_3685_cov_7.011154	1966	2046	146	4	80	0.0500000
NODE_419_length_3685_cov_7.011154	1966	2046	151	1	80	0.0125000
NODE_419_length_3685_cov_7.011154	1966	2046	153	4	80	0.0500000
NODE_419_length_3685_cov_7.011154	1966	2046	154	1	80	0.0125000
NODE_419_length_3685_cov_7.011154	1966	2046	158	1	80	0.0125000
NODE_419_length_3685_cov_7.011154	1966	2046	162	2	80	0.0250000
NODE_419_length_3685_cov_7.011154	1966	2046	167	2	80	0.0250000
NODE_419_length_3685_cov_7.011154	1966	2046	169	4	80	0.0500000
NODE_419_length_3685_cov_7.011154	1966	2046	171	2	80	0.0250000
NODE_419_length_3685_cov_7.011154	1966	2046	173	2	80	0.0250000
NODE_419_length_3685_cov_7.011154	1966	2046	174	2	80	0.0250000
NODE_419_length_3685_cov_7.011154	1966	2046	175	1	80	0.0125000
NODE_419_length_3685_cov_7.011154	1966	2046	176	3	80	0.0375000
NODE_419_length_3685_cov_7.011154	1966	2046	178	2	80	0.0250000
NODE_419_length_3685_cov_7.011154	1966	2046	180	2	80	0.0250000
NODE_419_length_3685_cov_7.011154	1966	2046	182	1	80	0.0125000
NODE_419_length_3685_cov_7.011154	1966	2046	184	2	80	0.0250000
NODE_419_length_3685_cov_7.011154	1966	2046	188	3	80	0.0375000
NODE_419_length_3685_cov_7.011154	1966	2046	190	1	80	0.0125000
NODE_419_length_3685_cov_7.011154	1966	2046	192	2	80	0.0250000
NODE_419_length_3685_cov_7.011154	1966	2046	194	2	80	0.0250000
NODE_419_length_3685_cov_7.011154	1966	2046	197	2	80	0.0250000
NODE_419_length_3685_cov_7.011154	1966	2046	199	2	80	0.0250000
NODE_419_length_3685_cov_7.011154	1966	2046	213	3	80	0.0375000
NODE_419_length_3685_cov_7.011154	1966	2046	215	2	80	0.0250000
NODE_419_length_3685_cov_7.011154	1966	2046	219	3	80	0.0375000
NODE_419_length_3685_cov_7.011154	1966	2046	221	1	80	0.0125000
NODE_419_length_3685_cov_7.011154	2019	2086	154	1	67	0.0149254
NODE_419_length_3685_cov_7.011154	2019	2086	160	4	67	0.0597015
NODE_419_length_3685_cov_7.011154	2019	2086	162	2	67	0.0298507
NODE_419_length_3685_cov_7.011154	2019	2086	170	1	67	0.0149254
NODE_419_length_3685_cov_7.011154	2019	2086	171	1	67	0.0149254
NODE_419_length_3685_cov_7.011154	2019	2086	172	1	67	0.0149254
NODE_419_length_3685_cov_7.011154	2019	2086	178	1	67	0.0149254
NODE_419_length_3685_cov_7.011154	2019	2086	180	3	67	0.0447761
NODE_419_length_3685_cov_7.011154	2019	2086	182	1	67	0.0149254
NODE_419_length_3685_cov_7.011154	2019	2086	184	2	67	0.0298507
NODE_419_length_3685_cov_7.011154	2019	2086	186	4	67	0.0597015
NODE_419_length_3685_cov_7.011154	2019	2086	188	4	67	0.0597015
NODE_419_length_3685_cov_7.011154	2019	2086	189	4	67	0.0597015
NODE_419_length_3685_cov_7.011154	2019	2086	190	1	67	0.0149254
NODE_419_length_3685_cov_7.011154	2019	2086	191	3	67	0.0447761
NODE_419_length_3685_cov_7.011154	2019	2086	192	2	67	0.0298507
NODE_419_length_3685_cov_7.011154	2019	2086	194	3	67	0.0447761
NODE_419_length_3685_cov_7.011154	2019	2086	197	3	67	0.0447761
NODE_419_length_3685_cov_7.011154	2019	2086	199	2	67	0.0298507
NODE_419_length_3685_cov_7.011154	2019	2086	200	1	67	0.0149254
NODE_419_length_3685_cov_7.011154	2019	2086	206	1	67	0.0149254
NODE_419_length_3685_cov_7.011154	2019	2086	210	1	67	0.0149254
NODE_419_length_3685_cov_7.011154	2019	2086	213	3	67	0.0447761
NODE_419_length_3685_cov_7.011154	2019	2086	215	5	67	0.0746269
NODE_419_length_3685_cov_7.011154	2019	2086	216	1	67	0.0149254
NODE_419_length_3685_cov_7.011154	2019	2086	217	1	67	0.0149254
NODE_419_length_3685_cov_7.011154	2019	2086	218	4	67	0.0597015
NODE_419_length_3685_cov_7.011154	2019	2086	219	4	67	0.0597015
NODE_419_length_3685_cov_7.011154	2019	2086	220	1	67	0.0149254
NODE_419_length_3685_cov_7.011154	2019	2086	221	2	67	0.0298507
NODE_426_length_3667_cov_1089.047365	1634	1705	34	11	71	0.1549296
NODE_426_length_3667_cov_1089.047365	1634	1705	36	5	71	0.0704225
NODE_426_length_3667_cov_1089.047365	1634	1705	37	1	71	0.0140845
NODE_426_length_3667_cov_1089.047365	1634	1705	38	17	71	0.2394366
NODE_426_length_3667_cov_1089.047365	1634	1705	39	1	71	0.0140845
NODE_426_length_3667_cov_1089.047365	1634	1705	47	3	71	0.0422535
NODE_426_length_3667_cov_1089.047365	1634	1705	49	14	71	0.1971831
NODE_426_length_3667_cov_1089.047365	1634	1705	61	6	71	0.0845070
NODE_426_length_3667_cov_1089.047365	1634	1705	63	9	71	0.1267606
NODE_426_length_3667_cov_1089.047365	1634	1705	64	2	71	0.0281690
NODE_426_length_3667_cov_1089.047365	1634	1705	65	1	71	0.0140845
NODE_426_length_3667_cov_1089.047365	1634	1705	66	1	71	0.0140845
NODE_426_length_3667_cov_1089.047365	1678	1758	34	3	80	0.0375000
NODE_426_length_3667_cov_1089.047365	1678	1758	36	1	80	0.0125000
NODE_426_length_3667_cov_1089.047365	1678	1758	38	1	80	0.0125000
NODE_426_length_3667_cov_1089.047365	1678	1758	46	2	80	0.0250000
NODE_426_length_3667_cov_1089.047365	1678	1758	49	11	80	0.1375000
NODE_426_length_3667_cov_1089.047365	1678	1758	51	4	80	0.0500000
NODE_426_length_3667_cov_1089.047365	1678	1758	55	5	80	0.0625000
NODE_426_length_3667_cov_1089.047365	1678	1758	57	9	80	0.1125000
NODE_426_length_3667_cov_1089.047365	1678	1758	61	9	80	0.1125000
NODE_426_length_3667_cov_1089.047365	1678	1758	63	17	80	0.2125000
NODE_426_length_3667_cov_1089.047365	1678	1758	64	2	80	0.0250000
NODE_426_length_3667_cov_1089.047365	1678	1758	65	9	80	0.1125000
NODE_426_length_3667_cov_1089.047365	1678	1758	66	1	80	0.0125000
NODE_426_length_3667_cov_1089.047365	1678	1758	67	5	80	0.0625000
NODE_426_length_3667_cov_1089.047365	1678	1758	69	1	80	0.0125000
NODE_428_length_3660_cov_79.447627	1806	1870	136	2	64	0.0312500
NODE_428_length_3660_cov_79.447627	1806	1870	137	1	64	0.0156250
NODE_428_length_3660_cov_79.447627	1806	1870	143	2	64	0.0312500
NODE_428_length_3660_cov_79.447627	1806	1870	144	1	64	0.0156250
NODE_428_length_3660_cov_79.447627	1806	1870	146	2	64	0.0312500
NODE_428_length_3660_cov_79.447627	1806	1870	149	1	64	0.0156250
NODE_428_length_3660_cov_79.447627	1806	1870	154	1	64	0.0156250
NODE_428_length_3660_cov_79.447627	1806	1870	159	1	64	0.0156250
NODE_428_length_3660_cov_79.447627	1806	1870	162	2	64	0.0312500
NODE_428_length_3660_cov_79.447627	1806	1870	163	2	64	0.0312500
NODE_428_length_3660_cov_79.447627	1806	1870	164	1	64	0.0156250
NODE_428_length_3660_cov_79.447627	1806	1870	166	1	64	0.0156250
NODE_428_length_3660_cov_79.447627	1806	1870	168	1	64	0.0156250
NODE_428_length_3660_cov_79.447627	1806	1870	169	2	64	0.0312500
NODE_428_length_3660_cov_79.447627	1806	1870	171	1	64	0.0156250
NODE_428_length_3660_cov_79.447627	1806	1870	186	1	64	0.0156250
NODE_428_length_3660_cov_79.447627	1806	1870	194	1	64	0.0156250
NODE_428_length_3660_cov_79.447627	1806	1870	199	1	64	0.0156250
NODE_428_length_3660_cov_79.447627	1806	1870	206	1	64	0.0156250
NODE_428_length_3660_cov_79.447627	1806	1870	209	1	64	0.0156250
NODE_428_length_3660_cov_79.447627	1806	1870	210	1	64	0.0156250
NODE_428_length_3660_cov_79.447627	1806	1870	211	1	64	0.0156250
NODE_428_length_3660_cov_79.447627	1806	1870	213	1	64	0.0156250
NODE_428_length_3660_cov_79.447627	1806	1870	219	1	64	0.0156250
NODE_428_length_3660_cov_79.447627	1806	1870	220	1	64	0.0156250
NODE_428_length_3660_cov_79.447627	1806	1870	222	1	64	0.0156250
NODE_428_length_3660_cov_79.447627	1806	1870	228	1	64	0.0156250
NODE_428_length_3660_cov_79.447627	1806	1870	229	1	64	0.0156250
NODE_428_length_3660_cov_79.447627	1806	1870	231	1	64	0.0156250
NODE_428_length_3660_cov_79.447627	1806	1870	232	1	64	0.0156250
NODE_428_length_3660_cov_79.447627	1806	1870	233	1	64	0.0156250
NODE_428_length_3660_cov_79.447627	1806	1870	238	2	64	0.0312500
NODE_428_length_3660_cov_79.447627	1806	1870	240	1	64	0.0156250
NODE_428_length_3660_cov_79.447627	1806	1870	244	1	64	0.0156250
NODE_428_length_3660_cov_79.447627	1806	1870	247	1	64	0.0156250
NODE_428_length_3660_cov_79.447627	1806	1870	249	2	64	0.0312500
NODE_428_length_3660_cov_79.447627	1806	1870	250	1	64	0.0156250
NODE_428_length_3660_cov_79.447627	1806	1870	251	5	64	0.0781250
NODE_428_length_3660_cov_79.447627	1806	1870	253	2	64	0.0312500
NODE_428_length_3660_cov_79.447627	1806	1870	255	1	64	0.0156250
NODE_428_length_3660_cov_79.447627	1806	1870	257	1	64	0.0156250
NODE_428_length_3660_cov_79.447627	1806	1870	262	1	64	0.0156250
NODE_428_length_3660_cov_79.447627	1806	1870	268	1	64	0.0156250
NODE_428_length_3660_cov_79.447627	1806	1870	270	2	64	0.0312500
NODE_428_length_3660_cov_79.447627	1806	1870	271	1	64	0.0156250
NODE_428_length_3660_cov_79.447627	1806	1870	272	2	64	0.0312500
NODE_428_length_3660_cov_79.447627	1806	1870	273	1	64	0.0156250
NODE_428_length_3660_cov_79.447627	1806	1870	274	1	64	0.0156250
NODE_428_length_3660_cov_79.447627	1806	1870	278	1	64	0.0156250
NODE_428_length_3660_cov_79.447627	1859	1906	257	1	47	0.0212766
NODE_428_length_3660_cov_79.447627	1859	1906	262	1	47	0.0212766
NODE_428_length_3660_cov_79.447627	1859	1906	268	1	47	0.0212766
NODE_428_length_3660_cov_79.447627	1859	1906	270	2	47	0.0425532
NODE_428_length_3660_cov_79.447627	1859	1906	271	1	47	0.0212766
NODE_428_length_3660_cov_79.447627	1859	1906	272	2	47	0.0425532
NODE_428_length_3660_cov_79.447627	1859	1906	273	1	47	0.0212766
NODE_428_length_3660_cov_79.447627	1859	1906	274	1	47	0.0212766
NODE_428_length_3660_cov_79.447627	1859	1906	278	1	47	0.0212766
NODE_428_length_3660_cov_79.447627	1859	1906	282	1	47	0.0212766
NODE_428_length_3660_cov_79.447627	1859	1906	285	1	47	0.0212766
NODE_428_length_3660_cov_79.447627	1859	1906	287	1	47	0.0212766
NODE_428_length_3660_cov_79.447627	1859	1906	290	1	47	0.0212766
NODE_428_length_3660_cov_79.447627	1859	1906	291	1	47	0.0212766
NODE_428_length_3660_cov_79.447627	1859	1906	293	1	47	0.0212766
NODE_428_length_3660_cov_79.447627	1859	1906	295	1	47	0.0212766
NODE_428_length_3660_cov_79.447627	1859	1906	305	1	47	0.0212766
NODE_428_length_3660_cov_79.447627	1859	1906	306	1	47	0.0212766
NODE_428_length_3660_cov_79.447627	1859	1906	307	1	47	0.0212766
NODE_428_length_3660_cov_79.447627	1859	1906	308	1	47	0.0212766
NODE_428_length_3660_cov_79.447627	1859	1906	309	1	47	0.0212766
NODE_428_length_3660_cov_79.447627	1859	1906	310	3	47	0.0638298
NODE_428_length_3660_cov_79.447627	1859	1906	311	2	47	0.0425532
NODE_428_length_3660_cov_79.447627	1859	1906	313	2	47	0.0425532
NODE_428_length_3660_cov_79.447627	1859	1906	315	3	47	0.0638298
NODE_428_length_3660_cov_79.447627	1859	1906	316	2	47	0.0425532
NODE_428_length_3660_cov_79.447627	1859	1906	319	3	47	0.0638298
NODE_428_length_3660_cov_79.447627	1859	1906	320	1	47	0.0212766
NODE_428_length_3660_cov_79.447627	1859	1906	322	1	47	0.0212766
NODE_428_length_3660_cov_79.447627	1859	1906	324	7	47	0.1489362
NODE_428_length_3660_cov_79.447627	2358	2438	0	80	80	1.0000000
NODE_428_length_3660_cov_79.447627	2411	2491	0	80	80	1.0000000
NODE_428_length_3660_cov_79.447627	2487	2567	0	80	80	1.0000000
NODE_428_length_3660_cov_79.447627	2540	2620	0	80	80	1.0000000
NODE_430_length_3634_cov_34.913154	1499	1544	56	1	45	0.0222222
NODE_430_length_3634_cov_34.913154	1499	1544	63	1	45	0.0222222
NODE_430_length_3634_cov_34.913154	1499	1544	75	1	45	0.0222222
NODE_430_length_3634_cov_34.913154	1499	1544	79	1	45	0.0222222
NODE_430_length_3634_cov_34.913154	1499	1544	85	2	45	0.0444444
NODE_430_length_3634_cov_34.913154	1499	1544	87	1	45	0.0222222
NODE_430_length_3634_cov_34.913154	1499	1544	90	1	45	0.0222222
NODE_430_length_3634_cov_34.913154	1499	1544	105	1	45	0.0222222
NODE_430_length_3634_cov_34.913154	1499	1544	106	1	45	0.0222222
NODE_430_length_3634_cov_34.913154	1499	1544	108	1	45	0.0222222
NODE_430_length_3634_cov_34.913154	1499	1544	112	1	45	0.0222222
NODE_430_length_3634_cov_34.913154	1499	1544	117	1	45	0.0222222
NODE_430_length_3634_cov_34.913154	1499	1544	121	2	45	0.0444444
NODE_430_length_3634_cov_34.913154	1499	1544	127	1	45	0.0222222
NODE_430_length_3634_cov_34.913154	1499	1544	137	1	45	0.0222222
NODE_430_length_3634_cov_34.913154	1499	1544	139	1	45	0.0222222
NODE_430_length_3634_cov_34.913154	1499	1544	145	1	45	0.0222222
NODE_430_length_3634_cov_34.913154	1499	1544	150	1	45	0.0222222
NODE_430_length_3634_cov_34.913154	1499	1544	151	1	45	0.0222222
NODE_430_length_3634_cov_34.913154	1499	1544	153	1	45	0.0222222
NODE_430_length_3634_cov_34.913154	1499	1544	160	1	45	0.0222222
NODE_430_length_3634_cov_34.913154	1499	1544	165	1	45	0.0222222
NODE_430_length_3634_cov_34.913154	1499	1544	168	1	45	0.0222222
NODE_430_length_3634_cov_34.913154	1499	1544	182	1	45	0.0222222
NODE_430_length_3634_cov_34.913154	1499	1544	197	1	45	0.0222222
NODE_430_length_3634_cov_34.913154	1499	1544	217	1	45	0.0222222
NODE_430_length_3634_cov_34.913154	1499	1544	220	1	45	0.0222222
NODE_430_length_3634_cov_34.913154	1499	1544	221	1	45	0.0222222
NODE_430_length_3634_cov_34.913154	1499	1544	226	1	45	0.0222222
NODE_430_length_3634_cov_34.913154	1499	1544	228	1	45	0.0222222
NODE_430_length_3634_cov_34.913154	1499	1544	232	1	45	0.0222222
NODE_430_length_3634_cov_34.913154	1499	1544	238	1	45	0.0222222
NODE_430_length_3634_cov_34.913154	1499	1544	247	1	45	0.0222222
NODE_430_length_3634_cov_34.913154	1499	1544	251	1	45	0.0222222
NODE_430_length_3634_cov_34.913154	1499	1544	255	1	45	0.0222222
NODE_430_length_3634_cov_34.913154	1499	1544	264	1	45	0.0222222
NODE_430_length_3634_cov_34.913154	1499	1544	271	1	45	0.0222222
NODE_430_length_3634_cov_34.913154	1499	1544	277	1	45	0.0222222
NODE_430_length_3634_cov_34.913154	1499	1544	278	1	45	0.0222222
NODE_430_length_3634_cov_34.913154	1499	1544	283	1	45	0.0222222
NODE_430_length_3634_cov_34.913154	1499	1544	285	1	45	0.0222222
NODE_430_length_3634_cov_34.913154	1499	1544	291	1	45	0.0222222
NODE_430_length_3634_cov_34.913154	1499	1544	292	1	45	0.0222222
NODE_430_length_3634_cov_34.913154	1517	1597	145	1	80	0.0125000
NODE_430_length_3634_cov_34.913154	1517	1597	150	1	80	0.0125000
NODE_430_length_3634_cov_34.913154	1517	1597	151	1	80	0.0125000
NODE_430_length_3634_cov_34.913154	1517	1597	153	1	80	0.0125000
NODE_430_length_3634_cov_34.913154	1517	1597	160	1	80	0.0125000
NODE_430_length_3634_cov_34.913154	1517	1597	165	1	80	0.0125000
NODE_430_length_3634_cov_34.913154	1517	1597	168	1	80	0.0125000
NODE_430_length_3634_cov_34.913154	1517	1597	182	1	80	0.0125000
NODE_430_length_3634_cov_34.913154	1517	1597	197	1	80	0.0125000
NODE_430_length_3634_cov_34.913154	1517	1597	217	1	80	0.0125000
NODE_430_length_3634_cov_34.913154	1517	1597	220	1	80	0.0125000
NODE_430_length_3634_cov_34.913154	1517	1597	221	1	80	0.0125000
NODE_430_length_3634_cov_34.913154	1517	1597	226	1	80	0.0125000
NODE_430_length_3634_cov_34.913154	1517	1597	228	1	80	0.0125000
NODE_430_length_3634_cov_34.913154	1517	1597	232	1	80	0.0125000
NODE_430_length_3634_cov_34.913154	1517	1597	238	1	80	0.0125000
NODE_430_length_3634_cov_34.913154	1517	1597	247	1	80	0.0125000
NODE_430_length_3634_cov_34.913154	1517	1597	251	1	80	0.0125000
NODE_430_length_3634_cov_34.913154	1517	1597	255	1	80	0.0125000
NODE_430_length_3634_cov_34.913154	1517	1597	264	1	80	0.0125000
NODE_430_length_3634_cov_34.913154	1517	1597	271	1	80	0.0125000
NODE_430_length_3634_cov_34.913154	1517	1597	277	1	80	0.0125000
NODE_430_length_3634_cov_34.913154	1517	1597	278	1	80	0.0125000
NODE_430_length_3634_cov_34.913154	1517	1597	283	1	80	0.0125000
NODE_430_length_3634_cov_34.913154	1517	1597	285	1	80	0.0125000
NODE_430_length_3634_cov_34.913154	1517	1597	291	1	80	0.0125000
NODE_430_length_3634_cov_34.913154	1517	1597	292	1	80	0.0125000
NODE_430_length_3634_cov_34.913154	1517	1597	294	1	80	0.0125000
NODE_430_length_3634_cov_34.913154	1517	1597	297	1	80	0.0125000
NODE_430_length_3634_cov_34.913154	1517	1597	305	1	80	0.0125000
NODE_430_length_3634_cov_34.913154	1517	1597	310	1	80	0.0125000
NODE_430_length_3634_cov_34.913154	1517	1597	311	1	80	0.0125000
NODE_430_length_3634_cov_34.913154	1517	1597	312	1	80	0.0125000
NODE_430_length_3634_cov_34.913154	1517	1597	313	1	80	0.0125000
NODE_430_length_3634_cov_34.913154	1517	1597	318	1	80	0.0125000
NODE_430_length_3634_cov_34.913154	1517	1597	320	1	80	0.0125000
NODE_430_length_3634_cov_34.913154	1517	1597	326	1	80	0.0125000
NODE_430_length_3634_cov_34.913154	1517	1597	337	1	80	0.0125000
NODE_430_length_3634_cov_34.913154	1517	1597	338	1	80	0.0125000
NODE_430_length_3634_cov_34.913154	1517	1597	340	1	80	0.0125000
NODE_430_length_3634_cov_34.913154	1517	1597	359	1	80	0.0125000
NODE_430_length_3634_cov_34.913154	1517	1597	360	1	80	0.0125000
NODE_430_length_3634_cov_34.913154	1517	1597	369	1	80	0.0125000
NODE_430_length_3634_cov_34.913154	1517	1597	371	1	80	0.0125000
NODE_430_length_3634_cov_34.913154	1517	1597	372	3	80	0.0375000
NODE_430_length_3634_cov_34.913154	1517	1597	374	1	80	0.0125000
NODE_430_length_3634_cov_34.913154	1517	1597	375	1	80	0.0125000
NODE_430_length_3634_cov_34.913154	1517	1597	377	1	80	0.0125000
NODE_430_length_3634_cov_34.913154	1517	1597	380	1	80	0.0125000
NODE_430_length_3634_cov_34.913154	1517	1597	383	1	80	0.0125000
NODE_430_length_3634_cov_34.913154	1517	1597	384	1	80	0.0125000
NODE_430_length_3634_cov_34.913154	1517	1597	402	1	80	0.0125000
NODE_430_length_3634_cov_34.913154	1517	1597	404	1	80	0.0125000
NODE_430_length_3634_cov_34.913154	1517	1597	415	1	80	0.0125000
NODE_430_length_3634_cov_34.913154	1517	1597	419	1	80	0.0125000
NODE_430_length_3634_cov_34.913154	1517	1597	429	1	80	0.0125000
NODE_430_length_3634_cov_34.913154	1517	1597	439	1	80	0.0125000
NODE_430_length_3634_cov_34.913154	1517	1597	449	1	80	0.0125000
NODE_430_length_3634_cov_34.913154	1517	1597	457	2	80	0.0250000
NODE_430_length_3634_cov_34.913154	1517	1597	465	1	80	0.0125000
NODE_430_length_3634_cov_34.913154	1517	1597	468	1	80	0.0125000
NODE_430_length_3634_cov_34.913154	1517	1597	470	1	80	0.0125000
NODE_430_length_3634_cov_34.913154	1517	1597	471	1	80	0.0125000
NODE_430_length_3634_cov_34.913154	1517	1597	473	1	80	0.0125000
NODE_430_length_3634_cov_34.913154	1517	1597	475	2	80	0.0250000
NODE_430_length_3634_cov_34.913154	1517	1597	477	1	80	0.0125000
NODE_430_length_3634_cov_34.913154	1517	1597	478	2	80	0.0250000
NODE_430_length_3634_cov_34.913154	1517	1597	479	5	80	0.0625000
NODE_430_length_3634_cov_34.913154	1517	1597	481	1	80	0.0125000
NODE_430_length_3634_cov_34.913154	1517	1597	482	2	80	0.0250000
NODE_430_length_3634_cov_34.913154	1978	2058	121	1	80	0.0125000
NODE_430_length_3634_cov_34.913154	1978	2058	123	1	80	0.0125000
NODE_430_length_3634_cov_34.913154	1978	2058	124	1	80	0.0125000
NODE_430_length_3634_cov_34.913154	1978	2058	134	1	80	0.0125000
NODE_430_length_3634_cov_34.913154	1978	2058	145	1	80	0.0125000
NODE_430_length_3634_cov_34.913154	1978	2058	148	2	80	0.0250000
NODE_430_length_3634_cov_34.913154	1978	2058	150	3	80	0.0375000
NODE_430_length_3634_cov_34.913154	1978	2058	154	1	80	0.0125000
NODE_430_length_3634_cov_34.913154	1978	2058	162	1	80	0.0125000
NODE_430_length_3634_cov_34.913154	1978	2058	165	1	80	0.0125000
NODE_430_length_3634_cov_34.913154	1978	2058	172	1	80	0.0125000
NODE_430_length_3634_cov_34.913154	1978	2058	178	1	80	0.0125000
NODE_430_length_3634_cov_34.913154	1978	2058	180	1	80	0.0125000
NODE_430_length_3634_cov_34.913154	1978	2058	185	1	80	0.0125000
NODE_430_length_3634_cov_34.913154	1978	2058	186	1	80	0.0125000
NODE_430_length_3634_cov_34.913154	1978	2058	191	4	80	0.0500000
NODE_430_length_3634_cov_34.913154	1978	2058	199	2	80	0.0250000
NODE_430_length_3634_cov_34.913154	1978	2058	202	1	80	0.0125000
NODE_430_length_3634_cov_34.913154	1978	2058	204	1	80	0.0125000
NODE_430_length_3634_cov_34.913154	1978	2058	212	3	80	0.0375000
NODE_430_length_3634_cov_34.913154	1978	2058	218	1	80	0.0125000
NODE_430_length_3634_cov_34.913154	1978	2058	219	1	80	0.0125000
NODE_430_length_3634_cov_34.913154	1978	2058	221	1	80	0.0125000
NODE_430_length_3634_cov_34.913154	1978	2058	226	1	80	0.0125000
NODE_430_length_3634_cov_34.913154	1978	2058	229	2	80	0.0250000
NODE_430_length_3634_cov_34.913154	1978	2058	235	1	80	0.0125000
NODE_430_length_3634_cov_34.913154	1978	2058	243	1	80	0.0125000
NODE_430_length_3634_cov_34.913154	1978	2058	244	1	80	0.0125000
NODE_430_length_3634_cov_34.913154	1978	2058	250	1	80	0.0125000
NODE_430_length_3634_cov_34.913154	1978	2058	259	2	80	0.0250000
NODE_430_length_3634_cov_34.913154	1978	2058	260	1	80	0.0125000
NODE_430_length_3634_cov_34.913154	1978	2058	262	1	80	0.0125000
NODE_430_length_3634_cov_34.913154	1978	2058	280	1	80	0.0125000
NODE_430_length_3634_cov_34.913154	1978	2058	282	1	80	0.0125000
NODE_430_length_3634_cov_34.913154	1978	2058	286	1	80	0.0125000
NODE_430_length_3634_cov_34.913154	1978	2058	288	3	80	0.0375000
NODE_430_length_3634_cov_34.913154	1978	2058	293	1	80	0.0125000
NODE_430_length_3634_cov_34.913154	1978	2058	295	1	80	0.0125000
NODE_430_length_3634_cov_34.913154	1978	2058	298	2	80	0.0250000
NODE_430_length_3634_cov_34.913154	1978	2058	302	1	80	0.0125000
NODE_430_length_3634_cov_34.913154	1978	2058	306	1	80	0.0125000
NODE_430_length_3634_cov_34.913154	1978	2058	309	1	80	0.0125000
NODE_430_length_3634_cov_34.913154	1978	2058	323	1	80	0.0125000
NODE_430_length_3634_cov_34.913154	1978	2058	328	2	80	0.0250000
NODE_430_length_3634_cov_34.913154	1978	2058	332	1	80	0.0125000
NODE_430_length_3634_cov_34.913154	1978	2058	339	2	80	0.0250000
NODE_430_length_3634_cov_34.913154	1978	2058	349	1	80	0.0125000
NODE_430_length_3634_cov_34.913154	1978	2058	367	1	80	0.0125000
NODE_430_length_3634_cov_34.913154	1978	2058	376	1	80	0.0125000
NODE_430_length_3634_cov_34.913154	1978	2058	380	2	80	0.0250000
NODE_430_length_3634_cov_34.913154	1978	2058	381	1	80	0.0125000
NODE_430_length_3634_cov_34.913154	1978	2058	383	1	80	0.0125000
NODE_430_length_3634_cov_34.913154	1978	2058	387	1	80	0.0125000
NODE_430_length_3634_cov_34.913154	1978	2058	398	1	80	0.0125000
NODE_430_length_3634_cov_34.913154	1978	2058	411	1	80	0.0125000
NODE_430_length_3634_cov_34.913154	1978	2058	417	1	80	0.0125000
NODE_430_length_3634_cov_34.913154	1978	2058	427	1	80	0.0125000
NODE_430_length_3634_cov_34.913154	1978	2058	433	2	80	0.0250000
NODE_430_length_3634_cov_34.913154	1978	2058	445	1	80	0.0125000
NODE_430_length_3634_cov_34.913154	1978	2058	448	1	80	0.0125000
NODE_430_length_3634_cov_34.913154	1978	2058	456	1	80	0.0125000
NODE_430_length_3634_cov_34.913154	1978	2058	458	1	80	0.0125000
NODE_430_length_3634_cov_34.913154	2031	2077	30	1	46	0.0217391
NODE_430_length_3634_cov_34.913154	2031	2077	36	1	46	0.0217391
NODE_430_length_3634_cov_34.913154	2031	2077	42	1	46	0.0217391
NODE_430_length_3634_cov_34.913154	2031	2077	48	1	46	0.0217391
NODE_430_length_3634_cov_34.913154	2031	2077	51	1	46	0.0217391
NODE_430_length_3634_cov_34.913154	2031	2077	55	1	46	0.0217391
NODE_430_length_3634_cov_34.913154	2031	2077	65	1	46	0.0217391
NODE_430_length_3634_cov_34.913154	2031	2077	75	1	46	0.0217391
NODE_430_length_3634_cov_34.913154	2031	2077	79	1	46	0.0217391
NODE_430_length_3634_cov_34.913154	2031	2077	81	1	46	0.0217391
NODE_430_length_3634_cov_34.913154	2031	2077	85	1	46	0.0217391
NODE_430_length_3634_cov_34.913154	2031	2077	87	1	46	0.0217391
NODE_430_length_3634_cov_34.913154	2031	2077	91	2	46	0.0434783
NODE_430_length_3634_cov_34.913154	2031	2077	101	1	46	0.0217391
NODE_430_length_3634_cov_34.913154	2031	2077	103	1	46	0.0217391
NODE_430_length_3634_cov_34.913154	2031	2077	106	1	46	0.0217391
NODE_430_length_3634_cov_34.913154	2031	2077	107	1	46	0.0217391
NODE_430_length_3634_cov_34.913154	2031	2077	115	1	46	0.0217391
NODE_430_length_3634_cov_34.913154	2031	2077	121	1	46	0.0217391
NODE_430_length_3634_cov_34.913154	2031	2077	123	1	46	0.0217391
NODE_430_length_3634_cov_34.913154	2031	2077	124	1	46	0.0217391
NODE_430_length_3634_cov_34.913154	2031	2077	134	1	46	0.0217391
NODE_430_length_3634_cov_34.913154	2031	2077	145	1	46	0.0217391
NODE_430_length_3634_cov_34.913154	2031	2077	148	2	46	0.0434783
NODE_430_length_3634_cov_34.913154	2031	2077	150	3	46	0.0652174
NODE_430_length_3634_cov_34.913154	2031	2077	154	1	46	0.0217391
NODE_430_length_3634_cov_34.913154	2031	2077	162	1	46	0.0217391
NODE_430_length_3634_cov_34.913154	2031	2077	165	1	46	0.0217391
NODE_430_length_3634_cov_34.913154	2031	2077	172	1	46	0.0217391
NODE_430_length_3634_cov_34.913154	2031	2077	178	1	46	0.0217391
NODE_430_length_3634_cov_34.913154	2031	2077	180	1	46	0.0217391
NODE_430_length_3634_cov_34.913154	2031	2077	185	1	46	0.0217391
NODE_430_length_3634_cov_34.913154	2031	2077	186	1	46	0.0217391
NODE_430_length_3634_cov_34.913154	2031	2077	191	4	46	0.0869565
NODE_430_length_3634_cov_34.913154	2031	2077	199	2	46	0.0434783
NODE_430_length_3634_cov_34.913154	2031	2077	202	1	46	0.0217391
NODE_430_length_3634_cov_34.913154	2031	2077	204	1	46	0.0217391
NODE_430_length_3634_cov_34.913154	2031	2077	212	1	46	0.0217391
NODE_435_length_3622_cov_29.112120	201	281	0	80	80	1.0000000
NODE_435_length_3622_cov_29.112120	254	334	0	65	80	0.8125000
NODE_435_length_3622_cov_29.112120	254	334	2	15	80	0.1875000
NODE_435_length_3622_cov_29.112120	2310	2390	40	1	80	0.0125000
NODE_435_length_3622_cov_29.112120	2310	2390	44	8	80	0.1000000
NODE_435_length_3622_cov_29.112120	2310	2390	46	1	80	0.0125000
NODE_435_length_3622_cov_29.112120	2310	2390	50	4	80	0.0500000
NODE_435_length_3622_cov_29.112120	2310	2390	51	3	80	0.0375000
NODE_435_length_3622_cov_29.112120	2310	2390	53	1	80	0.0125000
NODE_435_length_3622_cov_29.112120	2310	2390	59	1	80	0.0125000
NODE_435_length_3622_cov_29.112120	2310	2390	61	2	80	0.0250000
NODE_435_length_3622_cov_29.112120	2310	2390	63	1	80	0.0125000
NODE_435_length_3622_cov_29.112120	2310	2390	67	1	80	0.0125000
NODE_435_length_3622_cov_29.112120	2310	2390	71	1	80	0.0125000
NODE_435_length_3622_cov_29.112120	2310	2390	77	1	80	0.0125000
NODE_435_length_3622_cov_29.112120	2310	2390	78	1	80	0.0125000
NODE_435_length_3622_cov_29.112120	2310	2390	82	1	80	0.0125000
NODE_435_length_3622_cov_29.112120	2310	2390	84	6	80	0.0750000
NODE_435_length_3622_cov_29.112120	2310	2390	86	1	80	0.0125000
NODE_435_length_3622_cov_29.112120	2310	2390	88	1	80	0.0125000
NODE_435_length_3622_cov_29.112120	2310	2390	91	1	80	0.0125000
NODE_435_length_3622_cov_29.112120	2310	2390	93	1	80	0.0125000
NODE_435_length_3622_cov_29.112120	2310	2390	98	1	80	0.0125000
NODE_435_length_3622_cov_29.112120	2310	2390	100	3	80	0.0375000
NODE_435_length_3622_cov_29.112120	2310	2390	108	2	80	0.0250000
NODE_435_length_3622_cov_29.112120	2310	2390	110	3	80	0.0375000
NODE_435_length_3622_cov_29.112120	2310	2390	114	1	80	0.0125000
NODE_435_length_3622_cov_29.112120	2310	2390	116	1	80	0.0125000
NODE_435_length_3622_cov_29.112120	2310	2390	118	7	80	0.0875000
NODE_435_length_3622_cov_29.112120	2310	2390	120	2	80	0.0250000
NODE_435_length_3622_cov_29.112120	2310	2390	125	3	80	0.0375000
NODE_435_length_3622_cov_29.112120	2310	2390	127	1	80	0.0125000
NODE_435_length_3622_cov_29.112120	2310	2390	131	1	80	0.0125000
NODE_435_length_3622_cov_29.112120	2310	2390	133	1	80	0.0125000
NODE_435_length_3622_cov_29.112120	2310	2390	136	1	80	0.0125000
NODE_435_length_3622_cov_29.112120	2310	2390	137	1	80	0.0125000
NODE_435_length_3622_cov_29.112120	2310	2390	138	1	80	0.0125000
NODE_435_length_3622_cov_29.112120	2310	2390	140	2	80	0.0250000
NODE_435_length_3622_cov_29.112120	2310	2390	142	2	80	0.0250000
NODE_435_length_3622_cov_29.112120	2310	2390	144	9	80	0.1125000
NODE_435_length_3622_cov_29.112120	2310	2390	148	1	80	0.0125000
NODE_435_length_3622_cov_29.112120	2363	2441	2	7	78	0.0897436
NODE_435_length_3622_cov_29.112120	2363	2441	4	1	78	0.0128205
NODE_435_length_3622_cov_29.112120	2363	2441	6	1	78	0.0128205
NODE_435_length_3622_cov_29.112120	2363	2441	7	7	78	0.0897436
NODE_435_length_3622_cov_29.112120	2363	2441	11	1	78	0.0128205
NODE_435_length_3622_cov_29.112120	2363	2441	12	1	78	0.0128205
NODE_435_length_3622_cov_29.112120	2363	2441	14	1	78	0.0128205
NODE_435_length_3622_cov_29.112120	2363	2441	17	7	78	0.0897436
NODE_435_length_3622_cov_29.112120	2363	2441	18	2	78	0.0256410
NODE_435_length_3622_cov_29.112120	2363	2441	21	10	78	0.1282051
NODE_435_length_3622_cov_29.112120	2363	2441	23	2	78	0.0256410
NODE_435_length_3622_cov_29.112120	2363	2441	27	5	78	0.0641026
NODE_435_length_3622_cov_29.112120	2363	2441	29	2	78	0.0256410
NODE_435_length_3622_cov_29.112120	2363	2441	33	1	78	0.0128205
NODE_435_length_3622_cov_29.112120	2363	2441	37	2	78	0.0256410
NODE_435_length_3622_cov_29.112120	2363	2441	40	2	78	0.0256410
NODE_435_length_3622_cov_29.112120	2363	2441	44	8	78	0.1025641
NODE_435_length_3622_cov_29.112120	2363	2441	46	1	78	0.0128205
NODE_435_length_3622_cov_29.112120	2363	2441	50	4	78	0.0512821
NODE_435_length_3622_cov_29.112120	2363	2441	51	3	78	0.0384615
NODE_435_length_3622_cov_29.112120	2363	2441	53	1	78	0.0128205
NODE_435_length_3622_cov_29.112120	2363	2441	59	1	78	0.0128205
NODE_435_length_3622_cov_29.112120	2363	2441	61	2	78	0.0256410
NODE_435_length_3622_cov_29.112120	2363	2441	63	1	78	0.0128205
NODE_435_length_3622_cov_29.112120	2363	2441	67	1	78	0.0128205
NODE_435_length_3622_cov_29.112120	2363	2441	71	1	78	0.0128205
NODE_435_length_3622_cov_29.112120	2363	2441	77	1	78	0.0128205
NODE_435_length_3622_cov_29.112120	2363	2441	78	1	78	0.0128205
NODE_435_length_3622_cov_29.112120	2363	2441	82	1	78	0.0128205
NODE_437_length_3610_cov_8.785816	294	340	6	20	46	0.4347826
NODE_437_length_3610_cov_8.785816	294	340	12	26	46	0.5652174
NODE_437_length_3610_cov_8.785816	313	393	6	1	80	0.0125000
NODE_437_length_3610_cov_8.785816	313	393	10	6	80	0.0750000
NODE_437_length_3610_cov_8.785816	313	393	12	73	80	0.9125000
NODE_444_length_3588_cov_16.296360	2421	2501	0	16	80	0.2000000
NODE_444_length_3588_cov_16.296360	2421	2501	2	64	80	0.8000000
NODE_444_length_3588_cov_16.296360	2474	2539	0	33	65	0.5076923
NODE_444_length_3588_cov_16.296360	2474	2539	2	32	65	0.4923077
NODE_447_length_3585_cov_2.283419	605	668	0	63	63	1.0000000
NODE_451_length_3567_cov_16.283160	410	429	8	5	19	0.2631579
NODE_451_length_3567_cov_16.283160	410	429	10	13	19	0.6842105
NODE_451_length_3567_cov_16.283160	410	429	16	1	19	0.0526316
NODE_451_length_3567_cov_16.283160	2259	2339	364	1	80	0.0125000
NODE_451_length_3567_cov_16.283160	2259	2339	368	1	80	0.0125000
NODE_451_length_3567_cov_16.283160	2259	2339	369	1	80	0.0125000
NODE_451_length_3567_cov_16.283160	2259	2339	370	1	80	0.0125000
NODE_451_length_3567_cov_16.283160	2259	2339	371	1	80	0.0125000
NODE_451_length_3567_cov_16.283160	2259	2339	372	1	80	0.0125000
NODE_451_length_3567_cov_16.283160	2259	2339	373	2	80	0.0250000
NODE_451_length_3567_cov_16.283160	2259	2339	374	2	80	0.0250000
NODE_451_length_3567_cov_16.283160	2259	2339	375	4	80	0.0500000
NODE_451_length_3567_cov_16.283160	2259	2339	376	1	80	0.0125000
NODE_451_length_3567_cov_16.283160	2259	2339	377	1	80	0.0125000
NODE_451_length_3567_cov_16.283160	2259	2339	378	1	80	0.0125000
NODE_451_length_3567_cov_16.283160	2259	2339	381	1	80	0.0125000
NODE_451_length_3567_cov_16.283160	2259	2339	382	1	80	0.0125000
NODE_451_length_3567_cov_16.283160	2259	2339	383	2	80	0.0250000
NODE_451_length_3567_cov_16.283160	2259	2339	386	1	80	0.0125000
NODE_451_length_3567_cov_16.283160	2259	2339	387	1	80	0.0125000
NODE_451_length_3567_cov_16.283160	2259	2339	388	2	80	0.0250000
NODE_451_length_3567_cov_16.283160	2259	2339	389	2	80	0.0250000
NODE_451_length_3567_cov_16.283160	2259	2339	390	5	80	0.0625000
NODE_451_length_3567_cov_16.283160	2259	2339	392	2	80	0.0250000
NODE_451_length_3567_cov_16.283160	2259	2339	393	1	80	0.0125000
NODE_451_length_3567_cov_16.283160	2259	2339	394	2	80	0.0250000
NODE_451_length_3567_cov_16.283160	2259	2339	395	1	80	0.0125000
NODE_451_length_3567_cov_16.283160	2259	2339	396	3	80	0.0375000
NODE_451_length_3567_cov_16.283160	2259	2339	397	1	80	0.0125000
NODE_451_length_3567_cov_16.283160	2259	2339	402	1	80	0.0125000
NODE_451_length_3567_cov_16.283160	2259	2339	408	2	80	0.0250000
NODE_451_length_3567_cov_16.283160	2259	2339	412	3	80	0.0375000
NODE_451_length_3567_cov_16.283160	2259	2339	413	6	80	0.0750000
NODE_451_length_3567_cov_16.283160	2259	2339	414	3	80	0.0375000
NODE_451_length_3567_cov_16.283160	2259	2339	415	4	80	0.0500000
NODE_451_length_3567_cov_16.283160	2259	2339	416	4	80	0.0500000
NODE_451_length_3567_cov_16.283160	2259	2339	417	1	80	0.0125000
NODE_451_length_3567_cov_16.283160	2259	2339	418	2	80	0.0250000
NODE_451_length_3567_cov_16.283160	2259	2339	420	4	80	0.0500000
NODE_451_length_3567_cov_16.283160	2259	2339	421	1	80	0.0125000
NODE_451_length_3567_cov_16.283160	2259	2339	422	5	80	0.0625000
NODE_451_length_3567_cov_16.283160	2259	2339	424	1	80	0.0125000
NODE_451_length_3567_cov_16.283160	2259	2339	425	1	80	0.0125000
NODE_451_length_3567_cov_16.283160	2312	2379	7	1	67	0.0149254
NODE_451_length_3567_cov_16.283160	2312	2379	23	1	67	0.0149254
NODE_451_length_3567_cov_16.283160	2312	2379	31	1	67	0.0149254
NODE_451_length_3567_cov_16.283160	2312	2379	32	1	67	0.0149254
NODE_451_length_3567_cov_16.283160	2312	2379	39	1	67	0.0149254
NODE_451_length_3567_cov_16.283160	2312	2379	61	1	67	0.0149254
NODE_451_length_3567_cov_16.283160	2312	2379	74	2	67	0.0298507
NODE_451_length_3567_cov_16.283160	2312	2379	79	1	67	0.0149254
NODE_451_length_3567_cov_16.283160	2312	2379	81	1	67	0.0149254
NODE_451_length_3567_cov_16.283160	2312	2379	116	1	67	0.0149254
NODE_451_length_3567_cov_16.283160	2312	2379	137	1	67	0.0149254
NODE_451_length_3567_cov_16.283160	2312	2379	142	1	67	0.0149254
NODE_451_length_3567_cov_16.283160	2312	2379	165	1	67	0.0149254
NODE_451_length_3567_cov_16.283160	2312	2379	167	1	67	0.0149254
NODE_451_length_3567_cov_16.283160	2312	2379	169	2	67	0.0298507
NODE_451_length_3567_cov_16.283160	2312	2379	196	1	67	0.0149254
NODE_451_length_3567_cov_16.283160	2312	2379	199	1	67	0.0149254
NODE_451_length_3567_cov_16.283160	2312	2379	223	1	67	0.0149254
NODE_451_length_3567_cov_16.283160	2312	2379	227	1	67	0.0149254
NODE_451_length_3567_cov_16.283160	2312	2379	252	1	67	0.0149254
NODE_451_length_3567_cov_16.283160	2312	2379	254	1	67	0.0149254
NODE_451_length_3567_cov_16.283160	2312	2379	269	1	67	0.0149254
NODE_451_length_3567_cov_16.283160	2312	2379	270	1	67	0.0149254
NODE_451_length_3567_cov_16.283160	2312	2379	290	1	67	0.0149254
NODE_451_length_3567_cov_16.283160	2312	2379	300	1	67	0.0149254
NODE_451_length_3567_cov_16.283160	2312	2379	306	1	67	0.0149254
NODE_451_length_3567_cov_16.283160	2312	2379	310	1	67	0.0149254
NODE_451_length_3567_cov_16.283160	2312	2379	311	1	67	0.0149254
NODE_451_length_3567_cov_16.283160	2312	2379	322	1	67	0.0149254
NODE_451_length_3567_cov_16.283160	2312	2379	327	1	67	0.0149254
NODE_451_length_3567_cov_16.283160	2312	2379	329	1	67	0.0149254
NODE_451_length_3567_cov_16.283160	2312	2379	335	2	67	0.0298507
NODE_451_length_3567_cov_16.283160	2312	2379	338	1	67	0.0149254
NODE_451_length_3567_cov_16.283160	2312	2379	345	1	67	0.0149254
NODE_451_length_3567_cov_16.283160	2312	2379	359	1	67	0.0149254
NODE_451_length_3567_cov_16.283160	2312	2379	360	1	67	0.0149254
NODE_451_length_3567_cov_16.283160	2312	2379	362	1	67	0.0149254
NODE_451_length_3567_cov_16.283160	2312	2379	364	1	67	0.0149254
NODE_451_length_3567_cov_16.283160	2312	2379	368	1	67	0.0149254
NODE_451_length_3567_cov_16.283160	2312	2379	370	1	67	0.0149254
NODE_451_length_3567_cov_16.283160	2312	2379	371	1	67	0.0149254
NODE_451_length_3567_cov_16.283160	2312	2379	374	2	67	0.0298507
NODE_451_length_3567_cov_16.283160	2312	2379	375	3	67	0.0447761
NODE_451_length_3567_cov_16.283160	2312	2379	376	1	67	0.0149254
NODE_451_length_3567_cov_16.283160	2312	2379	377	1	67	0.0149254
NODE_451_length_3567_cov_16.283160	2312	2379	381	1	67	0.0149254
NODE_451_length_3567_cov_16.283160	2312	2379	382	1	67	0.0149254
NODE_451_length_3567_cov_16.283160	2312	2379	383	1	67	0.0149254
NODE_451_length_3567_cov_16.283160	2312	2379	387	1	67	0.0149254
NODE_451_length_3567_cov_16.283160	2312	2379	388	2	67	0.0298507
NODE_451_length_3567_cov_16.283160	2312	2379	389	2	67	0.0298507
NODE_451_length_3567_cov_16.283160	2312	2379	390	5	67	0.0746269
NODE_451_length_3567_cov_16.283160	2312	2379	392	2	67	0.0298507
NODE_451_length_3567_cov_16.283160	2312	2379	393	1	67	0.0149254
NODE_454_length_3557_cov_12.423077	640	718	0	78	78	1.0000000
NODE_454_length_3557_cov_12.423077	640	688	0	48	48	1.0000000
NODE_454_length_3557_cov_12.423077	640	688	0	48	48	1.0000000
NODE_454_length_3557_cov_12.423077	640	688	0	48	48	1.0000000
NODE_454_length_3557_cov_12.423077	640	688	0	48	48	1.0000000
NODE_454_length_3557_cov_12.423077	693	771	0	78	78	1.0000000
NODE_455_length_3548_cov_7.216295	554	634	0	80	80	1.0000000
NODE_455_length_3548_cov_7.216295	607	687	0	80	80	1.0000000
NODE_461_length_3518_cov_40.508336	1320	1400	16	25	80	0.3125000
NODE_461_length_3518_cov_40.508336	1320	1400	17	6	80	0.0750000
NODE_461_length_3518_cov_40.508336	1320	1400	18	21	80	0.2625000
NODE_461_length_3518_cov_40.508336	1320	1400	24	28	80	0.3500000
NODE_461_length_3518_cov_40.508336	1373	1453	10	16	80	0.2000000
NODE_461_length_3518_cov_40.508336	1373	1453	12	31	80	0.3875000
NODE_461_length_3518_cov_40.508336	1373	1453	24	33	80	0.4125000
NODE_465_length_3497_cov_65.791348	3062	3142	406	1	80	0.0125000
NODE_465_length_3497_cov_65.791348	3062	3142	407	1	80	0.0125000
NODE_465_length_3497_cov_65.791348	3062	3142	409	1	80	0.0125000
NODE_465_length_3497_cov_65.791348	3062	3142	410	1	80	0.0125000
NODE_465_length_3497_cov_65.791348	3062	3142	412	1	80	0.0125000
NODE_465_length_3497_cov_65.791348	3062	3142	413	1	80	0.0125000
NODE_465_length_3497_cov_65.791348	3062	3142	414	2	80	0.0250000
NODE_465_length_3497_cov_65.791348	3062	3142	417	1	80	0.0125000
NODE_465_length_3497_cov_65.791348	3062	3142	419	1	80	0.0125000
NODE_465_length_3497_cov_65.791348	3062	3142	424	1	80	0.0125000
NODE_465_length_3497_cov_65.791348	3062	3142	427	1	80	0.0125000
NODE_465_length_3497_cov_65.791348	3062	3142	429	1	80	0.0125000
NODE_465_length_3497_cov_65.791348	3062	3142	437	1	80	0.0125000
NODE_465_length_3497_cov_65.791348	3062	3142	445	1	80	0.0125000
NODE_465_length_3497_cov_65.791348	3062	3142	458	1	80	0.0125000
NODE_465_length_3497_cov_65.791348	3062	3142	474	1	80	0.0125000
NODE_465_length_3497_cov_65.791348	3062	3142	475	1	80	0.0125000
NODE_465_length_3497_cov_65.791348	3062	3142	481	1	80	0.0125000
NODE_465_length_3497_cov_65.791348	3062	3142	483	1	80	0.0125000
NODE_465_length_3497_cov_65.791348	3062	3142	486	1	80	0.0125000
NODE_465_length_3497_cov_65.791348	3062	3142	489	1	80	0.0125000
NODE_465_length_3497_cov_65.791348	3062	3142	493	2	80	0.0250000
NODE_465_length_3497_cov_65.791348	3062	3142	495	1	80	0.0125000
NODE_465_length_3497_cov_65.791348	3062	3142	501	1	80	0.0125000
NODE_465_length_3497_cov_65.791348	3062	3142	506	1	80	0.0125000
NODE_465_length_3497_cov_65.791348	3062	3142	510	1	80	0.0125000
NODE_465_length_3497_cov_65.791348	3062	3142	513	1	80	0.0125000
NODE_465_length_3497_cov_65.791348	3062	3142	515	3	80	0.0375000
NODE_465_length_3497_cov_65.791348	3062	3142	516	2	80	0.0250000
NODE_465_length_3497_cov_65.791348	3062	3142	517	4	80	0.0500000
NODE_465_length_3497_cov_65.791348	3062	3142	518	3	80	0.0375000
NODE_465_length_3497_cov_65.791348	3062	3142	519	4	80	0.0500000
NODE_465_length_3497_cov_65.791348	3062	3142	520	1	80	0.0125000
NODE_465_length_3497_cov_65.791348	3062	3142	521	5	80	0.0625000
NODE_465_length_3497_cov_65.791348	3062	3142	522	4	80	0.0500000
NODE_465_length_3497_cov_65.791348	3062	3142	524	1	80	0.0125000
NODE_465_length_3497_cov_65.791348	3062	3142	525	1	80	0.0125000
NODE_465_length_3497_cov_65.791348	3062	3142	526	1	80	0.0125000
NODE_465_length_3497_cov_65.791348	3062	3142	527	1	80	0.0125000
NODE_465_length_3497_cov_65.791348	3062	3142	528	1	80	0.0125000
NODE_465_length_3497_cov_65.791348	3062	3142	529	4	80	0.0500000
NODE_465_length_3497_cov_65.791348	3062	3142	530	1	80	0.0125000
NODE_465_length_3497_cov_65.791348	3062	3142	531	1	80	0.0125000
NODE_465_length_3497_cov_65.791348	3062	3142	532	2	80	0.0250000
NODE_465_length_3497_cov_65.791348	3062	3142	533	2	80	0.0250000
NODE_465_length_3497_cov_65.791348	3062	3142	534	2	80	0.0250000
NODE_465_length_3497_cov_65.791348	3062	3142	535	1	80	0.0125000
NODE_465_length_3497_cov_65.791348	3062	3142	539	1	80	0.0125000
NODE_465_length_3497_cov_65.791348	3062	3142	541	1	80	0.0125000
NODE_465_length_3497_cov_65.791348	3062	3142	544	3	80	0.0375000
NODE_465_length_3497_cov_65.791348	3062	3142	545	1	80	0.0125000
NODE_465_length_3497_cov_65.791348	3062	3142	548	1	80	0.0125000
NODE_466_length_3488_cov_2.243730	506	529	0	11	23	0.4782609
NODE_466_length_3488_cov_2.243730	506	529	1	12	23	0.5217391
NODE_470_length_3483_cov_14.759456	360	440	2	33	80	0.4125000
NODE_470_length_3483_cov_14.759456	360	440	4	2	80	0.0250000
NODE_470_length_3483_cov_14.759456	360	440	8	45	80	0.5625000
NODE_470_length_3483_cov_14.759456	413	493	4	16	80	0.2000000
NODE_470_length_3483_cov_14.759456	413	493	8	60	80	0.7500000
NODE_470_length_3483_cov_14.759456	413	493	10	4	80	0.0500000
NODE_474_length_3471_cov_37.887604	2795	2875	0	23	80	0.2875000
NODE_474_length_3471_cov_37.887604	2795	2875	2	57	80	0.7125000
NODE_474_length_3471_cov_37.887604	2848	2928	0	76	80	0.9500000
NODE_474_length_3471_cov_37.887604	2848	2928	2	4	80	0.0500000
NODE_474_length_3471_cov_37.887604	2924	2943	0	19	19	1.0000000
NODE_474_length_3471_cov_37.887604	2924	3004	0	80	80	1.0000000
NODE_474_length_3471_cov_37.887604	2977	3057	0	80	80	1.0000000
NODE_479_length_3451_cov_29.833234	2973	3053	0	30	80	0.3750000
NODE_479_length_3451_cov_29.833234	2973	3053	2	7	80	0.0875000
NODE_479_length_3451_cov_29.833234	2973	3053	4	43	80	0.5375000
NODE_479_length_3451_cov_29.833234	3026	3106	0	13	80	0.1625000
NODE_479_length_3451_cov_29.833234	3026	3106	2	7	80	0.0875000
NODE_479_length_3451_cov_29.833234	3026	3106	4	60	80	0.7500000
NODE_481_length_3446_cov_32.421273	3181	3261	18	38	80	0.4750000
NODE_481_length_3446_cov_32.421273	3181	3261	20	7	80	0.0875000
NODE_481_length_3446_cov_32.421273	3181	3261	22	30	80	0.3750000
NODE_481_length_3446_cov_32.421273	3181	3261	24	5	80	0.0625000
NODE_482_length_3444_cov_29.954858	792	872	2	58	80	0.7250000
NODE_482_length_3444_cov_29.954858	792	872	4	3	80	0.0375000
NODE_482_length_3444_cov_29.954858	792	872	5	2	80	0.0250000
NODE_482_length_3444_cov_29.954858	792	872	6	17	80	0.2125000
NODE_482_length_3444_cov_29.954858	845	925	2	8	80	0.1000000
NODE_482_length_3444_cov_29.954858	845	925	5	2	80	0.0250000
NODE_482_length_3444_cov_29.954858	845	925	6	70	80	0.8750000
NODE_483_length_3442_cov_17.799880	3155	3220	13	1	65	0.0153846
NODE_483_length_3442_cov_17.799880	3155	3220	36	1	65	0.0153846
NODE_483_length_3442_cov_17.799880	3155	3220	38	6	65	0.0923077
NODE_483_length_3442_cov_17.799880	3155	3220	39	1	65	0.0153846
NODE_483_length_3442_cov_17.799880	3155	3220	40	1	65	0.0153846
NODE_483_length_3442_cov_17.799880	3155	3220	59	2	65	0.0307692
NODE_483_length_3442_cov_17.799880	3155	3220	63	1	65	0.0153846
NODE_483_length_3442_cov_17.799880	3155	3220	64	1	65	0.0153846
NODE_483_length_3442_cov_17.799880	3155	3220	72	1	65	0.0153846
NODE_483_length_3442_cov_17.799880	3155	3220	76	1	65	0.0153846
NODE_483_length_3442_cov_17.799880	3155	3220	80	1	65	0.0153846
NODE_483_length_3442_cov_17.799880	3155	3220	84	1	65	0.0153846
NODE_483_length_3442_cov_17.799880	3155	3220	94	1	65	0.0153846
NODE_483_length_3442_cov_17.799880	3155	3220	96	1	65	0.0153846
NODE_483_length_3442_cov_17.799880	3155	3220	108	1	65	0.0153846
NODE_483_length_3442_cov_17.799880	3155	3220	110	2	65	0.0307692
NODE_483_length_3442_cov_17.799880	3155	3220	121	1	65	0.0153846
NODE_483_length_3442_cov_17.799880	3155	3220	124	1	65	0.0153846
NODE_483_length_3442_cov_17.799880	3155	3220	136	1	65	0.0153846
NODE_483_length_3442_cov_17.799880	3155	3220	138	1	65	0.0153846
NODE_483_length_3442_cov_17.799880	3155	3220	143	1	65	0.0153846
NODE_483_length_3442_cov_17.799880	3155	3220	145	2	65	0.0307692
NODE_483_length_3442_cov_17.799880	3155	3220	155	1	65	0.0153846
NODE_483_length_3442_cov_17.799880	3155	3220	167	1	65	0.0153846
NODE_483_length_3442_cov_17.799880	3155	3220	169	1	65	0.0153846
NODE_483_length_3442_cov_17.799880	3155	3220	185	1	65	0.0153846
NODE_483_length_3442_cov_17.799880	3155	3220	190	1	65	0.0153846
NODE_483_length_3442_cov_17.799880	3155	3220	199	1	65	0.0153846
NODE_483_length_3442_cov_17.799880	3155	3220	205	1	65	0.0153846
NODE_483_length_3442_cov_17.799880	3155	3220	206	3	65	0.0461538
NODE_483_length_3442_cov_17.799880	3155	3220	208	2	65	0.0307692
NODE_483_length_3442_cov_17.799880	3155	3220	213	1	65	0.0153846
NODE_483_length_3442_cov_17.799880	3155	3220	217	1	65	0.0153846
NODE_483_length_3442_cov_17.799880	3155	3220	226	12	65	0.1846154
NODE_483_length_3442_cov_17.799880	3155	3220	230	1	65	0.0153846
NODE_483_length_3442_cov_17.799880	3155	3220	250	1	65	0.0153846
NODE_483_length_3442_cov_17.799880	3155	3220	252	1	65	0.0153846
NODE_483_length_3442_cov_17.799880	3155	3220	254	2	65	0.0307692
NODE_483_length_3442_cov_17.799880	3155	3220	256	4	65	0.0615385
NODE_483_length_3442_cov_17.799880	3208	3273	226	3	65	0.0461538
NODE_483_length_3442_cov_17.799880	3208	3273	230	1	65	0.0153846
NODE_483_length_3442_cov_17.799880	3208	3273	236	1	65	0.0153846
NODE_483_length_3442_cov_17.799880	3208	3273	238	1	65	0.0153846
NODE_483_length_3442_cov_17.799880	3208	3273	240	2	65	0.0307692
NODE_483_length_3442_cov_17.799880	3208	3273	242	1	65	0.0153846
NODE_483_length_3442_cov_17.799880	3208	3273	244	1	65	0.0153846
NODE_483_length_3442_cov_17.799880	3208	3273	249	1	65	0.0153846
NODE_483_length_3442_cov_17.799880	3208	3273	250	1	65	0.0153846
NODE_483_length_3442_cov_17.799880	3208	3273	252	1	65	0.0153846
NODE_483_length_3442_cov_17.799880	3208	3273	254	2	65	0.0307692
NODE_483_length_3442_cov_17.799880	3208	3273	256	9	65	0.1384615
NODE_483_length_3442_cov_17.799880	3208	3273	257	1	65	0.0153846
NODE_483_length_3442_cov_17.799880	3208	3273	260	5	65	0.0769231
NODE_483_length_3442_cov_17.799880	3208	3273	261	1	65	0.0153846
NODE_483_length_3442_cov_17.799880	3208	3273	262	1	65	0.0153846
NODE_483_length_3442_cov_17.799880	3208	3273	264	4	65	0.0615385
NODE_483_length_3442_cov_17.799880	3208	3273	265	3	65	0.0461538
NODE_483_length_3442_cov_17.799880	3208	3273	266	2	65	0.0307692
NODE_483_length_3442_cov_17.799880	3208	3273	267	2	65	0.0307692
NODE_483_length_3442_cov_17.799880	3208	3273	268	1	65	0.0153846
NODE_483_length_3442_cov_17.799880	3208	3273	270	1	65	0.0153846
NODE_483_length_3442_cov_17.799880	3208	3273	271	7	65	0.1076923
NODE_483_length_3442_cov_17.799880	3208	3273	272	1	65	0.0153846
NODE_483_length_3442_cov_17.799880	3208	3273	274	1	65	0.0153846
NODE_483_length_3442_cov_17.799880	3208	3273	275	7	65	0.1076923
NODE_483_length_3442_cov_17.799880	3208	3273	276	1	65	0.0153846
NODE_483_length_3442_cov_17.799880	3208	3273	278	2	65	0.0307692
NODE_483_length_3442_cov_17.799880	3208	3273	280	1	65	0.0153846
NODE_486_length_3429_cov_5.070270	125	148	27	9	23	0.3913043
NODE_486_length_3429_cov_5.070270	125	148	29	9	23	0.3913043
NODE_486_length_3429_cov_5.070270	125	148	31	4	23	0.1739130
NODE_486_length_3429_cov_5.070270	125	148	33	1	23	0.0434783
NODE_493_length_3408_cov_2.406769	0	45	0	45	45	1.0000000
NODE_495_length_3405_cov_44.930127	2683	2759	14	24	76	0.3157895
NODE_495_length_3405_cov_44.930127	2683	2759	15	3	76	0.0394737
NODE_495_length_3405_cov_44.930127	2683	2759	16	2	76	0.0263158
NODE_495_length_3405_cov_44.930127	2683	2759	17	2	76	0.0263158
NODE_495_length_3405_cov_44.930127	2683	2759	19	45	76	0.5921053
NODE_495_length_3405_cov_44.930127	3116	3164	0	48	48	1.0000000
NODE_496_length_3402_cov_28.961550	128	183	2	55	55	1.0000000
NODE_496_length_3402_cov_28.961550	3154	3234	39	2	80	0.0250000
NODE_496_length_3402_cov_28.961550	3154	3234	42	1	80	0.0125000
NODE_496_length_3402_cov_28.961550	3154	3234	44	13	80	0.1625000
NODE_496_length_3402_cov_28.961550	3154	3234	48	2	80	0.0250000
NODE_496_length_3402_cov_28.961550	3154	3234	50	1	80	0.0125000
NODE_496_length_3402_cov_28.961550	3154	3234	54	1	80	0.0125000
NODE_496_length_3402_cov_28.961550	3154	3234	56	9	80	0.1125000
NODE_496_length_3402_cov_28.961550	3154	3234	59	3	80	0.0375000
NODE_496_length_3402_cov_28.961550	3154	3234	60	5	80	0.0625000
NODE_496_length_3402_cov_28.961550	3154	3234	61	11	80	0.1375000
NODE_496_length_3402_cov_28.961550	3154	3234	62	21	80	0.2625000
NODE_496_length_3402_cov_28.961550	3154	3234	63	10	80	0.1250000
NODE_496_length_3402_cov_28.961550	3154	3234	64	1	80	0.0125000
NODE_496_length_3402_cov_28.961550	3207	3287	0	15	80	0.1875000
NODE_496_length_3402_cov_28.961550	3207	3287	2	3	80	0.0375000
NODE_496_length_3402_cov_28.961550	3207	3287	6	8	80	0.1000000
NODE_496_length_3402_cov_28.961550	3207	3287	8	2	80	0.0250000
NODE_496_length_3402_cov_28.961550	3207	3287	14	1	80	0.0125000
NODE_496_length_3402_cov_28.961550	3207	3287	18	3	80	0.0375000
NODE_496_length_3402_cov_28.961550	3207	3287	22	2	80	0.0250000
NODE_496_length_3402_cov_28.961550	3207	3287	24	6	80	0.0750000
NODE_496_length_3402_cov_28.961550	3207	3287	28	2	80	0.0250000
NODE_496_length_3402_cov_28.961550	3207	3287	30	1	80	0.0125000
NODE_496_length_3402_cov_28.961550	3207	3287	32	1	80	0.0125000
NODE_496_length_3402_cov_28.961550	3207	3287	33	2	80	0.0250000
NODE_496_length_3402_cov_28.961550	3207	3287	35	5	80	0.0625000
NODE_496_length_3402_cov_28.961550	3207	3287	37	2	80	0.0250000
NODE_496_length_3402_cov_28.961550	3207	3287	39	2	80	0.0250000
NODE_496_length_3402_cov_28.961550	3207	3287	42	1	80	0.0125000
NODE_496_length_3402_cov_28.961550	3207	3287	44	13	80	0.1625000
NODE_496_length_3402_cov_28.961550	3207	3287	48	2	80	0.0250000
NODE_496_length_3402_cov_28.961550	3207	3287	50	1	80	0.0125000
NODE_496_length_3402_cov_28.961550	3207	3287	54	1	80	0.0125000
NODE_496_length_3402_cov_28.961550	3207	3287	56	7	80	0.0875000
NODE_498_length_3393_cov_43.623558	1009	1075	14	1	66	0.0151515
NODE_498_length_3393_cov_43.623558	1009	1075	15	1	66	0.0151515
NODE_498_length_3393_cov_43.623558	1009	1075	17	2	66	0.0303030
NODE_498_length_3393_cov_43.623558	1009	1075	22	1	66	0.0151515
NODE_498_length_3393_cov_43.623558	1009	1075	24	3	66	0.0454545
NODE_498_length_3393_cov_43.623558	1009	1075	26	2	66	0.0303030
NODE_498_length_3393_cov_43.623558	1009	1075	30	2	66	0.0303030
NODE_498_length_3393_cov_43.623558	1009	1075	33	1	66	0.0151515
NODE_498_length_3393_cov_43.623558	1009	1075	37	1	66	0.0151515
NODE_498_length_3393_cov_43.623558	1009	1075	38	2	66	0.0303030
NODE_498_length_3393_cov_43.623558	1009	1075	40	1	66	0.0151515
NODE_498_length_3393_cov_43.623558	1009	1075	42	3	66	0.0454545
NODE_498_length_3393_cov_43.623558	1009	1075	44	2	66	0.0303030
NODE_498_length_3393_cov_43.623558	1009	1075	46	1	66	0.0151515
NODE_498_length_3393_cov_43.623558	1009	1075	50	1	66	0.0151515
NODE_498_length_3393_cov_43.623558	1009	1075	57	1	66	0.0151515
NODE_498_length_3393_cov_43.623558	1009	1075	61	1	66	0.0151515
NODE_498_length_3393_cov_43.623558	1009	1075	62	3	66	0.0454545
NODE_498_length_3393_cov_43.623558	1009	1075	64	1	66	0.0151515
NODE_498_length_3393_cov_43.623558	1009	1075	68	1	66	0.0151515
NODE_498_length_3393_cov_43.623558	1009	1075	70	1	66	0.0151515
NODE_498_length_3393_cov_43.623558	1009	1075	73	1	66	0.0151515
NODE_498_length_3393_cov_43.623558	1009	1075	75	2	66	0.0303030
NODE_498_length_3393_cov_43.623558	1009	1075	77	1	66	0.0151515
NODE_498_length_3393_cov_43.623558	1009	1075	81	2	66	0.0303030
NODE_498_length_3393_cov_43.623558	1009	1075	84	1	66	0.0151515
NODE_498_length_3393_cov_43.623558	1009	1075	90	1	66	0.0151515
NODE_498_length_3393_cov_43.623558	1009	1075	98	1	66	0.0151515
NODE_498_length_3393_cov_43.623558	1009	1075	106	1	66	0.0151515
NODE_498_length_3393_cov_43.623558	1009	1075	110	1	66	0.0151515
NODE_498_length_3393_cov_43.623558	1009	1075	112	1	66	0.0151515
NODE_498_length_3393_cov_43.623558	1009	1075	116	1	66	0.0151515
NODE_498_length_3393_cov_43.623558	1009	1075	118	1	66	0.0151515
NODE_498_length_3393_cov_43.623558	1009	1075	124	1	66	0.0151515
NODE_498_length_3393_cov_43.623558	1009	1075	132	3	66	0.0454545
NODE_498_length_3393_cov_43.623558	1009	1075	134	3	66	0.0454545
NODE_498_length_3393_cov_43.623558	1009	1075	141	3	66	0.0454545
NODE_498_length_3393_cov_43.623558	1009	1075	142	4	66	0.0606061
NODE_498_length_3393_cov_43.623558	1009	1075	144	5	66	0.0757576
NODE_498_length_3393_cov_43.623558	1009	1075	153	1	66	0.0151515
NODE_498_length_3393_cov_43.623558	1048	1128	2	7	80	0.0875000
NODE_498_length_3393_cov_43.623558	1048	1128	4	11	80	0.1375000
NODE_498_length_3393_cov_43.623558	1048	1128	5	14	80	0.1750000
NODE_498_length_3393_cov_43.623558	1048	1128	6	2	80	0.0250000
NODE_498_length_3393_cov_43.623558	1048	1128	7	2	80	0.0250000
NODE_498_length_3393_cov_43.623558	1048	1128	8	15	80	0.1875000
NODE_498_length_3393_cov_43.623558	1048	1128	13	1	80	0.0125000
NODE_498_length_3393_cov_43.623558	1048	1128	14	2	80	0.0250000
NODE_498_length_3393_cov_43.623558	1048	1128	15	1	80	0.0125000
NODE_498_length_3393_cov_43.623558	1048	1128	17	2	80	0.0250000
NODE_498_length_3393_cov_43.623558	1048	1128	22	1	80	0.0125000
NODE_498_length_3393_cov_43.623558	1048	1128	24	3	80	0.0375000
NODE_498_length_3393_cov_43.623558	1048	1128	26	2	80	0.0250000
NODE_498_length_3393_cov_43.623558	1048	1128	30	2	80	0.0250000
NODE_498_length_3393_cov_43.623558	1048	1128	33	1	80	0.0125000
NODE_498_length_3393_cov_43.623558	1048	1128	37	1	80	0.0125000
NODE_498_length_3393_cov_43.623558	1048	1128	38	2	80	0.0250000
NODE_498_length_3393_cov_43.623558	1048	1128	40	1	80	0.0125000
NODE_498_length_3393_cov_43.623558	1048	1128	42	3	80	0.0375000
NODE_498_length_3393_cov_43.623558	1048	1128	44	2	80	0.0250000
NODE_498_length_3393_cov_43.623558	1048	1128	46	1	80	0.0125000
NODE_498_length_3393_cov_43.623558	1048	1128	50	1	80	0.0125000
NODE_498_length_3393_cov_43.623558	1048	1128	57	1	80	0.0125000
NODE_498_length_3393_cov_43.623558	1048	1128	61	1	80	0.0125000
NODE_498_length_3393_cov_43.623558	1048	1128	62	1	80	0.0125000
NODE_498_length_3393_cov_43.623558	3086	3128	13	1	42	0.0238095
NODE_498_length_3393_cov_43.623558	3086	3128	47	2	42	0.0476190
NODE_498_length_3393_cov_43.623558	3086	3128	77	1	42	0.0238095
NODE_498_length_3393_cov_43.623558	3086	3128	95	1	42	0.0238095
NODE_498_length_3393_cov_43.623558	3086	3128	123	1	42	0.0238095
NODE_498_length_3393_cov_43.623558	3086	3128	129	1	42	0.0238095
NODE_498_length_3393_cov_43.623558	3086	3128	138	1	42	0.0238095
NODE_498_length_3393_cov_43.623558	3086	3128	146	1	42	0.0238095
NODE_498_length_3393_cov_43.623558	3086	3128	151	1	42	0.0238095
NODE_498_length_3393_cov_43.623558	3086	3128	155	1	42	0.0238095
NODE_498_length_3393_cov_43.623558	3086	3128	159	3	42	0.0714286
NODE_498_length_3393_cov_43.623558	3086	3128	163	1	42	0.0238095
NODE_498_length_3393_cov_43.623558	3086	3128	165	2	42	0.0476190
NODE_498_length_3393_cov_43.623558	3086	3128	167	3	42	0.0714286
NODE_498_length_3393_cov_43.623558	3086	3128	173	1	42	0.0238095
NODE_498_length_3393_cov_43.623558	3086	3128	181	1	42	0.0238095
NODE_498_length_3393_cov_43.623558	3086	3128	193	1	42	0.0238095
NODE_498_length_3393_cov_43.623558	3086	3128	195	1	42	0.0238095
NODE_498_length_3393_cov_43.623558	3086	3128	201	2	42	0.0476190
NODE_498_length_3393_cov_43.623558	3086	3128	211	1	42	0.0238095
NODE_498_length_3393_cov_43.623558	3086	3128	217	1	42	0.0238095
NODE_498_length_3393_cov_43.623558	3086	3128	218	2	42	0.0476190
NODE_498_length_3393_cov_43.623558	3086	3128	221	1	42	0.0238095
NODE_498_length_3393_cov_43.623558	3086	3128	224	1	42	0.0238095
NODE_498_length_3393_cov_43.623558	3086	3128	226	1	42	0.0238095
NODE_498_length_3393_cov_43.623558	3086	3128	228	3	42	0.0714286
NODE_498_length_3393_cov_43.623558	3086	3128	232	1	42	0.0238095
NODE_498_length_3393_cov_43.623558	3086	3128	239	1	42	0.0238095
NODE_498_length_3393_cov_43.623558	3086	3128	245	2	42	0.0476190
NODE_498_length_3393_cov_43.623558	3086	3128	249	1	42	0.0238095
NODE_498_length_3393_cov_43.623558	3086	3128	260	1	42	0.0238095
NODE_498_length_3393_cov_43.623558	3293	3373	94	2	80	0.0250000
NODE_498_length_3393_cov_43.623558	3293	3373	98	1	80	0.0125000
NODE_498_length_3393_cov_43.623558	3293	3373	105	1	80	0.0125000
NODE_498_length_3393_cov_43.623558	3293	3373	117	1	80	0.0125000
NODE_498_length_3393_cov_43.623558	3293	3373	136	1	80	0.0125000
NODE_498_length_3393_cov_43.623558	3293	3373	150	3	80	0.0375000
NODE_498_length_3393_cov_43.623558	3293	3373	152	1	80	0.0125000
NODE_498_length_3393_cov_43.623558	3293	3373	162	2	80	0.0250000
NODE_498_length_3393_cov_43.623558	3293	3373	175	1	80	0.0125000
NODE_498_length_3393_cov_43.623558	3293	3373	186	1	80	0.0125000
NODE_498_length_3393_cov_43.623558	3293	3373	204	1	80	0.0125000
NODE_498_length_3393_cov_43.623558	3293	3373	214	1	80	0.0125000
NODE_498_length_3393_cov_43.623558	3293	3373	226	1	80	0.0125000
NODE_498_length_3393_cov_43.623558	3293	3373	238	1	80	0.0125000
NODE_498_length_3393_cov_43.623558	3293	3373	254	1	80	0.0125000
NODE_498_length_3393_cov_43.623558	3293	3373	267	1	80	0.0125000
NODE_498_length_3393_cov_43.623558	3293	3373	274	1	80	0.0125000
NODE_498_length_3393_cov_43.623558	3293	3373	293	1	80	0.0125000
NODE_498_length_3393_cov_43.623558	3293	3373	295	1	80	0.0125000
NODE_498_length_3393_cov_43.623558	3293	3373	299	1	80	0.0125000
NODE_498_length_3393_cov_43.623558	3293	3373	313	1	80	0.0125000
NODE_498_length_3393_cov_43.623558	3293	3373	347	1	80	0.0125000
NODE_498_length_3393_cov_43.623558	3293	3373	350	1	80	0.0125000
NODE_498_length_3393_cov_43.623558	3293	3373	362	1	80	0.0125000
NODE_498_length_3393_cov_43.623558	3293	3373	368	1	80	0.0125000
NODE_498_length_3393_cov_43.623558	3293	3373	373	1	80	0.0125000
NODE_498_length_3393_cov_43.623558	3293	3373	381	2	80	0.0250000
NODE_498_length_3393_cov_43.623558	3293	3373	387	2	80	0.0250000
NODE_498_length_3393_cov_43.623558	3293	3373	401	2	80	0.0250000
NODE_498_length_3393_cov_43.623558	3293	3373	406	1	80	0.0125000
NODE_498_length_3393_cov_43.623558	3293	3373	408	1	80	0.0125000
NODE_498_length_3393_cov_43.623558	3293	3373	410	1	80	0.0125000
NODE_498_length_3393_cov_43.623558	3293	3373	413	1	80	0.0125000
NODE_498_length_3393_cov_43.623558	3293	3373	414	1	80	0.0125000
NODE_498_length_3393_cov_43.623558	3293	3373	418	2	80	0.0250000
NODE_498_length_3393_cov_43.623558	3293	3373	425	2	80	0.0250000
NODE_498_length_3393_cov_43.623558	3293	3373	427	2	80	0.0250000
NODE_498_length_3393_cov_43.623558	3293	3373	430	1	80	0.0125000
NODE_498_length_3393_cov_43.623558	3293	3373	434	4	80	0.0500000
NODE_498_length_3393_cov_43.623558	3293	3373	436	1	80	0.0125000
NODE_498_length_3393_cov_43.623558	3293	3373	438	1	80	0.0125000
NODE_498_length_3393_cov_43.623558	3293	3373	441	2	80	0.0250000
NODE_498_length_3393_cov_43.623558	3293	3373	443	2	80	0.0250000
NODE_498_length_3393_cov_43.623558	3293	3373	450	1	80	0.0125000
NODE_498_length_3393_cov_43.623558	3293	3373	454	1	80	0.0125000
NODE_498_length_3393_cov_43.623558	3293	3373	455	1	80	0.0125000
NODE_498_length_3393_cov_43.623558	3293	3373	461	1	80	0.0125000
NODE_498_length_3393_cov_43.623558	3293	3373	477	1	80	0.0125000
NODE_498_length_3393_cov_43.623558	3293	3373	486	1	80	0.0125000
NODE_498_length_3393_cov_43.623558	3293	3373	488	1	80	0.0125000
NODE_498_length_3393_cov_43.623558	3293	3373	493	1	80	0.0125000
NODE_498_length_3393_cov_43.623558	3293	3373	494	1	80	0.0125000
NODE_498_length_3393_cov_43.623558	3293	3373	498	1	80	0.0125000
NODE_498_length_3393_cov_43.623558	3293	3373	506	1	80	0.0125000
NODE_498_length_3393_cov_43.623558	3293	3373	508	1	80	0.0125000
NODE_498_length_3393_cov_43.623558	3293	3373	510	1	80	0.0125000
NODE_498_length_3393_cov_43.623558	3293	3373	514	1	80	0.0125000
NODE_498_length_3393_cov_43.623558	3293	3373	517	1	80	0.0125000
NODE_498_length_3393_cov_43.623558	3293	3373	521	1	80	0.0125000
NODE_498_length_3393_cov_43.623558	3293	3373	533	2	80	0.0250000
NODE_498_length_3393_cov_43.623558	3293	3373	535	2	80	0.0250000
NODE_498_length_3393_cov_43.623558	3293	3373	538	1	80	0.0125000
NODE_498_length_3393_cov_43.623558	3293	3373	542	1	80	0.0125000
NODE_499_length_3392_cov_41.514728	255	335	0	56	80	0.7000000
NODE_499_length_3392_cov_41.514728	255	335	2	24	80	0.3000000
NODE_499_length_3392_cov_41.514728	308	388	0	32	80	0.4000000
NODE_499_length_3392_cov_41.514728	308	388	2	48	80	0.6000000
NODE_499_length_3392_cov_41.514728	917	997	180	1	80	0.0125000
NODE_499_length_3392_cov_41.514728	917	997	181	1	80	0.0125000
NODE_499_length_3392_cov_41.514728	917	997	183	1	80	0.0125000
NODE_499_length_3392_cov_41.514728	917	997	184	1	80	0.0125000
NODE_499_length_3392_cov_41.514728	917	997	185	1	80	0.0125000
NODE_499_length_3392_cov_41.514728	917	997	188	1	80	0.0125000
NODE_499_length_3392_cov_41.514728	917	997	190	1	80	0.0125000
NODE_499_length_3392_cov_41.514728	917	997	192	3	80	0.0375000
NODE_499_length_3392_cov_41.514728	917	997	194	1	80	0.0125000
NODE_499_length_3392_cov_41.514728	917	997	195	1	80	0.0125000
NODE_499_length_3392_cov_41.514728	917	997	202	1	80	0.0125000
NODE_499_length_3392_cov_41.514728	917	997	203	1	80	0.0125000
NODE_499_length_3392_cov_41.514728	917	997	205	1	80	0.0125000
NODE_499_length_3392_cov_41.514728	917	997	211	1	80	0.0125000
NODE_499_length_3392_cov_41.514728	917	997	217	1	80	0.0125000
NODE_499_length_3392_cov_41.514728	917	997	226	1	80	0.0125000
NODE_499_length_3392_cov_41.514728	917	997	235	1	80	0.0125000
NODE_499_length_3392_cov_41.514728	917	997	252	1	80	0.0125000
NODE_499_length_3392_cov_41.514728	917	997	254	1	80	0.0125000
NODE_499_length_3392_cov_41.514728	917	997	255	1	80	0.0125000
NODE_499_length_3392_cov_41.514728	917	997	260	1	80	0.0125000
NODE_499_length_3392_cov_41.514728	917	997	274	1	80	0.0125000
NODE_499_length_3392_cov_41.514728	917	997	275	2	80	0.0250000
NODE_499_length_3392_cov_41.514728	917	997	280	2	80	0.0250000
NODE_499_length_3392_cov_41.514728	917	997	282	1	80	0.0125000
NODE_499_length_3392_cov_41.514728	917	997	291	1	80	0.0125000
NODE_499_length_3392_cov_41.514728	917	997	303	1	80	0.0125000
NODE_499_length_3392_cov_41.514728	917	997	307	1	80	0.0125000
NODE_499_length_3392_cov_41.514728	917	997	310	1	80	0.0125000
NODE_499_length_3392_cov_41.514728	917	997	313	1	80	0.0125000
NODE_499_length_3392_cov_41.514728	917	997	320	1	80	0.0125000
NODE_499_length_3392_cov_41.514728	917	997	326	1	80	0.0125000
NODE_499_length_3392_cov_41.514728	917	997	338	2	80	0.0250000
NODE_499_length_3392_cov_41.514728	917	997	340	2	80	0.0250000
NODE_499_length_3392_cov_41.514728	917	997	346	1	80	0.0125000
NODE_499_length_3392_cov_41.514728	917	997	357	4	80	0.0500000
NODE_499_length_3392_cov_41.514728	917	997	361	1	80	0.0125000
NODE_499_length_3392_cov_41.514728	917	997	362	1	80	0.0125000
NODE_499_length_3392_cov_41.514728	917	997	365	1	80	0.0125000
NODE_499_length_3392_cov_41.514728	917	997	370	1	80	0.0125000
NODE_499_length_3392_cov_41.514728	917	997	373	1	80	0.0125000
NODE_499_length_3392_cov_41.514728	917	997	381	1	80	0.0125000
NODE_499_length_3392_cov_41.514728	917	997	396	2	80	0.0250000
NODE_499_length_3392_cov_41.514728	917	997	397	1	80	0.0125000
NODE_499_length_3392_cov_41.514728	917	997	399	1	80	0.0125000
NODE_499_length_3392_cov_41.514728	917	997	418	1	80	0.0125000
NODE_499_length_3392_cov_41.514728	917	997	420	1	80	0.0125000
NODE_499_length_3392_cov_41.514728	917	997	436	1	80	0.0125000
NODE_499_length_3392_cov_41.514728	917	997	440	2	80	0.0250000
NODE_499_length_3392_cov_41.514728	917	997	445	1	80	0.0125000
NODE_499_length_3392_cov_41.514728	917	997	448	1	80	0.0125000
NODE_499_length_3392_cov_41.514728	917	997	452	1	80	0.0125000
NODE_499_length_3392_cov_41.514728	917	997	481	1	80	0.0125000
NODE_499_length_3392_cov_41.514728	917	997	486	1	80	0.0125000
NODE_499_length_3392_cov_41.514728	917	997	489	1	80	0.0125000
NODE_499_length_3392_cov_41.514728	917	997	499	1	80	0.0125000
NODE_499_length_3392_cov_41.514728	917	997	505	1	80	0.0125000
NODE_499_length_3392_cov_41.514728	917	997	510	1	80	0.0125000
NODE_499_length_3392_cov_41.514728	917	997	512	3	80	0.0375000
NODE_499_length_3392_cov_41.514728	917	997	513	1	80	0.0125000
NODE_499_length_3392_cov_41.514728	917	997	517	1	80	0.0125000
NODE_499_length_3392_cov_41.514728	917	997	519	1	80	0.0125000
NODE_499_length_3392_cov_41.514728	917	997	523	1	80	0.0125000
NODE_499_length_3392_cov_41.514728	917	997	524	1	80	0.0125000
NODE_499_length_3392_cov_41.514728	917	997	526	3	80	0.0375000
NODE_499_length_3392_cov_41.514728	970	1053	99	1	83	0.0120482
NODE_499_length_3392_cov_41.514728	970	1053	100	1	83	0.0120482
NODE_499_length_3392_cov_41.514728	970	1053	101	2	83	0.0240964
NODE_499_length_3392_cov_41.514728	970	1053	102	1	83	0.0120482
NODE_499_length_3392_cov_41.514728	970	1053	107	1	83	0.0120482
NODE_499_length_3392_cov_41.514728	970	1053	108	1	83	0.0120482
NODE_499_length_3392_cov_41.514728	970	1053	117	1	83	0.0120482
NODE_499_length_3392_cov_41.514728	970	1053	119	1	83	0.0120482
NODE_499_length_3392_cov_41.514728	970	1053	130	1	83	0.0120482
NODE_499_length_3392_cov_41.514728	970	1053	139	2	83	0.0240964
NODE_499_length_3392_cov_41.514728	970	1053	140	1	83	0.0120482
NODE_499_length_3392_cov_41.514728	970	1053	142	1	83	0.0120482
NODE_499_length_3392_cov_41.514728	970	1053	146	1	83	0.0120482
NODE_499_length_3392_cov_41.514728	970	1053	147	1	83	0.0120482
NODE_499_length_3392_cov_41.514728	970	1053	153	3	83	0.0361446
NODE_499_length_3392_cov_41.514728	970	1053	154	3	83	0.0361446
NODE_499_length_3392_cov_41.514728	970	1053	155	4	83	0.0481928
NODE_499_length_3392_cov_41.514728	970	1053	156	3	83	0.0361446
NODE_499_length_3392_cov_41.514728	970	1053	158	2	83	0.0240964
NODE_499_length_3392_cov_41.514728	970	1053	160	1	83	0.0120482
NODE_499_length_3392_cov_41.514728	970	1053	161	1	83	0.0120482
NODE_499_length_3392_cov_41.514728	970	1053	163	2	83	0.0240964
NODE_499_length_3392_cov_41.514728	970	1053	164	1	83	0.0120482
NODE_499_length_3392_cov_41.514728	970	1053	165	1	83	0.0120482
NODE_499_length_3392_cov_41.514728	970	1053	167	7	83	0.0843373
NODE_499_length_3392_cov_41.514728	970	1053	168	1	83	0.0120482
NODE_499_length_3392_cov_41.514728	970	1053	169	1	83	0.0120482
NODE_499_length_3392_cov_41.514728	970	1053	171	2	83	0.0240964
NODE_499_length_3392_cov_41.514728	970	1053	174	1	83	0.0120482
NODE_499_length_3392_cov_41.514728	970	1053	176	3	83	0.0361446
NODE_499_length_3392_cov_41.514728	970	1053	177	1	83	0.0120482
NODE_499_length_3392_cov_41.514728	970	1053	178	3	83	0.0361446
NODE_499_length_3392_cov_41.514728	970	1053	180	1	83	0.0120482
NODE_499_length_3392_cov_41.514728	970	1053	181	1	83	0.0120482
NODE_499_length_3392_cov_41.514728	970	1053	183	1	83	0.0120482
NODE_499_length_3392_cov_41.514728	970	1053	184	1	83	0.0120482
NODE_499_length_3392_cov_41.514728	970	1053	185	1	83	0.0120482
NODE_499_length_3392_cov_41.514728	970	1053	188	1	83	0.0120482
NODE_499_length_3392_cov_41.514728	970	1053	190	1	83	0.0120482
NODE_499_length_3392_cov_41.514728	970	1053	192	3	83	0.0361446
NODE_499_length_3392_cov_41.514728	970	1053	194	1	83	0.0120482
NODE_499_length_3392_cov_41.514728	970	1053	195	1	83	0.0120482
NODE_499_length_3392_cov_41.514728	970	1053	202	1	83	0.0120482
NODE_499_length_3392_cov_41.514728	970	1053	203	1	83	0.0120482
NODE_499_length_3392_cov_41.514728	970	1053	205	1	83	0.0120482
NODE_499_length_3392_cov_41.514728	970	1053	211	1	83	0.0120482
NODE_499_length_3392_cov_41.514728	970	1053	217	1	83	0.0120482
NODE_499_length_3392_cov_41.514728	970	1053	226	1	83	0.0120482
NODE_499_length_3392_cov_41.514728	970	1053	235	1	83	0.0120482
NODE_499_length_3392_cov_41.514728	970	1053	252	1	83	0.0120482
NODE_499_length_3392_cov_41.514728	970	1053	254	1	83	0.0120482
NODE_499_length_3392_cov_41.514728	970	1053	255	1	83	0.0120482
NODE_499_length_3392_cov_41.514728	970	1053	260	1	83	0.0120482
NODE_499_length_3392_cov_41.514728	970	1053	274	1	83	0.0120482
NODE_499_length_3392_cov_41.514728	970	1053	275	2	83	0.0240964
NODE_499_length_3392_cov_41.514728	970	1053	280	1	83	0.0120482
NODE_501_length_3389_cov_8.244073	2159	2239	0	69	80	0.8625000
NODE_501_length_3389_cov_8.244073	2159	2239	1	11	80	0.1375000
NODE_501_length_3389_cov_8.244073	2212	2292	0	16	80	0.2000000
NODE_501_length_3389_cov_8.244073	2212	2292	1	64	80	0.8000000
NODE_506_length_3363_cov_4.412684	56	124	28	1	68	0.0147059
NODE_506_length_3363_cov_4.412684	56	124	34	1	68	0.0147059
NODE_506_length_3363_cov_4.412684	56	124	36	1	68	0.0147059
NODE_506_length_3363_cov_4.412684	56	124	50	1	68	0.0147059
NODE_506_length_3363_cov_4.412684	56	124	52	1	68	0.0147059
NODE_506_length_3363_cov_4.412684	56	124	54	1	68	0.0147059
NODE_506_length_3363_cov_4.412684	56	124	58	1	68	0.0147059
NODE_506_length_3363_cov_4.412684	56	124	60	1	68	0.0147059
NODE_506_length_3363_cov_4.412684	56	124	64	1	68	0.0147059
NODE_506_length_3363_cov_4.412684	56	124	70	1	68	0.0147059
NODE_506_length_3363_cov_4.412684	56	124	84	2	68	0.0294118
NODE_506_length_3363_cov_4.412684	56	124	88	2	68	0.0294118
NODE_506_length_3363_cov_4.412684	56	124	92	1	68	0.0147059
NODE_506_length_3363_cov_4.412684	56	124	93	1	68	0.0147059
NODE_506_length_3363_cov_4.412684	56	124	94	1	68	0.0147059
NODE_506_length_3363_cov_4.412684	56	124	96	51	68	0.7500000
NODE_510_length_3353_cov_2.687462	0	61	0	61	61	1.0000000
NODE_510_length_3353_cov_2.687462	0	61	0	61	61	1.0000000
NODE_510_length_3353_cov_2.687462	34	99	0	65	65	1.0000000
NODE_513_length_3348_cov_243.959372	2473	2553	438	1	80	0.0125000
NODE_513_length_3348_cov_243.959372	2473	2553	441	1	80	0.0125000
NODE_513_length_3348_cov_243.959372	2473	2553	442	1	80	0.0125000
NODE_513_length_3348_cov_243.959372	2473	2553	443	1	80	0.0125000
NODE_513_length_3348_cov_243.959372	2473	2553	445	2	80	0.0250000
NODE_513_length_3348_cov_243.959372	2473	2553	446	1	80	0.0125000
NODE_513_length_3348_cov_243.959372	2473	2553	456	1	80	0.0125000
NODE_513_length_3348_cov_243.959372	2473	2553	459	2	80	0.0250000
NODE_513_length_3348_cov_243.959372	2473	2553	460	2	80	0.0250000
NODE_513_length_3348_cov_243.959372	2473	2553	472	1	80	0.0125000
NODE_513_length_3348_cov_243.959372	2473	2553	479	1	80	0.0125000
NODE_513_length_3348_cov_243.959372	2473	2553	482	1	80	0.0125000
NODE_513_length_3348_cov_243.959372	2473	2553	484	1	80	0.0125000
NODE_513_length_3348_cov_243.959372	2473	2553	485	1	80	0.0125000
NODE_513_length_3348_cov_243.959372	2473	2553	487	3	80	0.0375000
NODE_513_length_3348_cov_243.959372	2473	2553	488	2	80	0.0250000
NODE_513_length_3348_cov_243.959372	2473	2553	490	1	80	0.0125000
NODE_513_length_3348_cov_243.959372	2473	2553	491	2	80	0.0250000
NODE_513_length_3348_cov_243.959372	2473	2553	492	1	80	0.0125000
NODE_513_length_3348_cov_243.959372	2473	2553	493	3	80	0.0375000
NODE_513_length_3348_cov_243.959372	2473	2553	494	2	80	0.0250000
NODE_513_length_3348_cov_243.959372	2473	2553	496	3	80	0.0375000
NODE_513_length_3348_cov_243.959372	2473	2553	497	1	80	0.0125000
NODE_513_length_3348_cov_243.959372	2473	2553	498	3	80	0.0375000
NODE_513_length_3348_cov_243.959372	2473	2553	499	4	80	0.0500000
NODE_513_length_3348_cov_243.959372	2473	2553	500	3	80	0.0375000
NODE_513_length_3348_cov_243.959372	2473	2553	502	3	80	0.0375000
NODE_513_length_3348_cov_243.959372	2473	2553	503	2	80	0.0250000
NODE_513_length_3348_cov_243.959372	2473	2553	504	2	80	0.0250000
NODE_513_length_3348_cov_243.959372	2473	2553	505	1	80	0.0125000
NODE_513_length_3348_cov_243.959372	2473	2553	506	1	80	0.0125000
NODE_513_length_3348_cov_243.959372	2473	2553	507	1	80	0.0125000
NODE_513_length_3348_cov_243.959372	2473	2553	508	2	80	0.0250000
NODE_513_length_3348_cov_243.959372	2473	2553	510	1	80	0.0125000
NODE_513_length_3348_cov_243.959372	2473	2553	511	1	80	0.0125000
NODE_513_length_3348_cov_243.959372	2473	2553	512	1	80	0.0125000
NODE_513_length_3348_cov_243.959372	2473	2553	513	3	80	0.0375000
NODE_513_length_3348_cov_243.959372	2473	2553	516	1	80	0.0125000
NODE_513_length_3348_cov_243.959372	2473	2553	518	1	80	0.0125000
NODE_513_length_3348_cov_243.959372	2473	2553	523	1	80	0.0125000
NODE_513_length_3348_cov_243.959372	2473	2553	526	1	80	0.0125000
NODE_513_length_3348_cov_243.959372	2473	2553	527	1	80	0.0125000
NODE_513_length_3348_cov_243.959372	2473	2553	528	2	80	0.0250000
NODE_513_length_3348_cov_243.959372	2473	2553	529	1	80	0.0125000
NODE_513_length_3348_cov_243.959372	2473	2553	531	1	80	0.0125000
NODE_513_length_3348_cov_243.959372	2473	2553	532	2	80	0.0250000
NODE_513_length_3348_cov_243.959372	2473	2553	534	1	80	0.0125000
NODE_513_length_3348_cov_243.959372	2473	2553	540	1	80	0.0125000
NODE_513_length_3348_cov_243.959372	2473	2553	549	1	80	0.0125000
NODE_513_length_3348_cov_243.959372	2473	2553	556	1	80	0.0125000
NODE_513_length_3348_cov_243.959372	2473	2553	558	1	80	0.0125000
NODE_513_length_3348_cov_243.959372	2473	2553	560	1	80	0.0125000
NODE_513_length_3348_cov_243.959372	2526	2606	438	1	80	0.0125000
NODE_513_length_3348_cov_243.959372	2526	2606	441	1	80	0.0125000
NODE_513_length_3348_cov_243.959372	2526	2606	445	1	80	0.0125000
NODE_513_length_3348_cov_243.959372	2526	2606	456	1	80	0.0125000
NODE_513_length_3348_cov_243.959372	2526	2606	460	1	80	0.0125000
NODE_513_length_3348_cov_243.959372	2526	2606	479	1	80	0.0125000
NODE_513_length_3348_cov_243.959372	2526	2606	482	1	80	0.0125000
NODE_513_length_3348_cov_243.959372	2526	2606	485	1	80	0.0125000
NODE_513_length_3348_cov_243.959372	2526	2606	487	2	80	0.0250000
NODE_513_length_3348_cov_243.959372	2526	2606	490	1	80	0.0125000
NODE_513_length_3348_cov_243.959372	2526	2606	491	2	80	0.0250000
NODE_513_length_3348_cov_243.959372	2526	2606	492	3	80	0.0375000
NODE_513_length_3348_cov_243.959372	2526	2606	493	6	80	0.0750000
NODE_513_length_3348_cov_243.959372	2526	2606	494	1	80	0.0125000
NODE_513_length_3348_cov_243.959372	2526	2606	495	3	80	0.0375000
NODE_513_length_3348_cov_243.959372	2526	2606	496	5	80	0.0625000
NODE_513_length_3348_cov_243.959372	2526	2606	497	1	80	0.0125000
NODE_513_length_3348_cov_243.959372	2526	2606	498	3	80	0.0375000
NODE_513_length_3348_cov_243.959372	2526	2606	499	2	80	0.0250000
NODE_513_length_3348_cov_243.959372	2526	2606	500	3	80	0.0375000
NODE_513_length_3348_cov_243.959372	2526	2606	501	2	80	0.0250000
NODE_513_length_3348_cov_243.959372	2526	2606	502	1	80	0.0125000
NODE_513_length_3348_cov_243.959372	2526	2606	503	1	80	0.0125000
NODE_513_length_3348_cov_243.959372	2526	2606	504	1	80	0.0125000
NODE_513_length_3348_cov_243.959372	2526	2606	505	1	80	0.0125000
NODE_513_length_3348_cov_243.959372	2526	2606	506	3	80	0.0375000
NODE_513_length_3348_cov_243.959372	2526	2606	507	1	80	0.0125000
NODE_513_length_3348_cov_243.959372	2526	2606	508	3	80	0.0375000
NODE_513_length_3348_cov_243.959372	2526	2606	509	1	80	0.0125000
NODE_513_length_3348_cov_243.959372	2526	2606	511	2	80	0.0250000
NODE_513_length_3348_cov_243.959372	2526	2606	513	5	80	0.0625000
NODE_513_length_3348_cov_243.959372	2526	2606	516	1	80	0.0125000
NODE_513_length_3348_cov_243.959372	2526	2606	517	4	80	0.0500000
NODE_513_length_3348_cov_243.959372	2526	2606	518	1	80	0.0125000
NODE_513_length_3348_cov_243.959372	2526	2606	519	2	80	0.0250000
NODE_513_length_3348_cov_243.959372	2526	2606	520	2	80	0.0250000
NODE_513_length_3348_cov_243.959372	2526	2606	522	1	80	0.0125000
NODE_513_length_3348_cov_243.959372	2526	2606	523	1	80	0.0125000
NODE_513_length_3348_cov_243.959372	2526	2606	524	3	80	0.0375000
NODE_513_length_3348_cov_243.959372	2526	2606	528	1	80	0.0125000
NODE_513_length_3348_cov_243.959372	2526	2606	529	1	80	0.0125000
NODE_513_length_3348_cov_243.959372	2526	2606	530	1	80	0.0125000
NODE_513_length_3348_cov_243.959372	2526	2606	531	1	80	0.0125000
NODE_514_length_3348_cov_31.953216	103	183	6	16	80	0.2000000
NODE_514_length_3348_cov_31.953216	103	183	11	2	80	0.0250000
NODE_514_length_3348_cov_31.953216	103	183	13	2	80	0.0250000
NODE_514_length_3348_cov_31.953216	103	183	14	4	80	0.0500000
NODE_514_length_3348_cov_31.953216	103	183	16	5	80	0.0625000
NODE_514_length_3348_cov_31.953216	103	183	17	5	80	0.0625000
NODE_514_length_3348_cov_31.953216	103	183	23	10	80	0.1250000
NODE_514_length_3348_cov_31.953216	103	183	24	32	80	0.4000000
NODE_514_length_3348_cov_31.953216	103	183	25	4	80	0.0500000
NODE_514_length_3348_cov_31.953216	105	179	6	14	74	0.1891892
NODE_514_length_3348_cov_31.953216	105	179	11	2	74	0.0270270
NODE_514_length_3348_cov_31.953216	105	179	13	2	74	0.0270270
NODE_514_length_3348_cov_31.953216	105	179	14	4	74	0.0540541
NODE_514_length_3348_cov_31.953216	105	179	16	5	74	0.0675676
NODE_514_length_3348_cov_31.953216	105	179	17	5	74	0.0675676
NODE_514_length_3348_cov_31.953216	105	179	23	8	74	0.1081081
NODE_514_length_3348_cov_31.953216	105	179	24	32	74	0.4324324
NODE_514_length_3348_cov_31.953216	105	179	25	2	74	0.0270270
NODE_514_length_3348_cov_31.953216	156	236	12	13	80	0.1625000
NODE_514_length_3348_cov_31.953216	156	236	14	3	80	0.0375000
NODE_514_length_3348_cov_31.953216	156	236	19	2	80	0.0250000
NODE_514_length_3348_cov_31.953216	156	236	20	10	80	0.1250000
NODE_514_length_3348_cov_31.953216	156	236	22	4	80	0.0500000
NODE_514_length_3348_cov_31.953216	156	236	23	2	80	0.0250000
NODE_514_length_3348_cov_31.953216	156	236	24	28	80	0.3500000
NODE_514_length_3348_cov_31.953216	156	236	25	4	80	0.0500000
NODE_514_length_3348_cov_31.953216	156	236	26	14	80	0.1750000
NODE_514_length_3348_cov_31.953216	156	236	12	13	80	0.1625000
NODE_514_length_3348_cov_31.953216	156	236	14	3	80	0.0375000
NODE_514_length_3348_cov_31.953216	156	236	19	2	80	0.0250000
NODE_514_length_3348_cov_31.953216	156	236	20	10	80	0.1250000
NODE_514_length_3348_cov_31.953216	156	236	22	4	80	0.0500000
NODE_514_length_3348_cov_31.953216	156	236	23	2	80	0.0250000
NODE_514_length_3348_cov_31.953216	156	236	24	28	80	0.3500000
NODE_514_length_3348_cov_31.953216	156	236	25	4	80	0.0500000
NODE_514_length_3348_cov_31.953216	156	236	26	14	80	0.1750000
NODE_514_length_3348_cov_31.953216	2405	2476	101	1	71	0.0140845
NODE_514_length_3348_cov_31.953216	2405	2476	102	1	71	0.0140845
NODE_514_length_3348_cov_31.953216	2405	2476	108	1	71	0.0140845
NODE_514_length_3348_cov_31.953216	2405	2476	113	1	71	0.0140845
NODE_514_length_3348_cov_31.953216	2405	2476	121	1	71	0.0140845
NODE_514_length_3348_cov_31.953216	2405	2476	125	1	71	0.0140845
NODE_514_length_3348_cov_31.953216	2405	2476	126	4	71	0.0563380
NODE_514_length_3348_cov_31.953216	2405	2476	128	2	71	0.0281690
NODE_514_length_3348_cov_31.953216	2405	2476	130	2	71	0.0281690
NODE_514_length_3348_cov_31.953216	2405	2476	132	2	71	0.0281690
NODE_514_length_3348_cov_31.953216	2405	2476	134	1	71	0.0140845
NODE_514_length_3348_cov_31.953216	2405	2476	135	1	71	0.0140845
NODE_514_length_3348_cov_31.953216	2405	2476	139	3	71	0.0422535
NODE_514_length_3348_cov_31.953216	2405	2476	140	1	71	0.0140845
NODE_514_length_3348_cov_31.953216	2405	2476	143	1	71	0.0140845
NODE_514_length_3348_cov_31.953216	2405	2476	144	1	71	0.0140845
NODE_514_length_3348_cov_31.953216	2405	2476	145	2	71	0.0281690
NODE_514_length_3348_cov_31.953216	2405	2476	147	1	71	0.0140845
NODE_514_length_3348_cov_31.953216	2405	2476	154	1	71	0.0140845
NODE_514_length_3348_cov_31.953216	2405	2476	157	2	71	0.0281690
NODE_514_length_3348_cov_31.953216	2405	2476	162	1	71	0.0140845
NODE_514_length_3348_cov_31.953216	2405	2476	163	2	71	0.0281690
NODE_514_length_3348_cov_31.953216	2405	2476	171	1	71	0.0140845
NODE_514_length_3348_cov_31.953216	2405	2476	172	1	71	0.0140845
NODE_514_length_3348_cov_31.953216	2405	2476	175	1	71	0.0140845
NODE_514_length_3348_cov_31.953216	2405	2476	178	2	71	0.0281690
NODE_514_length_3348_cov_31.953216	2405	2476	179	1	71	0.0140845
NODE_514_length_3348_cov_31.953216	2405	2476	182	1	71	0.0140845
NODE_514_length_3348_cov_31.953216	2405	2476	184	1	71	0.0140845
NODE_514_length_3348_cov_31.953216	2405	2476	193	1	71	0.0140845
NODE_514_length_3348_cov_31.953216	2405	2476	196	2	71	0.0281690
NODE_514_length_3348_cov_31.953216	2405	2476	197	1	71	0.0140845
NODE_514_length_3348_cov_31.953216	2405	2476	199	1	71	0.0140845
NODE_514_length_3348_cov_31.953216	2405	2476	201	1	71	0.0140845
NODE_514_length_3348_cov_31.953216	2405	2476	208	1	71	0.0140845
NODE_514_length_3348_cov_31.953216	2405	2476	210	1	71	0.0140845
NODE_514_length_3348_cov_31.953216	2405	2476	212	1	71	0.0140845
NODE_514_length_3348_cov_31.953216	2405	2476	216	1	71	0.0140845
NODE_514_length_3348_cov_31.953216	2405	2476	218	1	71	0.0140845
NODE_514_length_3348_cov_31.953216	2405	2476	229	2	71	0.0281690
NODE_514_length_3348_cov_31.953216	2405	2476	235	2	71	0.0281690
NODE_514_length_3348_cov_31.953216	2405	2476	236	3	71	0.0422535
NODE_514_length_3348_cov_31.953216	2405	2476	238	1	71	0.0140845
NODE_514_length_3348_cov_31.953216	2405	2476	244	2	71	0.0281690
NODE_514_length_3348_cov_31.953216	2405	2476	250	1	71	0.0140845
NODE_514_length_3348_cov_31.953216	2405	2476	256	1	71	0.0140845
NODE_514_length_3348_cov_31.953216	2405	2476	258	1	71	0.0140845
NODE_514_length_3348_cov_31.953216	2405	2476	264	1	71	0.0140845
NODE_514_length_3348_cov_31.953216	2405	2476	266	2	71	0.0281690
NODE_514_length_3348_cov_31.953216	2405	2476	269	1	71	0.0140845
NODE_514_length_3348_cov_31.953216	2405	2476	272	1	71	0.0140845
NODE_514_length_3348_cov_31.953216	2405	2476	275	1	71	0.0140845
NODE_514_length_3348_cov_31.953216	2458	2529	229	1	71	0.0140845
NODE_514_length_3348_cov_31.953216	2458	2529	235	2	71	0.0281690
NODE_514_length_3348_cov_31.953216	2458	2529	236	3	71	0.0422535
NODE_514_length_3348_cov_31.953216	2458	2529	238	1	71	0.0140845
NODE_514_length_3348_cov_31.953216	2458	2529	244	2	71	0.0281690
NODE_514_length_3348_cov_31.953216	2458	2529	250	1	71	0.0140845
NODE_514_length_3348_cov_31.953216	2458	2529	256	2	71	0.0281690
NODE_514_length_3348_cov_31.953216	2458	2529	258	4	71	0.0563380
NODE_514_length_3348_cov_31.953216	2458	2529	262	2	71	0.0281690
NODE_514_length_3348_cov_31.953216	2458	2529	264	3	71	0.0422535
NODE_514_length_3348_cov_31.953216	2458	2529	266	2	71	0.0281690
NODE_514_length_3348_cov_31.953216	2458	2529	267	2	71	0.0281690
NODE_514_length_3348_cov_31.953216	2458	2529	269	2	71	0.0281690
NODE_514_length_3348_cov_31.953216	2458	2529	270	2	71	0.0281690
NODE_514_length_3348_cov_31.953216	2458	2529	272	5	71	0.0704225
NODE_514_length_3348_cov_31.953216	2458	2529	273	1	71	0.0140845
NODE_514_length_3348_cov_31.953216	2458	2529	274	1	71	0.0140845
NODE_514_length_3348_cov_31.953216	2458	2529	275	2	71	0.0281690
NODE_514_length_3348_cov_31.953216	2458	2529	276	1	71	0.0140845
NODE_514_length_3348_cov_31.953216	2458	2529	277	1	71	0.0140845
NODE_514_length_3348_cov_31.953216	2458	2529	278	1	71	0.0140845
NODE_514_length_3348_cov_31.953216	2458	2529	279	3	71	0.0422535
NODE_514_length_3348_cov_31.953216	2458	2529	282	1	71	0.0140845
NODE_514_length_3348_cov_31.953216	2458	2529	284	1	71	0.0140845
NODE_514_length_3348_cov_31.953216	2458	2529	285	3	71	0.0422535
NODE_514_length_3348_cov_31.953216	2458	2529	286	3	71	0.0422535
NODE_514_length_3348_cov_31.953216	2458	2529	287	1	71	0.0140845
NODE_514_length_3348_cov_31.953216	2458	2529	288	2	71	0.0281690
NODE_514_length_3348_cov_31.953216	2458	2529	290	1	71	0.0140845
NODE_514_length_3348_cov_31.953216	2458	2529	291	3	71	0.0422535
NODE_514_length_3348_cov_31.953216	2458	2529	292	2	71	0.0281690
NODE_514_length_3348_cov_31.953216	2458	2529	293	1	71	0.0140845
NODE_514_length_3348_cov_31.953216	2458	2529	294	2	71	0.0281690
NODE_514_length_3348_cov_31.953216	2458	2529	295	3	71	0.0422535
NODE_514_length_3348_cov_31.953216	2458	2529	296	2	71	0.0281690
NODE_514_length_3348_cov_31.953216	2458	2529	297	1	71	0.0140845
NODE_514_length_3348_cov_31.953216	2458	2529	299	1	71	0.0140845
NODE_517_length_3335_cov_19.649567	2100	2180	0	80	80	1.0000000
NODE_517_length_3335_cov_19.649567	2153	2233	0	80	80	1.0000000
NODE_517_length_3335_cov_19.649567	2229	2309	0	80	80	1.0000000
NODE_517_length_3335_cov_19.649567	2282	2362	0	80	80	1.0000000
NODE_518_length_3333_cov_24.805504	734	814	4	54	80	0.6750000
NODE_518_length_3333_cov_24.805504	734	814	8	26	80	0.3250000
NODE_518_length_3333_cov_24.805504	787	867	2	16	80	0.2000000
NODE_518_length_3333_cov_24.805504	787	867	4	28	80	0.3500000
NODE_518_length_3333_cov_24.805504	787	867	6	18	80	0.2250000
NODE_518_length_3333_cov_24.805504	787	867	8	18	80	0.2250000
NODE_523_length_3312_cov_6.996576	85	165	0	31	80	0.3875000
NODE_523_length_3312_cov_6.996576	85	165	2	14	80	0.1750000
NODE_523_length_3312_cov_6.996576	85	165	4	35	80	0.4375000
NODE_523_length_3312_cov_6.996576	138	218	0	14	80	0.1750000
NODE_523_length_3312_cov_6.996576	138	218	2	28	80	0.3500000
NODE_523_length_3312_cov_6.996576	138	218	4	38	80	0.4750000
NODE_525_length_3302_cov_3.859195	3184	3262	4	61	78	0.7820513
NODE_525_length_3302_cov_3.859195	3184	3262	6	17	78	0.2179487
NODE_525_length_3302_cov_3.859195	3184	3253	4	52	69	0.7536232
NODE_525_length_3302_cov_3.859195	3184	3253	6	17	69	0.2463768
NODE_526_length_3299_cov_6.014687	1632	1688	0	56	56	1.0000000
NODE_530_length_3290_cov_17.805390	773	853	6	4	80	0.0500000
NODE_530_length_3290_cov_17.805390	773	853	7	47	80	0.5875000
NODE_530_length_3290_cov_17.805390	773	853	8	6	80	0.0750000
NODE_530_length_3290_cov_17.805390	773	853	9	14	80	0.1750000
NODE_530_length_3290_cov_17.805390	773	853	10	9	80	0.1125000
NODE_530_length_3290_cov_17.805390	826	906	5	4	80	0.0500000
NODE_530_length_3290_cov_17.805390	826	906	6	53	80	0.6625000
NODE_530_length_3290_cov_17.805390	826	906	8	6	80	0.0750000
NODE_530_length_3290_cov_17.805390	826	906	9	8	80	0.1000000
NODE_530_length_3290_cov_17.805390	826	906	10	9	80	0.1125000
NODE_531_length_3290_cov_12.352554	2749	2829	0	80	80	1.0000000
NODE_531_length_3290_cov_12.352554	2802	2882	0	80	80	1.0000000
NODE_532_length_3286_cov_5.973015	0	50	0	2	50	0.0400000
NODE_532_length_3286_cov_5.973015	0	50	6	48	50	0.9600000
NODE_532_length_3286_cov_5.973015	0	50	0	2	50	0.0400000
NODE_532_length_3286_cov_5.973015	0	50	6	48	50	0.9600000
NODE_532_length_3286_cov_5.973015	0	50	0	2	50	0.0400000
NODE_532_length_3286_cov_5.973015	0	50	6	48	50	0.9600000
NODE_532_length_3286_cov_5.973015	23	89	6	66	66	1.0000000
NODE_532_length_3286_cov_5.973015	23	94	6	71	71	1.0000000
NODE_533_length_3284_cov_6.453689	313	392	0	79	79	1.0000000
NODE_533_length_3284_cov_6.453689	365	445	0	80	80	1.0000000
NODE_541_length_3267_cov_12.768624	11	91	0	7	80	0.0875000
NODE_541_length_3267_cov_12.768624	11	91	2	5	80	0.0625000
NODE_541_length_3267_cov_12.768624	11	91	4	1	80	0.0125000
NODE_541_length_3267_cov_12.768624	11	91	6	3	80	0.0375000
NODE_541_length_3267_cov_12.768624	11	91	14	4	80	0.0500000
NODE_541_length_3267_cov_12.768624	11	91	16	7	80	0.0875000
NODE_541_length_3267_cov_12.768624	11	91	20	1	80	0.0125000
NODE_541_length_3267_cov_12.768624	11	91	21	2	80	0.0250000
NODE_541_length_3267_cov_12.768624	11	91	24	5	80	0.0625000
NODE_541_length_3267_cov_12.768624	11	91	26	21	80	0.2625000
NODE_541_length_3267_cov_12.768624	11	91	27	23	80	0.2875000
NODE_541_length_3267_cov_12.768624	11	91	29	1	80	0.0125000
NODE_542_length_3266_cov_14.108304	2620	2684	8	4	64	0.0625000
NODE_542_length_3266_cov_14.108304	2620	2684	10	9	64	0.1406250
NODE_542_length_3266_cov_14.108304	2620	2684	12	51	64	0.7968750
NODE_542_length_3266_cov_14.108304	2620	2684	8	4	64	0.0625000
NODE_542_length_3266_cov_14.108304	2620	2684	10	9	64	0.1406250
NODE_542_length_3266_cov_14.108304	2620	2684	12	51	64	0.7968750
NODE_542_length_3266_cov_14.108304	2620	2684	8	4	64	0.0625000
NODE_542_length_3266_cov_14.108304	2620	2684	10	9	64	0.1406250
NODE_542_length_3266_cov_14.108304	2620	2684	12	51	64	0.7968750
NODE_547_length_3242_cov_12.407891	391	471	0	79	80	0.9875000
NODE_547_length_3242_cov_12.407891	391	471	2	1	80	0.0125000
NODE_547_length_3242_cov_12.407891	444	524	0	26	80	0.3250000
NODE_547_length_3242_cov_12.407891	444	524	2	54	80	0.6750000
NODE_550_length_3233_cov_19.903957	411	491	0	80	80	1.0000000
NODE_550_length_3233_cov_19.903957	411	491	0	80	80	1.0000000
NODE_550_length_3233_cov_19.903957	464	544	0	80	80	1.0000000
NODE_552_length_3232_cov_11.378870	2586	2621	0	10	35	0.2857143
NODE_552_length_3232_cov_11.378870	2586	2621	2	25	35	0.7142857
NODE_555_length_3214_cov_22.853291	2090	2170	66	4	80	0.0500000
NODE_555_length_3214_cov_22.853291	2090	2170	68	2	80	0.0250000
NODE_555_length_3214_cov_22.853291	2090	2170	76	3	80	0.0375000
NODE_555_length_3214_cov_22.853291	2090	2170	79	1	80	0.0125000
NODE_555_length_3214_cov_22.853291	2090	2170	80	1	80	0.0125000
NODE_555_length_3214_cov_22.853291	2090	2170	81	4	80	0.0500000
NODE_555_length_3214_cov_22.853291	2090	2170	82	2	80	0.0250000
NODE_555_length_3214_cov_22.853291	2090	2170	83	5	80	0.0625000
NODE_555_length_3214_cov_22.853291	2090	2170	84	6	80	0.0750000
NODE_555_length_3214_cov_22.853291	2090	2170	85	3	80	0.0375000
NODE_555_length_3214_cov_22.853291	2090	2170	86	5	80	0.0625000
NODE_555_length_3214_cov_22.853291	2090	2170	87	5	80	0.0625000
NODE_555_length_3214_cov_22.853291	2090	2170	88	2	80	0.0250000
NODE_555_length_3214_cov_22.853291	2090	2170	89	2	80	0.0250000
NODE_555_length_3214_cov_22.853291	2090	2170	91	2	80	0.0250000
NODE_555_length_3214_cov_22.853291	2090	2170	93	4	80	0.0500000
NODE_555_length_3214_cov_22.853291	2090	2170	95	14	80	0.1750000
NODE_555_length_3214_cov_22.853291	2090	2170	97	12	80	0.1500000
NODE_555_length_3214_cov_22.853291	2090	2170	99	3	80	0.0375000
NODE_555_length_3214_cov_22.853291	2143	2223	80	1	80	0.0125000
NODE_555_length_3214_cov_22.853291	2143	2223	81	5	80	0.0625000
NODE_555_length_3214_cov_22.853291	2143	2223	82	2	80	0.0250000
NODE_555_length_3214_cov_22.853291	2143	2223	83	2	80	0.0250000
NODE_555_length_3214_cov_22.853291	2143	2223	84	10	80	0.1250000
NODE_555_length_3214_cov_22.853291	2143	2223	85	1	80	0.0125000
NODE_555_length_3214_cov_22.853291	2143	2223	86	5	80	0.0625000
NODE_555_length_3214_cov_22.853291	2143	2223	87	5	80	0.0625000
NODE_555_length_3214_cov_22.853291	2143	2223	88	2	80	0.0250000
NODE_555_length_3214_cov_22.853291	2143	2223	89	2	80	0.0250000
NODE_555_length_3214_cov_22.853291	2143	2223	92	1	80	0.0125000
NODE_555_length_3214_cov_22.853291	2143	2223	93	1	80	0.0125000
NODE_555_length_3214_cov_22.853291	2143	2223	95	15	80	0.1875000
NODE_555_length_3214_cov_22.853291	2143	2223	96	1	80	0.0125000
NODE_555_length_3214_cov_22.853291	2143	2223	97	5	80	0.0625000
NODE_555_length_3214_cov_22.853291	2143	2223	98	1	80	0.0125000
NODE_555_length_3214_cov_22.853291	2143	2223	99	1	80	0.0125000
NODE_555_length_3214_cov_22.853291	2143	2223	100	3	80	0.0375000
NODE_555_length_3214_cov_22.853291	2143	2223	101	2	80	0.0250000
NODE_555_length_3214_cov_22.853291	2143	2223	103	1	80	0.0125000
NODE_555_length_3214_cov_22.853291	2143	2223	104	9	80	0.1125000
NODE_555_length_3214_cov_22.853291	2143	2223	105	1	80	0.0125000
NODE_555_length_3214_cov_22.853291	2143	2223	107	4	80	0.0500000
NODE_555_length_3214_cov_22.853291	3028	3086	0	2	58	0.0344828
NODE_555_length_3214_cov_22.853291	3028	3086	2	23	58	0.3965517
NODE_555_length_3214_cov_22.853291	3028	3086	4	18	58	0.3103448
NODE_555_length_3214_cov_22.853291	3028	3086	6	14	58	0.2413793
NODE_555_length_3214_cov_22.853291	3028	3086	18	1	58	0.0172414
NODE_556_length_3211_cov_1.921915	95	175	2	20	80	0.2500000
NODE_556_length_3211_cov_1.921915	95	175	4	1	80	0.0125000
NODE_556_length_3211_cov_1.921915	95	175	6	11	80	0.1375000
NODE_556_length_3211_cov_1.921915	95	175	8	8	80	0.1000000
NODE_556_length_3211_cov_1.921915	95	175	12	1	80	0.0125000
NODE_556_length_3211_cov_1.921915	95	175	14	10	80	0.1250000
NODE_556_length_3211_cov_1.921915	95	175	18	1	80	0.0125000
NODE_556_length_3211_cov_1.921915	95	175	20	9	80	0.1125000
NODE_556_length_3211_cov_1.921915	95	175	22	5	80	0.0625000
NODE_556_length_3211_cov_1.921915	95	175	26	14	80	0.1750000
NODE_556_length_3211_cov_1.921915	148	178	2	23	30	0.7666667
NODE_556_length_3211_cov_1.921915	148	178	4	1	30	0.0333333
NODE_556_length_3211_cov_1.921915	148	178	6	6	30	0.2000000
NODE_557_length_3210_cov_7.428480	2040	2111	6	10	71	0.1408451
NODE_557_length_3210_cov_7.428480	2040	2111	10	1	71	0.0140845
NODE_557_length_3210_cov_7.428480	2040	2111	14	2	71	0.0281690
NODE_557_length_3210_cov_7.428480	2040	2111	18	2	71	0.0281690
NODE_557_length_3210_cov_7.428480	2040	2111	20	2	71	0.0281690
NODE_557_length_3210_cov_7.428480	2040	2111	24	2	71	0.0281690
NODE_557_length_3210_cov_7.428480	2040	2111	26	4	71	0.0563380
NODE_557_length_3210_cov_7.428480	2040	2111	28	2	71	0.0281690
NODE_557_length_3210_cov_7.428480	2040	2111	30	17	71	0.2394366
NODE_557_length_3210_cov_7.428480	2040	2111	38	29	71	0.4084507
NODE_557_length_3210_cov_7.428480	2084	2164	18	5	80	0.0625000
NODE_557_length_3210_cov_7.428480	2084	2164	22	20	80	0.2500000
NODE_557_length_3210_cov_7.428480	2084	2164	26	3	80	0.0375000
NODE_557_length_3210_cov_7.428480	2084	2164	28	4	80	0.0500000
NODE_557_length_3210_cov_7.428480	2084	2164	30	6	80	0.0750000
NODE_557_length_3210_cov_7.428480	2084	2164	34	1	80	0.0125000
NODE_557_length_3210_cov_7.428480	2084	2164	36	7	80	0.0875000
NODE_557_length_3210_cov_7.428480	2084	2164	38	34	80	0.4250000
NODE_557_length_3210_cov_7.428480	2715	2797	0	82	82	1.0000000
NODE_557_length_3210_cov_7.428480	2770	2850	0	80	80	1.0000000
NODE_562_length_3201_cov_3.591231	3120	3200	0	42	80	0.5250000
NODE_562_length_3201_cov_3.591231	3120	3200	4	38	80	0.4750000
NODE_566_length_3189_cov_69.446602	137	188	0	29	51	0.5686275
NODE_566_length_3189_cov_69.446602	137	188	2	22	51	0.4313726
NODE_567_length_3188_cov_7.233085	1663	1743	11	5	80	0.0625000
NODE_567_length_3188_cov_7.233085	1663	1743	20	11	80	0.1375000
NODE_567_length_3188_cov_7.233085	1663	1743	21	20	80	0.2500000
NODE_567_length_3188_cov_7.233085	1663	1743	23	44	80	0.5500000
NODE_567_length_3188_cov_7.233085	1716	1796	9	11	80	0.1375000
NODE_567_length_3188_cov_7.233085	1716	1796	11	19	80	0.2375000
NODE_567_length_3188_cov_7.233085	1716	1796	13	28	80	0.3500000
NODE_567_length_3188_cov_7.233085	1716	1796	21	4	80	0.0500000
NODE_567_length_3188_cov_7.233085	1716	1796	23	18	80	0.2250000
NODE_570_length_3177_cov_2.789474	2021	2042	0	21	21	1.0000000
NODE_575_length_3158_cov_19.018960	840	920	0	80	80	1.0000000
NODE_575_length_3158_cov_19.018960	893	973	0	80	80	1.0000000
NODE_575_length_3158_cov_19.018960	2833	2915	0	82	82	1.0000000
NODE_575_length_3158_cov_19.018960	2888	2959	0	71	71	1.0000000
NODE_576_length_3150_cov_26.520813	770	850	18	6	80	0.0750000
NODE_576_length_3150_cov_26.520813	770	850	24	4	80	0.0500000
NODE_576_length_3150_cov_26.520813	770	850	26	9	80	0.1125000
NODE_576_length_3150_cov_26.520813	770	850	32	13	80	0.1625000
NODE_576_length_3150_cov_26.520813	770	850	34	18	80	0.2250000
NODE_576_length_3150_cov_26.520813	770	850	36	22	80	0.2750000
NODE_576_length_3150_cov_26.520813	770	850	38	8	80	0.1000000
NODE_576_length_3150_cov_26.520813	823	901	8	2	78	0.0256410
NODE_576_length_3150_cov_26.520813	823	901	12	12	78	0.1538462
NODE_576_length_3150_cov_26.520813	823	901	18	5	78	0.0641026
NODE_576_length_3150_cov_26.520813	823	901	20	5	78	0.0641026
NODE_576_length_3150_cov_26.520813	823	901	24	12	78	0.1538462
NODE_576_length_3150_cov_26.520813	823	901	30	2	78	0.0256410
NODE_576_length_3150_cov_26.520813	823	901	32	13	78	0.1666667
NODE_576_length_3150_cov_26.520813	823	901	34	18	78	0.2307692
NODE_576_length_3150_cov_26.520813	823	901	36	9	78	0.1153846
NODE_576_length_3150_cov_26.520813	2616	2696	0	2	80	0.0250000
NODE_576_length_3150_cov_26.520813	2616	2696	4	78	80	0.9750000
NODE_576_length_3150_cov_26.520813	2669	2749	0	55	80	0.6875000
NODE_576_length_3150_cov_26.520813	2669	2749	4	25	80	0.3125000
NODE_577_length_3150_cov_5.923959	2313	2393	0	80	80	1.0000000
NODE_579_length_3148_cov_2.313873	3053	3105	0	52	52	1.0000000
NODE_581_length_3146_cov_18.277322	2418	2498	0	62	80	0.7750000
NODE_581_length_3146_cov_18.277322	2418	2498	2	18	80	0.2250000
NODE_581_length_3146_cov_18.277322	2471	2551	0	9	80	0.1125000
NODE_581_length_3146_cov_18.277322	2471	2551	2	27	80	0.3375000
NODE_581_length_3146_cov_18.277322	2471	2551	4	35	80	0.4375000
NODE_581_length_3146_cov_18.277322	2471	2551	6	9	80	0.1125000
NODE_581_length_3146_cov_18.277322	2547	2627	4	29	80	0.3625000
NODE_581_length_3146_cov_18.277322	2547	2627	6	26	80	0.3250000
NODE_581_length_3146_cov_18.277322	2547	2627	8	3	80	0.0375000
NODE_581_length_3146_cov_18.277322	2547	2627	14	15	80	0.1875000
NODE_581_length_3146_cov_18.277322	2547	2627	18	7	80	0.0875000
NODE_581_length_3146_cov_18.277322	2600	2680	4	2	80	0.0250000
NODE_581_length_3146_cov_18.277322	2600	2680	6	3	80	0.0375000
NODE_581_length_3146_cov_18.277322	2600	2680	14	15	80	0.1875000
NODE_581_length_3146_cov_18.277322	2600	2680	18	44	80	0.5500000
NODE_581_length_3146_cov_18.277322	2600	2680	20	16	80	0.2000000
NODE_581_length_3146_cov_18.277322	2975	3055	7	7	80	0.0875000
NODE_581_length_3146_cov_18.277322	2975	3055	8	5	80	0.0625000
NODE_581_length_3146_cov_18.277322	2975	3055	10	68	80	0.8500000
NODE_585_length_3134_cov_8.717957	1290	1362	32	1	72	0.0138889
NODE_585_length_3134_cov_8.717957	1290	1362	34	13	72	0.1805556
NODE_585_length_3134_cov_8.717957	1290	1362	38	5	72	0.0694444
NODE_585_length_3134_cov_8.717957	1290	1362	44	3	72	0.0416667
NODE_585_length_3134_cov_8.717957	1290	1362	46	1	72	0.0138889
NODE_585_length_3134_cov_8.717957	1290	1362	50	8	72	0.1111111
NODE_585_length_3134_cov_8.717957	1290	1362	57	3	72	0.0416667
NODE_585_length_3134_cov_8.717957	1290	1362	61	2	72	0.0277778
NODE_585_length_3134_cov_8.717957	1290	1362	63	4	72	0.0555556
NODE_585_length_3134_cov_8.717957	1290	1362	68	1	72	0.0138889
NODE_585_length_3134_cov_8.717957	1290	1362	69	1	72	0.0138889
NODE_585_length_3134_cov_8.717957	1290	1362	71	1	72	0.0138889
NODE_585_length_3134_cov_8.717957	1290	1362	73	2	72	0.0277778
NODE_585_length_3134_cov_8.717957	1290	1362	78	1	72	0.0138889
NODE_585_length_3134_cov_8.717957	1290	1362	79	2	72	0.0277778
NODE_585_length_3134_cov_8.717957	1290	1362	81	1	72	0.0138889
NODE_585_length_3134_cov_8.717957	1290	1362	83	1	72	0.0138889
NODE_585_length_3134_cov_8.717957	1290	1362	85	5	72	0.0694444
NODE_585_length_3134_cov_8.717957	1290	1362	87	1	72	0.0138889
NODE_585_length_3134_cov_8.717957	1290	1362	88	1	72	0.0138889
NODE_585_length_3134_cov_8.717957	1290	1362	90	1	72	0.0138889
NODE_585_length_3134_cov_8.717957	1290	1362	92	1	72	0.0138889
NODE_585_length_3134_cov_8.717957	1290	1362	94	1	72	0.0138889
NODE_585_length_3134_cov_8.717957	1290	1362	96	1	72	0.0138889
NODE_585_length_3134_cov_8.717957	1290	1362	100	1	72	0.0138889
NODE_585_length_3134_cov_8.717957	1290	1362	102	8	72	0.1111111
NODE_585_length_3134_cov_8.717957	1290	1362	104	2	72	0.0277778
NODE_585_length_3134_cov_8.717957	1335	1415	78	1	80	0.0125000
NODE_585_length_3134_cov_8.717957	1335	1415	79	2	80	0.0250000
NODE_585_length_3134_cov_8.717957	1335	1415	81	1	80	0.0125000
NODE_585_length_3134_cov_8.717957	1335	1415	83	1	80	0.0125000
NODE_585_length_3134_cov_8.717957	1335	1415	85	5	80	0.0625000
NODE_585_length_3134_cov_8.717957	1335	1415	87	1	80	0.0125000
NODE_585_length_3134_cov_8.717957	1335	1415	88	1	80	0.0125000
NODE_585_length_3134_cov_8.717957	1335	1415	90	1	80	0.0125000
NODE_585_length_3134_cov_8.717957	1335	1415	92	1	80	0.0125000
NODE_585_length_3134_cov_8.717957	1335	1415	94	1	80	0.0125000
NODE_585_length_3134_cov_8.717957	1335	1415	95	5	80	0.0625000
NODE_585_length_3134_cov_8.717957	1335	1415	96	7	80	0.0875000
NODE_585_length_3134_cov_8.717957	1335	1415	97	3	80	0.0375000
NODE_585_length_3134_cov_8.717957	1335	1415	98	8	80	0.1000000
NODE_585_length_3134_cov_8.717957	1335	1415	100	10	80	0.1250000
NODE_585_length_3134_cov_8.717957	1335	1415	102	23	80	0.2875000
NODE_585_length_3134_cov_8.717957	1335	1415	104	2	80	0.0250000
NODE_585_length_3134_cov_8.717957	1335	1415	110	1	80	0.0125000
NODE_585_length_3134_cov_8.717957	1335	1415	112	2	80	0.0250000
NODE_585_length_3134_cov_8.717957	1335	1415	114	4	80	0.0500000
NODE_586_length_3131_cov_26.910620	232	312	0	34	80	0.4250000
NODE_586_length_3131_cov_26.910620	232	312	2	46	80	0.5750000
NODE_586_length_3131_cov_26.910620	285	364	0	33	79	0.4177215
NODE_586_length_3131_cov_26.910620	285	364	2	46	79	0.5822785
NODE_586_length_3131_cov_26.910620	2151	2231	0	47	80	0.5875000
NODE_586_length_3131_cov_26.910620	2151	2231	14	33	80	0.4125000
NODE_586_length_3131_cov_26.910620	2155	2227	0	43	72	0.5972222
NODE_586_length_3131_cov_26.910620	2155	2227	14	29	72	0.4027778
NODE_586_length_3131_cov_26.910620	2204	2284	11	29	80	0.3625000
NODE_586_length_3131_cov_26.910620	2204	2284	12	1	80	0.0125000
NODE_586_length_3131_cov_26.910620	2204	2284	13	23	80	0.2875000
NODE_586_length_3131_cov_26.910620	2204	2284	14	27	80	0.3375000
NODE_586_length_3131_cov_26.910620	2208	2284	11	29	76	0.3815790
NODE_586_length_3131_cov_26.910620	2208	2284	12	1	76	0.0131579
NODE_586_length_3131_cov_26.910620	2208	2284	13	23	76	0.3026316
NODE_586_length_3131_cov_26.910620	2208	2284	14	23	76	0.3026316
NODE_586_length_3131_cov_26.910620	2280	2360	0	63	80	0.7875000
NODE_586_length_3131_cov_26.910620	2280	2360	11	17	80	0.2125000
NODE_586_length_3131_cov_26.910620	2333	2413	0	80	80	1.0000000
NODE_590_length_3118_cov_5.059622	367	445	0	55	78	0.7051282
NODE_590_length_3118_cov_5.059622	367	445	1	21	78	0.2692308
NODE_590_length_3118_cov_5.059622	367	445	2	2	78	0.0256410
NODE_590_length_3118_cov_5.059622	418	498	0	38	80	0.4750000
NODE_590_length_3118_cov_5.059622	418	498	1	3	80	0.0375000
NODE_590_length_3118_cov_5.059622	418	498	2	39	80	0.4875000
NODE_591_length_3117_cov_5.938038	2525	2605	0	29	80	0.3625000
NODE_591_length_3117_cov_5.938038	2525	2605	2	51	80	0.6375000
NODE_591_length_3117_cov_5.938038	2578	2658	0	44	80	0.5500000
NODE_591_length_3117_cov_5.938038	2578	2658	2	36	80	0.4500000
NODE_595_length_3110_cov_31.733643	2864	2923	0	10	59	0.1694915
NODE_595_length_3110_cov_31.733643	2864	2923	6	49	59	0.8305085
NODE_602_length_3093_cov_54.559786	571	651	0	80	80	1.0000000
NODE_602_length_3093_cov_54.559786	624	704	0	80	80	1.0000000
NODE_602_length_3093_cov_54.559786	2901	2981	2	1	80	0.0125000
NODE_602_length_3093_cov_54.559786	2901	2981	8	72	80	0.9000000
NODE_602_length_3093_cov_54.559786	2901	2981	10	7	80	0.0875000
NODE_602_length_3093_cov_54.559786	2954	3034	2	29	80	0.3625000
NODE_602_length_3093_cov_54.559786	2954	3034	4	3	80	0.0375000
NODE_602_length_3093_cov_54.559786	2954	3034	8	20	80	0.2500000
NODE_602_length_3093_cov_54.559786	2954	3034	10	28	80	0.3500000
NODE_603_length_3091_cov_35.895722	1743	1804	0	14	61	0.2295082
NODE_603_length_3091_cov_35.895722	1743	1804	2	4	61	0.0655738
NODE_603_length_3091_cov_35.895722	1743	1804	4	43	61	0.7049180
NODE_603_length_3091_cov_35.895722	1777	1857	0	17	80	0.2125000
NODE_603_length_3091_cov_35.895722	1777	1857	2	22	80	0.2750000
NODE_603_length_3091_cov_35.895722	1777	1857	4	41	80	0.5125000
NODE_603_length_3091_cov_35.895722	2472	2535	0	63	63	1.0000000
NODE_603_length_3091_cov_35.895722	2508	2553	0	45	45	1.0000000
NODE_603_length_3091_cov_35.895722	2534	2604	0	70	70	1.0000000
NODE_603_length_3091_cov_35.895722	2578	2618	0	40	40	1.0000000
NODE_603_length_3091_cov_35.895722	2586	2623	0	37	37	1.0000000
NODE_603_length_3091_cov_35.895722	2626	2671	0	45	45	1.0000000
NODE_603_length_3091_cov_35.895722	2682	2730	0	48	48	1.0000000
NODE_603_length_3091_cov_35.895722	2918	2969	0	51	51	1.0000000
NODE_603_length_3091_cov_35.895722	2942	2987	0	45	45	1.0000000
NODE_603_length_3091_cov_35.895722	2994	3039	0	45	45	1.0000000
NODE_607_length_3079_cov_7.081879	2340	2420	0	11	80	0.1375000
NODE_607_length_3079_cov_7.081879	2340	2420	2	64	80	0.8000000
NODE_607_length_3079_cov_7.081879	2340	2420	4	5	80	0.0625000
NODE_607_length_3079_cov_7.081879	2886	2938	2	15	52	0.2884615
NODE_607_length_3079_cov_7.081879	2886	2938	4	16	52	0.3076923
NODE_607_length_3079_cov_7.081879	2886	2938	5	13	52	0.2500000
NODE_607_length_3079_cov_7.081879	2886	2938	8	8	52	0.1538462
NODE_607_length_3079_cov_7.081879	2893	2959	2	15	66	0.2272727
NODE_607_length_3079_cov_7.081879	2893	2959	4	9	66	0.1363636
NODE_607_length_3079_cov_7.081879	2893	2959	5	13	66	0.1969697
NODE_607_length_3079_cov_7.081879	2893	2959	8	8	66	0.1212121
NODE_607_length_3079_cov_7.081879	2893	2959	13	1	66	0.0151515
NODE_607_length_3079_cov_7.081879	2893	2959	14	5	66	0.0757576
NODE_607_length_3079_cov_7.081879	2893	2959	18	1	66	0.0151515
NODE_607_length_3079_cov_7.081879	2893	2959	24	3	66	0.0454545
NODE_607_length_3079_cov_7.081879	2893	2959	32	7	66	0.1060606
NODE_607_length_3079_cov_7.081879	2893	2959	35	1	66	0.0151515
NODE_607_length_3079_cov_7.081879	2893	2959	37	3	66	0.0454545
NODE_607_length_3079_cov_7.081879	2932	2993	8	6	61	0.0983607
NODE_607_length_3079_cov_7.081879	2932	2993	13	1	61	0.0163934
NODE_607_length_3079_cov_7.081879	2932	2993	14	5	61	0.0819672
NODE_607_length_3079_cov_7.081879	2932	2993	18	1	61	0.0163934
NODE_607_length_3079_cov_7.081879	2932	2993	24	3	61	0.0491803
NODE_607_length_3079_cov_7.081879	2932	2993	32	7	61	0.1147541
NODE_607_length_3079_cov_7.081879	2932	2993	35	1	61	0.0163934
NODE_607_length_3079_cov_7.081879	2932	2993	37	11	61	0.1803279
NODE_607_length_3079_cov_7.081879	2932	2993	39	4	61	0.0655738
NODE_607_length_3079_cov_7.081879	2932	2993	45	20	61	0.3278688
NODE_607_length_3079_cov_7.081879	2932	2993	46	2	61	0.0327869
NODE_607_length_3079_cov_7.081879	2932	2995	8	6	63	0.0952381
NODE_607_length_3079_cov_7.081879	2932	2995	13	1	63	0.0158730
NODE_607_length_3079_cov_7.081879	2932	2995	14	5	63	0.0793651
NODE_607_length_3079_cov_7.081879	2932	2995	18	1	63	0.0158730
NODE_607_length_3079_cov_7.081879	2932	2995	24	3	63	0.0476190
NODE_607_length_3079_cov_7.081879	2932	2995	32	7	63	0.1111111
NODE_607_length_3079_cov_7.081879	2932	2995	35	1	63	0.0158730
NODE_607_length_3079_cov_7.081879	2932	2995	37	11	63	0.1746032
NODE_607_length_3079_cov_7.081879	2932	2995	39	4	63	0.0634921
NODE_607_length_3079_cov_7.081879	2932	2995	45	22	63	0.3492064
NODE_607_length_3079_cov_7.081879	2932	2995	46	2	63	0.0317460
NODE_607_length_3079_cov_7.081879	2932	2995	8	6	63	0.0952381
NODE_607_length_3079_cov_7.081879	2932	2995	13	1	63	0.0158730
NODE_607_length_3079_cov_7.081879	2932	2995	14	5	63	0.0793651
NODE_607_length_3079_cov_7.081879	2932	2995	18	1	63	0.0158730
NODE_607_length_3079_cov_7.081879	2932	2995	24	3	63	0.0476190
NODE_607_length_3079_cov_7.081879	2932	2995	32	7	63	0.1111111
NODE_607_length_3079_cov_7.081879	2932	2995	35	1	63	0.0158730
NODE_607_length_3079_cov_7.081879	2932	2995	37	11	63	0.1746032
NODE_607_length_3079_cov_7.081879	2932	2995	39	4	63	0.0634921
NODE_607_length_3079_cov_7.081879	2932	2995	45	22	63	0.3492064
NODE_607_length_3079_cov_7.081879	2932	2995	46	2	63	0.0317460
NODE_608_length_3077_cov_23.535259	1244	1321	6	77	77	1.0000000
NODE_608_length_3077_cov_23.535259	1911	1991	1	11	80	0.1375000
NODE_608_length_3077_cov_23.535259	1911	1991	2	16	80	0.2000000
NODE_608_length_3077_cov_23.535259	1911	1991	3	5	80	0.0625000
NODE_608_length_3077_cov_23.535259	1911	1991	4	12	80	0.1500000
NODE_608_length_3077_cov_23.535259	1911	1991	6	36	80	0.4500000
NODE_608_length_3077_cov_23.535259	1964	2016	6	52	52	1.0000000
NODE_608_length_3077_cov_23.535259	2028	2114	0	9	86	0.1046512
NODE_608_length_3077_cov_23.535259	2028	2114	1	2	86	0.0232558
NODE_608_length_3077_cov_23.535259	2028	2114	2	8	86	0.0930233
NODE_608_length_3077_cov_23.535259	2028	2114	4	9	86	0.1046512
NODE_608_length_3077_cov_23.535259	2028	2114	6	58	86	0.6744186
NODE_609_length_3077_cov_8.693083	1157	1237	2	20	80	0.2500000
NODE_609_length_3077_cov_8.693083	1157	1237	4	13	80	0.1625000
NODE_609_length_3077_cov_8.693083	1157	1237	8	10	80	0.1250000
NODE_609_length_3077_cov_8.693083	1157	1237	15	1	80	0.0125000
NODE_609_length_3077_cov_8.693083	1157	1237	16	20	80	0.2500000
NODE_609_length_3077_cov_8.693083	1157	1237	20	16	80	0.2000000
NODE_609_length_3077_cov_8.693083	1161	1184	2	18	23	0.7826087
NODE_609_length_3077_cov_8.693083	1161	1184	4	5	23	0.2173913
NODE_609_length_3077_cov_8.693083	1233	1313	20	15	80	0.1875000
NODE_609_length_3077_cov_8.693083	1233	1313	24	4	80	0.0500000
NODE_609_length_3077_cov_8.693083	1233	1313	28	5	80	0.0625000
NODE_609_length_3077_cov_8.693083	1233	1313	30	5	80	0.0625000
NODE_609_length_3077_cov_8.693083	1233	1313	32	4	80	0.0500000
NODE_609_length_3077_cov_8.693083	1233	1313	34	4	80	0.0500000
NODE_609_length_3077_cov_8.693083	1233	1313	36	2	80	0.0250000
NODE_609_length_3077_cov_8.693083	1233	1313	40	4	80	0.0500000
NODE_609_length_3077_cov_8.693083	1233	1313	42	6	80	0.0750000
NODE_609_length_3077_cov_8.693083	1233	1313	44	1	80	0.0125000
NODE_609_length_3077_cov_8.693083	1233	1313	46	2	80	0.0250000
NODE_609_length_3077_cov_8.693083	1233	1313	48	11	80	0.1375000
NODE_609_length_3077_cov_8.693083	1233	1313	49	10	80	0.1250000
NODE_609_length_3077_cov_8.693083	1233	1313	50	7	80	0.0875000
NODE_609_length_3077_cov_8.693083	1286	1352	48	12	66	0.1818182
NODE_609_length_3077_cov_8.693083	1286	1352	49	15	66	0.2272727
NODE_609_length_3077_cov_8.693083	1286	1352	50	7	66	0.1060606
NODE_609_length_3077_cov_8.693083	1286	1352	51	6	66	0.0909091
NODE_609_length_3077_cov_8.693083	1286	1352	52	6	66	0.0909091
NODE_609_length_3077_cov_8.693083	1286	1352	54	4	66	0.0606061
NODE_609_length_3077_cov_8.693083	1286	1352	55	8	66	0.1212121
NODE_609_length_3077_cov_8.693083	1286	1352	56	1	66	0.0151515
NODE_609_length_3077_cov_8.693083	1286	1352	57	5	66	0.0757576
NODE_609_length_3077_cov_8.693083	1286	1352	58	2	66	0.0303030
NODE_609_length_3077_cov_8.693083	2672	2757	4	3	85	0.0352941
NODE_609_length_3077_cov_8.693083	2672	2757	6	15	85	0.1764706
NODE_609_length_3077_cov_8.693083	2672	2757	7	5	85	0.0588235
NODE_609_length_3077_cov_8.693083	2672	2757	9	7	85	0.0823529
NODE_609_length_3077_cov_8.693083	2672	2757	14	1	85	0.0117647
NODE_609_length_3077_cov_8.693083	2672	2757	15	7	85	0.0823529
NODE_609_length_3077_cov_8.693083	2672	2757	17	18	85	0.2117647
NODE_609_length_3077_cov_8.693083	2672	2757	19	8	85	0.0941176
NODE_609_length_3077_cov_8.693083	2672	2757	21	21	85	0.2470588
NODE_611_length_3074_cov_2.996303	2561	2629	27	2	68	0.0294118
NODE_611_length_3074_cov_2.996303	2561	2629	31	1	68	0.0147059
NODE_611_length_3074_cov_2.996303	2561	2629	33	1	68	0.0147059
NODE_611_length_3074_cov_2.996303	2561	2629	38	1	68	0.0147059
NODE_611_length_3074_cov_2.996303	2561	2629	43	1	68	0.0147059
NODE_611_length_3074_cov_2.996303	2561	2629	48	1	68	0.0147059
NODE_611_length_3074_cov_2.996303	2561	2629	62	2	68	0.0294118
NODE_611_length_3074_cov_2.996303	2561	2629	76	1	68	0.0147059
NODE_611_length_3074_cov_2.996303	2561	2629	79	1	68	0.0147059
NODE_611_length_3074_cov_2.996303	2561	2629	81	1	68	0.0147059
NODE_611_length_3074_cov_2.996303	2561	2629	84	2	68	0.0294118
NODE_611_length_3074_cov_2.996303	2561	2629	85	3	68	0.0441176
NODE_611_length_3074_cov_2.996303	2561	2629	90	2	68	0.0294118
NODE_611_length_3074_cov_2.996303	2561	2629	96	1	68	0.0147059
NODE_611_length_3074_cov_2.996303	2561	2629	109	1	68	0.0147059
NODE_611_length_3074_cov_2.996303	2561	2629	115	1	68	0.0147059
NODE_611_length_3074_cov_2.996303	2561	2629	118	1	68	0.0147059
NODE_611_length_3074_cov_2.996303	2561	2629	120	1	68	0.0147059
NODE_611_length_3074_cov_2.996303	2561	2629	124	1	68	0.0147059
NODE_611_length_3074_cov_2.996303	2561	2629	133	2	68	0.0294118
NODE_611_length_3074_cov_2.996303	2561	2629	137	1	68	0.0147059
NODE_611_length_3074_cov_2.996303	2561	2629	139	1	68	0.0147059
NODE_611_length_3074_cov_2.996303	2561	2629	145	5	68	0.0735294
NODE_611_length_3074_cov_2.996303	2561	2629	149	2	68	0.0294118
NODE_611_length_3074_cov_2.996303	2561	2629	154	1	68	0.0147059
NODE_611_length_3074_cov_2.996303	2561	2629	156	1	68	0.0147059
NODE_611_length_3074_cov_2.996303	2561	2629	161	1	68	0.0147059
NODE_611_length_3074_cov_2.996303	2561	2629	169	1	68	0.0147059
NODE_611_length_3074_cov_2.996303	2561	2629	171	2	68	0.0294118
NODE_611_length_3074_cov_2.996303	2561	2629	172	2	68	0.0294118
NODE_611_length_3074_cov_2.996303	2561	2629	174	4	68	0.0588235
NODE_611_length_3074_cov_2.996303	2561	2629	183	1	68	0.0147059
NODE_611_length_3074_cov_2.996303	2561	2629	186	1	68	0.0147059
NODE_611_length_3074_cov_2.996303	2561	2629	192	3	68	0.0441176
NODE_611_length_3074_cov_2.996303	2561	2629	196	1	68	0.0147059
NODE_611_length_3074_cov_2.996303	2561	2629	198	1	68	0.0147059
NODE_611_length_3074_cov_2.996303	2561	2629	202	1	68	0.0147059
NODE_611_length_3074_cov_2.996303	2561	2629	207	1	68	0.0147059
NODE_611_length_3074_cov_2.996303	2561	2629	231	1	68	0.0147059
NODE_611_length_3074_cov_2.996303	2561	2629	236	1	68	0.0147059
NODE_611_length_3074_cov_2.996303	2561	2629	246	1	68	0.0147059
NODE_611_length_3074_cov_2.996303	2561	2629	254	1	68	0.0147059
NODE_611_length_3074_cov_2.996303	2561	2629	259	1	68	0.0147059
NODE_611_length_3074_cov_2.996303	2561	2629	267	1	68	0.0147059
NODE_611_length_3074_cov_2.996303	2561	2629	276	1	68	0.0147059
NODE_611_length_3074_cov_2.996303	2561	2629	290	1	68	0.0147059
NODE_611_length_3074_cov_2.996303	2561	2629	301	1	68	0.0147059
NODE_611_length_3074_cov_2.996303	2561	2629	307	1	68	0.0147059
NODE_611_length_3074_cov_2.996303	2561	2629	309	1	68	0.0147059
NODE_615_length_3069_cov_2.448822	2948	2991	2	12	43	0.2790698
NODE_615_length_3069_cov_2.448822	2948	2991	4	31	43	0.7209302
NODE_616_length_3059_cov_20.037500	346	426	4	30	80	0.3750000
NODE_616_length_3059_cov_20.037500	346	426	6	14	80	0.1750000
NODE_616_length_3059_cov_20.037500	346	426	12	25	80	0.3125000
NODE_616_length_3059_cov_20.037500	346	426	14	7	80	0.0875000
NODE_616_length_3059_cov_20.037500	346	426	16	4	80	0.0500000
NODE_616_length_3059_cov_20.037500	399	479	12	43	80	0.5375000
NODE_616_length_3059_cov_20.037500	399	479	13	13	80	0.1625000
NODE_616_length_3059_cov_20.037500	399	479	14	20	80	0.2500000
NODE_616_length_3059_cov_20.037500	399	479	16	4	80	0.0500000
NODE_616_length_3059_cov_20.037500	1317	1397	2	30	80	0.3750000
NODE_616_length_3059_cov_20.037500	1317	1397	12	3	80	0.0375000
NODE_616_length_3059_cov_20.037500	1317	1397	14	1	80	0.0125000
NODE_616_length_3059_cov_20.037500	1317	1397	16	41	80	0.5125000
NODE_616_length_3059_cov_20.037500	1317	1397	18	5	80	0.0625000
NODE_616_length_3059_cov_20.037500	1370	1447	0	27	77	0.3506494
NODE_616_length_3059_cov_20.037500	1370	1447	2	50	77	0.6493506
NODE_616_length_3059_cov_20.037500	2514	2594	0	62	80	0.7750000
NODE_616_length_3059_cov_20.037500	2514	2594	2	18	80	0.2250000
NODE_616_length_3059_cov_20.037500	2567	2647	0	9	80	0.1125000
NODE_616_length_3059_cov_20.037500	2567	2647	2	71	80	0.8875000
NODE_617_length_3058_cov_21.767489	2802	2882	0	3	80	0.0375000
NODE_617_length_3058_cov_21.767489	2802	2882	2	12	80	0.1500000
NODE_617_length_3058_cov_21.767489	2802	2882	6	60	80	0.7500000
NODE_617_length_3058_cov_21.767489	2802	2882	14	3	80	0.0375000
NODE_617_length_3058_cov_21.767489	2802	2882	32	1	80	0.0125000
NODE_617_length_3058_cov_21.767489	2802	2882	35	1	80	0.0125000
NODE_617_length_3058_cov_21.767489	2855	2930	0	3	75	0.0400000
NODE_617_length_3058_cov_21.767489	2855	2930	6	72	75	0.9600000
NODE_621_length_3047_cov_47.232361	418	489	0	8	71	0.1126761
NODE_621_length_3047_cov_47.232361	418	489	2	21	71	0.2957746
NODE_621_length_3047_cov_47.232361	418	489	4	42	71	0.5915493
NODE_621_length_3047_cov_47.232361	758	801	22	3	43	0.0697674
NODE_621_length_3047_cov_47.232361	758	801	24	6	43	0.1395349
NODE_621_length_3047_cov_47.232361	758	801	26	1	43	0.0232558
NODE_621_length_3047_cov_47.232361	758	801	28	8	43	0.1860465
NODE_621_length_3047_cov_47.232361	758	801	31	4	43	0.0930233
NODE_621_length_3047_cov_47.232361	758	801	32	2	43	0.0465116
NODE_621_length_3047_cov_47.232361	758	801	33	5	43	0.1162791
NODE_621_length_3047_cov_47.232361	758	801	34	2	43	0.0465116
NODE_621_length_3047_cov_47.232361	758	801	36	1	43	0.0232558
NODE_621_length_3047_cov_47.232361	758	801	37	10	43	0.2325581
NODE_621_length_3047_cov_47.232361	758	801	38	1	43	0.0232558
NODE_623_length_3044_cov_38.951783	1702	1782	0	27	80	0.3375000
NODE_623_length_3044_cov_38.951783	1702	1782	2	53	80	0.6625000
NODE_623_length_3044_cov_38.951783	1755	1835	0	80	80	1.0000000
NODE_623_length_3044_cov_38.951783	1831	1911	0	55	80	0.6875000
NODE_623_length_3044_cov_38.951783	1831	1911	3	1	80	0.0125000
NODE_623_length_3044_cov_38.951783	1831	1911	4	24	80	0.3000000
NODE_623_length_3044_cov_38.951783	1884	1964	0	2	80	0.0250000
NODE_623_length_3044_cov_38.951783	1884	1964	3	1	80	0.0125000
NODE_623_length_3044_cov_38.951783	1884	1964	4	77	80	0.9625000
NODE_623_length_3044_cov_38.951783	2556	2636	0	80	80	1.0000000
NODE_623_length_3044_cov_38.951783	2609	2689	0	80	80	1.0000000
NODE_625_length_3039_cov_3.258163	261	337	2	44	76	0.5789474
NODE_625_length_3039_cov_3.258163	261	337	4	32	76	0.4210526
NODE_625_length_3039_cov_3.258163	261	336	2	43	75	0.5733333
NODE_625_length_3039_cov_3.258163	261	336	4	32	75	0.4266667
NODE_625_length_3039_cov_3.258163	261	337	2	44	76	0.5789474
NODE_625_length_3039_cov_3.258163	261	337	4	32	76	0.4210526
NODE_625_length_3039_cov_3.258163	270	337	2	44	67	0.6567164
NODE_625_length_3039_cov_3.258163	270	337	4	23	67	0.3432836
NODE_627_length_3036_cov_8.968676	2303	2367	0	54	64	0.8437500
NODE_627_length_3036_cov_8.968676	2303	2367	2	10	64	0.1562500
NODE_627_length_3036_cov_8.968676	2340	2420	0	67	80	0.8375000
NODE_627_length_3036_cov_8.968676	2340	2420	2	13	80	0.1625000
NODE_627_length_3036_cov_8.968676	2416	2496	2	80	80	1.0000000
NODE_627_length_3036_cov_8.968676	2469	2549	0	52	80	0.6500000
NODE_627_length_3036_cov_8.968676	2469	2549	2	28	80	0.3500000
NODE_629_length_3032_cov_7.470849	1026	1068	24	2	42	0.0476190
NODE_629_length_3032_cov_7.470849	1026	1068	25	3	42	0.0714286
NODE_629_length_3032_cov_7.470849	1026	1068	26	8	42	0.1904762
NODE_629_length_3032_cov_7.470849	1026	1068	28	14	42	0.3333333
NODE_629_length_3032_cov_7.470849	1026	1068	30	10	42	0.2380952
NODE_629_length_3032_cov_7.470849	1026	1068	32	5	42	0.1190476
NODE_630_length_3025_cov_11.862611	2371	2451	5	80	80	1.0000000
NODE_630_length_3025_cov_11.862611	2424	2504	0	6	80	0.0750000
NODE_630_length_3025_cov_11.862611	2424	2504	1	7	80	0.0875000
NODE_630_length_3025_cov_11.862611	2424	2504	4	1	80	0.0125000
NODE_630_length_3025_cov_11.862611	2424	2504	5	66	80	0.8250000
NODE_630_length_3025_cov_11.862611	2500	2580	0	80	80	1.0000000
NODE_630_length_3025_cov_11.862611	2553	2633	0	80	80	1.0000000
NODE_635_length_3012_cov_33.100240	2379	2459	0	80	80	1.0000000
NODE_635_length_3012_cov_33.100240	2432	2512	0	80	80	1.0000000
NODE_637_length_3007_cov_11.843535	2641	2721	4	11	80	0.1375000
NODE_637_length_3007_cov_11.843535	2641	2721	6	9	80	0.1125000
NODE_637_length_3007_cov_11.843535	2641	2721	7	1	80	0.0125000
NODE_637_length_3007_cov_11.843535	2641	2721	8	59	80	0.7375000
NODE_643_length_2992_cov_2.636709	2032	2112	0	80	80	1.0000000
NODE_643_length_2992_cov_2.636709	2085	2165	0	39	80	0.4875000
NODE_643_length_2992_cov_2.636709	2085	2165	2	41	80	0.5125000
NODE_646_length_2978_cov_4.883293	382	452	0	70	70	1.0000000
NODE_646_length_2978_cov_4.883293	1858	1938	0	55	80	0.6875000
NODE_646_length_2978_cov_4.883293	1858	1938	4	23	80	0.2875000
NODE_646_length_2978_cov_4.883293	1858	1938	6	2	80	0.0250000
NODE_646_length_2978_cov_4.883293	1926	1991	4	10	65	0.1538462
NODE_646_length_2978_cov_4.883293	1926	1991	6	55	65	0.8461539
NODE_646_length_2978_cov_4.883293	1987	2066	0	39	79	0.4936709
NODE_646_length_2978_cov_4.883293	1987	2066	2	18	79	0.2278481
NODE_646_length_2978_cov_4.883293	1987	2066	6	22	79	0.2784810
NODE_646_length_2978_cov_4.883293	2040	2079	0	39	39	1.0000000
NODE_647_length_2976_cov_24.683003	1764	1844	0	73	80	0.9125000
NODE_647_length_2976_cov_24.683003	1764	1844	2	7	80	0.0875000
NODE_647_length_2976_cov_24.683003	1817	1897	0	20	80	0.2500000
NODE_647_length_2976_cov_24.683003	1817	1897	2	60	80	0.7500000
NODE_647_length_2976_cov_24.683003	1893	1973	2	9	80	0.1125000
NODE_647_length_2976_cov_24.683003	1893	1973	6	38	80	0.4750000
NODE_647_length_2976_cov_24.683003	1893	1973	8	33	80	0.4125000
NODE_647_length_2976_cov_24.683003	1946	2026	0	23	80	0.2875000
NODE_647_length_2976_cov_24.683003	1946	2026	6	57	80	0.7125000
NODE_651_length_2967_cov_16.146095	238	318	2	59	80	0.7375000
NODE_651_length_2967_cov_16.146095	238	318	4	13	80	0.1625000
NODE_651_length_2967_cov_16.146095	238	318	6	8	80	0.1000000
NODE_651_length_2967_cov_16.146095	291	371	2	6	80	0.0750000
NODE_651_length_2967_cov_16.146095	291	371	4	66	80	0.8250000
NODE_651_length_2967_cov_16.146095	291	371	6	8	80	0.1000000
NODE_651_length_2967_cov_16.146095	367	447	1	25	80	0.3125000
NODE_651_length_2967_cov_16.146095	367	447	2	23	80	0.2875000
NODE_651_length_2967_cov_16.146095	367	447	3	26	80	0.3250000
NODE_651_length_2967_cov_16.146095	367	447	4	6	80	0.0750000
NODE_651_length_2967_cov_16.146095	420	500	1	7	80	0.0875000
NODE_651_length_2967_cov_16.146095	420	500	2	73	80	0.9125000
NODE_653_length_2965_cov_19.913468	92	134	2	10	42	0.2380952
NODE_653_length_2965_cov_19.913468	92	134	6	5	42	0.1190476
NODE_653_length_2965_cov_19.913468	92	134	10	3	42	0.0714286
NODE_653_length_2965_cov_19.913468	92	134	12	3	42	0.0714286
NODE_653_length_2965_cov_19.913468	92	134	13	1	42	0.0238095
NODE_653_length_2965_cov_19.913468	92	134	14	20	42	0.4761905
NODE_653_length_2965_cov_19.913468	109	178	0	14	69	0.2028985
NODE_653_length_2965_cov_19.913468	109	178	2	39	69	0.5652174
NODE_653_length_2965_cov_19.913468	109	178	6	6	69	0.0869565
NODE_653_length_2965_cov_19.913468	109	178	10	3	69	0.0434783
NODE_653_length_2965_cov_19.913468	109	178	12	3	69	0.0434783
NODE_653_length_2965_cov_19.913468	109	178	13	1	69	0.0144928
NODE_653_length_2965_cov_19.913468	109	178	14	3	69	0.0434783
NODE_653_length_2965_cov_19.913468	109	178	0	14	69	0.2028985
NODE_653_length_2965_cov_19.913468	109	178	2	39	69	0.5652174
NODE_653_length_2965_cov_19.913468	109	178	6	6	69	0.0869565
NODE_653_length_2965_cov_19.913468	109	178	10	3	69	0.0434783
NODE_653_length_2965_cov_19.913468	109	178	12	3	69	0.0434783
NODE_653_length_2965_cov_19.913468	109	178	13	1	69	0.0144928
NODE_653_length_2965_cov_19.913468	109	178	14	3	69	0.0434783
NODE_653_length_2965_cov_19.913468	2298	2378	2	80	80	1.0000000
NODE_653_length_2965_cov_19.913468	2351	2431	0	22	80	0.2750000
NODE_653_length_2965_cov_19.913468	2351	2431	1	24	80	0.3000000
NODE_653_length_2965_cov_19.913468	2351	2431	2	34	80	0.4250000
NODE_653_length_2965_cov_19.913468	2427	2507	0	80	80	1.0000000
NODE_653_length_2965_cov_19.913468	2480	2560	0	80	80	1.0000000
NODE_656_length_2960_cov_35.741699	459	539	0	80	80	1.0000000
NODE_656_length_2960_cov_35.741699	512	592	0	80	80	1.0000000
NODE_659_length_2951_cov_7.195652	1100	1141	217	1	41	0.0243902
NODE_659_length_2951_cov_7.195652	1100	1141	221	1	41	0.0243902
NODE_659_length_2951_cov_7.195652	1100	1141	226	1	41	0.0243902
NODE_659_length_2951_cov_7.195652	1100	1141	228	1	41	0.0243902
NODE_659_length_2951_cov_7.195652	1100	1141	230	1	41	0.0243902
NODE_659_length_2951_cov_7.195652	1100	1141	233	1	41	0.0243902
NODE_659_length_2951_cov_7.195652	1100	1141	239	1	41	0.0243902
NODE_659_length_2951_cov_7.195652	1100	1141	241	1	41	0.0243902
NODE_659_length_2951_cov_7.195652	1100	1141	243	1	41	0.0243902
NODE_659_length_2951_cov_7.195652	1100	1141	245	1	41	0.0243902
NODE_659_length_2951_cov_7.195652	1100	1141	247	1	41	0.0243902
NODE_659_length_2951_cov_7.195652	1100	1141	251	1	41	0.0243902
NODE_659_length_2951_cov_7.195652	1100	1141	255	1	41	0.0243902
NODE_659_length_2951_cov_7.195652	1100	1141	258	1	41	0.0243902
NODE_659_length_2951_cov_7.195652	1100	1141	263	2	41	0.0487805
NODE_659_length_2951_cov_7.195652	1100	1141	265	1	41	0.0243902
NODE_659_length_2951_cov_7.195652	1100	1141	268	1	41	0.0243902
NODE_659_length_2951_cov_7.195652	1100	1141	269	1	41	0.0243902
NODE_659_length_2951_cov_7.195652	1100	1141	272	2	41	0.0487805
NODE_659_length_2951_cov_7.195652	1100	1141	278	1	41	0.0243902
NODE_659_length_2951_cov_7.195652	1100	1141	282	1	41	0.0243902
NODE_659_length_2951_cov_7.195652	1100	1141	286	1	41	0.0243902
NODE_659_length_2951_cov_7.195652	1100	1141	287	1	41	0.0243902
NODE_659_length_2951_cov_7.195652	1100	1141	303	1	41	0.0243902
NODE_659_length_2951_cov_7.195652	1100	1141	305	1	41	0.0243902
NODE_659_length_2951_cov_7.195652	1100	1141	315	1	41	0.0243902
NODE_659_length_2951_cov_7.195652	1100	1141	316	1	41	0.0243902
NODE_659_length_2951_cov_7.195652	1100	1141	317	1	41	0.0243902
NODE_659_length_2951_cov_7.195652	1100	1141	319	5	41	0.1219512
NODE_659_length_2951_cov_7.195652	1100	1141	321	1	41	0.0243902
NODE_659_length_2951_cov_7.195652	1100	1141	324	1	41	0.0243902
NODE_659_length_2951_cov_7.195652	1100	1141	330	1	41	0.0243902
NODE_659_length_2951_cov_7.195652	1100	1141	340	1	41	0.0243902
NODE_659_length_2951_cov_7.195652	1100	1141	344	1	41	0.0243902
NODE_659_length_2951_cov_7.195652	1100	1141	348	1	41	0.0243902
NODE_665_length_2935_cov_37.693230	1492	1572	30	3	80	0.0375000
NODE_665_length_2935_cov_37.693230	1492	1572	32	3	80	0.0375000
NODE_665_length_2935_cov_37.693230	1492	1572	40	2	80	0.0250000
NODE_665_length_2935_cov_37.693230	1492	1572	42	15	80	0.1875000
NODE_665_length_2935_cov_37.693230	1492	1572	44	11	80	0.1375000
NODE_665_length_2935_cov_37.693230	1492	1572	46	38	80	0.4750000
NODE_665_length_2935_cov_37.693230	1492	1572	48	5	80	0.0625000
NODE_665_length_2935_cov_37.693230	1492	1572	50	3	80	0.0375000
NODE_665_length_2935_cov_37.693230	1534	1589	38	13	55	0.2363636
NODE_665_length_2935_cov_37.693230	1534	1589	40	1	55	0.0181818
NODE_665_length_2935_cov_37.693230	1534	1589	42	16	55	0.2909091
NODE_665_length_2935_cov_37.693230	1534	1589	46	25	55	0.4545455
NODE_665_length_2935_cov_37.693230	1545	1619	12	1	74	0.0135135
NODE_665_length_2935_cov_37.693230	1545	1619	14	1	74	0.0135135
NODE_665_length_2935_cov_37.693230	1545	1619	16	7	74	0.0945946
NODE_665_length_2935_cov_37.693230	1545	1619	18	2	74	0.0270270
NODE_665_length_2935_cov_37.693230	1545	1619	20	6	74	0.0810811
NODE_665_length_2935_cov_37.693230	1545	1619	26	2	74	0.0270270
NODE_665_length_2935_cov_37.693230	1545	1619	28	3	74	0.0405405
NODE_665_length_2935_cov_37.693230	1545	1619	30	3	74	0.0405405
NODE_665_length_2935_cov_37.693230	1545	1619	34	1	74	0.0135135
NODE_665_length_2935_cov_37.693230	1545	1619	36	3	74	0.0405405
NODE_665_length_2935_cov_37.693230	1545	1619	38	14	74	0.1891892
NODE_665_length_2935_cov_37.693230	1545	1619	40	1	74	0.0135135
NODE_665_length_2935_cov_37.693230	1545	1619	42	16	74	0.2162162
NODE_665_length_2935_cov_37.693230	1545	1619	46	14	74	0.1891892
NODE_665_length_2935_cov_37.693230	1625	1701	2	71	76	0.9342105
NODE_665_length_2935_cov_37.693230	1625	1701	4	4	76	0.0526316
NODE_665_length_2935_cov_37.693230	1625	1701	10	1	76	0.0131579
NODE_665_length_2935_cov_37.693230	2863	2906	0	29	43	0.6744186
NODE_665_length_2935_cov_37.693230	2863	2906	2	14	43	0.3255814
NODE_675_length_2913_cov_4.376688	2664	2739	0	11	75	0.1466667
NODE_675_length_2913_cov_4.376688	2664	2739	3	2	75	0.0266667
NODE_675_length_2913_cov_4.376688	2664	2739	4	62	75	0.8266667
NODE_675_length_2913_cov_4.376688	2664	2723	4	59	59	1.0000000
NODE_675_length_2913_cov_4.376688	2664	2739	0	11	75	0.1466667
NODE_675_length_2913_cov_4.376688	2664	2739	3	2	75	0.0266667
NODE_675_length_2913_cov_4.376688	2664	2739	4	62	75	0.8266667
NODE_675_length_2913_cov_4.376688	2664	2739	0	11	75	0.1466667
NODE_675_length_2913_cov_4.376688	2664	2739	3	2	75	0.0266667
NODE_675_length_2913_cov_4.376688	2664	2739	4	62	75	0.8266667
NODE_675_length_2913_cov_4.376688	2673	2739	0	11	66	0.1666667
NODE_675_length_2913_cov_4.376688	2673	2739	3	2	66	0.0303030
NODE_675_length_2913_cov_4.376688	2673	2739	4	53	66	0.8030303
NODE_675_length_2913_cov_4.376688	2717	2780	0	52	63	0.8253968
NODE_675_length_2913_cov_4.376688	2717	2780	3	2	63	0.0317460
NODE_675_length_2913_cov_4.376688	2717	2780	4	9	63	0.1428571
NODE_675_length_2913_cov_4.376688	2745	2778	0	33	33	1.0000000
NODE_677_length_2909_cov_71.975089	2090	2174	428	2	84	0.0238095
NODE_677_length_2909_cov_71.975089	2090	2174	429	1	84	0.0119048
NODE_677_length_2909_cov_71.975089	2090	2174	430	1	84	0.0119048
NODE_677_length_2909_cov_71.975089	2090	2174	432	1	84	0.0119048
NODE_677_length_2909_cov_71.975089	2090	2174	436	2	84	0.0238095
NODE_677_length_2909_cov_71.975089	2090	2174	437	5	84	0.0595238
NODE_677_length_2909_cov_71.975089	2090	2174	438	4	84	0.0476190
NODE_677_length_2909_cov_71.975089	2090	2174	439	4	84	0.0476190
NODE_677_length_2909_cov_71.975089	2090	2174	441	2	84	0.0238095
NODE_677_length_2909_cov_71.975089	2090	2174	442	1	84	0.0119048
NODE_677_length_2909_cov_71.975089	2090	2174	443	1	84	0.0119048
NODE_677_length_2909_cov_71.975089	2090	2174	444	1	84	0.0119048
NODE_677_length_2909_cov_71.975089	2090	2174	445	1	84	0.0119048
NODE_677_length_2909_cov_71.975089	2090	2174	447	1	84	0.0119048
NODE_677_length_2909_cov_71.975089	2090	2174	448	2	84	0.0238095
NODE_677_length_2909_cov_71.975089	2090	2174	450	1	84	0.0119048
NODE_677_length_2909_cov_71.975089	2090	2174	452	2	84	0.0238095
NODE_677_length_2909_cov_71.975089	2090	2174	453	1	84	0.0119048
NODE_677_length_2909_cov_71.975089	2090	2174	455	4	84	0.0476190
NODE_677_length_2909_cov_71.975089	2090	2174	456	2	84	0.0238095
NODE_677_length_2909_cov_71.975089	2090	2174	457	1	84	0.0119048
NODE_677_length_2909_cov_71.975089	2090	2174	458	2	84	0.0238095
NODE_677_length_2909_cov_71.975089	2090	2174	459	3	84	0.0357143
NODE_677_length_2909_cov_71.975089	2090	2174	461	2	84	0.0238095
NODE_677_length_2909_cov_71.975089	2090	2174	463	2	84	0.0238095
NODE_677_length_2909_cov_71.975089	2090	2174	464	1	84	0.0119048
NODE_677_length_2909_cov_71.975089	2090	2174	468	1	84	0.0119048
NODE_677_length_2909_cov_71.975089	2090	2174	470	1	84	0.0119048
NODE_677_length_2909_cov_71.975089	2090	2174	477	1	84	0.0119048
NODE_677_length_2909_cov_71.975089	2090	2174	481	1	84	0.0119048
NODE_677_length_2909_cov_71.975089	2090	2174	488	1	84	0.0119048
NODE_677_length_2909_cov_71.975089	2090	2174	495	1	84	0.0119048
NODE_677_length_2909_cov_71.975089	2090	2174	510	1	84	0.0119048
NODE_677_length_2909_cov_71.975089	2090	2174	522	1	84	0.0119048
NODE_677_length_2909_cov_71.975089	2090	2174	527	1	84	0.0119048
NODE_677_length_2909_cov_71.975089	2090	2174	535	1	84	0.0119048
NODE_677_length_2909_cov_71.975089	2090	2174	541	1	84	0.0119048
NODE_677_length_2909_cov_71.975089	2090	2174	543	1	84	0.0119048
NODE_677_length_2909_cov_71.975089	2090	2174	549	1	84	0.0119048
NODE_677_length_2909_cov_71.975089	2090	2174	550	1	84	0.0119048
NODE_677_length_2909_cov_71.975089	2090	2174	555	1	84	0.0119048
NODE_677_length_2909_cov_71.975089	2090	2174	556	2	84	0.0238095
NODE_677_length_2909_cov_71.975089	2090	2174	557	2	84	0.0238095
NODE_677_length_2909_cov_71.975089	2090	2174	559	1	84	0.0119048
NODE_677_length_2909_cov_71.975089	2090	2174	584	1	84	0.0119048
NODE_677_length_2909_cov_71.975089	2090	2174	590	1	84	0.0119048
NODE_677_length_2909_cov_71.975089	2090	2174	598	1	84	0.0119048
NODE_677_length_2909_cov_71.975089	2090	2174	600	1	84	0.0119048
NODE_677_length_2909_cov_71.975089	2090	2174	605	2	84	0.0238095
NODE_677_length_2909_cov_71.975089	2090	2174	607	1	84	0.0119048
NODE_677_length_2909_cov_71.975089	2090	2174	611	2	84	0.0238095
NODE_677_length_2909_cov_71.975089	2090	2174	612	2	84	0.0238095
NODE_677_length_2909_cov_71.975089	2090	2174	614	1	84	0.0119048
NODE_677_length_2909_cov_71.975089	2090	2174	615	1	84	0.0119048
NODE_677_length_2909_cov_71.975089	2090	2174	622	1	84	0.0119048
NODE_678_length_2908_cov_5.937344	2495	2575	0	80	80	1.0000000
NODE_678_length_2908_cov_5.937344	2548	2628	0	80	80	1.0000000
NODE_678_length_2908_cov_5.937344	2624	2704	0	8	80	0.1000000
NODE_678_length_2908_cov_5.937344	2624	2704	2	72	80	0.9000000
NODE_678_length_2908_cov_5.937344	2677	2757	0	11	80	0.1375000
NODE_678_length_2908_cov_5.937344	2677	2757	2	69	80	0.8625000
NODE_679_length_2905_cov_12.777619	2358	2419	0	58	61	0.9508197
NODE_679_length_2905_cov_12.777619	2358	2419	4	3	61	0.0491803
NODE_679_length_2905_cov_12.777619	2358	2419	0	58	61	0.9508197
NODE_679_length_2905_cov_12.777619	2358	2419	4	3	61	0.0491803
NODE_679_length_2905_cov_12.777619	2358	2419	0	58	61	0.9508197
NODE_679_length_2905_cov_12.777619	2358	2419	4	3	61	0.0491803
NODE_679_length_2905_cov_12.777619	2392	2472	0	80	80	1.0000000
NODE_680_length_2903_cov_5.474322	2423	2464	18	4	41	0.0975610
NODE_680_length_2903_cov_5.474322	2423	2464	20	37	41	0.9024390
NODE_684_length_2898_cov_5.786352	0	74	0	40	74	0.5405405
NODE_684_length_2898_cov_5.786352	0	74	4	12	74	0.1621622
NODE_684_length_2898_cov_5.786352	0	74	8	22	74	0.2972973
NODE_684_length_2898_cov_5.786352	47	124	4	6	77	0.0779221
NODE_684_length_2898_cov_5.786352	47	124	8	71	77	0.9220779
NODE_686_length_2895_cov_8.519313	869	949	2	67	80	0.8375000
NODE_686_length_2895_cov_8.519313	869	949	4	13	80	0.1625000
NODE_686_length_2895_cov_8.519313	922	1002	0	41	80	0.5125000
NODE_686_length_2895_cov_8.519313	922	1002	2	32	80	0.4000000
NODE_686_length_2895_cov_8.519313	922	1002	4	7	80	0.0875000
NODE_688_length_2894_cov_2.036136	2677	2757	10	4	80	0.0500000
NODE_688_length_2894_cov_2.036136	2677	2757	14	6	80	0.0750000
NODE_688_length_2894_cov_2.036136	2677	2757	16	1	80	0.0125000
NODE_688_length_2894_cov_2.036136	2677	2757	18	3	80	0.0375000
NODE_688_length_2894_cov_2.036136	2677	2757	20	8	80	0.1000000
NODE_688_length_2894_cov_2.036136	2677	2757	22	16	80	0.2000000
NODE_688_length_2894_cov_2.036136	2677	2757	24	42	80	0.5250000
NODE_689_length_2891_cov_7.938037	193	275	4	10	82	0.1219512
NODE_689_length_2891_cov_7.938037	193	275	6	32	82	0.3902439
NODE_689_length_2891_cov_7.938037	193	275	8	8	82	0.0975610
NODE_689_length_2891_cov_7.938037	193	275	10	12	82	0.1463415
NODE_689_length_2891_cov_7.938037	193	275	12	2	82	0.0243902
NODE_689_length_2891_cov_7.938037	193	275	14	9	82	0.1097561
NODE_689_length_2891_cov_7.938037	193	275	16	2	82	0.0243902
NODE_689_length_2891_cov_7.938037	193	275	18	6	82	0.0731707
NODE_689_length_2891_cov_7.938037	193	275	22	1	82	0.0121951
NODE_691_length_2889_cov_11.426882	407	487	0	58	80	0.7250000
NODE_691_length_2889_cov_11.426882	407	487	11	1	80	0.0125000
NODE_691_length_2889_cov_11.426882	407	487	12	21	80	0.2625000
NODE_691_length_2889_cov_11.426882	460	540	0	5	80	0.0625000
NODE_691_length_2889_cov_11.426882	460	540	11	1	80	0.0125000
NODE_691_length_2889_cov_11.426882	460	540	12	74	80	0.9250000
NODE_691_length_2889_cov_11.426882	1006	1086	11	1	80	0.0125000
NODE_691_length_2889_cov_11.426882	1006	1086	13	3	80	0.0375000
NODE_691_length_2889_cov_11.426882	1006	1086	16	1	80	0.0125000
NODE_691_length_2889_cov_11.426882	1006	1086	18	1	80	0.0125000
NODE_691_length_2889_cov_11.426882	1006	1086	19	5	80	0.0625000
NODE_691_length_2889_cov_11.426882	1006	1086	21	2	80	0.0250000
NODE_691_length_2889_cov_11.426882	1006	1086	23	1	80	0.0125000
NODE_691_length_2889_cov_11.426882	1006	1086	24	2	80	0.0250000
NODE_691_length_2889_cov_11.426882	1006	1086	25	3	80	0.0375000
NODE_691_length_2889_cov_11.426882	1006	1086	26	2	80	0.0250000
NODE_691_length_2889_cov_11.426882	1006	1086	28	14	80	0.1750000
NODE_691_length_2889_cov_11.426882	1006	1086	30	3	80	0.0375000
NODE_691_length_2889_cov_11.426882	1006	1086	33	1	80	0.0125000
NODE_691_length_2889_cov_11.426882	1006	1086	34	2	80	0.0250000
NODE_691_length_2889_cov_11.426882	1006	1086	36	2	80	0.0250000
NODE_691_length_2889_cov_11.426882	1006	1086	40	23	80	0.2875000
NODE_691_length_2889_cov_11.426882	1006	1086	42	3	80	0.0375000
NODE_691_length_2889_cov_11.426882	1006	1086	44	4	80	0.0500000
NODE_691_length_2889_cov_11.426882	1006	1086	45	1	80	0.0125000
NODE_691_length_2889_cov_11.426882	1006	1086	46	6	80	0.0750000
NODE_691_length_2889_cov_11.426882	1007	1086	11	1	79	0.0126582
NODE_691_length_2889_cov_11.426882	1007	1086	13	3	79	0.0379747
NODE_691_length_2889_cov_11.426882	1007	1086	16	1	79	0.0126582
NODE_691_length_2889_cov_11.426882	1007	1086	18	1	79	0.0126582
NODE_691_length_2889_cov_11.426882	1007	1086	19	5	79	0.0632911
NODE_691_length_2889_cov_11.426882	1007	1086	21	2	79	0.0253165
NODE_691_length_2889_cov_11.426882	1007	1086	23	1	79	0.0126582
NODE_691_length_2889_cov_11.426882	1007	1086	24	2	79	0.0253165
NODE_691_length_2889_cov_11.426882	1007	1086	25	3	79	0.0379747
NODE_691_length_2889_cov_11.426882	1007	1086	26	2	79	0.0253165
NODE_691_length_2889_cov_11.426882	1007	1086	28	14	79	0.1772152
NODE_691_length_2889_cov_11.426882	1007	1086	30	3	79	0.0379747
NODE_691_length_2889_cov_11.426882	1007	1086	33	1	79	0.0126582
NODE_691_length_2889_cov_11.426882	1007	1086	34	2	79	0.0253165
NODE_691_length_2889_cov_11.426882	1007	1086	36	2	79	0.0253165
NODE_691_length_2889_cov_11.426882	1007	1086	40	23	79	0.2911392
NODE_691_length_2889_cov_11.426882	1007	1086	42	3	79	0.0379747
NODE_691_length_2889_cov_11.426882	1007	1086	44	4	79	0.0506329
NODE_691_length_2889_cov_11.426882	1007	1086	45	1	79	0.0126582
NODE_691_length_2889_cov_11.426882	1007	1086	46	5	79	0.0632911
NODE_691_length_2889_cov_11.426882	1059	1138	0	35	79	0.4430380
NODE_691_length_2889_cov_11.426882	1059	1138	2	8	79	0.1012658
NODE_691_length_2889_cov_11.426882	1059	1138	3	4	79	0.0506329
NODE_691_length_2889_cov_11.426882	1059	1138	7	1	79	0.0126582
NODE_691_length_2889_cov_11.426882	1059	1138	9	4	79	0.0506329
NODE_691_length_2889_cov_11.426882	1059	1138	11	1	79	0.0126582
NODE_691_length_2889_cov_11.426882	1059	1138	13	3	79	0.0379747
NODE_691_length_2889_cov_11.426882	1059	1138	16	1	79	0.0126582
NODE_691_length_2889_cov_11.426882	1059	1138	18	1	79	0.0126582
NODE_691_length_2889_cov_11.426882	1059	1138	19	5	79	0.0632911
NODE_691_length_2889_cov_11.426882	1059	1138	21	2	79	0.0253165
NODE_691_length_2889_cov_11.426882	1059	1138	23	1	79	0.0126582
NODE_691_length_2889_cov_11.426882	1059	1138	24	2	79	0.0253165
NODE_691_length_2889_cov_11.426882	1059	1138	25	3	79	0.0379747
NODE_691_length_2889_cov_11.426882	1059	1138	26	2	79	0.0253165
NODE_691_length_2889_cov_11.426882	1059	1138	28	6	79	0.0759494
NODE_691_length_2889_cov_11.426882	1059	1138	0	35	79	0.4430380
NODE_691_length_2889_cov_11.426882	1059	1138	2	8	79	0.1012658
NODE_691_length_2889_cov_11.426882	1059	1138	3	4	79	0.0506329
NODE_691_length_2889_cov_11.426882	1059	1138	7	1	79	0.0126582
NODE_691_length_2889_cov_11.426882	1059	1138	9	4	79	0.0506329
NODE_691_length_2889_cov_11.426882	1059	1138	11	1	79	0.0126582
NODE_691_length_2889_cov_11.426882	1059	1138	13	3	79	0.0379747
NODE_691_length_2889_cov_11.426882	1059	1138	16	1	79	0.0126582
NODE_691_length_2889_cov_11.426882	1059	1138	18	1	79	0.0126582
NODE_691_length_2889_cov_11.426882	1059	1138	19	5	79	0.0632911
NODE_691_length_2889_cov_11.426882	1059	1138	21	2	79	0.0253165
NODE_691_length_2889_cov_11.426882	1059	1138	23	1	79	0.0126582
NODE_691_length_2889_cov_11.426882	1059	1138	24	2	79	0.0253165
NODE_691_length_2889_cov_11.426882	1059	1138	25	3	79	0.0379747
NODE_691_length_2889_cov_11.426882	1059	1138	26	2	79	0.0253165
NODE_691_length_2889_cov_11.426882	1059	1138	28	6	79	0.0759494
NODE_693_length_2888_cov_3.789172	992	1072	13	19	80	0.2375000
NODE_693_length_2888_cov_3.789172	992	1072	14	48	80	0.6000000
NODE_693_length_2888_cov_3.789172	992	1072	16	13	80	0.1625000
NODE_693_length_2888_cov_3.789172	1045	1087	2	9	42	0.2142857
NODE_693_length_2888_cov_3.789172	1045	1087	6	6	42	0.1428571
NODE_693_length_2888_cov_3.789172	1045	1087	13	19	42	0.4523810
NODE_693_length_2888_cov_3.789172	1045	1087	14	8	42	0.1904762
NODE_697_length_2878_cov_6.277798	2712	2781	2	6	69	0.0869565
NODE_697_length_2878_cov_6.277798	2712	2781	3	36	69	0.5217391
NODE_697_length_2878_cov_6.277798	2712	2781	4	3	69	0.0434783
NODE_697_length_2878_cov_6.277798	2712	2781	6	9	69	0.1304348
NODE_697_length_2878_cov_6.277798	2712	2781	8	15	69	0.2173913
NODE_703_length_2862_cov_9.060803	2409	2489	0	80	80	1.0000000
NODE_703_length_2862_cov_9.060803	2462	2542	0	80	80	1.0000000
NODE_712_length_2840_cov_2.079533	1660	1740	0	63	80	0.7875000
NODE_712_length_2840_cov_2.079533	1660	1740	2	17	80	0.2125000
NODE_713_length_2839_cov_16.762044	327	402	0	75	75	1.0000000
NODE_713_length_2839_cov_16.762044	380	468	0	88	88	1.0000000
NODE_713_length_2839_cov_16.762044	1021	1101	0	40	80	0.5000000
NODE_713_length_2839_cov_16.762044	1021	1101	2	40	80	0.5000000
NODE_713_length_2839_cov_16.762044	1074	1154	0	37	80	0.4625000
NODE_713_length_2839_cov_16.762044	1074	1154	2	43	80	0.5375000
NODE_714_length_2835_cov_29.691520	1552	1581	254	1	29	0.0344828
NODE_714_length_2835_cov_29.691520	1552	1581	258	4	29	0.1379310
NODE_714_length_2835_cov_29.691520	1552	1581	259	2	29	0.0689655
NODE_714_length_2835_cov_29.691520	1552	1581	263	1	29	0.0344828
NODE_714_length_2835_cov_29.691520	1552	1581	267	2	29	0.0689655
NODE_714_length_2835_cov_29.691520	1552	1581	271	1	29	0.0344828
NODE_714_length_2835_cov_29.691520	1552	1581	274	1	29	0.0344828
NODE_714_length_2835_cov_29.691520	1552	1581	278	1	29	0.0344828
NODE_714_length_2835_cov_29.691520	1552	1581	283	1	29	0.0344828
NODE_714_length_2835_cov_29.691520	1552	1581	284	1	29	0.0344828
NODE_714_length_2835_cov_29.691520	1552	1581	286	1	29	0.0344828
NODE_714_length_2835_cov_29.691520	1552	1581	293	2	29	0.0689655
NODE_714_length_2835_cov_29.691520	1552	1581	297	1	29	0.0344828
NODE_714_length_2835_cov_29.691520	1552	1581	298	1	29	0.0344828
NODE_714_length_2835_cov_29.691520	1552	1581	301	1	29	0.0344828
NODE_714_length_2835_cov_29.691520	1552	1581	304	1	29	0.0344828
NODE_714_length_2835_cov_29.691520	1552	1581	307	1	29	0.0344828
NODE_714_length_2835_cov_29.691520	1552	1581	309	1	29	0.0344828
NODE_714_length_2835_cov_29.691520	1552	1581	311	1	29	0.0344828
NODE_714_length_2835_cov_29.691520	1552	1581	312	1	29	0.0344828
NODE_714_length_2835_cov_29.691520	1552	1581	317	1	29	0.0344828
NODE_714_length_2835_cov_29.691520	1552	1581	320	1	29	0.0344828
NODE_714_length_2835_cov_29.691520	1552	1581	325	1	29	0.0344828
NODE_714_length_2835_cov_29.691520	1554	1629	42	2	75	0.0266667
NODE_714_length_2835_cov_29.691520	1554	1629	46	2	75	0.0266667
NODE_714_length_2835_cov_29.691520	1554	1629	50	1	75	0.0133333
NODE_714_length_2835_cov_29.691520	1554	1629	57	2	75	0.0266667
NODE_714_length_2835_cov_29.691520	1554	1629	60	1	75	0.0133333
NODE_714_length_2835_cov_29.691520	1554	1629	64	1	75	0.0133333
NODE_714_length_2835_cov_29.691520	1554	1629	67	1	75	0.0133333
NODE_714_length_2835_cov_29.691520	1554	1629	69	1	75	0.0133333
NODE_714_length_2835_cov_29.691520	1554	1629	74	1	75	0.0133333
NODE_714_length_2835_cov_29.691520	1554	1629	77	1	75	0.0133333
NODE_714_length_2835_cov_29.691520	1554	1629	87	1	75	0.0133333
NODE_714_length_2835_cov_29.691520	1554	1629	91	2	75	0.0266667
NODE_714_length_2835_cov_29.691520	1554	1629	100	1	75	0.0133333
NODE_714_length_2835_cov_29.691520	1554	1629	106	1	75	0.0133333
NODE_714_length_2835_cov_29.691520	1554	1629	113	1	75	0.0133333
NODE_714_length_2835_cov_29.691520	1554	1629	120	1	75	0.0133333
NODE_714_length_2835_cov_29.691520	1554	1629	124	1	75	0.0133333
NODE_714_length_2835_cov_29.691520	1554	1629	132	1	75	0.0133333
NODE_714_length_2835_cov_29.691520	1554	1629	147	2	75	0.0266667
NODE_714_length_2835_cov_29.691520	1554	1629	149	2	75	0.0266667
NODE_714_length_2835_cov_29.691520	1554	1629	160	1	75	0.0133333
NODE_714_length_2835_cov_29.691520	1554	1629	174	1	75	0.0133333
NODE_714_length_2835_cov_29.691520	1554	1629	180	2	75	0.0266667
NODE_714_length_2835_cov_29.691520	1554	1629	183	1	75	0.0133333
NODE_714_length_2835_cov_29.691520	1554	1629	185	1	75	0.0133333
NODE_714_length_2835_cov_29.691520	1554	1629	195	1	75	0.0133333
NODE_714_length_2835_cov_29.691520	1554	1629	199	1	75	0.0133333
NODE_714_length_2835_cov_29.691520	1554	1629	202	1	75	0.0133333
NODE_714_length_2835_cov_29.691520	1554	1629	204	1	75	0.0133333
NODE_714_length_2835_cov_29.691520	1554	1629	207	1	75	0.0133333
NODE_714_length_2835_cov_29.691520	1554	1629	215	1	75	0.0133333
NODE_714_length_2835_cov_29.691520	1554	1629	217	1	75	0.0133333
NODE_714_length_2835_cov_29.691520	1554	1629	222	1	75	0.0133333
NODE_714_length_2835_cov_29.691520	1554	1629	224	1	75	0.0133333
NODE_714_length_2835_cov_29.691520	1554	1629	233	1	75	0.0133333
NODE_714_length_2835_cov_29.691520	1554	1629	236	1	75	0.0133333
NODE_714_length_2835_cov_29.691520	1554	1629	244	1	75	0.0133333
NODE_714_length_2835_cov_29.691520	1554	1629	248	1	75	0.0133333
NODE_714_length_2835_cov_29.691520	1554	1629	253	1	75	0.0133333
NODE_714_length_2835_cov_29.691520	1554	1629	254	3	75	0.0400000
NODE_714_length_2835_cov_29.691520	1554	1629	258	4	75	0.0533333
NODE_714_length_2835_cov_29.691520	1554	1629	259	2	75	0.0266667
NODE_714_length_2835_cov_29.691520	1554	1629	263	1	75	0.0133333
NODE_714_length_2835_cov_29.691520	1554	1629	267	2	75	0.0266667
NODE_714_length_2835_cov_29.691520	1554	1629	271	1	75	0.0133333
NODE_714_length_2835_cov_29.691520	1554	1629	274	1	75	0.0133333
NODE_714_length_2835_cov_29.691520	1554	1629	278	1	75	0.0133333
NODE_714_length_2835_cov_29.691520	1554	1629	283	1	75	0.0133333
NODE_714_length_2835_cov_29.691520	1554	1629	284	1	75	0.0133333
NODE_714_length_2835_cov_29.691520	1554	1629	286	1	75	0.0133333
NODE_714_length_2835_cov_29.691520	1554	1629	293	2	75	0.0266667
NODE_714_length_2835_cov_29.691520	1554	1629	297	1	75	0.0133333
NODE_714_length_2835_cov_29.691520	1554	1629	298	1	75	0.0133333
NODE_714_length_2835_cov_29.691520	1554	1629	301	1	75	0.0133333
NODE_714_length_2835_cov_29.691520	1554	1629	304	1	75	0.0133333
NODE_714_length_2835_cov_29.691520	1554	1629	307	1	75	0.0133333
NODE_714_length_2835_cov_29.691520	1554	1629	309	1	75	0.0133333
NODE_714_length_2835_cov_29.691520	1554	1629	311	1	75	0.0133333
NODE_714_length_2835_cov_29.691520	1554	1629	312	1	75	0.0133333
NODE_714_length_2835_cov_29.691520	1554	1629	317	1	75	0.0133333
NODE_720_length_2825_cov_9.731108	487	567	1	7	80	0.0875000
NODE_720_length_2825_cov_9.731108	487	567	3	73	80	0.9125000
NODE_720_length_2825_cov_9.731108	540	620	1	43	80	0.5375000
NODE_720_length_2825_cov_9.731108	540	620	3	37	80	0.4625000
NODE_726_length_2810_cov_2.844338	206	289	10	4	83	0.0481928
NODE_726_length_2810_cov_2.844338	206	289	14	1	83	0.0120482
NODE_726_length_2810_cov_2.844338	206	289	17	2	83	0.0240964
NODE_726_length_2810_cov_2.844338	206	289	19	8	83	0.0963855
NODE_726_length_2810_cov_2.844338	206	289	21	11	83	0.1325301
NODE_726_length_2810_cov_2.844338	206	289	27	5	83	0.0602410
NODE_726_length_2810_cov_2.844338	206	289	31	3	83	0.0361446
NODE_726_length_2810_cov_2.844338	206	289	32	5	83	0.0602410
NODE_726_length_2810_cov_2.844338	206	289	34	1	83	0.0120482
NODE_726_length_2810_cov_2.844338	206	289	36	3	83	0.0361446
NODE_726_length_2810_cov_2.844338	206	289	37	1	83	0.0120482
NODE_726_length_2810_cov_2.844338	206	289	42	1	83	0.0120482
NODE_726_length_2810_cov_2.844338	206	289	44	1	83	0.0120482
NODE_726_length_2810_cov_2.844338	206	289	55	13	83	0.1566265
NODE_726_length_2810_cov_2.844338	206	289	57	6	83	0.0722892
NODE_726_length_2810_cov_2.844338	206	289	61	3	83	0.0361446
NODE_726_length_2810_cov_2.844338	206	289	63	1	83	0.0120482
NODE_726_length_2810_cov_2.844338	206	289	66	6	83	0.0722892
NODE_726_length_2810_cov_2.844338	206	289	68	3	83	0.0361446
NODE_726_length_2810_cov_2.844338	206	289	70	3	83	0.0361446
NODE_726_length_2810_cov_2.844338	206	289	72	1	83	0.0120482
NODE_726_length_2810_cov_2.844338	206	289	74	1	83	0.0120482
NODE_728_length_2808_cov_2.867110	140	163	12	1	23	0.0434783
NODE_728_length_2808_cov_2.867110	140	163	14	14	23	0.6086956
NODE_728_length_2808_cov_2.867110	140	163	18	5	23	0.2173913
NODE_728_length_2808_cov_2.867110	140	163	20	3	23	0.1304348
NODE_729_length_2807_cov_8.423191	125	205	0	12	80	0.1500000
NODE_729_length_2807_cov_8.423191	125	205	2	26	80	0.3250000
NODE_729_length_2807_cov_8.423191	125	205	4	42	80	0.5250000
NODE_729_length_2807_cov_8.423191	178	258	2	3	80	0.0375000
NODE_729_length_2807_cov_8.423191	178	258	4	67	80	0.8375000
NODE_729_length_2807_cov_8.423191	178	258	6	10	80	0.1250000
NODE_729_length_2807_cov_8.423191	2451	2515	2	32	64	0.5000000
NODE_729_length_2807_cov_8.423191	2451	2515	4	32	64	0.5000000
NODE_735_length_2801_cov_26.131384	461	521	4	60	60	1.0000000
NODE_735_length_2801_cov_26.131384	494	574	0	48	80	0.6000000
NODE_735_length_2801_cov_26.131384	494	574	4	32	80	0.4000000
NODE_735_length_2801_cov_26.131384	1536	1596	62	2	60	0.0333333
NODE_735_length_2801_cov_26.131384	1536	1596	68	1	60	0.0166667
NODE_735_length_2801_cov_26.131384	1536	1596	76	2	60	0.0333333
NODE_735_length_2801_cov_26.131384	1536	1596	77	1	60	0.0166667
NODE_735_length_2801_cov_26.131384	1536	1596	78	1	60	0.0166667
NODE_735_length_2801_cov_26.131384	1536	1596	80	1	60	0.0166667
NODE_735_length_2801_cov_26.131384	1536	1596	84	4	60	0.0666667
NODE_735_length_2801_cov_26.131384	1536	1596	88	2	60	0.0333333
NODE_735_length_2801_cov_26.131384	1536	1596	96	1	60	0.0166667
NODE_735_length_2801_cov_26.131384	1536	1596	98	1	60	0.0166667
NODE_735_length_2801_cov_26.131384	1536	1596	102	1	60	0.0166667
NODE_735_length_2801_cov_26.131384	1536	1596	104	1	60	0.0166667
NODE_735_length_2801_cov_26.131384	1536	1596	107	1	60	0.0166667
NODE_735_length_2801_cov_26.131384	1536	1596	114	2	60	0.0333333
NODE_735_length_2801_cov_26.131384	1536	1596	124	2	60	0.0333333
NODE_735_length_2801_cov_26.131384	1536	1596	130	1	60	0.0166667
NODE_735_length_2801_cov_26.131384	1536	1596	132	1	60	0.0166667
NODE_735_length_2801_cov_26.131384	1536	1596	140	1	60	0.0166667
NODE_735_length_2801_cov_26.131384	1536	1596	144	1	60	0.0166667
NODE_735_length_2801_cov_26.131384	1536	1596	150	2	60	0.0333333
NODE_735_length_2801_cov_26.131384	1536	1596	154	2	60	0.0333333
NODE_735_length_2801_cov_26.131384	1536	1596	157	2	60	0.0333333
NODE_735_length_2801_cov_26.131384	1536	1596	159	1	60	0.0166667
NODE_735_length_2801_cov_26.131384	1536	1596	161	3	60	0.0500000
NODE_735_length_2801_cov_26.131384	1536	1596	162	1	60	0.0166667
NODE_735_length_2801_cov_26.131384	1536	1596	166	2	60	0.0333333
NODE_735_length_2801_cov_26.131384	1536	1596	167	2	60	0.0333333
NODE_735_length_2801_cov_26.131384	1536	1596	169	1	60	0.0166667
NODE_735_length_2801_cov_26.131384	1536	1596	175	1	60	0.0166667
NODE_735_length_2801_cov_26.131384	1536	1596	177	6	60	0.1000000
NODE_735_length_2801_cov_26.131384	1536	1596	179	1	60	0.0166667
NODE_735_length_2801_cov_26.131384	1536	1596	180	1	60	0.0166667
NODE_735_length_2801_cov_26.131384	1536	1596	191	2	60	0.0333333
NODE_735_length_2801_cov_26.131384	1536	1596	201	2	60	0.0333333
NODE_735_length_2801_cov_26.131384	1536	1596	202	1	60	0.0166667
NODE_735_length_2801_cov_26.131384	1536	1596	206	2	60	0.0333333
NODE_735_length_2801_cov_26.131384	1536	1596	208	1	60	0.0166667
NODE_735_length_2801_cov_26.131384	1815	1881	0	66	66	1.0000000
NODE_735_length_2801_cov_26.131384	1854	1934	0	80	80	1.0000000
NODE_736_length_2801_cov_3.594375	2589	2645	11	19	56	0.3392857
NODE_736_length_2801_cov_3.594375	2589	2645	13	14	56	0.2500000
NODE_736_length_2801_cov_3.594375	2589	2645	17	6	56	0.1071429
NODE_736_length_2801_cov_3.594375	2589	2645	18	3	56	0.0535714
NODE_736_length_2801_cov_3.594375	2589	2645	19	14	56	0.2500000
NODE_738_length_2796_cov_94.511680	1090	1137	9	1	47	0.0212766
NODE_738_length_2796_cov_94.511680	1090	1137	14	1	47	0.0212766
NODE_738_length_2796_cov_94.511680	1090	1137	16	2	47	0.0425532
NODE_738_length_2796_cov_94.511680	1090	1137	18	3	47	0.0638298
NODE_738_length_2796_cov_94.511680	1090	1137	23	3	47	0.0638298
NODE_738_length_2796_cov_94.511680	1090	1137	24	1	47	0.0212766
NODE_738_length_2796_cov_94.511680	1090	1137	34	1	47	0.0212766
NODE_738_length_2796_cov_94.511680	1090	1137	36	1	47	0.0212766
NODE_738_length_2796_cov_94.511680	1090	1137	38	1	47	0.0212766
NODE_738_length_2796_cov_94.511680	1090	1137	41	1	47	0.0212766
NODE_738_length_2796_cov_94.511680	1090	1137	43	2	47	0.0425532
NODE_738_length_2796_cov_94.511680	1090	1137	46	1	47	0.0212766
NODE_738_length_2796_cov_94.511680	1090	1137	47	1	47	0.0212766
NODE_738_length_2796_cov_94.511680	1090	1137	48	1	47	0.0212766
NODE_738_length_2796_cov_94.511680	1090	1137	50	1	47	0.0212766
NODE_738_length_2796_cov_94.511680	1090	1137	53	1	47	0.0212766
NODE_738_length_2796_cov_94.511680	1090	1137	55	2	47	0.0425532
NODE_738_length_2796_cov_94.511680	1090	1137	62	1	47	0.0212766
NODE_738_length_2796_cov_94.511680	1090	1137	69	1	47	0.0212766
NODE_738_length_2796_cov_94.511680	1090	1137	71	1	47	0.0212766
NODE_738_length_2796_cov_94.511680	1090	1137	75	1	47	0.0212766
NODE_738_length_2796_cov_94.511680	1090	1137	76	1	47	0.0212766
NODE_738_length_2796_cov_94.511680	1090	1137	80	2	47	0.0425532
NODE_738_length_2796_cov_94.511680	1090	1137	88	2	47	0.0425532
NODE_738_length_2796_cov_94.511680	1090	1137	92	1	47	0.0212766
NODE_738_length_2796_cov_94.511680	1090	1137	95	3	47	0.0638298
NODE_738_length_2796_cov_94.511680	1090	1137	106	1	47	0.0212766
NODE_738_length_2796_cov_94.511680	1090	1137	111	1	47	0.0212766
NODE_738_length_2796_cov_94.511680	1090	1137	122	1	47	0.0212766
NODE_738_length_2796_cov_94.511680	1090	1137	127	1	47	0.0212766
NODE_738_length_2796_cov_94.511680	1090	1137	129	1	47	0.0212766
NODE_738_length_2796_cov_94.511680	1090	1137	133	1	47	0.0212766
NODE_738_length_2796_cov_94.511680	1090	1137	135	1	47	0.0212766
NODE_738_length_2796_cov_94.511680	1090	1137	139	1	47	0.0212766
NODE_738_length_2796_cov_94.511680	1090	1137	146	1	47	0.0212766
NODE_738_length_2796_cov_94.511680	1090	1137	149	1	47	0.0212766
NODE_738_length_2796_cov_94.511680	2717	2796	0	79	79	1.0000000
NODE_744_length_2791_cov_9.997028	310	390	18	18	80	0.2250000
NODE_744_length_2791_cov_9.997028	310	390	34	1	80	0.0125000
NODE_744_length_2791_cov_9.997028	310	390	36	61	80	0.7625000
NODE_744_length_2791_cov_9.997028	363	443	0	47	80	0.5875000
NODE_744_length_2791_cov_9.997028	363	443	17	1	80	0.0125000
NODE_744_length_2791_cov_9.997028	363	443	18	23	80	0.2875000
NODE_744_length_2791_cov_9.997028	363	443	34	1	80	0.0125000
NODE_744_length_2791_cov_9.997028	363	443	36	8	80	0.1000000
NODE_752_length_2778_cov_31.340799	2241	2321	0	80	80	1.0000000
NODE_752_length_2778_cov_31.340799	2294	2374	0	80	80	1.0000000
NODE_752_length_2778_cov_31.340799	2370	2450	0	17	80	0.2125000
NODE_752_length_2778_cov_31.340799	2370	2450	2	63	80	0.7875000
NODE_752_length_2778_cov_31.340799	2423	2503	0	38	80	0.4750000
NODE_752_length_2778_cov_31.340799	2423	2503	2	42	80	0.5250000
NODE_752_length_2778_cov_31.340799	2564	2620	0	56	56	1.0000000
NODE_758_length_2767_cov_12.450150	1941	2021	0	80	80	1.0000000
NODE_758_length_2767_cov_12.450150	1994	2074	0	80	80	1.0000000
NODE_767_length_2745_cov_5.322751	511	583	0	19	72	0.2638889
NODE_767_length_2745_cov_5.322751	511	583	2	53	72	0.7361111
NODE_777_length_2720_cov_25.561618	2213	2293	0	22	80	0.2750000
NODE_777_length_2720_cov_25.561618	2213	2293	2	58	80	0.7250000
NODE_777_length_2720_cov_25.561618	2266	2346	2	80	80	1.0000000
NODE_782_length_2716_cov_39.885747	715	795	10	15	80	0.1875000
NODE_782_length_2716_cov_39.885747	715	795	12	30	80	0.3750000
NODE_782_length_2716_cov_39.885747	715	795	14	7	80	0.0875000
NODE_782_length_2716_cov_39.885747	715	795	16	28	80	0.3500000
NODE_782_length_2716_cov_39.885747	768	848	4	11	80	0.1375000
NODE_782_length_2716_cov_39.885747	768	848	6	24	80	0.3000000
NODE_782_length_2716_cov_39.885747	768	848	7	6	80	0.0750000
NODE_782_length_2716_cov_39.885747	768	848	8	12	80	0.1500000
NODE_782_length_2716_cov_39.885747	768	848	10	15	80	0.1875000
NODE_782_length_2716_cov_39.885747	768	848	12	12	80	0.1500000
NODE_782_length_2716_cov_39.885747	844	924	4	45	80	0.5625000
NODE_782_length_2716_cov_39.885747	844	924	6	35	80	0.4375000
NODE_782_length_2716_cov_39.885747	897	977	0	11	80	0.1375000
NODE_782_length_2716_cov_39.885747	897	977	2	14	80	0.1750000
NODE_782_length_2716_cov_39.885747	897	977	4	41	80	0.5125000
NODE_782_length_2716_cov_39.885747	897	977	6	14	80	0.1750000
NODE_785_length_2710_cov_10.896974	2410	2446	2	8	36	0.2222222
NODE_785_length_2710_cov_10.896974	2410	2446	4	10	36	0.2777778
NODE_785_length_2710_cov_10.896974	2410	2446	6	16	36	0.4444444
NODE_785_length_2710_cov_10.896974	2410	2446	11	1	36	0.0277778
NODE_785_length_2710_cov_10.896974	2410	2446	12	1	36	0.0277778
NODE_785_length_2710_cov_10.896974	2419	2499	4	9	80	0.1125000
NODE_785_length_2710_cov_10.896974	2419	2499	6	16	80	0.2000000
NODE_785_length_2710_cov_10.896974	2419	2499	11	1	80	0.0125000
NODE_785_length_2710_cov_10.896974	2419	2499	12	9	80	0.1125000
NODE_785_length_2710_cov_10.896974	2419	2499	14	6	80	0.0750000
NODE_785_length_2710_cov_10.896974	2419	2499	18	7	80	0.0875000
NODE_785_length_2710_cov_10.896974	2419	2499	19	1	80	0.0125000
NODE_785_length_2710_cov_10.896974	2419	2499	20	3	80	0.0375000
NODE_785_length_2710_cov_10.896974	2419	2499	22	6	80	0.0750000
NODE_785_length_2710_cov_10.896974	2419	2499	24	10	80	0.1250000
NODE_785_length_2710_cov_10.896974	2419	2499	26	2	80	0.0250000
NODE_785_length_2710_cov_10.896974	2419	2499	28	6	80	0.0750000
NODE_785_length_2710_cov_10.896974	2419	2499	30	4	80	0.0500000
NODE_788_length_2708_cov_25.097355	2289	2369	0	80	80	1.0000000
NODE_788_length_2708_cov_25.097355	2342	2422	0	80	80	1.0000000
NODE_789_length_2708_cov_14.569950	18	98	105	1	80	0.0125000
NODE_789_length_2708_cov_14.569950	18	98	106	1	80	0.0125000
NODE_789_length_2708_cov_14.569950	18	98	108	3	80	0.0375000
NODE_789_length_2708_cov_14.569950	18	98	117	3	80	0.0375000
NODE_789_length_2708_cov_14.569950	18	98	118	1	80	0.0125000
NODE_789_length_2708_cov_14.569950	18	98	120	2	80	0.0250000
NODE_789_length_2708_cov_14.569950	18	98	124	2	80	0.0250000
NODE_789_length_2708_cov_14.569950	18	98	126	67	80	0.8375000
NODE_789_length_2708_cov_14.569950	71	134	2	1	63	0.0158730
NODE_789_length_2708_cov_14.569950	71	134	16	1	63	0.0158730
NODE_789_length_2708_cov_14.569950	71	134	20	1	63	0.0158730
NODE_789_length_2708_cov_14.569950	71	134	28	1	63	0.0158730
NODE_789_length_2708_cov_14.569950	71	134	48	1	63	0.0158730
NODE_789_length_2708_cov_14.569950	71	134	52	1	63	0.0158730
NODE_789_length_2708_cov_14.569950	71	134	64	1	63	0.0158730
NODE_789_length_2708_cov_14.569950	71	134	66	1	63	0.0158730
NODE_789_length_2708_cov_14.569950	71	134	78	1	63	0.0158730
NODE_789_length_2708_cov_14.569950	71	134	80	1	63	0.0158730
NODE_789_length_2708_cov_14.569950	71	134	82	1	63	0.0158730
NODE_789_length_2708_cov_14.569950	71	134	90	3	63	0.0476190
NODE_789_length_2708_cov_14.569950	71	134	94	1	63	0.0158730
NODE_789_length_2708_cov_14.569950	71	134	104	1	63	0.0158730
NODE_789_length_2708_cov_14.569950	71	134	110	1	63	0.0158730
NODE_789_length_2708_cov_14.569950	71	134	112	1	63	0.0158730
NODE_789_length_2708_cov_14.569950	71	134	114	6	63	0.0952381
NODE_789_length_2708_cov_14.569950	71	134	118	2	63	0.0317460
NODE_789_length_2708_cov_14.569950	71	134	120	1	63	0.0158730
NODE_789_length_2708_cov_14.569950	71	134	126	36	63	0.5714286
NODE_797_length_2691_cov_35.457948	401	481	0	80	80	1.0000000
NODE_797_length_2691_cov_35.457948	454	534	0	80	80	1.0000000
NODE_803_length_2684_cov_17.345068	146	194	4	17	48	0.3541667
NODE_803_length_2684_cov_17.345068	146	194	6	29	48	0.6041667
NODE_803_length_2684_cov_17.345068	146	194	8	2	48	0.0416667
NODE_803_length_2684_cov_17.345068	146	194	4	17	48	0.3541667
NODE_803_length_2684_cov_17.345068	146	194	6	29	48	0.6041667
NODE_803_length_2684_cov_17.345068	146	194	8	2	48	0.0416667
NODE_803_length_2684_cov_17.345068	146	194	4	17	48	0.3541667
NODE_803_length_2684_cov_17.345068	146	194	6	29	48	0.6041667
NODE_803_length_2684_cov_17.345068	146	194	8	2	48	0.0416667
NODE_803_length_2684_cov_17.345068	146	194	4	17	48	0.3541667
NODE_803_length_2684_cov_17.345068	146	194	6	29	48	0.6041667
NODE_803_length_2684_cov_17.345068	146	194	8	2	48	0.0416667
NODE_803_length_2684_cov_17.345068	146	194	4	17	48	0.3541667
NODE_803_length_2684_cov_17.345068	146	194	6	29	48	0.6041667
NODE_803_length_2684_cov_17.345068	146	194	8	2	48	0.0416667
NODE_805_length_2682_cov_43.500581	913	992	263	3	79	0.0379747
NODE_805_length_2682_cov_43.500581	913	992	265	2	79	0.0253165
NODE_805_length_2682_cov_43.500581	913	992	267	2	79	0.0253165
NODE_805_length_2682_cov_43.500581	913	992	272	1	79	0.0126582
NODE_805_length_2682_cov_43.500581	913	992	278	1	79	0.0126582
NODE_805_length_2682_cov_43.500581	913	992	280	1	79	0.0126582
NODE_805_length_2682_cov_43.500581	913	992	282	1	79	0.0126582
NODE_805_length_2682_cov_43.500581	913	992	286	2	79	0.0253165
NODE_805_length_2682_cov_43.500581	913	992	290	1	79	0.0126582
NODE_805_length_2682_cov_43.500581	913	992	292	5	79	0.0632911
NODE_805_length_2682_cov_43.500581	913	992	294	1	79	0.0126582
NODE_805_length_2682_cov_43.500581	913	992	296	1	79	0.0126582
NODE_805_length_2682_cov_43.500581	913	992	298	1	79	0.0126582
NODE_805_length_2682_cov_43.500581	913	992	300	2	79	0.0253165
NODE_805_length_2682_cov_43.500581	913	992	301	1	79	0.0126582
NODE_805_length_2682_cov_43.500581	913	992	303	2	79	0.0253165
NODE_805_length_2682_cov_43.500581	913	992	304	1	79	0.0126582
NODE_805_length_2682_cov_43.500581	913	992	333	1	79	0.0126582
NODE_805_length_2682_cov_43.500581	913	992	346	1	79	0.0126582
NODE_805_length_2682_cov_43.500581	913	992	352	1	79	0.0126582
NODE_805_length_2682_cov_43.500581	913	992	356	1	79	0.0126582
NODE_805_length_2682_cov_43.500581	913	992	358	2	79	0.0253165
NODE_805_length_2682_cov_43.500581	913	992	359	2	79	0.0253165
NODE_805_length_2682_cov_43.500581	913	992	361	1	79	0.0126582
NODE_805_length_2682_cov_43.500581	913	992	362	1	79	0.0126582
NODE_805_length_2682_cov_43.500581	913	992	363	1	79	0.0126582
NODE_805_length_2682_cov_43.500581	913	992	366	1	79	0.0126582
NODE_805_length_2682_cov_43.500581	913	992	367	1	79	0.0126582
NODE_805_length_2682_cov_43.500581	913	992	370	2	79	0.0253165
NODE_805_length_2682_cov_43.500581	913	992	371	2	79	0.0253165
NODE_805_length_2682_cov_43.500581	913	992	373	2	79	0.0253165
NODE_805_length_2682_cov_43.500581	913	992	374	4	79	0.0506329
NODE_805_length_2682_cov_43.500581	913	992	375	2	79	0.0253165
NODE_805_length_2682_cov_43.500581	913	992	376	2	79	0.0253165
NODE_805_length_2682_cov_43.500581	913	992	377	1	79	0.0126582
NODE_805_length_2682_cov_43.500581	913	992	378	4	79	0.0506329
NODE_805_length_2682_cov_43.500581	913	992	379	1	79	0.0126582
NODE_805_length_2682_cov_43.500581	913	992	380	3	79	0.0379747
NODE_805_length_2682_cov_43.500581	913	992	382	2	79	0.0253165
NODE_805_length_2682_cov_43.500581	913	992	394	1	79	0.0126582
NODE_805_length_2682_cov_43.500581	913	992	408	1	79	0.0126582
NODE_805_length_2682_cov_43.500581	913	992	409	1	79	0.0126582
NODE_805_length_2682_cov_43.500581	913	992	411	1	79	0.0126582
NODE_805_length_2682_cov_43.500581	913	992	412	2	79	0.0253165
NODE_805_length_2682_cov_43.500581	913	992	415	1	79	0.0126582
NODE_805_length_2682_cov_43.500581	913	992	419	2	79	0.0253165
NODE_805_length_2682_cov_43.500581	913	992	423	1	79	0.0126582
NODE_805_length_2682_cov_43.500581	913	992	424	1	79	0.0126582
NODE_805_length_2682_cov_43.500581	913	992	432	1	79	0.0126582
NODE_805_length_2682_cov_43.500581	913	992	438	1	79	0.0126582
NODE_805_length_2682_cov_43.500581	965	1002	243	1	37	0.0270270
NODE_805_length_2682_cov_43.500581	965	1002	247	1	37	0.0270270
NODE_805_length_2682_cov_43.500581	965	1002	249	1	37	0.0270270
NODE_805_length_2682_cov_43.500581	965	1002	253	1	37	0.0270270
NODE_805_length_2682_cov_43.500581	965	1002	257	5	37	0.1351351
NODE_805_length_2682_cov_43.500581	965	1002	259	1	37	0.0270270
NODE_805_length_2682_cov_43.500581	965	1002	263	3	37	0.0810811
NODE_805_length_2682_cov_43.500581	965	1002	265	2	37	0.0540541
NODE_805_length_2682_cov_43.500581	965	1002	267	2	37	0.0540541
NODE_805_length_2682_cov_43.500581	965	1002	272	1	37	0.0270270
NODE_805_length_2682_cov_43.500581	965	1002	278	1	37	0.0270270
NODE_805_length_2682_cov_43.500581	965	1002	280	1	37	0.0270270
NODE_805_length_2682_cov_43.500581	965	1002	282	1	37	0.0270270
NODE_805_length_2682_cov_43.500581	965	1002	286	2	37	0.0540541
NODE_805_length_2682_cov_43.500581	965	1002	290	1	37	0.0270270
NODE_805_length_2682_cov_43.500581	965	1002	292	5	37	0.1351351
NODE_805_length_2682_cov_43.500581	965	1002	294	1	37	0.0270270
NODE_805_length_2682_cov_43.500581	965	1002	296	1	37	0.0270270
NODE_805_length_2682_cov_43.500581	965	1002	298	1	37	0.0270270
NODE_805_length_2682_cov_43.500581	965	1002	300	2	37	0.0540541
NODE_805_length_2682_cov_43.500581	965	1002	301	1	37	0.0270270
NODE_805_length_2682_cov_43.500581	965	1002	303	2	37	0.0540541
NODE_808_length_2675_cov_10.369565	209	289	8	10	80	0.1250000
NODE_808_length_2675_cov_10.369565	209	289	10	40	80	0.5000000
NODE_808_length_2675_cov_10.369565	209	289	12	13	80	0.1625000
NODE_808_length_2675_cov_10.369565	209	289	16	17	80	0.2125000
NODE_813_length_2670_cov_17.489304	1995	2075	0	80	80	1.0000000
NODE_813_length_2670_cov_17.489304	2048	2128	0	69	80	0.8625000
NODE_813_length_2670_cov_17.489304	2048	2128	2	8	80	0.1000000
NODE_813_length_2670_cov_17.489304	2048	2128	8	3	80	0.0375000
NODE_813_length_2670_cov_17.489304	2124	2204	2	1	80	0.0125000
NODE_813_length_2670_cov_17.489304	2124	2204	8	18	80	0.2250000
NODE_813_length_2670_cov_17.489304	2124	2204	10	16	80	0.2000000
NODE_813_length_2670_cov_17.489304	2124	2204	12	45	80	0.5625000
NODE_813_length_2670_cov_17.489304	2177	2257	0	15	80	0.1875000
NODE_813_length_2670_cov_17.489304	2177	2257	6	14	80	0.1750000
NODE_813_length_2670_cov_17.489304	2177	2257	10	40	80	0.5000000
NODE_813_length_2670_cov_17.489304	2177	2257	12	11	80	0.1375000
NODE_815_length_2665_cov_19.145752	548	628	0	34	80	0.4250000
NODE_815_length_2665_cov_19.145752	548	628	18	24	80	0.3000000
NODE_815_length_2665_cov_19.145752	548	628	30	22	80	0.2750000
NODE_815_length_2665_cov_19.145752	601	681	18	5	80	0.0625000
NODE_815_length_2665_cov_19.145752	601	681	26	12	80	0.1500000
NODE_815_length_2665_cov_19.145752	601	681	28	5	80	0.0625000
NODE_815_length_2665_cov_19.145752	601	681	30	58	80	0.7250000
NODE_815_length_2665_cov_19.145752	2099	2176	0	1	77	0.0129870
NODE_815_length_2665_cov_19.145752	2099	2176	1	5	77	0.0649351
NODE_815_length_2665_cov_19.145752	2099	2176	2	71	77	0.9220779
NODE_815_length_2665_cov_19.145752	2172	2252	2	10	80	0.1250000
NODE_815_length_2665_cov_19.145752	2172	2252	6	21	80	0.2625000
NODE_815_length_2665_cov_19.145752	2172	2252	10	4	80	0.0500000
NODE_815_length_2665_cov_19.145752	2172	2252	14	18	80	0.2250000
NODE_815_length_2665_cov_19.145752	2172	2252	22	27	80	0.3375000
NODE_815_length_2665_cov_19.145752	2172	2252	2	10	80	0.1250000
NODE_815_length_2665_cov_19.145752	2172	2252	6	21	80	0.2625000
NODE_815_length_2665_cov_19.145752	2172	2252	10	4	80	0.0500000
NODE_815_length_2665_cov_19.145752	2172	2252	14	18	80	0.2250000
NODE_815_length_2665_cov_19.145752	2172	2252	22	27	80	0.3375000
NODE_815_length_2665_cov_19.145752	2225	2267	22	42	42	1.0000000
NODE_816_length_2664_cov_4.175049	2005	2085	0	80	80	1.0000000
NODE_816_length_2664_cov_4.175049	2058	2138	0	29	80	0.3625000
NODE_816_length_2664_cov_4.175049	2058	2138	4	7	80	0.0875000
NODE_816_length_2664_cov_4.175049	2058	2138	6	32	80	0.4000000
NODE_816_length_2664_cov_4.175049	2058	2138	8	12	80	0.1500000
NODE_822_length_2650_cov_19.800862	800	880	25	3	80	0.0375000
NODE_822_length_2650_cov_19.800862	800	880	32	12	80	0.1500000
NODE_822_length_2650_cov_19.800862	800	880	34	6	80	0.0750000
NODE_822_length_2650_cov_19.800862	800	880	36	1	80	0.0125000
NODE_822_length_2650_cov_19.800862	800	880	37	4	80	0.0500000
NODE_822_length_2650_cov_19.800862	800	880	38	22	80	0.2750000
NODE_822_length_2650_cov_19.800862	800	880	39	11	80	0.1375000
NODE_822_length_2650_cov_19.800862	800	880	41	7	80	0.0875000
NODE_822_length_2650_cov_19.800862	800	880	44	13	80	0.1625000
NODE_822_length_2650_cov_19.800862	800	880	45	1	80	0.0125000
NODE_824_length_2645_cov_8.618225	931	1011	0	80	80	1.0000000
NODE_824_length_2645_cov_8.618225	984	1064	0	80	80	1.0000000
NODE_827_length_2640_cov_16.462810	94	164	174	1	70	0.0142857
NODE_827_length_2640_cov_16.462810	94	164	176	1	70	0.0142857
NODE_827_length_2640_cov_16.462810	94	164	179	1	70	0.0142857
NODE_827_length_2640_cov_16.462810	94	164	183	1	70	0.0142857
NODE_827_length_2640_cov_16.462810	94	164	192	2	70	0.0285714
NODE_827_length_2640_cov_16.462810	94	164	194	2	70	0.0285714
NODE_827_length_2640_cov_16.462810	94	164	199	1	70	0.0142857
NODE_827_length_2640_cov_16.462810	94	164	201	1	70	0.0142857
NODE_827_length_2640_cov_16.462810	94	164	203	2	70	0.0285714
NODE_827_length_2640_cov_16.462810	94	164	206	1	70	0.0142857
NODE_827_length_2640_cov_16.462810	94	164	218	1	70	0.0142857
NODE_827_length_2640_cov_16.462810	94	164	230	1	70	0.0142857
NODE_827_length_2640_cov_16.462810	94	164	232	1	70	0.0142857
NODE_827_length_2640_cov_16.462810	94	164	237	1	70	0.0142857
NODE_827_length_2640_cov_16.462810	94	164	241	1	70	0.0142857
NODE_827_length_2640_cov_16.462810	94	164	243	1	70	0.0142857
NODE_827_length_2640_cov_16.462810	94	164	244	2	70	0.0285714
NODE_827_length_2640_cov_16.462810	94	164	245	1	70	0.0142857
NODE_827_length_2640_cov_16.462810	94	164	246	1	70	0.0142857
NODE_827_length_2640_cov_16.462810	94	164	265	2	70	0.0285714
NODE_827_length_2640_cov_16.462810	94	164	267	1	70	0.0142857
NODE_827_length_2640_cov_16.462810	94	164	270	1	70	0.0142857
NODE_827_length_2640_cov_16.462810	94	164	278	1	70	0.0142857
NODE_827_length_2640_cov_16.462810	94	164	290	1	70	0.0142857
NODE_827_length_2640_cov_16.462810	94	164	303	2	70	0.0285714
NODE_827_length_2640_cov_16.462810	94	164	304	1	70	0.0142857
NODE_827_length_2640_cov_16.462810	94	164	309	2	70	0.0285714
NODE_827_length_2640_cov_16.462810	94	164	315	1	70	0.0142857
NODE_827_length_2640_cov_16.462810	94	164	325	1	70	0.0142857
NODE_827_length_2640_cov_16.462810	94	164	326	1	70	0.0142857
NODE_827_length_2640_cov_16.462810	94	164	328	1	70	0.0142857
NODE_827_length_2640_cov_16.462810	94	164	334	2	70	0.0285714
NODE_827_length_2640_cov_16.462810	94	164	344	1	70	0.0142857
NODE_827_length_2640_cov_16.462810	94	164	356	1	70	0.0142857
NODE_827_length_2640_cov_16.462810	94	164	369	1	70	0.0142857
NODE_827_length_2640_cov_16.462810	94	164	383	1	70	0.0142857
NODE_827_length_2640_cov_16.462810	94	164	402	1	70	0.0142857
NODE_827_length_2640_cov_16.462810	94	164	414	1	70	0.0142857
NODE_827_length_2640_cov_16.462810	94	164	420	1	70	0.0142857
NODE_827_length_2640_cov_16.462810	94	164	438	1	70	0.0142857
NODE_827_length_2640_cov_16.462810	94	164	446	7	70	0.1000000
NODE_827_length_2640_cov_16.462810	94	164	447	3	70	0.0428571
NODE_827_length_2640_cov_16.462810	94	164	448	3	70	0.0428571
NODE_827_length_2640_cov_16.462810	94	164	450	1	70	0.0142857
NODE_827_length_2640_cov_16.462810	94	164	452	1	70	0.0142857
NODE_827_length_2640_cov_16.462810	94	164	456	4	70	0.0571429
NODE_827_length_2640_cov_16.462810	94	164	458	2	70	0.0285714
NODE_827_length_2640_cov_16.462810	94	164	460	1	70	0.0142857
NODE_827_length_2640_cov_16.462810	147	209	126	2	62	0.0322581
NODE_827_length_2640_cov_16.462810	147	209	128	3	62	0.0483871
NODE_827_length_2640_cov_16.462810	147	209	130	3	62	0.0483871
NODE_827_length_2640_cov_16.462810	147	209	131	1	62	0.0161290
NODE_827_length_2640_cov_16.462810	147	209	134	8	62	0.1290323
NODE_827_length_2640_cov_16.462810	147	209	136	4	62	0.0645161
NODE_827_length_2640_cov_16.462810	147	209	138	2	62	0.0322581
NODE_827_length_2640_cov_16.462810	147	209	141	1	62	0.0161290
NODE_827_length_2640_cov_16.462810	147	209	143	1	62	0.0161290
NODE_827_length_2640_cov_16.462810	147	209	144	2	62	0.0322581
NODE_827_length_2640_cov_16.462810	147	209	146	4	62	0.0645161
NODE_827_length_2640_cov_16.462810	147	209	150	1	62	0.0161290
NODE_827_length_2640_cov_16.462810	147	209	152	1	62	0.0161290
NODE_827_length_2640_cov_16.462810	147	209	155	1	62	0.0161290
NODE_827_length_2640_cov_16.462810	147	209	156	3	62	0.0483871
NODE_827_length_2640_cov_16.462810	147	209	157	1	62	0.0161290
NODE_827_length_2640_cov_16.462810	147	209	158	2	62	0.0322581
NODE_827_length_2640_cov_16.462810	147	209	161	1	62	0.0161290
NODE_827_length_2640_cov_16.462810	147	209	167	1	62	0.0161290
NODE_827_length_2640_cov_16.462810	147	209	168	2	62	0.0322581
NODE_827_length_2640_cov_16.462810	147	209	173	1	62	0.0161290
NODE_827_length_2640_cov_16.462810	147	209	174	1	62	0.0161290
NODE_827_length_2640_cov_16.462810	147	209	176	1	62	0.0161290
NODE_827_length_2640_cov_16.462810	147	209	179	1	62	0.0161290
NODE_827_length_2640_cov_16.462810	147	209	183	1	62	0.0161290
NODE_827_length_2640_cov_16.462810	147	209	192	2	62	0.0322581
NODE_827_length_2640_cov_16.462810	147	209	194	2	62	0.0322581
NODE_827_length_2640_cov_16.462810	147	209	199	1	62	0.0161290
NODE_827_length_2640_cov_16.462810	147	209	201	1	62	0.0161290
NODE_827_length_2640_cov_16.462810	147	209	203	2	62	0.0322581
NODE_827_length_2640_cov_16.462810	147	209	206	1	62	0.0161290
NODE_827_length_2640_cov_16.462810	147	209	218	1	62	0.0161290
NODE_827_length_2640_cov_16.462810	147	209	230	1	62	0.0161290
NODE_827_length_2640_cov_16.462810	147	209	232	1	62	0.0161290
NODE_827_length_2640_cov_16.462810	147	209	237	1	62	0.0161290
NODE_828_length_2636_cov_200.191171	561	641	1252	1	80	0.0125000
NODE_828_length_2636_cov_200.191171	561	641	1279	1	80	0.0125000
NODE_828_length_2636_cov_200.191171	561	641	1287	1	80	0.0125000
NODE_828_length_2636_cov_200.191171	561	641	1293	1	80	0.0125000
NODE_828_length_2636_cov_200.191171	561	641	1295	1	80	0.0125000
NODE_828_length_2636_cov_200.191171	561	641	1296	1	80	0.0125000
NODE_828_length_2636_cov_200.191171	561	641	1301	1	80	0.0125000
NODE_828_length_2636_cov_200.191171	561	641	1319	2	80	0.0250000
NODE_828_length_2636_cov_200.191171	561	641	1321	1	80	0.0125000
NODE_828_length_2636_cov_200.191171	561	641	1333	1	80	0.0125000
NODE_828_length_2636_cov_200.191171	561	641	1337	1	80	0.0125000
NODE_828_length_2636_cov_200.191171	561	641	1344	1	80	0.0125000
NODE_828_length_2636_cov_200.191171	561	641	1349	1	80	0.0125000
NODE_828_length_2636_cov_200.191171	561	641	1352	1	80	0.0125000
NODE_828_length_2636_cov_200.191171	561	641	1362	1	80	0.0125000
NODE_828_length_2636_cov_200.191171	561	641	1365	1	80	0.0125000
NODE_828_length_2636_cov_200.191171	561	641	1373	1	80	0.0125000
NODE_828_length_2636_cov_200.191171	561	641	1377	1	80	0.0125000
NODE_828_length_2636_cov_200.191171	561	641	1380	1	80	0.0125000
NODE_828_length_2636_cov_200.191171	561	641	1388	1	80	0.0125000
NODE_828_length_2636_cov_200.191171	561	641	1390	1	80	0.0125000
NODE_828_length_2636_cov_200.191171	561	641	1394	1	80	0.0125000
NODE_828_length_2636_cov_200.191171	561	641	1398	1	80	0.0125000
NODE_828_length_2636_cov_200.191171	561	641	1399	1	80	0.0125000
NODE_828_length_2636_cov_200.191171	561	641	1405	1	80	0.0125000
NODE_828_length_2636_cov_200.191171	561	641	1409	2	80	0.0250000
NODE_828_length_2636_cov_200.191171	561	641	1412	1	80	0.0125000
NODE_828_length_2636_cov_200.191171	561	641	1416	1	80	0.0125000
NODE_828_length_2636_cov_200.191171	561	641	1427	1	80	0.0125000
NODE_828_length_2636_cov_200.191171	561	641	1432	1	80	0.0125000
NODE_828_length_2636_cov_200.191171	561	641	1434	1	80	0.0125000
NODE_828_length_2636_cov_200.191171	561	641	1442	1	80	0.0125000
NODE_828_length_2636_cov_200.191171	561	641	1447	1	80	0.0125000
NODE_828_length_2636_cov_200.191171	561	641	1451	1	80	0.0125000
NODE_828_length_2636_cov_200.191171	561	641	1454	1	80	0.0125000
NODE_828_length_2636_cov_200.191171	561	641	1460	2	80	0.0250000
NODE_828_length_2636_cov_200.191171	561	641	1468	1	80	0.0125000
NODE_828_length_2636_cov_200.191171	561	641	1482	1	80	0.0125000
NODE_828_length_2636_cov_200.191171	561	641	1486	1	80	0.0125000
NODE_828_length_2636_cov_200.191171	561	641	1488	2	80	0.0250000
NODE_828_length_2636_cov_200.191171	561	641	1490	1	80	0.0125000
NODE_828_length_2636_cov_200.191171	561	641	1494	1	80	0.0125000
NODE_828_length_2636_cov_200.191171	561	641	1496	1	80	0.0125000
NODE_828_length_2636_cov_200.191171	561	641	1505	1	80	0.0125000
NODE_828_length_2636_cov_200.191171	561	641	1509	1	80	0.0125000
NODE_828_length_2636_cov_200.191171	561	641	1515	1	80	0.0125000
NODE_828_length_2636_cov_200.191171	561	641	1518	1	80	0.0125000
NODE_828_length_2636_cov_200.191171	561	641	1519	1	80	0.0125000
NODE_828_length_2636_cov_200.191171	561	641	1536	1	80	0.0125000
NODE_828_length_2636_cov_200.191171	561	641	1538	1	80	0.0125000
NODE_828_length_2636_cov_200.191171	561	641	1542	1	80	0.0125000
NODE_828_length_2636_cov_200.191171	561	641	1549	1	80	0.0125000
NODE_828_length_2636_cov_200.191171	561	641	1554	1	80	0.0125000
NODE_828_length_2636_cov_200.191171	561	641	1555	2	80	0.0250000
NODE_828_length_2636_cov_200.191171	561	641	1557	1	80	0.0125000
NODE_828_length_2636_cov_200.191171	561	641	1563	1	80	0.0125000
NODE_828_length_2636_cov_200.191171	561	641	1564	1	80	0.0125000
NODE_828_length_2636_cov_200.191171	561	641	1566	1	80	0.0125000
NODE_828_length_2636_cov_200.191171	561	641	1567	1	80	0.0125000
NODE_828_length_2636_cov_200.191171	561	641	1568	1	80	0.0125000
NODE_828_length_2636_cov_200.191171	561	641	1578	1	80	0.0125000
NODE_828_length_2636_cov_200.191171	561	641	1581	1	80	0.0125000
NODE_828_length_2636_cov_200.191171	561	641	1582	1	80	0.0125000
NODE_828_length_2636_cov_200.191171	561	641	1583	1	80	0.0125000
NODE_828_length_2636_cov_200.191171	561	641	1585	3	80	0.0375000
NODE_828_length_2636_cov_200.191171	561	641	1586	1	80	0.0125000
NODE_828_length_2636_cov_200.191171	561	641	1589	2	80	0.0250000
NODE_828_length_2636_cov_200.191171	561	641	1591	1	80	0.0125000
NODE_828_length_2636_cov_200.191171	561	641	1594	1	80	0.0125000
NODE_828_length_2636_cov_200.191171	561	641	1599	1	80	0.0125000
NODE_828_length_2636_cov_200.191171	561	641	1609	1	80	0.0125000
NODE_828_length_2636_cov_200.191171	561	641	1611	1	80	0.0125000
NODE_828_length_2636_cov_200.191171	614	695	223	1	81	0.0123457
NODE_828_length_2636_cov_200.191171	614	695	231	1	81	0.0123457
NODE_828_length_2636_cov_200.191171	614	695	253	1	81	0.0123457
NODE_828_length_2636_cov_200.191171	614	695	261	1	81	0.0123457
NODE_828_length_2636_cov_200.191171	614	695	263	1	81	0.0123457
NODE_828_length_2636_cov_200.191171	614	695	275	1	81	0.0123457
NODE_828_length_2636_cov_200.191171	614	695	292	1	81	0.0123457
NODE_828_length_2636_cov_200.191171	614	695	293	1	81	0.0123457
NODE_828_length_2636_cov_200.191171	614	695	305	1	81	0.0123457
NODE_828_length_2636_cov_200.191171	614	695	317	1	81	0.0123457
NODE_828_length_2636_cov_200.191171	614	695	325	1	81	0.0123457
NODE_828_length_2636_cov_200.191171	614	695	357	1	81	0.0123457
NODE_828_length_2636_cov_200.191171	614	695	369	1	81	0.0123457
NODE_828_length_2636_cov_200.191171	614	695	386	1	81	0.0123457
NODE_828_length_2636_cov_200.191171	614	695	438	1	81	0.0123457
NODE_828_length_2636_cov_200.191171	614	695	443	1	81	0.0123457
NODE_828_length_2636_cov_200.191171	614	695	453	1	81	0.0123457
NODE_828_length_2636_cov_200.191171	614	695	474	1	81	0.0123457
NODE_828_length_2636_cov_200.191171	614	695	486	1	81	0.0123457
NODE_828_length_2636_cov_200.191171	614	695	523	1	81	0.0123457
NODE_828_length_2636_cov_200.191171	614	695	540	1	81	0.0123457
NODE_828_length_2636_cov_200.191171	614	695	563	1	81	0.0123457
NODE_828_length_2636_cov_200.191171	614	695	574	1	81	0.0123457
NODE_828_length_2636_cov_200.191171	614	695	601	1	81	0.0123457
NODE_828_length_2636_cov_200.191171	614	695	629	1	81	0.0123457
NODE_828_length_2636_cov_200.191171	614	695	652	1	81	0.0123457
NODE_828_length_2636_cov_200.191171	614	695	692	1	81	0.0123457
NODE_828_length_2636_cov_200.191171	614	695	694	1	81	0.0123457
NODE_828_length_2636_cov_200.191171	614	695	732	1	81	0.0123457
NODE_828_length_2636_cov_200.191171	614	695	767	1	81	0.0123457
NODE_828_length_2636_cov_200.191171	614	695	877	1	81	0.0123457
NODE_828_length_2636_cov_200.191171	614	695	887	1	81	0.0123457
NODE_828_length_2636_cov_200.191171	614	695	894	1	81	0.0123457
NODE_828_length_2636_cov_200.191171	614	695	901	1	81	0.0123457
NODE_828_length_2636_cov_200.191171	614	695	907	1	81	0.0123457
NODE_828_length_2636_cov_200.191171	614	695	925	1	81	0.0123457
NODE_828_length_2636_cov_200.191171	614	695	950	1	81	0.0123457
NODE_828_length_2636_cov_200.191171	614	695	958	1	81	0.0123457
NODE_828_length_2636_cov_200.191171	614	695	965	1	81	0.0123457
NODE_828_length_2636_cov_200.191171	614	695	982	1	81	0.0123457
NODE_828_length_2636_cov_200.191171	614	695	1001	1	81	0.0123457
NODE_828_length_2636_cov_200.191171	614	695	1018	1	81	0.0123457
NODE_828_length_2636_cov_200.191171	614	695	1077	1	81	0.0123457
NODE_828_length_2636_cov_200.191171	614	695	1079	1	81	0.0123457
NODE_828_length_2636_cov_200.191171	614	695	1090	1	81	0.0123457
NODE_828_length_2636_cov_200.191171	614	695	1100	1	81	0.0123457
NODE_828_length_2636_cov_200.191171	614	695	1109	1	81	0.0123457
NODE_828_length_2636_cov_200.191171	614	695	1134	1	81	0.0123457
NODE_828_length_2636_cov_200.191171	614	695	1154	1	81	0.0123457
NODE_828_length_2636_cov_200.191171	614	695	1158	1	81	0.0123457
NODE_828_length_2636_cov_200.191171	614	695	1166	1	81	0.0123457
NODE_828_length_2636_cov_200.191171	614	695	1169	1	81	0.0123457
NODE_828_length_2636_cov_200.191171	614	695	1196	1	81	0.0123457
NODE_828_length_2636_cov_200.191171	614	695	1235	1	81	0.0123457
NODE_828_length_2636_cov_200.191171	614	695	1252	1	81	0.0123457
NODE_828_length_2636_cov_200.191171	614	695	1279	1	81	0.0123457
NODE_828_length_2636_cov_200.191171	614	695	1287	1	81	0.0123457
NODE_828_length_2636_cov_200.191171	614	695	1293	1	81	0.0123457
NODE_828_length_2636_cov_200.191171	614	695	1319	2	81	0.0246914
NODE_828_length_2636_cov_200.191171	614	695	1333	1	81	0.0123457
NODE_828_length_2636_cov_200.191171	614	695	1344	1	81	0.0123457
NODE_828_length_2636_cov_200.191171	614	695	1352	1	81	0.0123457
NODE_828_length_2636_cov_200.191171	614	695	1362	1	81	0.0123457
NODE_828_length_2636_cov_200.191171	614	695	1365	1	81	0.0123457
NODE_828_length_2636_cov_200.191171	614	695	1373	1	81	0.0123457
NODE_828_length_2636_cov_200.191171	614	695	1380	1	81	0.0123457
NODE_828_length_2636_cov_200.191171	614	695	1388	1	81	0.0123457
NODE_828_length_2636_cov_200.191171	614	695	1390	1	81	0.0123457
NODE_828_length_2636_cov_200.191171	614	695	1394	1	81	0.0123457
NODE_828_length_2636_cov_200.191171	614	695	1405	1	81	0.0123457
NODE_828_length_2636_cov_200.191171	614	695	1409	1	81	0.0123457
NODE_828_length_2636_cov_200.191171	614	695	1412	1	81	0.0123457
NODE_828_length_2636_cov_200.191171	614	695	1416	1	81	0.0123457
NODE_828_length_2636_cov_200.191171	614	695	1427	1	81	0.0123457
NODE_828_length_2636_cov_200.191171	614	695	1434	1	81	0.0123457
NODE_828_length_2636_cov_200.191171	614	695	1442	1	81	0.0123457
NODE_828_length_2636_cov_200.191171	614	695	1451	1	81	0.0123457
NODE_828_length_2636_cov_200.191171	614	695	1454	1	81	0.0123457
NODE_828_length_2636_cov_200.191171	614	695	1460	1	81	0.0123457
NODE_828_length_2636_cov_200.191171	614	695	1468	1	81	0.0123457
NODE_830_length_2631_cov_10.831754	446	526	0	10	80	0.1250000
NODE_830_length_2631_cov_10.831754	446	526	10	70	80	0.8750000
NODE_830_length_2631_cov_10.831754	499	572	0	26	73	0.3561644
NODE_830_length_2631_cov_10.831754	499	572	9	10	73	0.1369863
NODE_830_length_2631_cov_10.831754	499	572	10	37	73	0.5068493
NODE_833_length_2622_cov_63.057471	1877	1953	180	2	76	0.0263158
NODE_833_length_2622_cov_63.057471	1877	1953	184	1	76	0.0131579
NODE_833_length_2622_cov_63.057471	1877	1953	185	2	76	0.0263158
NODE_833_length_2622_cov_63.057471	1877	1953	187	1	76	0.0131579
NODE_833_length_2622_cov_63.057471	1877	1953	188	1	76	0.0131579
NODE_833_length_2622_cov_63.057471	1877	1953	189	2	76	0.0263158
NODE_833_length_2622_cov_63.057471	1877	1953	192	1	76	0.0131579
NODE_833_length_2622_cov_63.057471	1877	1953	194	3	76	0.0394737
NODE_833_length_2622_cov_63.057471	1877	1953	196	1	76	0.0131579
NODE_833_length_2622_cov_63.057471	1877	1953	198	2	76	0.0263158
NODE_833_length_2622_cov_63.057471	1877	1953	210	1	76	0.0131579
NODE_833_length_2622_cov_63.057471	1877	1953	211	1	76	0.0131579
NODE_833_length_2622_cov_63.057471	1877	1953	212	1	76	0.0131579
NODE_833_length_2622_cov_63.057471	1877	1953	216	3	76	0.0394737
NODE_833_length_2622_cov_63.057471	1877	1953	217	6	76	0.0789474
NODE_833_length_2622_cov_63.057471	1877	1953	218	1	76	0.0131579
NODE_833_length_2622_cov_63.057471	1877	1953	219	1	76	0.0131579
NODE_833_length_2622_cov_63.057471	1877	1953	222	1	76	0.0131579
NODE_833_length_2622_cov_63.057471	1877	1953	223	2	76	0.0263158
NODE_833_length_2622_cov_63.057471	1877	1953	227	1	76	0.0131579
NODE_833_length_2622_cov_63.057471	1877	1953	229	1	76	0.0131579
NODE_833_length_2622_cov_63.057471	1877	1953	230	1	76	0.0131579
NODE_833_length_2622_cov_63.057471	1877	1953	234	1	76	0.0131579
NODE_833_length_2622_cov_63.057471	1877	1953	236	1	76	0.0131579
NODE_833_length_2622_cov_63.057471	1877	1953	240	2	76	0.0263158
NODE_833_length_2622_cov_63.057471	1877	1953	242	3	76	0.0394737
NODE_833_length_2622_cov_63.057471	1877	1953	247	1	76	0.0131579
NODE_833_length_2622_cov_63.057471	1877	1953	251	2	76	0.0263158
NODE_833_length_2622_cov_63.057471	1877	1953	253	1	76	0.0131579
NODE_833_length_2622_cov_63.057471	1877	1953	257	1	76	0.0131579
NODE_833_length_2622_cov_63.057471	1877	1953	260	1	76	0.0131579
NODE_833_length_2622_cov_63.057471	1877	1953	261	1	76	0.0131579
NODE_833_length_2622_cov_63.057471	1877	1953	262	6	76	0.0789474
NODE_833_length_2622_cov_63.057471	1877	1953	263	6	76	0.0789474
NODE_833_length_2622_cov_63.057471	1877	1953	264	1	76	0.0131579
NODE_833_length_2622_cov_63.057471	1877	1953	265	2	76	0.0263158
NODE_833_length_2622_cov_63.057471	1877	1953	266	3	76	0.0394737
NODE_833_length_2622_cov_63.057471	1877	1953	268	2	76	0.0263158
NODE_833_length_2622_cov_63.057471	1877	1953	269	1	76	0.0131579
NODE_833_length_2622_cov_63.057471	1877	1953	270	3	76	0.0394737
NODE_833_length_2622_cov_63.057471	1877	1953	272	1	76	0.0131579
NODE_833_length_2622_cov_63.057471	1877	1953	273	1	76	0.0131579
NODE_833_length_2622_cov_63.057471	2426	2506	20	2	80	0.0250000
NODE_833_length_2622_cov_63.057471	2426	2506	22	4	80	0.0500000
NODE_833_length_2622_cov_63.057471	2426	2506	24	13	80	0.1625000
NODE_833_length_2622_cov_63.057471	2426	2506	27	10	80	0.1250000
NODE_833_length_2622_cov_63.057471	2426	2506	29	6	80	0.0750000
NODE_833_length_2622_cov_63.057471	2426	2506	31	3	80	0.0375000
NODE_833_length_2622_cov_63.057471	2426	2506	35	2	80	0.0250000
NODE_833_length_2622_cov_63.057471	2426	2506	38	1	80	0.0125000
NODE_833_length_2622_cov_63.057471	2426	2506	40	2	80	0.0250000
NODE_833_length_2622_cov_63.057471	2426	2506	42	1	80	0.0125000
NODE_833_length_2622_cov_63.057471	2426	2506	45	1	80	0.0125000
NODE_833_length_2622_cov_63.057471	2426	2506	48	2	80	0.0250000
NODE_833_length_2622_cov_63.057471	2426	2506	50	1	80	0.0125000
NODE_833_length_2622_cov_63.057471	2426	2506	51	1	80	0.0125000
NODE_833_length_2622_cov_63.057471	2426	2506	55	1	80	0.0125000
NODE_833_length_2622_cov_63.057471	2426	2506	56	1	80	0.0125000
NODE_833_length_2622_cov_63.057471	2426	2506	59	1	80	0.0125000
NODE_833_length_2622_cov_63.057471	2426	2506	61	1	80	0.0125000
NODE_833_length_2622_cov_63.057471	2426	2506	62	1	80	0.0125000
NODE_833_length_2622_cov_63.057471	2426	2506	64	1	80	0.0125000
NODE_833_length_2622_cov_63.057471	2426	2506	67	1	80	0.0125000
NODE_833_length_2622_cov_63.057471	2426	2506	68	3	80	0.0375000
NODE_833_length_2622_cov_63.057471	2426	2506	72	8	80	0.1000000
NODE_833_length_2622_cov_63.057471	2426	2506	74	2	80	0.0250000
NODE_833_length_2622_cov_63.057471	2426	2506	76	3	80	0.0375000
NODE_833_length_2622_cov_63.057471	2426	2506	78	3	80	0.0375000
NODE_833_length_2622_cov_63.057471	2426	2506	80	4	80	0.0500000
NODE_833_length_2622_cov_63.057471	2426	2506	82	1	80	0.0125000
NODE_833_length_2622_cov_63.057471	2479	2559	62	1	80	0.0125000
NODE_833_length_2622_cov_63.057471	2479	2559	64	1	80	0.0125000
NODE_833_length_2622_cov_63.057471	2479	2559	67	1	80	0.0125000
NODE_833_length_2622_cov_63.057471	2479	2559	68	3	80	0.0375000
NODE_833_length_2622_cov_63.057471	2479	2559	72	11	80	0.1375000
NODE_833_length_2622_cov_63.057471	2479	2559	74	3	80	0.0375000
NODE_833_length_2622_cov_63.057471	2479	2559	76	4	80	0.0500000
NODE_833_length_2622_cov_63.057471	2479	2559	78	4	80	0.0500000
NODE_833_length_2622_cov_63.057471	2479	2559	80	4	80	0.0500000
NODE_833_length_2622_cov_63.057471	2479	2559	81	1	80	0.0125000
NODE_833_length_2622_cov_63.057471	2479	2559	82	1	80	0.0125000
NODE_833_length_2622_cov_63.057471	2479	2559	83	4	80	0.0500000
NODE_833_length_2622_cov_63.057471	2479	2559	84	3	80	0.0375000
NODE_833_length_2622_cov_63.057471	2479	2559	86	2	80	0.0250000
NODE_833_length_2622_cov_63.057471	2479	2559	88	7	80	0.0875000
NODE_833_length_2622_cov_63.057471	2479	2559	89	19	80	0.2375000
NODE_833_length_2622_cov_63.057471	2479	2559	90	11	80	0.1375000
NODE_836_length_2617_cov_16.817315	1404	1448	12	1	44	0.0227273
NODE_836_length_2617_cov_16.817315	1404	1448	14	9	44	0.2045455
NODE_836_length_2617_cov_16.817315	1404	1448	16	6	44	0.1363636
NODE_836_length_2617_cov_16.817315	1404	1448	18	7	44	0.1590909
NODE_836_length_2617_cov_16.817315	1404	1448	20	10	44	0.2272727
NODE_836_length_2617_cov_16.817315	1404	1448	22	11	44	0.2500000
NODE_836_length_2617_cov_16.817315	1467	1521	10	27	54	0.5000000
NODE_836_length_2617_cov_16.817315	1467	1521	12	7	54	0.1296296
NODE_836_length_2617_cov_16.817315	1467	1521	14	20	54	0.3703704
NODE_839_length_2610_cov_2.232577	2127	2163	0	36	36	1.0000000
NODE_840_length_2609_cov_13.245418	2066	2146	30	27	80	0.3375000
NODE_840_length_2609_cov_13.245418	2066	2146	37	21	80	0.2625000
NODE_840_length_2609_cov_13.245418	2066	2146	38	8	80	0.1000000
NODE_840_length_2609_cov_13.245418	2066	2146	39	11	80	0.1375000
NODE_840_length_2609_cov_13.245418	2066	2146	40	13	80	0.1625000
NODE_840_length_2609_cov_13.245418	2119	2199	0	30	80	0.3750000
NODE_840_length_2609_cov_13.245418	2119	2199	2	17	80	0.2125000
NODE_840_length_2609_cov_13.245418	2119	2199	30	33	80	0.4125000
NODE_840_length_2609_cov_13.245418	2195	2275	0	5	80	0.0625000
NODE_840_length_2609_cov_13.245418	2195	2275	2	75	80	0.9375000
NODE_840_length_2609_cov_13.245418	2248	2328	0	58	80	0.7250000
NODE_840_length_2609_cov_13.245418	2248	2328	2	22	80	0.2750000
NODE_845_length_2595_cov_5.638622	2157	2237	0	80	80	1.0000000
NODE_847_length_2594_cov_109.880160	386	450	61	1	64	0.0156250
NODE_847_length_2594_cov_109.880160	386	450	67	2	64	0.0312500
NODE_847_length_2594_cov_109.880160	386	450	71	1	64	0.0156250
NODE_847_length_2594_cov_109.880160	386	450	89	1	64	0.0156250
NODE_847_length_2594_cov_109.880160	386	450	93	1	64	0.0156250
NODE_847_length_2594_cov_109.880160	386	450	95	1	64	0.0156250
NODE_847_length_2594_cov_109.880160	386	450	99	1	64	0.0156250
NODE_847_length_2594_cov_109.880160	386	450	106	1	64	0.0156250
NODE_847_length_2594_cov_109.880160	386	450	108	1	64	0.0156250
NODE_847_length_2594_cov_109.880160	386	450	112	1	64	0.0156250
NODE_847_length_2594_cov_109.880160	386	450	117	1	64	0.0156250
NODE_847_length_2594_cov_109.880160	386	450	118	1	64	0.0156250
NODE_847_length_2594_cov_109.880160	386	450	120	1	64	0.0156250
NODE_847_length_2594_cov_109.880160	386	450	127	1	64	0.0156250
NODE_847_length_2594_cov_109.880160	386	450	136	1	64	0.0156250
NODE_847_length_2594_cov_109.880160	386	450	142	1	64	0.0156250
NODE_847_length_2594_cov_109.880160	386	450	154	1	64	0.0156250
NODE_847_length_2594_cov_109.880160	386	450	158	3	64	0.0468750
NODE_847_length_2594_cov_109.880160	386	450	160	1	64	0.0156250
NODE_847_length_2594_cov_109.880160	386	450	164	3	64	0.0468750
NODE_847_length_2594_cov_109.880160	386	450	171	1	64	0.0156250
NODE_847_length_2594_cov_109.880160	386	450	175	1	64	0.0156250
NODE_847_length_2594_cov_109.880160	386	450	185	2	64	0.0312500
NODE_847_length_2594_cov_109.880160	386	450	187	1	64	0.0156250
NODE_847_length_2594_cov_109.880160	386	450	192	2	64	0.0312500
NODE_847_length_2594_cov_109.880160	386	450	194	1	64	0.0156250
NODE_847_length_2594_cov_109.880160	386	450	196	1	64	0.0156250
NODE_847_length_2594_cov_109.880160	386	450	200	1	64	0.0156250
NODE_847_length_2594_cov_109.880160	386	450	202	5	64	0.0781250
NODE_847_length_2594_cov_109.880160	386	450	204	1	64	0.0156250
NODE_847_length_2594_cov_109.880160	386	450	209	1	64	0.0156250
NODE_847_length_2594_cov_109.880160	386	450	214	3	64	0.0468750
NODE_847_length_2594_cov_109.880160	386	450	216	5	64	0.0781250
NODE_847_length_2594_cov_109.880160	386	450	220	1	64	0.0156250
NODE_847_length_2594_cov_109.880160	386	450	222	1	64	0.0156250
NODE_847_length_2594_cov_109.880160	386	450	224	1	64	0.0156250
NODE_847_length_2594_cov_109.880160	386	450	226	1	64	0.0156250
NODE_847_length_2594_cov_109.880160	386	450	228	2	64	0.0312500
NODE_847_length_2594_cov_109.880160	386	450	230	1	64	0.0156250
NODE_847_length_2594_cov_109.880160	386	450	232	1	64	0.0156250
NODE_847_length_2594_cov_109.880160	386	450	236	2	64	0.0312500
NODE_847_length_2594_cov_109.880160	386	450	239	4	64	0.0625000
NODE_856_length_2575_cov_4.890549	1860	1912	2	52	52	1.0000000
NODE_857_length_2572_cov_46.828548	302	382	0	80	80	1.0000000
NODE_857_length_2572_cov_46.828548	355	435	0	80	80	1.0000000
NODE_868_length_2551_cov_40.721860	1104	1150	10	23	46	0.5000000
NODE_868_length_2551_cov_40.721860	1104	1150	12	16	46	0.3478261
NODE_868_length_2551_cov_40.721860	1104	1150	16	1	46	0.0217391
NODE_868_length_2551_cov_40.721860	1104	1150	18	6	46	0.1304348
NODE_868_length_2551_cov_40.721860	1199	1259	10	7	60	0.1166667
NODE_868_length_2551_cov_40.721860	1199	1259	12	9	60	0.1500000
NODE_868_length_2551_cov_40.721860	1199	1259	14	14	60	0.2333333
NODE_868_length_2551_cov_40.721860	1199	1259	15	4	60	0.0666667
NODE_868_length_2551_cov_40.721860	1199	1259	16	6	60	0.1000000
NODE_868_length_2551_cov_40.721860	1199	1259	17	20	60	0.3333333
NODE_870_length_2547_cov_218.062908	436	486	0	5	50	0.1000000
NODE_870_length_2547_cov_218.062908	436	486	2	4	50	0.0800000
NODE_870_length_2547_cov_218.062908	436	486	4	21	50	0.4200000
NODE_870_length_2547_cov_218.062908	436	486	8	1	50	0.0200000
NODE_870_length_2547_cov_218.062908	436	486	12	3	50	0.0600000
NODE_870_length_2547_cov_218.062908	436	486	13	1	50	0.0200000
NODE_870_length_2547_cov_218.062908	436	486	14	1	50	0.0200000
NODE_870_length_2547_cov_218.062908	436	486	18	1	50	0.0200000
NODE_870_length_2547_cov_218.062908	436	486	20	2	50	0.0400000
NODE_870_length_2547_cov_218.062908	436	486	22	2	50	0.0400000
NODE_870_length_2547_cov_218.062908	436	486	24	1	50	0.0200000
NODE_870_length_2547_cov_218.062908	436	486	26	1	50	0.0200000
NODE_870_length_2547_cov_218.062908	436	486	28	2	50	0.0400000
NODE_870_length_2547_cov_218.062908	436	486	34	1	50	0.0200000
NODE_870_length_2547_cov_218.062908	436	486	36	1	50	0.0200000
NODE_870_length_2547_cov_218.062908	436	486	38	3	50	0.0600000
NODE_879_length_2527_cov_27.275947	503	548	42	7	45	0.1555556
NODE_879_length_2527_cov_27.275947	503	548	44	9	45	0.2000000
NODE_879_length_2527_cov_27.275947	503	548	45	1	45	0.0222222
NODE_879_length_2527_cov_27.275947	503	548	46	22	45	0.4888889
NODE_879_length_2527_cov_27.275947	503	548	48	1	45	0.0222222
NODE_879_length_2527_cov_27.275947	503	548	50	1	45	0.0222222
NODE_879_length_2527_cov_27.275947	503	548	52	3	45	0.0666667
NODE_879_length_2527_cov_27.275947	503	548	54	1	45	0.0222222
NODE_884_length_2519_cov_15.991322	2122	2202	0	80	80	1.0000000
NODE_884_length_2519_cov_15.991322	2175	2255	0	80	80	1.0000000
NODE_885_length_2518_cov_7.035965	62	142	118	1	80	0.0125000
NODE_885_length_2518_cov_7.035965	62	142	120	1	80	0.0125000
NODE_885_length_2518_cov_7.035965	62	142	124	1	80	0.0125000
NODE_885_length_2518_cov_7.035965	62	142	126	1	80	0.0125000
NODE_885_length_2518_cov_7.035965	62	142	128	1	80	0.0125000
NODE_885_length_2518_cov_7.035965	62	142	130	2	80	0.0250000
NODE_885_length_2518_cov_7.035965	62	142	138	3	80	0.0375000
NODE_885_length_2518_cov_7.035965	62	142	140	2	80	0.0250000
NODE_885_length_2518_cov_7.035965	62	142	146	7	80	0.0875000
NODE_885_length_2518_cov_7.035965	62	142	148	5	80	0.0625000
NODE_885_length_2518_cov_7.035965	62	142	150	1	80	0.0125000
NODE_885_length_2518_cov_7.035965	62	142	152	1	80	0.0125000
NODE_885_length_2518_cov_7.035965	62	142	153	5	80	0.0625000
NODE_885_length_2518_cov_7.035965	62	142	154	5	80	0.0625000
NODE_885_length_2518_cov_7.035965	62	142	156	2	80	0.0250000
NODE_885_length_2518_cov_7.035965	62	142	158	5	80	0.0625000
NODE_885_length_2518_cov_7.035965	62	142	160	7	80	0.0875000
NODE_885_length_2518_cov_7.035965	62	142	161	1	80	0.0125000
NODE_885_length_2518_cov_7.035965	62	142	162	2	80	0.0250000
NODE_885_length_2518_cov_7.035965	62	142	164	5	80	0.0625000
NODE_885_length_2518_cov_7.035965	62	142	166	15	80	0.1875000
NODE_885_length_2518_cov_7.035965	62	142	168	3	80	0.0375000
NODE_885_length_2518_cov_7.035965	62	142	170	3	80	0.0375000
NODE_885_length_2518_cov_7.035965	62	142	172	1	80	0.0125000
NODE_885_length_2518_cov_7.035965	2005	2085	0	80	80	1.0000000
NODE_885_length_2518_cov_7.035965	2058	2138	0	80	80	1.0000000
NODE_887_length_2515_cov_37.984272	393	473	0	80	80	1.0000000
NODE_887_length_2515_cov_37.984272	446	526	0	80	80	1.0000000
NODE_887_length_2515_cov_37.984272	1896	1976	0	80	80	1.0000000
NODE_887_length_2515_cov_37.984272	1949	2029	0	80	80	1.0000000
NODE_887_length_2515_cov_37.984272	2025	2105	0	80	80	1.0000000
NODE_887_length_2515_cov_37.984272	2025	2104	0	79	79	1.0000000
NODE_887_length_2515_cov_37.984272	2078	2158	0	80	80	1.0000000
NODE_888_length_2512_cov_48.259428	1299	1379	57	2	80	0.0250000
NODE_888_length_2512_cov_48.259428	1299	1379	59	3	80	0.0375000
NODE_888_length_2512_cov_48.259428	1299	1379	61	10	80	0.1250000
NODE_888_length_2512_cov_48.259428	1299	1379	63	13	80	0.1625000
NODE_888_length_2512_cov_48.259428	1299	1379	65	14	80	0.1750000
NODE_888_length_2512_cov_48.259428	1299	1379	67	14	80	0.1750000
NODE_888_length_2512_cov_48.259428	1299	1379	68	1	80	0.0125000
NODE_888_length_2512_cov_48.259428	1299	1379	75	1	80	0.0125000
NODE_888_length_2512_cov_48.259428	1299	1379	77	3	80	0.0375000
NODE_888_length_2512_cov_48.259428	1299	1379	79	3	80	0.0375000
NODE_888_length_2512_cov_48.259428	1299	1379	81	2	80	0.0250000
NODE_888_length_2512_cov_48.259428	1299	1379	82	1	80	0.0125000
NODE_888_length_2512_cov_48.259428	1299	1379	83	2	80	0.0250000
NODE_888_length_2512_cov_48.259428	1299	1379	85	5	80	0.0625000
NODE_888_length_2512_cov_48.259428	1299	1379	86	4	80	0.0500000
NODE_888_length_2512_cov_48.259428	1299	1379	92	2	80	0.0250000
NODE_888_length_2512_cov_48.259428	1352	1432	27	2	80	0.0250000
NODE_888_length_2512_cov_48.259428	1352	1432	29	8	80	0.1000000
NODE_888_length_2512_cov_48.259428	1352	1432	30	3	80	0.0375000
NODE_888_length_2512_cov_48.259428	1352	1432	31	11	80	0.1375000
NODE_888_length_2512_cov_48.259428	1352	1432	33	1	80	0.0125000
NODE_888_length_2512_cov_48.259428	1352	1432	34	1	80	0.0125000
NODE_888_length_2512_cov_48.259428	1352	1432	35	3	80	0.0375000
NODE_888_length_2512_cov_48.259428	1352	1432	36	3	80	0.0375000
NODE_888_length_2512_cov_48.259428	1352	1432	37	1	80	0.0125000
NODE_888_length_2512_cov_48.259428	1352	1432	38	4	80	0.0500000
NODE_888_length_2512_cov_48.259428	1352	1432	46	1	80	0.0125000
NODE_888_length_2512_cov_48.259428	1352	1432	61	8	80	0.1000000
NODE_888_length_2512_cov_48.259428	1352	1432	62	1	80	0.0125000
NODE_888_length_2512_cov_48.259428	1352	1432	63	12	80	0.1500000
NODE_888_length_2512_cov_48.259428	1352	1432	65	20	80	0.2500000
NODE_888_length_2512_cov_48.259428	1352	1432	67	1	80	0.0125000
NODE_888_length_2512_cov_48.259428	1428	1512	27	2	84	0.0238095
NODE_888_length_2512_cov_48.259428	1428	1512	33	4	84	0.0476190
NODE_888_length_2512_cov_48.259428	1428	1512	34	13	84	0.1547619
NODE_888_length_2512_cov_48.259428	1428	1512	37	3	84	0.0357143
NODE_888_length_2512_cov_48.259428	1428	1512	38	2	84	0.0238095
NODE_888_length_2512_cov_48.259428	1428	1512	40	6	84	0.0714286
NODE_888_length_2512_cov_48.259428	1428	1512	41	2	84	0.0238095
NODE_888_length_2512_cov_48.259428	1428	1512	42	6	84	0.0714286
NODE_888_length_2512_cov_48.259428	1428	1512	44	4	84	0.0476190
NODE_888_length_2512_cov_48.259428	1428	1512	45	1	84	0.0119048
NODE_888_length_2512_cov_48.259428	1428	1512	46	4	84	0.0476190
NODE_888_length_2512_cov_48.259428	1428	1512	52	5	84	0.0595238
NODE_888_length_2512_cov_48.259428	1428	1512	62	2	84	0.0238095
NODE_888_length_2512_cov_48.259428	1428	1512	63	1	84	0.0119048
NODE_888_length_2512_cov_48.259428	1428	1512	64	1	84	0.0119048
NODE_888_length_2512_cov_48.259428	1428	1512	66	1	84	0.0119048
NODE_888_length_2512_cov_48.259428	1428	1512	69	1	84	0.0119048
NODE_888_length_2512_cov_48.259428	1428	1512	71	1	84	0.0119048
NODE_888_length_2512_cov_48.259428	1428	1512	73	1	84	0.0119048
NODE_888_length_2512_cov_48.259428	1428	1512	76	6	84	0.0714286
NODE_888_length_2512_cov_48.259428	1428	1512	77	4	84	0.0476190
NODE_888_length_2512_cov_48.259428	1428	1512	79	1	84	0.0119048
NODE_888_length_2512_cov_48.259428	1428	1512	83	2	84	0.0238095
NODE_888_length_2512_cov_48.259428	1428	1512	85	2	84	0.0238095
NODE_888_length_2512_cov_48.259428	1428	1512	87	1	84	0.0119048
NODE_888_length_2512_cov_48.259428	1428	1512	93	2	84	0.0238095
NODE_888_length_2512_cov_48.259428	1428	1512	94	2	84	0.0238095
NODE_888_length_2512_cov_48.259428	1428	1512	96	4	84	0.0476190
NODE_888_length_2512_cov_48.259428	1485	1565	69	1	80	0.0125000
NODE_888_length_2512_cov_48.259428	1485	1565	71	1	80	0.0125000
NODE_888_length_2512_cov_48.259428	1485	1565	73	1	80	0.0125000
NODE_888_length_2512_cov_48.259428	1485	1565	76	6	80	0.0750000
NODE_888_length_2512_cov_48.259428	1485	1565	77	4	80	0.0500000
NODE_888_length_2512_cov_48.259428	1485	1565	79	1	80	0.0125000
NODE_888_length_2512_cov_48.259428	1485	1565	83	2	80	0.0250000
NODE_888_length_2512_cov_48.259428	1485	1565	85	2	80	0.0250000
NODE_888_length_2512_cov_48.259428	1485	1565	87	1	80	0.0125000
NODE_888_length_2512_cov_48.259428	1485	1565	93	2	80	0.0250000
NODE_888_length_2512_cov_48.259428	1485	1565	94	2	80	0.0250000
NODE_888_length_2512_cov_48.259428	1485	1565	96	4	80	0.0500000
NODE_888_length_2512_cov_48.259428	1485	1565	98	7	80	0.0875000
NODE_888_length_2512_cov_48.259428	1485	1565	100	1	80	0.0125000
NODE_888_length_2512_cov_48.259428	1485	1565	103	3	80	0.0375000
NODE_888_length_2512_cov_48.259428	1485	1565	104	1	80	0.0125000
NODE_888_length_2512_cov_48.259428	1485	1565	105	1	80	0.0125000
NODE_888_length_2512_cov_48.259428	1485	1565	106	8	80	0.1000000
NODE_888_length_2512_cov_48.259428	1485	1565	107	3	80	0.0375000
NODE_888_length_2512_cov_48.259428	1485	1565	108	7	80	0.0875000
NODE_888_length_2512_cov_48.259428	1485	1565	109	6	80	0.0750000
NODE_888_length_2512_cov_48.259428	1485	1565	111	2	80	0.0250000
NODE_888_length_2512_cov_48.259428	1485	1565	112	14	80	0.1750000
NODE_891_length_2505_cov_102.009975	390	470	0	15	80	0.1875000
NODE_891_length_2505_cov_102.009975	390	470	2	65	80	0.8125000
NODE_891_length_2505_cov_102.009975	443	510	0	55	67	0.8208955
NODE_891_length_2505_cov_102.009975	443	510	2	12	67	0.1791045
NODE_894_length_2499_cov_2.655417	2325	2375	0	3	50	0.0600000
NODE_894_length_2499_cov_2.655417	2325	2375	3	47	50	0.9400000
NODE_895_length_2498_cov_9.614840	239	281	0	42	42	1.0000000
NODE_895_length_2498_cov_9.614840	254	335	0	81	81	1.0000000
NODE_895_length_2498_cov_9.614840	254	335	0	81	81	1.0000000
NODE_895_length_2498_cov_9.614840	331	411	0	80	80	1.0000000
NODE_895_length_2498_cov_9.614840	384	464	0	70	80	0.8750000
NODE_895_length_2498_cov_9.614840	384	464	2	10	80	0.1250000
NODE_898_length_2495_cov_5.151085	2395	2444	8	6	49	0.1224490
NODE_898_length_2495_cov_5.151085	2395	2444	10	6	49	0.1224490
NODE_898_length_2495_cov_5.151085	2395	2444	12	3	49	0.0612245
NODE_898_length_2495_cov_5.151085	2395	2444	18	34	49	0.6938776
NODE_898_length_2495_cov_5.151085	2395	2444	8	6	49	0.1224490
NODE_898_length_2495_cov_5.151085	2395	2444	10	6	49	0.1224490
NODE_898_length_2495_cov_5.151085	2395	2444	12	3	49	0.0612245
NODE_898_length_2495_cov_5.151085	2395	2444	18	34	49	0.6938776
NODE_898_length_2495_cov_5.151085	2396	2444	8	6	48	0.1250000
NODE_898_length_2495_cov_5.151085	2396	2444	10	6	48	0.1250000
NODE_898_length_2495_cov_5.151085	2396	2444	12	3	48	0.0625000
NODE_898_length_2495_cov_5.151085	2396	2444	18	33	48	0.6875000
NODE_898_length_2495_cov_5.151085	2396	2444	8	6	48	0.1250000
NODE_898_length_2495_cov_5.151085	2396	2444	10	6	48	0.1250000
NODE_898_length_2495_cov_5.151085	2396	2444	12	3	48	0.0625000
NODE_898_length_2495_cov_5.151085	2396	2444	18	33	48	0.6875000
NODE_898_length_2495_cov_5.151085	2396	2444	8	6	48	0.1250000
NODE_898_length_2495_cov_5.151085	2396	2444	10	6	48	0.1250000
NODE_898_length_2495_cov_5.151085	2396	2444	12	3	48	0.0625000
NODE_898_length_2495_cov_5.151085	2396	2444	18	33	48	0.6875000
NODE_900_length_2492_cov_43.645215	408	488	0	80	80	1.0000000
NODE_903_length_2489_cov_15.105021	204	234	0	30	30	1.0000000
NODE_905_length_2488_cov_2.434910	2141	2200	20	3	59	0.0508475
NODE_905_length_2488_cov_2.434910	2141	2200	22	7	59	0.1186441
NODE_905_length_2488_cov_2.434910	2141	2200	24	14	59	0.2372881
NODE_905_length_2488_cov_2.434910	2141	2200	26	3	59	0.0508475
NODE_905_length_2488_cov_2.434910	2141	2200	28	14	59	0.2372881
NODE_905_length_2488_cov_2.434910	2141	2200	30	8	59	0.1355932
NODE_905_length_2488_cov_2.434910	2141	2200	31	5	59	0.0847458
NODE_905_length_2488_cov_2.434910	2141	2200	32	2	59	0.0338983
NODE_905_length_2488_cov_2.434910	2141	2200	33	3	59	0.0508475
NODE_906_length_2484_cov_335.301887	224	279	799	1	55	0.0181818
NODE_906_length_2484_cov_335.301887	224	279	806	1	55	0.0181818
NODE_906_length_2484_cov_335.301887	224	279	810	1	55	0.0181818
NODE_906_length_2484_cov_335.301887	224	279	819	1	55	0.0181818
NODE_906_length_2484_cov_335.301887	224	279	821	1	55	0.0181818
NODE_906_length_2484_cov_335.301887	224	279	835	1	55	0.0181818
NODE_906_length_2484_cov_335.301887	224	279	837	2	55	0.0363636
NODE_906_length_2484_cov_335.301887	224	279	848	1	55	0.0181818
NODE_906_length_2484_cov_335.301887	224	279	850	1	55	0.0181818
NODE_906_length_2484_cov_335.301887	224	279	862	1	55	0.0181818
NODE_906_length_2484_cov_335.301887	224	279	867	1	55	0.0181818
NODE_906_length_2484_cov_335.301887	224	279	877	1	55	0.0181818
NODE_906_length_2484_cov_335.301887	224	279	887	1	55	0.0181818
NODE_906_length_2484_cov_335.301887	224	279	889	1	55	0.0181818
NODE_906_length_2484_cov_335.301887	224	279	893	1	55	0.0181818
NODE_906_length_2484_cov_335.301887	224	279	903	1	55	0.0181818
NODE_906_length_2484_cov_335.301887	224	279	908	1	55	0.0181818
NODE_906_length_2484_cov_335.301887	224	279	912	1	55	0.0181818
NODE_906_length_2484_cov_335.301887	224	279	916	2	55	0.0363636
NODE_906_length_2484_cov_335.301887	224	279	918	2	55	0.0363636
NODE_906_length_2484_cov_335.301887	224	279	919	1	55	0.0181818
NODE_906_length_2484_cov_335.301887	224	279	920	1	55	0.0181818
NODE_906_length_2484_cov_335.301887	224	279	921	1	55	0.0181818
NODE_906_length_2484_cov_335.301887	224	279	922	3	55	0.0545455
NODE_906_length_2484_cov_335.301887	224	279	925	1	55	0.0181818
NODE_906_length_2484_cov_335.301887	224	279	941	1	55	0.0181818
NODE_906_length_2484_cov_335.301887	224	279	942	1	55	0.0181818
NODE_906_length_2484_cov_335.301887	224	279	944	2	55	0.0363636
NODE_906_length_2484_cov_335.301887	224	279	945	2	55	0.0363636
NODE_906_length_2484_cov_335.301887	224	279	947	1	55	0.0181818
NODE_906_length_2484_cov_335.301887	224	279	948	1	55	0.0181818
NODE_906_length_2484_cov_335.301887	224	279	949	3	55	0.0545455
NODE_906_length_2484_cov_335.301887	224	279	950	1	55	0.0181818
NODE_906_length_2484_cov_335.301887	224	279	951	3	55	0.0545455
NODE_906_length_2484_cov_335.301887	224	279	953	2	55	0.0363636
NODE_906_length_2484_cov_335.301887	224	279	954	1	55	0.0181818
NODE_906_length_2484_cov_335.301887	224	279	955	1	55	0.0181818
NODE_906_length_2484_cov_335.301887	224	279	957	3	55	0.0545455
NODE_906_length_2484_cov_335.301887	224	279	958	1	55	0.0181818
NODE_906_length_2484_cov_335.301887	224	279	960	1	55	0.0181818
NODE_906_length_2484_cov_335.301887	224	279	968	1	55	0.0181818
NODE_906_length_2484_cov_335.301887	252	332	703	1	80	0.0125000
NODE_906_length_2484_cov_335.301887	252	332	708	1	80	0.0125000
NODE_906_length_2484_cov_335.301887	252	332	716	1	80	0.0125000
NODE_906_length_2484_cov_335.301887	252	332	727	1	80	0.0125000
NODE_906_length_2484_cov_335.301887	252	332	737	1	80	0.0125000
NODE_906_length_2484_cov_335.301887	252	332	744	1	80	0.0125000
NODE_906_length_2484_cov_335.301887	252	332	754	1	80	0.0125000
NODE_906_length_2484_cov_335.301887	252	332	772	1	80	0.0125000
NODE_906_length_2484_cov_335.301887	252	332	782	1	80	0.0125000
NODE_906_length_2484_cov_335.301887	252	332	783	1	80	0.0125000
NODE_906_length_2484_cov_335.301887	252	332	793	1	80	0.0125000
NODE_906_length_2484_cov_335.301887	252	332	829	1	80	0.0125000
NODE_906_length_2484_cov_335.301887	252	332	842	1	80	0.0125000
NODE_906_length_2484_cov_335.301887	252	332	861	1	80	0.0125000
NODE_906_length_2484_cov_335.301887	252	332	870	1	80	0.0125000
NODE_906_length_2484_cov_335.301887	252	332	881	1	80	0.0125000
NODE_906_length_2484_cov_335.301887	252	332	897	2	80	0.0250000
NODE_906_length_2484_cov_335.301887	252	332	900	1	80	0.0125000
NODE_906_length_2484_cov_335.301887	252	332	902	1	80	0.0125000
NODE_906_length_2484_cov_335.301887	252	332	907	1	80	0.0125000
NODE_906_length_2484_cov_335.301887	252	332	911	1	80	0.0125000
NODE_906_length_2484_cov_335.301887	252	332	914	2	80	0.0250000
NODE_906_length_2484_cov_335.301887	252	332	915	1	80	0.0125000
NODE_906_length_2484_cov_335.301887	252	332	919	2	80	0.0250000
NODE_906_length_2484_cov_335.301887	252	332	920	1	80	0.0125000
NODE_906_length_2484_cov_335.301887	252	332	921	2	80	0.0250000
NODE_906_length_2484_cov_335.301887	252	332	926	1	80	0.0125000
NODE_906_length_2484_cov_335.301887	252	332	928	1	80	0.0125000
NODE_906_length_2484_cov_335.301887	252	332	930	1	80	0.0125000
NODE_906_length_2484_cov_335.301887	252	332	933	1	80	0.0125000
NODE_906_length_2484_cov_335.301887	252	332	937	3	80	0.0375000
NODE_906_length_2484_cov_335.301887	252	332	941	2	80	0.0250000
NODE_906_length_2484_cov_335.301887	252	332	942	3	80	0.0375000
NODE_906_length_2484_cov_335.301887	252	332	943	2	80	0.0250000
NODE_906_length_2484_cov_335.301887	252	332	944	6	80	0.0750000
NODE_906_length_2484_cov_335.301887	252	332	945	4	80	0.0500000
NODE_906_length_2484_cov_335.301887	252	332	946	1	80	0.0125000
NODE_906_length_2484_cov_335.301887	252	332	947	2	80	0.0250000
NODE_906_length_2484_cov_335.301887	252	332	948	2	80	0.0250000
NODE_906_length_2484_cov_335.301887	252	332	949	3	80	0.0375000
NODE_906_length_2484_cov_335.301887	252	332	950	1	80	0.0125000
NODE_906_length_2484_cov_335.301887	252	332	951	3	80	0.0375000
NODE_906_length_2484_cov_335.301887	252	332	953	2	80	0.0250000
NODE_906_length_2484_cov_335.301887	252	332	954	1	80	0.0125000
NODE_906_length_2484_cov_335.301887	252	332	955	1	80	0.0125000
NODE_906_length_2484_cov_335.301887	252	332	957	3	80	0.0375000
NODE_906_length_2484_cov_335.301887	252	332	958	1	80	0.0125000
NODE_906_length_2484_cov_335.301887	252	332	959	1	80	0.0125000
NODE_906_length_2484_cov_335.301887	252	332	960	2	80	0.0250000
NODE_906_length_2484_cov_335.301887	252	332	962	1	80	0.0125000
NODE_906_length_2484_cov_335.301887	252	332	963	1	80	0.0125000
NODE_906_length_2484_cov_335.301887	252	332	968	1	80	0.0125000
NODE_912_length_2479_cov_90.381092	369	449	0	80	80	1.0000000
NODE_912_length_2479_cov_90.381092	422	499	0	77	77	1.0000000
NODE_912_length_2479_cov_90.381092	1610	1685	119	1	75	0.0133333
NODE_912_length_2479_cov_90.381092	1610	1685	183	1	75	0.0133333
NODE_912_length_2479_cov_90.381092	1610	1685	191	1	75	0.0133333
NODE_912_length_2479_cov_90.381092	1610	1685	193	2	75	0.0266667
NODE_912_length_2479_cov_90.381092	1610	1685	218	1	75	0.0133333
NODE_912_length_2479_cov_90.381092	1610	1685	234	2	75	0.0266667
NODE_912_length_2479_cov_90.381092	1610	1685	236	1	75	0.0133333
NODE_912_length_2479_cov_90.381092	1610	1685	240	1	75	0.0133333
NODE_912_length_2479_cov_90.381092	1610	1685	248	1	75	0.0133333
NODE_912_length_2479_cov_90.381092	1610	1685	250	2	75	0.0266667
NODE_912_length_2479_cov_90.381092	1610	1685	252	1	75	0.0133333
NODE_912_length_2479_cov_90.381092	1610	1685	258	1	75	0.0133333
NODE_912_length_2479_cov_90.381092	1610	1685	262	1	75	0.0133333
NODE_912_length_2479_cov_90.381092	1610	1685	278	1	75	0.0133333
NODE_912_length_2479_cov_90.381092	1610	1685	288	1	75	0.0133333
NODE_912_length_2479_cov_90.381092	1610	1685	293	1	75	0.0133333
NODE_912_length_2479_cov_90.381092	1610	1685	304	2	75	0.0266667
NODE_912_length_2479_cov_90.381092	1610	1685	310	1	75	0.0133333
NODE_912_length_2479_cov_90.381092	1610	1685	327	1	75	0.0133333
NODE_912_length_2479_cov_90.381092	1610	1685	352	1	75	0.0133333
NODE_912_length_2479_cov_90.381092	1610	1685	368	1	75	0.0133333
NODE_912_length_2479_cov_90.381092	1610	1685	374	1	75	0.0133333
NODE_912_length_2479_cov_90.381092	1610	1685	390	1	75	0.0133333
NODE_912_length_2479_cov_90.381092	1610	1685	394	1	75	0.0133333
NODE_912_length_2479_cov_90.381092	1610	1685	398	1	75	0.0133333
NODE_912_length_2479_cov_90.381092	1610	1685	410	2	75	0.0266667
NODE_912_length_2479_cov_90.381092	1610	1685	412	1	75	0.0133333
NODE_912_length_2479_cov_90.381092	1610	1685	420	1	75	0.0133333
NODE_912_length_2479_cov_90.381092	1610	1685	423	1	75	0.0133333
NODE_912_length_2479_cov_90.381092	1610	1685	424	1	75	0.0133333
NODE_912_length_2479_cov_90.381092	1610	1685	431	1	75	0.0133333
NODE_912_length_2479_cov_90.381092	1610	1685	444	1	75	0.0133333
NODE_912_length_2479_cov_90.381092	1610	1685	445	1	75	0.0133333
NODE_912_length_2479_cov_90.381092	1610	1685	448	1	75	0.0133333
NODE_912_length_2479_cov_90.381092	1610	1685	459	1	75	0.0133333
NODE_912_length_2479_cov_90.381092	1610	1685	468	1	75	0.0133333
NODE_912_length_2479_cov_90.381092	1610	1685	476	1	75	0.0133333
NODE_912_length_2479_cov_90.381092	1610	1685	488	1	75	0.0133333
NODE_912_length_2479_cov_90.381092	1610	1685	491	1	75	0.0133333
NODE_912_length_2479_cov_90.381092	1610	1685	499	1	75	0.0133333
NODE_912_length_2479_cov_90.381092	1610	1685	501	1	75	0.0133333
NODE_912_length_2479_cov_90.381092	1610	1685	513	1	75	0.0133333
NODE_912_length_2479_cov_90.381092	1610	1685	523	1	75	0.0133333
NODE_912_length_2479_cov_90.381092	1610	1685	537	1	75	0.0133333
NODE_912_length_2479_cov_90.381092	1610	1685	541	2	75	0.0266667
NODE_912_length_2479_cov_90.381092	1610	1685	547	1	75	0.0133333
NODE_912_length_2479_cov_90.381092	1610	1685	549	1	75	0.0133333
NODE_912_length_2479_cov_90.381092	1610	1685	551	2	75	0.0266667
NODE_912_length_2479_cov_90.381092	1610	1685	562	1	75	0.0133333
NODE_912_length_2479_cov_90.381092	1610	1685	571	1	75	0.0133333
NODE_912_length_2479_cov_90.381092	1610	1685	573	1	75	0.0133333
NODE_912_length_2479_cov_90.381092	1610	1685	578	1	75	0.0133333
NODE_912_length_2479_cov_90.381092	1610	1685	579	1	75	0.0133333
NODE_912_length_2479_cov_90.381092	1610	1685	580	1	75	0.0133333
NODE_912_length_2479_cov_90.381092	1610	1685	581	2	75	0.0266667
NODE_912_length_2479_cov_90.381092	1610	1685	583	2	75	0.0266667
NODE_912_length_2479_cov_90.381092	1610	1685	584	2	75	0.0266667
NODE_912_length_2479_cov_90.381092	1610	1685	585	2	75	0.0266667
NODE_912_length_2479_cov_90.381092	1610	1685	586	1	75	0.0133333
NODE_912_length_2479_cov_90.381092	1610	1685	587	3	75	0.0400000
NODE_912_length_2479_cov_90.381092	1610	1685	588	1	75	0.0133333
NODE_912_length_2479_cov_90.381092	1610	1685	589	1	75	0.0133333
NODE_912_length_2479_cov_90.381092	1658	1730	524	1	72	0.0138889
NODE_912_length_2479_cov_90.381092	1658	1730	526	1	72	0.0138889
NODE_912_length_2479_cov_90.381092	1658	1730	527	2	72	0.0277778
NODE_912_length_2479_cov_90.381092	1658	1730	528	1	72	0.0138889
NODE_912_length_2479_cov_90.381092	1658	1730	529	1	72	0.0138889
NODE_912_length_2479_cov_90.381092	1658	1730	531	3	72	0.0416667
NODE_912_length_2479_cov_90.381092	1658	1730	536	1	72	0.0138889
NODE_912_length_2479_cov_90.381092	1658	1730	537	2	72	0.0277778
NODE_912_length_2479_cov_90.381092	1658	1730	538	1	72	0.0138889
NODE_912_length_2479_cov_90.381092	1658	1730	539	2	72	0.0277778
NODE_912_length_2479_cov_90.381092	1658	1730	541	3	72	0.0416667
NODE_912_length_2479_cov_90.381092	1658	1730	542	1	72	0.0138889
NODE_912_length_2479_cov_90.381092	1658	1730	544	1	72	0.0138889
NODE_912_length_2479_cov_90.381092	1658	1730	545	2	72	0.0277778
NODE_912_length_2479_cov_90.381092	1658	1730	546	3	72	0.0416667
NODE_912_length_2479_cov_90.381092	1658	1730	547	1	72	0.0138889
NODE_912_length_2479_cov_90.381092	1658	1730	548	1	72	0.0138889
NODE_912_length_2479_cov_90.381092	1658	1730	549	2	72	0.0277778
NODE_912_length_2479_cov_90.381092	1658	1730	550	3	72	0.0416667
NODE_912_length_2479_cov_90.381092	1658	1730	551	2	72	0.0277778
NODE_912_length_2479_cov_90.381092	1658	1730	553	2	72	0.0277778
NODE_912_length_2479_cov_90.381092	1658	1730	559	1	72	0.0138889
NODE_912_length_2479_cov_90.381092	1658	1730	562	1	72	0.0138889
NODE_912_length_2479_cov_90.381092	1658	1730	567	1	72	0.0138889
NODE_912_length_2479_cov_90.381092	1658	1730	571	2	72	0.0277778
NODE_912_length_2479_cov_90.381092	1658	1730	573	1	72	0.0138889
NODE_912_length_2479_cov_90.381092	1658	1730	578	1	72	0.0138889
NODE_912_length_2479_cov_90.381092	1658	1730	579	1	72	0.0138889
NODE_912_length_2479_cov_90.381092	1658	1730	580	1	72	0.0138889
NODE_912_length_2479_cov_90.381092	1658	1730	581	2	72	0.0277778
NODE_912_length_2479_cov_90.381092	1658	1730	583	3	72	0.0416667
NODE_912_length_2479_cov_90.381092	1658	1730	584	4	72	0.0555556
NODE_912_length_2479_cov_90.381092	1658	1730	585	2	72	0.0277778
NODE_912_length_2479_cov_90.381092	1658	1730	586	2	72	0.0277778
NODE_912_length_2479_cov_90.381092	1658	1730	587	3	72	0.0416667
NODE_912_length_2479_cov_90.381092	1658	1730	588	1	72	0.0138889
NODE_912_length_2479_cov_90.381092	1658	1730	589	2	72	0.0277778
NODE_912_length_2479_cov_90.381092	1658	1730	591	1	72	0.0138889
NODE_912_length_2479_cov_90.381092	1658	1730	594	1	72	0.0138889
NODE_912_length_2479_cov_90.381092	1658	1730	596	3	72	0.0416667
NODE_912_length_2479_cov_90.381092	1658	1730	598	3	72	0.0416667
NODE_913_length_2479_cov_3.433193	2379	2426	0	45	47	0.9574468
NODE_913_length_2479_cov_3.433193	2379	2426	4	1	47	0.0212766
NODE_913_length_2479_cov_3.433193	2379	2426	6	1	47	0.0212766
NODE_913_length_2479_cov_3.433193	2399	2479	0	80	80	1.0000000
NODE_915_length_2474_cov_7.237895	399	479	4	49	80	0.6125000
NODE_915_length_2474_cov_7.237895	399	479	6	31	80	0.3875000
NODE_915_length_2474_cov_7.237895	452	532	2	23	80	0.2875000
NODE_915_length_2474_cov_7.237895	452	532	4	45	80	0.5625000
NODE_915_length_2474_cov_7.237895	452	532	6	12	80	0.1500000
NODE_922_length_2465_cov_3.098056	2133	2213	0	25	80	0.3125000
NODE_922_length_2465_cov_3.098056	2133	2213	2	15	80	0.1875000
NODE_922_length_2465_cov_3.098056	2133	2213	6	15	80	0.1875000
NODE_922_length_2465_cov_3.098056	2133	2213	8	25	80	0.3125000
NODE_922_length_2465_cov_3.098056	2191	2253	8	40	62	0.6451613
NODE_922_length_2465_cov_3.098056	2191	2253	10	22	62	0.3548387
NODE_923_length_2464_cov_24.562791	331	409	0	12	78	0.1538462
NODE_923_length_2464_cov_24.562791	331	409	2	66	78	0.8461539
NODE_923_length_2464_cov_24.562791	382	462	0	45	80	0.5625000
NODE_923_length_2464_cov_24.562791	382	462	2	35	80	0.4375000
NODE_924_length_2461_cov_2.696444	292	372	0	7	80	0.0875000
NODE_924_length_2461_cov_2.696444	292	372	4	48	80	0.6000000
NODE_924_length_2461_cov_2.696444	292	372	6	25	80	0.3125000
NODE_924_length_2461_cov_2.696444	345	425	0	60	80	0.7500000
NODE_924_length_2461_cov_2.696444	345	425	4	20	80	0.2500000
NODE_938_length_2447_cov_16.079216	2344	2424	41	2	80	0.0250000
NODE_938_length_2447_cov_16.079216	2344	2424	44	2	80	0.0250000
NODE_938_length_2447_cov_16.079216	2344	2424	48	12	80	0.1500000
NODE_938_length_2447_cov_16.079216	2344	2424	50	1	80	0.0125000
NODE_938_length_2447_cov_16.079216	2344	2424	52	3	80	0.0375000
NODE_938_length_2447_cov_16.079216	2344	2424	54	4	80	0.0500000
NODE_938_length_2447_cov_16.079216	2344	2424	58	6	80	0.0750000
NODE_938_length_2447_cov_16.079216	2344	2424	61	8	80	0.1000000
NODE_938_length_2447_cov_16.079216	2344	2424	62	1	80	0.0125000
NODE_938_length_2447_cov_16.079216	2344	2424	64	6	80	0.0750000
NODE_938_length_2447_cov_16.079216	2344	2424	66	3	80	0.0375000
NODE_938_length_2447_cov_16.079216	2344	2424	68	8	80	0.1000000
NODE_938_length_2447_cov_16.079216	2344	2424	72	5	80	0.0625000
NODE_938_length_2447_cov_16.079216	2344	2424	73	4	80	0.0500000
NODE_938_length_2447_cov_16.079216	2344	2424	75	5	80	0.0625000
NODE_938_length_2447_cov_16.079216	2344	2424	77	2	80	0.0250000
NODE_938_length_2447_cov_16.079216	2344	2424	79	4	80	0.0500000
NODE_938_length_2447_cov_16.079216	2344	2424	81	1	80	0.0125000
NODE_938_length_2447_cov_16.079216	2344	2424	83	1	80	0.0125000
NODE_938_length_2447_cov_16.079216	2344	2424	85	2	80	0.0250000
NODE_938_length_2447_cov_16.079216	2397	2447	6	1	50	0.0200000
NODE_938_length_2447_cov_16.079216	2397	2447	10	1	50	0.0200000
NODE_938_length_2447_cov_16.079216	2397	2447	14	6	50	0.1200000
NODE_938_length_2447_cov_16.079216	2397	2447	15	4	50	0.0800000
NODE_938_length_2447_cov_16.079216	2397	2447	23	3	50	0.0600000
NODE_938_length_2447_cov_16.079216	2397	2447	29	1	50	0.0200000
NODE_938_length_2447_cov_16.079216	2397	2447	30	1	50	0.0200000
NODE_938_length_2447_cov_16.079216	2397	2447	32	1	50	0.0200000
NODE_938_length_2447_cov_16.079216	2397	2447	36	1	50	0.0200000
NODE_938_length_2447_cov_16.079216	2397	2447	38	1	50	0.0200000
NODE_938_length_2447_cov_16.079216	2397	2447	39	2	50	0.0400000
NODE_938_length_2447_cov_16.079216	2397	2447	41	3	50	0.0600000
NODE_938_length_2447_cov_16.079216	2397	2447	44	2	50	0.0400000
NODE_938_length_2447_cov_16.079216	2397	2447	48	12	50	0.2400000
NODE_938_length_2447_cov_16.079216	2397	2447	50	1	50	0.0200000
NODE_938_length_2447_cov_16.079216	2397	2447	52	3	50	0.0600000
NODE_938_length_2447_cov_16.079216	2397	2447	54	4	50	0.0800000
NODE_938_length_2447_cov_16.079216	2397	2447	58	3	50	0.0600000
NODE_940_length_2446_cov_2.341287	1521	1578	2	16	57	0.2807018
NODE_940_length_2446_cov_2.341287	1521	1578	4	41	57	0.7192982
NODE_940_length_2446_cov_2.341287	1551	1593	4	42	42	1.0000000
NODE_949_length_2437_cov_13.341745	418	498	0	40	80	0.5000000
NODE_949_length_2437_cov_13.341745	418	498	4	40	80	0.5000000
NODE_949_length_2437_cov_13.341745	471	551	0	27	80	0.3375000
NODE_949_length_2437_cov_13.341745	471	551	2	3	80	0.0375000
NODE_949_length_2437_cov_13.341745	471	551	4	32	80	0.4000000
NODE_949_length_2437_cov_13.341745	471	551	6	2	80	0.0250000
NODE_949_length_2437_cov_13.341745	471	551	7	10	80	0.1250000
NODE_949_length_2437_cov_13.341745	471	551	9	1	80	0.0125000
NODE_949_length_2437_cov_13.341745	471	551	11	1	80	0.0125000
NODE_949_length_2437_cov_13.341745	471	551	15	2	80	0.0250000
NODE_949_length_2437_cov_13.341745	471	551	18	2	80	0.0250000
NODE_951_length_2432_cov_70.360909	1875	1955	0	80	80	1.0000000
NODE_951_length_2432_cov_70.360909	1928	2008	0	32	80	0.4000000
NODE_951_length_2432_cov_70.360909	1928	2008	2	48	80	0.6000000
NODE_955_length_2430_cov_19.835264	0	68	11	1	68	0.0147059
NODE_955_length_2430_cov_19.835264	0	68	13	1	68	0.0147059
NODE_955_length_2430_cov_19.835264	0	68	16	1	68	0.0147059
NODE_955_length_2430_cov_19.835264	0	68	21	1	68	0.0147059
NODE_955_length_2430_cov_19.835264	0	68	25	2	68	0.0294118
NODE_955_length_2430_cov_19.835264	0	68	27	1	68	0.0147059
NODE_955_length_2430_cov_19.835264	0	68	30	1	68	0.0147059
NODE_955_length_2430_cov_19.835264	0	68	34	2	68	0.0294118
NODE_955_length_2430_cov_19.835264	0	68	36	3	68	0.0441176
NODE_955_length_2430_cov_19.835264	0	68	38	1	68	0.0147059
NODE_955_length_2430_cov_19.835264	0	68	39	1	68	0.0147059
NODE_955_length_2430_cov_19.835264	0	68	41	1	68	0.0147059
NODE_955_length_2430_cov_19.835264	0	68	42	1	68	0.0147059
NODE_955_length_2430_cov_19.835264	0	68	43	1	68	0.0147059
NODE_955_length_2430_cov_19.835264	0	68	47	1	68	0.0147059
NODE_955_length_2430_cov_19.835264	0	68	54	1	68	0.0147059
NODE_955_length_2430_cov_19.835264	0	68	57	1	68	0.0147059
NODE_955_length_2430_cov_19.835264	0	68	62	1	68	0.0147059
NODE_955_length_2430_cov_19.835264	0	68	64	1	68	0.0147059
NODE_955_length_2430_cov_19.835264	0	68	66	1	68	0.0147059
NODE_955_length_2430_cov_19.835264	0	68	67	1	68	0.0147059
NODE_955_length_2430_cov_19.835264	0	68	70	1	68	0.0147059
NODE_955_length_2430_cov_19.835264	0	68	73	3	68	0.0441176
NODE_955_length_2430_cov_19.835264	0	68	75	1	68	0.0147059
NODE_955_length_2430_cov_19.835264	0	68	77	4	68	0.0588235
NODE_955_length_2430_cov_19.835264	0	68	79	2	68	0.0294118
NODE_955_length_2430_cov_19.835264	0	68	85	2	68	0.0294118
NODE_955_length_2430_cov_19.835264	0	68	90	5	68	0.0735294
NODE_955_length_2430_cov_19.835264	0	68	92	1	68	0.0147059
NODE_955_length_2430_cov_19.835264	0	68	97	3	68	0.0441176
NODE_955_length_2430_cov_19.835264	0	68	98	3	68	0.0441176
NODE_955_length_2430_cov_19.835264	0	68	100	1	68	0.0147059
NODE_955_length_2430_cov_19.835264	0	68	102	1	68	0.0147059
NODE_955_length_2430_cov_19.835264	0	68	104	1	68	0.0147059
NODE_955_length_2430_cov_19.835264	0	68	110	1	68	0.0147059
NODE_955_length_2430_cov_19.835264	0	68	111	2	68	0.0294118
NODE_955_length_2430_cov_19.835264	0	68	121	1	68	0.0147059
NODE_955_length_2430_cov_19.835264	0	68	123	1	68	0.0147059
NODE_955_length_2430_cov_19.835264	0	68	127	1	68	0.0147059
NODE_955_length_2430_cov_19.835264	0	68	131	1	68	0.0147059
NODE_955_length_2430_cov_19.835264	0	68	132	1	68	0.0147059
NODE_955_length_2430_cov_19.835264	0	68	137	1	68	0.0147059
NODE_955_length_2430_cov_19.835264	0	68	139	1	68	0.0147059
NODE_955_length_2430_cov_19.835264	0	68	147	1	68	0.0147059
NODE_955_length_2430_cov_19.835264	0	68	150	1	68	0.0147059
NODE_955_length_2430_cov_19.835264	0	68	154	3	68	0.0441176
NODE_955_length_2430_cov_19.835264	0	24	11	1	24	0.0416667
NODE_955_length_2430_cov_19.835264	0	24	13	1	24	0.0416667
NODE_955_length_2430_cov_19.835264	0	24	16	1	24	0.0416667
NODE_955_length_2430_cov_19.835264	0	24	21	1	24	0.0416667
NODE_955_length_2430_cov_19.835264	0	24	25	2	24	0.0833333
NODE_955_length_2430_cov_19.835264	0	24	27	1	24	0.0416667
NODE_955_length_2430_cov_19.835264	0	24	30	1	24	0.0416667
NODE_955_length_2430_cov_19.835264	0	24	34	2	24	0.0833333
NODE_955_length_2430_cov_19.835264	0	24	36	3	24	0.1250000
NODE_955_length_2430_cov_19.835264	0	24	38	1	24	0.0416667
NODE_955_length_2430_cov_19.835264	0	24	39	1	24	0.0416667
NODE_955_length_2430_cov_19.835264	0	24	41	1	24	0.0416667
NODE_955_length_2430_cov_19.835264	0	24	42	1	24	0.0416667
NODE_955_length_2430_cov_19.835264	0	24	43	1	24	0.0416667
NODE_955_length_2430_cov_19.835264	0	24	47	1	24	0.0416667
NODE_955_length_2430_cov_19.835264	0	24	54	1	24	0.0416667
NODE_955_length_2430_cov_19.835264	0	24	57	1	24	0.0416667
NODE_955_length_2430_cov_19.835264	0	24	62	1	24	0.0416667
NODE_955_length_2430_cov_19.835264	0	24	64	1	24	0.0416667
NODE_955_length_2430_cov_19.835264	0	24	66	1	24	0.0416667
NODE_956_length_2428_cov_179.842422	538	618	0	2	80	0.0250000
NODE_956_length_2428_cov_179.842422	538	618	2	7	80	0.0875000
NODE_956_length_2428_cov_179.842422	538	618	4	22	80	0.2750000
NODE_956_length_2428_cov_179.842422	538	618	6	49	80	0.6125000
NODE_956_length_2428_cov_179.842422	591	671	0	40	80	0.5000000
NODE_956_length_2428_cov_179.842422	591	671	2	20	80	0.2500000
NODE_956_length_2428_cov_179.842422	591	671	6	20	80	0.2500000
NODE_956_length_2428_cov_179.842422	667	747	0	80	80	1.0000000
NODE_956_length_2428_cov_179.842422	720	800	0	80	80	1.0000000
NODE_956_length_2428_cov_179.842422	1308	1388	0	80	80	1.0000000
NODE_956_length_2428_cov_179.842422	1361	1441	0	80	80	1.0000000
NODE_956_length_2428_cov_179.842422	1437	1517	0	80	80	1.0000000
NODE_956_length_2428_cov_179.842422	1490	1570	0	80	80	1.0000000
NODE_956_length_2428_cov_179.842422	1986	2026	931	1	40	0.0250000
NODE_956_length_2428_cov_179.842422	1986	2026	935	2	40	0.0500000
NODE_956_length_2428_cov_179.842422	1986	2026	937	4	40	0.1000000
NODE_956_length_2428_cov_179.842422	1986	2026	943	1	40	0.0250000
NODE_956_length_2428_cov_179.842422	1986	2026	947	1	40	0.0250000
NODE_956_length_2428_cov_179.842422	1986	2026	949	2	40	0.0500000
NODE_956_length_2428_cov_179.842422	1986	2026	950	1	40	0.0250000
NODE_956_length_2428_cov_179.842422	1986	2026	952	1	40	0.0250000
NODE_956_length_2428_cov_179.842422	1986	2026	954	1	40	0.0250000
NODE_956_length_2428_cov_179.842422	1986	2026	955	1	40	0.0250000
NODE_956_length_2428_cov_179.842422	1986	2026	956	5	40	0.1250000
NODE_956_length_2428_cov_179.842422	1986	2026	958	1	40	0.0250000
NODE_956_length_2428_cov_179.842422	1986	2026	960	1	40	0.0250000
NODE_956_length_2428_cov_179.842422	1986	2026	961	4	40	0.1000000
NODE_956_length_2428_cov_179.842422	1986	2026	962	3	40	0.0750000
NODE_956_length_2428_cov_179.842422	1986	2026	963	2	40	0.0500000
NODE_956_length_2428_cov_179.842422	1986	2026	964	1	40	0.0250000
NODE_956_length_2428_cov_179.842422	1986	2026	965	1	40	0.0250000
NODE_956_length_2428_cov_179.842422	1986	2026	973	1	40	0.0250000
NODE_956_length_2428_cov_179.842422	1986	2026	977	1	40	0.0250000
NODE_956_length_2428_cov_179.842422	1986	2026	989	1	40	0.0250000
NODE_956_length_2428_cov_179.842422	1986	2026	1006	1	40	0.0250000
NODE_956_length_2428_cov_179.842422	1986	2026	1015	1	40	0.0250000
NODE_956_length_2428_cov_179.842422	1986	2026	1029	1	40	0.0250000
NODE_956_length_2428_cov_179.842422	1986	2026	1033	1	40	0.0250000
NODE_959_length_2422_cov_6.665088	197	255	2	57	58	0.9827586
NODE_959_length_2422_cov_6.665088	197	255	4	1	58	0.0172414
NODE_963_length_2414_cov_32.871706	411	491	0	21	80	0.2625000
NODE_963_length_2414_cov_32.871706	411	491	2	59	80	0.7375000
NODE_963_length_2414_cov_32.871706	464	544	0	74	80	0.9250000
NODE_963_length_2414_cov_32.871706	464	544	2	6	80	0.0750000
NODE_964_length_2414_cov_2.105832	2349	2390	0	41	41	1.0000000
NODE_968_length_2410_cov_9.107313	1874	1954	1	6	80	0.0750000
NODE_968_length_2410_cov_9.107313	1874	1954	2	15	80	0.1875000
NODE_968_length_2410_cov_9.107313	1874	1954	10	2	80	0.0250000
NODE_968_length_2410_cov_9.107313	1874	1954	11	20	80	0.2500000
NODE_968_length_2410_cov_9.107313	1874	1954	12	15	80	0.1875000
NODE_968_length_2410_cov_9.107313	1874	1954	14	22	80	0.2750000
NODE_968_length_2410_cov_9.107313	1927	2007	11	6	80	0.0750000
NODE_968_length_2410_cov_9.107313	1927	2007	12	10	80	0.1250000
NODE_968_length_2410_cov_9.107313	1927	2007	14	64	80	0.8000000
NODE_977_length_2390_cov_20.371454	1753	1833	0	40	80	0.5000000
NODE_977_length_2390_cov_20.371454	1753	1833	2	40	80	0.5000000
NODE_977_length_2390_cov_20.371454	1806	1886	0	80	80	1.0000000
NODE_979_length_2389_cov_17.904803	1601	1681	0	80	80	1.0000000
NODE_979_length_2389_cov_17.904803	1654	1734	0	80	80	1.0000000
NODE_979_length_2389_cov_17.904803	1730	1810	0	80	80	1.0000000
NODE_979_length_2389_cov_17.904803	1783	1863	0	40	80	0.5000000
NODE_979_length_2389_cov_17.904803	1783	1863	2	40	80	0.5000000
NODE_988_length_2381_cov_32.280894	398	478	0	80	80	1.0000000
NODE_988_length_2381_cov_32.280894	451	531	0	76	80	0.9500000
NODE_988_length_2381_cov_32.280894	451	531	2	4	80	0.0500000
NODE_988_length_2381_cov_32.280894	527	607	2	59	80	0.7375000
NODE_988_length_2381_cov_32.280894	527	607	4	21	80	0.2625000
NODE_988_length_2381_cov_32.280894	580	660	2	51	80	0.6375000
NODE_988_length_2381_cov_32.280894	580	660	4	29	80	0.3625000
NODE_988_length_2381_cov_32.280894	2288	2368	0	75	80	0.9375000
NODE_988_length_2381_cov_32.280894	2288	2368	2	3	80	0.0375000
NODE_988_length_2381_cov_32.280894	2288	2368	4	2	80	0.0250000
NODE_997_length_2369_cov_4.896916	241	321	0	6	80	0.0750000
NODE_997_length_2369_cov_4.896916	241	321	4	74	80	0.9250000
NODE_997_length_2369_cov_4.896916	294	374	0	47	80	0.5875000
NODE_997_length_2369_cov_4.896916	294	374	4	33	80	0.4125000
NODE_1002_length_2364_cov_2.482561	0	79	0	79	79	1.0000000
NODE_1004_length_2360_cov_8.620080	587	651	26	6	64	0.0937500
NODE_1004_length_2360_cov_8.620080	587	651	28	2	64	0.0312500
NODE_1004_length_2360_cov_8.620080	587	651	32	2	64	0.0312500
NODE_1004_length_2360_cov_8.620080	587	651	36	4	64	0.0625000
NODE_1004_length_2360_cov_8.620080	587	651	46	5	64	0.0781250
NODE_1004_length_2360_cov_8.620080	587	651	48	32	64	0.5000000
NODE_1004_length_2360_cov_8.620080	587	651	52	3	64	0.0468750
NODE_1004_length_2360_cov_8.620080	587	651	54	10	64	0.1562500
NODE_1004_length_2360_cov_8.620080	587	651	26	6	64	0.0937500
NODE_1004_length_2360_cov_8.620080	587	651	28	2	64	0.0312500
NODE_1004_length_2360_cov_8.620080	587	651	32	2	64	0.0312500
NODE_1004_length_2360_cov_8.620080	587	651	36	4	64	0.0625000
NODE_1004_length_2360_cov_8.620080	587	651	46	5	64	0.0781250
NODE_1004_length_2360_cov_8.620080	587	651	48	32	64	0.5000000
NODE_1004_length_2360_cov_8.620080	587	651	52	3	64	0.0468750
NODE_1004_length_2360_cov_8.620080	587	651	54	10	64	0.1562500
NODE_1004_length_2360_cov_8.620080	624	684	6	3	60	0.0500000
NODE_1004_length_2360_cov_8.620080	624	684	8	14	60	0.2333333
NODE_1004_length_2360_cov_8.620080	624	684	12	2	60	0.0333333
NODE_1004_length_2360_cov_8.620080	624	684	14	3	60	0.0500000
NODE_1004_length_2360_cov_8.620080	624	684	16	2	60	0.0333333
NODE_1004_length_2360_cov_8.620080	624	684	26	15	60	0.2500000
NODE_1004_length_2360_cov_8.620080	624	684	28	2	60	0.0333333
NODE_1004_length_2360_cov_8.620080	624	684	32	2	60	0.0333333
NODE_1004_length_2360_cov_8.620080	624	684	36	4	60	0.0666667
NODE_1004_length_2360_cov_8.620080	624	684	46	5	60	0.0833333
NODE_1004_length_2360_cov_8.620080	624	684	52	3	60	0.0500000
NODE_1004_length_2360_cov_8.620080	624	684	54	5	60	0.0833333
NODE_1004_length_2360_cov_8.620080	1827	1907	0	80	80	1.0000000
NODE_1004_length_2360_cov_8.620080	1880	1960	0	80	80	1.0000000
NODE_1005_length_2359_cov_22.317257	958	1038	0	9	80	0.1125000
NODE_1005_length_2359_cov_22.317257	958	1038	2	71	80	0.8875000
NODE_1005_length_2359_cov_22.317257	1011	1091	0	53	80	0.6625000
NODE_1005_length_2359_cov_22.317257	1011	1091	2	27	80	0.3375000
NODE_1008_length_2357_cov_25.711249	716	796	0	44	80	0.5500000
NODE_1008_length_2357_cov_25.711249	716	796	2	36	80	0.4500000
NODE_1008_length_2357_cov_25.711249	769	849	0	80	80	1.0000000
NODE_1015_length_2345_cov_5.386465	1845	1925	0	80	80	1.0000000
NODE_1015_length_2345_cov_5.386465	1898	1978	0	80	80	1.0000000
NODE_1016_length_2344_cov_6.236526	1208	1269	12	9	61	0.1475410
NODE_1016_length_2344_cov_6.236526	1208	1269	13	4	61	0.0655738
NODE_1016_length_2344_cov_6.236526	1208	1269	15	12	61	0.1967213
NODE_1016_length_2344_cov_6.236526	1208	1269	17	1	61	0.0163934
NODE_1016_length_2344_cov_6.236526	1208	1269	18	6	61	0.0983607
NODE_1016_length_2344_cov_6.236526	1208	1269	19	1	61	0.0163934
NODE_1016_length_2344_cov_6.236526	1208	1269	20	28	61	0.4590164
NODE_1016_length_2344_cov_6.236526	1208	1269	12	9	61	0.1475410
NODE_1016_length_2344_cov_6.236526	1208	1269	13	4	61	0.0655738
NODE_1016_length_2344_cov_6.236526	1208	1269	15	12	61	0.1967213
NODE_1016_length_2344_cov_6.236526	1208	1269	17	1	61	0.0163934
NODE_1016_length_2344_cov_6.236526	1208	1269	18	6	61	0.0983607
NODE_1016_length_2344_cov_6.236526	1208	1269	19	1	61	0.0163934
NODE_1016_length_2344_cov_6.236526	1208	1269	20	28	61	0.4590164
NODE_1016_length_2344_cov_6.236526	1208	1269	12	9	61	0.1475410
NODE_1016_length_2344_cov_6.236526	1208	1269	13	4	61	0.0655738
NODE_1016_length_2344_cov_6.236526	1208	1269	15	12	61	0.1967213
NODE_1016_length_2344_cov_6.236526	1208	1269	17	1	61	0.0163934
NODE_1016_length_2344_cov_6.236526	1208	1269	18	6	61	0.0983607
NODE_1016_length_2344_cov_6.236526	1208	1269	19	1	61	0.0163934
NODE_1016_length_2344_cov_6.236526	1208	1269	20	28	61	0.4590164
NODE_1016_length_2344_cov_6.236526	1208	1267	12	7	59	0.1186441
NODE_1016_length_2344_cov_6.236526	1208	1267	13	4	59	0.0677966
NODE_1016_length_2344_cov_6.236526	1208	1267	15	12	59	0.2033898
NODE_1016_length_2344_cov_6.236526	1208	1267	17	1	59	0.0169492
NODE_1016_length_2344_cov_6.236526	1208	1267	18	6	59	0.1016949
NODE_1016_length_2344_cov_6.236526	1208	1267	19	1	59	0.0169492
NODE_1016_length_2344_cov_6.236526	1208	1267	20	28	59	0.4745763
NODE_1023_length_2332_cov_4.725929	34	101	4	64	67	0.9552239
NODE_1023_length_2332_cov_4.725929	34	101	6	1	67	0.0149254
NODE_1023_length_2332_cov_4.725929	34	101	16	2	67	0.0298507
NODE_1027_length_2327_cov_18.210952	2213	2293	4	46	80	0.5750000
NODE_1027_length_2327_cov_18.210952	2213	2293	6	15	80	0.1875000
NODE_1027_length_2327_cov_18.210952	2213	2293	8	13	80	0.1625000
NODE_1027_length_2327_cov_18.210952	2213	2293	10	6	80	0.0750000
NODE_1027_length_2327_cov_18.210952	2266	2327	6	49	61	0.8032787
NODE_1027_length_2327_cov_18.210952	2266	2327	8	6	61	0.0983607
NODE_1027_length_2327_cov_18.210952	2266	2327	10	6	61	0.0983607
NODE_1028_length_2326_cov_15.583745	1709	1789	1	15	80	0.1875000
NODE_1028_length_2326_cov_15.583745	1709	1789	8	8	80	0.1000000
NODE_1028_length_2326_cov_15.583745	1709	1789	9	50	80	0.6250000
NODE_1028_length_2326_cov_15.583745	1709	1789	10	1	80	0.0125000
NODE_1028_length_2326_cov_15.583745	1709	1789	12	6	80	0.0750000
NODE_1028_length_2326_cov_15.583745	1762	1842	8	11	80	0.1375000
NODE_1028_length_2326_cov_15.583745	1762	1842	9	12	80	0.1500000
NODE_1028_length_2326_cov_15.583745	1762	1842	10	1	80	0.0125000
NODE_1028_length_2326_cov_15.583745	1762	1842	12	56	80	0.7000000
NODE_1030_length_2325_cov_14.998652	553	633	0	80	80	1.0000000
NODE_1030_length_2325_cov_14.998652	606	686	0	80	80	1.0000000
NODE_1034_length_2317_cov_11.956718	920	1000	0	80	80	1.0000000
NODE_1034_length_2317_cov_11.956718	973	1053	0	80	80	1.0000000
NODE_1034_length_2317_cov_11.956718	1049	1129	0	13	80	0.1625000
NODE_1034_length_2317_cov_11.956718	1049	1129	2	67	80	0.8375000
NODE_1034_length_2317_cov_11.956718	1102	1184	0	11	82	0.1341463
NODE_1034_length_2317_cov_11.956718	1102	1184	2	71	82	0.8658537
NODE_1037_length_2316_cov_8.556608	168	247	60	4	79	0.0506329
NODE_1037_length_2316_cov_8.556608	168	247	63	1	79	0.0126582
NODE_1037_length_2316_cov_8.556608	168	247	64	1	79	0.0126582
NODE_1037_length_2316_cov_8.556608	168	247	65	1	79	0.0126582
NODE_1037_length_2316_cov_8.556608	168	247	66	5	79	0.0632911
NODE_1037_length_2316_cov_8.556608	168	247	67	1	79	0.0126582
NODE_1037_length_2316_cov_8.556608	168	247	71	2	79	0.0253165
NODE_1037_length_2316_cov_8.556608	168	247	74	1	79	0.0126582
NODE_1037_length_2316_cov_8.556608	168	247	78	1	79	0.0126582
NODE_1037_length_2316_cov_8.556608	168	247	82	1	79	0.0126582
NODE_1037_length_2316_cov_8.556608	168	247	86	3	79	0.0379747
NODE_1037_length_2316_cov_8.556608	168	247	90	1	79	0.0126582
NODE_1037_length_2316_cov_8.556608	168	247	91	2	79	0.0253165
NODE_1037_length_2316_cov_8.556608	168	247	92	2	79	0.0253165
NODE_1037_length_2316_cov_8.556608	168	247	94	1	79	0.0126582
NODE_1037_length_2316_cov_8.556608	168	247	96	3	79	0.0379747
NODE_1037_length_2316_cov_8.556608	168	247	98	1	79	0.0126582
NODE_1037_length_2316_cov_8.556608	168	247	100	1	79	0.0126582
NODE_1037_length_2316_cov_8.556608	168	247	104	1	79	0.0126582
NODE_1037_length_2316_cov_8.556608	168	247	108	1	79	0.0126582
NODE_1037_length_2316_cov_8.556608	168	247	114	2	79	0.0253165
NODE_1037_length_2316_cov_8.556608	168	247	118	2	79	0.0253165
NODE_1037_length_2316_cov_8.556608	168	247	119	2	79	0.0253165
NODE_1037_length_2316_cov_8.556608	168	247	120	3	79	0.0379747
NODE_1037_length_2316_cov_8.556608	168	247	121	2	79	0.0253165
NODE_1037_length_2316_cov_8.556608	168	247	122	4	79	0.0506329
NODE_1037_length_2316_cov_8.556608	168	247	123	8	79	0.1012658
NODE_1037_length_2316_cov_8.556608	168	247	124	2	79	0.0253165
NODE_1037_length_2316_cov_8.556608	168	247	125	13	79	0.1645570
NODE_1037_length_2316_cov_8.556608	168	247	126	2	79	0.0253165
NODE_1037_length_2316_cov_8.556608	168	247	129	5	79	0.0632911
NODE_1037_length_2316_cov_8.556608	1117	1198	18	12	81	0.1481481
NODE_1037_length_2316_cov_8.556608	1117	1198	19	1	81	0.0123457
NODE_1037_length_2316_cov_8.556608	1117	1198	20	10	81	0.1234568
NODE_1037_length_2316_cov_8.556608	1117	1198	22	9	81	0.1111111
NODE_1037_length_2316_cov_8.556608	1117	1198	23	1	81	0.0123457
NODE_1037_length_2316_cov_8.556608	1117	1198	24	2	81	0.0246914
NODE_1037_length_2316_cov_8.556608	1117	1198	26	8	81	0.0987654
NODE_1037_length_2316_cov_8.556608	1117	1198	28	7	81	0.0864198
NODE_1037_length_2316_cov_8.556608	1117	1198	30	3	81	0.0370370
NODE_1037_length_2316_cov_8.556608	1117	1198	36	4	81	0.0493827
NODE_1037_length_2316_cov_8.556608	1117	1198	38	16	81	0.1975309
NODE_1037_length_2316_cov_8.556608	1117	1198	40	8	81	0.0987654
NODE_1037_length_2316_cov_8.556608	1369	1412	132	2	43	0.0465116
NODE_1037_length_2316_cov_8.556608	1369	1412	134	2	43	0.0465116
NODE_1037_length_2316_cov_8.556608	1369	1412	135	1	43	0.0232558
NODE_1037_length_2316_cov_8.556608	1369	1412	138	3	43	0.0697674
NODE_1037_length_2316_cov_8.556608	1369	1412	142	3	43	0.0697674
NODE_1037_length_2316_cov_8.556608	1369	1412	146	1	43	0.0232558
NODE_1037_length_2316_cov_8.556608	1369	1412	148	1	43	0.0232558
NODE_1037_length_2316_cov_8.556608	1369	1412	156	1	43	0.0232558
NODE_1037_length_2316_cov_8.556608	1369	1412	159	1	43	0.0232558
NODE_1037_length_2316_cov_8.556608	1369	1412	161	3	43	0.0697674
NODE_1037_length_2316_cov_8.556608	1369	1412	167	1	43	0.0232558
NODE_1037_length_2316_cov_8.556608	1369	1412	169	1	43	0.0232558
NODE_1037_length_2316_cov_8.556608	1369	1412	171	1	43	0.0232558
NODE_1037_length_2316_cov_8.556608	1369	1412	175	4	43	0.0930233
NODE_1037_length_2316_cov_8.556608	1369	1412	179	2	43	0.0465116
NODE_1037_length_2316_cov_8.556608	1369	1412	180	5	43	0.1162791
NODE_1037_length_2316_cov_8.556608	1369	1412	181	2	43	0.0465116
NODE_1037_length_2316_cov_8.556608	1369	1412	182	2	43	0.0465116
NODE_1037_length_2316_cov_8.556608	1369	1412	186	1	43	0.0232558
NODE_1037_length_2316_cov_8.556608	1369	1412	188	1	43	0.0232558
NODE_1037_length_2316_cov_8.556608	1369	1412	190	1	43	0.0232558
NODE_1037_length_2316_cov_8.556608	1369	1412	192	3	43	0.0697674
NODE_1037_length_2316_cov_8.556608	1369	1412	194	1	43	0.0232558
NODE_1040_length_2311_cov_2.821881	2121	2201	0	80	80	1.0000000
NODE_1040_length_2311_cov_2.821881	2174	2225	0	51	51	1.0000000
NODE_1044_length_2306_cov_17.347984	995	1075	0	10	80	0.1250000
NODE_1044_length_2306_cov_17.347984	995	1075	2	41	80	0.5125000
NODE_1044_length_2306_cov_17.347984	995	1075	4	29	80	0.3625000
NODE_1044_length_2306_cov_17.347984	1048	1128	0	5	80	0.0625000
NODE_1044_length_2306_cov_17.347984	1048	1128	2	12	80	0.1500000
NODE_1044_length_2306_cov_17.347984	1048	1128	4	63	80	0.7875000
NODE_1052_length_2300_cov_9.803271	934	1014	0	14	80	0.1750000
NODE_1052_length_2300_cov_9.803271	934	1014	4	66	80	0.8250000
NODE_1052_length_2300_cov_9.803271	1892	1965	0	13	73	0.1780822
NODE_1052_length_2300_cov_9.803271	1892	1965	1	2	73	0.0273973
NODE_1052_length_2300_cov_9.803271	1892	1965	2	58	73	0.7945206
NODE_1059_length_2289_cov_17.807306	968	1026	310	2	58	0.0344828
NODE_1059_length_2289_cov_17.807306	968	1026	311	1	58	0.0172414
NODE_1059_length_2289_cov_17.807306	968	1026	312	2	58	0.0344828
NODE_1059_length_2289_cov_17.807306	968	1026	313	1	58	0.0172414
NODE_1059_length_2289_cov_17.807306	968	1026	314	1	58	0.0172414
NODE_1059_length_2289_cov_17.807306	968	1026	315	3	58	0.0517241
NODE_1059_length_2289_cov_17.807306	968	1026	316	2	58	0.0344828
NODE_1059_length_2289_cov_17.807306	968	1026	317	1	58	0.0172414
NODE_1059_length_2289_cov_17.807306	968	1026	318	2	58	0.0344828
NODE_1059_length_2289_cov_17.807306	968	1026	319	3	58	0.0517241
NODE_1059_length_2289_cov_17.807306	968	1026	320	2	58	0.0344828
NODE_1059_length_2289_cov_17.807306	968	1026	321	1	58	0.0172414
NODE_1059_length_2289_cov_17.807306	968	1026	324	1	58	0.0172414
NODE_1059_length_2289_cov_17.807306	968	1026	326	1	58	0.0172414
NODE_1059_length_2289_cov_17.807306	968	1026	329	1	58	0.0172414
NODE_1059_length_2289_cov_17.807306	968	1026	330	3	58	0.0517241
NODE_1059_length_2289_cov_17.807306	968	1026	331	4	58	0.0689655
NODE_1059_length_2289_cov_17.807306	968	1026	332	5	58	0.0862069
NODE_1059_length_2289_cov_17.807306	968	1026	337	1	58	0.0172414
NODE_1059_length_2289_cov_17.807306	968	1026	338	1	58	0.0172414
NODE_1059_length_2289_cov_17.807306	968	1026	339	1	58	0.0172414
NODE_1059_length_2289_cov_17.807306	968	1026	341	1	58	0.0172414
NODE_1059_length_2289_cov_17.807306	968	1026	343	1	58	0.0172414
NODE_1059_length_2289_cov_17.807306	968	1026	345	1	58	0.0172414
NODE_1059_length_2289_cov_17.807306	968	1026	355	1	58	0.0172414
NODE_1059_length_2289_cov_17.807306	968	1026	357	4	58	0.0689655
NODE_1059_length_2289_cov_17.807306	968	1026	358	1	58	0.0172414
NODE_1059_length_2289_cov_17.807306	968	1026	359	1	58	0.0172414
NODE_1059_length_2289_cov_17.807306	968	1026	360	3	58	0.0517241
NODE_1059_length_2289_cov_17.807306	968	1026	362	1	58	0.0172414
NODE_1059_length_2289_cov_17.807306	968	1026	364	3	58	0.0517241
NODE_1059_length_2289_cov_17.807306	968	1026	365	1	58	0.0172414
NODE_1059_length_2289_cov_17.807306	968	1026	367	1	58	0.0172414
NODE_1059_length_2289_cov_17.807306	1021	1079	223	1	58	0.0172414
NODE_1059_length_2289_cov_17.807306	1021	1079	225	1	58	0.0172414
NODE_1059_length_2289_cov_17.807306	1021	1079	233	1	58	0.0172414
NODE_1059_length_2289_cov_17.807306	1021	1079	237	1	58	0.0172414
NODE_1059_length_2289_cov_17.807306	1021	1079	241	1	58	0.0172414
NODE_1059_length_2289_cov_17.807306	1021	1079	244	1	58	0.0172414
NODE_1059_length_2289_cov_17.807306	1021	1079	245	2	58	0.0344828
NODE_1059_length_2289_cov_17.807306	1021	1079	246	3	58	0.0517241
NODE_1059_length_2289_cov_17.807306	1021	1079	248	2	58	0.0344828
NODE_1059_length_2289_cov_17.807306	1021	1079	249	4	58	0.0689655
NODE_1059_length_2289_cov_17.807306	1021	1079	250	2	58	0.0344828
NODE_1059_length_2289_cov_17.807306	1021	1079	252	2	58	0.0344828
NODE_1059_length_2289_cov_17.807306	1021	1079	253	2	58	0.0344828
NODE_1059_length_2289_cov_17.807306	1021	1079	254	1	58	0.0172414
NODE_1059_length_2289_cov_17.807306	1021	1079	255	1	58	0.0172414
NODE_1059_length_2289_cov_17.807306	1021	1079	257	1	58	0.0172414
NODE_1059_length_2289_cov_17.807306	1021	1079	258	1	58	0.0172414
NODE_1059_length_2289_cov_17.807306	1021	1079	259	1	58	0.0172414
NODE_1059_length_2289_cov_17.807306	1021	1079	260	1	58	0.0172414
NODE_1059_length_2289_cov_17.807306	1021	1079	261	1	58	0.0172414
NODE_1059_length_2289_cov_17.807306	1021	1079	268	1	58	0.0172414
NODE_1059_length_2289_cov_17.807306	1021	1079	270	1	58	0.0172414
NODE_1059_length_2289_cov_17.807306	1021	1079	279	1	58	0.0172414
NODE_1059_length_2289_cov_17.807306	1021	1079	283	1	58	0.0172414
NODE_1059_length_2289_cov_17.807306	1021	1079	287	1	58	0.0172414
NODE_1059_length_2289_cov_17.807306	1021	1079	289	3	58	0.0517241
NODE_1059_length_2289_cov_17.807306	1021	1079	290	1	58	0.0172414
NODE_1059_length_2289_cov_17.807306	1021	1079	293	4	58	0.0689655
NODE_1059_length_2289_cov_17.807306	1021	1079	294	2	58	0.0344828
NODE_1059_length_2289_cov_17.807306	1021	1079	295	1	58	0.0172414
NODE_1059_length_2289_cov_17.807306	1021	1079	296	2	58	0.0344828
NODE_1059_length_2289_cov_17.807306	1021	1079	298	2	58	0.0344828
NODE_1059_length_2289_cov_17.807306	1021	1079	302	1	58	0.0172414
NODE_1059_length_2289_cov_17.807306	1021	1079	310	3	58	0.0517241
NODE_1059_length_2289_cov_17.807306	1021	1079	311	1	58	0.0172414
NODE_1059_length_2289_cov_17.807306	1021	1079	312	2	58	0.0344828
NODE_1059_length_2289_cov_17.807306	1021	1079	313	1	58	0.0172414
NODE_1060_length_2289_cov_7.736986	2161	2218	127	1	57	0.0175439
NODE_1060_length_2289_cov_7.736986	2161	2218	140	1	57	0.0175439
NODE_1060_length_2289_cov_7.736986	2161	2218	168	1	57	0.0175439
NODE_1060_length_2289_cov_7.736986	2161	2218	175	1	57	0.0175439
NODE_1060_length_2289_cov_7.736986	2161	2218	183	1	57	0.0175439
NODE_1060_length_2289_cov_7.736986	2161	2218	201	1	57	0.0175439
NODE_1060_length_2289_cov_7.736986	2161	2218	204	1	57	0.0175439
NODE_1060_length_2289_cov_7.736986	2161	2218	214	1	57	0.0175439
NODE_1060_length_2289_cov_7.736986	2161	2218	216	1	57	0.0175439
NODE_1060_length_2289_cov_7.736986	2161	2218	220	2	57	0.0350877
NODE_1060_length_2289_cov_7.736986	2161	2218	224	1	57	0.0175439
NODE_1060_length_2289_cov_7.736986	2161	2218	236	1	57	0.0175439
NODE_1060_length_2289_cov_7.736986	2161	2218	248	1	57	0.0175439
NODE_1060_length_2289_cov_7.736986	2161	2218	250	1	57	0.0175439
NODE_1060_length_2289_cov_7.736986	2161	2218	252	1	57	0.0175439
NODE_1060_length_2289_cov_7.736986	2161	2218	254	2	57	0.0350877
NODE_1060_length_2289_cov_7.736986	2161	2218	258	1	57	0.0175439
NODE_1060_length_2289_cov_7.736986	2161	2218	266	1	57	0.0175439
NODE_1060_length_2289_cov_7.736986	2161	2218	288	1	57	0.0175439
NODE_1060_length_2289_cov_7.736986	2161	2218	294	1	57	0.0175439
NODE_1060_length_2289_cov_7.736986	2161	2218	296	1	57	0.0175439
NODE_1060_length_2289_cov_7.736986	2161	2218	300	2	57	0.0350877
NODE_1060_length_2289_cov_7.736986	2161	2218	308	32	57	0.5614035
NODE_1060_length_2289_cov_7.736986	2191	2271	203	1	80	0.0125000
NODE_1060_length_2289_cov_7.736986	2191	2271	205	1	80	0.0125000
NODE_1060_length_2289_cov_7.736986	2191	2271	207	1	80	0.0125000
NODE_1060_length_2289_cov_7.736986	2191	2271	221	1	80	0.0125000
NODE_1060_length_2289_cov_7.736986	2191	2271	223	1	80	0.0125000
NODE_1060_length_2289_cov_7.736986	2191	2271	231	1	80	0.0125000
NODE_1060_length_2289_cov_7.736986	2191	2271	233	1	80	0.0125000
NODE_1060_length_2289_cov_7.736986	2191	2271	243	1	80	0.0125000
NODE_1060_length_2289_cov_7.736986	2191	2271	252	1	80	0.0125000
NODE_1060_length_2289_cov_7.736986	2191	2271	259	1	80	0.0125000
NODE_1060_length_2289_cov_7.736986	2191	2271	263	1	80	0.0125000
NODE_1060_length_2289_cov_7.736986	2191	2271	272	1	80	0.0125000
NODE_1060_length_2289_cov_7.736986	2191	2271	277	1	80	0.0125000
NODE_1060_length_2289_cov_7.736986	2191	2271	280	1	80	0.0125000
NODE_1060_length_2289_cov_7.736986	2191	2271	298	1	80	0.0125000
NODE_1060_length_2289_cov_7.736986	2191	2271	299	1	80	0.0125000
NODE_1060_length_2289_cov_7.736986	2191	2271	303	1	80	0.0125000
NODE_1060_length_2289_cov_7.736986	2191	2271	305	1	80	0.0125000
NODE_1060_length_2289_cov_7.736986	2191	2271	307	4	80	0.0500000
NODE_1060_length_2289_cov_7.736986	2191	2271	308	58	80	0.7250000
NODE_1061_length_2288_cov_8.539973	340	420	0	23	80	0.2875000
NODE_1061_length_2288_cov_8.539973	340	420	2	10	80	0.1250000
NODE_1061_length_2288_cov_8.539973	340	420	4	18	80	0.2250000
NODE_1061_length_2288_cov_8.539973	340	420	6	2	80	0.0250000
NODE_1061_length_2288_cov_8.539973	340	420	27	3	80	0.0375000
NODE_1061_length_2288_cov_8.539973	340	420	28	4	80	0.0500000
NODE_1061_length_2288_cov_8.539973	340	420	34	1	80	0.0125000
NODE_1061_length_2288_cov_8.539973	340	420	35	13	80	0.1625000
NODE_1061_length_2288_cov_8.539973	340	420	38	2	80	0.0250000
NODE_1061_length_2288_cov_8.539973	340	420	40	3	80	0.0375000
NODE_1061_length_2288_cov_8.539973	340	420	42	1	80	0.0125000
NODE_1061_length_2288_cov_8.539973	393	473	0	2	80	0.0250000
NODE_1061_length_2288_cov_8.539973	393	473	2	32	80	0.4000000
NODE_1061_length_2288_cov_8.539973	393	473	4	46	80	0.5750000
NODE_1065_length_2278_cov_19.655805	450	530	2	21	80	0.2625000
NODE_1065_length_2278_cov_19.655805	450	530	4	45	80	0.5625000
NODE_1065_length_2278_cov_19.655805	450	530	5	2	80	0.0250000
NODE_1065_length_2278_cov_19.655805	450	530	6	12	80	0.1500000
NODE_1065_length_2278_cov_19.655805	503	583	0	20	80	0.2500000
NODE_1065_length_2278_cov_19.655805	503	583	2	4	80	0.0500000
NODE_1065_length_2278_cov_19.655805	503	583	4	56	80	0.7000000
NODE_1065_length_2278_cov_19.655805	579	659	0	10	80	0.1250000
NODE_1065_length_2278_cov_19.655805	579	659	2	70	80	0.8750000
NODE_1065_length_2278_cov_19.655805	632	712	0	61	80	0.7625000
NODE_1065_length_2278_cov_19.655805	632	712	2	19	80	0.2375000
NODE_1071_length_2272_cov_26.123792	226	306	0	80	80	1.0000000
NODE_1071_length_2272_cov_26.123792	279	359	0	80	80	1.0000000
NODE_1071_length_2272_cov_26.123792	1684	1731	31	1	47	0.0212766
NODE_1071_length_2272_cov_26.123792	1684	1731	35	1	47	0.0212766
NODE_1071_length_2272_cov_26.123792	1684	1731	48	1	47	0.0212766
NODE_1071_length_2272_cov_26.123792	1684	1731	69	1	47	0.0212766
NODE_1071_length_2272_cov_26.123792	1684	1731	80	1	47	0.0212766
NODE_1071_length_2272_cov_26.123792	1684	1731	93	1	47	0.0212766
NODE_1071_length_2272_cov_26.123792	1684	1731	95	1	47	0.0212766
NODE_1071_length_2272_cov_26.123792	1684	1731	96	1	47	0.0212766
NODE_1071_length_2272_cov_26.123792	1684	1731	104	1	47	0.0212766
NODE_1071_length_2272_cov_26.123792	1684	1731	112	1	47	0.0212766
NODE_1071_length_2272_cov_26.123792	1684	1731	120	2	47	0.0425532
NODE_1071_length_2272_cov_26.123792	1684	1731	121	2	47	0.0425532
NODE_1071_length_2272_cov_26.123792	1684	1731	125	1	47	0.0212766
NODE_1071_length_2272_cov_26.123792	1684	1731	127	1	47	0.0212766
NODE_1071_length_2272_cov_26.123792	1684	1731	135	1	47	0.0212766
NODE_1071_length_2272_cov_26.123792	1684	1731	138	1	47	0.0212766
NODE_1071_length_2272_cov_26.123792	1684	1731	141	3	47	0.0638298
NODE_1071_length_2272_cov_26.123792	1684	1731	145	1	47	0.0212766
NODE_1071_length_2272_cov_26.123792	1684	1731	151	3	47	0.0638298
NODE_1071_length_2272_cov_26.123792	1684	1731	156	1	47	0.0212766
NODE_1071_length_2272_cov_26.123792	1684	1731	157	2	47	0.0425532
NODE_1071_length_2272_cov_26.123792	1684	1731	162	1	47	0.0212766
NODE_1071_length_2272_cov_26.123792	1684	1731	169	1	47	0.0212766
NODE_1071_length_2272_cov_26.123792	1684	1731	173	1	47	0.0212766
NODE_1071_length_2272_cov_26.123792	1684	1731	181	2	47	0.0425532
NODE_1071_length_2272_cov_26.123792	1684	1731	185	1	47	0.0212766
NODE_1071_length_2272_cov_26.123792	1684	1731	190	1	47	0.0212766
NODE_1071_length_2272_cov_26.123792	1684	1731	199	1	47	0.0212766
NODE_1071_length_2272_cov_26.123792	1684	1731	201	1	47	0.0212766
NODE_1071_length_2272_cov_26.123792	1684	1731	206	1	47	0.0212766
NODE_1071_length_2272_cov_26.123792	1684	1731	209	1	47	0.0212766
NODE_1071_length_2272_cov_26.123792	1684	1731	217	1	47	0.0212766
NODE_1071_length_2272_cov_26.123792	1684	1731	219	1	47	0.0212766
NODE_1071_length_2272_cov_26.123792	1684	1731	224	1	47	0.0212766
NODE_1071_length_2272_cov_26.123792	1684	1731	229	1	47	0.0212766
NODE_1071_length_2272_cov_26.123792	1684	1731	233	1	47	0.0212766
NODE_1071_length_2272_cov_26.123792	1684	1731	237	1	47	0.0212766
NODE_1071_length_2272_cov_26.123792	1684	1731	244	1	47	0.0212766
NODE_1071_length_2272_cov_26.123792	1684	1731	249	1	47	0.0212766
NODE_1071_length_2272_cov_26.123792	1694	1725	95	1	31	0.0322581
NODE_1071_length_2272_cov_26.123792	1694	1725	96	1	31	0.0322581
NODE_1071_length_2272_cov_26.123792	1694	1725	104	1	31	0.0322581
NODE_1071_length_2272_cov_26.123792	1694	1725	112	1	31	0.0322581
NODE_1071_length_2272_cov_26.123792	1694	1725	120	2	31	0.0645161
NODE_1071_length_2272_cov_26.123792	1694	1725	121	2	31	0.0645161
NODE_1071_length_2272_cov_26.123792	1694	1725	125	1	31	0.0322581
NODE_1071_length_2272_cov_26.123792	1694	1725	127	1	31	0.0322581
NODE_1071_length_2272_cov_26.123792	1694	1725	135	1	31	0.0322581
NODE_1071_length_2272_cov_26.123792	1694	1725	138	1	31	0.0322581
NODE_1071_length_2272_cov_26.123792	1694	1725	141	3	31	0.0967742
NODE_1071_length_2272_cov_26.123792	1694	1725	145	1	31	0.0322581
NODE_1071_length_2272_cov_26.123792	1694	1725	151	3	31	0.0967742
NODE_1071_length_2272_cov_26.123792	1694	1725	156	1	31	0.0322581
NODE_1071_length_2272_cov_26.123792	1694	1725	157	2	31	0.0645161
NODE_1071_length_2272_cov_26.123792	1694	1725	162	1	31	0.0322581
NODE_1071_length_2272_cov_26.123792	1694	1725	169	1	31	0.0322581
NODE_1071_length_2272_cov_26.123792	1694	1725	173	1	31	0.0322581
NODE_1071_length_2272_cov_26.123792	1694	1725	181	2	31	0.0645161
NODE_1071_length_2272_cov_26.123792	1694	1725	185	1	31	0.0322581
NODE_1071_length_2272_cov_26.123792	1694	1725	190	1	31	0.0322581
NODE_1071_length_2272_cov_26.123792	1694	1725	199	1	31	0.0322581
NODE_1071_length_2272_cov_26.123792	1694	1725	201	1	31	0.0322581
NODE_1071_length_2272_cov_26.123792	1759	1833	0	33	74	0.4459459
NODE_1071_length_2272_cov_26.123792	1759	1833	2	7	74	0.0945946
NODE_1071_length_2272_cov_26.123792	1759	1833	6	34	74	0.4594595
NODE_1071_length_2272_cov_26.123792	1812	1892	0	80	80	1.0000000
NODE_1072_length_2272_cov_8.175334	213	293	167	1	80	0.0125000
NODE_1072_length_2272_cov_8.175334	213	293	169	1	80	0.0125000
NODE_1072_length_2272_cov_8.175334	213	293	170	1	80	0.0125000
NODE_1072_length_2272_cov_8.175334	213	293	172	1	80	0.0125000
NODE_1072_length_2272_cov_8.175334	213	293	173	1	80	0.0125000
NODE_1072_length_2272_cov_8.175334	213	293	176	1	80	0.0125000
NODE_1072_length_2272_cov_8.175334	213	293	182	1	80	0.0125000
NODE_1072_length_2272_cov_8.175334	213	293	183	2	80	0.0250000
NODE_1072_length_2272_cov_8.175334	213	293	184	2	80	0.0250000
NODE_1072_length_2272_cov_8.175334	213	293	188	1	80	0.0125000
NODE_1072_length_2272_cov_8.175334	213	293	190	5	80	0.0625000
NODE_1072_length_2272_cov_8.175334	213	293	195	2	80	0.0250000
NODE_1072_length_2272_cov_8.175334	213	293	197	1	80	0.0125000
NODE_1072_length_2272_cov_8.175334	213	293	198	1	80	0.0125000
NODE_1072_length_2272_cov_8.175334	213	293	200	2	80	0.0250000
NODE_1072_length_2272_cov_8.175334	213	293	204	5	80	0.0625000
NODE_1072_length_2272_cov_8.175334	213	293	206	1	80	0.0125000
NODE_1072_length_2272_cov_8.175334	213	293	208	2	80	0.0250000
NODE_1072_length_2272_cov_8.175334	213	293	209	1	80	0.0125000
NODE_1072_length_2272_cov_8.175334	213	293	210	1	80	0.0125000
NODE_1072_length_2272_cov_8.175334	213	293	212	1	80	0.0125000
NODE_1072_length_2272_cov_8.175334	213	293	215	1	80	0.0125000
NODE_1072_length_2272_cov_8.175334	213	293	218	3	80	0.0375000
NODE_1072_length_2272_cov_8.175334	213	293	220	6	80	0.0750000
NODE_1072_length_2272_cov_8.175334	213	293	222	4	80	0.0500000
NODE_1072_length_2272_cov_8.175334	213	293	224	6	80	0.0750000
NODE_1072_length_2272_cov_8.175334	213	293	226	4	80	0.0500000
NODE_1072_length_2272_cov_8.175334	213	293	228	2	80	0.0250000
NODE_1072_length_2272_cov_8.175334	213	293	230	2	80	0.0250000
NODE_1072_length_2272_cov_8.175334	213	293	232	1	80	0.0125000
NODE_1072_length_2272_cov_8.175334	213	293	233	1	80	0.0125000
NODE_1072_length_2272_cov_8.175334	213	293	237	2	80	0.0250000
NODE_1072_length_2272_cov_8.175334	213	293	238	6	80	0.0750000
NODE_1072_length_2272_cov_8.175334	213	293	239	1	80	0.0125000
NODE_1072_length_2272_cov_8.175334	213	293	240	1	80	0.0125000
NODE_1072_length_2272_cov_8.175334	213	293	241	1	80	0.0125000
NODE_1072_length_2272_cov_8.175334	213	293	244	4	80	0.0500000
NODE_1072_length_2272_cov_8.175334	213	293	246	1	80	0.0125000
NODE_1072_length_2272_cov_8.175334	266	346	2	1	80	0.0125000
NODE_1072_length_2272_cov_8.175334	266	346	26	1	80	0.0125000
NODE_1072_length_2272_cov_8.175334	266	346	58	2	80	0.0250000
NODE_1072_length_2272_cov_8.175334	266	346	69	1	80	0.0125000
NODE_1072_length_2272_cov_8.175334	266	346	72	3	80	0.0375000
NODE_1072_length_2272_cov_8.175334	266	346	74	2	80	0.0250000
NODE_1072_length_2272_cov_8.175334	266	346	76	1	80	0.0125000
NODE_1072_length_2272_cov_8.175334	266	346	78	1	80	0.0125000
NODE_1072_length_2272_cov_8.175334	266	346	79	1	80	0.0125000
NODE_1072_length_2272_cov_8.175334	266	346	85	1	80	0.0125000
NODE_1072_length_2272_cov_8.175334	266	346	96	1	80	0.0125000
NODE_1072_length_2272_cov_8.175334	266	346	98	1	80	0.0125000
NODE_1072_length_2272_cov_8.175334	266	346	100	3	80	0.0375000
NODE_1072_length_2272_cov_8.175334	266	346	102	1	80	0.0125000
NODE_1072_length_2272_cov_8.175334	266	346	104	1	80	0.0125000
NODE_1072_length_2272_cov_8.175334	266	346	108	3	80	0.0375000
NODE_1072_length_2272_cov_8.175334	266	346	113	1	80	0.0125000
NODE_1072_length_2272_cov_8.175334	266	346	116	1	80	0.0125000
NODE_1072_length_2272_cov_8.175334	266	346	118	7	80	0.0875000
NODE_1072_length_2272_cov_8.175334	266	346	122	1	80	0.0125000
NODE_1072_length_2272_cov_8.175334	266	346	128	1	80	0.0125000
NODE_1072_length_2272_cov_8.175334	266	346	130	1	80	0.0125000
NODE_1072_length_2272_cov_8.175334	266	346	140	1	80	0.0125000
NODE_1072_length_2272_cov_8.175334	266	346	144	2	80	0.0250000
NODE_1072_length_2272_cov_8.175334	266	346	152	5	80	0.0625000
NODE_1072_length_2272_cov_8.175334	266	346	155	2	80	0.0250000
NODE_1072_length_2272_cov_8.175334	266	346	170	2	80	0.0250000
NODE_1072_length_2272_cov_8.175334	266	346	171	1	80	0.0125000
NODE_1072_length_2272_cov_8.175334	266	346	173	1	80	0.0125000
NODE_1072_length_2272_cov_8.175334	266	346	175	1	80	0.0125000
NODE_1072_length_2272_cov_8.175334	266	346	176	1	80	0.0125000
NODE_1072_length_2272_cov_8.175334	266	346	182	2	80	0.0250000
NODE_1072_length_2272_cov_8.175334	266	346	183	2	80	0.0250000
NODE_1072_length_2272_cov_8.175334	266	346	184	2	80	0.0250000
NODE_1072_length_2272_cov_8.175334	266	346	188	1	80	0.0125000
NODE_1072_length_2272_cov_8.175334	266	346	190	5	80	0.0625000
NODE_1072_length_2272_cov_8.175334	266	346	197	1	80	0.0125000
NODE_1072_length_2272_cov_8.175334	266	346	200	2	80	0.0250000
NODE_1072_length_2272_cov_8.175334	266	346	204	5	80	0.0625000
NODE_1072_length_2272_cov_8.175334	266	346	206	1	80	0.0125000
NODE_1072_length_2272_cov_8.175334	266	346	208	1	80	0.0125000
NODE_1072_length_2272_cov_8.175334	266	346	212	1	80	0.0125000
NODE_1072_length_2272_cov_8.175334	266	346	218	1	80	0.0125000
NODE_1072_length_2272_cov_8.175334	266	346	220	2	80	0.0250000
NODE_1072_length_2272_cov_8.175334	266	346	222	2	80	0.0250000
NODE_1077_length_2266_cov_13.206276	359	439	6	78	80	0.9750000
NODE_1077_length_2266_cov_13.206276	359	439	7	2	80	0.0250000
NODE_1077_length_2266_cov_13.206276	412	492	0	12	80	0.1500000
NODE_1077_length_2266_cov_13.206276	412	492	2	20	80	0.2500000
NODE_1077_length_2266_cov_13.206276	412	492	4	5	80	0.0625000
NODE_1077_length_2266_cov_13.206276	412	492	6	29	80	0.3625000
NODE_1077_length_2266_cov_13.206276	412	492	10	14	80	0.1750000
NODE_1077_length_2266_cov_13.206276	488	568	6	13	80	0.1625000
NODE_1077_length_2266_cov_13.206276	488	568	8	13	80	0.1625000
NODE_1077_length_2266_cov_13.206276	488	568	10	54	80	0.6750000
NODE_1077_length_2266_cov_13.206276	541	627	2	25	86	0.2906977
NODE_1077_length_2266_cov_13.206276	541	627	4	19	86	0.2209302
NODE_1077_length_2266_cov_13.206276	541	627	6	23	86	0.2674419
NODE_1077_length_2266_cov_13.206276	541	627	8	18	86	0.2093023
NODE_1077_length_2266_cov_13.206276	541	627	10	1	86	0.0116279
NODE_1078_length_2262_cov_11.759131	413	493	0	80	80	1.0000000
NODE_1078_length_2262_cov_11.759131	466	546	0	80	80	1.0000000
NODE_1079_length_2260_cov_37.814901	219	299	2	10	80	0.1250000
NODE_1079_length_2260_cov_37.814901	219	299	6	70	80	0.8750000
NODE_1079_length_2260_cov_37.814901	742	822	2	80	80	1.0000000
NODE_1079_length_2260_cov_37.814901	795	875	0	29	80	0.3625000
NODE_1079_length_2260_cov_37.814901	795	875	2	51	80	0.6375000
NODE_1079_length_2260_cov_37.814901	1533	1613	13	5	80	0.0625000
NODE_1079_length_2260_cov_37.814901	1533	1613	17	4	80	0.0500000
NODE_1079_length_2260_cov_37.814901	1533	1613	22	11	80	0.1375000
NODE_1079_length_2260_cov_37.814901	1533	1613	26	4	80	0.0500000
NODE_1079_length_2260_cov_37.814901	1533	1613	29	1	80	0.0125000
NODE_1079_length_2260_cov_37.814901	1533	1613	30	55	80	0.6875000
NODE_1079_length_2260_cov_37.814901	1586	1666	0	27	80	0.3375000
NODE_1079_length_2260_cov_37.814901	1586	1666	4	20	80	0.2500000
NODE_1079_length_2260_cov_37.814901	1586	1666	11	1	80	0.0125000
NODE_1079_length_2260_cov_37.814901	1586	1666	12	2	80	0.0250000
NODE_1079_length_2260_cov_37.814901	1586	1666	13	8	80	0.1000000
NODE_1079_length_2260_cov_37.814901	1586	1666	17	4	80	0.0500000
NODE_1079_length_2260_cov_37.814901	1586	1666	29	1	80	0.0125000
NODE_1079_length_2260_cov_37.814901	1586	1666	30	17	80	0.2125000
NODE_1079_length_2260_cov_37.814901	1662	1742	0	33	80	0.4125000
NODE_1079_length_2260_cov_37.814901	1662	1742	2	19	80	0.2375000
NODE_1079_length_2260_cov_37.814901	1662	1742	4	28	80	0.3500000
NODE_1079_length_2260_cov_37.814901	1715	1795	2	14	80	0.1750000
NODE_1079_length_2260_cov_37.814901	1715	1795	4	66	80	0.8250000
NODE_1082_length_2253_cov_8.904828	472	552	10	15	80	0.1875000
NODE_1082_length_2253_cov_8.904828	472	552	11	1	80	0.0125000
NODE_1082_length_2253_cov_8.904828	472	552	12	1	80	0.0125000
NODE_1082_length_2253_cov_8.904828	472	552	14	14	80	0.1750000
NODE_1082_length_2253_cov_8.904828	472	552	19	7	80	0.0875000
NODE_1082_length_2253_cov_8.904828	472	552	21	5	80	0.0625000
NODE_1082_length_2253_cov_8.904828	472	552	23	5	80	0.0625000
NODE_1082_length_2253_cov_8.904828	472	552	25	3	80	0.0375000
NODE_1082_length_2253_cov_8.904828	472	552	29	1	80	0.0125000
NODE_1082_length_2253_cov_8.904828	472	552	33	4	80	0.0500000
NODE_1082_length_2253_cov_8.904828	472	552	36	2	80	0.0250000
NODE_1082_length_2253_cov_8.904828	472	552	46	1	80	0.0125000
NODE_1082_length_2253_cov_8.904828	472	552	52	1	80	0.0125000
NODE_1082_length_2253_cov_8.904828	472	552	53	2	80	0.0250000
NODE_1082_length_2253_cov_8.904828	472	552	56	1	80	0.0125000
NODE_1082_length_2253_cov_8.904828	472	552	58	3	80	0.0375000
NODE_1082_length_2253_cov_8.904828	472	552	62	4	80	0.0500000
NODE_1082_length_2253_cov_8.904828	472	552	63	3	80	0.0375000
NODE_1082_length_2253_cov_8.904828	472	552	65	1	80	0.0125000
NODE_1082_length_2253_cov_8.904828	472	552	68	1	80	0.0125000
NODE_1082_length_2253_cov_8.904828	472	552	70	1	80	0.0125000
NODE_1082_length_2253_cov_8.904828	472	552	78	2	80	0.0250000
NODE_1082_length_2253_cov_8.904828	472	552	80	2	80	0.0250000
NODE_1085_length_2252_cov_2.801208	1128	1170	0	42	42	1.0000000
NODE_1085_length_2252_cov_2.801208	1137	1172	0	33	35	0.9428571
NODE_1085_length_2252_cov_2.801208	1137	1172	2	2	35	0.0571429
NODE_1086_length_2252_cov_2.078031	13	62	0	49	49	1.0000000
NODE_1086_length_2252_cov_2.078031	13	61	0	48	48	1.0000000
NODE_1086_length_2252_cov_2.078031	13	62	0	49	49	1.0000000
NODE_1086_length_2252_cov_2.078031	13	62	0	49	49	1.0000000
NODE_1086_length_2252_cov_2.078031	13	61	0	48	48	1.0000000
NODE_1087_length_2251_cov_15.458178	1443	1506	4	43	63	0.6825397
NODE_1087_length_2251_cov_15.458178	1443	1506	5	16	63	0.2539683
NODE_1087_length_2251_cov_15.458178	1443	1506	6	1	63	0.0158730
NODE_1087_length_2251_cov_15.458178	1443	1506	8	2	63	0.0317460
NODE_1087_length_2251_cov_15.458178	1443	1506	16	1	63	0.0158730
NODE_1087_length_2251_cov_15.458178	1496	1550	5	10	54	0.1851852
NODE_1087_length_2251_cov_15.458178	1496	1550	6	1	54	0.0185185
NODE_1087_length_2251_cov_15.458178	1496	1550	7	7	54	0.1296296
NODE_1087_length_2251_cov_15.458178	1496	1550	8	5	54	0.0925926
NODE_1087_length_2251_cov_15.458178	1496	1550	10	4	54	0.0740741
NODE_1087_length_2251_cov_15.458178	1496	1550	12	1	54	0.0185185
NODE_1087_length_2251_cov_15.458178	1496	1550	16	1	54	0.0185185
NODE_1087_length_2251_cov_15.458178	1496	1550	18	6	54	0.1111111
NODE_1087_length_2251_cov_15.458178	1496	1550	20	11	54	0.2037037
NODE_1087_length_2251_cov_15.458178	1496	1550	22	2	54	0.0370370
NODE_1087_length_2251_cov_15.458178	1496	1550	24	5	54	0.0925926
NODE_1087_length_2251_cov_15.458178	1496	1550	25	1	54	0.0185185
NODE_1089_length_2250_cov_18.370990	1658	1738	0	80	80	1.0000000
NODE_1089_length_2250_cov_18.370990	1711	1791	0	80	80	1.0000000
NODE_1090_length_2250_cov_5.331474	1844	1924	0	37	80	0.4625000
NODE_1090_length_2250_cov_5.331474	1844	1924	2	43	80	0.5375000
NODE_1093_length_2247_cov_7.906890	364	436	27	5	72	0.0694444
NODE_1093_length_2247_cov_7.906890	364	436	29	27	72	0.3750000
NODE_1093_length_2247_cov_7.906890	364	436	30	5	72	0.0694444
NODE_1093_length_2247_cov_7.906890	364	436	31	25	72	0.3472222
NODE_1093_length_2247_cov_7.906890	364	436	32	4	72	0.0555556
NODE_1093_length_2247_cov_7.906890	364	436	33	6	72	0.0833333
NODE_1095_length_2246_cov_7.612948	1992	2055	0	18	63	0.2857143
NODE_1095_length_2246_cov_7.612948	1992	2055	2	41	63	0.6507937
NODE_1095_length_2246_cov_7.612948	1992	2055	3	1	63	0.0158730
NODE_1095_length_2246_cov_7.612948	1992	2055	7	3	63	0.0476190
NODE_1095_length_2246_cov_7.612948	2045	2108	2	26	63	0.4126984
NODE_1095_length_2246_cov_7.612948	2045	2108	6	23	63	0.3650794
NODE_1095_length_2246_cov_7.612948	2045	2108	8	14	63	0.2222222
NODE_1104_length_2233_cov_35.127460	1517	1597	1	50	80	0.6250000
NODE_1104_length_2233_cov_35.127460	1517	1597	2	3	80	0.0375000
NODE_1104_length_2233_cov_35.127460	1517	1597	3	27	80	0.3375000
NODE_1104_length_2233_cov_35.127460	1570	1650	2	47	80	0.5875000
NODE_1104_length_2233_cov_35.127460	1570	1650	3	24	80	0.3000000
NODE_1104_length_2233_cov_35.127460	1570	1650	4	9	80	0.1125000
NODE_1105_length_2231_cov_45.701689	315	396	17	10	81	0.1234568
NODE_1105_length_2231_cov_45.701689	315	396	19	1	81	0.0123457
NODE_1105_length_2231_cov_45.701689	315	396	21	1	81	0.0123457
NODE_1105_length_2231_cov_45.701689	315	396	22	2	81	0.0246914
NODE_1105_length_2231_cov_45.701689	315	396	24	4	81	0.0493827
NODE_1105_length_2231_cov_45.701689	315	396	26	7	81	0.0864198
NODE_1105_length_2231_cov_45.701689	315	396	28	4	81	0.0493827
NODE_1105_length_2231_cov_45.701689	315	396	30	16	81	0.1975309
NODE_1105_length_2231_cov_45.701689	315	396	32	10	81	0.1234568
NODE_1105_length_2231_cov_45.701689	315	396	33	1	81	0.0123457
NODE_1105_length_2231_cov_45.701689	315	396	35	1	81	0.0123457
NODE_1105_length_2231_cov_45.701689	315	396	36	13	81	0.1604938
NODE_1105_length_2231_cov_45.701689	315	396	37	4	81	0.0493827
NODE_1105_length_2231_cov_45.701689	315	396	38	3	81	0.0370370
NODE_1105_length_2231_cov_45.701689	315	396	39	4	81	0.0493827
NODE_1105_length_2231_cov_45.701689	369	449	0	27	80	0.3375000
NODE_1105_length_2231_cov_45.701689	369	449	2	17	80	0.2125000
NODE_1105_length_2231_cov_45.701689	369	449	4	2	80	0.0250000
NODE_1105_length_2231_cov_45.701689	369	449	9	1	80	0.0125000
NODE_1105_length_2231_cov_45.701689	369	449	11	3	80	0.0375000
NODE_1105_length_2231_cov_45.701689	369	449	15	1	80	0.0125000
NODE_1105_length_2231_cov_45.701689	369	449	17	12	80	0.1500000
NODE_1105_length_2231_cov_45.701689	369	449	19	1	80	0.0125000
NODE_1105_length_2231_cov_45.701689	369	449	21	1	80	0.0125000
NODE_1105_length_2231_cov_45.701689	369	449	22	2	80	0.0250000
NODE_1105_length_2231_cov_45.701689	369	449	24	4	80	0.0500000
NODE_1105_length_2231_cov_45.701689	369	449	26	7	80	0.0875000
NODE_1105_length_2231_cov_45.701689	369	449	28	2	80	0.0250000
NODE_1105_length_2231_cov_45.701689	496	576	0	80	80	1.0000000
NODE_1105_length_2231_cov_45.701689	582	662	0	80	80	1.0000000
NODE_1105_length_2231_cov_45.701689	625	705	0	80	80	1.0000000
NODE_1105_length_2231_cov_45.701689	711	791	0	80	80	1.0000000
NODE_1105_length_2231_cov_45.701689	1141	1186	0	45	45	1.0000000
NODE_1105_length_2231_cov_45.701689	1787	1867	0	7	80	0.0875000
NODE_1105_length_2231_cov_45.701689	1787	1867	6	73	80	0.9125000
NODE_1105_length_2231_cov_45.701689	1840	1920	0	4	80	0.0500000
NODE_1105_length_2231_cov_45.701689	1840	1920	6	76	80	0.9500000
NODE_1106_length_2230_cov_12.608634	1520	1600	0	19	80	0.2375000
NODE_1106_length_2230_cov_12.608634	1520	1600	8	61	80	0.7625000
NODE_1106_length_2230_cov_12.608634	1573	1653	0	72	80	0.9000000
NODE_1106_length_2230_cov_12.608634	1573	1653	8	8	80	0.1000000
NODE_1112_length_2218_cov_5.292591	1427	1497	6	14	70	0.2000000
NODE_1112_length_2218_cov_5.292591	1427	1497	8	35	70	0.5000000
NODE_1112_length_2218_cov_5.292591	1427	1497	10	21	70	0.3000000
NODE_1112_length_2218_cov_5.292591	1470	1536	2	7	66	0.1060606
NODE_1112_length_2218_cov_5.292591	1470	1536	4	32	66	0.4848485
NODE_1112_length_2218_cov_5.292591	1470	1536	6	14	66	0.2121212
NODE_1112_length_2218_cov_5.292591	1470	1536	8	12	66	0.1818182
NODE_1112_length_2218_cov_5.292591	1470	1536	10	1	66	0.0151515
NODE_1115_length_2215_cov_51.865784	108	188	0	80	80	1.0000000
NODE_1115_length_2215_cov_51.865784	161	241	0	80	80	1.0000000
NODE_1115_length_2215_cov_51.865784	237	317	0	80	80	1.0000000
NODE_1115_length_2215_cov_51.865784	290	370	0	80	80	1.0000000
NODE_1115_length_2215_cov_51.865784	1030	1102	24	1	72	0.0138889
NODE_1115_length_2215_cov_51.865784	1030	1102	26	7	72	0.0972222
NODE_1115_length_2215_cov_51.865784	1030	1102	28	4	72	0.0555556
NODE_1115_length_2215_cov_51.865784	1030	1102	30	7	72	0.0972222
NODE_1115_length_2215_cov_51.865784	1030	1102	34	3	72	0.0416667
NODE_1115_length_2215_cov_51.865784	1030	1102	36	2	72	0.0277778
NODE_1115_length_2215_cov_51.865784	1030	1102	40	2	72	0.0277778
NODE_1115_length_2215_cov_51.865784	1030	1102	41	2	72	0.0277778
NODE_1115_length_2215_cov_51.865784	1030	1102	43	2	72	0.0277778
NODE_1115_length_2215_cov_51.865784	1030	1102	45	2	72	0.0277778
NODE_1115_length_2215_cov_51.865784	1030	1102	47	2	72	0.0277778
NODE_1115_length_2215_cov_51.865784	1030	1102	48	1	72	0.0138889
NODE_1115_length_2215_cov_51.865784	1030	1102	50	4	72	0.0555556
NODE_1115_length_2215_cov_51.865784	1030	1102	52	2	72	0.0277778
NODE_1115_length_2215_cov_51.865784	1030	1102	56	2	72	0.0277778
NODE_1115_length_2215_cov_51.865784	1030	1102	59	2	72	0.0277778
NODE_1115_length_2215_cov_51.865784	1030	1102	64	5	72	0.0694444
NODE_1115_length_2215_cov_51.865784	1030	1102	68	1	72	0.0138889
NODE_1115_length_2215_cov_51.865784	1030	1102	72	2	72	0.0277778
NODE_1115_length_2215_cov_51.865784	1030	1102	74	1	72	0.0138889
NODE_1115_length_2215_cov_51.865784	1030	1102	76	2	72	0.0277778
NODE_1115_length_2215_cov_51.865784	1030	1102	77	1	72	0.0138889
NODE_1115_length_2215_cov_51.865784	1030	1102	78	3	72	0.0416667
NODE_1115_length_2215_cov_51.865784	1030	1102	79	1	72	0.0138889
NODE_1115_length_2215_cov_51.865784	1030	1102	80	7	72	0.0972222
NODE_1115_length_2215_cov_51.865784	1030	1102	82	4	72	0.0555556
NODE_1115_length_2215_cov_51.865784	1571	1651	0	80	80	1.0000000
NODE_1115_length_2215_cov_51.865784	1624	1704	0	80	80	1.0000000
NODE_1117_length_2212_cov_63.988168	459	539	0	80	80	1.0000000
NODE_1117_length_2212_cov_63.988168	512	592	0	80	80	1.0000000
NODE_1117_length_2212_cov_63.988168	588	668	0	80	80	1.0000000
NODE_1117_length_2212_cov_63.988168	641	721	0	80	80	1.0000000
NODE_1119_length_2212_cov_4.632750	1479	1559	0	75	80	0.9375000
NODE_1119_length_2212_cov_4.632750	1479	1559	2	5	80	0.0625000
NODE_1119_length_2212_cov_4.632750	1532	1612	0	22	80	0.2750000
NODE_1119_length_2212_cov_4.632750	1532	1612	2	58	80	0.7250000
NODE_1122_length_2211_cov_16.247159	1808	1888	0	3	80	0.0375000
NODE_1122_length_2211_cov_16.247159	1808	1888	2	36	80	0.4500000
NODE_1122_length_2211_cov_16.247159	1808	1888	4	1	80	0.0125000
NODE_1122_length_2211_cov_16.247159	1808	1888	6	40	80	0.5000000
NODE_1124_length_2207_cov_46.766129	1273	1348	73	15	75	0.2000000
NODE_1124_length_2207_cov_46.766129	1273	1348	74	5	75	0.0666667
NODE_1124_length_2207_cov_46.766129	1273	1348	77	3	75	0.0400000
NODE_1124_length_2207_cov_46.766129	1273	1348	78	2	75	0.0266667
NODE_1124_length_2207_cov_46.766129	1273	1348	79	2	75	0.0266667
NODE_1124_length_2207_cov_46.766129	1273	1348	80	5	75	0.0666667
NODE_1124_length_2207_cov_46.766129	1273	1348	81	5	75	0.0666667
NODE_1124_length_2207_cov_46.766129	1273	1348	82	1	75	0.0133333
NODE_1124_length_2207_cov_46.766129	1273	1348	83	2	75	0.0266667
NODE_1124_length_2207_cov_46.766129	1273	1348	85	3	75	0.0400000
NODE_1124_length_2207_cov_46.766129	1273	1348	86	2	75	0.0266667
NODE_1124_length_2207_cov_46.766129	1273	1348	87	3	75	0.0400000
NODE_1124_length_2207_cov_46.766129	1273	1348	88	2	75	0.0266667
NODE_1124_length_2207_cov_46.766129	1273	1348	90	1	75	0.0133333
NODE_1124_length_2207_cov_46.766129	1273	1348	91	1	75	0.0133333
NODE_1124_length_2207_cov_46.766129	1273	1348	94	4	75	0.0533333
NODE_1124_length_2207_cov_46.766129	1273	1348	96	1	75	0.0133333
NODE_1124_length_2207_cov_46.766129	1273	1348	98	3	75	0.0400000
NODE_1124_length_2207_cov_46.766129	1273	1348	99	1	75	0.0133333
NODE_1124_length_2207_cov_46.766129	1273	1348	100	1	75	0.0133333
NODE_1124_length_2207_cov_46.766129	1273	1348	102	3	75	0.0400000
NODE_1124_length_2207_cov_46.766129	1273	1348	103	1	75	0.0133333
NODE_1124_length_2207_cov_46.766129	1273	1348	104	6	75	0.0800000
NODE_1124_length_2207_cov_46.766129	1273	1348	108	3	75	0.0400000
NODE_1124_length_2207_cov_46.766129	1324	1401	82	3	77	0.0389610
NODE_1124_length_2207_cov_46.766129	1324	1401	83	2	77	0.0259740
NODE_1124_length_2207_cov_46.766129	1324	1401	84	3	77	0.0389610
NODE_1124_length_2207_cov_46.766129	1324	1401	85	1	77	0.0129870
NODE_1124_length_2207_cov_46.766129	1324	1401	86	5	77	0.0649351
NODE_1124_length_2207_cov_46.766129	1324	1401	87	8	77	0.1038961
NODE_1124_length_2207_cov_46.766129	1324	1401	88	3	77	0.0389610
NODE_1124_length_2207_cov_46.766129	1324	1401	89	6	77	0.0779221
NODE_1124_length_2207_cov_46.766129	1324	1401	90	3	77	0.0389610
NODE_1124_length_2207_cov_46.766129	1324	1401	91	4	77	0.0519481
NODE_1124_length_2207_cov_46.766129	1324	1401	92	2	77	0.0259740
NODE_1124_length_2207_cov_46.766129	1324	1401	93	5	77	0.0649351
NODE_1124_length_2207_cov_46.766129	1324	1401	94	3	77	0.0389610
NODE_1124_length_2207_cov_46.766129	1324	1401	95	4	77	0.0519481
NODE_1124_length_2207_cov_46.766129	1324	1401	96	1	77	0.0129870
NODE_1124_length_2207_cov_46.766129	1324	1401	97	1	77	0.0129870
NODE_1124_length_2207_cov_46.766129	1324	1401	98	3	77	0.0389610
NODE_1124_length_2207_cov_46.766129	1324	1401	99	1	77	0.0129870
NODE_1124_length_2207_cov_46.766129	1324	1401	100	1	77	0.0129870
NODE_1124_length_2207_cov_46.766129	1324	1401	101	3	77	0.0389610
NODE_1124_length_2207_cov_46.766129	1324	1401	102	4	77	0.0519481
NODE_1124_length_2207_cov_46.766129	1324	1401	103	1	77	0.0129870
NODE_1124_length_2207_cov_46.766129	1324	1401	104	7	77	0.0909091
NODE_1124_length_2207_cov_46.766129	1324	1401	108	3	77	0.0389610
NODE_1127_length_2205_cov_12.762108	1818	1898	2	7	80	0.0875000
NODE_1127_length_2205_cov_12.762108	1818	1898	4	73	80	0.9125000
NODE_1127_length_2205_cov_12.762108	1871	1951	0	2	80	0.0250000
NODE_1127_length_2205_cov_12.762108	1871	1951	1	22	80	0.2750000
NODE_1127_length_2205_cov_12.762108	1871	1951	3	3	80	0.0375000
NODE_1127_length_2205_cov_12.762108	1871	1951	4	53	80	0.6625000
NODE_1127_length_2205_cov_12.762108	1872	1951	0	2	79	0.0253165
NODE_1127_length_2205_cov_12.762108	1872	1951	1	22	79	0.2784810
NODE_1127_length_2205_cov_12.762108	1872	1951	3	3	79	0.0379747
NODE_1127_length_2205_cov_12.762108	1872	1951	4	52	79	0.6582279
NODE_1127_length_2205_cov_12.762108	1947	2020	0	71	73	0.9726027
NODE_1127_length_2205_cov_12.762108	1947	2020	1	2	73	0.0273973
NODE_1128_length_2202_cov_8.687114	1848	1912	0	64	64	1.0000000
NODE_1130_length_2200_cov_10.639695	1461	1541	0	25	80	0.3125000
NODE_1130_length_2200_cov_10.639695	1461	1541	4	55	80	0.6875000
NODE_1130_length_2200_cov_10.639695	1514	1594	0	78	80	0.9750000
NODE_1130_length_2200_cov_10.639695	1514	1594	4	2	80	0.0250000
NODE_1131_length_2199_cov_10.839524	1709	1789	0	36	80	0.4500000
NODE_1131_length_2199_cov_10.839524	1709	1789	2	44	80	0.5500000
NODE_1131_length_2199_cov_10.839524	1762	1842	0	80	80	1.0000000
NODE_1135_length_2196_cov_64.718646	885	965	2	2	80	0.0250000
NODE_1135_length_2196_cov_64.718646	885	965	18	2	80	0.0250000
NODE_1135_length_2196_cov_64.718646	885	965	20	13	80	0.1625000
NODE_1135_length_2196_cov_64.718646	885	965	24	11	80	0.1375000
NODE_1135_length_2196_cov_64.718646	885	965	28	11	80	0.1375000
NODE_1135_length_2196_cov_64.718646	885	965	29	6	80	0.0750000
NODE_1135_length_2196_cov_64.718646	885	965	31	9	80	0.1125000
NODE_1135_length_2196_cov_64.718646	885	965	33	6	80	0.0750000
NODE_1135_length_2196_cov_64.718646	885	965	35	4	80	0.0500000
NODE_1135_length_2196_cov_64.718646	885	965	36	16	80	0.2000000
NODE_1135_length_2196_cov_64.718646	938	1018	6	16	80	0.2000000
NODE_1135_length_2196_cov_64.718646	938	1018	22	2	80	0.0250000
NODE_1135_length_2196_cov_64.718646	938	1018	23	6	80	0.0750000
NODE_1135_length_2196_cov_64.718646	938	1018	25	9	80	0.1125000
NODE_1135_length_2196_cov_64.718646	938	1018	26	1	80	0.0125000
NODE_1135_length_2196_cov_64.718646	938	1018	29	8	80	0.1000000
NODE_1135_length_2196_cov_64.718646	938	1018	31	1	80	0.0125000
NODE_1135_length_2196_cov_64.718646	938	1018	32	1	80	0.0125000
NODE_1135_length_2196_cov_64.718646	938	1018	33	10	80	0.1250000
NODE_1135_length_2196_cov_64.718646	938	1018	35	4	80	0.0500000
NODE_1135_length_2196_cov_64.718646	938	1018	36	22	80	0.2750000
NODE_1138_length_2195_cov_8.443225	114	136	0	22	22	1.0000000
NODE_1139_length_2195_cov_6.113550	1245	1330	0	42	85	0.4941176
NODE_1139_length_2195_cov_6.113550	1245	1330	2	43	85	0.5058824
NODE_1139_length_2195_cov_6.113550	1306	1352	2	46	46	1.0000000
NODE_1141_length_2194_cov_1.366587	15	77	0	62	62	1.0000000
NODE_1142_length_2193_cov_8.320917	374	454	4	20	80	0.2500000
NODE_1142_length_2193_cov_8.320917	374	454	6	3	80	0.0375000
NODE_1142_length_2193_cov_8.320917	374	454	7	36	80	0.4500000
NODE_1142_length_2193_cov_8.320917	374	454	8	21	80	0.2625000
NODE_1142_length_2193_cov_8.320917	427	502	0	24	75	0.3200000
NODE_1142_length_2193_cov_8.320917	427	502	2	15	75	0.2000000
NODE_1142_length_2193_cov_8.320917	427	502	4	6	75	0.0800000
NODE_1142_length_2193_cov_8.320917	427	502	7	30	75	0.4000000
NODE_1146_length_2189_cov_36.884689	383	463	0	41	80	0.5125000
NODE_1146_length_2189_cov_36.884689	383	463	6	14	80	0.1750000
NODE_1146_length_2189_cov_36.884689	383	463	7	19	80	0.2375000
NODE_1146_length_2189_cov_36.884689	383	463	8	6	80	0.0750000
NODE_1146_length_2189_cov_36.884689	436	516	2	9	80	0.1125000
NODE_1146_length_2189_cov_36.884689	436	516	6	2	80	0.0250000
NODE_1146_length_2189_cov_36.884689	436	516	7	19	80	0.2375000
NODE_1146_length_2189_cov_36.884689	436	516	8	50	80	0.6250000
NODE_1146_length_2189_cov_36.884689	1257	1337	0	10	80	0.1250000
NODE_1146_length_2189_cov_36.884689	1257	1337	1	70	80	0.8750000
NODE_1146_length_2189_cov_36.884689	1310	1390	1	80	80	1.0000000
NODE_1146_length_2189_cov_36.884689	1427	1507	0	59	80	0.7375000
NODE_1146_length_2189_cov_36.884689	1427	1507	1	21	80	0.2625000
NODE_1146_length_2189_cov_36.884689	1480	1560	0	6	80	0.0750000
NODE_1146_length_2189_cov_36.884689	1480	1560	1	74	80	0.9250000
NODE_1152_length_2184_cov_9.464748	1536	1616	0	7	80	0.0875000
NODE_1152_length_2184_cov_9.464748	1536	1616	2	60	80	0.7500000
NODE_1152_length_2184_cov_9.464748	1536	1616	4	13	80	0.1625000
NODE_1152_length_2184_cov_9.464748	1589	1669	2	68	80	0.8500000
NODE_1152_length_2184_cov_9.464748	1589	1669	4	12	80	0.1500000
NODE_1154_length_2183_cov_45.471209	1632	1712	5	5	80	0.0625000
NODE_1154_length_2183_cov_45.471209	1632	1712	8	75	80	0.9375000
NODE_1154_length_2183_cov_45.471209	1685	1765	3	10	80	0.1250000
NODE_1154_length_2183_cov_45.471209	1685	1765	5	16	80	0.2000000
NODE_1154_length_2183_cov_45.471209	1685	1765	8	54	80	0.6750000
NODE_1159_length_2176_cov_47.338950	0	52	0	52	52	1.0000000
NODE_1162_length_2174_cov_40.560964	1638	1718	0	22	80	0.2750000
NODE_1162_length_2174_cov_40.560964	1638	1718	2	11	80	0.1375000
NODE_1162_length_2174_cov_40.560964	1638	1718	12	47	80	0.5875000
NODE_1162_length_2174_cov_40.560964	1691	1771	12	80	80	1.0000000
NODE_1163_length_2174_cov_35.399518	284	364	0	66	80	0.8250000
NODE_1163_length_2174_cov_35.399518	284	364	2	14	80	0.1750000
NODE_1163_length_2174_cov_35.399518	337	414	0	77	77	1.0000000
NODE_1163_length_2174_cov_35.399518	1542	1620	287	2	78	0.0256410
NODE_1163_length_2174_cov_35.399518	1542	1620	291	1	78	0.0128205
NODE_1163_length_2174_cov_35.399518	1542	1620	293	1	78	0.0128205
NODE_1163_length_2174_cov_35.399518	1542	1620	295	2	78	0.0256410
NODE_1163_length_2174_cov_35.399518	1542	1620	296	1	78	0.0128205
NODE_1163_length_2174_cov_35.399518	1542	1620	297	1	78	0.0128205
NODE_1163_length_2174_cov_35.399518	1542	1620	299	4	78	0.0512821
NODE_1163_length_2174_cov_35.399518	1542	1620	300	1	78	0.0128205
NODE_1163_length_2174_cov_35.399518	1542	1620	301	4	78	0.0512821
NODE_1163_length_2174_cov_35.399518	1542	1620	302	1	78	0.0128205
NODE_1163_length_2174_cov_35.399518	1542	1620	303	1	78	0.0128205
NODE_1163_length_2174_cov_35.399518	1542	1620	304	5	78	0.0641026
NODE_1163_length_2174_cov_35.399518	1542	1620	305	1	78	0.0128205
NODE_1163_length_2174_cov_35.399518	1542	1620	306	2	78	0.0256410
NODE_1163_length_2174_cov_35.399518	1542	1620	310	3	78	0.0384615
NODE_1163_length_2174_cov_35.399518	1542	1620	312	1	78	0.0128205
NODE_1163_length_2174_cov_35.399518	1542	1620	314	1	78	0.0128205
NODE_1163_length_2174_cov_35.399518	1542	1620	316	1	78	0.0128205
NODE_1163_length_2174_cov_35.399518	1542	1620	318	1	78	0.0128205
NODE_1163_length_2174_cov_35.399518	1542	1620	319	1	78	0.0128205
NODE_1163_length_2174_cov_35.399518	1542	1620	324	1	78	0.0128205
NODE_1163_length_2174_cov_35.399518	1542	1620	327	1	78	0.0128205
NODE_1163_length_2174_cov_35.399518	1542	1620	336	1	78	0.0128205
NODE_1163_length_2174_cov_35.399518	1542	1620	338	1	78	0.0128205
NODE_1163_length_2174_cov_35.399518	1542	1620	339	1	78	0.0128205
NODE_1163_length_2174_cov_35.399518	1542	1620	341	1	78	0.0128205
NODE_1163_length_2174_cov_35.399518	1542	1620	343	2	78	0.0256410
NODE_1163_length_2174_cov_35.399518	1542	1620	344	6	78	0.0769231
NODE_1163_length_2174_cov_35.399518	1542	1620	345	3	78	0.0384615
NODE_1163_length_2174_cov_35.399518	1542	1620	346	2	78	0.0256410
NODE_1163_length_2174_cov_35.399518	1542	1620	347	3	78	0.0384615
NODE_1163_length_2174_cov_35.399518	1542	1620	348	2	78	0.0256410
NODE_1163_length_2174_cov_35.399518	1542	1620	349	2	78	0.0256410
NODE_1163_length_2174_cov_35.399518	1542	1620	350	2	78	0.0256410
NODE_1163_length_2174_cov_35.399518	1542	1620	351	3	78	0.0384615
NODE_1163_length_2174_cov_35.399518	1542	1620	352	2	78	0.0256410
NODE_1163_length_2174_cov_35.399518	1542	1620	353	2	78	0.0256410
NODE_1163_length_2174_cov_35.399518	1542	1620	354	4	78	0.0512821
NODE_1163_length_2174_cov_35.399518	1542	1620	355	1	78	0.0128205
NODE_1163_length_2174_cov_35.399518	1542	1620	356	1	78	0.0128205
NODE_1163_length_2174_cov_35.399518	1542	1620	357	1	78	0.0128205
NODE_1163_length_2174_cov_35.399518	1542	1620	359	1	78	0.0128205
NODE_1163_length_2174_cov_35.399518	1593	1673	244	2	80	0.0250000
NODE_1163_length_2174_cov_35.399518	1593	1673	246	2	80	0.0250000
NODE_1163_length_2174_cov_35.399518	1593	1673	248	3	80	0.0375000
NODE_1163_length_2174_cov_35.399518	1593	1673	249	3	80	0.0375000
NODE_1163_length_2174_cov_35.399518	1593	1673	250	1	80	0.0125000
NODE_1163_length_2174_cov_35.399518	1593	1673	252	1	80	0.0125000
NODE_1163_length_2174_cov_35.399518	1593	1673	254	1	80	0.0125000
NODE_1163_length_2174_cov_35.399518	1593	1673	256	1	80	0.0125000
NODE_1163_length_2174_cov_35.399518	1593	1673	258	1	80	0.0125000
NODE_1163_length_2174_cov_35.399518	1593	1673	259	2	80	0.0250000
NODE_1163_length_2174_cov_35.399518	1593	1673	260	4	80	0.0500000
NODE_1163_length_2174_cov_35.399518	1593	1673	261	4	80	0.0500000
NODE_1163_length_2174_cov_35.399518	1593	1673	262	2	80	0.0250000
NODE_1163_length_2174_cov_35.399518	1593	1673	264	8	80	0.1000000
NODE_1163_length_2174_cov_35.399518	1593	1673	265	1	80	0.0125000
NODE_1163_length_2174_cov_35.399518	1593	1673	266	3	80	0.0375000
NODE_1163_length_2174_cov_35.399518	1593	1673	267	1	80	0.0125000
NODE_1163_length_2174_cov_35.399518	1593	1673	268	2	80	0.0250000
NODE_1163_length_2174_cov_35.399518	1593	1673	271	3	80	0.0375000
NODE_1163_length_2174_cov_35.399518	1593	1673	272	2	80	0.0250000
NODE_1163_length_2174_cov_35.399518	1593	1673	273	1	80	0.0125000
NODE_1163_length_2174_cov_35.399518	1593	1673	274	1	80	0.0125000
NODE_1163_length_2174_cov_35.399518	1593	1673	275	2	80	0.0250000
NODE_1163_length_2174_cov_35.399518	1593	1673	279	1	80	0.0125000
NODE_1163_length_2174_cov_35.399518	1593	1673	286	1	80	0.0125000
NODE_1163_length_2174_cov_35.399518	1593	1673	287	2	80	0.0250000
NODE_1163_length_2174_cov_35.399518	1593	1673	291	1	80	0.0125000
NODE_1163_length_2174_cov_35.399518	1593	1673	293	1	80	0.0125000
NODE_1163_length_2174_cov_35.399518	1593	1673	295	2	80	0.0250000
NODE_1163_length_2174_cov_35.399518	1593	1673	296	1	80	0.0125000
NODE_1163_length_2174_cov_35.399518	1593	1673	297	1	80	0.0125000
NODE_1163_length_2174_cov_35.399518	1593	1673	299	4	80	0.0500000
NODE_1163_length_2174_cov_35.399518	1593	1673	300	1	80	0.0125000
NODE_1163_length_2174_cov_35.399518	1593	1673	301	4	80	0.0500000
NODE_1163_length_2174_cov_35.399518	1593	1673	302	1	80	0.0125000
NODE_1163_length_2174_cov_35.399518	1593	1673	303	1	80	0.0125000
NODE_1163_length_2174_cov_35.399518	1593	1673	304	5	80	0.0625000
NODE_1163_length_2174_cov_35.399518	1593	1673	305	1	80	0.0125000
NODE_1163_length_2174_cov_35.399518	1593	1673	306	2	80	0.0250000
NODE_1163_length_2174_cov_35.399518	2075	2152	80	77	77	1.0000000
NODE_1163_length_2174_cov_35.399518	2075	2152	80	77	77	1.0000000
NODE_1163_length_2174_cov_35.399518	2075	2152	80	77	77	1.0000000
NODE_1163_length_2174_cov_35.399518	2125	2174	14	1	49	0.0204082
NODE_1163_length_2174_cov_35.399518	2125	2174	21	3	49	0.0612245
NODE_1163_length_2174_cov_35.399518	2125	2174	22	3	49	0.0612245
NODE_1163_length_2174_cov_35.399518	2125	2174	34	9	49	0.1836735
NODE_1163_length_2174_cov_35.399518	2125	2174	44	1	49	0.0204082
NODE_1163_length_2174_cov_35.399518	2125	2174	58	1	49	0.0204082
NODE_1163_length_2174_cov_35.399518	2125	2174	68	1	49	0.0204082
NODE_1163_length_2174_cov_35.399518	2125	2174	74	1	49	0.0204082
NODE_1163_length_2174_cov_35.399518	2125	2174	78	2	49	0.0408163
NODE_1163_length_2174_cov_35.399518	2125	2174	80	27	49	0.5510204
NODE_1163_length_2174_cov_35.399518	2128	2174	14	1	46	0.0217391
NODE_1163_length_2174_cov_35.399518	2128	2174	21	3	46	0.0652174
NODE_1163_length_2174_cov_35.399518	2128	2174	22	3	46	0.0652174
NODE_1163_length_2174_cov_35.399518	2128	2174	34	9	46	0.1956522
NODE_1163_length_2174_cov_35.399518	2128	2174	44	1	46	0.0217391
NODE_1163_length_2174_cov_35.399518	2128	2174	58	1	46	0.0217391
NODE_1163_length_2174_cov_35.399518	2128	2174	68	1	46	0.0217391
NODE_1163_length_2174_cov_35.399518	2128	2174	74	1	46	0.0217391
NODE_1163_length_2174_cov_35.399518	2128	2174	78	2	46	0.0434783
NODE_1163_length_2174_cov_35.399518	2128	2174	80	24	46	0.5217391
NODE_1163_length_2174_cov_35.399518	2130	2174	14	1	44	0.0227273
NODE_1163_length_2174_cov_35.399518	2130	2174	21	3	44	0.0681818
NODE_1163_length_2174_cov_35.399518	2130	2174	22	3	44	0.0681818
NODE_1163_length_2174_cov_35.399518	2130	2174	34	9	44	0.2045455
NODE_1163_length_2174_cov_35.399518	2130	2174	44	1	44	0.0227273
NODE_1163_length_2174_cov_35.399518	2130	2174	58	1	44	0.0227273
NODE_1163_length_2174_cov_35.399518	2130	2174	68	1	44	0.0227273
NODE_1163_length_2174_cov_35.399518	2130	2174	74	1	44	0.0227273
NODE_1163_length_2174_cov_35.399518	2130	2174	78	2	44	0.0454545
NODE_1163_length_2174_cov_35.399518	2130	2174	80	22	44	0.5000000
NODE_1164_length_2172_cov_44.861553	1110	1190	0	9	80	0.1125000
NODE_1164_length_2172_cov_44.861553	1110	1190	4	3	80	0.0375000
NODE_1164_length_2172_cov_44.861553	1110	1190	6	41	80	0.5125000
NODE_1164_length_2172_cov_44.861553	1110	1190	11	26	80	0.3250000
NODE_1164_length_2172_cov_44.861553	1110	1190	12	1	80	0.0125000
NODE_1164_length_2172_cov_44.861553	1163	1243	11	51	80	0.6375000
NODE_1164_length_2172_cov_44.861553	1163	1243	12	9	80	0.1125000
NODE_1164_length_2172_cov_44.861553	1163	1243	13	9	80	0.1125000
NODE_1164_length_2172_cov_44.861553	1163	1243	16	9	80	0.1125000
NODE_1164_length_2172_cov_44.861553	1163	1243	17	2	80	0.0250000
NODE_1164_length_2172_cov_44.861553	1239	1319	9	4	80	0.0500000
NODE_1164_length_2172_cov_44.861553	1239	1319	11	5	80	0.0625000
NODE_1164_length_2172_cov_44.861553	1239	1319	15	13	80	0.1625000
NODE_1164_length_2172_cov_44.861553	1239	1319	16	6	80	0.0750000
NODE_1164_length_2172_cov_44.861553	1239	1319	18	1	80	0.0125000
NODE_1164_length_2172_cov_44.861553	1239	1319	19	11	80	0.1375000
NODE_1164_length_2172_cov_44.861553	1239	1319	21	32	80	0.4000000
NODE_1164_length_2172_cov_44.861553	1239	1319	22	8	80	0.1000000
NODE_1164_length_2172_cov_44.861553	1292	1372	9	4	80	0.0500000
NODE_1164_length_2172_cov_44.861553	1292	1372	11	6	80	0.0750000
NODE_1164_length_2172_cov_44.861553	1292	1372	12	18	80	0.2250000
NODE_1164_length_2172_cov_44.861553	1292	1372	14	16	80	0.2000000
NODE_1164_length_2172_cov_44.861553	1292	1372	15	13	80	0.1625000
NODE_1164_length_2172_cov_44.861553	1292	1372	16	1	80	0.0125000
NODE_1164_length_2172_cov_44.861553	1292	1372	18	1	80	0.0125000
NODE_1164_length_2172_cov_44.861553	1292	1372	19	1	80	0.0125000
NODE_1164_length_2172_cov_44.861553	1292	1372	20	15	80	0.1875000
NODE_1164_length_2172_cov_44.861553	1292	1372	22	5	80	0.0625000
NODE_1166_length_2167_cov_33.133946	414	494	0	80	80	1.0000000
NODE_1166_length_2167_cov_33.133946	467	547	0	80	80	1.0000000
NODE_1166_length_2167_cov_33.133946	543	623	0	59	80	0.7375000
NODE_1166_length_2167_cov_33.133946	543	623	2	21	80	0.2625000
NODE_1166_length_2167_cov_33.133946	596	676	0	6	80	0.0750000
NODE_1166_length_2167_cov_33.133946	596	676	2	73	80	0.9125000
NODE_1166_length_2167_cov_33.133946	596	676	4	1	80	0.0125000
NODE_1169_length_2165_cov_21.460794	980	1060	2	80	80	1.0000000
NODE_1169_length_2165_cov_21.460794	1033	1113	0	42	80	0.5250000
NODE_1169_length_2165_cov_21.460794	1033	1113	2	38	80	0.4750000
NODE_1176_length_2157_cov_22.284257	989	1069	0	80	80	1.0000000
NODE_1176_length_2157_cov_22.284257	1042	1122	0	74	80	0.9250000
NODE_1176_length_2157_cov_22.284257	1042	1122	6	6	80	0.0750000
NODE_1176_length_2157_cov_22.284257	1118	1198	6	42	80	0.5250000
NODE_1176_length_2157_cov_22.284257	1118	1198	8	9	80	0.1125000
NODE_1176_length_2157_cov_22.284257	1118	1198	10	29	80	0.3625000
NODE_1176_length_2157_cov_22.284257	1171	1251	2	18	80	0.2250000
NODE_1176_length_2157_cov_22.284257	1171	1251	4	9	80	0.1125000
NODE_1176_length_2157_cov_22.284257	1171	1251	8	12	80	0.1500000
NODE_1176_length_2157_cov_22.284257	1171	1251	10	41	80	0.5125000
NODE_1177_length_2157_cov_8.830418	867	947	0	30	80	0.3750000
NODE_1177_length_2157_cov_8.830418	867	947	2	50	80	0.6250000
NODE_1177_length_2157_cov_8.830418	920	1000	2	80	80	1.0000000
NODE_1177_length_2157_cov_8.830418	996	1076	0	12	80	0.1500000
NODE_1177_length_2157_cov_8.830418	996	1076	2	68	80	0.8500000
NODE_1177_length_2157_cov_8.830418	1049	1129	0	12	80	0.1500000
NODE_1177_length_2157_cov_8.830418	1049	1129	2	68	80	0.8500000
NODE_1178_length_2156_cov_25.065630	0	41	26	1	41	0.0243902
NODE_1178_length_2156_cov_25.065630	0	41	30	1	41	0.0243902
NODE_1178_length_2156_cov_25.065630	0	41	36	2	41	0.0487805
NODE_1178_length_2156_cov_25.065630	0	41	38	1	41	0.0243902
NODE_1178_length_2156_cov_25.065630	0	41	46	1	41	0.0243902
NODE_1178_length_2156_cov_25.065630	0	41	52	1	41	0.0243902
NODE_1178_length_2156_cov_25.065630	0	41	54	3	41	0.0731707
NODE_1178_length_2156_cov_25.065630	0	41	56	1	41	0.0243902
NODE_1178_length_2156_cov_25.065630	0	41	60	1	41	0.0243902
NODE_1178_length_2156_cov_25.065630	0	41	72	4	41	0.0975610
NODE_1178_length_2156_cov_25.065630	0	41	76	1	41	0.0243902
NODE_1178_length_2156_cov_25.065630	0	41	79	1	41	0.0243902
NODE_1178_length_2156_cov_25.065630	0	41	83	2	41	0.0487805
NODE_1178_length_2156_cov_25.065630	0	41	85	1	41	0.0243902
NODE_1178_length_2156_cov_25.065630	0	41	87	1	41	0.0243902
NODE_1178_length_2156_cov_25.065630	0	41	93	2	41	0.0487805
NODE_1178_length_2156_cov_25.065630	0	41	94	3	41	0.0731707
NODE_1178_length_2156_cov_25.065630	0	41	96	1	41	0.0243902
NODE_1178_length_2156_cov_25.065630	0	41	98	3	41	0.0731707
NODE_1178_length_2156_cov_25.065630	0	41	100	5	41	0.1219512
NODE_1178_length_2156_cov_25.065630	0	41	102	2	41	0.0487805
NODE_1178_length_2156_cov_25.065630	0	41	108	3	41	0.0731707
NODE_1178_length_2156_cov_25.065630	14	94	72	2	80	0.0250000
NODE_1178_length_2156_cov_25.065630	14	94	76	1	80	0.0125000
NODE_1178_length_2156_cov_25.065630	14	94	79	1	80	0.0125000
NODE_1178_length_2156_cov_25.065630	14	94	83	2	80	0.0250000
NODE_1178_length_2156_cov_25.065630	14	94	85	1	80	0.0125000
NODE_1178_length_2156_cov_25.065630	14	94	87	1	80	0.0125000
NODE_1178_length_2156_cov_25.065630	14	94	93	2	80	0.0250000
NODE_1178_length_2156_cov_25.065630	14	94	94	3	80	0.0375000
NODE_1178_length_2156_cov_25.065630	14	94	96	1	80	0.0125000
NODE_1178_length_2156_cov_25.065630	14	94	98	3	80	0.0375000
NODE_1178_length_2156_cov_25.065630	14	94	100	5	80	0.0625000
NODE_1178_length_2156_cov_25.065630	14	94	102	2	80	0.0250000
NODE_1178_length_2156_cov_25.065630	14	94	108	4	80	0.0500000
NODE_1178_length_2156_cov_25.065630	14	94	110	2	80	0.0250000
NODE_1178_length_2156_cov_25.065630	14	94	111	1	80	0.0125000
NODE_1178_length_2156_cov_25.065630	14	94	117	1	80	0.0125000
NODE_1178_length_2156_cov_25.065630	14	94	122	1	80	0.0125000
NODE_1178_length_2156_cov_25.065630	14	94	124	1	80	0.0125000
NODE_1178_length_2156_cov_25.065630	14	94	126	1	80	0.0125000
NODE_1178_length_2156_cov_25.065630	14	94	127	4	80	0.0500000
NODE_1178_length_2156_cov_25.065630	14	94	128	1	80	0.0125000
NODE_1178_length_2156_cov_25.065630	14	94	132	2	80	0.0250000
NODE_1178_length_2156_cov_25.065630	14	94	135	2	80	0.0250000
NODE_1178_length_2156_cov_25.065630	14	94	136	2	80	0.0250000
NODE_1178_length_2156_cov_25.065630	14	94	138	2	80	0.0250000
NODE_1178_length_2156_cov_25.065630	14	94	139	5	80	0.0625000
NODE_1178_length_2156_cov_25.065630	14	94	141	1	80	0.0125000
NODE_1178_length_2156_cov_25.065630	14	94	142	3	80	0.0375000
NODE_1178_length_2156_cov_25.065630	14	94	143	18	80	0.2250000
NODE_1178_length_2156_cov_25.065630	14	94	144	5	80	0.0625000
NODE_1181_length_2156_cov_3.216334	1890	1970	0	80	80	1.0000000
NODE_1181_length_2156_cov_3.216334	1943	2023	0	80	80	1.0000000
NODE_1184_length_2153_cov_11.610029	1968	2048	0	47	80	0.5875000
NODE_1184_length_2153_cov_11.610029	1968	2048	2	10	80	0.1250000
NODE_1184_length_2153_cov_11.610029	1968	2048	5	10	80	0.1250000
NODE_1184_length_2153_cov_11.610029	1968	2048	9	2	80	0.0250000
NODE_1184_length_2153_cov_11.610029	1968	2048	12	1	80	0.0125000
NODE_1184_length_2153_cov_11.610029	1968	2048	14	4	80	0.0500000
NODE_1184_length_2153_cov_11.610029	1968	2048	16	1	80	0.0125000
NODE_1184_length_2153_cov_11.610029	1968	2048	18	1	80	0.0125000
NODE_1184_length_2153_cov_11.610029	1968	2048	24	1	80	0.0125000
NODE_1184_length_2153_cov_11.610029	1968	2048	26	1	80	0.0125000
NODE_1184_length_2153_cov_11.610029	1968	2048	30	2	80	0.0250000
NODE_1184_length_2153_cov_11.610029	1977	2048	0	47	71	0.6619718
NODE_1184_length_2153_cov_11.610029	1977	2048	2	1	71	0.0140845
NODE_1184_length_2153_cov_11.610029	1977	2048	5	10	71	0.1408451
NODE_1184_length_2153_cov_11.610029	1977	2048	9	2	71	0.0281690
NODE_1184_length_2153_cov_11.610029	1977	2048	12	1	71	0.0140845
NODE_1184_length_2153_cov_11.610029	1977	2048	14	4	71	0.0563380
NODE_1184_length_2153_cov_11.610029	1977	2048	16	1	71	0.0140845
NODE_1184_length_2153_cov_11.610029	1977	2048	18	1	71	0.0140845
NODE_1184_length_2153_cov_11.610029	1977	2048	24	1	71	0.0140845
NODE_1184_length_2153_cov_11.610029	1977	2048	26	1	71	0.0140845
NODE_1184_length_2153_cov_11.610029	1977	2048	30	2	71	0.0281690
NODE_1190_length_2147_cov_25.116211	814	894	22	20	80	0.2500000
NODE_1190_length_2147_cov_25.116211	814	894	24	13	80	0.1625000
NODE_1190_length_2147_cov_25.116211	814	894	28	2	80	0.0250000
NODE_1190_length_2147_cov_25.116211	814	894	29	9	80	0.1125000
NODE_1190_length_2147_cov_25.116211	814	894	30	15	80	0.1875000
NODE_1190_length_2147_cov_25.116211	814	894	31	20	80	0.2500000
NODE_1190_length_2147_cov_25.116211	814	894	33	1	80	0.0125000
NODE_1190_length_2147_cov_25.116211	867	947	5	4	80	0.0500000
NODE_1190_length_2147_cov_25.116211	867	947	10	7	80	0.0875000
NODE_1190_length_2147_cov_25.116211	867	947	11	13	80	0.1625000
NODE_1190_length_2147_cov_25.116211	867	947	20	1	80	0.0125000
NODE_1190_length_2147_cov_25.116211	867	947	22	1	80	0.0125000
NODE_1190_length_2147_cov_25.116211	867	947	23	3	80	0.0375000
NODE_1190_length_2147_cov_25.116211	867	947	25	12	80	0.1500000
NODE_1190_length_2147_cov_25.116211	867	947	29	15	80	0.1875000
NODE_1190_length_2147_cov_25.116211	867	947	30	7	80	0.0875000
NODE_1190_length_2147_cov_25.116211	867	947	31	16	80	0.2000000
NODE_1190_length_2147_cov_25.116211	867	947	33	1	80	0.0125000
NODE_1197_length_2136_cov_16.947472	279	359	0	46	80	0.5750000
NODE_1197_length_2136_cov_16.947472	279	359	2	34	80	0.4250000
NODE_1197_length_2136_cov_16.947472	332	412	2	57	80	0.7125000
NODE_1197_length_2136_cov_16.947472	332	412	7	4	80	0.0500000
NODE_1197_length_2136_cov_16.947472	332	412	8	1	80	0.0125000
NODE_1197_length_2136_cov_16.947472	332	412	9	16	80	0.2000000
NODE_1197_length_2136_cov_16.947472	332	412	11	2	80	0.0250000
NODE_1197_length_2136_cov_16.947472	408	488	7	2	80	0.0250000
NODE_1197_length_2136_cov_16.947472	408	488	11	23	80	0.2875000
NODE_1197_length_2136_cov_16.947472	408	488	12	53	80	0.6625000
NODE_1197_length_2136_cov_16.947472	408	488	14	2	80	0.0250000
NODE_1197_length_2136_cov_16.947472	461	541	2	26	80	0.3250000
NODE_1197_length_2136_cov_16.947472	461	541	9	10	80	0.1250000
NODE_1197_length_2136_cov_16.947472	461	541	12	25	80	0.3125000
NODE_1197_length_2136_cov_16.947472	461	541	13	6	80	0.0750000
NODE_1197_length_2136_cov_16.947472	461	541	14	13	80	0.1625000
NODE_1199_length_2133_cov_15.038840	498	578	0	46	80	0.5750000
NODE_1199_length_2133_cov_15.038840	498	578	2	10	80	0.1250000
NODE_1199_length_2133_cov_15.038840	498	578	4	24	80	0.3000000
NODE_1199_length_2133_cov_15.038840	551	631	2	3	80	0.0375000
NODE_1199_length_2133_cov_15.038840	551	631	4	77	80	0.9625000
NODE_1199_length_2133_cov_15.038840	627	707	0	69	80	0.8625000
NODE_1199_length_2133_cov_15.038840	627	707	2	1	80	0.0125000
NODE_1199_length_2133_cov_15.038840	627	707	4	10	80	0.1250000
NODE_1199_length_2133_cov_15.038840	680	722	0	42	42	1.0000000
NODE_1204_length_2128_cov_11.799409	1698	1778	0	59	80	0.7375000
NODE_1204_length_2128_cov_11.799409	1698	1778	3	21	80	0.2625000
NODE_1204_length_2128_cov_11.799409	1751	1831	0	6	80	0.0750000
NODE_1204_length_2128_cov_11.799409	1751	1831	3	74	80	0.9250000
NODE_1206_length_2126_cov_6.854465	1614	1694	0	80	80	1.0000000
NODE_1206_length_2126_cov_6.854465	1667	1747	0	80	80	1.0000000
NODE_1209_length_2123_cov_12.668478	102	143	2	41	41	1.0000000
NODE_1209_length_2123_cov_12.668478	1474	1500	0	26	26	1.0000000
NODE_1209_length_2123_cov_12.668478	1552	1601	0	9	49	0.1836735
NODE_1209_length_2123_cov_12.668478	1552	1601	3	27	49	0.5510204
NODE_1209_length_2123_cov_12.668478	1552	1601	7	7	49	0.1428571
NODE_1209_length_2123_cov_12.668478	1552	1601	8	6	49	0.1224490
NODE_1209_length_2123_cov_12.668478	1574	1654	3	14	80	0.1750000
NODE_1209_length_2123_cov_12.668478	1574	1654	7	7	80	0.0875000
NODE_1209_length_2123_cov_12.668478	1574	1654	8	59	80	0.7375000
NODE_1211_length_2121_cov_10.101879	497	577	1	18	80	0.2250000
NODE_1211_length_2121_cov_10.101879	497	577	3	49	80	0.6125000
NODE_1211_length_2121_cov_10.101879	497	577	5	13	80	0.1625000
NODE_1211_length_2121_cov_10.101879	550	630	0	4	80	0.0500000
NODE_1211_length_2121_cov_10.101879	550	630	2	6	80	0.0750000
NODE_1211_length_2121_cov_10.101879	550	630	3	65	80	0.8125000
NODE_1211_length_2121_cov_10.101879	550	630	5	5	80	0.0625000
NODE_1211_length_2121_cov_10.101879	1935	2008	2	10	73	0.1369863
NODE_1211_length_2121_cov_10.101879	1935	2008	4	20	73	0.2739726
NODE_1211_length_2121_cov_10.101879	1935	2008	8	15	73	0.2054795
NODE_1211_length_2121_cov_10.101879	1935	2008	10	28	73	0.3835616
NODE_1212_length_2121_cov_9.964886	1523	1603	0	42	80	0.5250000
NODE_1212_length_2121_cov_9.964886	1523	1603	2	38	80	0.4750000
NODE_1212_length_2121_cov_9.964886	1576	1656	2	80	80	1.0000000
NODE_1213_length_2120_cov_24.609599	25	92	0	66	67	0.9850746
NODE_1213_length_2120_cov_24.609599	25	92	2	1	67	0.0149254
NODE_1215_length_2119_cov_18.446040	366	446	0	80	80	1.0000000
NODE_1215_length_2119_cov_18.446040	419	499	0	80	80	1.0000000
NODE_1215_length_2119_cov_18.446040	1239	1319	0	23	80	0.2875000
NODE_1215_length_2119_cov_18.446040	1239	1319	10	57	80	0.7125000
NODE_1215_length_2119_cov_18.446040	1292	1372	10	28	80	0.3500000
NODE_1215_length_2119_cov_18.446040	1292	1372	12	8	80	0.1000000
NODE_1215_length_2119_cov_18.446040	1292	1372	14	30	80	0.3750000
NODE_1215_length_2119_cov_18.446040	1292	1372	15	2	80	0.0250000
NODE_1215_length_2119_cov_18.446040	1292	1372	16	12	80	0.1500000
NODE_1225_length_2110_cov_8.668324	1755	1835	0	80	80	1.0000000
NODE_1225_length_2110_cov_8.668324	1808	1888	0	80	80	1.0000000
NODE_1227_length_2106_cov_14.643747	1579	1659	2	15	80	0.1875000
NODE_1227_length_2106_cov_14.643747	1579	1659	4	40	80	0.5000000
NODE_1227_length_2106_cov_14.643747	1579	1659	5	3	80	0.0375000
NODE_1227_length_2106_cov_14.643747	1579	1659	6	22	80	0.2750000
NODE_1227_length_2106_cov_14.643747	1632	1712	0	45	80	0.5625000
NODE_1227_length_2106_cov_14.643747	1632	1712	2	23	80	0.2875000
NODE_1227_length_2106_cov_14.643747	1632	1712	5	3	80	0.0375000
NODE_1227_length_2106_cov_14.643747	1632	1712	6	9	80	0.1125000
NODE_1227_length_2106_cov_14.643747	1708	1786	0	78	78	1.0000000
NODE_1227_length_2106_cov_14.643747	1759	1839	0	80	80	1.0000000
NODE_1228_length_2106_cov_3.173393	48	96	0	48	48	1.0000000
NODE_1228_length_2106_cov_3.173393	48	96	0	48	48	1.0000000
NODE_1228_length_2106_cov_3.173393	48	96	0	48	48	1.0000000
NODE_1228_length_2106_cov_3.173393	48	96	0	48	48	1.0000000
NODE_1228_length_2106_cov_3.173393	48	96	0	48	48	1.0000000
NODE_1229_length_2102_cov_23.872192	390	470	0	80	80	1.0000000
NODE_1229_length_2102_cov_23.872192	443	523	0	80	80	1.0000000
NODE_1229_length_2102_cov_23.872192	519	599	0	54	80	0.6750000
NODE_1229_length_2102_cov_23.872192	519	599	2	18	80	0.2250000
NODE_1229_length_2102_cov_23.872192	519	599	3	2	80	0.0250000
NODE_1229_length_2102_cov_23.872192	519	599	4	1	80	0.0125000
NODE_1229_length_2102_cov_23.872192	519	599	6	5	80	0.0625000
NODE_1229_length_2102_cov_23.872192	572	652	0	1	80	0.0125000
NODE_1229_length_2102_cov_23.872192	572	652	2	18	80	0.2250000
NODE_1229_length_2102_cov_23.872192	572	652	3	2	80	0.0250000
NODE_1229_length_2102_cov_23.872192	572	652	4	1	80	0.0125000
NODE_1229_length_2102_cov_23.872192	572	652	6	28	80	0.3500000
NODE_1229_length_2102_cov_23.872192	572	652	8	30	80	0.3750000
NODE_1229_length_2102_cov_23.872192	1049	1101	302	1	52	0.0192308
NODE_1229_length_2102_cov_23.872192	1049	1101	303	3	52	0.0576923
NODE_1229_length_2102_cov_23.872192	1049	1101	304	2	52	0.0384615
NODE_1229_length_2102_cov_23.872192	1049	1101	307	1	52	0.0192308
NODE_1229_length_2102_cov_23.872192	1049	1101	309	1	52	0.0192308
NODE_1229_length_2102_cov_23.872192	1049	1101	310	1	52	0.0192308
NODE_1229_length_2102_cov_23.872192	1049	1101	315	2	52	0.0384615
NODE_1229_length_2102_cov_23.872192	1049	1101	323	1	52	0.0192308
NODE_1229_length_2102_cov_23.872192	1049	1101	325	2	52	0.0384615
NODE_1229_length_2102_cov_23.872192	1049	1101	327	1	52	0.0192308
NODE_1229_length_2102_cov_23.872192	1049	1101	329	1	52	0.0192308
NODE_1229_length_2102_cov_23.872192	1049	1101	330	1	52	0.0192308
NODE_1229_length_2102_cov_23.872192	1049	1101	331	2	52	0.0384615
NODE_1229_length_2102_cov_23.872192	1049	1101	332	1	52	0.0192308
NODE_1229_length_2102_cov_23.872192	1049	1101	333	2	52	0.0384615
NODE_1229_length_2102_cov_23.872192	1049	1101	334	1	52	0.0192308
NODE_1229_length_2102_cov_23.872192	1049	1101	341	1	52	0.0192308
NODE_1229_length_2102_cov_23.872192	1049	1101	349	4	52	0.0769231
NODE_1229_length_2102_cov_23.872192	1049	1101	351	1	52	0.0192308
NODE_1229_length_2102_cov_23.872192	1049	1101	357	1	52	0.0192308
NODE_1229_length_2102_cov_23.872192	1049	1101	366	2	52	0.0384615
NODE_1229_length_2102_cov_23.872192	1049	1101	367	2	52	0.0384615
NODE_1229_length_2102_cov_23.872192	1049	1101	369	2	52	0.0384615
NODE_1229_length_2102_cov_23.872192	1049	1101	370	1	52	0.0192308
NODE_1229_length_2102_cov_23.872192	1049	1101	371	4	52	0.0769231
NODE_1229_length_2102_cov_23.872192	1049	1101	373	4	52	0.0769231
NODE_1229_length_2102_cov_23.872192	1049	1101	375	2	52	0.0384615
NODE_1229_length_2102_cov_23.872192	1049	1101	377	2	52	0.0384615
NODE_1229_length_2102_cov_23.872192	1049	1101	378	1	52	0.0192308
NODE_1229_length_2102_cov_23.872192	1049	1101	382	2	52	0.0384615
NODE_1231_length_2100_cov_21.504248	450	530	4	80	80	1.0000000
NODE_1231_length_2100_cov_21.504248	503	578	1	6	75	0.0800000
NODE_1231_length_2100_cov_21.504248	503	578	2	11	75	0.1466667
NODE_1231_length_2100_cov_21.504248	503	578	3	16	75	0.2133333
NODE_1231_length_2100_cov_21.504248	503	578	4	42	75	0.5600000
NODE_1231_length_2100_cov_21.504248	579	659	2	80	80	1.0000000
NODE_1231_length_2100_cov_21.504248	632	712	1	23	80	0.2875000
NODE_1231_length_2100_cov_21.504248	632	712	2	57	80	0.7125000
NODE_1231_length_2100_cov_21.504248	1420	1500	0	80	80	1.0000000
NODE_1231_length_2100_cov_21.504248	1473	1553	0	80	80	1.0000000
NODE_1232_length_2100_cov_6.399300	1510	1590	2	80	80	1.0000000
NODE_1232_length_2100_cov_6.399300	1559	1590	2	31	31	1.0000000
NODE_1232_length_2100_cov_6.399300	1563	1644	0	7	81	0.0864198
NODE_1232_length_2100_cov_6.399300	1563	1644	2	52	81	0.6419753
NODE_1232_length_2100_cov_6.399300	1563	1644	6	20	81	0.2469136
NODE_1232_length_2100_cov_6.399300	1563	1644	8	2	81	0.0246914
NODE_1232_length_2100_cov_6.399300	1563	1644	0	7	81	0.0864198
NODE_1232_length_2100_cov_6.399300	1563	1644	2	52	81	0.6419753
NODE_1232_length_2100_cov_6.399300	1563	1644	6	20	81	0.2469136
NODE_1232_length_2100_cov_6.399300	1563	1644	8	2	81	0.0246914
NODE_1234_length_2099_cov_40.603500	960	1040	0	58	80	0.7250000
NODE_1234_length_2099_cov_40.603500	960	1040	2	22	80	0.2750000
NODE_1234_length_2099_cov_40.603500	1013	1093	0	80	80	1.0000000
NODE_1234_length_2099_cov_40.603500	1089	1169	0	42	80	0.5250000
NODE_1234_length_2099_cov_40.603500	1089	1169	6	38	80	0.4750000
NODE_1234_length_2099_cov_40.603500	1142	1222	6	50	80	0.6250000
NODE_1234_length_2099_cov_40.603500	1142	1222	8	30	80	0.3750000
NODE_1235_length_2098_cov_62.733867	1042	1122	2	37	80	0.4625000
NODE_1235_length_2098_cov_62.733867	1042	1122	3	1	80	0.0125000
NODE_1235_length_2098_cov_62.733867	1042	1122	4	42	80	0.5250000
NODE_1235_length_2098_cov_62.733867	1095	1175	2	14	80	0.1750000
NODE_1235_length_2098_cov_62.733867	1095	1175	3	1	80	0.0125000
NODE_1235_length_2098_cov_62.733867	1095	1175	4	65	80	0.8125000
NODE_1235_length_2098_cov_62.733867	1171	1251	2	75	80	0.9375000
NODE_1235_length_2098_cov_62.733867	1171	1251	4	5	80	0.0625000
NODE_1235_length_2098_cov_62.733867	1224	1304	0	44	80	0.5500000
NODE_1235_length_2098_cov_62.733867	1224	1304	1	1	80	0.0125000
NODE_1235_length_2098_cov_62.733867	1224	1304	2	35	80	0.4375000
NODE_1236_length_2098_cov_20.220110	550	630	0	80	80	1.0000000
NODE_1236_length_2098_cov_20.220110	603	683	0	80	80	1.0000000
NODE_1236_length_2098_cov_20.220110	1571	1651	0	80	80	1.0000000
NODE_1236_length_2098_cov_20.220110	1624	1704	0	80	80	1.0000000
NODE_1237_length_2098_cov_8.261631	324	404	0	80	80	1.0000000
NODE_1239_length_2095_cov_29.930862	1128	1209	113	1	81	0.0123457
NODE_1239_length_2095_cov_29.930862	1128	1209	116	1	81	0.0123457
NODE_1239_length_2095_cov_29.930862	1128	1209	128	1	81	0.0123457
NODE_1239_length_2095_cov_29.930862	1128	1209	140	3	81	0.0370370
NODE_1239_length_2095_cov_29.930862	1128	1209	144	1	81	0.0123457
NODE_1239_length_2095_cov_29.930862	1128	1209	148	1	81	0.0123457
NODE_1239_length_2095_cov_29.930862	1128	1209	155	1	81	0.0123457
NODE_1239_length_2095_cov_29.930862	1128	1209	160	1	81	0.0123457
NODE_1239_length_2095_cov_29.930862	1128	1209	165	1	81	0.0123457
NODE_1239_length_2095_cov_29.930862	1128	1209	170	1	81	0.0123457
NODE_1239_length_2095_cov_29.930862	1128	1209	176	1	81	0.0123457
NODE_1239_length_2095_cov_29.930862	1128	1209	185	1	81	0.0123457
NODE_1239_length_2095_cov_29.930862	1128	1209	193	1	81	0.0123457
NODE_1239_length_2095_cov_29.930862	1128	1209	199	1	81	0.0123457
NODE_1239_length_2095_cov_29.930862	1128	1209	200	1	81	0.0123457
NODE_1239_length_2095_cov_29.930862	1128	1209	202	1	81	0.0123457
NODE_1239_length_2095_cov_29.930862	1128	1209	203	1	81	0.0123457
NODE_1239_length_2095_cov_29.930862	1128	1209	210	1	81	0.0123457
NODE_1239_length_2095_cov_29.930862	1128	1209	212	1	81	0.0123457
NODE_1239_length_2095_cov_29.930862	1128	1209	218	1	81	0.0123457
NODE_1239_length_2095_cov_29.930862	1128	1209	224	2	81	0.0246914
NODE_1239_length_2095_cov_29.930862	1128	1209	231	1	81	0.0123457
NODE_1239_length_2095_cov_29.930862	1128	1209	243	1	81	0.0123457
NODE_1239_length_2095_cov_29.930862	1128	1209	250	1	81	0.0123457
NODE_1239_length_2095_cov_29.930862	1128	1209	264	1	81	0.0123457
NODE_1239_length_2095_cov_29.930862	1128	1209	268	2	81	0.0246914
NODE_1239_length_2095_cov_29.930862	1128	1209	270	1	81	0.0123457
NODE_1239_length_2095_cov_29.930862	1128	1209	273	1	81	0.0123457
NODE_1239_length_2095_cov_29.930862	1128	1209	277	1	81	0.0123457
NODE_1239_length_2095_cov_29.930862	1128	1209	283	1	81	0.0123457
NODE_1239_length_2095_cov_29.930862	1128	1209	295	1	81	0.0123457
NODE_1239_length_2095_cov_29.930862	1128	1209	305	1	81	0.0123457
NODE_1239_length_2095_cov_29.930862	1128	1209	312	2	81	0.0246914
NODE_1239_length_2095_cov_29.930862	1128	1209	314	1	81	0.0123457
NODE_1239_length_2095_cov_29.930862	1128	1209	320	1	81	0.0123457
NODE_1239_length_2095_cov_29.930862	1128	1209	324	1	81	0.0123457
NODE_1239_length_2095_cov_29.930862	1128	1209	326	1	81	0.0123457
NODE_1239_length_2095_cov_29.930862	1128	1209	339	1	81	0.0123457
NODE_1239_length_2095_cov_29.930862	1128	1209	349	2	81	0.0246914
NODE_1239_length_2095_cov_29.930862	1128	1209	357	1	81	0.0123457
NODE_1239_length_2095_cov_29.930862	1128	1209	359	1	81	0.0123457
NODE_1239_length_2095_cov_29.930862	1128	1209	369	1	81	0.0123457
NODE_1239_length_2095_cov_29.930862	1128	1209	375	1	81	0.0123457
NODE_1239_length_2095_cov_29.930862	1128	1209	381	1	81	0.0123457
NODE_1239_length_2095_cov_29.930862	1128	1209	382	1	81	0.0123457
NODE_1239_length_2095_cov_29.930862	1128	1209	387	1	81	0.0123457
NODE_1239_length_2095_cov_29.930862	1128	1209	389	1	81	0.0123457
NODE_1239_length_2095_cov_29.930862	1128	1209	391	3	81	0.0370370
NODE_1239_length_2095_cov_29.930862	1128	1209	395	1	81	0.0123457
NODE_1239_length_2095_cov_29.930862	1128	1209	402	1	81	0.0123457
NODE_1239_length_2095_cov_29.930862	1128	1209	408	1	81	0.0123457
NODE_1239_length_2095_cov_29.930862	1128	1209	434	1	81	0.0123457
NODE_1239_length_2095_cov_29.930862	1128	1209	438	1	81	0.0123457
NODE_1239_length_2095_cov_29.930862	1128	1209	446	1	81	0.0123457
NODE_1239_length_2095_cov_29.930862	1128	1209	452	1	81	0.0123457
NODE_1239_length_2095_cov_29.930862	1128	1209	465	1	81	0.0123457
NODE_1239_length_2095_cov_29.930862	1128	1209	467	1	81	0.0123457
NODE_1239_length_2095_cov_29.930862	1128	1209	477	1	81	0.0123457
NODE_1239_length_2095_cov_29.930862	1128	1209	485	1	81	0.0123457
NODE_1239_length_2095_cov_29.930862	1128	1209	489	1	81	0.0123457
NODE_1239_length_2095_cov_29.930862	1128	1209	494	1	81	0.0123457
NODE_1239_length_2095_cov_29.930862	1128	1209	496	3	81	0.0370370
NODE_1239_length_2095_cov_29.930862	1128	1209	502	1	81	0.0123457
NODE_1239_length_2095_cov_29.930862	1128	1209	510	1	81	0.0123457
NODE_1239_length_2095_cov_29.930862	1128	1209	513	1	81	0.0123457
NODE_1239_length_2095_cov_29.930862	1128	1209	516	1	81	0.0123457
NODE_1239_length_2095_cov_29.930862	1128	1209	520	1	81	0.0123457
NODE_1239_length_2095_cov_29.930862	1128	1209	522	1	81	0.0123457
NODE_1239_length_2095_cov_29.930862	1128	1209	536	1	81	0.0123457
NODE_1239_length_2095_cov_29.930862	1128	1209	544	1	81	0.0123457
NODE_1239_length_2095_cov_29.930862	1128	1209	547	1	81	0.0123457
NODE_1239_length_2095_cov_29.930862	1204	1258	520	1	54	0.0185185
NODE_1239_length_2095_cov_29.930862	1204	1258	522	1	54	0.0185185
NODE_1239_length_2095_cov_29.930862	1204	1258	536	1	54	0.0185185
NODE_1239_length_2095_cov_29.930862	1204	1258	544	1	54	0.0185185
NODE_1239_length_2095_cov_29.930862	1204	1258	547	1	54	0.0185185
NODE_1239_length_2095_cov_29.930862	1204	1258	562	1	54	0.0185185
NODE_1239_length_2095_cov_29.930862	1204	1258	570	1	54	0.0185185
NODE_1239_length_2095_cov_29.930862	1204	1258	571	1	54	0.0185185
NODE_1239_length_2095_cov_29.930862	1204	1258	573	2	54	0.0370370
NODE_1239_length_2095_cov_29.930862	1204	1258	582	1	54	0.0185185
NODE_1239_length_2095_cov_29.930862	1204	1258	587	1	54	0.0185185
NODE_1239_length_2095_cov_29.930862	1204	1258	590	1	54	0.0185185
NODE_1239_length_2095_cov_29.930862	1204	1258	591	1	54	0.0185185
NODE_1239_length_2095_cov_29.930862	1204	1258	592	1	54	0.0185185
NODE_1239_length_2095_cov_29.930862	1204	1258	593	2	54	0.0370370
NODE_1239_length_2095_cov_29.930862	1204	1258	599	1	54	0.0185185
NODE_1239_length_2095_cov_29.930862	1204	1258	603	1	54	0.0185185
NODE_1239_length_2095_cov_29.930862	1204	1258	605	1	54	0.0185185
NODE_1239_length_2095_cov_29.930862	1204	1258	607	2	54	0.0370370
NODE_1239_length_2095_cov_29.930862	1204	1258	608	1	54	0.0185185
NODE_1239_length_2095_cov_29.930862	1204	1258	609	1	54	0.0185185
NODE_1239_length_2095_cov_29.930862	1204	1258	610	3	54	0.0555556
NODE_1239_length_2095_cov_29.930862	1204	1258	611	1	54	0.0185185
NODE_1239_length_2095_cov_29.930862	1204	1258	613	1	54	0.0185185
NODE_1239_length_2095_cov_29.930862	1204	1258	614	2	54	0.0370370
NODE_1239_length_2095_cov_29.930862	1204	1258	616	1	54	0.0185185
NODE_1239_length_2095_cov_29.930862	1204	1258	617	1	54	0.0185185
NODE_1239_length_2095_cov_29.930862	1204	1258	619	1	54	0.0185185
NODE_1239_length_2095_cov_29.930862	1204	1258	621	2	54	0.0370370
NODE_1239_length_2095_cov_29.930862	1204	1258	622	1	54	0.0185185
NODE_1239_length_2095_cov_29.930862	1204	1258	626	2	54	0.0370370
NODE_1239_length_2095_cov_29.930862	1204	1258	629	2	54	0.0370370
NODE_1239_length_2095_cov_29.930862	1204	1258	630	1	54	0.0185185
NODE_1239_length_2095_cov_29.930862	1204	1258	631	1	54	0.0185185
NODE_1239_length_2095_cov_29.930862	1204	1258	632	1	54	0.0185185
NODE_1239_length_2095_cov_29.930862	1204	1258	633	5	54	0.0925926
NODE_1239_length_2095_cov_29.930862	1204	1258	634	1	54	0.0185185
NODE_1239_length_2095_cov_29.930862	1204	1258	637	2	54	0.0370370
NODE_1239_length_2095_cov_29.930862	1204	1258	638	1	54	0.0185185
NODE_1239_length_2095_cov_29.930862	1204	1258	640	1	54	0.0185185
NODE_1251_length_2084_cov_1.720403	959	1039	4	7	80	0.0875000
NODE_1251_length_2084_cov_1.720403	959	1039	5	1	80	0.0125000
NODE_1251_length_2084_cov_1.720403	959	1039	6	34	80	0.4250000
NODE_1251_length_2084_cov_1.720403	959	1039	8	14	80	0.1750000
NODE_1251_length_2084_cov_1.720403	959	1039	10	24	80	0.3000000
NODE_1251_length_2084_cov_1.720403	1012	1092	2	28	80	0.3500000
NODE_1251_length_2084_cov_1.720403	1012	1092	4	16	80	0.2000000
NODE_1251_length_2084_cov_1.720403	1012	1092	5	1	80	0.0125000
NODE_1251_length_2084_cov_1.720403	1012	1092	6	35	80	0.4375000
NODE_1252_length_2083_cov_5.864415	419	499	0	6	80	0.0750000
NODE_1252_length_2083_cov_5.864415	419	499	2	15	80	0.1875000
NODE_1252_length_2083_cov_5.864415	419	499	4	59	80	0.7375000
NODE_1252_length_2083_cov_5.864415	472	552	0	59	80	0.7375000
NODE_1252_length_2083_cov_5.864415	472	552	2	15	80	0.1875000
NODE_1252_length_2083_cov_5.864415	472	552	4	6	80	0.0750000
NODE_1252_length_2083_cov_5.864415	548	628	0	41	80	0.5125000
NODE_1252_length_2083_cov_5.864415	548	628	2	39	80	0.4875000
NODE_1252_length_2083_cov_5.864415	601	681	2	80	80	1.0000000
NODE_1256_length_2078_cov_47.394644	311	391	2	80	80	1.0000000
NODE_1256_length_2078_cov_47.394644	364	444	0	26	80	0.3250000
NODE_1256_length_2078_cov_47.394644	364	444	2	54	80	0.6750000
NODE_1256_length_2078_cov_47.394644	440	520	0	61	80	0.7625000
NODE_1256_length_2078_cov_47.394644	440	520	4	19	80	0.2375000
NODE_1256_length_2078_cov_47.394644	493	573	0	8	80	0.1000000
NODE_1256_length_2078_cov_47.394644	493	573	4	72	80	0.9000000
NODE_1267_length_2067_cov_13.647866	1349	1429	0	31	80	0.3875000
NODE_1267_length_2067_cov_13.647866	1349	1429	2	49	80	0.6125000
NODE_1267_length_2067_cov_13.647866	1402	1482	0	80	80	1.0000000
NODE_1269_length_2066_cov_19.127605	1497	1577	6	33	80	0.4125000
NODE_1269_length_2066_cov_19.127605	1497	1577	14	15	80	0.1875000
NODE_1269_length_2066_cov_19.127605	1497	1577	15	1	80	0.0125000
NODE_1269_length_2066_cov_19.127605	1497	1577	16	31	80	0.3875000
NODE_1269_length_2066_cov_19.127605	1550	1630	10	27	80	0.3375000
NODE_1269_length_2066_cov_19.127605	1550	1630	14	41	80	0.5125000
NODE_1269_length_2066_cov_19.127605	1550	1630	16	12	80	0.1500000
NODE_1274_length_2061_cov_43.187054	364	444	0	80	80	1.0000000
NODE_1274_length_2061_cov_43.187054	417	497	0	80	80	1.0000000
NODE_1275_length_2061_cov_3.251784	981	1033	0	52	52	1.0000000
NODE_1275_length_2061_cov_3.251784	1006	1086	0	80	80	1.0000000
NODE_1277_length_2058_cov_4.531394	1844	1875	0	2	31	0.0645161
NODE_1277_length_2058_cov_4.531394	1844	1875	2	15	31	0.4838710
NODE_1277_length_2058_cov_4.531394	1844	1875	3	4	31	0.1290323
NODE_1277_length_2058_cov_4.531394	1844	1875	5	10	31	0.3225806
NODE_1277_length_2058_cov_4.531394	1848	1928	0	2	80	0.0250000
NODE_1277_length_2058_cov_4.531394	1848	1928	2	12	80	0.1500000
NODE_1277_length_2058_cov_4.531394	1848	1928	3	3	80	0.0375000
NODE_1277_length_2058_cov_4.531394	1848	1928	5	14	80	0.1750000
NODE_1277_length_2058_cov_4.531394	1848	1928	6	18	80	0.2250000
NODE_1277_length_2058_cov_4.531394	1848	1928	8	12	80	0.1500000
NODE_1277_length_2058_cov_4.531394	1848	1928	10	2	80	0.0250000
NODE_1277_length_2058_cov_4.531394	1848	1928	12	1	80	0.0125000
NODE_1277_length_2058_cov_4.531394	1848	1928	14	16	80	0.2000000
NODE_1279_length_2056_cov_20.525805	749	829	0	75	80	0.9375000
NODE_1279_length_2056_cov_20.525805	749	829	2	5	80	0.0625000
NODE_1279_length_2056_cov_20.525805	802	882	0	22	80	0.2750000
NODE_1279_length_2056_cov_20.525805	802	882	2	6	80	0.0750000
NODE_1279_length_2056_cov_20.525805	802	882	11	1	80	0.0125000
NODE_1279_length_2056_cov_20.525805	802	882	12	51	80	0.6375000
NODE_1279_length_2056_cov_20.525805	878	958	10	5	80	0.0625000
NODE_1279_length_2056_cov_20.525805	878	958	12	33	80	0.4125000
NODE_1279_length_2056_cov_20.525805	878	958	14	42	80	0.5250000
NODE_1279_length_2056_cov_20.525805	931	1011	0	51	80	0.6375000
NODE_1279_length_2056_cov_20.525805	931	1011	9	1	80	0.0125000
NODE_1279_length_2056_cov_20.525805	931	1011	10	6	80	0.0750000
NODE_1279_length_2056_cov_20.525805	931	1011	12	22	80	0.2750000
NODE_1281_length_2055_cov_10.047546	1468	1548	2	47	80	0.5875000
NODE_1281_length_2055_cov_10.047546	1468	1548	4	33	80	0.4125000
NODE_1281_length_2055_cov_10.047546	1521	1601	0	42	80	0.5250000
NODE_1281_length_2055_cov_10.047546	1521	1601	2	38	80	0.4750000
NODE_1286_length_2049_cov_6.846154	270	350	0	80	80	1.0000000
NODE_1286_length_2049_cov_6.846154	323	403	0	80	80	1.0000000
NODE_1286_length_2049_cov_6.846154	1595	1674	0	79	79	1.0000000
NODE_1286_length_2049_cov_6.846154	1648	1712	0	64	64	1.0000000
NODE_1293_length_2045_cov_46.790339	876	956	6	15	80	0.1875000
NODE_1293_length_2045_cov_46.790339	876	956	9	1	80	0.0125000
NODE_1293_length_2045_cov_46.790339	876	956	10	1	80	0.0125000
NODE_1293_length_2045_cov_46.790339	876	956	12	5	80	0.0625000
NODE_1293_length_2045_cov_46.790339	876	956	13	7	80	0.0875000
NODE_1293_length_2045_cov_46.790339	876	956	14	1	80	0.0125000
NODE_1293_length_2045_cov_46.790339	876	956	16	14	80	0.1750000
NODE_1293_length_2045_cov_46.790339	876	956	18	36	80	0.4500000
NODE_1293_length_2045_cov_46.790339	929	1009	6	35	80	0.4375000
NODE_1293_length_2045_cov_46.790339	929	1009	9	1	80	0.0125000
NODE_1293_length_2045_cov_46.790339	929	1009	10	27	80	0.3375000
NODE_1293_length_2045_cov_46.790339	929	1009	12	5	80	0.0625000
NODE_1293_length_2045_cov_46.790339	929	1009	13	5	80	0.0625000
NODE_1293_length_2045_cov_46.790339	929	1009	14	7	80	0.0875000
NODE_1293_length_2045_cov_46.790339	1005	1085	8	43	80	0.5375000
NODE_1293_length_2045_cov_46.790339	1005	1085	10	7	80	0.0875000
NODE_1293_length_2045_cov_46.790339	1005	1085	12	17	80	0.2125000
NODE_1293_length_2045_cov_46.790339	1005	1085	14	13	80	0.1625000
NODE_1293_length_2045_cov_46.790339	1058	1138	4	50	80	0.6250000
NODE_1293_length_2045_cov_46.790339	1058	1138	8	27	80	0.3375000
NODE_1293_length_2045_cov_46.790339	1058	1138	12	3	80	0.0375000
NODE_1298_length_2042_cov_4.447761	241	315	0	22	74	0.2972973
NODE_1298_length_2042_cov_4.447761	241	315	2	27	74	0.3648649
NODE_1298_length_2042_cov_4.447761	241	315	4	25	74	0.3378378
NODE_1301_length_2040_cov_30.109737	1760	1844	531	3	84	0.0357143
NODE_1301_length_2040_cov_30.109737	1760	1844	532	1	84	0.0119048
NODE_1301_length_2040_cov_30.109737	1760	1844	539	1	84	0.0119048
NODE_1301_length_2040_cov_30.109737	1760	1844	542	1	84	0.0119048
NODE_1301_length_2040_cov_30.109737	1760	1844	543	1	84	0.0119048
NODE_1301_length_2040_cov_30.109737	1760	1844	545	1	84	0.0119048
NODE_1301_length_2040_cov_30.109737	1760	1844	549	1	84	0.0119048
NODE_1301_length_2040_cov_30.109737	1760	1844	560	1	84	0.0119048
NODE_1301_length_2040_cov_30.109737	1760	1844	561	1	84	0.0119048
NODE_1301_length_2040_cov_30.109737	1760	1844	564	1	84	0.0119048
NODE_1301_length_2040_cov_30.109737	1760	1844	565	1	84	0.0119048
NODE_1301_length_2040_cov_30.109737	1760	1844	568	1	84	0.0119048
NODE_1301_length_2040_cov_30.109737	1760	1844	586	1	84	0.0119048
NODE_1301_length_2040_cov_30.109737	1760	1844	588	1	84	0.0119048
NODE_1301_length_2040_cov_30.109737	1760	1844	591	1	84	0.0119048
NODE_1301_length_2040_cov_30.109737	1760	1844	592	1	84	0.0119048
NODE_1301_length_2040_cov_30.109737	1760	1844	593	1	84	0.0119048
NODE_1301_length_2040_cov_30.109737	1760	1844	594	1	84	0.0119048
NODE_1301_length_2040_cov_30.109737	1760	1844	595	2	84	0.0238095
NODE_1301_length_2040_cov_30.109737	1760	1844	596	1	84	0.0119048
NODE_1301_length_2040_cov_30.109737	1760	1844	598	1	84	0.0119048
NODE_1301_length_2040_cov_30.109737	1760	1844	601	1	84	0.0119048
NODE_1301_length_2040_cov_30.109737	1760	1844	603	1	84	0.0119048
NODE_1301_length_2040_cov_30.109737	1760	1844	605	2	84	0.0238095
NODE_1301_length_2040_cov_30.109737	1760	1844	609	1	84	0.0119048
NODE_1301_length_2040_cov_30.109737	1760	1844	611	1	84	0.0119048
NODE_1301_length_2040_cov_30.109737	1760	1844	613	1	84	0.0119048
NODE_1301_length_2040_cov_30.109737	1760	1844	622	2	84	0.0238095
NODE_1301_length_2040_cov_30.109737	1760	1844	623	2	84	0.0238095
NODE_1301_length_2040_cov_30.109737	1760	1844	626	1	84	0.0119048
NODE_1301_length_2040_cov_30.109737	1760	1844	628	1	84	0.0119048
NODE_1301_length_2040_cov_30.109737	1760	1844	630	2	84	0.0238095
NODE_1301_length_2040_cov_30.109737	1760	1844	636	1	84	0.0119048
NODE_1301_length_2040_cov_30.109737	1760	1844	637	2	84	0.0238095
NODE_1301_length_2040_cov_30.109737	1760	1844	638	1	84	0.0119048
NODE_1301_length_2040_cov_30.109737	1760	1844	639	1	84	0.0119048
NODE_1301_length_2040_cov_30.109737	1760	1844	640	3	84	0.0357143
NODE_1301_length_2040_cov_30.109737	1760	1844	641	1	84	0.0119048
NODE_1301_length_2040_cov_30.109737	1760	1844	643	2	84	0.0238095
NODE_1301_length_2040_cov_30.109737	1760	1844	644	2	84	0.0238095
NODE_1301_length_2040_cov_30.109737	1760	1844	645	4	84	0.0476190
NODE_1301_length_2040_cov_30.109737	1760	1844	646	3	84	0.0357143
NODE_1301_length_2040_cov_30.109737	1760	1844	647	2	84	0.0238095
NODE_1301_length_2040_cov_30.109737	1760	1844	648	4	84	0.0476190
NODE_1301_length_2040_cov_30.109737	1760	1844	649	3	84	0.0357143
NODE_1301_length_2040_cov_30.109737	1760	1844	650	4	84	0.0476190
NODE_1301_length_2040_cov_30.109737	1760	1844	651	3	84	0.0357143
NODE_1301_length_2040_cov_30.109737	1760	1844	652	1	84	0.0119048
NODE_1301_length_2040_cov_30.109737	1760	1844	653	2	84	0.0238095
NODE_1301_length_2040_cov_30.109737	1760	1844	654	1	84	0.0119048
NODE_1301_length_2040_cov_30.109737	1760	1844	656	2	84	0.0238095
NODE_1301_length_2040_cov_30.109737	1760	1844	657	1	84	0.0119048
NODE_1301_length_2040_cov_30.109737	1760	1844	660	1	84	0.0119048
NODE_1301_length_2040_cov_30.109737	1760	1844	662	1	84	0.0119048
NODE_1306_length_2036_cov_11.672173	369	449	2	80	80	1.0000000
NODE_1306_length_2036_cov_11.672173	422	502	0	30	80	0.3750000
NODE_1306_length_2036_cov_11.672173	422	502	2	50	80	0.6250000
NODE_1312_length_2032_cov_11.188308	416	496	0	80	80	1.0000000
NODE_1312_length_2032_cov_11.188308	469	549	0	80	80	1.0000000
NODE_1318_length_2027_cov_43.702282	1129	1209	0	80	80	1.0000000
NODE_1318_length_2027_cov_43.702282	1182	1262	0	59	80	0.7375000
NODE_1318_length_2027_cov_43.702282	1182	1262	12	1	80	0.0125000
NODE_1318_length_2027_cov_43.702282	1182	1262	13	20	80	0.2500000
NODE_1318_length_2027_cov_43.702282	1258	1338	12	15	80	0.1875000
NODE_1318_length_2027_cov_43.702282	1258	1338	13	38	80	0.4750000
NODE_1318_length_2027_cov_43.702282	1258	1338	14	27	80	0.3375000
NODE_1318_length_2027_cov_43.702282	1311	1391	0	45	80	0.5625000
NODE_1318_length_2027_cov_43.702282	1311	1391	11	3	80	0.0375000
NODE_1318_length_2027_cov_43.702282	1311	1391	12	20	80	0.2500000
NODE_1318_length_2027_cov_43.702282	1311	1391	13	12	80	0.1500000
NODE_1319_length_2027_cov_6.558610	229	303	0	16	74	0.2162162
NODE_1319_length_2027_cov_6.558610	229	303	2	58	74	0.7837838
NODE_1319_length_2027_cov_6.558610	229	303	0	16	74	0.2162162
NODE_1319_length_2027_cov_6.558610	229	303	2	58	74	0.7837838
NODE_1319_length_2027_cov_6.558610	276	356	0	43	80	0.5375000
NODE_1319_length_2027_cov_6.558610	276	356	2	37	80	0.4625000
NODE_1320_length_2026_cov_18.457706	688	768	0	7	80	0.0875000
NODE_1320_length_2026_cov_18.457706	688	768	2	73	80	0.9125000
NODE_1320_length_2026_cov_18.457706	741	821	2	80	80	1.0000000
NODE_1324_length_2025_cov_10.711319	617	697	0	20	80	0.2500000
NODE_1324_length_2025_cov_10.711319	617	697	2	17	80	0.2125000
NODE_1324_length_2025_cov_10.711319	617	697	4	43	80	0.5375000
NODE_1324_length_2025_cov_10.711319	712	783	2	9	71	0.1267606
NODE_1324_length_2025_cov_10.711319	712	783	4	48	71	0.6760563
NODE_1324_length_2025_cov_10.711319	712	783	6	14	71	0.1971831
NODE_1324_length_2025_cov_10.711319	756	829	0	2	73	0.0273973
NODE_1324_length_2025_cov_10.711319	756	829	2	53	73	0.7260274
NODE_1324_length_2025_cov_10.711319	756	829	4	18	73	0.2465753
NODE_1325_length_2024_cov_33.891948	1045	1125	0	51	80	0.6375000
NODE_1325_length_2024_cov_33.891948	1045	1125	4	29	80	0.3625000
NODE_1325_length_2024_cov_33.891948	1098	1178	0	7	80	0.0875000
NODE_1325_length_2024_cov_33.891948	1098	1178	4	73	80	0.9125000
NODE_1331_length_2018_cov_33.742053	1215	1295	179	2	80	0.0250000
NODE_1331_length_2018_cov_33.742053	1215	1295	180	1	80	0.0125000
NODE_1331_length_2018_cov_33.742053	1215	1295	183	1	80	0.0125000
NODE_1331_length_2018_cov_33.742053	1215	1295	184	1	80	0.0125000
NODE_1331_length_2018_cov_33.742053	1215	1295	185	2	80	0.0250000
NODE_1331_length_2018_cov_33.742053	1215	1295	205	2	80	0.0250000
NODE_1331_length_2018_cov_33.742053	1215	1295	215	1	80	0.0125000
NODE_1331_length_2018_cov_33.742053	1215	1295	217	1	80	0.0125000
NODE_1331_length_2018_cov_33.742053	1215	1295	221	1	80	0.0125000
NODE_1331_length_2018_cov_33.742053	1215	1295	229	1	80	0.0125000
NODE_1331_length_2018_cov_33.742053	1215	1295	230	1	80	0.0125000
NODE_1331_length_2018_cov_33.742053	1215	1295	231	2	80	0.0250000
NODE_1331_length_2018_cov_33.742053	1215	1295	233	1	80	0.0125000
NODE_1331_length_2018_cov_33.742053	1215	1295	234	1	80	0.0125000
NODE_1331_length_2018_cov_33.742053	1215	1295	235	5	80	0.0625000
NODE_1331_length_2018_cov_33.742053	1215	1295	236	4	80	0.0500000
NODE_1331_length_2018_cov_33.742053	1215	1295	237	1	80	0.0125000
NODE_1331_length_2018_cov_33.742053	1215	1295	241	2	80	0.0250000
NODE_1331_length_2018_cov_33.742053	1215	1295	243	1	80	0.0125000
NODE_1331_length_2018_cov_33.742053	1215	1295	245	3	80	0.0375000
NODE_1331_length_2018_cov_33.742053	1215	1295	246	2	80	0.0250000
NODE_1331_length_2018_cov_33.742053	1215	1295	247	1	80	0.0125000
NODE_1331_length_2018_cov_33.742053	1215	1295	251	1	80	0.0125000
NODE_1331_length_2018_cov_33.742053	1215	1295	252	1	80	0.0125000
NODE_1331_length_2018_cov_33.742053	1215	1295	253	1	80	0.0125000
NODE_1331_length_2018_cov_33.742053	1215	1295	257	1	80	0.0125000
NODE_1331_length_2018_cov_33.742053	1215	1295	260	2	80	0.0250000
NODE_1331_length_2018_cov_33.742053	1215	1295	262	1	80	0.0125000
NODE_1331_length_2018_cov_33.742053	1215	1295	264	2	80	0.0250000
NODE_1331_length_2018_cov_33.742053	1215	1295	266	1	80	0.0125000
NODE_1331_length_2018_cov_33.742053	1215	1295	278	1	80	0.0125000
NODE_1331_length_2018_cov_33.742053	1215	1295	279	2	80	0.0250000
NODE_1331_length_2018_cov_33.742053	1215	1295	280	3	80	0.0375000
NODE_1331_length_2018_cov_33.742053	1215	1295	288	1	80	0.0125000
NODE_1331_length_2018_cov_33.742053	1215	1295	289	1	80	0.0125000
NODE_1331_length_2018_cov_33.742053	1215	1295	290	1	80	0.0125000
NODE_1331_length_2018_cov_33.742053	1215	1295	292	3	80	0.0375000
NODE_1331_length_2018_cov_33.742053	1215	1295	294	1	80	0.0125000
NODE_1331_length_2018_cov_33.742053	1215	1295	296	3	80	0.0375000
NODE_1331_length_2018_cov_33.742053	1215	1295	300	1	80	0.0125000
NODE_1331_length_2018_cov_33.742053	1215	1295	302	1	80	0.0125000
NODE_1331_length_2018_cov_33.742053	1215	1295	304	2	80	0.0250000
NODE_1331_length_2018_cov_33.742053	1215	1295	306	2	80	0.0250000
NODE_1331_length_2018_cov_33.742053	1215	1295	307	2	80	0.0250000
NODE_1331_length_2018_cov_33.742053	1215	1295	309	2	80	0.0250000
NODE_1331_length_2018_cov_33.742053	1215	1295	311	2	80	0.0250000
NODE_1331_length_2018_cov_33.742053	1215	1295	312	4	80	0.0500000
NODE_1331_length_2018_cov_33.742053	1215	1295	317	1	80	0.0125000
NODE_1331_length_2018_cov_33.742053	1268	1298	288	1	30	0.0333333
NODE_1331_length_2018_cov_33.742053	1268	1298	289	1	30	0.0333333
NODE_1331_length_2018_cov_33.742053	1268	1298	290	1	30	0.0333333
NODE_1331_length_2018_cov_33.742053	1268	1298	292	3	30	0.1000000
NODE_1331_length_2018_cov_33.742053	1268	1298	294	1	30	0.0333333
NODE_1331_length_2018_cov_33.742053	1268	1298	296	3	30	0.1000000
NODE_1331_length_2018_cov_33.742053	1268	1298	300	1	30	0.0333333
NODE_1331_length_2018_cov_33.742053	1268	1298	302	1	30	0.0333333
NODE_1331_length_2018_cov_33.742053	1268	1298	304	2	30	0.0666667
NODE_1331_length_2018_cov_33.742053	1268	1298	306	2	30	0.0666667
NODE_1331_length_2018_cov_33.742053	1268	1298	307	2	30	0.0666667
NODE_1331_length_2018_cov_33.742053	1268	1298	309	2	30	0.0666667
NODE_1331_length_2018_cov_33.742053	1268	1298	311	2	30	0.0666667
NODE_1331_length_2018_cov_33.742053	1268	1298	312	4	30	0.1333333
NODE_1331_length_2018_cov_33.742053	1268	1298	317	1	30	0.0333333
NODE_1331_length_2018_cov_33.742053	1268	1298	319	1	30	0.0333333
NODE_1331_length_2018_cov_33.742053	1268	1298	324	1	30	0.0333333
NODE_1331_length_2018_cov_33.742053	1268	1298	326	1	30	0.0333333
NODE_1331_length_2018_cov_33.742053	1876	1942	109	1	66	0.0151515
NODE_1331_length_2018_cov_33.742053	1876	1942	112	3	66	0.0454545
NODE_1331_length_2018_cov_33.742053	1876	1942	116	1	66	0.0151515
NODE_1331_length_2018_cov_33.742053	1876	1942	120	1	66	0.0151515
NODE_1331_length_2018_cov_33.742053	1876	1942	127	1	66	0.0151515
NODE_1331_length_2018_cov_33.742053	1876	1942	136	1	66	0.0151515
NODE_1331_length_2018_cov_33.742053	1876	1942	141	1	66	0.0151515
NODE_1331_length_2018_cov_33.742053	1876	1942	149	3	66	0.0454545
NODE_1331_length_2018_cov_33.742053	1876	1942	153	1	66	0.0151515
NODE_1331_length_2018_cov_33.742053	1876	1942	156	1	66	0.0151515
NODE_1331_length_2018_cov_33.742053	1876	1942	161	2	66	0.0303030
NODE_1331_length_2018_cov_33.742053	1876	1942	167	1	66	0.0151515
NODE_1331_length_2018_cov_33.742053	1876	1942	169	1	66	0.0151515
NODE_1331_length_2018_cov_33.742053	1876	1942	170	2	66	0.0303030
NODE_1331_length_2018_cov_33.742053	1876	1942	171	2	66	0.0303030
NODE_1331_length_2018_cov_33.742053	1876	1942	173	1	66	0.0151515
NODE_1331_length_2018_cov_33.742053	1876	1942	177	1	66	0.0151515
NODE_1331_length_2018_cov_33.742053	1876	1942	184	1	66	0.0151515
NODE_1331_length_2018_cov_33.742053	1876	1942	187	3	66	0.0454545
NODE_1331_length_2018_cov_33.742053	1876	1942	193	1	66	0.0151515
NODE_1331_length_2018_cov_33.742053	1876	1942	199	2	66	0.0303030
NODE_1331_length_2018_cov_33.742053	1876	1942	200	1	66	0.0151515
NODE_1331_length_2018_cov_33.742053	1876	1942	201	1	66	0.0151515
NODE_1331_length_2018_cov_33.742053	1876	1942	208	1	66	0.0151515
NODE_1331_length_2018_cov_33.742053	1876	1942	210	2	66	0.0303030
NODE_1331_length_2018_cov_33.742053	1876	1942	221	1	66	0.0151515
NODE_1331_length_2018_cov_33.742053	1876	1942	225	1	66	0.0151515
NODE_1331_length_2018_cov_33.742053	1876	1942	227	2	66	0.0303030
NODE_1331_length_2018_cov_33.742053	1876	1942	229	1	66	0.0151515
NODE_1331_length_2018_cov_33.742053	1876	1942	230	1	66	0.0151515
NODE_1331_length_2018_cov_33.742053	1876	1942	241	1	66	0.0151515
NODE_1331_length_2018_cov_33.742053	1876	1942	245	1	66	0.0151515
NODE_1331_length_2018_cov_33.742053	1876	1942	253	1	66	0.0151515
NODE_1331_length_2018_cov_33.742053	1876	1942	257	1	66	0.0151515
NODE_1331_length_2018_cov_33.742053	1876	1942	263	1	66	0.0151515
NODE_1331_length_2018_cov_33.742053	1876	1942	271	1	66	0.0151515
NODE_1331_length_2018_cov_33.742053	1876	1942	272	1	66	0.0151515
NODE_1331_length_2018_cov_33.742053	1876	1942	274	1	66	0.0151515
NODE_1331_length_2018_cov_33.742053	1876	1942	280	1	66	0.0151515
NODE_1331_length_2018_cov_33.742053	1876	1942	284	1	66	0.0151515
NODE_1331_length_2018_cov_33.742053	1876	1942	285	2	66	0.0303030
NODE_1331_length_2018_cov_33.742053	1876	1942	288	2	66	0.0303030
NODE_1331_length_2018_cov_33.742053	1876	1942	290	1	66	0.0151515
NODE_1331_length_2018_cov_33.742053	1876	1942	297	1	66	0.0151515
NODE_1331_length_2018_cov_33.742053	1876	1942	299	1	66	0.0151515
NODE_1331_length_2018_cov_33.742053	1876	1942	300	1	66	0.0151515
NODE_1331_length_2018_cov_33.742053	1876	1942	303	1	66	0.0151515
NODE_1331_length_2018_cov_33.742053	1876	1942	311	1	66	0.0151515
NODE_1331_length_2018_cov_33.742053	1876	1942	313	1	66	0.0151515
NODE_1331_length_2018_cov_33.742053	1876	1942	324	1	66	0.0151515
NODE_1331_length_2018_cov_33.742053	1876	1942	328	1	66	0.0151515
NODE_1331_length_2018_cov_33.742053	1876	1942	329	1	66	0.0151515
NODE_1331_length_2018_cov_33.742053	1915	1995	25	1	80	0.0125000
NODE_1331_length_2018_cov_33.742053	1915	1995	27	1	80	0.0125000
NODE_1331_length_2018_cov_33.742053	1915	1995	31	2	80	0.0250000
NODE_1331_length_2018_cov_33.742053	1915	1995	35	1	80	0.0125000
NODE_1331_length_2018_cov_33.742053	1915	1995	37	1	80	0.0125000
NODE_1331_length_2018_cov_33.742053	1915	1995	42	1	80	0.0125000
NODE_1331_length_2018_cov_33.742053	1915	1995	45	1	80	0.0125000
NODE_1331_length_2018_cov_33.742053	1915	1995	46	2	80	0.0250000
NODE_1331_length_2018_cov_33.742053	1915	1995	48	1	80	0.0125000
NODE_1331_length_2018_cov_33.742053	1915	1995	54	2	80	0.0250000
NODE_1331_length_2018_cov_33.742053	1915	1995	57	2	80	0.0250000
NODE_1331_length_2018_cov_33.742053	1915	1995	60	2	80	0.0250000
NODE_1331_length_2018_cov_33.742053	1915	1995	62	4	80	0.0500000
NODE_1331_length_2018_cov_33.742053	1915	1995	66	1	80	0.0125000
NODE_1331_length_2018_cov_33.742053	1915	1995	68	1	80	0.0125000
NODE_1331_length_2018_cov_33.742053	1915	1995	71	1	80	0.0125000
NODE_1331_length_2018_cov_33.742053	1915	1995	75	6	80	0.0750000
NODE_1331_length_2018_cov_33.742053	1915	1995	82	1	80	0.0125000
NODE_1331_length_2018_cov_33.742053	1915	1995	83	1	80	0.0125000
NODE_1331_length_2018_cov_33.742053	1915	1995	87	4	80	0.0500000
NODE_1331_length_2018_cov_33.742053	1915	1995	90	2	80	0.0250000
NODE_1331_length_2018_cov_33.742053	1915	1995	96	1	80	0.0125000
NODE_1331_length_2018_cov_33.742053	1915	1995	97	4	80	0.0500000
NODE_1331_length_2018_cov_33.742053	1915	1995	98	1	80	0.0125000
NODE_1331_length_2018_cov_33.742053	1915	1995	99	4	80	0.0500000
NODE_1331_length_2018_cov_33.742053	1915	1995	101	1	80	0.0125000
NODE_1331_length_2018_cov_33.742053	1915	1995	103	1	80	0.0125000
NODE_1331_length_2018_cov_33.742053	1915	1995	105	2	80	0.0250000
NODE_1331_length_2018_cov_33.742053	1915	1995	107	1	80	0.0125000
NODE_1331_length_2018_cov_33.742053	1915	1995	109	1	80	0.0125000
NODE_1331_length_2018_cov_33.742053	1915	1995	112	3	80	0.0375000
NODE_1331_length_2018_cov_33.742053	1915	1995	116	1	80	0.0125000
NODE_1331_length_2018_cov_33.742053	1915	1995	120	1	80	0.0125000
NODE_1331_length_2018_cov_33.742053	1915	1995	127	1	80	0.0125000
NODE_1331_length_2018_cov_33.742053	1915	1995	136	1	80	0.0125000
NODE_1331_length_2018_cov_33.742053	1915	1995	141	1	80	0.0125000
NODE_1331_length_2018_cov_33.742053	1915	1995	149	3	80	0.0375000
NODE_1331_length_2018_cov_33.742053	1915	1995	153	1	80	0.0125000
NODE_1331_length_2018_cov_33.742053	1915	1995	156	1	80	0.0125000
NODE_1331_length_2018_cov_33.742053	1915	1995	161	2	80	0.0250000
NODE_1331_length_2018_cov_33.742053	1915	1995	167	1	80	0.0125000
NODE_1331_length_2018_cov_33.742053	1915	1995	169	1	80	0.0125000
NODE_1331_length_2018_cov_33.742053	1915	1995	170	2	80	0.0250000
NODE_1331_length_2018_cov_33.742053	1915	1995	171	2	80	0.0250000
NODE_1331_length_2018_cov_33.742053	1915	1995	173	1	80	0.0125000
NODE_1331_length_2018_cov_33.742053	1915	1995	177	1	80	0.0125000
NODE_1331_length_2018_cov_33.742053	1915	1995	184	1	80	0.0125000
NODE_1331_length_2018_cov_33.742053	1915	1995	187	2	80	0.0250000
NODE_1337_length_2011_cov_22.430439	434	514	4	80	80	1.0000000
NODE_1337_length_2011_cov_22.430439	487	567	0	52	80	0.6500000
NODE_1337_length_2011_cov_22.430439	487	567	4	28	80	0.3500000
NODE_1337_length_2011_cov_22.430439	1124	1204	0	12	80	0.1500000
NODE_1337_length_2011_cov_22.430439	1124	1204	2	68	80	0.8500000
NODE_1337_length_2011_cov_22.430439	1177	1257	0	28	80	0.3500000
NODE_1337_length_2011_cov_22.430439	1177	1257	2	52	80	0.6500000
NODE_1343_length_2001_cov_10.416404	692	772	0	1	80	0.0125000
NODE_1343_length_2001_cov_10.416404	692	772	10	1	80	0.0125000
NODE_1343_length_2001_cov_10.416404	692	772	12	78	80	0.9750000
NODE_1343_length_2001_cov_10.416404	745	825	0	32	80	0.4000000
NODE_1343_length_2001_cov_10.416404	745	825	12	48	80	0.6000000
NODE_1350_length_1991_cov_112.926533	212	292	255	4	80	0.0500000
NODE_1350_length_1991_cov_112.926533	212	292	256	1	80	0.0125000
NODE_1350_length_1991_cov_112.926533	212	292	269	1	80	0.0125000
NODE_1350_length_1991_cov_112.926533	212	292	270	1	80	0.0125000
NODE_1350_length_1991_cov_112.926533	212	292	276	1	80	0.0125000
NODE_1350_length_1991_cov_112.926533	212	292	277	1	80	0.0125000
NODE_1350_length_1991_cov_112.926533	212	292	278	2	80	0.0250000
NODE_1350_length_1991_cov_112.926533	212	292	279	1	80	0.0125000
NODE_1350_length_1991_cov_112.926533	212	292	282	3	80	0.0375000
NODE_1350_length_1991_cov_112.926533	212	292	293	3	80	0.0375000
NODE_1350_length_1991_cov_112.926533	212	292	294	2	80	0.0250000
NODE_1350_length_1991_cov_112.926533	212	292	297	1	80	0.0125000
NODE_1350_length_1991_cov_112.926533	212	292	301	2	80	0.0250000
NODE_1350_length_1991_cov_112.926533	212	292	302	2	80	0.0250000
NODE_1350_length_1991_cov_112.926533	212	292	303	4	80	0.0500000
NODE_1350_length_1991_cov_112.926533	212	292	305	1	80	0.0125000
NODE_1350_length_1991_cov_112.926533	212	292	306	1	80	0.0125000
NODE_1350_length_1991_cov_112.926533	212	292	307	4	80	0.0500000
NODE_1350_length_1991_cov_112.926533	212	292	311	2	80	0.0250000
NODE_1350_length_1991_cov_112.926533	212	292	314	2	80	0.0250000
NODE_1350_length_1991_cov_112.926533	212	292	317	2	80	0.0250000
NODE_1350_length_1991_cov_112.926533	212	292	321	1	80	0.0125000
NODE_1350_length_1991_cov_112.926533	212	292	324	3	80	0.0375000
NODE_1350_length_1991_cov_112.926533	212	292	326	1	80	0.0125000
NODE_1350_length_1991_cov_112.926533	212	292	328	1	80	0.0125000
NODE_1350_length_1991_cov_112.926533	212	292	331	2	80	0.0250000
NODE_1350_length_1991_cov_112.926533	212	292	332	2	80	0.0250000
NODE_1350_length_1991_cov_112.926533	212	292	338	2	80	0.0250000
NODE_1350_length_1991_cov_112.926533	212	292	339	1	80	0.0125000
NODE_1350_length_1991_cov_112.926533	212	292	346	2	80	0.0250000
NODE_1350_length_1991_cov_112.926533	212	292	352	1	80	0.0125000
NODE_1350_length_1991_cov_112.926533	212	292	353	5	80	0.0625000
NODE_1350_length_1991_cov_112.926533	212	292	354	1	80	0.0125000
NODE_1350_length_1991_cov_112.926533	212	292	356	4	80	0.0500000
NODE_1350_length_1991_cov_112.926533	212	292	357	4	80	0.0500000
NODE_1350_length_1991_cov_112.926533	212	292	358	4	80	0.0500000
NODE_1350_length_1991_cov_112.926533	212	292	359	4	80	0.0500000
NODE_1350_length_1991_cov_112.926533	212	292	361	1	80	0.0125000
NODE_1352_length_1988_cov_13.736368	865	945	0	17	80	0.2125000
NODE_1352_length_1988_cov_13.736368	865	945	2	3	80	0.0375000
NODE_1352_length_1988_cov_13.736368	865	945	4	4	80	0.0500000
NODE_1352_length_1988_cov_13.736368	865	945	6	2	80	0.0250000
NODE_1352_length_1988_cov_13.736368	865	945	8	34	80	0.4250000
NODE_1352_length_1988_cov_13.736368	865	945	10	20	80	0.2500000
NODE_1352_length_1988_cov_13.736368	918	998	2	7	80	0.0875000
NODE_1352_length_1988_cov_13.736368	918	998	4	4	80	0.0500000
NODE_1352_length_1988_cov_13.736368	918	998	6	3	80	0.0375000
NODE_1352_length_1988_cov_13.736368	918	998	8	32	80	0.4000000
NODE_1352_length_1988_cov_13.736368	918	998	10	34	80	0.4250000
NODE_1353_length_1988_cov_9.980413	1616	1696	0	80	80	1.0000000
NODE_1353_length_1988_cov_9.980413	1669	1749	0	80	80	1.0000000
NODE_1356_length_1983_cov_17.332803	494	574	0	67	80	0.8375000
NODE_1356_length_1983_cov_17.332803	494	574	2	13	80	0.1625000
NODE_1356_length_1983_cov_17.332803	547	627	0	80	80	1.0000000
NODE_1356_length_1983_cov_17.332803	1600	1680	0	79	80	0.9875000
NODE_1356_length_1983_cov_17.332803	1600	1680	2	1	80	0.0125000
NODE_1356_length_1983_cov_17.332803	1653	1733	0	80	80	1.0000000
NODE_1359_length_1982_cov_17.164100	457	537	0	80	80	1.0000000
NODE_1359_length_1982_cov_17.164100	510	590	0	80	80	1.0000000
NODE_1359_length_1982_cov_17.164100	586	666	0	80	80	1.0000000
NODE_1359_length_1982_cov_17.164100	639	723	0	84	84	1.0000000
NODE_1360_length_1981_cov_46.444208	0	70	4	70	70	1.0000000
NODE_1362_length_1979_cov_1.630851	1554	1634	0	80	80	1.0000000
NODE_1364_length_1976_cov_1.959510	154	215	15	4	61	0.0655738
NODE_1364_length_1976_cov_1.959510	154	215	16	57	61	0.9344262
NODE_1364_length_1976_cov_1.959510	154	215	15	4	61	0.0655738
NODE_1364_length_1976_cov_1.959510	154	215	16	57	61	0.9344262
NODE_1364_length_1976_cov_1.959510	154	213	15	4	59	0.0677966
NODE_1364_length_1976_cov_1.959510	154	213	16	55	59	0.9322034
NODE_1365_length_1974_cov_8.058133	617	697	58	2	80	0.0250000
NODE_1365_length_1974_cov_8.058133	617	697	59	6	80	0.0750000
NODE_1365_length_1974_cov_8.058133	617	697	60	16	80	0.2000000
NODE_1365_length_1974_cov_8.058133	617	697	61	5	80	0.0625000
NODE_1365_length_1974_cov_8.058133	617	697	62	10	80	0.1250000
NODE_1365_length_1974_cov_8.058133	617	697	63	7	80	0.0875000
NODE_1365_length_1974_cov_8.058133	617	697	64	9	80	0.1125000
NODE_1365_length_1974_cov_8.058133	617	697	65	2	80	0.0250000
NODE_1365_length_1974_cov_8.058133	617	697	66	1	80	0.0125000
NODE_1365_length_1974_cov_8.058133	617	697	67	1	80	0.0125000
NODE_1365_length_1974_cov_8.058133	617	697	68	7	80	0.0875000
NODE_1365_length_1974_cov_8.058133	617	697	70	1	80	0.0125000
NODE_1365_length_1974_cov_8.058133	617	697	72	6	80	0.0750000
NODE_1365_length_1974_cov_8.058133	617	697	74	4	80	0.0500000
NODE_1365_length_1974_cov_8.058133	617	697	75	3	80	0.0375000
NODE_1365_length_1974_cov_8.058133	670	750	26	8	80	0.1000000
NODE_1365_length_1974_cov_8.058133	670	750	30	1	80	0.0125000
NODE_1365_length_1974_cov_8.058133	670	750	35	1	80	0.0125000
NODE_1365_length_1974_cov_8.058133	670	750	36	1	80	0.0125000
NODE_1365_length_1974_cov_8.058133	670	750	37	1	80	0.0125000
NODE_1365_length_1974_cov_8.058133	670	750	38	4	80	0.0500000
NODE_1365_length_1974_cov_8.058133	670	750	39	2	80	0.0250000
NODE_1365_length_1974_cov_8.058133	670	750	41	5	80	0.0625000
NODE_1365_length_1974_cov_8.058133	670	750	43	2	80	0.0250000
NODE_1365_length_1974_cov_8.058133	670	750	44	3	80	0.0375000
NODE_1365_length_1974_cov_8.058133	670	750	48	3	80	0.0375000
NODE_1365_length_1974_cov_8.058133	670	750	52	18	80	0.2250000
NODE_1365_length_1974_cov_8.058133	670	750	55	2	80	0.0250000
NODE_1365_length_1974_cov_8.058133	670	750	56	2	80	0.0250000
NODE_1365_length_1974_cov_8.058133	670	750	58	2	80	0.0250000
NODE_1365_length_1974_cov_8.058133	670	750	63	7	80	0.0875000
NODE_1365_length_1974_cov_8.058133	670	750	65	1	80	0.0125000
NODE_1365_length_1974_cov_8.058133	670	750	68	3	80	0.0375000
NODE_1365_length_1974_cov_8.058133	670	750	70	1	80	0.0125000
NODE_1365_length_1974_cov_8.058133	670	750	72	6	80	0.0750000
NODE_1365_length_1974_cov_8.058133	670	750	74	4	80	0.0500000
NODE_1365_length_1974_cov_8.058133	670	750	75	3	80	0.0375000
NODE_1366_length_1973_cov_14.885272	640	726	6	86	86	1.0000000
NODE_1366_length_1973_cov_14.885272	699	779	0	41	80	0.5125000
NODE_1366_length_1973_cov_14.885272	699	779	6	39	80	0.4875000
NODE_1366_length_1973_cov_14.885272	1389	1469	0	42	80	0.5250000
NODE_1366_length_1973_cov_14.885272	1389	1469	2	38	80	0.4750000
NODE_1366_length_1973_cov_14.885272	1442	1522	0	15	80	0.1875000
NODE_1366_length_1973_cov_14.885272	1442	1522	2	65	80	0.8125000
NODE_1372_length_1971_cov_3.126068	1662	1742	18	9	80	0.1125000
NODE_1372_length_1971_cov_3.126068	1662	1742	19	1	80	0.0125000
NODE_1372_length_1971_cov_3.126068	1662	1742	25	2	80	0.0250000
NODE_1372_length_1971_cov_3.126068	1662	1742	26	3	80	0.0375000
NODE_1372_length_1971_cov_3.126068	1662	1742	28	3	80	0.0375000
NODE_1372_length_1971_cov_3.126068	1662	1742	29	1	80	0.0125000
NODE_1372_length_1971_cov_3.126068	1662	1742	30	8	80	0.1000000
NODE_1372_length_1971_cov_3.126068	1662	1742	31	19	80	0.2375000
NODE_1372_length_1971_cov_3.126068	1662	1742	32	18	80	0.2250000
NODE_1372_length_1971_cov_3.126068	1662	1742	33	4	80	0.0500000
NODE_1372_length_1971_cov_3.126068	1662	1742	34	3	80	0.0375000
NODE_1372_length_1971_cov_3.126068	1662	1742	35	1	80	0.0125000
NODE_1372_length_1971_cov_3.126068	1662	1742	36	8	80	0.1000000
NODE_1372_length_1971_cov_3.126068	1715	1799	18	11	84	0.1309524
NODE_1372_length_1971_cov_3.126068	1715	1799	19	20	84	0.2380952
NODE_1372_length_1971_cov_3.126068	1715	1799	20	1	84	0.0119048
NODE_1372_length_1971_cov_3.126068	1715	1799	22	3	84	0.0357143
NODE_1372_length_1971_cov_3.126068	1715	1799	24	4	84	0.0476190
NODE_1372_length_1971_cov_3.126068	1715	1799	26	21	84	0.2500000
NODE_1372_length_1971_cov_3.126068	1715	1799	28	3	84	0.0357143
NODE_1372_length_1971_cov_3.126068	1715	1799	30	8	84	0.0952381
NODE_1372_length_1971_cov_3.126068	1715	1799	32	12	84	0.1428571
NODE_1372_length_1971_cov_3.126068	1715	1799	34	1	84	0.0119048
NODE_1386_length_1962_cov_23.774557	281	311	0	30	30	1.0000000
NODE_1386_length_1962_cov_23.774557	329	355	0	26	26	1.0000000
NODE_1386_length_1962_cov_23.774557	408	487	0	9	79	0.1139240
NODE_1386_length_1962_cov_23.774557	408	487	2	19	79	0.2405063
NODE_1386_length_1962_cov_23.774557	408	487	4	51	79	0.6455696
NODE_1386_length_1962_cov_23.774557	460	540	0	4	80	0.0500000
NODE_1386_length_1962_cov_23.774557	460	540	2	53	80	0.6625000
NODE_1386_length_1962_cov_23.774557	460	540	4	23	80	0.2875000
NODE_1386_length_1962_cov_23.774557	1417	1497	0	80	80	1.0000000
NODE_1386_length_1962_cov_23.774557	1470	1550	0	80	80	1.0000000
NODE_1386_length_1962_cov_23.774557	1607	1640	0	33	33	1.0000000
NODE_1395_length_1953_cov_26.183927	1	81	14	1	80	0.0125000
NODE_1395_length_1953_cov_26.183927	1	81	20	1	80	0.0125000
NODE_1395_length_1953_cov_26.183927	1	81	24	1	80	0.0125000
NODE_1395_length_1953_cov_26.183927	1	81	34	1	80	0.0125000
NODE_1395_length_1953_cov_26.183927	1	81	46	2	80	0.0250000
NODE_1395_length_1953_cov_26.183927	1	81	51	3	80	0.0375000
NODE_1395_length_1953_cov_26.183927	1	81	53	2	80	0.0250000
NODE_1395_length_1953_cov_26.183927	1	81	59	1	80	0.0125000
NODE_1395_length_1953_cov_26.183927	1	81	61	2	80	0.0250000
NODE_1395_length_1953_cov_26.183927	1	81	65	1	80	0.0125000
NODE_1395_length_1953_cov_26.183927	1	81	68	1	80	0.0125000
NODE_1395_length_1953_cov_26.183927	1	81	70	2	80	0.0250000
NODE_1395_length_1953_cov_26.183927	1	81	80	1	80	0.0125000
NODE_1395_length_1953_cov_26.183927	1	81	82	8	80	0.1000000
NODE_1395_length_1953_cov_26.183927	1	81	84	1	80	0.0125000
NODE_1395_length_1953_cov_26.183927	1	81	88	2	80	0.0250000
NODE_1395_length_1953_cov_26.183927	1	81	95	1	80	0.0125000
NODE_1395_length_1953_cov_26.183927	1	81	96	5	80	0.0625000
NODE_1395_length_1953_cov_26.183927	1	81	97	21	80	0.2625000
NODE_1395_length_1953_cov_26.183927	1	81	99	7	80	0.0875000
NODE_1395_length_1953_cov_26.183927	1	81	100	1	80	0.0125000
NODE_1395_length_1953_cov_26.183927	1	81	102	15	80	0.1875000
NODE_1395_length_1953_cov_26.183927	6	28	46	1	22	0.0454545
NODE_1395_length_1953_cov_26.183927	6	28	51	3	22	0.1363636
NODE_1395_length_1953_cov_26.183927	6	28	53	2	22	0.0909091
NODE_1395_length_1953_cov_26.183927	6	28	59	1	22	0.0454545
NODE_1395_length_1953_cov_26.183927	6	28	61	2	22	0.0909091
NODE_1395_length_1953_cov_26.183927	6	28	65	1	22	0.0454545
NODE_1395_length_1953_cov_26.183927	6	28	68	1	22	0.0454545
NODE_1395_length_1953_cov_26.183927	6	28	70	2	22	0.0909091
NODE_1395_length_1953_cov_26.183927	6	28	80	1	22	0.0454545
NODE_1395_length_1953_cov_26.183927	6	28	82	8	22	0.3636364
NODE_1395_length_1953_cov_26.183927	152	232	0	59	80	0.7375000
NODE_1395_length_1953_cov_26.183927	152	232	2	21	80	0.2625000
NODE_1395_length_1953_cov_26.183927	205	257	0	50	52	0.9615384
NODE_1395_length_1953_cov_26.183927	205	257	6	2	52	0.0384615
NODE_1405_length_1943_cov_11.218547	516	596	0	17	80	0.2125000
NODE_1405_length_1943_cov_11.218547	516	596	2	63	80	0.7875000
NODE_1405_length_1943_cov_11.218547	569	649	0	46	80	0.5750000
NODE_1405_length_1943_cov_11.218547	569	649	2	34	80	0.4250000
NODE_1408_length_1941_cov_14.407709	891	921	0	30	30	1.0000000
NODE_1408_length_1941_cov_14.407709	894	964	0	70	70	1.0000000
NODE_1408_length_1941_cov_14.407709	1878	1941	0	63	63	1.0000000
NODE_1409_length_1941_cov_9.632465	139	213	3	1	74	0.0135135
NODE_1409_length_1941_cov_9.632465	139	213	7	3	74	0.0405405
NODE_1409_length_1941_cov_9.632465	139	213	8	42	74	0.5675676
NODE_1409_length_1941_cov_9.632465	139	213	11	1	74	0.0135135
NODE_1409_length_1941_cov_9.632465	139	213	12	9	74	0.1216216
NODE_1409_length_1941_cov_9.632465	139	213	13	5	74	0.0675676
NODE_1409_length_1941_cov_9.632465	139	213	14	13	74	0.1756757
NODE_1409_length_1941_cov_9.632465	139	219	3	1	80	0.0125000
NODE_1409_length_1941_cov_9.632465	139	219	7	3	80	0.0375000
NODE_1409_length_1941_cov_9.632465	139	219	8	42	80	0.5250000
NODE_1409_length_1941_cov_9.632465	139	219	11	1	80	0.0125000
NODE_1409_length_1941_cov_9.632465	139	219	12	9	80	0.1125000
NODE_1409_length_1941_cov_9.632465	139	219	13	11	80	0.1375000
NODE_1409_length_1941_cov_9.632465	139	219	14	13	80	0.1625000
NODE_1409_length_1941_cov_9.632465	139	194	3	1	55	0.0181818
NODE_1409_length_1941_cov_9.632465	139	194	7	3	55	0.0545455
NODE_1409_length_1941_cov_9.632465	139	194	8	42	55	0.7636364
NODE_1409_length_1941_cov_9.632465	139	194	11	1	55	0.0181818
NODE_1409_length_1941_cov_9.632465	139	194	12	8	55	0.1454545
NODE_1409_length_1941_cov_9.632465	192	272	12	35	80	0.4375000
NODE_1409_length_1941_cov_9.632465	192	272	13	20	80	0.2500000
NODE_1409_length_1941_cov_9.632465	192	272	14	13	80	0.1625000
NODE_1409_length_1941_cov_9.632465	192	272	16	12	80	0.1500000
NODE_1414_length_1936_cov_13.338596	679	759	0	80	80	1.0000000
NODE_1414_length_1936_cov_13.338596	732	812	0	80	80	1.0000000
NODE_1414_length_1936_cov_13.338596	738	812	0	74	74	1.0000000
NODE_1414_length_1936_cov_13.338596	738	759	0	21	21	1.0000000
NODE_1415_length_1936_cov_12.592814	102	153	0	17	51	0.3333333
NODE_1415_length_1936_cov_12.592814	102	153	2	11	51	0.2156863
NODE_1415_length_1936_cov_12.592814	102	153	4	12	51	0.2352941
NODE_1415_length_1936_cov_12.592814	102	153	6	7	51	0.1372549
NODE_1415_length_1936_cov_12.592814	102	153	8	2	51	0.0392157
NODE_1415_length_1936_cov_12.592814	102	153	10	2	51	0.0392157
NODE_1415_length_1936_cov_12.592814	154	230	4	3	76	0.0394737
NODE_1415_length_1936_cov_12.592814	154	230	6	6	76	0.0789474
NODE_1415_length_1936_cov_12.592814	154	230	8	26	76	0.3421053
NODE_1415_length_1936_cov_12.592814	154	230	10	41	76	0.5394737
NODE_1415_length_1936_cov_12.592814	211	251	2	3	40	0.0750000
NODE_1415_length_1936_cov_12.592814	211	251	4	7	40	0.1750000
NODE_1415_length_1936_cov_12.592814	211	251	6	9	40	0.2250000
NODE_1415_length_1936_cov_12.592814	211	251	8	6	40	0.1500000
NODE_1415_length_1936_cov_12.592814	211	251	10	15	40	0.3750000
NODE_1416_length_1933_cov_86.724646	1044	1124	0	35	80	0.4375000
NODE_1416_length_1933_cov_86.724646	1044	1124	1	26	80	0.3250000
NODE_1416_length_1933_cov_86.724646	1044	1124	3	7	80	0.0875000
NODE_1416_length_1933_cov_86.724646	1044	1124	5	12	80	0.1500000
NODE_1416_length_1933_cov_86.724646	1097	1177	1	8	80	0.1000000
NODE_1416_length_1933_cov_86.724646	1097	1177	3	7	80	0.0875000
NODE_1416_length_1933_cov_86.724646	1097	1177	5	65	80	0.8125000
NODE_1416_length_1933_cov_86.724646	1173	1253	1	24	80	0.3000000
NODE_1416_length_1933_cov_86.724646	1173	1253	2	35	80	0.4375000
NODE_1416_length_1933_cov_86.724646	1173	1253	4	16	80	0.2000000
NODE_1416_length_1933_cov_86.724646	1173	1253	5	4	80	0.0500000
NODE_1416_length_1933_cov_86.724646	1173	1253	6	1	80	0.0125000
NODE_1416_length_1933_cov_86.724646	1226	1306	1	77	80	0.9625000
NODE_1416_length_1933_cov_86.724646	1226	1306	2	3	80	0.0375000
NODE_1419_length_1932_cov_5.905074	1534	1614	4	41	80	0.5125000
NODE_1419_length_1932_cov_5.905074	1534	1614	6	22	80	0.2750000
NODE_1419_length_1932_cov_5.905074	1534	1614	8	17	80	0.2125000
NODE_1422_length_1930_cov_3.005461	1700	1780	112	1	80	0.0125000
NODE_1422_length_1930_cov_3.005461	1700	1780	119	3	80	0.0375000
NODE_1422_length_1930_cov_3.005461	1700	1780	123	9	80	0.1125000
NODE_1422_length_1930_cov_3.005461	1700	1780	134	4	80	0.0500000
NODE_1422_length_1930_cov_3.005461	1700	1780	136	1	80	0.0125000
NODE_1422_length_1930_cov_3.005461	1700	1780	140	1	80	0.0125000
NODE_1422_length_1930_cov_3.005461	1700	1780	142	1	80	0.0125000
NODE_1422_length_1930_cov_3.005461	1700	1780	143	1	80	0.0125000
NODE_1422_length_1930_cov_3.005461	1700	1780	146	4	80	0.0500000
NODE_1422_length_1930_cov_3.005461	1700	1780	148	5	80	0.0625000
NODE_1422_length_1930_cov_3.005461	1700	1780	149	2	80	0.0250000
NODE_1422_length_1930_cov_3.005461	1700	1780	150	1	80	0.0125000
NODE_1422_length_1930_cov_3.005461	1700	1780	151	11	80	0.1375000
NODE_1422_length_1930_cov_3.005461	1700	1780	152	1	80	0.0125000
NODE_1422_length_1930_cov_3.005461	1700	1780	153	2	80	0.0250000
NODE_1422_length_1930_cov_3.005461	1700	1780	154	15	80	0.1875000
NODE_1422_length_1930_cov_3.005461	1700	1780	155	18	80	0.2250000
NODE_1427_length_1928_cov_2.580098	74	131	120	9	57	0.1578947
NODE_1427_length_1928_cov_2.580098	74	131	122	6	57	0.1052632
NODE_1427_length_1928_cov_2.580098	74	131	124	5	57	0.0877193
NODE_1427_length_1928_cov_2.580098	74	131	128	3	57	0.0526316
NODE_1427_length_1928_cov_2.580098	74	131	130	4	57	0.0701754
NODE_1427_length_1928_cov_2.580098	74	131	135	2	57	0.0350877
NODE_1427_length_1928_cov_2.580098	74	131	136	14	57	0.2456140
NODE_1427_length_1928_cov_2.580098	74	131	138	14	57	0.2456140
NODE_1427_length_1928_cov_2.580098	127	184	33	1	57	0.0175439
NODE_1427_length_1928_cov_2.580098	127	184	41	1	57	0.0175439
NODE_1427_length_1928_cov_2.580098	127	184	44	1	57	0.0175439
NODE_1427_length_1928_cov_2.580098	127	184	46	1	57	0.0175439
NODE_1427_length_1928_cov_2.580098	127	184	47	3	57	0.0526316
NODE_1427_length_1928_cov_2.580098	127	184	49	3	57	0.0526316
NODE_1427_length_1928_cov_2.580098	127	184	51	2	57	0.0350877
NODE_1427_length_1928_cov_2.580098	127	184	55	1	57	0.0175439
NODE_1427_length_1928_cov_2.580098	127	184	57	5	57	0.0877193
NODE_1427_length_1928_cov_2.580098	127	184	64	1	57	0.0175439
NODE_1427_length_1928_cov_2.580098	127	184	68	1	57	0.0175439
NODE_1427_length_1928_cov_2.580098	127	184	72	1	57	0.0175439
NODE_1427_length_1928_cov_2.580098	127	184	74	1	57	0.0175439
NODE_1427_length_1928_cov_2.580098	127	184	79	5	57	0.0877193
NODE_1427_length_1928_cov_2.580098	127	184	83	1	57	0.0175439
NODE_1427_length_1928_cov_2.580098	127	184	84	3	57	0.0526316
NODE_1427_length_1928_cov_2.580098	127	184	93	2	57	0.0350877
NODE_1427_length_1928_cov_2.580098	127	184	107	5	57	0.0877193
NODE_1427_length_1928_cov_2.580098	127	184	112	1	57	0.0175439
NODE_1427_length_1928_cov_2.580098	127	184	114	5	57	0.0877193
NODE_1427_length_1928_cov_2.580098	127	184	120	13	57	0.2280702
NODE_1434_length_1919_cov_17.901099	454	529	2	2	75	0.0266667
NODE_1434_length_1919_cov_17.901099	454	529	4	8	75	0.1066667
NODE_1434_length_1919_cov_17.901099	454	529	6	65	75	0.8666667
NODE_1434_length_1919_cov_17.901099	507	558	0	18	51	0.3529412
NODE_1434_length_1919_cov_17.901099	507	558	2	10	51	0.1960784
NODE_1434_length_1919_cov_17.901099	507	558	5	1	51	0.0196078
NODE_1434_length_1919_cov_17.901099	507	558	6	22	51	0.4313726
NODE_1436_length_1918_cov_14.876855	314	396	0	5	82	0.0609756
NODE_1436_length_1918_cov_14.876855	314	396	4	77	82	0.9390244
NODE_1438_length_1918_cov_3.493128	9	55	6	12	46	0.2608696
NODE_1438_length_1918_cov_3.493128	9	55	12	13	46	0.2826087
NODE_1438_length_1918_cov_3.493128	9	55	14	2	46	0.0434783
NODE_1438_length_1918_cov_3.493128	9	55	20	4	46	0.0869565
NODE_1438_length_1918_cov_3.493128	9	55	22	15	46	0.3260870
NODE_1438_length_1918_cov_3.493128	1480	1561	2	81	81	1.0000000
NODE_1440_length_1916_cov_4.426527	162	192	0	30	30	1.0000000
NODE_1442_length_1915_cov_35.787996	106	186	39	1	80	0.0125000
NODE_1442_length_1915_cov_35.787996	106	186	44	1	80	0.0125000
NODE_1442_length_1915_cov_35.787996	106	186	47	1	80	0.0125000
NODE_1442_length_1915_cov_35.787996	106	186	49	1	80	0.0125000
NODE_1442_length_1915_cov_35.787996	106	186	51	1	80	0.0125000
NODE_1442_length_1915_cov_35.787996	106	186	53	1	80	0.0125000
NODE_1442_length_1915_cov_35.787996	106	186	55	2	80	0.0250000
NODE_1442_length_1915_cov_35.787996	106	186	69	2	80	0.0250000
NODE_1442_length_1915_cov_35.787996	106	186	77	2	80	0.0250000
NODE_1442_length_1915_cov_35.787996	106	186	79	1	80	0.0125000
NODE_1442_length_1915_cov_35.787996	106	186	81	1	80	0.0125000
NODE_1442_length_1915_cov_35.787996	106	186	85	1	80	0.0125000
NODE_1442_length_1915_cov_35.787996	106	186	89	2	80	0.0250000
NODE_1442_length_1915_cov_35.787996	106	186	90	1	80	0.0125000
NODE_1442_length_1915_cov_35.787996	106	186	103	1	80	0.0125000
NODE_1442_length_1915_cov_35.787996	106	186	107	1	80	0.0125000
NODE_1442_length_1915_cov_35.787996	106	186	111	2	80	0.0250000
NODE_1442_length_1915_cov_35.787996	106	186	113	8	80	0.1000000
NODE_1442_length_1915_cov_35.787996	106	186	116	1	80	0.0125000
NODE_1442_length_1915_cov_35.787996	106	186	119	2	80	0.0250000
NODE_1442_length_1915_cov_35.787996	106	186	123	1	80	0.0125000
NODE_1442_length_1915_cov_35.787996	106	186	125	1	80	0.0125000
NODE_1442_length_1915_cov_35.787996	106	186	128	5	80	0.0625000
NODE_1442_length_1915_cov_35.787996	106	186	132	1	80	0.0125000
NODE_1442_length_1915_cov_35.787996	106	186	136	2	80	0.0250000
NODE_1442_length_1915_cov_35.787996	106	186	138	1	80	0.0125000
NODE_1442_length_1915_cov_35.787996	106	186	142	3	80	0.0375000
NODE_1442_length_1915_cov_35.787996	106	186	144	1	80	0.0125000
NODE_1442_length_1915_cov_35.787996	106	186	146	1	80	0.0125000
NODE_1442_length_1915_cov_35.787996	106	186	152	1	80	0.0125000
NODE_1442_length_1915_cov_35.787996	106	186	154	1	80	0.0125000
NODE_1442_length_1915_cov_35.787996	106	186	156	1	80	0.0125000
NODE_1442_length_1915_cov_35.787996	106	186	161	4	80	0.0500000
NODE_1442_length_1915_cov_35.787996	106	186	167	1	80	0.0125000
NODE_1442_length_1915_cov_35.787996	106	186	169	2	80	0.0250000
NODE_1442_length_1915_cov_35.787996	106	186	171	3	80	0.0375000
NODE_1442_length_1915_cov_35.787996	106	186	173	4	80	0.0500000
NODE_1442_length_1915_cov_35.787996	106	186	175	3	80	0.0375000
NODE_1442_length_1915_cov_35.787996	106	186	177	7	80	0.0875000
NODE_1442_length_1915_cov_35.787996	106	186	178	1	80	0.0125000
NODE_1442_length_1915_cov_35.787996	106	186	180	3	80	0.0375000
NODE_1451_length_1905_cov_18.464563	740	820	0	78	80	0.9750000
NODE_1451_length_1905_cov_18.464563	740	820	2	2	80	0.0250000
NODE_1451_length_1905_cov_18.464563	793	873	0	25	80	0.3125000
NODE_1451_length_1905_cov_18.464563	793	873	2	55	80	0.6875000
NODE_1451_length_1905_cov_18.464563	869	949	2	70	80	0.8750000
NODE_1451_length_1905_cov_18.464563	869	949	4	10	80	0.1250000
NODE_1451_length_1905_cov_18.464563	922	1010	0	7	88	0.0795455
NODE_1451_length_1905_cov_18.464563	922	1010	2	80	88	0.9090909
NODE_1451_length_1905_cov_18.464563	922	1010	4	1	88	0.0113636
NODE_1452_length_1905_cov_7.197121	596	676	0	76	80	0.9500000
NODE_1452_length_1905_cov_7.197121	596	676	2	4	80	0.0500000
NODE_1452_length_1905_cov_7.197121	649	682	0	23	33	0.6969697
NODE_1452_length_1905_cov_7.197121	649	682	2	10	33	0.3030303
NODE_1455_length_1902_cov_1.633943	1728	1792	60	2	64	0.0312500
NODE_1455_length_1902_cov_1.633943	1728	1792	65	2	64	0.0312500
NODE_1455_length_1902_cov_1.633943	1728	1792	66	1	64	0.0156250
NODE_1455_length_1902_cov_1.633943	1728	1792	71	1	64	0.0156250
NODE_1455_length_1902_cov_1.633943	1728	1792	73	1	64	0.0156250
NODE_1455_length_1902_cov_1.633943	1728	1792	75	2	64	0.0312500
NODE_1455_length_1902_cov_1.633943	1728	1792	82	2	64	0.0312500
NODE_1455_length_1902_cov_1.633943	1728	1792	85	1	64	0.0156250
NODE_1455_length_1902_cov_1.633943	1728	1792	88	1	64	0.0156250
NODE_1455_length_1902_cov_1.633943	1728	1792	89	2	64	0.0312500
NODE_1455_length_1902_cov_1.633943	1728	1792	91	1	64	0.0156250
NODE_1455_length_1902_cov_1.633943	1728	1792	95	2	64	0.0312500
NODE_1455_length_1902_cov_1.633943	1728	1792	100	1	64	0.0156250
NODE_1455_length_1902_cov_1.633943	1728	1792	102	1	64	0.0156250
NODE_1455_length_1902_cov_1.633943	1728	1792	107	1	64	0.0156250
NODE_1455_length_1902_cov_1.633943	1728	1792	108	5	64	0.0781250
NODE_1455_length_1902_cov_1.633943	1728	1792	112	1	64	0.0156250
NODE_1455_length_1902_cov_1.633943	1728	1792	113	1	64	0.0156250
NODE_1455_length_1902_cov_1.633943	1728	1792	117	1	64	0.0156250
NODE_1455_length_1902_cov_1.633943	1728	1792	121	1	64	0.0156250
NODE_1455_length_1902_cov_1.633943	1728	1792	131	12	64	0.1875000
NODE_1455_length_1902_cov_1.633943	1728	1792	135	3	64	0.0468750
NODE_1455_length_1902_cov_1.633943	1728	1792	136	3	64	0.0468750
NODE_1455_length_1902_cov_1.633943	1728	1792	138	3	64	0.0468750
NODE_1455_length_1902_cov_1.633943	1728	1792	142	2	64	0.0312500
NODE_1455_length_1902_cov_1.633943	1728	1792	144	3	64	0.0468750
NODE_1455_length_1902_cov_1.633943	1728	1792	146	8	64	0.1250000
NODE_1458_length_1900_cov_1.081066	1805	1851	0	46	46	1.0000000
NODE_1458_length_1900_cov_1.081066	1824	1900	0	76	76	1.0000000
NODE_1461_length_1895_cov_17.940980	1070	1150	2	21	80	0.2625000
NODE_1461_length_1895_cov_17.940980	1070	1150	4	26	80	0.3250000
NODE_1461_length_1895_cov_17.940980	1070	1150	6	33	80	0.4125000
NODE_1461_length_1895_cov_17.940980	1123	1203	0	5	80	0.0625000
NODE_1461_length_1895_cov_17.940980	1123	1203	4	11	80	0.1375000
NODE_1461_length_1895_cov_17.940980	1123	1203	6	64	80	0.8000000
NODE_1466_length_1893_cov_3.299331	918	998	2	20	80	0.2500000
NODE_1466_length_1893_cov_3.299331	918	998	6	10	80	0.1250000
NODE_1466_length_1893_cov_3.299331	918	998	8	45	80	0.5625000
NODE_1466_length_1893_cov_3.299331	918	998	10	5	80	0.0625000
NODE_1467_length_1892_cov_5.158394	317	397	2	80	80	1.0000000
NODE_1467_length_1892_cov_5.158394	370	445	0	21	75	0.2800000
NODE_1467_length_1892_cov_5.158394	370	445	2	54	75	0.7200000
NODE_1469_length_1889_cov_4.049162	1652	1686	0	34	34	1.0000000
NODE_1470_length_1889_cov_3.888268	960	1040	0	26	80	0.3250000
NODE_1470_length_1889_cov_3.888268	960	1040	2	43	80	0.5375000
NODE_1470_length_1889_cov_3.888268	960	1040	6	11	80	0.1375000
NODE_1470_length_1889_cov_3.888268	1013	1093	0	79	80	0.9875000
NODE_1470_length_1889_cov_3.888268	1013	1093	2	1	80	0.0125000
NODE_1472_length_1888_cov_17.106764	15	96	36	4	81	0.0493827
NODE_1472_length_1888_cov_17.106764	15	96	42	1	81	0.0123457
NODE_1472_length_1888_cov_17.106764	15	96	45	1	81	0.0123457
NODE_1472_length_1888_cov_17.106764	15	96	56	1	81	0.0123457
NODE_1472_length_1888_cov_17.106764	15	96	58	1	81	0.0123457
NODE_1472_length_1888_cov_17.106764	15	96	68	1	81	0.0123457
NODE_1472_length_1888_cov_17.106764	15	96	70	1	81	0.0123457
NODE_1472_length_1888_cov_17.106764	15	96	72	1	81	0.0123457
NODE_1472_length_1888_cov_17.106764	15	96	76	1	81	0.0123457
NODE_1472_length_1888_cov_17.106764	15	96	79	1	81	0.0123457
NODE_1472_length_1888_cov_17.106764	15	96	85	1	81	0.0123457
NODE_1472_length_1888_cov_17.106764	15	96	86	1	81	0.0123457
NODE_1472_length_1888_cov_17.106764	15	96	90	16	81	0.1975309
NODE_1472_length_1888_cov_17.106764	15	96	92	50	81	0.6172839
NODE_1472_length_1888_cov_17.106764	68	143	4	5	75	0.0666667
NODE_1472_length_1888_cov_17.106764	68	143	6	1	75	0.0133333
NODE_1472_length_1888_cov_17.106764	68	143	8	4	75	0.0533333
NODE_1472_length_1888_cov_17.106764	68	143	16	3	75	0.0400000
NODE_1472_length_1888_cov_17.106764	68	143	22	1	75	0.0133333
NODE_1472_length_1888_cov_17.106764	68	143	35	1	75	0.0133333
NODE_1472_length_1888_cov_17.106764	68	143	38	2	75	0.0266667
NODE_1472_length_1888_cov_17.106764	68	143	42	2	75	0.0266667
NODE_1472_length_1888_cov_17.106764	68	143	49	1	75	0.0133333
NODE_1472_length_1888_cov_17.106764	68	143	50	1	75	0.0133333
NODE_1472_length_1888_cov_17.106764	68	143	56	2	75	0.0266667
NODE_1472_length_1888_cov_17.106764	68	143	62	1	75	0.0133333
NODE_1472_length_1888_cov_17.106764	68	143	64	3	75	0.0400000
NODE_1472_length_1888_cov_17.106764	68	143	66	1	75	0.0133333
NODE_1472_length_1888_cov_17.106764	68	143	68	1	75	0.0133333
NODE_1472_length_1888_cov_17.106764	68	143	70	1	75	0.0133333
NODE_1472_length_1888_cov_17.106764	68	143	76	3	75	0.0400000
NODE_1472_length_1888_cov_17.106764	68	143	80	1	75	0.0133333
NODE_1472_length_1888_cov_17.106764	68	143	82	2	75	0.0266667
NODE_1472_length_1888_cov_17.106764	68	143	84	1	75	0.0133333
NODE_1472_length_1888_cov_17.106764	68	143	86	1	75	0.0133333
NODE_1472_length_1888_cov_17.106764	68	143	88	1	75	0.0133333
NODE_1472_length_1888_cov_17.106764	68	143	92	36	75	0.4800000
NODE_1477_length_1885_cov_4.439530	441	521	0	16	80	0.2000000
NODE_1477_length_1885_cov_4.439530	441	521	2	39	80	0.4875000
NODE_1477_length_1885_cov_4.439530	441	521	4	25	80	0.3125000
NODE_1477_length_1885_cov_4.439530	494	574	2	52	80	0.6500000
NODE_1477_length_1885_cov_4.439530	494	574	4	28	80	0.3500000
NODE_1483_length_1882_cov_5.884464	1499	1579	0	78	80	0.9750000
NODE_1483_length_1882_cov_5.884464	1499	1579	1	2	80	0.0250000
NODE_1483_length_1882_cov_5.884464	1552	1632	0	80	80	1.0000000
NODE_1493_length_1875_cov_3.974662	1650	1730	10	4	80	0.0500000
NODE_1493_length_1875_cov_3.974662	1650	1730	16	2	80	0.0250000
NODE_1493_length_1875_cov_3.974662	1650	1730	18	3	80	0.0375000
NODE_1493_length_1875_cov_3.974662	1650	1730	20	30	80	0.3750000
NODE_1493_length_1875_cov_3.974662	1650	1730	22	4	80	0.0500000
NODE_1493_length_1875_cov_3.974662	1650	1730	24	15	80	0.1875000
NODE_1493_length_1875_cov_3.974662	1650	1730	28	5	80	0.0625000
NODE_1493_length_1875_cov_3.974662	1650	1730	30	3	80	0.0375000
NODE_1493_length_1875_cov_3.974662	1650	1730	34	1	80	0.0125000
NODE_1493_length_1875_cov_3.974662	1650	1730	36	2	80	0.0250000
NODE_1493_length_1875_cov_3.974662	1650	1730	38	11	80	0.1375000
NODE_1497_length_1872_cov_21.355330	153	201	0	48	48	1.0000000
NODE_1503_length_1868_cov_96.046919	1018	1098	31	1	80	0.0125000
NODE_1503_length_1868_cov_96.046919	1018	1098	32	6	80	0.0750000
NODE_1503_length_1868_cov_96.046919	1018	1098	33	8	80	0.1000000
NODE_1503_length_1868_cov_96.046919	1018	1098	35	6	80	0.0750000
NODE_1503_length_1868_cov_96.046919	1018	1098	36	2	80	0.0250000
NODE_1503_length_1868_cov_96.046919	1018	1098	40	5	80	0.0625000
NODE_1503_length_1868_cov_96.046919	1018	1098	42	11	80	0.1375000
NODE_1503_length_1868_cov_96.046919	1018	1098	48	1	80	0.0125000
NODE_1503_length_1868_cov_96.046919	1018	1098	59	1	80	0.0125000
NODE_1503_length_1868_cov_96.046919	1018	1098	70	2	80	0.0250000
NODE_1503_length_1868_cov_96.046919	1018	1098	79	1	80	0.0125000
NODE_1503_length_1868_cov_96.046919	1018	1098	80	1	80	0.0125000
NODE_1503_length_1868_cov_96.046919	1018	1098	86	1	80	0.0125000
NODE_1503_length_1868_cov_96.046919	1018	1098	89	4	80	0.0500000
NODE_1503_length_1868_cov_96.046919	1018	1098	95	2	80	0.0250000
NODE_1503_length_1868_cov_96.046919	1018	1098	99	1	80	0.0125000
NODE_1503_length_1868_cov_96.046919	1018	1098	101	4	80	0.0500000
NODE_1503_length_1868_cov_96.046919	1018	1098	107	4	80	0.0500000
NODE_1503_length_1868_cov_96.046919	1018	1098	110	5	80	0.0625000
NODE_1503_length_1868_cov_96.046919	1018	1098	112	1	80	0.0125000
NODE_1503_length_1868_cov_96.046919	1018	1098	114	2	80	0.0250000
NODE_1503_length_1868_cov_96.046919	1018	1098	116	7	80	0.0875000
NODE_1503_length_1868_cov_96.046919	1018	1098	117	4	80	0.0500000
NODE_1503_length_1868_cov_96.046919	1071	1151	101	4	80	0.0500000
NODE_1503_length_1868_cov_96.046919	1071	1151	102	2	80	0.0250000
NODE_1503_length_1868_cov_96.046919	1071	1151	104	6	80	0.0750000
NODE_1503_length_1868_cov_96.046919	1071	1151	106	2	80	0.0250000
NODE_1503_length_1868_cov_96.046919	1071	1151	107	9	80	0.1125000
NODE_1503_length_1868_cov_96.046919	1071	1151	109	6	80	0.0750000
NODE_1503_length_1868_cov_96.046919	1071	1151	110	6	80	0.0750000
NODE_1503_length_1868_cov_96.046919	1071	1151	112	9	80	0.1125000
NODE_1503_length_1868_cov_96.046919	1071	1151	114	4	80	0.0500000
NODE_1503_length_1868_cov_96.046919	1071	1151	115	7	80	0.0875000
NODE_1503_length_1868_cov_96.046919	1071	1151	116	7	80	0.0875000
NODE_1503_length_1868_cov_96.046919	1071	1151	117	16	80	0.2000000
NODE_1503_length_1868_cov_96.046919	1071	1151	118	2	80	0.0250000
NODE_1508_length_1866_cov_53.869270	1149	1229	0	60	80	0.7500000
NODE_1508_length_1866_cov_53.869270	1149	1229	2	20	80	0.2500000
NODE_1508_length_1866_cov_53.869270	1202	1282	0	7	80	0.0875000
NODE_1508_length_1866_cov_53.869270	1202	1282	2	73	80	0.9125000
NODE_1508_length_1866_cov_53.869270	1278	1358	0	50	80	0.6250000
NODE_1508_length_1866_cov_53.869270	1278	1358	2	30	80	0.3750000
NODE_1508_length_1866_cov_53.869270	1331	1411	0	80	80	1.0000000
NODE_1510_length_1866_cov_3.347482	888	966	0	78	78	1.0000000
NODE_1510_length_1866_cov_3.347482	939	1019	0	80	80	1.0000000
NODE_1513_length_1863_cov_11.265306	698	778	4	1	80	0.0125000
NODE_1513_length_1863_cov_11.265306	698	778	8	45	80	0.5625000
NODE_1513_length_1863_cov_11.265306	698	778	9	18	80	0.2250000
NODE_1513_length_1863_cov_11.265306	698	778	15	3	80	0.0375000
NODE_1513_length_1863_cov_11.265306	698	778	19	3	80	0.0375000
NODE_1513_length_1863_cov_11.265306	698	778	20	10	80	0.1250000
NODE_1513_length_1863_cov_11.265306	751	831	9	11	80	0.1375000
NODE_1513_length_1863_cov_11.265306	751	831	11	47	80	0.5875000
NODE_1513_length_1863_cov_11.265306	751	831	15	9	80	0.1125000
NODE_1513_length_1863_cov_11.265306	751	831	19	3	80	0.0375000
NODE_1513_length_1863_cov_11.265306	751	831	20	10	80	0.1250000
NODE_1518_length_1858_cov_19.019329	23	85	0	62	62	1.0000000
NODE_1518_length_1858_cov_19.019329	1125	1205	0	54	80	0.6750000
NODE_1518_length_1858_cov_19.019329	1125	1205	2	26	80	0.3250000
NODE_1518_length_1858_cov_19.019329	1178	1256	0	3	78	0.0384615
NODE_1518_length_1858_cov_19.019329	1178	1256	2	75	78	0.9615384
NODE_1518_length_1858_cov_19.019329	1387	1464	0	49	77	0.6363636
NODE_1518_length_1858_cov_19.019329	1387	1464	2	28	77	0.3636364
NODE_1518_length_1858_cov_19.019329	1440	1503	0	63	63	1.0000000
NODE_1519_length_1857_cov_18.402730	1282	1348	1	4	66	0.0606061
NODE_1519_length_1857_cov_18.402730	1282	1348	3	62	66	0.9393939
NODE_1519_length_1857_cov_18.402730	1321	1401	0	33	80	0.4125000
NODE_1519_length_1857_cov_18.402730	1321	1401	1	24	80	0.3000000
NODE_1519_length_1857_cov_18.402730	1321	1401	3	23	80	0.2875000
NODE_1519_length_1857_cov_18.402730	1397	1477	0	80	80	1.0000000
NODE_1519_length_1857_cov_18.402730	1450	1530	0	80	80	1.0000000
NODE_1531_length_1845_cov_12.653494	473	553	2	60	80	0.7500000
NODE_1531_length_1845_cov_12.653494	473	553	4	20	80	0.2500000
NODE_1531_length_1845_cov_12.653494	526	606	2	53	80	0.6625000
NODE_1531_length_1845_cov_12.653494	526	606	4	27	80	0.3375000
NODE_1546_length_1833_cov_31.337947	810	888	0	10	78	0.1282051
NODE_1546_length_1833_cov_31.337947	810	888	2	68	78	0.8717949
NODE_1546_length_1833_cov_31.337947	861	941	0	13	80	0.1625000
NODE_1546_length_1833_cov_31.337947	861	941	2	17	80	0.2125000
NODE_1546_length_1833_cov_31.337947	861	941	6	50	80	0.6250000
NODE_1546_length_1833_cov_31.337947	937	1017	6	5	80	0.0625000
NODE_1546_length_1833_cov_31.337947	937	1017	12	74	80	0.9250000
NODE_1546_length_1833_cov_31.337947	937	1017	16	1	80	0.0125000
NODE_1546_length_1833_cov_31.337947	990	1070	4	35	80	0.4375000
NODE_1546_length_1833_cov_31.337947	990	1070	10	16	80	0.2000000
NODE_1546_length_1833_cov_31.337947	990	1070	12	26	80	0.3250000
NODE_1546_length_1833_cov_31.337947	990	1070	16	3	80	0.0375000
NODE_1550_length_1831_cov_3.065820	112	154	14	1	42	0.0238095
NODE_1550_length_1831_cov_3.065820	112	154	18	2	42	0.0476190
NODE_1550_length_1831_cov_3.065820	112	154	20	1	42	0.0238095
NODE_1550_length_1831_cov_3.065820	112	154	22	1	42	0.0238095
NODE_1550_length_1831_cov_3.065820	112	154	24	1	42	0.0238095
NODE_1550_length_1831_cov_3.065820	112	154	27	9	42	0.2142857
NODE_1550_length_1831_cov_3.065820	112	154	29	2	42	0.0476190
NODE_1550_length_1831_cov_3.065820	112	154	31	1	42	0.0238095
NODE_1550_length_1831_cov_3.065820	112	154	33	2	42	0.0476190
NODE_1550_length_1831_cov_3.065820	112	154	35	3	42	0.0714286
NODE_1550_length_1831_cov_3.065820	112	154	37	5	42	0.1190476
NODE_1550_length_1831_cov_3.065820	112	154	38	2	42	0.0476190
NODE_1550_length_1831_cov_3.065820	112	154	40	2	42	0.0476190
NODE_1550_length_1831_cov_3.065820	112	154	42	1	42	0.0238095
NODE_1550_length_1831_cov_3.065820	112	154	48	1	42	0.0238095
NODE_1550_length_1831_cov_3.065820	112	154	51	3	42	0.0714286
NODE_1550_length_1831_cov_3.065820	112	154	53	5	42	0.1190476
NODE_1553_length_1830_cov_2.512998	123	203	0	80	80	1.0000000
NODE_1553_length_1830_cov_2.512998	176	256	0	80	80	1.0000000
NODE_1553_length_1830_cov_2.512998	308	357	4	49	49	1.0000000
NODE_1554_length_1828_cov_40.437825	789	869	0	28	80	0.3500000
NODE_1554_length_1828_cov_40.437825	789	869	4	52	80	0.6500000
NODE_1554_length_1828_cov_40.437825	842	922	0	80	80	1.0000000
NODE_1554_length_1828_cov_40.437825	918	998	0	21	80	0.2625000
NODE_1554_length_1828_cov_40.437825	918	998	4	30	80	0.3750000
NODE_1554_length_1828_cov_40.437825	918	998	6	29	80	0.3625000
NODE_1554_length_1828_cov_40.437825	971	1051	0	17	80	0.2125000
NODE_1554_length_1828_cov_40.437825	971	1051	2	4	80	0.0500000
NODE_1554_length_1828_cov_40.437825	971	1051	6	59	80	0.7375000
NODE_1559_length_1825_cov_6.652955	641	689	0	48	48	1.0000000
NODE_1559_length_1825_cov_6.652955	694	744	0	38	50	0.7600000
NODE_1559_length_1825_cov_6.652955	694	744	2	11	50	0.2200000
NODE_1559_length_1825_cov_6.652955	694	744	4	1	50	0.0200000
NODE_1562_length_1824_cov_10.152464	685	765	0	80	80	1.0000000
NODE_1562_length_1824_cov_10.152464	738	818	0	80	80	1.0000000
NODE_1562_length_1824_cov_10.152464	1412	1433	0	3	21	0.1428571
NODE_1562_length_1824_cov_10.152464	1412	1433	2	18	21	0.8571429
NODE_1564_length_1821_cov_7.682346	953	1033	0	80	80	1.0000000
NODE_1564_length_1821_cov_7.682346	1006	1086	0	80	80	1.0000000
NODE_1566_length_1820_cov_12.061592	477	557	0	4	80	0.0500000
NODE_1566_length_1820_cov_12.061592	477	557	5	1	80	0.0125000
NODE_1566_length_1820_cov_12.061592	477	557	6	2	80	0.0250000
NODE_1566_length_1820_cov_12.061592	477	557	10	1	80	0.0125000
NODE_1566_length_1820_cov_12.061592	477	557	12	37	80	0.4625000
NODE_1566_length_1820_cov_12.061592	477	557	14	35	80	0.4375000
NODE_1566_length_1820_cov_12.061592	530	610	12	16	80	0.2000000
NODE_1566_length_1820_cov_12.061592	530	610	14	64	80	0.8000000
NODE_1566_length_1820_cov_12.061592	1232	1312	6	49	80	0.6125000
NODE_1566_length_1820_cov_12.061592	1232	1312	8	31	80	0.3875000
NODE_1566_length_1820_cov_12.061592	1285	1365	2	4	80	0.0500000
NODE_1566_length_1820_cov_12.061592	1285	1365	6	30	80	0.3750000
NODE_1566_length_1820_cov_12.061592	1285	1365	8	46	80	0.5750000
NODE_1572_length_1817_cov_8.302095	63	122	0	43	59	0.7288136
NODE_1572_length_1817_cov_8.302095	63	122	5	1	59	0.0169492
NODE_1572_length_1817_cov_8.302095	63	122	6	1	59	0.0169492
NODE_1572_length_1817_cov_8.302095	63	122	8	14	59	0.2372881
NODE_1572_length_1817_cov_8.302095	1195	1275	0	80	80	1.0000000
NODE_1572_length_1817_cov_8.302095	1248	1328	0	80	80	1.0000000
NODE_1573_length_1816_cov_25.489225	1059	1139	0	80	80	1.0000000
NODE_1573_length_1816_cov_25.489225	1112	1192	0	80	80	1.0000000
NODE_1578_length_1812_cov_11.453006	398	427	0	27	29	0.9310345
NODE_1578_length_1812_cov_11.453006	398	427	2	2	29	0.0689655
NODE_1578_length_1812_cov_11.453006	400	480	0	80	80	1.0000000
NODE_1586_length_1807_cov_3.977752	1743	1807	0	64	64	1.0000000
NODE_1590_length_1806_cov_2.681312	1461	1541	0	6	80	0.0750000
NODE_1590_length_1806_cov_2.681312	1461	1541	3	2	80	0.0250000
NODE_1590_length_1806_cov_2.681312	1461	1541	7	22	80	0.2750000
NODE_1590_length_1806_cov_2.681312	1461	1541	9	2	80	0.0250000
NODE_1590_length_1806_cov_2.681312	1461	1541	11	1	80	0.0125000
NODE_1590_length_1806_cov_2.681312	1461	1541	13	4	80	0.0500000
NODE_1590_length_1806_cov_2.681312	1461	1541	15	2	80	0.0250000
NODE_1590_length_1806_cov_2.681312	1461	1541	18	3	80	0.0375000
NODE_1590_length_1806_cov_2.681312	1461	1541	24	2	80	0.0250000
NODE_1590_length_1806_cov_2.681312	1461	1541	26	2	80	0.0250000
NODE_1590_length_1806_cov_2.681312	1461	1541	28	1	80	0.0125000
NODE_1590_length_1806_cov_2.681312	1461	1541	30	6	80	0.0750000
NODE_1590_length_1806_cov_2.681312	1461	1541	32	3	80	0.0375000
NODE_1590_length_1806_cov_2.681312	1461	1541	34	1	80	0.0125000
NODE_1590_length_1806_cov_2.681312	1461	1541	36	1	80	0.0125000
NODE_1590_length_1806_cov_2.681312	1461	1541	39	12	80	0.1500000
NODE_1590_length_1806_cov_2.681312	1461	1541	41	5	80	0.0625000
NODE_1590_length_1806_cov_2.681312	1461	1541	43	2	80	0.0250000
NODE_1590_length_1806_cov_2.681312	1461	1541	45	3	80	0.0375000
NODE_1590_length_1806_cov_2.681312	1517	1594	0	59	77	0.7662337
NODE_1590_length_1806_cov_2.681312	1517	1594	3	2	77	0.0259740
NODE_1590_length_1806_cov_2.681312	1517	1594	7	16	77	0.2077922
NODE_1593_length_1805_cov_10.271395	258	329	0	71	71	1.0000000
NODE_1593_length_1805_cov_10.271395	311	391	0	80	80	1.0000000
NODE_1598_length_1802_cov_11.546682	1284	1364	0	80	80	1.0000000
NODE_1598_length_1802_cov_11.546682	1337	1417	0	80	80	1.0000000
NODE_1600_length_1801_cov_12.145711	85	165	16	20	80	0.2500000
NODE_1600_length_1801_cov_12.145711	85	165	18	7	80	0.0875000
NODE_1600_length_1801_cov_12.145711	85	165	24	4	80	0.0500000
NODE_1600_length_1801_cov_12.145711	85	165	27	24	80	0.3000000
NODE_1600_length_1801_cov_12.145711	85	165	29	17	80	0.2125000
NODE_1600_length_1801_cov_12.145711	85	165	31	8	80	0.1000000
NODE_1600_length_1801_cov_12.145711	138	218	2	6	80	0.0750000
NODE_1600_length_1801_cov_12.145711	138	218	6	4	80	0.0500000
NODE_1600_length_1801_cov_12.145711	138	218	8	6	80	0.0750000
NODE_1600_length_1801_cov_12.145711	138	218	10	9	80	0.1125000
NODE_1600_length_1801_cov_12.145711	138	218	12	3	80	0.0375000
NODE_1600_length_1801_cov_12.145711	138	218	18	1	80	0.0125000
NODE_1600_length_1801_cov_12.145711	138	218	22	8	80	0.1000000
NODE_1600_length_1801_cov_12.145711	138	218	24	19	80	0.2375000
NODE_1600_length_1801_cov_12.145711	138	218	27	2	80	0.0250000
NODE_1600_length_1801_cov_12.145711	138	218	29	16	80	0.2000000
NODE_1600_length_1801_cov_12.145711	138	218	31	6	80	0.0750000
NODE_1601_length_1801_cov_9.793184	1010	1090	2	77	80	0.9625000
NODE_1601_length_1801_cov_9.793184	1010	1090	4	3	80	0.0375000
NODE_1601_length_1801_cov_9.793184	1063	1143	2	80	80	1.0000000
NODE_1604_length_1800_cov_15.074662	695	775	0	78	80	0.9750000
NODE_1604_length_1800_cov_15.074662	695	775	1	2	80	0.0250000
NODE_1604_length_1800_cov_15.074662	755	826	0	18	71	0.2535211
NODE_1604_length_1800_cov_15.074662	755	826	1	27	71	0.3802817
NODE_1604_length_1800_cov_15.074662	755	826	2	26	71	0.3661972
NODE_1605_length_1800_cov_7.281599	10	74	75	2	64	0.0312500
NODE_1605_length_1800_cov_7.281599	10	74	83	1	64	0.0156250
NODE_1605_length_1800_cov_7.281599	10	74	88	11	64	0.1718750
NODE_1605_length_1800_cov_7.281599	10	74	94	1	64	0.0156250
NODE_1605_length_1800_cov_7.281599	10	74	95	1	64	0.0156250
NODE_1605_length_1800_cov_7.281599	10	74	109	2	64	0.0312500
NODE_1605_length_1800_cov_7.281599	10	74	117	3	64	0.0468750
NODE_1605_length_1800_cov_7.281599	10	74	126	3	64	0.0468750
NODE_1605_length_1800_cov_7.281599	10	74	134	2	64	0.0312500
NODE_1605_length_1800_cov_7.281599	10	74	138	2	64	0.0312500
NODE_1605_length_1800_cov_7.281599	10	74	161	3	64	0.0468750
NODE_1605_length_1800_cov_7.281599	10	74	163	1	64	0.0156250
NODE_1605_length_1800_cov_7.281599	10	74	171	1	64	0.0156250
NODE_1605_length_1800_cov_7.281599	10	74	174	8	64	0.1250000
NODE_1605_length_1800_cov_7.281599	10	74	175	1	64	0.0156250
NODE_1605_length_1800_cov_7.281599	10	74	177	3	64	0.0468750
NODE_1605_length_1800_cov_7.281599	10	74	183	1	64	0.0156250
NODE_1605_length_1800_cov_7.281599	10	74	187	1	64	0.0156250
NODE_1605_length_1800_cov_7.281599	10	74	189	5	64	0.0781250
NODE_1605_length_1800_cov_7.281599	10	74	197	6	64	0.0937500
NODE_1605_length_1800_cov_7.281599	10	74	198	5	64	0.0781250
NODE_1605_length_1800_cov_7.281599	10	74	200	1	64	0.0156250
NODE_1605_length_1800_cov_7.281599	10	74	75	2	64	0.0312500
NODE_1605_length_1800_cov_7.281599	10	74	83	1	64	0.0156250
NODE_1605_length_1800_cov_7.281599	10	74	88	11	64	0.1718750
NODE_1605_length_1800_cov_7.281599	10	74	94	1	64	0.0156250
NODE_1605_length_1800_cov_7.281599	10	74	95	1	64	0.0156250
NODE_1605_length_1800_cov_7.281599	10	74	109	2	64	0.0312500
NODE_1605_length_1800_cov_7.281599	10	74	117	3	64	0.0468750
NODE_1605_length_1800_cov_7.281599	10	74	126	3	64	0.0468750
NODE_1605_length_1800_cov_7.281599	10	74	134	2	64	0.0312500
NODE_1605_length_1800_cov_7.281599	10	74	138	2	64	0.0312500
NODE_1605_length_1800_cov_7.281599	10	74	161	3	64	0.0468750
NODE_1605_length_1800_cov_7.281599	10	74	163	1	64	0.0156250
NODE_1605_length_1800_cov_7.281599	10	74	171	1	64	0.0156250
NODE_1605_length_1800_cov_7.281599	10	74	174	8	64	0.1250000
NODE_1605_length_1800_cov_7.281599	10	74	175	1	64	0.0156250
NODE_1605_length_1800_cov_7.281599	10	74	177	3	64	0.0468750
NODE_1605_length_1800_cov_7.281599	10	74	183	1	64	0.0156250
NODE_1605_length_1800_cov_7.281599	10	74	187	1	64	0.0156250
NODE_1605_length_1800_cov_7.281599	10	74	189	5	64	0.0781250
NODE_1605_length_1800_cov_7.281599	10	74	197	6	64	0.0937500
NODE_1605_length_1800_cov_7.281599	10	74	198	5	64	0.0781250
NODE_1605_length_1800_cov_7.281599	10	74	200	1	64	0.0156250
NODE_1605_length_1800_cov_7.281599	10	74	75	2	64	0.0312500
NODE_1605_length_1800_cov_7.281599	10	74	83	1	64	0.0156250
NODE_1605_length_1800_cov_7.281599	10	74	88	11	64	0.1718750
NODE_1605_length_1800_cov_7.281599	10	74	94	1	64	0.0156250
NODE_1605_length_1800_cov_7.281599	10	74	95	1	64	0.0156250
NODE_1605_length_1800_cov_7.281599	10	74	109	2	64	0.0312500
NODE_1605_length_1800_cov_7.281599	10	74	117	3	64	0.0468750
NODE_1605_length_1800_cov_7.281599	10	74	126	3	64	0.0468750
NODE_1605_length_1800_cov_7.281599	10	74	134	2	64	0.0312500
NODE_1605_length_1800_cov_7.281599	10	74	138	2	64	0.0312500
NODE_1605_length_1800_cov_7.281599	10	74	161	3	64	0.0468750
NODE_1605_length_1800_cov_7.281599	10	74	163	1	64	0.0156250
NODE_1605_length_1800_cov_7.281599	10	74	171	1	64	0.0156250
NODE_1605_length_1800_cov_7.281599	10	74	174	8	64	0.1250000
NODE_1605_length_1800_cov_7.281599	10	74	175	1	64	0.0156250
NODE_1605_length_1800_cov_7.281599	10	74	177	3	64	0.0468750
NODE_1605_length_1800_cov_7.281599	10	74	183	1	64	0.0156250
NODE_1605_length_1800_cov_7.281599	10	74	187	1	64	0.0156250
NODE_1605_length_1800_cov_7.281599	10	74	189	5	64	0.0781250
NODE_1605_length_1800_cov_7.281599	10	74	197	6	64	0.0937500
NODE_1605_length_1800_cov_7.281599	10	74	198	5	64	0.0781250
NODE_1605_length_1800_cov_7.281599	10	74	200	1	64	0.0156250
NODE_1605_length_1800_cov_7.281599	47	127	174	4	80	0.0500000
NODE_1605_length_1800_cov_7.281599	47	127	175	1	80	0.0125000
NODE_1605_length_1800_cov_7.281599	47	127	177	3	80	0.0375000
NODE_1605_length_1800_cov_7.281599	47	127	183	1	80	0.0125000
NODE_1605_length_1800_cov_7.281599	47	127	187	1	80	0.0125000
NODE_1605_length_1800_cov_7.281599	47	127	189	5	80	0.0625000
NODE_1605_length_1800_cov_7.281599	47	127	194	1	80	0.0125000
NODE_1605_length_1800_cov_7.281599	47	127	197	6	80	0.0750000
NODE_1605_length_1800_cov_7.281599	47	127	198	8	80	0.1000000
NODE_1605_length_1800_cov_7.281599	47	127	200	15	80	0.1875000
NODE_1605_length_1800_cov_7.281599	47	127	201	1	80	0.0125000
NODE_1605_length_1800_cov_7.281599	47	127	202	4	80	0.0500000
NODE_1605_length_1800_cov_7.281599	47	127	208	4	80	0.0500000
NODE_1605_length_1800_cov_7.281599	47	127	209	4	80	0.0500000
NODE_1605_length_1800_cov_7.281599	47	127	210	3	80	0.0375000
NODE_1605_length_1800_cov_7.281599	47	127	212	3	80	0.0375000
NODE_1605_length_1800_cov_7.281599	47	127	213	1	80	0.0125000
NODE_1605_length_1800_cov_7.281599	47	127	215	8	80	0.1000000
NODE_1605_length_1800_cov_7.281599	47	127	217	7	80	0.0875000
NODE_1605_length_1800_cov_7.281599	63	126	197	5	63	0.0793651
NODE_1605_length_1800_cov_7.281599	63	126	198	8	63	0.1269841
NODE_1605_length_1800_cov_7.281599	63	126	200	15	63	0.2380952
NODE_1605_length_1800_cov_7.281599	63	126	201	1	63	0.0158730
NODE_1605_length_1800_cov_7.281599	63	126	202	4	63	0.0634921
NODE_1605_length_1800_cov_7.281599	63	126	208	4	63	0.0634921
NODE_1605_length_1800_cov_7.281599	63	126	209	4	63	0.0634921
NODE_1605_length_1800_cov_7.281599	63	126	210	3	63	0.0476190
NODE_1605_length_1800_cov_7.281599	63	126	212	3	63	0.0476190
NODE_1605_length_1800_cov_7.281599	63	126	213	1	63	0.0158730
NODE_1605_length_1800_cov_7.281599	63	126	215	8	63	0.1269841
NODE_1605_length_1800_cov_7.281599	63	126	217	7	63	0.1111111
NODE_1616_length_1793_cov_16.161157	539	619	0	57	80	0.7125000
NODE_1616_length_1793_cov_16.161157	539	619	1	22	80	0.2750000
NODE_1616_length_1793_cov_16.161157	539	619	2	1	80	0.0125000
NODE_1616_length_1793_cov_16.161157	592	672	0	80	80	1.0000000
NODE_1616_length_1793_cov_16.161157	1202	1281	0	79	79	1.0000000
NODE_1616_length_1793_cov_16.161157	1254	1335	0	81	81	1.0000000
NODE_1617_length_1793_cov_14.322904	521	601	0	35	80	0.4375000
NODE_1617_length_1793_cov_14.322904	521	601	2	45	80	0.5625000
NODE_1617_length_1793_cov_14.322904	574	654	0	80	80	1.0000000
NODE_1617_length_1793_cov_14.322904	1230	1310	0	80	80	1.0000000
NODE_1618_length_1791_cov_5.516548	1190	1261	0	71	71	1.0000000
NODE_1621_length_1790_cov_4.282082	684	764	0	80	80	1.0000000
NODE_1621_length_1790_cov_4.282082	737	817	0	80	80	1.0000000
NODE_1623_length_1788_cov_39.558911	385	465	0	80	80	1.0000000
NODE_1623_length_1788_cov_39.558911	438	518	0	80	80	1.0000000
NODE_1623_length_1788_cov_39.558911	514	594	0	80	80	1.0000000
NODE_1623_length_1788_cov_39.558911	567	647	0	80	80	1.0000000
NODE_1624_length_1787_cov_44.927133	530	610	63	2	80	0.0250000
NODE_1624_length_1787_cov_44.927133	530	610	64	3	80	0.0375000
NODE_1624_length_1787_cov_44.927133	530	610	65	5	80	0.0625000
NODE_1624_length_1787_cov_44.927133	530	610	66	2	80	0.0250000
NODE_1624_length_1787_cov_44.927133	530	610	69	18	80	0.2250000
NODE_1624_length_1787_cov_44.927133	530	610	70	4	80	0.0500000
NODE_1624_length_1787_cov_44.927133	530	610	71	7	80	0.0875000
NODE_1624_length_1787_cov_44.927133	530	610	72	12	80	0.1500000
NODE_1624_length_1787_cov_44.927133	530	610	73	6	80	0.0750000
NODE_1624_length_1787_cov_44.927133	530	610	75	1	80	0.0125000
NODE_1624_length_1787_cov_44.927133	530	610	79	5	80	0.0625000
NODE_1624_length_1787_cov_44.927133	530	610	81	6	80	0.0750000
NODE_1624_length_1787_cov_44.927133	530	610	83	3	80	0.0375000
NODE_1624_length_1787_cov_44.927133	530	610	85	4	80	0.0500000
NODE_1624_length_1787_cov_44.927133	530	610	87	2	80	0.0250000
NODE_1625_length_1787_cov_2.752370	675	755	6	18	80	0.2250000
NODE_1625_length_1787_cov_2.752370	675	755	8	47	80	0.5875000
NODE_1625_length_1787_cov_2.752370	675	755	10	15	80	0.1875000
NODE_1625_length_1787_cov_2.752370	728	806	8	12	78	0.1538462
NODE_1625_length_1787_cov_2.752370	728	806	9	16	78	0.2051282
NODE_1625_length_1787_cov_2.752370	728	806	10	41	78	0.5256410
NODE_1625_length_1787_cov_2.752370	728	806	14	7	78	0.0897436
NODE_1625_length_1787_cov_2.752370	728	806	16	2	78	0.0256410
NODE_1626_length_1786_cov_13.459395	523	603	0	80	80	1.0000000
NODE_1626_length_1786_cov_13.459395	576	656	0	27	80	0.3375000
NODE_1626_length_1786_cov_13.459395	576	656	4	53	80	0.6625000
NODE_1633_length_1784_cov_40.769733	358	438	0	80	80	1.0000000
NODE_1633_length_1784_cov_40.769733	411	491	0	80	80	1.0000000
NODE_1633_length_1784_cov_40.769733	1057	1137	2	71	80	0.8875000
NODE_1633_length_1784_cov_40.769733	1057	1137	3	1	80	0.0125000
NODE_1633_length_1784_cov_40.769733	1057	1137	4	8	80	0.1000000
NODE_1633_length_1784_cov_40.769733	1110	1190	2	80	80	1.0000000
NODE_1633_length_1784_cov_40.769733	1186	1266	2	61	80	0.7625000
NODE_1633_length_1784_cov_40.769733	1186	1266	3	2	80	0.0250000
NODE_1633_length_1784_cov_40.769733	1186	1266	4	17	80	0.2125000
NODE_1633_length_1784_cov_40.769733	1239	1319	2	24	80	0.3000000
NODE_1633_length_1784_cov_40.769733	1239	1319	4	8	80	0.1000000
NODE_1633_length_1784_cov_40.769733	1239	1319	8	22	80	0.2750000
NODE_1633_length_1784_cov_40.769733	1239	1319	10	26	80	0.3250000
NODE_1634_length_1784_cov_6.049258	1646	1725	0	7	79	0.0886076
NODE_1634_length_1784_cov_6.049258	1646	1725	4	72	79	0.9113924
NODE_1637_length_1783_cov_45.569477	600	680	0	80	80	1.0000000
NODE_1637_length_1783_cov_45.569477	653	733	0	80	80	1.0000000
NODE_1640_length_1780_cov_21.089233	361	441	0	35	80	0.4375000
NODE_1640_length_1780_cov_21.089233	361	441	4	45	80	0.5625000
NODE_1640_length_1780_cov_21.089233	414	494	0	77	80	0.9625000
NODE_1640_length_1780_cov_21.089233	414	494	4	3	80	0.0375000
NODE_1640_length_1780_cov_21.089233	1031	1104	0	27	73	0.3698630
NODE_1640_length_1780_cov_21.089233	1031	1104	2	5	73	0.0684932
NODE_1640_length_1780_cov_21.089233	1031	1104	6	19	73	0.2602740
NODE_1640_length_1780_cov_21.089233	1031	1104	7	1	73	0.0136986
NODE_1640_length_1780_cov_21.089233	1031	1104	8	6	73	0.0821918
NODE_1640_length_1780_cov_21.089233	1031	1104	12	2	73	0.0273973
NODE_1640_length_1780_cov_21.089233	1031	1104	14	1	73	0.0136986
NODE_1640_length_1780_cov_21.089233	1031	1104	16	2	73	0.0273973
NODE_1640_length_1780_cov_21.089233	1031	1104	18	5	73	0.0684932
NODE_1640_length_1780_cov_21.089233	1031	1104	20	5	73	0.0684932
NODE_1640_length_1780_cov_21.089233	1071	1112	6	11	41	0.2682927
NODE_1640_length_1780_cov_21.089233	1071	1112	7	1	41	0.0243902
NODE_1640_length_1780_cov_21.089233	1071	1112	8	6	41	0.1463415
NODE_1640_length_1780_cov_21.089233	1071	1112	12	2	41	0.0487805
NODE_1640_length_1780_cov_21.089233	1071	1112	14	1	41	0.0243902
NODE_1640_length_1780_cov_21.089233	1071	1112	16	2	41	0.0487805
NODE_1640_length_1780_cov_21.089233	1071	1112	18	5	41	0.1219512
NODE_1640_length_1780_cov_21.089233	1071	1112	20	5	41	0.1219512
NODE_1640_length_1780_cov_21.089233	1071	1112	23	1	41	0.0243902
NODE_1640_length_1780_cov_21.089233	1071	1112	25	7	41	0.1707317
NODE_1641_length_1780_cov_7.837597	1682	1747	0	65	65	1.0000000
NODE_1649_length_1778_cov_52.804050	1528	1568	0	3	40	0.0750000
NODE_1649_length_1778_cov_52.804050	1528	1568	14	2	40	0.0500000
NODE_1649_length_1778_cov_52.804050	1528	1568	24	6	40	0.1500000
NODE_1649_length_1778_cov_52.804050	1528	1568	26	2	40	0.0500000
NODE_1649_length_1778_cov_52.804050	1528	1568	32	2	40	0.0500000
NODE_1649_length_1778_cov_52.804050	1528	1568	75	1	40	0.0250000
NODE_1649_length_1778_cov_52.804050	1528	1568	81	1	40	0.0250000
NODE_1649_length_1778_cov_52.804050	1528	1568	82	1	40	0.0250000
NODE_1649_length_1778_cov_52.804050	1528	1568	86	1	40	0.0250000
NODE_1649_length_1778_cov_52.804050	1528	1568	96	3	40	0.0750000
NODE_1649_length_1778_cov_52.804050	1528	1568	100	5	40	0.1250000
NODE_1649_length_1778_cov_52.804050	1528	1568	108	7	40	0.1750000
NODE_1649_length_1778_cov_52.804050	1528	1568	114	1	40	0.0250000
NODE_1649_length_1778_cov_52.804050	1528	1568	115	1	40	0.0250000
NODE_1649_length_1778_cov_52.804050	1528	1568	116	4	40	0.1000000
NODE_1649_length_1778_cov_52.804050	1541	1621	32	2	80	0.0250000
NODE_1649_length_1778_cov_52.804050	1541	1621	75	1	80	0.0125000
NODE_1649_length_1778_cov_52.804050	1541	1621	81	1	80	0.0125000
NODE_1649_length_1778_cov_52.804050	1541	1621	82	1	80	0.0125000
NODE_1649_length_1778_cov_52.804050	1541	1621	86	1	80	0.0125000
NODE_1649_length_1778_cov_52.804050	1541	1621	96	3	80	0.0375000
NODE_1649_length_1778_cov_52.804050	1541	1621	100	5	80	0.0625000
NODE_1649_length_1778_cov_52.804050	1541	1621	108	7	80	0.0875000
NODE_1649_length_1778_cov_52.804050	1541	1621	114	1	80	0.0125000
NODE_1649_length_1778_cov_52.804050	1541	1621	115	1	80	0.0125000
NODE_1649_length_1778_cov_52.804050	1541	1621	116	4	80	0.0500000
NODE_1649_length_1778_cov_52.804050	1541	1621	119	1	80	0.0125000
NODE_1649_length_1778_cov_52.804050	1541	1621	120	4	80	0.0500000
NODE_1649_length_1778_cov_52.804050	1541	1621	124	2	80	0.0250000
NODE_1649_length_1778_cov_52.804050	1541	1621	130	1	80	0.0125000
NODE_1649_length_1778_cov_52.804050	1541	1621	132	32	80	0.4000000
NODE_1649_length_1778_cov_52.804050	1541	1621	136	5	80	0.0625000
NODE_1649_length_1778_cov_52.804050	1541	1621	138	2	80	0.0250000
NODE_1649_length_1778_cov_52.804050	1541	1621	140	1	80	0.0125000
NODE_1649_length_1778_cov_52.804050	1541	1621	148	5	80	0.0625000
NODE_1649_length_1778_cov_52.804050	1541	1621	32	2	80	0.0250000
NODE_1649_length_1778_cov_52.804050	1541	1621	75	1	80	0.0125000
NODE_1649_length_1778_cov_52.804050	1541	1621	81	1	80	0.0125000
NODE_1649_length_1778_cov_52.804050	1541	1621	82	1	80	0.0125000
NODE_1649_length_1778_cov_52.804050	1541	1621	86	1	80	0.0125000
NODE_1649_length_1778_cov_52.804050	1541	1621	96	3	80	0.0375000
NODE_1649_length_1778_cov_52.804050	1541	1621	100	5	80	0.0625000
NODE_1649_length_1778_cov_52.804050	1541	1621	108	7	80	0.0875000
NODE_1649_length_1778_cov_52.804050	1541	1621	114	1	80	0.0125000
NODE_1649_length_1778_cov_52.804050	1541	1621	115	1	80	0.0125000
NODE_1649_length_1778_cov_52.804050	1541	1621	116	4	80	0.0500000
NODE_1649_length_1778_cov_52.804050	1541	1621	119	1	80	0.0125000
NODE_1649_length_1778_cov_52.804050	1541	1621	120	4	80	0.0500000
NODE_1649_length_1778_cov_52.804050	1541	1621	124	2	80	0.0250000
NODE_1649_length_1778_cov_52.804050	1541	1621	130	1	80	0.0125000
NODE_1649_length_1778_cov_52.804050	1541	1621	132	32	80	0.4000000
NODE_1649_length_1778_cov_52.804050	1541	1621	136	5	80	0.0625000
NODE_1649_length_1778_cov_52.804050	1541	1621	138	2	80	0.0250000
NODE_1649_length_1778_cov_52.804050	1541	1621	140	1	80	0.0125000
NODE_1649_length_1778_cov_52.804050	1541	1621	148	5	80	0.0625000
NODE_1649_length_1778_cov_52.804050	1541	1621	32	2	80	0.0250000
NODE_1649_length_1778_cov_52.804050	1541	1621	75	1	80	0.0125000
NODE_1649_length_1778_cov_52.804050	1541	1621	81	1	80	0.0125000
NODE_1649_length_1778_cov_52.804050	1541	1621	82	1	80	0.0125000
NODE_1649_length_1778_cov_52.804050	1541	1621	86	1	80	0.0125000
NODE_1649_length_1778_cov_52.804050	1541	1621	96	3	80	0.0375000
NODE_1649_length_1778_cov_52.804050	1541	1621	100	5	80	0.0625000
NODE_1649_length_1778_cov_52.804050	1541	1621	108	7	80	0.0875000
NODE_1649_length_1778_cov_52.804050	1541	1621	114	1	80	0.0125000
NODE_1649_length_1778_cov_52.804050	1541	1621	115	1	80	0.0125000
NODE_1649_length_1778_cov_52.804050	1541	1621	116	4	80	0.0500000
NODE_1649_length_1778_cov_52.804050	1541	1621	119	1	80	0.0125000
NODE_1649_length_1778_cov_52.804050	1541	1621	120	4	80	0.0500000
NODE_1649_length_1778_cov_52.804050	1541	1621	124	2	80	0.0250000
NODE_1649_length_1778_cov_52.804050	1541	1621	130	1	80	0.0125000
NODE_1649_length_1778_cov_52.804050	1541	1621	132	32	80	0.4000000
NODE_1649_length_1778_cov_52.804050	1541	1621	136	5	80	0.0625000
NODE_1649_length_1778_cov_52.804050	1541	1621	138	2	80	0.0250000
NODE_1649_length_1778_cov_52.804050	1541	1621	140	1	80	0.0125000
NODE_1649_length_1778_cov_52.804050	1541	1621	148	5	80	0.0625000
NODE_1649_length_1778_cov_52.804050	1541	1621	32	2	80	0.0250000
NODE_1649_length_1778_cov_52.804050	1541	1621	75	1	80	0.0125000
NODE_1649_length_1778_cov_52.804050	1541	1621	81	1	80	0.0125000
NODE_1649_length_1778_cov_52.804050	1541	1621	82	1	80	0.0125000
NODE_1649_length_1778_cov_52.804050	1541	1621	86	1	80	0.0125000
NODE_1649_length_1778_cov_52.804050	1541	1621	96	3	80	0.0375000
NODE_1649_length_1778_cov_52.804050	1541	1621	100	5	80	0.0625000
NODE_1649_length_1778_cov_52.804050	1541	1621	108	7	80	0.0875000
NODE_1649_length_1778_cov_52.804050	1541	1621	114	1	80	0.0125000
NODE_1649_length_1778_cov_52.804050	1541	1621	115	1	80	0.0125000
NODE_1649_length_1778_cov_52.804050	1541	1621	116	4	80	0.0500000
NODE_1649_length_1778_cov_52.804050	1541	1621	119	1	80	0.0125000
NODE_1649_length_1778_cov_52.804050	1541	1621	120	4	80	0.0500000
NODE_1649_length_1778_cov_52.804050	1541	1621	124	2	80	0.0250000
NODE_1649_length_1778_cov_52.804050	1541	1621	130	1	80	0.0125000
NODE_1649_length_1778_cov_52.804050	1541	1621	132	32	80	0.4000000
NODE_1649_length_1778_cov_52.804050	1541	1621	136	5	80	0.0625000
NODE_1649_length_1778_cov_52.804050	1541	1621	138	2	80	0.0250000
NODE_1649_length_1778_cov_52.804050	1541	1621	140	1	80	0.0125000
NODE_1649_length_1778_cov_52.804050	1541	1621	148	5	80	0.0625000
NODE_1649_length_1778_cov_52.804050	1541	1621	32	2	80	0.0250000
NODE_1649_length_1778_cov_52.804050	1541	1621	75	1	80	0.0125000
NODE_1649_length_1778_cov_52.804050	1541	1621	81	1	80	0.0125000
NODE_1649_length_1778_cov_52.804050	1541	1621	82	1	80	0.0125000
NODE_1649_length_1778_cov_52.804050	1541	1621	86	1	80	0.0125000
NODE_1649_length_1778_cov_52.804050	1541	1621	96	3	80	0.0375000
NODE_1649_length_1778_cov_52.804050	1541	1621	100	5	80	0.0625000
NODE_1649_length_1778_cov_52.804050	1541	1621	108	7	80	0.0875000
NODE_1649_length_1778_cov_52.804050	1541	1621	114	1	80	0.0125000
NODE_1649_length_1778_cov_52.804050	1541	1621	115	1	80	0.0125000
NODE_1649_length_1778_cov_52.804050	1541	1621	116	4	80	0.0500000
NODE_1649_length_1778_cov_52.804050	1541	1621	119	1	80	0.0125000
NODE_1649_length_1778_cov_52.804050	1541	1621	120	4	80	0.0500000
NODE_1649_length_1778_cov_52.804050	1541	1621	124	2	80	0.0250000
NODE_1649_length_1778_cov_52.804050	1541	1621	130	1	80	0.0125000
NODE_1649_length_1778_cov_52.804050	1541	1621	132	32	80	0.4000000
NODE_1649_length_1778_cov_52.804050	1541	1621	136	5	80	0.0625000
NODE_1649_length_1778_cov_52.804050	1541	1621	138	2	80	0.0250000
NODE_1649_length_1778_cov_52.804050	1541	1621	140	1	80	0.0125000
NODE_1649_length_1778_cov_52.804050	1541	1621	148	5	80	0.0625000
NODE_1649_length_1778_cov_52.804050	1541	1621	32	2	80	0.0250000
NODE_1649_length_1778_cov_52.804050	1541	1621	75	1	80	0.0125000
NODE_1649_length_1778_cov_52.804050	1541	1621	81	1	80	0.0125000
NODE_1649_length_1778_cov_52.804050	1541	1621	82	1	80	0.0125000
NODE_1649_length_1778_cov_52.804050	1541	1621	86	1	80	0.0125000
NODE_1649_length_1778_cov_52.804050	1541	1621	96	3	80	0.0375000
NODE_1649_length_1778_cov_52.804050	1541	1621	100	5	80	0.0625000
NODE_1649_length_1778_cov_52.804050	1541	1621	108	7	80	0.0875000
NODE_1649_length_1778_cov_52.804050	1541	1621	114	1	80	0.0125000
NODE_1649_length_1778_cov_52.804050	1541	1621	115	1	80	0.0125000
NODE_1649_length_1778_cov_52.804050	1541	1621	116	4	80	0.0500000
NODE_1649_length_1778_cov_52.804050	1541	1621	119	1	80	0.0125000
NODE_1649_length_1778_cov_52.804050	1541	1621	120	4	80	0.0500000
NODE_1649_length_1778_cov_52.804050	1541	1621	124	2	80	0.0250000
NODE_1649_length_1778_cov_52.804050	1541	1621	130	1	80	0.0125000
NODE_1649_length_1778_cov_52.804050	1541	1621	132	32	80	0.4000000
NODE_1649_length_1778_cov_52.804050	1541	1621	136	5	80	0.0625000
NODE_1649_length_1778_cov_52.804050	1541	1621	138	2	80	0.0250000
NODE_1649_length_1778_cov_52.804050	1541	1621	140	1	80	0.0125000
NODE_1649_length_1778_cov_52.804050	1541	1621	148	5	80	0.0625000
NODE_1649_length_1778_cov_52.804050	1617	1697	81	5	80	0.0625000
NODE_1649_length_1778_cov_52.804050	1617	1697	83	1	80	0.0125000
NODE_1649_length_1778_cov_52.804050	1617	1697	87	4	80	0.0500000
NODE_1649_length_1778_cov_52.804050	1617	1697	91	6	80	0.0750000
NODE_1649_length_1778_cov_52.804050	1617	1697	117	1	80	0.0125000
NODE_1649_length_1778_cov_52.804050	1617	1697	118	1	80	0.0125000
NODE_1649_length_1778_cov_52.804050	1617	1697	121	1	80	0.0125000
NODE_1649_length_1778_cov_52.804050	1617	1697	146	5	80	0.0625000
NODE_1649_length_1778_cov_52.804050	1617	1697	148	10	80	0.1250000
NODE_1649_length_1778_cov_52.804050	1617	1697	150	1	80	0.0125000
NODE_1649_length_1778_cov_52.804050	1617	1697	152	1	80	0.0125000
NODE_1649_length_1778_cov_52.804050	1617	1697	154	5	80	0.0625000
NODE_1649_length_1778_cov_52.804050	1617	1697	155	1	80	0.0125000
NODE_1649_length_1778_cov_52.804050	1617	1697	156	2	80	0.0250000
NODE_1649_length_1778_cov_52.804050	1617	1697	158	7	80	0.0875000
NODE_1649_length_1778_cov_52.804050	1617	1697	160	3	80	0.0375000
NODE_1649_length_1778_cov_52.804050	1617	1697	161	3	80	0.0375000
NODE_1649_length_1778_cov_52.804050	1617	1697	164	6	80	0.0750000
NODE_1649_length_1778_cov_52.804050	1617	1697	165	2	80	0.0250000
NODE_1649_length_1778_cov_52.804050	1617	1697	171	1	80	0.0125000
NODE_1649_length_1778_cov_52.804050	1617	1697	173	4	80	0.0500000
NODE_1649_length_1778_cov_52.804050	1617	1697	175	4	80	0.0500000
NODE_1649_length_1778_cov_52.804050	1617	1697	177	3	80	0.0375000
NODE_1649_length_1778_cov_52.804050	1617	1697	178	1	80	0.0125000
NODE_1649_length_1778_cov_52.804050	1617	1697	180	1	80	0.0125000
NODE_1649_length_1778_cov_52.804050	1617	1697	184	1	80	0.0125000
NODE_1649_length_1778_cov_52.804050	1617	1697	81	5	80	0.0625000
NODE_1649_length_1778_cov_52.804050	1617	1697	83	1	80	0.0125000
NODE_1649_length_1778_cov_52.804050	1617	1697	87	4	80	0.0500000
NODE_1649_length_1778_cov_52.804050	1617	1697	91	6	80	0.0750000
NODE_1649_length_1778_cov_52.804050	1617	1697	117	1	80	0.0125000
NODE_1649_length_1778_cov_52.804050	1617	1697	118	1	80	0.0125000
NODE_1649_length_1778_cov_52.804050	1617	1697	121	1	80	0.0125000
NODE_1649_length_1778_cov_52.804050	1617	1697	146	5	80	0.0625000
NODE_1649_length_1778_cov_52.804050	1617	1697	148	10	80	0.1250000
NODE_1649_length_1778_cov_52.804050	1617	1697	150	1	80	0.0125000
NODE_1649_length_1778_cov_52.804050	1617	1697	152	1	80	0.0125000
NODE_1649_length_1778_cov_52.804050	1617	1697	154	5	80	0.0625000
NODE_1649_length_1778_cov_52.804050	1617	1697	155	1	80	0.0125000
NODE_1649_length_1778_cov_52.804050	1617	1697	156	2	80	0.0250000
NODE_1649_length_1778_cov_52.804050	1617	1697	158	7	80	0.0875000
NODE_1649_length_1778_cov_52.804050	1617	1697	160	3	80	0.0375000
NODE_1649_length_1778_cov_52.804050	1617	1697	161	3	80	0.0375000
NODE_1649_length_1778_cov_52.804050	1617	1697	164	6	80	0.0750000
NODE_1649_length_1778_cov_52.804050	1617	1697	165	2	80	0.0250000
NODE_1649_length_1778_cov_52.804050	1617	1697	171	1	80	0.0125000
NODE_1649_length_1778_cov_52.804050	1617	1697	173	4	80	0.0500000
NODE_1649_length_1778_cov_52.804050	1617	1697	175	4	80	0.0500000
NODE_1649_length_1778_cov_52.804050	1617	1697	177	3	80	0.0375000
NODE_1649_length_1778_cov_52.804050	1617	1697	178	1	80	0.0125000
NODE_1649_length_1778_cov_52.804050	1617	1697	180	1	80	0.0125000
NODE_1649_length_1778_cov_52.804050	1617	1697	184	1	80	0.0125000
NODE_1649_length_1778_cov_52.804050	1617	1697	81	5	80	0.0625000
NODE_1649_length_1778_cov_52.804050	1617	1697	83	1	80	0.0125000
NODE_1649_length_1778_cov_52.804050	1617	1697	87	4	80	0.0500000
NODE_1649_length_1778_cov_52.804050	1617	1697	91	6	80	0.0750000
NODE_1649_length_1778_cov_52.804050	1617	1697	117	1	80	0.0125000
NODE_1649_length_1778_cov_52.804050	1617	1697	118	1	80	0.0125000
NODE_1649_length_1778_cov_52.804050	1617	1697	121	1	80	0.0125000
NODE_1649_length_1778_cov_52.804050	1617	1697	146	5	80	0.0625000
NODE_1649_length_1778_cov_52.804050	1617	1697	148	10	80	0.1250000
NODE_1649_length_1778_cov_52.804050	1617	1697	150	1	80	0.0125000
NODE_1649_length_1778_cov_52.804050	1617	1697	152	1	80	0.0125000
NODE_1649_length_1778_cov_52.804050	1617	1697	154	5	80	0.0625000
NODE_1649_length_1778_cov_52.804050	1617	1697	155	1	80	0.0125000
NODE_1649_length_1778_cov_52.804050	1617	1697	156	2	80	0.0250000
NODE_1649_length_1778_cov_52.804050	1617	1697	158	7	80	0.0875000
NODE_1649_length_1778_cov_52.804050	1617	1697	160	3	80	0.0375000
NODE_1649_length_1778_cov_52.804050	1617	1697	161	3	80	0.0375000
NODE_1649_length_1778_cov_52.804050	1617	1697	164	6	80	0.0750000
NODE_1649_length_1778_cov_52.804050	1617	1697	165	2	80	0.0250000
NODE_1649_length_1778_cov_52.804050	1617	1697	171	1	80	0.0125000
NODE_1649_length_1778_cov_52.804050	1617	1697	173	4	80	0.0500000
NODE_1649_length_1778_cov_52.804050	1617	1697	175	4	80	0.0500000
NODE_1649_length_1778_cov_52.804050	1617	1697	177	3	80	0.0375000
NODE_1649_length_1778_cov_52.804050	1617	1697	178	1	80	0.0125000
NODE_1649_length_1778_cov_52.804050	1617	1697	180	1	80	0.0125000
NODE_1649_length_1778_cov_52.804050	1617	1697	184	1	80	0.0125000
NODE_1649_length_1778_cov_52.804050	1617	1697	81	5	80	0.0625000
NODE_1649_length_1778_cov_52.804050	1617	1697	83	1	80	0.0125000
NODE_1649_length_1778_cov_52.804050	1617	1697	87	4	80	0.0500000
NODE_1649_length_1778_cov_52.804050	1617	1697	91	6	80	0.0750000
NODE_1649_length_1778_cov_52.804050	1617	1697	117	1	80	0.0125000
NODE_1649_length_1778_cov_52.804050	1617	1697	118	1	80	0.0125000
NODE_1649_length_1778_cov_52.804050	1617	1697	121	1	80	0.0125000
NODE_1649_length_1778_cov_52.804050	1617	1697	146	5	80	0.0625000
NODE_1649_length_1778_cov_52.804050	1617	1697	148	10	80	0.1250000
NODE_1649_length_1778_cov_52.804050	1617	1697	150	1	80	0.0125000
NODE_1649_length_1778_cov_52.804050	1617	1697	152	1	80	0.0125000
NODE_1649_length_1778_cov_52.804050	1617	1697	154	5	80	0.0625000
NODE_1649_length_1778_cov_52.804050	1617	1697	155	1	80	0.0125000
NODE_1649_length_1778_cov_52.804050	1617	1697	156	2	80	0.0250000
NODE_1649_length_1778_cov_52.804050	1617	1697	158	7	80	0.0875000
NODE_1649_length_1778_cov_52.804050	1617	1697	160	3	80	0.0375000
NODE_1649_length_1778_cov_52.804050	1617	1697	161	3	80	0.0375000
NODE_1649_length_1778_cov_52.804050	1617	1697	164	6	80	0.0750000
NODE_1649_length_1778_cov_52.804050	1617	1697	165	2	80	0.0250000
NODE_1649_length_1778_cov_52.804050	1617	1697	171	1	80	0.0125000
NODE_1649_length_1778_cov_52.804050	1617	1697	173	4	80	0.0500000
NODE_1649_length_1778_cov_52.804050	1617	1697	175	4	80	0.0500000
NODE_1649_length_1778_cov_52.804050	1617	1697	177	3	80	0.0375000
NODE_1649_length_1778_cov_52.804050	1617	1697	178	1	80	0.0125000
NODE_1649_length_1778_cov_52.804050	1617	1697	180	1	80	0.0125000
NODE_1649_length_1778_cov_52.804050	1617	1697	184	1	80	0.0125000
NODE_1649_length_1778_cov_52.804050	1670	1750	30	2	80	0.0250000
NODE_1649_length_1778_cov_52.804050	1670	1750	32	5	80	0.0625000
NODE_1649_length_1778_cov_52.804050	1670	1750	34	1	80	0.0125000
NODE_1649_length_1778_cov_52.804050	1670	1750	38	2	80	0.0250000
NODE_1649_length_1778_cov_52.804050	1670	1750	45	5	80	0.0625000
NODE_1649_length_1778_cov_52.804050	1670	1750	54	4	80	0.0500000
NODE_1649_length_1778_cov_52.804050	1670	1750	56	1	80	0.0125000
NODE_1649_length_1778_cov_52.804050	1670	1750	57	6	80	0.0750000
NODE_1649_length_1778_cov_52.804050	1670	1750	59	1	80	0.0125000
NODE_1649_length_1778_cov_52.804050	1670	1750	62	1	80	0.0125000
NODE_1649_length_1778_cov_52.804050	1670	1750	63	6	80	0.0750000
NODE_1649_length_1778_cov_52.804050	1670	1750	65	4	80	0.0500000
NODE_1649_length_1778_cov_52.804050	1670	1750	71	1	80	0.0125000
NODE_1649_length_1778_cov_52.804050	1670	1750	73	6	80	0.0750000
NODE_1649_length_1778_cov_52.804050	1670	1750	81	13	80	0.1625000
NODE_1649_length_1778_cov_52.804050	1670	1750	83	1	80	0.0125000
NODE_1649_length_1778_cov_52.804050	1670	1750	87	4	80	0.0500000
NODE_1649_length_1778_cov_52.804050	1670	1750	91	6	80	0.0750000
NODE_1649_length_1778_cov_52.804050	1670	1750	117	1	80	0.0125000
NODE_1649_length_1778_cov_52.804050	1670	1750	118	1	80	0.0125000
NODE_1649_length_1778_cov_52.804050	1670	1750	121	1	80	0.0125000
NODE_1649_length_1778_cov_52.804050	1670	1750	146	5	80	0.0625000
NODE_1649_length_1778_cov_52.804050	1670	1750	158	3	80	0.0375000
NODE_1649_length_1778_cov_52.804050	1670	1750	30	2	80	0.0250000
NODE_1649_length_1778_cov_52.804050	1670	1750	32	5	80	0.0625000
NODE_1649_length_1778_cov_52.804050	1670	1750	34	1	80	0.0125000
NODE_1649_length_1778_cov_52.804050	1670	1750	38	2	80	0.0250000
NODE_1649_length_1778_cov_52.804050	1670	1750	45	5	80	0.0625000
NODE_1649_length_1778_cov_52.804050	1670	1750	54	4	80	0.0500000
NODE_1649_length_1778_cov_52.804050	1670	1750	56	1	80	0.0125000
NODE_1649_length_1778_cov_52.804050	1670	1750	57	6	80	0.0750000
NODE_1649_length_1778_cov_52.804050	1670	1750	59	1	80	0.0125000
NODE_1649_length_1778_cov_52.804050	1670	1750	62	1	80	0.0125000
NODE_1649_length_1778_cov_52.804050	1670	1750	63	6	80	0.0750000
NODE_1649_length_1778_cov_52.804050	1670	1750	65	4	80	0.0500000
NODE_1649_length_1778_cov_52.804050	1670	1750	71	1	80	0.0125000
NODE_1649_length_1778_cov_52.804050	1670	1750	73	6	80	0.0750000
NODE_1649_length_1778_cov_52.804050	1670	1750	81	13	80	0.1625000
NODE_1649_length_1778_cov_52.804050	1670	1750	83	1	80	0.0125000
NODE_1649_length_1778_cov_52.804050	1670	1750	87	4	80	0.0500000
NODE_1649_length_1778_cov_52.804050	1670	1750	91	6	80	0.0750000
NODE_1649_length_1778_cov_52.804050	1670	1750	117	1	80	0.0125000
NODE_1649_length_1778_cov_52.804050	1670	1750	118	1	80	0.0125000
NODE_1649_length_1778_cov_52.804050	1670	1750	121	1	80	0.0125000
NODE_1649_length_1778_cov_52.804050	1670	1750	146	5	80	0.0625000
NODE_1649_length_1778_cov_52.804050	1670	1750	158	3	80	0.0375000
NODE_1649_length_1778_cov_52.804050	1670	1750	30	2	80	0.0250000
NODE_1649_length_1778_cov_52.804050	1670	1750	32	5	80	0.0625000
NODE_1649_length_1778_cov_52.804050	1670	1750	34	1	80	0.0125000
NODE_1649_length_1778_cov_52.804050	1670	1750	38	2	80	0.0250000
NODE_1649_length_1778_cov_52.804050	1670	1750	45	5	80	0.0625000
NODE_1649_length_1778_cov_52.804050	1670	1750	54	4	80	0.0500000
NODE_1649_length_1778_cov_52.804050	1670	1750	56	1	80	0.0125000
NODE_1649_length_1778_cov_52.804050	1670	1750	57	6	80	0.0750000
NODE_1649_length_1778_cov_52.804050	1670	1750	59	1	80	0.0125000
NODE_1649_length_1778_cov_52.804050	1670	1750	62	1	80	0.0125000
NODE_1649_length_1778_cov_52.804050	1670	1750	63	6	80	0.0750000
NODE_1649_length_1778_cov_52.804050	1670	1750	65	4	80	0.0500000
NODE_1649_length_1778_cov_52.804050	1670	1750	71	1	80	0.0125000
NODE_1649_length_1778_cov_52.804050	1670	1750	73	6	80	0.0750000
NODE_1649_length_1778_cov_52.804050	1670	1750	81	13	80	0.1625000
NODE_1649_length_1778_cov_52.804050	1670	1750	83	1	80	0.0125000
NODE_1649_length_1778_cov_52.804050	1670	1750	87	4	80	0.0500000
NODE_1649_length_1778_cov_52.804050	1670	1750	91	6	80	0.0750000
NODE_1649_length_1778_cov_52.804050	1670	1750	117	1	80	0.0125000
NODE_1649_length_1778_cov_52.804050	1670	1750	118	1	80	0.0125000
NODE_1649_length_1778_cov_52.804050	1670	1750	121	1	80	0.0125000
NODE_1649_length_1778_cov_52.804050	1670	1750	146	5	80	0.0625000
NODE_1649_length_1778_cov_52.804050	1670	1750	158	3	80	0.0375000
NODE_1649_length_1778_cov_52.804050	1670	1741	38	1	71	0.0140845
NODE_1649_length_1778_cov_52.804050	1670	1741	45	5	71	0.0704225
NODE_1649_length_1778_cov_52.804050	1670	1741	54	4	71	0.0563380
NODE_1649_length_1778_cov_52.804050	1670	1741	56	1	71	0.0140845
NODE_1649_length_1778_cov_52.804050	1670	1741	57	6	71	0.0845070
NODE_1649_length_1778_cov_52.804050	1670	1741	59	1	71	0.0140845
NODE_1649_length_1778_cov_52.804050	1670	1741	62	1	71	0.0140845
NODE_1649_length_1778_cov_52.804050	1670	1741	63	6	71	0.0845070
NODE_1649_length_1778_cov_52.804050	1670	1741	65	4	71	0.0563380
NODE_1649_length_1778_cov_52.804050	1670	1741	71	1	71	0.0140845
NODE_1649_length_1778_cov_52.804050	1670	1741	73	6	71	0.0845070
NODE_1649_length_1778_cov_52.804050	1670	1741	81	13	71	0.1830986
NODE_1649_length_1778_cov_52.804050	1670	1741	83	1	71	0.0140845
NODE_1649_length_1778_cov_52.804050	1670	1741	87	4	71	0.0563380
NODE_1649_length_1778_cov_52.804050	1670	1741	91	6	71	0.0845070
NODE_1649_length_1778_cov_52.804050	1670	1741	117	1	71	0.0140845
NODE_1649_length_1778_cov_52.804050	1670	1741	118	1	71	0.0140845
NODE_1649_length_1778_cov_52.804050	1670	1741	121	1	71	0.0140845
NODE_1649_length_1778_cov_52.804050	1670	1741	146	5	71	0.0704225
NODE_1649_length_1778_cov_52.804050	1670	1741	158	3	71	0.0422535
NODE_1649_length_1778_cov_52.804050	1673	1743	34	1	70	0.0142857
NODE_1649_length_1778_cov_52.804050	1673	1743	38	2	70	0.0285714
NODE_1649_length_1778_cov_52.804050	1673	1743	45	5	70	0.0714286
NODE_1649_length_1778_cov_52.804050	1673	1743	54	4	70	0.0571429
NODE_1649_length_1778_cov_52.804050	1673	1743	56	1	70	0.0142857
NODE_1649_length_1778_cov_52.804050	1673	1743	57	6	70	0.0857143
NODE_1649_length_1778_cov_52.804050	1673	1743	59	1	70	0.0142857
NODE_1649_length_1778_cov_52.804050	1673	1743	62	1	70	0.0142857
NODE_1649_length_1778_cov_52.804050	1673	1743	63	6	70	0.0857143
NODE_1649_length_1778_cov_52.804050	1673	1743	65	4	70	0.0571429
NODE_1649_length_1778_cov_52.804050	1673	1743	71	1	70	0.0142857
NODE_1649_length_1778_cov_52.804050	1673	1743	73	6	70	0.0857143
NODE_1649_length_1778_cov_52.804050	1673	1743	81	13	70	0.1857143
NODE_1649_length_1778_cov_52.804050	1673	1743	83	1	70	0.0142857
NODE_1649_length_1778_cov_52.804050	1673	1743	87	4	70	0.0571429
NODE_1649_length_1778_cov_52.804050	1673	1743	91	6	70	0.0857143
NODE_1649_length_1778_cov_52.804050	1673	1743	117	1	70	0.0142857
NODE_1649_length_1778_cov_52.804050	1673	1743	118	1	70	0.0142857
NODE_1649_length_1778_cov_52.804050	1673	1743	121	1	70	0.0142857
NODE_1649_length_1778_cov_52.804050	1673	1743	146	5	70	0.0714286
NODE_1649_length_1778_cov_52.804050	1679	1750	30	2	71	0.0281690
NODE_1649_length_1778_cov_52.804050	1679	1750	32	5	71	0.0704225
NODE_1649_length_1778_cov_52.804050	1679	1750	34	1	71	0.0140845
NODE_1649_length_1778_cov_52.804050	1679	1750	38	2	71	0.0281690
NODE_1649_length_1778_cov_52.804050	1679	1750	45	5	71	0.0704225
NODE_1649_length_1778_cov_52.804050	1679	1750	54	4	71	0.0563380
NODE_1649_length_1778_cov_52.804050	1679	1750	56	1	71	0.0140845
NODE_1649_length_1778_cov_52.804050	1679	1750	57	6	71	0.0845070
NODE_1649_length_1778_cov_52.804050	1679	1750	59	1	71	0.0140845
NODE_1649_length_1778_cov_52.804050	1679	1750	62	1	71	0.0140845
NODE_1649_length_1778_cov_52.804050	1679	1750	63	6	71	0.0845070
NODE_1649_length_1778_cov_52.804050	1679	1750	65	4	71	0.0563380
NODE_1649_length_1778_cov_52.804050	1679	1750	71	1	71	0.0140845
NODE_1649_length_1778_cov_52.804050	1679	1750	73	6	71	0.0845070
NODE_1649_length_1778_cov_52.804050	1679	1750	81	13	71	0.1830986
NODE_1649_length_1778_cov_52.804050	1679	1750	83	1	71	0.0140845
NODE_1649_length_1778_cov_52.804050	1679	1750	87	4	71	0.0563380
NODE_1649_length_1778_cov_52.804050	1679	1750	91	6	71	0.0845070
NODE_1649_length_1778_cov_52.804050	1679	1750	117	1	71	0.0140845
NODE_1649_length_1778_cov_52.804050	1679	1750	118	1	71	0.0140845
NODE_1651_length_1776_cov_43.081694	1246	1308	0	56	62	0.9032258
NODE_1651_length_1776_cov_43.081694	1246	1308	10	1	62	0.0161290
NODE_1651_length_1776_cov_43.081694	1246	1308	21	3	62	0.0483871
NODE_1651_length_1776_cov_43.081694	1246	1308	23	1	62	0.0161290
NODE_1651_length_1776_cov_43.081694	1246	1308	102	1	62	0.0161290
NODE_1651_length_1776_cov_43.081694	1281	1361	0	80	80	1.0000000
NODE_1652_length_1776_cov_9.256410	1120	1200	0	28	80	0.3500000
NODE_1652_length_1776_cov_9.256410	1120	1200	2	52	80	0.6500000
NODE_1652_length_1776_cov_9.256410	1173	1253	0	16	80	0.2000000
NODE_1652_length_1776_cov_9.256410	1173	1253	2	64	80	0.8000000
NODE_1652_length_1776_cov_9.256410	1249	1329	2	59	80	0.7375000
NODE_1652_length_1776_cov_9.256410	1249	1329	4	11	80	0.1375000
NODE_1652_length_1776_cov_9.256410	1249	1329	5	7	80	0.0875000
NODE_1652_length_1776_cov_9.256410	1249	1329	6	3	80	0.0375000
NODE_1652_length_1776_cov_9.256410	1302	1382	2	6	80	0.0750000
NODE_1652_length_1776_cov_9.256410	1302	1382	4	25	80	0.3125000
NODE_1652_length_1776_cov_9.256410	1302	1382	5	7	80	0.0875000
NODE_1652_length_1776_cov_9.256410	1302	1382	6	42	80	0.5250000
NODE_1657_length_1775_cov_54.208234	1103	1167	121	1	64	0.0156250
NODE_1657_length_1775_cov_54.208234	1103	1167	125	1	64	0.0156250
NODE_1657_length_1775_cov_54.208234	1103	1167	130	1	64	0.0156250
NODE_1657_length_1775_cov_54.208234	1103	1167	131	2	64	0.0312500
NODE_1657_length_1775_cov_54.208234	1103	1167	132	5	64	0.0781250
NODE_1657_length_1775_cov_54.208234	1103	1167	135	1	64	0.0156250
NODE_1657_length_1775_cov_54.208234	1103	1167	136	2	64	0.0312500
NODE_1657_length_1775_cov_54.208234	1103	1167	137	1	64	0.0156250
NODE_1657_length_1775_cov_54.208234	1103	1167	138	3	64	0.0468750
NODE_1657_length_1775_cov_54.208234	1103	1167	139	2	64	0.0312500
NODE_1657_length_1775_cov_54.208234	1103	1167	140	3	64	0.0468750
NODE_1657_length_1775_cov_54.208234	1103	1167	141	1	64	0.0156250
NODE_1657_length_1775_cov_54.208234	1103	1167	142	2	64	0.0312500
NODE_1657_length_1775_cov_54.208234	1103	1167	144	4	64	0.0625000
NODE_1657_length_1775_cov_54.208234	1103	1167	145	1	64	0.0156250
NODE_1657_length_1775_cov_54.208234	1103	1167	147	3	64	0.0468750
NODE_1657_length_1775_cov_54.208234	1103	1167	148	5	64	0.0781250
NODE_1657_length_1775_cov_54.208234	1103	1167	149	3	64	0.0468750
NODE_1657_length_1775_cov_54.208234	1103	1167	150	5	64	0.0781250
NODE_1657_length_1775_cov_54.208234	1103	1167	151	2	64	0.0312500
NODE_1657_length_1775_cov_54.208234	1103	1167	155	1	64	0.0156250
NODE_1657_length_1775_cov_54.208234	1103	1167	156	1	64	0.0156250
NODE_1657_length_1775_cov_54.208234	1103	1167	159	4	64	0.0625000
NODE_1657_length_1775_cov_54.208234	1103	1167	161	1	64	0.0156250
NODE_1657_length_1775_cov_54.208234	1103	1167	165	1	64	0.0156250
NODE_1657_length_1775_cov_54.208234	1103	1167	166	1	64	0.0156250
NODE_1657_length_1775_cov_54.208234	1103	1167	169	6	64	0.0937500
NODE_1657_length_1775_cov_54.208234	1103	1167	171	1	64	0.0156250
NODE_1657_length_1775_cov_54.208234	1103	1167	121	1	64	0.0156250
NODE_1657_length_1775_cov_54.208234	1103	1167	125	1	64	0.0156250
NODE_1657_length_1775_cov_54.208234	1103	1167	130	1	64	0.0156250
NODE_1657_length_1775_cov_54.208234	1103	1167	131	2	64	0.0312500
NODE_1657_length_1775_cov_54.208234	1103	1167	132	5	64	0.0781250
NODE_1657_length_1775_cov_54.208234	1103	1167	135	1	64	0.0156250
NODE_1657_length_1775_cov_54.208234	1103	1167	136	2	64	0.0312500
NODE_1657_length_1775_cov_54.208234	1103	1167	137	1	64	0.0156250
NODE_1657_length_1775_cov_54.208234	1103	1167	138	3	64	0.0468750
NODE_1657_length_1775_cov_54.208234	1103	1167	139	2	64	0.0312500
NODE_1657_length_1775_cov_54.208234	1103	1167	140	3	64	0.0468750
NODE_1657_length_1775_cov_54.208234	1103	1167	141	1	64	0.0156250
NODE_1657_length_1775_cov_54.208234	1103	1167	142	2	64	0.0312500
NODE_1657_length_1775_cov_54.208234	1103	1167	144	4	64	0.0625000
NODE_1657_length_1775_cov_54.208234	1103	1167	145	1	64	0.0156250
NODE_1657_length_1775_cov_54.208234	1103	1167	147	3	64	0.0468750
NODE_1657_length_1775_cov_54.208234	1103	1167	148	5	64	0.0781250
NODE_1657_length_1775_cov_54.208234	1103	1167	149	3	64	0.0468750
NODE_1657_length_1775_cov_54.208234	1103	1167	150	5	64	0.0781250
NODE_1657_length_1775_cov_54.208234	1103	1167	151	2	64	0.0312500
NODE_1657_length_1775_cov_54.208234	1103	1167	155	1	64	0.0156250
NODE_1657_length_1775_cov_54.208234	1103	1167	156	1	64	0.0156250
NODE_1657_length_1775_cov_54.208234	1103	1167	159	4	64	0.0625000
NODE_1657_length_1775_cov_54.208234	1103	1167	161	1	64	0.0156250
NODE_1657_length_1775_cov_54.208234	1103	1167	165	1	64	0.0156250
NODE_1657_length_1775_cov_54.208234	1103	1167	166	1	64	0.0156250
NODE_1657_length_1775_cov_54.208234	1103	1167	169	6	64	0.0937500
NODE_1657_length_1775_cov_54.208234	1103	1167	171	1	64	0.0156250
NODE_1657_length_1775_cov_54.208234	1140	1200	112	6	60	0.1000000
NODE_1657_length_1775_cov_54.208234	1140	1200	115	1	60	0.0166667
NODE_1657_length_1775_cov_54.208234	1140	1200	116	2	60	0.0333333
NODE_1657_length_1775_cov_54.208234	1140	1200	117	8	60	0.1333333
NODE_1657_length_1775_cov_54.208234	1140	1200	119	7	60	0.1166667
NODE_1657_length_1775_cov_54.208234	1140	1200	121	1	60	0.0166667
NODE_1657_length_1775_cov_54.208234	1140	1200	125	1	60	0.0166667
NODE_1657_length_1775_cov_54.208234	1140	1200	126	2	60	0.0333333
NODE_1657_length_1775_cov_54.208234	1140	1200	127	3	60	0.0500000
NODE_1657_length_1775_cov_54.208234	1140	1200	128	2	60	0.0333333
NODE_1657_length_1775_cov_54.208234	1140	1200	129	1	60	0.0166667
NODE_1657_length_1775_cov_54.208234	1140	1200	130	2	60	0.0333333
NODE_1657_length_1775_cov_54.208234	1140	1200	131	2	60	0.0333333
NODE_1657_length_1775_cov_54.208234	1140	1200	132	1	60	0.0166667
NODE_1657_length_1775_cov_54.208234	1140	1200	140	1	60	0.0166667
NODE_1657_length_1775_cov_54.208234	1140	1200	142	2	60	0.0333333
NODE_1657_length_1775_cov_54.208234	1140	1200	144	3	60	0.0500000
NODE_1657_length_1775_cov_54.208234	1140	1200	148	2	60	0.0333333
NODE_1657_length_1775_cov_54.208234	1140	1200	149	3	60	0.0500000
NODE_1657_length_1775_cov_54.208234	1140	1200	150	5	60	0.0833333
NODE_1657_length_1775_cov_54.208234	1140	1200	151	2	60	0.0333333
NODE_1657_length_1775_cov_54.208234	1140	1200	155	1	60	0.0166667
NODE_1657_length_1775_cov_54.208234	1140	1200	156	1	60	0.0166667
NODE_1657_length_1775_cov_54.208234	1140	1200	159	1	60	0.0166667
NODE_1658_length_1775_cov_13.181981	1170	1250	0	80	80	1.0000000
NODE_1658_length_1775_cov_13.181981	1223	1303	0	80	80	1.0000000
NODE_1659_length_1775_cov_4.218974	1304	1384	0	80	80	1.0000000
NODE_1659_length_1775_cov_4.218974	1357	1437	0	80	80	1.0000000
NODE_1660_length_1774_cov_48.617313	345	425	4	80	80	1.0000000
NODE_1660_length_1774_cov_48.617313	398	478	0	34	80	0.4250000
NODE_1660_length_1774_cov_48.617313	398	478	2	10	80	0.1250000
NODE_1660_length_1774_cov_48.617313	398	478	4	36	80	0.4500000
NODE_1660_length_1774_cov_48.617313	474	554	0	80	80	1.0000000
NODE_1660_length_1774_cov_48.617313	527	607	0	80	80	1.0000000
NODE_1660_length_1774_cov_48.617313	1027	1107	0	62	80	0.7750000
NODE_1660_length_1774_cov_48.617313	1027	1107	2	18	80	0.2250000
NODE_1660_length_1774_cov_48.617313	1080	1160	0	80	80	1.0000000
NODE_1660_length_1774_cov_48.617313	1156	1236	0	61	80	0.7625000
NODE_1660_length_1774_cov_48.617313	1156	1236	4	19	80	0.2375000
NODE_1660_length_1774_cov_48.617313	1209	1289	0	8	80	0.1000000
NODE_1660_length_1774_cov_48.617313	1209	1289	4	72	80	0.9000000
NODE_1662_length_1774_cov_8.011343	1655	1735	0	80	80	1.0000000
NODE_1663_length_1773_cov_5.547192	433	513	0	80	80	1.0000000
NODE_1663_length_1773_cov_5.547192	486	566	0	80	80	1.0000000
NODE_1664_length_1773_cov_3.925329	267	347	0	14	80	0.1750000
NODE_1664_length_1773_cov_3.925329	267	347	4	66	80	0.8250000
NODE_1664_length_1773_cov_3.925329	320	400	0	18	80	0.2250000
NODE_1664_length_1773_cov_3.925329	320	400	4	62	80	0.7750000
NODE_1666_length_1770_cov_9.912029	369	437	0	68	68	1.0000000
NODE_1666_length_1770_cov_9.912029	388	431	0	43	43	1.0000000
NODE_1666_length_1770_cov_9.912029	509	577	0	68	68	1.0000000
NODE_1666_length_1770_cov_9.912029	515	571	0	56	56	1.0000000
NODE_1666_length_1770_cov_9.912029	579	618	0	39	39	1.0000000
NODE_1666_length_1770_cov_9.912029	697	776	0	79	79	1.0000000
NODE_1666_length_1770_cov_9.912029	714	794	0	78	80	0.9750000
NODE_1666_length_1770_cov_9.912029	714	794	2	2	80	0.0250000
NODE_1666_length_1770_cov_9.912029	767	819	0	25	52	0.4807692
NODE_1666_length_1770_cov_9.912029	767	819	2	27	52	0.5192308
NODE_1666_length_1770_cov_9.912029	785	819	0	7	34	0.2058824
NODE_1666_length_1770_cov_9.912029	785	819	2	27	34	0.7941176
NODE_1667_length_1768_cov_9.134811	687	736	28	3	49	0.0612245
NODE_1667_length_1768_cov_9.134811	687	736	30	7	49	0.1428571
NODE_1667_length_1768_cov_9.134811	687	736	31	6	49	0.1224490
NODE_1667_length_1768_cov_9.134811	687	736	32	6	49	0.1224490
NODE_1667_length_1768_cov_9.134811	687	736	33	9	49	0.1836735
NODE_1667_length_1768_cov_9.134811	687	736	34	11	49	0.2244898
NODE_1667_length_1768_cov_9.134811	687	736	35	7	49	0.1428571
NODE_1668_length_1768_cov_6.605153	1207	1287	0	80	80	1.0000000
NODE_1668_length_1768_cov_6.605153	1260	1340	0	80	80	1.0000000
NODE_1668_length_1768_cov_6.605153	1336	1416	0	80	80	1.0000000
NODE_1668_length_1768_cov_6.605153	1389	1469	0	80	80	1.0000000
NODE_1669_length_1767_cov_5.475420	508	588	4	15	80	0.1875000
NODE_1669_length_1767_cov_5.475420	508	588	6	10	80	0.1250000
NODE_1669_length_1767_cov_5.475420	508	588	8	1	80	0.0125000
NODE_1669_length_1767_cov_5.475420	508	588	10	1	80	0.0125000
NODE_1669_length_1767_cov_5.475420	508	588	12	2	80	0.0250000
NODE_1669_length_1767_cov_5.475420	508	588	14	23	80	0.2875000
NODE_1669_length_1767_cov_5.475420	508	588	16	28	80	0.3500000
NODE_1680_length_1762_cov_18.673482	606	686	4	16	80	0.2000000
NODE_1680_length_1762_cov_18.673482	606	686	6	50	80	0.6250000
NODE_1680_length_1762_cov_18.673482	606	686	8	14	80	0.1750000
NODE_1680_length_1762_cov_18.673482	659	739	0	21	80	0.2625000
NODE_1680_length_1762_cov_18.673482	659	739	2	32	80	0.4000000
NODE_1680_length_1762_cov_18.673482	659	739	4	16	80	0.2000000
NODE_1680_length_1762_cov_18.673482	659	739	8	11	80	0.1375000
NODE_1680_length_1762_cov_18.673482	735	815	0	51	80	0.6375000
NODE_1680_length_1762_cov_18.673482	735	815	2	29	80	0.3625000
NODE_1680_length_1762_cov_18.673482	788	868	2	80	80	1.0000000
NODE_1681_length_1762_cov_6.760072	1033	1113	2	59	80	0.7375000
NODE_1681_length_1762_cov_6.760072	1033	1113	7	9	80	0.1125000
NODE_1681_length_1762_cov_6.760072	1033	1113	9	12	80	0.1500000
NODE_1681_length_1762_cov_6.760072	1086	1166	2	6	80	0.0750000
NODE_1681_length_1762_cov_6.760072	1086	1166	7	60	80	0.7500000
NODE_1681_length_1762_cov_6.760072	1086	1166	9	14	80	0.1750000
NODE_1685_length_1760_cov_8.064419	941	1021	0	61	80	0.7625000
NODE_1685_length_1760_cov_8.064419	941	1021	2	19	80	0.2375000
NODE_1685_length_1760_cov_8.064419	994	1074	0	8	80	0.1000000
NODE_1685_length_1760_cov_8.064419	994	1074	2	72	80	0.9000000
NODE_1692_length_1758_cov_99.869198	599	679	1	39	80	0.4875000
NODE_1692_length_1758_cov_99.869198	599	679	3	25	80	0.3125000
NODE_1692_length_1758_cov_99.869198	599	679	4	9	80	0.1125000
NODE_1692_length_1758_cov_99.869198	599	679	5	7	80	0.0875000
NODE_1692_length_1758_cov_99.869198	652	732	0	18	80	0.2250000
NODE_1692_length_1758_cov_99.869198	652	732	1	57	80	0.7125000
NODE_1692_length_1758_cov_99.869198	652	732	2	5	80	0.0625000
NODE_1692_length_1758_cov_99.869198	728	808	2	9	80	0.1125000
NODE_1692_length_1758_cov_99.869198	728	808	18	53	80	0.6625000
NODE_1692_length_1758_cov_99.869198	728	808	20	18	80	0.2250000
NODE_1692_length_1758_cov_99.869198	781	861	2	6	80	0.0750000
NODE_1692_length_1758_cov_99.869198	781	861	3	17	80	0.2125000
NODE_1692_length_1758_cov_99.869198	781	861	15	1	80	0.0125000
NODE_1692_length_1758_cov_99.869198	781	861	18	38	80	0.4750000
NODE_1692_length_1758_cov_99.869198	781	861	20	18	80	0.2250000
NODE_1693_length_1757_cov_3.126659	49	121	2	72	72	1.0000000
NODE_1696_length_1755_cov_9.938406	231	311	0	36	80	0.4500000
NODE_1696_length_1755_cov_9.938406	231	311	4	20	80	0.2500000
NODE_1696_length_1755_cov_9.938406	231	311	7	4	80	0.0500000
NODE_1696_length_1755_cov_9.938406	231	311	10	20	80	0.2500000
NODE_1696_length_1755_cov_9.938406	284	364	4	3	80	0.0375000
NODE_1696_length_1755_cov_9.938406	284	364	6	13	80	0.1625000
NODE_1696_length_1755_cov_9.938406	284	364	7	4	80	0.0500000
NODE_1696_length_1755_cov_9.938406	284	364	10	60	80	0.7500000
NODE_1698_length_1755_cov_3.614130	171	222	2	6	51	0.1176471
NODE_1698_length_1755_cov_3.614130	171	222	4	1	51	0.0196078
NODE_1698_length_1755_cov_3.614130	171	222	6	29	51	0.5686275
NODE_1698_length_1755_cov_3.614130	171	222	7	3	51	0.0588235
NODE_1698_length_1755_cov_3.614130	171	222	9	12	51	0.2352941
NODE_1699_length_1754_cov_8.523263	0	77	0	77	77	1.0000000
NODE_1699_length_1754_cov_8.523263	0	77	0	77	77	1.0000000
NODE_1699_length_1754_cov_8.523263	0	77	0	77	77	1.0000000
NODE_1699_length_1754_cov_8.523263	50	99	0	49	49	1.0000000
NODE_1699_length_1754_cov_8.523263	53	99	0	46	46	1.0000000
NODE_1699_length_1754_cov_8.523263	55	99	0	44	44	1.0000000
NODE_1700_length_1753_cov_26.851874	356	436	0	55	80	0.6875000
NODE_1700_length_1753_cov_26.851874	356	436	2	25	80	0.3125000
NODE_1700_length_1753_cov_26.851874	409	489	0	80	80	1.0000000
NODE_1701_length_1753_cov_12.297461	355	435	0	80	80	1.0000000
NODE_1701_length_1753_cov_12.297461	408	488	0	80	80	1.0000000
NODE_1705_length_1750_cov_90.732283	1191	1254	398	1	63	0.0158730
NODE_1705_length_1750_cov_90.732283	1191	1254	402	1	63	0.0158730
NODE_1705_length_1750_cov_90.732283	1191	1254	405	1	63	0.0158730
NODE_1705_length_1750_cov_90.732283	1191	1254	409	4	63	0.0634921
NODE_1705_length_1750_cov_90.732283	1191	1254	411	1	63	0.0158730
NODE_1705_length_1750_cov_90.732283	1191	1254	414	2	63	0.0317460
NODE_1705_length_1750_cov_90.732283	1191	1254	415	1	63	0.0158730
NODE_1705_length_1750_cov_90.732283	1191	1254	417	1	63	0.0158730
NODE_1705_length_1750_cov_90.732283	1191	1254	426	1	63	0.0158730
NODE_1705_length_1750_cov_90.732283	1191	1254	433	1	63	0.0158730
NODE_1705_length_1750_cov_90.732283	1191	1254	440	1	63	0.0158730
NODE_1705_length_1750_cov_90.732283	1191	1254	442	1	63	0.0158730
NODE_1705_length_1750_cov_90.732283	1191	1254	449	1	63	0.0158730
NODE_1705_length_1750_cov_90.732283	1191	1254	450	1	63	0.0158730
NODE_1705_length_1750_cov_90.732283	1191	1254	452	1	63	0.0158730
NODE_1705_length_1750_cov_90.732283	1191	1254	458	1	63	0.0158730
NODE_1705_length_1750_cov_90.732283	1191	1254	466	1	63	0.0158730
NODE_1705_length_1750_cov_90.732283	1191	1254	480	1	63	0.0158730
NODE_1705_length_1750_cov_90.732283	1191	1254	486	1	63	0.0158730
NODE_1705_length_1750_cov_90.732283	1191	1254	492	1	63	0.0158730
NODE_1705_length_1750_cov_90.732283	1191	1254	493	1	63	0.0158730
NODE_1705_length_1750_cov_90.732283	1191	1254	497	1	63	0.0158730
NODE_1705_length_1750_cov_90.732283	1191	1254	499	3	63	0.0476190
NODE_1705_length_1750_cov_90.732283	1191	1254	503	1	63	0.0158730
NODE_1705_length_1750_cov_90.732283	1191	1254	515	1	63	0.0158730
NODE_1705_length_1750_cov_90.732283	1191	1254	522	1	63	0.0158730
NODE_1705_length_1750_cov_90.732283	1191	1254	527	1	63	0.0158730
NODE_1705_length_1750_cov_90.732283	1191	1254	530	1	63	0.0158730
NODE_1705_length_1750_cov_90.732283	1191	1254	531	1	63	0.0158730
NODE_1705_length_1750_cov_90.732283	1191	1254	535	1	63	0.0158730
NODE_1705_length_1750_cov_90.732283	1191	1254	541	1	63	0.0158730
NODE_1705_length_1750_cov_90.732283	1191	1254	552	1	63	0.0158730
NODE_1705_length_1750_cov_90.732283	1191	1254	558	1	63	0.0158730
NODE_1705_length_1750_cov_90.732283	1191	1254	562	1	63	0.0158730
NODE_1705_length_1750_cov_90.732283	1191	1254	564	1	63	0.0158730
NODE_1705_length_1750_cov_90.732283	1191	1254	569	1	63	0.0158730
NODE_1705_length_1750_cov_90.732283	1191	1254	588	1	63	0.0158730
NODE_1705_length_1750_cov_90.732283	1191	1254	591	1	63	0.0158730
NODE_1705_length_1750_cov_90.732283	1191	1254	592	1	63	0.0158730
NODE_1705_length_1750_cov_90.732283	1191	1254	597	1	63	0.0158730
NODE_1705_length_1750_cov_90.732283	1191	1254	605	1	63	0.0158730
NODE_1705_length_1750_cov_90.732283	1191	1254	615	1	63	0.0158730
NODE_1705_length_1750_cov_90.732283	1191	1254	619	1	63	0.0158730
NODE_1705_length_1750_cov_90.732283	1191	1254	621	1	63	0.0158730
NODE_1705_length_1750_cov_90.732283	1191	1254	623	1	63	0.0158730
NODE_1705_length_1750_cov_90.732283	1191	1254	624	2	63	0.0317460
NODE_1705_length_1750_cov_90.732283	1191	1254	634	1	63	0.0158730
NODE_1705_length_1750_cov_90.732283	1191	1254	636	1	63	0.0158730
NODE_1705_length_1750_cov_90.732283	1191	1254	641	1	63	0.0158730
NODE_1705_length_1750_cov_90.732283	1191	1254	648	1	63	0.0158730
NODE_1705_length_1750_cov_90.732283	1191	1254	650	1	63	0.0158730
NODE_1705_length_1750_cov_90.732283	1191	1254	668	1	63	0.0158730
NODE_1705_length_1750_cov_90.732283	1191	1254	676	1	63	0.0158730
NODE_1705_length_1750_cov_90.732283	1191	1254	685	2	63	0.0317460
NODE_1705_length_1750_cov_90.732283	1191	1254	699	1	63	0.0158730
NODE_1705_length_1750_cov_90.732283	1239	1310	619	1	71	0.0140845
NODE_1705_length_1750_cov_90.732283	1239	1310	621	1	71	0.0140845
NODE_1705_length_1750_cov_90.732283	1239	1310	623	1	71	0.0140845
NODE_1705_length_1750_cov_90.732283	1239	1310	624	2	71	0.0281690
NODE_1705_length_1750_cov_90.732283	1239	1310	634	1	71	0.0140845
NODE_1705_length_1750_cov_90.732283	1239	1310	636	1	71	0.0140845
NODE_1705_length_1750_cov_90.732283	1239	1310	641	1	71	0.0140845
NODE_1705_length_1750_cov_90.732283	1239	1310	648	1	71	0.0140845
NODE_1705_length_1750_cov_90.732283	1239	1310	650	1	71	0.0140845
NODE_1705_length_1750_cov_90.732283	1239	1310	668	1	71	0.0140845
NODE_1705_length_1750_cov_90.732283	1239	1310	676	1	71	0.0140845
NODE_1705_length_1750_cov_90.732283	1239	1310	685	3	71	0.0422535
NODE_1705_length_1750_cov_90.732283	1239	1310	692	1	71	0.0140845
NODE_1705_length_1750_cov_90.732283	1239	1310	698	1	71	0.0140845
NODE_1705_length_1750_cov_90.732283	1239	1310	699	1	71	0.0140845
NODE_1705_length_1750_cov_90.732283	1239	1310	705	1	71	0.0140845
NODE_1705_length_1750_cov_90.732283	1239	1310	709	2	71	0.0281690
NODE_1705_length_1750_cov_90.732283	1239	1310	715	2	71	0.0281690
NODE_1705_length_1750_cov_90.732283	1239	1310	728	1	71	0.0140845
NODE_1705_length_1750_cov_90.732283	1239	1310	730	1	71	0.0140845
NODE_1705_length_1750_cov_90.732283	1239	1310	733	1	71	0.0140845
NODE_1705_length_1750_cov_90.732283	1239	1310	735	2	71	0.0281690
NODE_1705_length_1750_cov_90.732283	1239	1310	738	2	71	0.0281690
NODE_1705_length_1750_cov_90.732283	1239	1310	740	1	71	0.0140845
NODE_1705_length_1750_cov_90.732283	1239	1310	741	2	71	0.0281690
NODE_1705_length_1750_cov_90.732283	1239	1310	743	1	71	0.0140845
NODE_1705_length_1750_cov_90.732283	1239	1310	745	1	71	0.0140845
NODE_1705_length_1750_cov_90.732283	1239	1310	746	2	71	0.0281690
NODE_1705_length_1750_cov_90.732283	1239	1310	748	2	71	0.0281690
NODE_1705_length_1750_cov_90.732283	1239	1310	749	1	71	0.0140845
NODE_1705_length_1750_cov_90.732283	1239	1310	754	2	71	0.0281690
NODE_1705_length_1750_cov_90.732283	1239	1310	755	2	71	0.0281690
NODE_1705_length_1750_cov_90.732283	1239	1310	757	1	71	0.0140845
NODE_1705_length_1750_cov_90.732283	1239	1310	766	1	71	0.0140845
NODE_1705_length_1750_cov_90.732283	1239	1310	768	1	71	0.0140845
NODE_1705_length_1750_cov_90.732283	1239	1310	769	1	71	0.0140845
NODE_1705_length_1750_cov_90.732283	1239	1310	774	2	71	0.0281690
NODE_1705_length_1750_cov_90.732283	1239	1310	775	4	71	0.0563380
NODE_1705_length_1750_cov_90.732283	1239	1310	776	1	71	0.0140845
NODE_1705_length_1750_cov_90.732283	1239	1310	778	1	71	0.0140845
NODE_1705_length_1750_cov_90.732283	1239	1310	783	1	71	0.0140845
NODE_1705_length_1750_cov_90.732283	1239	1310	784	1	71	0.0140845
NODE_1705_length_1750_cov_90.732283	1239	1310	785	2	71	0.0281690
NODE_1705_length_1750_cov_90.732283	1239	1310	786	1	71	0.0140845
NODE_1705_length_1750_cov_90.732283	1239	1310	788	1	71	0.0140845
NODE_1705_length_1750_cov_90.732283	1239	1310	798	2	71	0.0281690
NODE_1705_length_1750_cov_90.732283	1239	1310	799	1	71	0.0140845
NODE_1705_length_1750_cov_90.732283	1239	1310	805	1	71	0.0140845
NODE_1705_length_1750_cov_90.732283	1239	1310	806	1	71	0.0140845
NODE_1705_length_1750_cov_90.732283	1239	1310	809	1	71	0.0140845
NODE_1705_length_1750_cov_90.732283	1239	1310	810	1	71	0.0140845
NODE_1705_length_1750_cov_90.732283	1239	1310	811	1	71	0.0140845
NODE_1705_length_1750_cov_90.732283	1239	1310	813	1	71	0.0140845
NODE_1711_length_1746_cov_3.095932	458	524	0	66	66	1.0000000
NODE_1712_length_1745_cov_7.646416	430	510	0	80	80	1.0000000
NODE_1712_length_1745_cov_7.646416	483	563	0	80	80	1.0000000
NODE_1715_length_1744_cov_10.144681	1213	1289	2	14	76	0.1842105
NODE_1715_length_1744_cov_10.144681	1213	1289	8	30	76	0.3947369
NODE_1715_length_1744_cov_10.144681	1213	1289	12	7	76	0.0921053
NODE_1715_length_1744_cov_10.144681	1213	1289	16	9	76	0.1184211
NODE_1715_length_1744_cov_10.144681	1213	1289	18	8	76	0.1052632
NODE_1715_length_1744_cov_10.144681	1213	1289	20	1	76	0.0131579
NODE_1715_length_1744_cov_10.144681	1213	1289	22	7	76	0.0921053
NODE_1715_length_1744_cov_10.144681	1262	1342	12	2	80	0.0250000
NODE_1715_length_1744_cov_10.144681	1262	1342	16	15	80	0.1875000
NODE_1715_length_1744_cov_10.144681	1262	1342	18	8	80	0.1000000
NODE_1715_length_1744_cov_10.144681	1262	1342	20	47	80	0.5875000
NODE_1715_length_1744_cov_10.144681	1262	1342	22	8	80	0.1000000
NODE_1719_length_1742_cov_18.923311	699	776	0	77	77	1.0000000
NODE_1719_length_1742_cov_18.923311	749	829	0	80	80	1.0000000
NODE_1722_length_1741_cov_7.657734	1234	1314	0	80	80	1.0000000
NODE_1722_length_1741_cov_7.657734	1287	1367	0	57	80	0.7125000
NODE_1722_length_1741_cov_7.657734	1287	1367	4	23	80	0.2875000
NODE_1722_length_1741_cov_7.657734	1363	1443	0	5	80	0.0625000
NODE_1722_length_1741_cov_7.657734	1363	1443	4	75	80	0.9375000
NODE_1722_length_1741_cov_7.657734	1416	1496	0	25	80	0.3125000
NODE_1722_length_1741_cov_7.657734	1416	1496	2	27	80	0.3375000
NODE_1722_length_1741_cov_7.657734	1416	1496	4	28	80	0.3500000
NODE_1726_length_1740_cov_38.411335	517	597	4	80	80	1.0000000
NODE_1726_length_1740_cov_38.411335	570	650	0	52	80	0.6500000
NODE_1726_length_1740_cov_38.411335	570	650	4	28	80	0.3500000
NODE_1726_length_1740_cov_38.411335	646	726	0	80	80	1.0000000
NODE_1726_length_1740_cov_38.411335	699	779	0	61	80	0.7625000
NODE_1726_length_1740_cov_38.411335	699	779	1	19	80	0.2375000
NODE_1727_length_1740_cov_10.843388	552	632	3	20	80	0.2500000
NODE_1727_length_1740_cov_10.843388	552	632	5	26	80	0.3250000
NODE_1727_length_1740_cov_10.843388	552	632	7	34	80	0.4250000
NODE_1727_length_1740_cov_10.843388	708	788	0	80	80	1.0000000
NODE_1727_length_1740_cov_10.843388	708	788	0	80	80	1.0000000
NODE_1727_length_1740_cov_10.843388	708	788	0	80	80	1.0000000
NODE_1727_length_1740_cov_10.843388	761	841	0	80	80	1.0000000
NODE_1727_length_1740_cov_10.843388	761	808	0	47	47	1.0000000
NODE_1727_length_1740_cov_10.843388	761	808	0	47	47	1.0000000
NODE_1737_length_1736_cov_71.959682	841	901	494	2	60	0.0333333
NODE_1737_length_1736_cov_71.959682	841	901	504	1	60	0.0166667
NODE_1737_length_1736_cov_71.959682	841	901	508	1	60	0.0166667
NODE_1737_length_1736_cov_71.959682	841	901	510	1	60	0.0166667
NODE_1737_length_1736_cov_71.959682	841	901	516	1	60	0.0166667
NODE_1737_length_1736_cov_71.959682	841	901	519	1	60	0.0166667
NODE_1737_length_1736_cov_71.959682	841	901	520	1	60	0.0166667
NODE_1737_length_1736_cov_71.959682	841	901	524	1	60	0.0166667
NODE_1737_length_1736_cov_71.959682	841	901	528	2	60	0.0333333
NODE_1737_length_1736_cov_71.959682	841	901	534	1	60	0.0166667
NODE_1737_length_1736_cov_71.959682	841	901	542	1	60	0.0166667
NODE_1737_length_1736_cov_71.959682	841	901	543	1	60	0.0166667
NODE_1737_length_1736_cov_71.959682	841	901	545	2	60	0.0333333
NODE_1737_length_1736_cov_71.959682	841	901	547	1	60	0.0166667
NODE_1737_length_1736_cov_71.959682	841	901	548	1	60	0.0166667
NODE_1737_length_1736_cov_71.959682	841	901	549	1	60	0.0166667
NODE_1737_length_1736_cov_71.959682	841	901	551	4	60	0.0666667
NODE_1737_length_1736_cov_71.959682	841	901	553	2	60	0.0333333
NODE_1737_length_1736_cov_71.959682	841	901	554	2	60	0.0333333
NODE_1737_length_1736_cov_71.959682	841	901	556	4	60	0.0666667
NODE_1737_length_1736_cov_71.959682	841	901	558	2	60	0.0333333
NODE_1737_length_1736_cov_71.959682	841	901	560	2	60	0.0333333
NODE_1737_length_1736_cov_71.959682	841	901	561	1	60	0.0166667
NODE_1737_length_1736_cov_71.959682	841	901	563	1	60	0.0166667
NODE_1737_length_1736_cov_71.959682	841	901	564	1	60	0.0166667
NODE_1737_length_1736_cov_71.959682	841	901	565	1	60	0.0166667
NODE_1737_length_1736_cov_71.959682	841	901	566	1	60	0.0166667
NODE_1737_length_1736_cov_71.959682	841	901	568	1	60	0.0166667
NODE_1737_length_1736_cov_71.959682	841	901	571	2	60	0.0333333
NODE_1737_length_1736_cov_71.959682	841	901	576	3	60	0.0500000
NODE_1737_length_1736_cov_71.959682	841	901	578	3	60	0.0500000
NODE_1737_length_1736_cov_71.959682	841	901	579	7	60	0.1166667
NODE_1737_length_1736_cov_71.959682	841	901	581	1	60	0.0166667
NODE_1737_length_1736_cov_71.959682	841	901	583	1	60	0.0166667
NODE_1737_length_1736_cov_71.959682	841	901	585	1	60	0.0166667
NODE_1737_length_1736_cov_71.959682	841	901	587	1	60	0.0166667
NODE_1738_length_1736_cov_29.174710	1361	1390	162	1	29	0.0344828
NODE_1738_length_1736_cov_29.174710	1361	1390	164	1	29	0.0344828
NODE_1738_length_1736_cov_29.174710	1361	1390	165	1	29	0.0344828
NODE_1738_length_1736_cov_29.174710	1361	1390	166	1	29	0.0344828
NODE_1738_length_1736_cov_29.174710	1361	1390	167	5	29	0.1724138
NODE_1738_length_1736_cov_29.174710	1361	1390	168	2	29	0.0689655
NODE_1738_length_1736_cov_29.174710	1361	1390	169	5	29	0.1724138
NODE_1738_length_1736_cov_29.174710	1361	1390	170	2	29	0.0689655
NODE_1738_length_1736_cov_29.174710	1361	1390	171	4	29	0.1379310
NODE_1738_length_1736_cov_29.174710	1361	1390	172	1	29	0.0344828
NODE_1738_length_1736_cov_29.174710	1361	1390	173	2	29	0.0689655
NODE_1738_length_1736_cov_29.174710	1361	1390	175	2	29	0.0689655
NODE_1738_length_1736_cov_29.174710	1361	1390	179	1	29	0.0344828
NODE_1738_length_1736_cov_29.174710	1361	1390	184	1	29	0.0344828
NODE_1738_length_1736_cov_29.174710	1566	1628	226	2	62	0.0322581
NODE_1738_length_1736_cov_29.174710	1566	1628	230	2	62	0.0322581
NODE_1738_length_1736_cov_29.174710	1566	1628	232	1	62	0.0161290
NODE_1738_length_1736_cov_29.174710	1566	1628	233	4	62	0.0645161
NODE_1738_length_1736_cov_29.174710	1566	1628	235	2	62	0.0322581
NODE_1738_length_1736_cov_29.174710	1566	1628	236	2	62	0.0322581
NODE_1738_length_1736_cov_29.174710	1566	1628	246	1	62	0.0161290
NODE_1738_length_1736_cov_29.174710	1566	1628	252	1	62	0.0161290
NODE_1738_length_1736_cov_29.174710	1566	1628	254	1	62	0.0161290
NODE_1738_length_1736_cov_29.174710	1566	1628	258	2	62	0.0322581
NODE_1738_length_1736_cov_29.174710	1566	1628	259	3	62	0.0483871
NODE_1738_length_1736_cov_29.174710	1566	1628	260	2	62	0.0322581
NODE_1738_length_1736_cov_29.174710	1566	1628	261	3	62	0.0483871
NODE_1738_length_1736_cov_29.174710	1566	1628	263	1	62	0.0161290
NODE_1738_length_1736_cov_29.174710	1566	1628	265	2	62	0.0322581
NODE_1738_length_1736_cov_29.174710	1566	1628	267	5	62	0.0806452
NODE_1738_length_1736_cov_29.174710	1566	1628	268	1	62	0.0161290
NODE_1738_length_1736_cov_29.174710	1566	1628	269	1	62	0.0161290
NODE_1738_length_1736_cov_29.174710	1566	1628	270	1	62	0.0161290
NODE_1738_length_1736_cov_29.174710	1566	1628	271	5	62	0.0806452
NODE_1738_length_1736_cov_29.174710	1566	1628	272	1	62	0.0161290
NODE_1738_length_1736_cov_29.174710	1566	1628	273	4	62	0.0645161
NODE_1738_length_1736_cov_29.174710	1566	1628	275	2	62	0.0322581
NODE_1738_length_1736_cov_29.174710	1566	1628	276	2	62	0.0322581
NODE_1738_length_1736_cov_29.174710	1566	1628	277	5	62	0.0806452
NODE_1738_length_1736_cov_29.174710	1566	1628	278	1	62	0.0161290
NODE_1738_length_1736_cov_29.174710	1566	1628	279	1	62	0.0161290
NODE_1738_length_1736_cov_29.174710	1566	1628	281	3	62	0.0483871
NODE_1738_length_1736_cov_29.174710	1566	1628	285	1	62	0.0161290
NODE_1743_length_1732_cov_6.162890	807	887	0	80	80	1.0000000
NODE_1743_length_1732_cov_6.162890	860	940	0	80	80	1.0000000
NODE_1749_length_1729_cov_23.708589	364	443	0	79	79	1.0000000
NODE_1749_length_1729_cov_23.708589	416	496	0	74	80	0.9250000
NODE_1749_length_1729_cov_23.708589	416	496	6	6	80	0.0750000
NODE_1749_length_1729_cov_23.708589	492	572	6	80	80	1.0000000
NODE_1749_length_1729_cov_23.708589	545	625	0	28	80	0.3500000
NODE_1749_length_1729_cov_23.708589	545	625	6	52	80	0.6500000
NODE_1753_length_1728_cov_26.505832	259	339	13	13	80	0.1625000
NODE_1753_length_1728_cov_26.505832	259	339	14	31	80	0.3875000
NODE_1753_length_1728_cov_26.505832	259	339	15	36	80	0.4500000
NODE_1753_length_1728_cov_26.505832	312	392	0	29	80	0.3625000
NODE_1753_length_1728_cov_26.505832	312	392	7	8	80	0.1000000
NODE_1753_length_1728_cov_26.505832	312	392	13	28	80	0.3500000
NODE_1753_length_1728_cov_26.505832	312	392	15	15	80	0.1875000
NODE_1757_length_1725_cov_142.158057	767	814	432	1	47	0.0212766
NODE_1757_length_1725_cov_142.158057	767	814	433	1	47	0.0212766
NODE_1757_length_1725_cov_142.158057	767	814	434	1	47	0.0212766
NODE_1757_length_1725_cov_142.158057	767	814	435	1	47	0.0212766
NODE_1757_length_1725_cov_142.158057	767	814	443	1	47	0.0212766
NODE_1757_length_1725_cov_142.158057	767	814	453	1	47	0.0212766
NODE_1757_length_1725_cov_142.158057	767	814	455	1	47	0.0212766
NODE_1757_length_1725_cov_142.158057	767	814	457	2	47	0.0425532
NODE_1757_length_1725_cov_142.158057	767	814	459	1	47	0.0212766
NODE_1757_length_1725_cov_142.158057	767	814	476	1	47	0.0212766
NODE_1757_length_1725_cov_142.158057	767	814	477	1	47	0.0212766
NODE_1757_length_1725_cov_142.158057	767	814	483	1	47	0.0212766
NODE_1757_length_1725_cov_142.158057	767	814	487	1	47	0.0212766
NODE_1757_length_1725_cov_142.158057	767	814	489	1	47	0.0212766
NODE_1757_length_1725_cov_142.158057	767	814	506	1	47	0.0212766
NODE_1757_length_1725_cov_142.158057	767	814	512	1	47	0.0212766
NODE_1757_length_1725_cov_142.158057	767	814	514	2	47	0.0425532
NODE_1757_length_1725_cov_142.158057	767	814	532	1	47	0.0212766
NODE_1757_length_1725_cov_142.158057	767	814	535	1	47	0.0212766
NODE_1757_length_1725_cov_142.158057	767	814	537	1	47	0.0212766
NODE_1757_length_1725_cov_142.158057	767	814	549	1	47	0.0212766
NODE_1757_length_1725_cov_142.158057	767	814	551	1	47	0.0212766
NODE_1757_length_1725_cov_142.158057	767	814	556	2	47	0.0425532
NODE_1757_length_1725_cov_142.158057	767	814	557	1	47	0.0212766
NODE_1757_length_1725_cov_142.158057	767	814	558	1	47	0.0212766
NODE_1757_length_1725_cov_142.158057	767	814	560	2	47	0.0425532
NODE_1757_length_1725_cov_142.158057	767	814	568	1	47	0.0212766
NODE_1757_length_1725_cov_142.158057	767	814	570	1	47	0.0212766
NODE_1757_length_1725_cov_142.158057	767	814	572	3	47	0.0638298
NODE_1757_length_1725_cov_142.158057	767	814	574	1	47	0.0212766
NODE_1757_length_1725_cov_142.158057	767	814	576	3	47	0.0638298
NODE_1757_length_1725_cov_142.158057	767	814	578	2	47	0.0425532
NODE_1757_length_1725_cov_142.158057	767	814	579	4	47	0.0851064
NODE_1757_length_1725_cov_142.158057	767	814	581	2	47	0.0425532
NODE_1757_length_1725_cov_142.158057	803	867	458	2	64	0.0312500
NODE_1757_length_1725_cov_142.158057	803	867	464	1	64	0.0156250
NODE_1757_length_1725_cov_142.158057	803	867	473	1	64	0.0156250
NODE_1757_length_1725_cov_142.158057	803	867	477	1	64	0.0156250
NODE_1757_length_1725_cov_142.158057	803	867	480	1	64	0.0156250
NODE_1757_length_1725_cov_142.158057	803	867	481	2	64	0.0312500
NODE_1757_length_1725_cov_142.158057	803	867	489	2	64	0.0312500
NODE_1757_length_1725_cov_142.158057	803	867	492	2	64	0.0312500
NODE_1757_length_1725_cov_142.158057	803	867	494	2	64	0.0312500
NODE_1757_length_1725_cov_142.158057	803	867	500	1	64	0.0156250
NODE_1757_length_1725_cov_142.158057	803	867	502	1	64	0.0156250
NODE_1757_length_1725_cov_142.158057	803	867	512	1	64	0.0156250
NODE_1757_length_1725_cov_142.158057	803	867	515	1	64	0.0156250
NODE_1757_length_1725_cov_142.158057	803	867	519	1	64	0.0156250
NODE_1757_length_1725_cov_142.158057	803	867	523	1	64	0.0156250
NODE_1757_length_1725_cov_142.158057	803	867	530	1	64	0.0156250
NODE_1757_length_1725_cov_142.158057	803	867	543	1	64	0.0156250
NODE_1757_length_1725_cov_142.158057	803	867	553	1	64	0.0156250
NODE_1757_length_1725_cov_142.158057	803	867	555	1	64	0.0156250
NODE_1757_length_1725_cov_142.158057	803	867	557	1	64	0.0156250
NODE_1757_length_1725_cov_142.158057	803	867	563	1	64	0.0156250
NODE_1757_length_1725_cov_142.158057	803	867	572	3	64	0.0468750
NODE_1757_length_1725_cov_142.158057	803	867	573	2	64	0.0312500
NODE_1757_length_1725_cov_142.158057	803	867	574	2	64	0.0312500
NODE_1757_length_1725_cov_142.158057	803	867	576	1	64	0.0156250
NODE_1757_length_1725_cov_142.158057	803	867	579	4	64	0.0625000
NODE_1757_length_1725_cov_142.158057	803	867	580	1	64	0.0156250
NODE_1757_length_1725_cov_142.158057	803	867	581	3	64	0.0468750
NODE_1757_length_1725_cov_142.158057	803	867	582	5	64	0.0781250
NODE_1757_length_1725_cov_142.158057	803	867	584	3	64	0.0468750
NODE_1757_length_1725_cov_142.158057	803	867	585	1	64	0.0156250
NODE_1757_length_1725_cov_142.158057	803	867	586	1	64	0.0156250
NODE_1757_length_1725_cov_142.158057	803	867	588	4	64	0.0625000
NODE_1757_length_1725_cov_142.158057	803	867	590	1	64	0.0156250
NODE_1757_length_1725_cov_142.158057	803	867	592	2	64	0.0312500
NODE_1757_length_1725_cov_142.158057	803	867	594	2	64	0.0312500
NODE_1757_length_1725_cov_142.158057	803	867	596	2	64	0.0312500
NODE_1757_length_1725_cov_142.158057	803	867	598	1	64	0.0156250
NODE_1759_length_1724_cov_17.931077	677	746	0	69	69	1.0000000
NODE_1759_length_1724_cov_17.931077	788	850	0	4	62	0.0645161
NODE_1759_length_1724_cov_17.931077	788	850	2	58	62	0.9354839
NODE_1761_length_1723_cov_35.355296	1174	1254	2	41	80	0.5125000
NODE_1761_length_1723_cov_35.355296	1174	1254	4	39	80	0.4875000
NODE_1761_length_1723_cov_35.355296	1227	1307	0	22	80	0.2750000
NODE_1761_length_1723_cov_35.355296	1227	1307	2	58	80	0.7250000
NODE_1763_length_1722_cov_13.235367	708	788	0	40	80	0.5000000
NODE_1763_length_1722_cov_13.235367	708	788	2	40	80	0.5000000
NODE_1763_length_1722_cov_13.235367	761	841	0	20	80	0.2500000
NODE_1763_length_1722_cov_13.235367	761	841	2	60	80	0.7500000
NODE_1763_length_1722_cov_13.235367	1319	1399	0	80	80	1.0000000
NODE_1763_length_1722_cov_13.235367	1372	1452	0	80	80	1.0000000
NODE_1765_length_1720_cov_27.328192	1248	1307	82	3	59	0.0508475
NODE_1765_length_1720_cov_27.328192	1248	1307	90	6	59	0.1016949
NODE_1765_length_1720_cov_27.328192	1248	1307	92	1	59	0.0169492
NODE_1765_length_1720_cov_27.328192	1248	1307	106	1	59	0.0169492
NODE_1765_length_1720_cov_27.328192	1248	1307	108	1	59	0.0169492
NODE_1765_length_1720_cov_27.328192	1248	1307	109	3	59	0.0508475
NODE_1765_length_1720_cov_27.328192	1248	1307	122	2	59	0.0338983
NODE_1765_length_1720_cov_27.328192	1248	1307	125	1	59	0.0169492
NODE_1765_length_1720_cov_27.328192	1248	1307	126	11	59	0.1864407
NODE_1765_length_1720_cov_27.328192	1248	1307	127	9	59	0.1525424
NODE_1765_length_1720_cov_27.328192	1248	1307	129	3	59	0.0508475
NODE_1765_length_1720_cov_27.328192	1248	1307	131	5	59	0.0847458
NODE_1765_length_1720_cov_27.328192	1248	1307	135	3	59	0.0508475
NODE_1765_length_1720_cov_27.328192	1248	1307	136	10	59	0.1694915
NODE_1765_length_1720_cov_27.328192	1280	1360	86	1	80	0.0125000
NODE_1765_length_1720_cov_27.328192	1280	1360	93	7	80	0.0875000
NODE_1765_length_1720_cov_27.328192	1280	1360	94	5	80	0.0625000
NODE_1765_length_1720_cov_27.328192	1280	1360	109	16	80	0.2000000
NODE_1765_length_1720_cov_27.328192	1280	1360	111	4	80	0.0500000
NODE_1765_length_1720_cov_27.328192	1280	1360	115	2	80	0.0250000
NODE_1765_length_1720_cov_27.328192	1280	1360	117	3	80	0.0375000
NODE_1765_length_1720_cov_27.328192	1280	1360	119	1	80	0.0125000
NODE_1765_length_1720_cov_27.328192	1280	1360	121	9	80	0.1125000
NODE_1765_length_1720_cov_27.328192	1280	1360	125	5	80	0.0625000
NODE_1765_length_1720_cov_27.328192	1280	1360	127	9	80	0.1125000
NODE_1765_length_1720_cov_27.328192	1280	1360	129	3	80	0.0375000
NODE_1765_length_1720_cov_27.328192	1280	1360	131	5	80	0.0625000
NODE_1765_length_1720_cov_27.328192	1280	1360	135	2	80	0.0250000
NODE_1765_length_1720_cov_27.328192	1280	1360	136	8	80	0.1000000
NODE_1766_length_1720_cov_4.129550	241	321	0	80	80	1.0000000
NODE_1766_length_1720_cov_4.129550	294	374	0	80	80	1.0000000
NODE_1768_length_1719_cov_9.878395	410	490	0	10	80	0.1250000
NODE_1768_length_1719_cov_9.878395	410	490	4	70	80	0.8750000
NODE_1768_length_1719_cov_9.878395	463	543	0	4	80	0.0500000
NODE_1768_length_1719_cov_9.878395	463	543	4	76	80	0.9500000
NODE_1768_length_1719_cov_9.878395	539	619	0	14	80	0.1750000
NODE_1768_length_1719_cov_9.878395	539	619	2	66	80	0.8250000
NODE_1768_length_1719_cov_9.878395	592	672	0	35	80	0.4375000
NODE_1768_length_1719_cov_9.878395	592	672	2	45	80	0.5625000
NODE_1772_length_1717_cov_5.159456	145	219	1	3	74	0.0405405
NODE_1772_length_1717_cov_5.159456	145	219	3	2	74	0.0270270
NODE_1772_length_1717_cov_5.159456	145	219	5	1	74	0.0135135
NODE_1772_length_1717_cov_5.159456	145	219	7	1	74	0.0135135
NODE_1772_length_1717_cov_5.159456	145	219	9	4	74	0.0540541
NODE_1772_length_1717_cov_5.159456	145	219	10	1	74	0.0135135
NODE_1772_length_1717_cov_5.159456	145	219	13	2	74	0.0270270
NODE_1772_length_1717_cov_5.159456	145	219	15	2	74	0.0270270
NODE_1772_length_1717_cov_5.159456	145	219	17	3	74	0.0405405
NODE_1772_length_1717_cov_5.159456	145	219	26	2	74	0.0270270
NODE_1772_length_1717_cov_5.159456	145	219	28	3	74	0.0405405
NODE_1772_length_1717_cov_5.159456	145	219	30	1	74	0.0135135
NODE_1772_length_1717_cov_5.159456	145	219	34	1	74	0.0135135
NODE_1772_length_1717_cov_5.159456	145	219	36	2	74	0.0270270
NODE_1772_length_1717_cov_5.159456	145	219	39	10	74	0.1351351
NODE_1772_length_1717_cov_5.159456	145	219	41	9	74	0.1216216
NODE_1772_length_1717_cov_5.159456	145	219	46	1	74	0.0135135
NODE_1772_length_1717_cov_5.159456	145	219	47	5	74	0.0675676
NODE_1772_length_1717_cov_5.159456	145	219	51	2	74	0.0270270
NODE_1772_length_1717_cov_5.159456	145	219	53	7	74	0.0945946
NODE_1772_length_1717_cov_5.159456	145	219	63	3	74	0.0405405
NODE_1772_length_1717_cov_5.159456	145	219	65	9	74	0.1216216
NODE_1772_length_1717_cov_5.159456	1450	1508	6	9	58	0.1551724
NODE_1772_length_1717_cov_5.159456	1450	1508	8	27	58	0.4655173
NODE_1772_length_1717_cov_5.159456	1450	1508	10	14	58	0.2413793
NODE_1772_length_1717_cov_5.159456	1450	1508	12	8	58	0.1379310
NODE_1772_length_1717_cov_5.159456	1503	1561	4	12	58	0.2068966
NODE_1772_length_1717_cov_5.159456	1503	1561	6	3	58	0.0517241
NODE_1772_length_1717_cov_5.159456	1503	1561	8	7	58	0.1206897
NODE_1772_length_1717_cov_5.159456	1503	1561	10	2	58	0.0344828
NODE_1772_length_1717_cov_5.159456	1503	1561	12	34	58	0.5862069
NODE_1778_length_1715_cov_12.607054	555	635	0	80	80	1.0000000
NODE_1778_length_1715_cov_12.607054	608	688	0	80	80	1.0000000
NODE_1778_length_1715_cov_12.607054	684	764	0	80	80	1.0000000
NODE_1778_length_1715_cov_12.607054	737	817	0	80	80	1.0000000
NODE_1788_length_1707_cov_16.909204	397	477	0	80	80	1.0000000
NODE_1788_length_1707_cov_16.909204	450	530	0	80	80	1.0000000
NODE_1788_length_1707_cov_16.909204	1151	1231	0	80	80	1.0000000
NODE_1788_length_1707_cov_16.909204	1204	1284	0	80	80	1.0000000
NODE_1792_length_1705_cov_19.645081	451	531	0	80	80	1.0000000
NODE_1792_length_1705_cov_19.645081	504	584	0	80	80	1.0000000
NODE_1792_length_1705_cov_19.645081	580	660	0	80	80	1.0000000
NODE_1792_length_1705_cov_19.645081	633	714	0	81	81	1.0000000
NODE_1792_length_1705_cov_19.645081	1315	1395	0	59	80	0.7375000
NODE_1792_length_1705_cov_19.645081	1315	1395	2	21	80	0.2625000
NODE_1792_length_1705_cov_19.645081	1368	1448	0	6	80	0.0750000
NODE_1792_length_1705_cov_19.645081	1368	1448	2	74	80	0.9250000
NODE_1796_length_1703_cov_26.016833	1201	1264	0	7	63	0.1111111
NODE_1796_length_1703_cov_26.016833	1201	1264	3	1	63	0.0158730
NODE_1796_length_1703_cov_26.016833	1201	1264	4	13	63	0.2063492
NODE_1796_length_1703_cov_26.016833	1201	1264	7	1	63	0.0158730
NODE_1796_length_1703_cov_26.016833	1201	1264	10	31	63	0.4920635
NODE_1796_length_1703_cov_26.016833	1201	1264	18	2	63	0.0317460
NODE_1796_length_1703_cov_26.016833	1201	1264	26	1	63	0.0158730
NODE_1796_length_1703_cov_26.016833	1201	1264	34	2	63	0.0317460
NODE_1796_length_1703_cov_26.016833	1201	1264	38	1	63	0.0158730
NODE_1796_length_1703_cov_26.016833	1201	1264	44	1	63	0.0158730
NODE_1796_length_1703_cov_26.016833	1201	1264	48	3	63	0.0476190
NODE_1796_length_1703_cov_26.016833	1207	1264	0	7	57	0.1228070
NODE_1796_length_1703_cov_26.016833	1207	1264	3	1	57	0.0175439
NODE_1796_length_1703_cov_26.016833	1207	1264	4	13	57	0.2280702
NODE_1796_length_1703_cov_26.016833	1207	1264	7	1	57	0.0175439
NODE_1796_length_1703_cov_26.016833	1207	1264	10	31	57	0.5438597
NODE_1796_length_1703_cov_26.016833	1207	1264	18	2	57	0.0350877
NODE_1796_length_1703_cov_26.016833	1207	1264	26	1	57	0.0175439
NODE_1796_length_1703_cov_26.016833	1207	1264	34	1	57	0.0175439
NODE_1796_length_1703_cov_26.016833	1207	1264	0	7	57	0.1228070
NODE_1796_length_1703_cov_26.016833	1207	1264	3	1	57	0.0175439
NODE_1796_length_1703_cov_26.016833	1207	1264	4	13	57	0.2280702
NODE_1796_length_1703_cov_26.016833	1207	1264	7	1	57	0.0175439
NODE_1796_length_1703_cov_26.016833	1207	1264	10	31	57	0.5438597
NODE_1796_length_1703_cov_26.016833	1207	1264	18	2	57	0.0350877
NODE_1796_length_1703_cov_26.016833	1207	1264	26	1	57	0.0175439
NODE_1796_length_1703_cov_26.016833	1207	1264	34	1	57	0.0175439
NODE_1799_length_1701_cov_15.969413	1490	1565	2	1	75	0.0133333
NODE_1799_length_1701_cov_15.969413	1490	1565	4	2	75	0.0266667
NODE_1799_length_1701_cov_15.969413	1490	1565	6	1	75	0.0133333
NODE_1799_length_1701_cov_15.969413	1490	1565	12	1	75	0.0133333
NODE_1799_length_1701_cov_15.969413	1490	1565	21	1	75	0.0133333
NODE_1799_length_1701_cov_15.969413	1490	1565	22	2	75	0.0266667
NODE_1799_length_1701_cov_15.969413	1490	1565	24	13	75	0.1733333
NODE_1799_length_1701_cov_15.969413	1490	1565	26	3	75	0.0400000
NODE_1799_length_1701_cov_15.969413	1490	1565	28	1	75	0.0133333
NODE_1799_length_1701_cov_15.969413	1490	1565	30	2	75	0.0266667
NODE_1799_length_1701_cov_15.969413	1490	1565	32	2	75	0.0266667
NODE_1799_length_1701_cov_15.969413	1490	1565	33	2	75	0.0266667
NODE_1799_length_1701_cov_15.969413	1490	1565	34	4	75	0.0533333
NODE_1799_length_1701_cov_15.969413	1490	1565	36	17	75	0.2266667
NODE_1799_length_1701_cov_15.969413	1490	1565	38	19	75	0.2533333
NODE_1799_length_1701_cov_15.969413	1490	1565	44	4	75	0.0533333
NODE_1799_length_1701_cov_15.969413	1538	1603	36	4	65	0.0615385
NODE_1799_length_1701_cov_15.969413	1538	1603	38	19	65	0.2923077
NODE_1799_length_1701_cov_15.969413	1538	1603	44	4	65	0.0615385
NODE_1799_length_1701_cov_15.969413	1538	1603	46	3	65	0.0461538
NODE_1799_length_1701_cov_15.969413	1538	1603	48	8	65	0.1230769
NODE_1799_length_1701_cov_15.969413	1538	1603	52	2	65	0.0307692
NODE_1799_length_1701_cov_15.969413	1538	1603	56	1	65	0.0153846
NODE_1799_length_1701_cov_15.969413	1538	1603	58	2	65	0.0307692
NODE_1799_length_1701_cov_15.969413	1538	1603	60	3	65	0.0461538
NODE_1799_length_1701_cov_15.969413	1538	1603	64	6	65	0.0923077
NODE_1799_length_1701_cov_15.969413	1538	1603	66	13	65	0.2000000
NODE_1800_length_1701_cov_13.549313	607	687	0	80	80	1.0000000
NODE_1800_length_1701_cov_13.549313	660	740	0	80	80	1.0000000
NODE_1805_length_1700_cov_20.003123	1168	1197	253	1	29	0.0344828
NODE_1805_length_1700_cov_20.003123	1168	1197	257	2	29	0.0689655
NODE_1805_length_1700_cov_20.003123	1168	1197	259	1	29	0.0344828
NODE_1805_length_1700_cov_20.003123	1168	1197	261	2	29	0.0689655
NODE_1805_length_1700_cov_20.003123	1168	1197	262	1	29	0.0344828
NODE_1805_length_1700_cov_20.003123	1168	1197	267	1	29	0.0344828
NODE_1805_length_1700_cov_20.003123	1168	1197	273	1	29	0.0344828
NODE_1805_length_1700_cov_20.003123	1168	1197	275	2	29	0.0689655
NODE_1805_length_1700_cov_20.003123	1168	1197	277	1	29	0.0344828
NODE_1805_length_1700_cov_20.003123	1168	1197	278	1	29	0.0344828
NODE_1805_length_1700_cov_20.003123	1168	1197	283	1	29	0.0344828
NODE_1805_length_1700_cov_20.003123	1168	1197	284	2	29	0.0689655
NODE_1805_length_1700_cov_20.003123	1168	1197	288	3	29	0.1034483
NODE_1805_length_1700_cov_20.003123	1168	1197	290	3	29	0.1034483
NODE_1805_length_1700_cov_20.003123	1168	1197	291	4	29	0.1379310
NODE_1805_length_1700_cov_20.003123	1168	1197	294	2	29	0.0689655
NODE_1805_length_1700_cov_20.003123	1168	1197	298	1	29	0.0344828
NODE_1805_length_1700_cov_20.003123	1184	1263	261	2	79	0.0253165
NODE_1805_length_1700_cov_20.003123	1184	1263	267	1	79	0.0126582
NODE_1805_length_1700_cov_20.003123	1184	1263	275	1	79	0.0126582
NODE_1805_length_1700_cov_20.003123	1184	1263	277	1	79	0.0126582
NODE_1805_length_1700_cov_20.003123	1184	1263	278	1	79	0.0126582
NODE_1805_length_1700_cov_20.003123	1184	1263	280	1	79	0.0126582
NODE_1805_length_1700_cov_20.003123	1184	1263	282	1	79	0.0126582
NODE_1805_length_1700_cov_20.003123	1184	1263	283	2	79	0.0253165
NODE_1805_length_1700_cov_20.003123	1184	1263	284	3	79	0.0379747
NODE_1805_length_1700_cov_20.003123	1184	1263	285	1	79	0.0126582
NODE_1805_length_1700_cov_20.003123	1184	1263	286	2	79	0.0253165
NODE_1805_length_1700_cov_20.003123	1184	1263	287	4	79	0.0506329
NODE_1805_length_1700_cov_20.003123	1184	1263	288	1	79	0.0126582
NODE_1805_length_1700_cov_20.003123	1184	1263	289	1	79	0.0126582
NODE_1805_length_1700_cov_20.003123	1184	1263	290	1	79	0.0126582
NODE_1805_length_1700_cov_20.003123	1184	1263	291	5	79	0.0632911
NODE_1805_length_1700_cov_20.003123	1184	1263	293	1	79	0.0126582
NODE_1805_length_1700_cov_20.003123	1184	1263	294	2	79	0.0253165
NODE_1805_length_1700_cov_20.003123	1184	1263	298	1	79	0.0126582
NODE_1805_length_1700_cov_20.003123	1184	1263	299	1	79	0.0126582
NODE_1805_length_1700_cov_20.003123	1184	1263	300	2	79	0.0253165
NODE_1805_length_1700_cov_20.003123	1184	1263	301	1	79	0.0126582
NODE_1805_length_1700_cov_20.003123	1184	1263	303	1	79	0.0126582
NODE_1805_length_1700_cov_20.003123	1184	1263	307	1	79	0.0126582
NODE_1805_length_1700_cov_20.003123	1184	1263	311	1	79	0.0126582
NODE_1805_length_1700_cov_20.003123	1184	1263	313	1	79	0.0126582
NODE_1805_length_1700_cov_20.003123	1184	1263	314	1	79	0.0126582
NODE_1805_length_1700_cov_20.003123	1184	1263	316	2	79	0.0253165
NODE_1805_length_1700_cov_20.003123	1184	1263	318	4	79	0.0506329
NODE_1805_length_1700_cov_20.003123	1184	1263	319	1	79	0.0126582
NODE_1805_length_1700_cov_20.003123	1184	1263	320	1	79	0.0126582
NODE_1805_length_1700_cov_20.003123	1184	1263	321	1	79	0.0126582
NODE_1805_length_1700_cov_20.003123	1184	1263	323	1	79	0.0126582
NODE_1805_length_1700_cov_20.003123	1184	1263	324	3	79	0.0379747
NODE_1805_length_1700_cov_20.003123	1184	1263	326	3	79	0.0379747
NODE_1805_length_1700_cov_20.003123	1184	1263	327	1	79	0.0126582
NODE_1805_length_1700_cov_20.003123	1184	1263	328	1	79	0.0126582
NODE_1805_length_1700_cov_20.003123	1184	1263	330	1	79	0.0126582
NODE_1805_length_1700_cov_20.003123	1184	1263	342	1	79	0.0126582
NODE_1805_length_1700_cov_20.003123	1184	1263	348	1	79	0.0126582
NODE_1805_length_1700_cov_20.003123	1184	1263	349	2	79	0.0253165
NODE_1805_length_1700_cov_20.003123	1184	1263	351	1	79	0.0126582
NODE_1805_length_1700_cov_20.003123	1184	1263	352	1	79	0.0126582
NODE_1805_length_1700_cov_20.003123	1184	1263	356	2	79	0.0253165
NODE_1805_length_1700_cov_20.003123	1184	1263	358	2	79	0.0253165
NODE_1805_length_1700_cov_20.003123	1184	1263	360	2	79	0.0253165
NODE_1805_length_1700_cov_20.003123	1184	1263	362	1	79	0.0126582
NODE_1805_length_1700_cov_20.003123	1184	1263	364	2	79	0.0253165
NODE_1805_length_1700_cov_20.003123	1184	1263	365	4	79	0.0506329
NODE_1810_length_1698_cov_19.175735	1001	1081	0	80	80	1.0000000
NODE_1810_length_1698_cov_19.175735	1054	1134	0	80	80	1.0000000
NODE_1814_length_1696_cov_11.494678	590	670	1	29	80	0.3625000
NODE_1814_length_1696_cov_11.494678	590	670	2	51	80	0.6375000
NODE_1814_length_1696_cov_11.494678	643	723	1	54	80	0.6750000
NODE_1814_length_1696_cov_11.494678	643	723	2	26	80	0.3250000
NODE_1815_length_1696_cov_6.620539	369	449	0	30	80	0.3750000
NODE_1815_length_1696_cov_6.620539	369	449	2	50	80	0.6250000
NODE_1815_length_1696_cov_6.620539	422	502	0	18	80	0.2250000
NODE_1815_length_1696_cov_6.620539	422	502	2	62	80	0.7750000
NODE_1816_length_1695_cov_27.783208	399	479	0	36	80	0.4500000
NODE_1816_length_1695_cov_27.783208	399	479	2	4	80	0.0500000
NODE_1816_length_1695_cov_27.783208	399	479	8	40	80	0.5000000
NODE_1816_length_1695_cov_27.783208	452	532	0	9	80	0.1125000
NODE_1816_length_1695_cov_27.783208	452	532	5	1	80	0.0125000
NODE_1816_length_1695_cov_27.783208	452	532	6	7	80	0.0875000
NODE_1816_length_1695_cov_27.783208	452	532	8	63	80	0.7875000
NODE_1817_length_1695_cov_12.084586	1047	1127	0	33	80	0.4125000
NODE_1817_length_1695_cov_12.084586	1047	1127	2	16	80	0.2000000
NODE_1817_length_1695_cov_12.084586	1047	1127	4	31	80	0.3875000
NODE_1817_length_1695_cov_12.084586	1100	1180	0	80	80	1.0000000
NODE_1825_length_1692_cov_4.557439	727	807	0	42	80	0.5250000
NODE_1825_length_1692_cov_4.557439	727	807	1	3	80	0.0375000
NODE_1825_length_1692_cov_4.557439	727	807	2	21	80	0.2625000
NODE_1825_length_1692_cov_4.557439	727	807	3	14	80	0.1750000
NODE_1825_length_1692_cov_4.557439	780	860	0	24	80	0.3000000
NODE_1825_length_1692_cov_4.557439	780	860	1	29	80	0.3625000
NODE_1825_length_1692_cov_4.557439	780	860	2	27	80	0.3375000
NODE_1830_length_1689_cov_5.844025	1210	1285	0	58	75	0.7733333
NODE_1830_length_1689_cov_5.844025	1210	1285	4	17	75	0.2266667
NODE_1830_length_1689_cov_5.844025	1260	1338	0	29	78	0.3717949
NODE_1830_length_1689_cov_5.844025	1260	1338	2	49	78	0.6282051
NODE_1837_length_1682_cov_14.416930	1183	1263	0	80	80	1.0000000
NODE_1837_length_1682_cov_14.416930	1236	1315	0	79	79	1.0000000
NODE_1843_length_1678_cov_23.965168	636	716	0	80	80	1.0000000
NODE_1843_length_1678_cov_23.965168	689	769	0	75	80	0.9375000
NODE_1843_length_1678_cov_23.965168	689	769	2	5	80	0.0625000
NODE_1843_length_1678_cov_23.965168	1145	1225	0	80	80	1.0000000
NODE_1843_length_1678_cov_23.965168	1198	1278	0	80	80	1.0000000
NODE_1846_length_1677_cov_3.578580	407	487	0	80	80	1.0000000
NODE_1846_length_1677_cov_3.578580	460	530	0	70	70	1.0000000
NODE_1846_length_1677_cov_3.578580	666	724	0	58	58	1.0000000
NODE_1856_length_1670_cov_29.264163	741	821	0	80	80	1.0000000
NODE_1856_length_1670_cov_29.264163	794	874	0	80	80	1.0000000
NODE_1857_length_1669_cov_5.913376	246	326	3	4	80	0.0500000
NODE_1857_length_1669_cov_5.913376	246	326	4	32	80	0.4000000
NODE_1857_length_1669_cov_5.913376	246	326	5	27	80	0.3375000
NODE_1857_length_1669_cov_5.913376	246	326	7	17	80	0.2125000
NODE_1857_length_1669_cov_5.913376	299	379	2	26	80	0.3250000
NODE_1857_length_1669_cov_5.913376	299	379	4	51	80	0.6375000
NODE_1857_length_1669_cov_5.913376	299	379	6	3	80	0.0375000
NODE_1860_length_1668_cov_18.372212	1100	1180	0	8	80	0.1000000
NODE_1860_length_1668_cov_18.372212	1100	1180	2	16	80	0.2000000
NODE_1860_length_1668_cov_18.372212	1100	1180	4	56	80	0.7000000
NODE_1860_length_1668_cov_18.372212	1153	1233	0	8	80	0.1000000
NODE_1860_length_1668_cov_18.372212	1153	1233	2	69	80	0.8625000
NODE_1860_length_1668_cov_18.372212	1153	1233	4	3	80	0.0375000
NODE_1861_length_1667_cov_15.651786	902	982	6	80	80	1.0000000
NODE_1861_length_1667_cov_15.651786	955	1035	0	13	80	0.1625000
NODE_1861_length_1667_cov_15.651786	955	1035	6	67	80	0.8375000
NODE_1862_length_1667_cov_3.661352	649	679	0	30	30	1.0000000
NODE_1865_length_1666_cov_4.601149	1541	1623	28	14	82	0.1707317
NODE_1865_length_1666_cov_4.601149	1541	1623	30	4	82	0.0487805
NODE_1865_length_1666_cov_4.601149	1541	1623	34	32	82	0.3902439
NODE_1865_length_1666_cov_4.601149	1541	1623	36	8	82	0.0975610
NODE_1865_length_1666_cov_4.601149	1541	1623	38	24	82	0.2926829
NODE_1865_length_1666_cov_4.601149	1553	1613	28	2	60	0.0333333
NODE_1865_length_1666_cov_4.601149	1553	1613	30	4	60	0.0666667
NODE_1865_length_1666_cov_4.601149	1553	1613	34	22	60	0.3666667
NODE_1865_length_1666_cov_4.601149	1553	1613	36	8	60	0.1333333
NODE_1865_length_1666_cov_4.601149	1553	1613	38	24	60	0.4000000
NODE_1865_length_1666_cov_4.601149	1553	1613	28	2	60	0.0333333
NODE_1865_length_1666_cov_4.601149	1553	1613	30	4	60	0.0666667
NODE_1865_length_1666_cov_4.601149	1553	1613	34	22	60	0.3666667
NODE_1865_length_1666_cov_4.601149	1553	1613	36	8	60	0.1333333
NODE_1865_length_1666_cov_4.601149	1553	1613	38	24	60	0.4000000
NODE_1865_length_1666_cov_4.601149	1557	1623	30	2	66	0.0303030
NODE_1865_length_1666_cov_4.601149	1557	1623	34	32	66	0.4848485
NODE_1865_length_1666_cov_4.601149	1557	1623	36	8	66	0.1212121
NODE_1865_length_1666_cov_4.601149	1557	1623	38	24	66	0.3636364
NODE_1865_length_1666_cov_4.601149	1596	1666	24	4	70	0.0571429
NODE_1865_length_1666_cov_4.601149	1596	1666	26	1	70	0.0142857
NODE_1865_length_1666_cov_4.601149	1596	1666	34	65	70	0.9285714
NODE_1865_length_1666_cov_4.601149	1596	1666	24	4	70	0.0571429
NODE_1865_length_1666_cov_4.601149	1596	1666	26	1	70	0.0142857
NODE_1865_length_1666_cov_4.601149	1596	1666	34	65	70	0.9285714
NODE_1865_length_1666_cov_4.601149	1596	1666	24	4	70	0.0571429
NODE_1865_length_1666_cov_4.601149	1596	1666	26	1	70	0.0142857
NODE_1865_length_1666_cov_4.601149	1596	1666	34	65	70	0.9285714
NODE_1872_length_1662_cov_16.638516	538	618	0	80	80	1.0000000
NODE_1872_length_1662_cov_16.638516	591	671	0	59	80	0.7375000
NODE_1872_length_1662_cov_16.638516	591	671	2	21	80	0.2625000
NODE_1872_length_1662_cov_16.638516	667	747	2	6	80	0.0750000
NODE_1872_length_1662_cov_16.638516	667	747	4	25	80	0.3125000
NODE_1872_length_1662_cov_16.638516	667	747	10	28	80	0.3500000
NODE_1872_length_1662_cov_16.638516	667	747	11	10	80	0.1250000
NODE_1872_length_1662_cov_16.638516	667	747	12	11	80	0.1375000
NODE_1872_length_1662_cov_16.638516	720	800	8	19	80	0.2375000
NODE_1872_length_1662_cov_16.638516	720	800	10	19	80	0.2375000
NODE_1872_length_1662_cov_16.638516	720	800	11	10	80	0.1250000
NODE_1872_length_1662_cov_16.638516	720	800	12	32	80	0.4000000
NODE_1876_length_1660_cov_28.297886	415	495	0	80	80	1.0000000
NODE_1876_length_1660_cov_28.297886	468	548	0	80	80	1.0000000
NODE_1886_length_1654_cov_17.245016	631	711	2	47	80	0.5875000
NODE_1886_length_1654_cov_17.245016	631	711	3	6	80	0.0750000
NODE_1886_length_1654_cov_17.245016	631	711	4	27	80	0.3375000
NODE_1886_length_1654_cov_17.245016	684	764	1	10	80	0.1250000
NODE_1886_length_1654_cov_17.245016	684	764	2	70	80	0.8750000
NODE_1888_length_1653_cov_34.827542	0	41	0	41	41	1.0000000
NODE_1888_length_1653_cov_34.827542	14	44	0	30	30	1.0000000
NODE_1888_length_1653_cov_34.827542	1081	1161	0	63	80	0.7875000
NODE_1888_length_1653_cov_34.827542	1081	1161	2	17	80	0.2125000
NODE_1888_length_1653_cov_34.827542	1134	1214	0	10	80	0.1250000
NODE_1888_length_1653_cov_34.827542	1134	1214	2	36	80	0.4500000
NODE_1888_length_1653_cov_34.827542	1134	1214	4	10	80	0.1250000
NODE_1888_length_1653_cov_34.827542	1134	1214	6	13	80	0.1625000
NODE_1888_length_1653_cov_34.827542	1134	1214	10	11	80	0.1375000
NODE_1888_length_1653_cov_34.827542	1210	1290	10	10	80	0.1250000
NODE_1888_length_1653_cov_34.827542	1210	1290	14	5	80	0.0625000
NODE_1888_length_1653_cov_34.827542	1210	1290	15	21	80	0.2625000
NODE_1888_length_1653_cov_34.827542	1210	1290	16	13	80	0.1625000
NODE_1888_length_1653_cov_34.827542	1210	1290	17	17	80	0.2125000
NODE_1888_length_1653_cov_34.827542	1210	1290	19	14	80	0.1750000
NODE_1888_length_1653_cov_34.827542	1263	1339	10	12	76	0.1578947
NODE_1888_length_1653_cov_34.827542	1263	1339	14	42	76	0.5526316
NODE_1888_length_1653_cov_34.827542	1263	1339	15	9	76	0.1184211
NODE_1888_length_1653_cov_34.827542	1263	1339	16	13	76	0.1710526
NODE_1892_length_1652_cov_23.939472	1352	1432	0	80	80	1.0000000
NODE_1892_length_1652_cov_23.939472	1405	1485	0	80	80	1.0000000
NODE_1894_length_1651_cov_3.916881	1552	1617	0	65	65	1.0000000
NODE_1899_length_1649_cov_7.480000	774	854	0	80	80	1.0000000
NODE_1899_length_1649_cov_7.480000	827	907	0	80	80	1.0000000
NODE_1903_length_1647_cov_3.534238	1012	1075	4	1	63	0.0158730
NODE_1903_length_1647_cov_3.534238	1012	1075	5	11	63	0.1746032
NODE_1903_length_1647_cov_3.534238	1012	1075	6	6	63	0.0952381
NODE_1903_length_1647_cov_3.534238	1012	1075	7	38	63	0.6031746
NODE_1903_length_1647_cov_3.534238	1012	1075	8	7	63	0.1111111
NODE_1906_length_1645_cov_16.040103	155	235	0	80	80	1.0000000
NODE_1906_length_1645_cov_16.040103	208	288	0	80	80	1.0000000
NODE_1906_length_1645_cov_16.040103	1090	1170	0	14	80	0.1750000
NODE_1906_length_1645_cov_16.040103	1090	1170	2	42	80	0.5250000
NODE_1906_length_1645_cov_16.040103	1090	1170	4	5	80	0.0625000
NODE_1906_length_1645_cov_16.040103	1090	1170	6	19	80	0.2375000
NODE_1906_length_1645_cov_16.040103	1143	1222	0	66	79	0.8354430
NODE_1906_length_1645_cov_16.040103	1143	1222	2	13	79	0.1645570
NODE_1908_length_1644_cov_2.902913	1160	1240	2	3	80	0.0375000
NODE_1908_length_1644_cov_2.902913	1160	1240	4	7	80	0.0875000
NODE_1908_length_1644_cov_2.902913	1160	1240	6	2	80	0.0250000
NODE_1908_length_1644_cov_2.902913	1160	1240	8	6	80	0.0750000
NODE_1908_length_1644_cov_2.902913	1160	1240	10	33	80	0.4125000
NODE_1908_length_1644_cov_2.902913	1160	1240	11	3	80	0.0375000
NODE_1908_length_1644_cov_2.902913	1160	1240	17	5	80	0.0625000
NODE_1908_length_1644_cov_2.902913	1160	1240	19	21	80	0.2625000
NODE_1917_length_1641_cov_34.032425	487	567	0	53	80	0.6625000
NODE_1917_length_1641_cov_34.032425	487	567	2	27	80	0.3375000
NODE_1917_length_1641_cov_34.032425	540	620	2	80	80	1.0000000
NODE_1917_length_1641_cov_34.032425	616	696	2	78	80	0.9750000
NODE_1917_length_1641_cov_34.032425	616	696	4	2	80	0.0250000
NODE_1917_length_1641_cov_34.032425	669	749	0	49	80	0.6125000
NODE_1917_length_1641_cov_34.032425	669	749	2	31	80	0.3875000
NODE_1917_length_1641_cov_34.032425	1168	1248	0	80	80	1.0000000
NODE_1917_length_1641_cov_34.032425	1219	1301	0	82	82	1.0000000
NODE_1918_length_1641_cov_7.042802	339	390	2	51	51	1.0000000
NODE_1922_length_1640_cov_33.097339	943	1023	0	80	80	1.0000000
NODE_1922_length_1640_cov_33.097339	996	1076	0	80	80	1.0000000
NODE_1922_length_1640_cov_33.097339	1072	1152	0	80	80	1.0000000
NODE_1922_length_1640_cov_33.097339	1125	1206	0	81	81	1.0000000
NODE_1923_length_1640_cov_18.519143	471	551	0	39	80	0.4875000
NODE_1923_length_1640_cov_18.519143	471	551	2	24	80	0.3000000
NODE_1923_length_1640_cov_18.519143	471	551	4	17	80	0.2125000
NODE_1923_length_1640_cov_18.519143	524	604	2	10	80	0.1250000
NODE_1923_length_1640_cov_18.519143	524	604	4	17	80	0.2125000
NODE_1923_length_1640_cov_18.519143	524	604	6	6	80	0.0750000
NODE_1923_length_1640_cov_18.519143	524	604	8	29	80	0.3625000
NODE_1923_length_1640_cov_18.519143	524	604	10	18	80	0.2250000
NODE_1925_length_1639_cov_6.585714	975	1056	0	1	81	0.0123457
NODE_1925_length_1639_cov_6.585714	975	1056	4	80	81	0.9876543
NODE_1925_length_1639_cov_6.585714	1028	1109	0	54	81	0.6666667
NODE_1925_length_1639_cov_6.585714	1028	1109	4	27	81	0.3333333
NODE_1926_length_1639_cov_2.163636	1260	1334	0	19	74	0.2567568
NODE_1926_length_1639_cov_2.163636	1260	1334	2	23	74	0.3108108
NODE_1926_length_1639_cov_2.163636	1260	1334	9	1	74	0.0135135
NODE_1926_length_1639_cov_2.163636	1260	1334	10	31	74	0.4189189
NODE_1926_length_1639_cov_2.163636	1312	1387	10	75	75	1.0000000
NODE_1928_length_1638_cov_18.598441	443	523	0	44	80	0.5500000
NODE_1928_length_1638_cov_18.598441	443	523	4	36	80	0.4500000
NODE_1928_length_1638_cov_18.598441	496	576	0	80	80	1.0000000
NODE_1928_length_1638_cov_18.598441	1157	1237	0	80	80	1.0000000
NODE_1928_length_1638_cov_18.598441	1210	1290	0	80	80	1.0000000
NODE_1932_length_1637_cov_12.048765	410	490	0	80	80	1.0000000
NODE_1932_length_1637_cov_12.048765	463	543	0	80	80	1.0000000
NODE_1932_length_1637_cov_12.048765	1081	1161	0	80	80	1.0000000
NODE_1932_length_1637_cov_12.048765	1134	1214	0	80	80	1.0000000
NODE_1934_length_1635_cov_21.022786	958	1038	0	42	80	0.5250000
NODE_1934_length_1635_cov_21.022786	958	1038	2	38	80	0.4750000
NODE_1934_length_1635_cov_21.022786	1011	1091	0	6	80	0.0750000
NODE_1934_length_1635_cov_21.022786	1011	1091	2	74	80	0.9250000
NODE_1934_length_1635_cov_21.022786	1087	1167	0	79	80	0.9875000
NODE_1934_length_1635_cov_21.022786	1087	1167	2	1	80	0.0125000
NODE_1934_length_1635_cov_21.022786	1140	1220	0	26	80	0.3250000
NODE_1934_length_1635_cov_21.022786	1140	1220	2	54	80	0.6750000
NODE_1936_length_1633_cov_16.743807	1067	1147	8	48	80	0.6000000
NODE_1936_length_1633_cov_16.743807	1067	1147	10	32	80	0.4000000
NODE_1936_length_1633_cov_16.743807	1120	1200	0	48	80	0.6000000
NODE_1936_length_1633_cov_16.743807	1120	1200	6	1	80	0.0125000
NODE_1936_length_1633_cov_16.743807	1120	1200	8	31	80	0.3875000
NODE_1937_length_1633_cov_14.271838	977	1057	0	80	80	1.0000000
NODE_1937_length_1633_cov_14.271838	1030	1110	0	80	80	1.0000000
NODE_1937_length_1633_cov_14.271838	1106	1186	0	80	80	1.0000000
NODE_1937_length_1633_cov_14.271838	1159	1239	0	80	80	1.0000000
NODE_1939_length_1631_cov_25.881201	424	504	0	50	80	0.6250000
NODE_1939_length_1631_cov_25.881201	424	504	2	19	80	0.2375000
NODE_1939_length_1631_cov_25.881201	424	504	4	11	80	0.1375000
NODE_1939_length_1631_cov_25.881201	477	557	2	16	80	0.2000000
NODE_1939_length_1631_cov_25.881201	477	557	4	64	80	0.8000000
NODE_1939_length_1631_cov_25.881201	553	633	0	12	80	0.1500000
NODE_1939_length_1631_cov_25.881201	553	633	2	48	80	0.6000000
NODE_1939_length_1631_cov_25.881201	553	633	3	1	80	0.0125000
NODE_1939_length_1631_cov_25.881201	553	633	4	19	80	0.2375000
NODE_1939_length_1631_cov_25.881201	606	686	0	65	80	0.8125000
NODE_1939_length_1631_cov_25.881201	606	686	2	15	80	0.1875000
NODE_1943_length_1629_cov_32.733987	518	598	0	80	80	1.0000000
NODE_1943_length_1629_cov_32.733987	635	715	0	25	80	0.3125000
NODE_1943_length_1629_cov_32.733987	635	715	4	49	80	0.6125000
NODE_1943_length_1629_cov_32.733987	635	715	7	1	80	0.0125000
NODE_1943_length_1629_cov_32.733987	635	715	8	5	80	0.0625000
NODE_1943_length_1629_cov_32.733987	688	768	4	39	80	0.4875000
NODE_1943_length_1629_cov_32.733987	688	768	7	1	80	0.0125000
NODE_1943_length_1629_cov_32.733987	688	768	8	40	80	0.5000000
NODE_1946_length_1628_cov_15.551995	1454	1518	391	1	64	0.0156250
NODE_1946_length_1628_cov_15.551995	1454	1518	411	1	64	0.0156250
NODE_1946_length_1628_cov_15.551995	1454	1518	431	1	64	0.0156250
NODE_1946_length_1628_cov_15.551995	1454	1518	441	1	64	0.0156250
NODE_1946_length_1628_cov_15.551995	1454	1518	475	1	64	0.0156250
NODE_1946_length_1628_cov_15.551995	1454	1518	493	1	64	0.0156250
NODE_1946_length_1628_cov_15.551995	1454	1518	502	1	64	0.0156250
NODE_1946_length_1628_cov_15.551995	1454	1518	526	1	64	0.0156250
NODE_1946_length_1628_cov_15.551995	1454	1518	538	1	64	0.0156250
NODE_1946_length_1628_cov_15.551995	1454	1518	562	1	64	0.0156250
NODE_1946_length_1628_cov_15.551995	1454	1518	572	1	64	0.0156250
NODE_1946_length_1628_cov_15.551995	1454	1518	584	1	64	0.0156250
NODE_1946_length_1628_cov_15.551995	1454	1518	587	1	64	0.0156250
NODE_1946_length_1628_cov_15.551995	1454	1518	622	1	64	0.0156250
NODE_1946_length_1628_cov_15.551995	1454	1518	640	1	64	0.0156250
NODE_1946_length_1628_cov_15.551995	1454	1518	654	1	64	0.0156250
NODE_1946_length_1628_cov_15.551995	1454	1518	667	1	64	0.0156250
NODE_1946_length_1628_cov_15.551995	1454	1518	685	1	64	0.0156250
NODE_1946_length_1628_cov_15.551995	1454	1518	698	1	64	0.0156250
NODE_1946_length_1628_cov_15.551995	1454	1518	707	1	64	0.0156250
NODE_1946_length_1628_cov_15.551995	1454	1518	746	2	64	0.0312500
NODE_1946_length_1628_cov_15.551995	1454	1518	757	1	64	0.0156250
NODE_1946_length_1628_cov_15.551995	1454	1518	790	1	64	0.0156250
NODE_1946_length_1628_cov_15.551995	1454	1518	798	1	64	0.0156250
NODE_1946_length_1628_cov_15.551995	1454	1518	808	1	64	0.0156250
NODE_1946_length_1628_cov_15.551995	1454	1518	826	1	64	0.0156250
NODE_1946_length_1628_cov_15.551995	1454	1518	834	1	64	0.0156250
NODE_1946_length_1628_cov_15.551995	1454	1518	844	1	64	0.0156250
NODE_1946_length_1628_cov_15.551995	1454	1518	849	1	64	0.0156250
NODE_1946_length_1628_cov_15.551995	1454	1518	867	1	64	0.0156250
NODE_1946_length_1628_cov_15.551995	1454	1518	879	1	64	0.0156250
NODE_1946_length_1628_cov_15.551995	1454	1518	889	1	64	0.0156250
NODE_1946_length_1628_cov_15.551995	1454	1518	899	1	64	0.0156250
NODE_1946_length_1628_cov_15.551995	1454	1518	909	1	64	0.0156250
NODE_1946_length_1628_cov_15.551995	1454	1518	911	1	64	0.0156250
NODE_1946_length_1628_cov_15.551995	1454	1518	913	2	64	0.0312500
NODE_1946_length_1628_cov_15.551995	1454	1518	922	1	64	0.0156250
NODE_1946_length_1628_cov_15.551995	1454	1518	925	1	64	0.0156250
NODE_1946_length_1628_cov_15.551995	1454	1518	927	1	64	0.0156250
NODE_1946_length_1628_cov_15.551995	1454	1518	933	1	64	0.0156250
NODE_1946_length_1628_cov_15.551995	1454	1518	942	2	64	0.0312500
NODE_1946_length_1628_cov_15.551995	1454	1518	950	1	64	0.0156250
NODE_1946_length_1628_cov_15.551995	1454	1518	964	1	64	0.0156250
NODE_1946_length_1628_cov_15.551995	1454	1518	980	1	64	0.0156250
NODE_1946_length_1628_cov_15.551995	1454	1518	992	1	64	0.0156250
NODE_1946_length_1628_cov_15.551995	1454	1518	1002	1	64	0.0156250
NODE_1946_length_1628_cov_15.551995	1454	1518	1019	1	64	0.0156250
NODE_1946_length_1628_cov_15.551995	1454	1518	1020	1	64	0.0156250
NODE_1946_length_1628_cov_15.551995	1454	1518	1042	1	64	0.0156250
NODE_1946_length_1628_cov_15.551995	1454	1518	1054	3	64	0.0468750
NODE_1946_length_1628_cov_15.551995	1454	1518	1076	1	64	0.0156250
NODE_1946_length_1628_cov_15.551995	1454	1518	1082	1	64	0.0156250
NODE_1946_length_1628_cov_15.551995	1454	1518	1084	1	64	0.0156250
NODE_1946_length_1628_cov_15.551995	1454	1518	1090	1	64	0.0156250
NODE_1946_length_1628_cov_15.551995	1454	1518	1100	1	64	0.0156250
NODE_1946_length_1628_cov_15.551995	1454	1518	1104	1	64	0.0156250
NODE_1946_length_1628_cov_15.551995	1454	1518	1118	2	64	0.0312500
NODE_1946_length_1628_cov_15.551995	1454	1518	1120	1	64	0.0156250
NODE_1947_length_1628_cov_4.852845	81	163	25	5	82	0.0609756
NODE_1947_length_1628_cov_4.852845	81	163	27	3	82	0.0365854
NODE_1947_length_1628_cov_4.852845	81	163	28	26	82	0.3170732
NODE_1947_length_1628_cov_4.852845	81	163	30	26	82	0.3170732
NODE_1947_length_1628_cov_4.852845	81	163	32	16	82	0.1951219
NODE_1947_length_1628_cov_4.852845	81	163	34	6	82	0.0731707
NODE_1952_length_1626_cov_20.549443	495	575	0	80	80	1.0000000
NODE_1952_length_1626_cov_20.549443	548	628	0	80	80	1.0000000
NODE_1953_length_1626_cov_6.552718	1189	1269	0	22	80	0.2750000
NODE_1953_length_1626_cov_6.552718	1189	1269	23	14	80	0.1750000
NODE_1953_length_1626_cov_6.552718	1189	1269	25	11	80	0.1375000
NODE_1953_length_1626_cov_6.552718	1189	1269	26	33	80	0.4125000
NODE_1953_length_1626_cov_6.552718	1242	1321	21	29	79	0.3670886
NODE_1953_length_1626_cov_6.552718	1242	1321	22	3	79	0.0379747
NODE_1953_length_1626_cov_6.552718	1242	1321	23	34	79	0.4303797
NODE_1953_length_1626_cov_6.552718	1242	1321	25	11	79	0.1392405
NODE_1953_length_1626_cov_6.552718	1242	1321	26	2	79	0.0253165
NODE_1954_length_1626_cov_4.728880	247	329	1	24	82	0.2926829
NODE_1954_length_1626_cov_4.728880	247	329	6	6	82	0.0731707
NODE_1954_length_1626_cov_4.728880	247	329	7	52	82	0.6341463
NODE_1954_length_1626_cov_4.728880	302	382	6	59	80	0.7375000
NODE_1954_length_1626_cov_4.728880	302	382	7	21	80	0.2625000
NODE_1956_length_1625_cov_20.598952	938	1018	8	56	80	0.7000000
NODE_1956_length_1625_cov_20.598952	938	1018	10	24	80	0.3000000
NODE_1956_length_1625_cov_20.598952	991	1071	2	20	80	0.2500000
NODE_1956_length_1625_cov_20.598952	991	1071	8	3	80	0.0375000
NODE_1956_length_1625_cov_20.598952	991	1071	10	57	80	0.7125000
NODE_1962_length_1623_cov_28.551181	416	486	38	3	70	0.0428571
NODE_1962_length_1623_cov_28.551181	416	486	40	18	70	0.2571429
NODE_1962_length_1623_cov_28.551181	416	486	42	20	70	0.2857143
NODE_1962_length_1623_cov_28.551181	416	486	44	5	70	0.0714286
NODE_1962_length_1623_cov_28.551181	416	486	46	16	70	0.2285714
NODE_1962_length_1623_cov_28.551181	416	486	47	8	70	0.1142857
NODE_1962_length_1623_cov_28.551181	459	507	20	4	48	0.0833333
NODE_1962_length_1623_cov_28.551181	459	507	22	2	48	0.0416667
NODE_1962_length_1623_cov_28.551181	459	507	26	1	48	0.0208333
NODE_1962_length_1623_cov_28.551181	459	507	30	3	48	0.0625000
NODE_1962_length_1623_cov_28.551181	459	507	32	1	48	0.0208333
NODE_1962_length_1623_cov_28.551181	459	507	38	10	48	0.2083333
NODE_1962_length_1623_cov_28.551181	459	507	40	18	48	0.3750000
NODE_1962_length_1623_cov_28.551181	459	507	42	6	48	0.1250000
NODE_1962_length_1623_cov_28.551181	459	507	58	1	48	0.0208333
NODE_1962_length_1623_cov_28.551181	459	507	59	1	48	0.0208333
NODE_1962_length_1623_cov_28.551181	459	507	60	1	48	0.0208333
NODE_1965_length_1622_cov_7.969140	645	725	0	80	80	1.0000000
NODE_1965_length_1622_cov_7.969140	698	778	0	80	80	1.0000000
NODE_1970_length_1621_cov_2.192510	330	401	10	2	71	0.0281690
NODE_1970_length_1621_cov_2.192510	330	401	16	41	71	0.5774648
NODE_1970_length_1621_cov_2.192510	330	401	18	28	71	0.3943662
NODE_1975_length_1618_cov_44.138907	361	441	0	8	80	0.1000000
NODE_1975_length_1618_cov_44.138907	361	441	2	72	80	0.9000000
NODE_1975_length_1618_cov_44.138907	414	494	0	61	80	0.7625000
NODE_1975_length_1618_cov_44.138907	414	494	2	19	80	0.2375000
NODE_1975_length_1618_cov_44.138907	1063	1143	2	21	80	0.2625000
NODE_1975_length_1618_cov_44.138907	1063	1143	8	49	80	0.6125000
NODE_1975_length_1618_cov_44.138907	1063	1143	10	10	80	0.1250000
NODE_1975_length_1618_cov_44.138907	1116	1196	8	80	80	1.0000000
NODE_1976_length_1618_cov_5.779460	332	414	0	82	82	1.0000000
NODE_1976_length_1618_cov_5.779460	387	467	0	38	80	0.4750000
NODE_1976_length_1618_cov_5.779460	387	467	4	42	80	0.5250000
NODE_1976_length_1618_cov_5.779460	972	1028	2	56	56	1.0000000
NODE_1980_length_1616_cov_5.313777	589	669	0	7	80	0.0875000
NODE_1980_length_1616_cov_5.313777	589	669	1	1	80	0.0125000
NODE_1980_length_1616_cov_5.313777	589	669	2	72	80	0.9000000
NODE_1980_length_1616_cov_5.313777	642	722	0	25	80	0.3125000
NODE_1980_length_1616_cov_5.313777	642	722	2	55	80	0.6875000
NODE_1981_length_1615_cov_12.575858	1032	1112	0	38	80	0.4750000
NODE_1981_length_1615_cov_12.575858	1032	1112	2	42	80	0.5250000
NODE_1981_length_1615_cov_12.575858	1085	1162	0	77	77	1.0000000
NODE_1981_length_1615_cov_12.575858	1158	1238	0	52	80	0.6500000
NODE_1981_length_1615_cov_12.575858	1158	1238	1	1	80	0.0125000
NODE_1981_length_1615_cov_12.575858	1158	1238	2	27	80	0.3375000
NODE_1981_length_1615_cov_12.575858	1211	1291	0	7	80	0.0875000
NODE_1981_length_1615_cov_12.575858	1211	1291	2	73	80	0.9125000
NODE_1983_length_1614_cov_94.900990	0	46	0	11	46	0.2391304
NODE_1983_length_1614_cov_94.900990	0	46	2	4	46	0.0869565
NODE_1983_length_1614_cov_94.900990	0	46	6	31	46	0.6739131
NODE_1983_length_1614_cov_94.900990	23	99	6	76	76	1.0000000
NODE_1984_length_1614_cov_18.799340	655	735	8	14	80	0.1750000
NODE_1984_length_1614_cov_18.799340	655	735	12	66	80	0.8250000
NODE_1984_length_1614_cov_18.799340	708	788	4	47	80	0.5875000
NODE_1984_length_1614_cov_18.799340	708	788	8	2	80	0.0250000
NODE_1984_length_1614_cov_18.799340	708	788	12	31	80	0.3875000
NODE_1986_length_1613_cov_6.865258	1128	1203	2	1	75	0.0133333
NODE_1986_length_1613_cov_6.865258	1128	1203	4	1	75	0.0133333
NODE_1986_length_1613_cov_6.865258	1128	1203	10	11	75	0.1466667
NODE_1986_length_1613_cov_6.865258	1128	1203	12	13	75	0.1733333
NODE_1986_length_1613_cov_6.865258	1128	1203	14	49	75	0.6533333
NODE_1986_length_1613_cov_6.865258	1176	1256	8	5	80	0.0625000
NODE_1986_length_1613_cov_6.865258	1176	1256	9	4	80	0.0500000
NODE_1986_length_1613_cov_6.865258	1176	1256	11	18	80	0.2250000
NODE_1986_length_1613_cov_6.865258	1176	1256	12	39	80	0.4875000
NODE_1986_length_1613_cov_6.865258	1176	1256	14	14	80	0.1750000
NODE_1993_length_1610_cov_18.014560	1035	1115	0	80	80	1.0000000
NODE_1993_length_1610_cov_18.014560	1088	1168	0	80	80	1.0000000
NODE_2001_length_1603_cov_9.128324	1109	1189	0	56	80	0.7000000
NODE_2001_length_1603_cov_9.128324	1109	1189	2	24	80	0.3000000
NODE_2001_length_1603_cov_9.128324	1162	1242	0	3	80	0.0375000
NODE_2001_length_1603_cov_9.128324	1162	1242	2	25	80	0.3125000
NODE_2001_length_1603_cov_9.128324	1162	1242	4	52	80	0.6500000
NODE_2003_length_1602_cov_79.840319	1378	1445	79	1	67	0.0149254
NODE_2003_length_1602_cov_79.840319	1378	1445	81	3	67	0.0447761
NODE_2003_length_1602_cov_79.840319	1378	1445	83	1	67	0.0149254
NODE_2003_length_1602_cov_79.840319	1378	1445	85	5	67	0.0746269
NODE_2003_length_1602_cov_79.840319	1378	1445	89	2	67	0.0298507
NODE_2003_length_1602_cov_79.840319	1378	1445	91	2	67	0.0298507
NODE_2003_length_1602_cov_79.840319	1378	1445	94	1	67	0.0149254
NODE_2003_length_1602_cov_79.840319	1378	1445	95	1	67	0.0149254
NODE_2003_length_1602_cov_79.840319	1378	1445	97	7	67	0.1044776
NODE_2003_length_1602_cov_79.840319	1378	1445	99	1	67	0.0149254
NODE_2003_length_1602_cov_79.840319	1378	1445	102	1	67	0.0149254
NODE_2003_length_1602_cov_79.840319	1378	1445	103	1	67	0.0149254
NODE_2003_length_1602_cov_79.840319	1378	1445	106	2	67	0.0298507
NODE_2003_length_1602_cov_79.840319	1378	1445	109	3	67	0.0447761
NODE_2003_length_1602_cov_79.840319	1378	1445	113	2	67	0.0298507
NODE_2003_length_1602_cov_79.840319	1378	1445	123	2	67	0.0298507
NODE_2003_length_1602_cov_79.840319	1378	1445	125	2	67	0.0298507
NODE_2003_length_1602_cov_79.840319	1378	1445	127	3	67	0.0447761
NODE_2003_length_1602_cov_79.840319	1378	1445	128	1	67	0.0149254
NODE_2003_length_1602_cov_79.840319	1378	1445	129	5	67	0.0746269
NODE_2003_length_1602_cov_79.840319	1378	1445	135	1	67	0.0149254
NODE_2003_length_1602_cov_79.840319	1378	1445	136	1	67	0.0149254
NODE_2003_length_1602_cov_79.840319	1378	1445	140	2	67	0.0298507
NODE_2003_length_1602_cov_79.840319	1378	1445	144	2	67	0.0298507
NODE_2003_length_1602_cov_79.840319	1378	1445	146	1	67	0.0149254
NODE_2003_length_1602_cov_79.840319	1378	1445	148	1	67	0.0149254
NODE_2003_length_1602_cov_79.840319	1378	1445	150	6	67	0.0895522
NODE_2003_length_1602_cov_79.840319	1378	1445	151	2	67	0.0298507
NODE_2003_length_1602_cov_79.840319	1378	1445	152	2	67	0.0298507
NODE_2003_length_1602_cov_79.840319	1378	1445	153	1	67	0.0149254
NODE_2003_length_1602_cov_79.840319	1378	1445	154	1	67	0.0149254
NODE_2003_length_1602_cov_79.840319	1378	1445	156	1	67	0.0149254
NODE_2003_length_1602_cov_79.840319	1462	1508	49	2	46	0.0434783
NODE_2003_length_1602_cov_79.840319	1462	1508	50	1	46	0.0217391
NODE_2003_length_1602_cov_79.840319	1462	1508	52	1	46	0.0217391
NODE_2003_length_1602_cov_79.840319	1462	1508	53	10	46	0.2173913
NODE_2003_length_1602_cov_79.840319	1462	1508	54	1	46	0.0217391
NODE_2003_length_1602_cov_79.840319	1462	1508	55	2	46	0.0434783
NODE_2003_length_1602_cov_79.840319	1462	1508	57	3	46	0.0652174
NODE_2003_length_1602_cov_79.840319	1462	1508	58	1	46	0.0217391
NODE_2003_length_1602_cov_79.840319	1462	1508	59	3	46	0.0652174
NODE_2003_length_1602_cov_79.840319	1462	1508	61	8	46	0.1739130
NODE_2003_length_1602_cov_79.840319	1462	1508	62	3	46	0.0652174
NODE_2003_length_1602_cov_79.840319	1462	1508	63	4	46	0.0869565
NODE_2003_length_1602_cov_79.840319	1462	1508	64	7	46	0.1521739
NODE_2004_length_1602_cov_2.701264	1490	1570	15	9	80	0.1125000
NODE_2004_length_1602_cov_2.701264	1490	1570	16	2	80	0.0250000
NODE_2004_length_1602_cov_2.701264	1490	1570	18	3	80	0.0375000
NODE_2004_length_1602_cov_2.701264	1490	1570	20	9	80	0.1125000
NODE_2004_length_1602_cov_2.701264	1490	1570	22	57	80	0.7125000
NODE_2009_length_1600_cov_34.988008	785	865	2	15	80	0.1875000
NODE_2009_length_1600_cov_34.988008	785	865	4	12	80	0.1500000
NODE_2009_length_1600_cov_34.988008	785	865	6	53	80	0.6625000
NODE_2009_length_1600_cov_34.988008	838	918	0	37	80	0.4625000
NODE_2009_length_1600_cov_34.988008	838	918	2	31	80	0.3875000
NODE_2009_length_1600_cov_34.988008	838	918	4	1	80	0.0125000
NODE_2009_length_1600_cov_34.988008	838	918	6	11	80	0.1375000
NODE_2009_length_1600_cov_34.988008	914	994	0	51	80	0.6375000
NODE_2009_length_1600_cov_34.988008	914	994	4	29	80	0.3625000
NODE_2009_length_1600_cov_34.988008	967	1047	2	1	80	0.0125000
NODE_2009_length_1600_cov_34.988008	967	1047	4	45	80	0.5625000
NODE_2009_length_1600_cov_34.988008	967	1047	6	34	80	0.4250000
NODE_2011_length_1600_cov_11.383744	0	72	0	72	72	1.0000000
NODE_2011_length_1600_cov_11.383744	45	99	0	54	54	1.0000000
NODE_2011_length_1600_cov_11.383744	891	971	0	80	80	1.0000000
NODE_2011_length_1600_cov_11.383744	944	1024	0	45	80	0.5625000
NODE_2011_length_1600_cov_11.383744	944	1024	2	35	80	0.4375000
NODE_2013_length_1600_cov_7.236509	1037	1109	0	72	72	1.0000000
NODE_2013_length_1600_cov_7.236509	1090	1160	0	70	70	1.0000000
NODE_2018_length_1598_cov_29.337558	335	415	0	80	80	1.0000000
NODE_2018_length_1598_cov_29.337558	388	468	0	73	80	0.9125000
NODE_2018_length_1598_cov_29.337558	388	468	2	7	80	0.0875000
NODE_2018_length_1598_cov_29.337558	464	516	2	4	52	0.0769231
NODE_2018_length_1598_cov_29.337558	464	516	4	6	52	0.1153846
NODE_2018_length_1598_cov_29.337558	464	516	6	11	52	0.2115385
NODE_2018_length_1598_cov_29.337558	464	516	8	31	52	0.5961539
NODE_2018_length_1598_cov_29.337558	1026	1106	0	80	80	1.0000000
NODE_2018_length_1598_cov_29.337558	1079	1159	0	80	80	1.0000000
NODE_2019_length_1598_cov_3.730487	1117	1197	0	80	80	1.0000000
NODE_2021_length_1597_cov_7.434579	1373	1453	30	6	80	0.0750000
NODE_2021_length_1597_cov_7.434579	1373	1453	32	2	80	0.0250000
NODE_2021_length_1597_cov_7.434579	1373	1453	46	1	80	0.0125000
NODE_2021_length_1597_cov_7.434579	1373	1453	47	3	80	0.0375000
NODE_2021_length_1597_cov_7.434579	1373	1453	49	15	80	0.1875000
NODE_2021_length_1597_cov_7.434579	1373	1453	58	1	80	0.0125000
NODE_2021_length_1597_cov_7.434579	1373	1453	61	11	80	0.1375000
NODE_2021_length_1597_cov_7.434579	1373	1453	63	14	80	0.1750000
NODE_2021_length_1597_cov_7.434579	1373	1453	64	1	80	0.0125000
NODE_2021_length_1597_cov_7.434579	1373	1453	65	4	80	0.0500000
NODE_2021_length_1597_cov_7.434579	1373	1453	69	2	80	0.0250000
NODE_2021_length_1597_cov_7.434579	1373	1453	72	1	80	0.0125000
NODE_2021_length_1597_cov_7.434579	1373	1453	85	1	80	0.0125000
NODE_2021_length_1597_cov_7.434579	1373	1453	89	1	80	0.0125000
NODE_2021_length_1597_cov_7.434579	1373	1453	98	1	80	0.0125000
NODE_2021_length_1597_cov_7.434579	1373	1453	102	1	80	0.0125000
NODE_2021_length_1597_cov_7.434579	1373	1453	113	2	80	0.0250000
NODE_2021_length_1597_cov_7.434579	1373	1453	122	1	80	0.0125000
NODE_2021_length_1597_cov_7.434579	1373	1453	125	1	80	0.0125000
NODE_2021_length_1597_cov_7.434579	1373	1453	129	1	80	0.0125000
NODE_2021_length_1597_cov_7.434579	1373	1453	135	2	80	0.0250000
NODE_2021_length_1597_cov_7.434579	1373	1453	136	1	80	0.0125000
NODE_2021_length_1597_cov_7.434579	1373	1453	142	1	80	0.0125000
NODE_2021_length_1597_cov_7.434579	1373	1453	146	1	80	0.0125000
NODE_2021_length_1597_cov_7.434579	1373	1453	155	1	80	0.0125000
NODE_2021_length_1597_cov_7.434579	1373	1453	169	2	80	0.0250000
NODE_2021_length_1597_cov_7.434579	1373	1453	171	1	80	0.0125000
NODE_2021_length_1597_cov_7.434579	1373	1453	177	1	80	0.0125000
NODE_2021_length_1597_cov_7.434579	1382	1453	47	3	71	0.0422535
NODE_2021_length_1597_cov_7.434579	1382	1453	49	15	71	0.2112676
NODE_2021_length_1597_cov_7.434579	1382	1453	58	1	71	0.0140845
NODE_2021_length_1597_cov_7.434579	1382	1453	61	11	71	0.1549296
NODE_2021_length_1597_cov_7.434579	1382	1453	63	14	71	0.1971831
NODE_2021_length_1597_cov_7.434579	1382	1453	64	1	71	0.0140845
NODE_2021_length_1597_cov_7.434579	1382	1453	65	4	71	0.0563380
NODE_2021_length_1597_cov_7.434579	1382	1453	69	2	71	0.0281690
NODE_2021_length_1597_cov_7.434579	1382	1453	72	1	71	0.0140845
NODE_2021_length_1597_cov_7.434579	1382	1453	85	1	71	0.0140845
NODE_2021_length_1597_cov_7.434579	1382	1453	89	1	71	0.0140845
NODE_2021_length_1597_cov_7.434579	1382	1453	98	1	71	0.0140845
NODE_2021_length_1597_cov_7.434579	1382	1453	102	1	71	0.0140845
NODE_2021_length_1597_cov_7.434579	1382	1453	113	2	71	0.0281690
NODE_2021_length_1597_cov_7.434579	1382	1453	122	1	71	0.0140845
NODE_2021_length_1597_cov_7.434579	1382	1453	125	1	71	0.0140845
NODE_2021_length_1597_cov_7.434579	1382	1453	129	1	71	0.0140845
NODE_2021_length_1597_cov_7.434579	1382	1453	135	2	71	0.0281690
NODE_2021_length_1597_cov_7.434579	1382	1453	136	1	71	0.0140845
NODE_2021_length_1597_cov_7.434579	1382	1453	142	1	71	0.0140845
NODE_2021_length_1597_cov_7.434579	1382	1453	146	1	71	0.0140845
NODE_2021_length_1597_cov_7.434579	1382	1453	155	1	71	0.0140845
NODE_2021_length_1597_cov_7.434579	1382	1453	169	2	71	0.0281690
NODE_2021_length_1597_cov_7.434579	1382	1453	171	1	71	0.0140845
NODE_2021_length_1597_cov_7.434579	1382	1453	177	1	71	0.0140845
NODE_2022_length_1595_cov_16.788770	215	267	10	5	52	0.0961538
NODE_2022_length_1595_cov_16.788770	215	267	14	7	52	0.1346154
NODE_2022_length_1595_cov_16.788770	215	267	18	6	52	0.1153846
NODE_2022_length_1595_cov_16.788770	215	267	22	34	52	0.6538461
NODE_2022_length_1595_cov_16.788770	614	673	8	1	59	0.0169492
NODE_2022_length_1595_cov_16.788770	614	673	20	1	59	0.0169492
NODE_2022_length_1595_cov_16.788770	614	673	26	4	59	0.0677966
NODE_2022_length_1595_cov_16.788770	614	673	27	1	59	0.0169492
NODE_2022_length_1595_cov_16.788770	614	673	28	52	59	0.8813559
NODE_2025_length_1593_cov_22.412316	144	224	0	78	80	0.9750000
NODE_2025_length_1593_cov_22.412316	144	224	2	2	80	0.0250000
NODE_2025_length_1593_cov_22.412316	197	277	0	40	80	0.5000000
NODE_2025_length_1593_cov_22.412316	197	277	1	40	80	0.5000000
NODE_2025_length_1593_cov_22.412316	1192	1272	0	30	80	0.3750000
NODE_2025_length_1593_cov_22.412316	1192	1272	2	50	80	0.6250000
NODE_2025_length_1593_cov_22.412316	1245	1325	0	32	80	0.4000000
NODE_2025_length_1593_cov_22.412316	1245	1325	2	48	80	0.6000000
NODE_2026_length_1593_cov_14.092369	357	437	0	80	80	1.0000000
NODE_2026_length_1593_cov_14.092369	410	490	0	80	80	1.0000000
NODE_2026_length_1593_cov_14.092369	1061	1141	0	49	80	0.6125000
NODE_2026_length_1593_cov_14.092369	1061	1141	2	2	80	0.0250000
NODE_2026_length_1593_cov_14.092369	1061	1141	4	29	80	0.3625000
NODE_2026_length_1593_cov_14.092369	1114	1194	4	80	80	1.0000000
NODE_2031_length_1592_cov_4.576691	277	357	18	20	80	0.2500000
NODE_2031_length_1592_cov_4.576691	277	357	20	60	80	0.7500000
NODE_2031_length_1592_cov_4.576691	330	410	0	23	80	0.2875000
NODE_2031_length_1592_cov_4.576691	330	410	2	10	80	0.1250000
NODE_2031_length_1592_cov_4.576691	330	410	20	47	80	0.5875000
NODE_2034_length_1591_cov_15.481233	841	921	0	58	80	0.7250000
NODE_2034_length_1591_cov_15.481233	841	921	2	22	80	0.2750000
NODE_2034_length_1591_cov_15.481233	894	974	0	5	80	0.0625000
NODE_2034_length_1591_cov_15.481233	894	974	2	75	80	0.9375000
NODE_2035_length_1591_cov_4.040885	35	65	0	30	30	1.0000000
NODE_2035_length_1591_cov_4.040885	38	99	0	60	61	0.9836066
NODE_2035_length_1591_cov_4.040885	38	99	2	1	61	0.0163934
NODE_2042_length_1589_cov_10.184564	379	459	0	80	80	1.0000000
NODE_2042_length_1589_cov_10.184564	432	512	0	80	80	1.0000000
NODE_2042_length_1589_cov_10.184564	473	512	0	39	39	1.0000000
NODE_2042_length_1589_cov_10.184564	508	588	0	80	80	1.0000000
NODE_2042_length_1589_cov_10.184564	561	641	0	80	80	1.0000000
NODE_2043_length_1588_cov_9.955675	415	495	4	80	80	1.0000000
NODE_2043_length_1588_cov_9.955675	468	548	0	40	80	0.5000000
NODE_2043_length_1588_cov_9.955675	468	548	4	40	80	0.5000000
NODE_2046_length_1587_cov_7.942204	710	790	0	33	80	0.4125000
NODE_2046_length_1587_cov_7.942204	710	790	2	7	80	0.0875000
NODE_2046_length_1587_cov_7.942204	710	790	4	6	80	0.0750000
NODE_2046_length_1587_cov_7.942204	710	790	6	6	80	0.0750000
NODE_2046_length_1587_cov_7.942204	710	790	10	10	80	0.1250000
NODE_2046_length_1587_cov_7.942204	710	790	12	1	80	0.0125000
NODE_2046_length_1587_cov_7.942204	710	790	18	3	80	0.0375000
NODE_2046_length_1587_cov_7.942204	710	790	21	1	80	0.0125000
NODE_2046_length_1587_cov_7.942204	710	790	22	1	80	0.0125000
NODE_2046_length_1587_cov_7.942204	710	790	24	11	80	0.1375000
NODE_2046_length_1587_cov_7.942204	710	790	26	1	80	0.0125000
NODE_2046_length_1587_cov_7.942204	763	843	0	42	80	0.5250000
NODE_2046_length_1587_cov_7.942204	763	843	2	38	80	0.4750000
NODE_2049_length_1586_cov_6.488231	447	474	0	27	27	1.0000000
NODE_2049_length_1586_cov_6.488231	447	527	0	80	80	1.0000000
NODE_2049_length_1586_cov_6.488231	500	580	0	80	80	1.0000000
NODE_2056_length_1583_cov_27.825472	800	880	0	80	80	1.0000000
NODE_2056_length_1583_cov_27.825472	853	933	0	80	80	1.0000000
NODE_2056_length_1583_cov_27.825472	929	1009	0	80	80	1.0000000
NODE_2056_length_1583_cov_27.825472	982	1062	0	80	80	1.0000000
NODE_2060_length_1581_cov_10.610661	457	537	0	80	80	1.0000000
NODE_2060_length_1581_cov_10.610661	510	590	0	80	80	1.0000000
NODE_2065_length_1579_cov_7.395946	5	80	0	75	75	1.0000000
NODE_2065_length_1579_cov_7.395946	58	126	0	68	68	1.0000000
NODE_2066_length_1579_cov_7.152027	1331	1409	0	78	78	1.0000000
NODE_2066_length_1579_cov_7.152027	1382	1462	0	80	80	1.0000000
NODE_2067_length_1579_cov_6.741892	4	52	23	7	48	0.1458333
NODE_2067_length_1579_cov_6.741892	4	52	28	6	48	0.1250000
NODE_2067_length_1579_cov_6.741892	4	52	29	11	48	0.2291667
NODE_2067_length_1579_cov_6.741892	4	52	37	4	48	0.0833333
NODE_2067_length_1579_cov_6.741892	4	52	39	1	48	0.0208333
NODE_2067_length_1579_cov_6.741892	4	52	43	7	48	0.1458333
NODE_2067_length_1579_cov_6.741892	4	52	46	1	48	0.0208333
NODE_2067_length_1579_cov_6.741892	4	52	47	3	48	0.0625000
NODE_2067_length_1579_cov_6.741892	4	52	54	8	48	0.1666667
NODE_2067_length_1579_cov_6.741892	4	52	23	7	48	0.1458333
NODE_2067_length_1579_cov_6.741892	4	52	28	6	48	0.1250000
NODE_2067_length_1579_cov_6.741892	4	52	29	11	48	0.2291667
NODE_2067_length_1579_cov_6.741892	4	52	37	4	48	0.0833333
NODE_2067_length_1579_cov_6.741892	4	52	39	1	48	0.0208333
NODE_2067_length_1579_cov_6.741892	4	52	43	7	48	0.1458333
NODE_2067_length_1579_cov_6.741892	4	52	46	1	48	0.0208333
NODE_2067_length_1579_cov_6.741892	4	52	47	3	48	0.0625000
NODE_2067_length_1579_cov_6.741892	4	52	54	8	48	0.1666667
NODE_2067_length_1579_cov_6.741892	4	52	23	7	48	0.1458333
NODE_2067_length_1579_cov_6.741892	4	52	28	6	48	0.1250000
NODE_2067_length_1579_cov_6.741892	4	52	29	11	48	0.2291667
NODE_2067_length_1579_cov_6.741892	4	52	37	4	48	0.0833333
NODE_2067_length_1579_cov_6.741892	4	52	39	1	48	0.0208333
NODE_2067_length_1579_cov_6.741892	4	52	43	7	48	0.1458333
NODE_2067_length_1579_cov_6.741892	4	52	46	1	48	0.0208333
NODE_2067_length_1579_cov_6.741892	4	52	47	3	48	0.0625000
NODE_2067_length_1579_cov_6.741892	4	52	54	8	48	0.1666667
NODE_2067_length_1579_cov_6.741892	25	105	29	3	80	0.0375000
NODE_2067_length_1579_cov_6.741892	25	105	37	4	80	0.0500000
NODE_2067_length_1579_cov_6.741892	25	105	39	1	80	0.0125000
NODE_2067_length_1579_cov_6.741892	25	105	43	7	80	0.0875000
NODE_2067_length_1579_cov_6.741892	25	105	46	1	80	0.0125000
NODE_2067_length_1579_cov_6.741892	25	105	47	3	80	0.0375000
NODE_2067_length_1579_cov_6.741892	25	105	54	8	80	0.1000000
NODE_2067_length_1579_cov_6.741892	25	105	56	1	80	0.0125000
NODE_2067_length_1579_cov_6.741892	25	105	60	1	80	0.0125000
NODE_2067_length_1579_cov_6.741892	25	105	61	3	80	0.0375000
NODE_2067_length_1579_cov_6.741892	25	105	63	9	80	0.1125000
NODE_2067_length_1579_cov_6.741892	25	105	68	7	80	0.0875000
NODE_2067_length_1579_cov_6.741892	25	105	69	3	80	0.0375000
NODE_2067_length_1579_cov_6.741892	25	105	74	1	80	0.0125000
NODE_2067_length_1579_cov_6.741892	25	105	75	1	80	0.0125000
NODE_2067_length_1579_cov_6.741892	25	105	76	27	80	0.3375000
NODE_2067_length_1579_cov_6.741892	25	91	29	3	66	0.0454545
NODE_2067_length_1579_cov_6.741892	25	91	37	4	66	0.0606061
NODE_2067_length_1579_cov_6.741892	25	91	39	1	66	0.0151515
NODE_2067_length_1579_cov_6.741892	25	91	43	7	66	0.1060606
NODE_2067_length_1579_cov_6.741892	25	91	46	1	66	0.0151515
NODE_2067_length_1579_cov_6.741892	25	91	47	3	66	0.0454545
NODE_2067_length_1579_cov_6.741892	25	91	54	8	66	0.1212121
NODE_2067_length_1579_cov_6.741892	25	91	56	1	66	0.0151515
NODE_2067_length_1579_cov_6.741892	25	91	60	1	66	0.0151515
NODE_2067_length_1579_cov_6.741892	25	91	61	3	66	0.0454545
NODE_2067_length_1579_cov_6.741892	25	91	63	9	66	0.1363636
NODE_2067_length_1579_cov_6.741892	25	91	68	7	66	0.1060606
NODE_2067_length_1579_cov_6.741892	25	91	69	3	66	0.0454545
NODE_2067_length_1579_cov_6.741892	25	91	74	1	66	0.0151515
NODE_2067_length_1579_cov_6.741892	25	91	75	1	66	0.0151515
NODE_2067_length_1579_cov_6.741892	25	91	76	13	66	0.1969697
NODE_2067_length_1579_cov_6.741892	25	96	29	3	71	0.0422535
NODE_2067_length_1579_cov_6.741892	25	96	37	4	71	0.0563380
NODE_2067_length_1579_cov_6.741892	25	96	39	1	71	0.0140845
NODE_2067_length_1579_cov_6.741892	25	96	43	7	71	0.0985916
NODE_2067_length_1579_cov_6.741892	25	96	46	1	71	0.0140845
NODE_2067_length_1579_cov_6.741892	25	96	47	3	71	0.0422535
NODE_2067_length_1579_cov_6.741892	25	96	54	8	71	0.1126761
NODE_2067_length_1579_cov_6.741892	25	96	56	1	71	0.0140845
NODE_2067_length_1579_cov_6.741892	25	96	60	1	71	0.0140845
NODE_2067_length_1579_cov_6.741892	25	96	61	3	71	0.0422535
NODE_2067_length_1579_cov_6.741892	25	96	63	9	71	0.1267606
NODE_2067_length_1579_cov_6.741892	25	96	68	7	71	0.0985916
NODE_2067_length_1579_cov_6.741892	25	96	69	3	71	0.0422535
NODE_2067_length_1579_cov_6.741892	25	96	74	1	71	0.0140845
NODE_2067_length_1579_cov_6.741892	25	96	75	1	71	0.0140845
NODE_2067_length_1579_cov_6.741892	25	96	76	18	71	0.2535211
NODE_2076_length_1575_cov_4.250000	993	1073	0	80	80	1.0000000
NODE_2076_length_1575_cov_4.250000	1046	1126	0	80	80	1.0000000
NODE_2078_length_1574_cov_40.682034	551	631	4	80	80	1.0000000
NODE_2078_length_1574_cov_40.682034	604	684	0	23	80	0.2875000
NODE_2078_length_1574_cov_40.682034	604	684	1	2	80	0.0250000
NODE_2078_length_1574_cov_40.682034	604	684	2	5	80	0.0625000
NODE_2078_length_1574_cov_40.682034	604	684	4	50	80	0.6250000
NODE_2078_length_1574_cov_40.682034	680	760	0	80	80	1.0000000
NODE_2078_length_1574_cov_40.682034	733	813	0	80	80	1.0000000
NODE_2079_length_1574_cov_7.572203	1306	1386	6	9	80	0.1125000
NODE_2079_length_1574_cov_7.572203	1306	1386	8	37	80	0.4625000
NODE_2079_length_1574_cov_7.572203	1306	1386	12	34	80	0.4250000
NODE_2079_length_1574_cov_7.572203	1359	1439	0	13	80	0.1625000
NODE_2079_length_1574_cov_7.572203	1359	1439	4	37	80	0.4625000
NODE_2079_length_1574_cov_7.572203	1359	1439	6	12	80	0.1500000
NODE_2079_length_1574_cov_7.572203	1359	1439	12	18	80	0.2250000
NODE_2081_length_1573_cov_16.107191	437	512	0	75	75	1.0000000
NODE_2081_length_1573_cov_16.107191	485	565	0	66	80	0.8250000
NODE_2081_length_1573_cov_16.107191	485	565	2	14	80	0.1750000
NODE_2081_length_1573_cov_16.107191	561	639	2	62	78	0.7948718
NODE_2081_length_1573_cov_16.107191	561	639	4	16	78	0.2051282
NODE_2081_length_1573_cov_16.107191	612	692	2	11	80	0.1375000
NODE_2081_length_1573_cov_16.107191	612	692	4	26	80	0.3250000
NODE_2081_length_1573_cov_16.107191	612	692	8	39	80	0.4875000
NODE_2081_length_1573_cov_16.107191	612	692	10	4	80	0.0500000
NODE_2085_length_1572_cov_25.966735	359	404	260	1	45	0.0222222
NODE_2085_length_1572_cov_25.966735	359	404	265	1	45	0.0222222
NODE_2085_length_1572_cov_25.966735	359	404	267	2	45	0.0444444
NODE_2085_length_1572_cov_25.966735	359	404	272	1	45	0.0222222
NODE_2085_length_1572_cov_25.966735	359	404	276	1	45	0.0222222
NODE_2085_length_1572_cov_25.966735	359	404	279	1	45	0.0222222
NODE_2085_length_1572_cov_25.966735	359	404	283	1	45	0.0222222
NODE_2085_length_1572_cov_25.966735	359	404	285	1	45	0.0222222
NODE_2085_length_1572_cov_25.966735	359	404	286	1	45	0.0222222
NODE_2085_length_1572_cov_25.966735	359	404	287	2	45	0.0444444
NODE_2085_length_1572_cov_25.966735	359	404	289	1	45	0.0222222
NODE_2085_length_1572_cov_25.966735	359	404	292	1	45	0.0222222
NODE_2085_length_1572_cov_25.966735	359	404	293	2	45	0.0444444
NODE_2085_length_1572_cov_25.966735	359	404	294	1	45	0.0222222
NODE_2085_length_1572_cov_25.966735	359	404	295	1	45	0.0222222
NODE_2085_length_1572_cov_25.966735	359	404	296	1	45	0.0222222
NODE_2085_length_1572_cov_25.966735	359	404	297	1	45	0.0222222
NODE_2085_length_1572_cov_25.966735	359	404	299	1	45	0.0222222
NODE_2085_length_1572_cov_25.966735	359	404	304	2	45	0.0444444
NODE_2085_length_1572_cov_25.966735	359	404	306	1	45	0.0222222
NODE_2085_length_1572_cov_25.966735	359	404	308	1	45	0.0222222
NODE_2085_length_1572_cov_25.966735	359	404	310	1	45	0.0222222
NODE_2085_length_1572_cov_25.966735	359	404	316	1	45	0.0222222
NODE_2085_length_1572_cov_25.966735	359	404	324	1	45	0.0222222
NODE_2085_length_1572_cov_25.966735	359	404	327	1	45	0.0222222
NODE_2085_length_1572_cov_25.966735	359	404	329	1	45	0.0222222
NODE_2085_length_1572_cov_25.966735	359	404	333	1	45	0.0222222
NODE_2085_length_1572_cov_25.966735	359	404	335	1	45	0.0222222
NODE_2085_length_1572_cov_25.966735	359	404	336	1	45	0.0222222
NODE_2085_length_1572_cov_25.966735	359	404	341	2	45	0.0444444
NODE_2085_length_1572_cov_25.966735	359	404	342	2	45	0.0444444
NODE_2085_length_1572_cov_25.966735	359	404	343	1	45	0.0222222
NODE_2085_length_1572_cov_25.966735	359	404	346	1	45	0.0222222
NODE_2085_length_1572_cov_25.966735	359	404	355	1	45	0.0222222
NODE_2085_length_1572_cov_25.966735	359	404	359	1	45	0.0222222
NODE_2085_length_1572_cov_25.966735	359	404	360	1	45	0.0222222
NODE_2085_length_1572_cov_25.966735	359	404	362	1	45	0.0222222
NODE_2085_length_1572_cov_25.966735	359	404	373	1	45	0.0222222
NODE_2085_length_1572_cov_25.966735	359	404	384	1	45	0.0222222
NODE_2085_length_1572_cov_25.966735	405	477	140	2	72	0.0277778
NODE_2085_length_1572_cov_25.966735	405	477	146	2	72	0.0277778
NODE_2085_length_1572_cov_25.966735	405	477	148	1	72	0.0138889
NODE_2085_length_1572_cov_25.966735	405	477	149	1	72	0.0138889
NODE_2085_length_1572_cov_25.966735	405	477	155	1	72	0.0138889
NODE_2085_length_1572_cov_25.966735	405	477	157	2	72	0.0277778
NODE_2085_length_1572_cov_25.966735	405	477	159	2	72	0.0277778
NODE_2085_length_1572_cov_25.966735	405	477	161	3	72	0.0416667
NODE_2085_length_1572_cov_25.966735	405	477	162	4	72	0.0555556
NODE_2085_length_1572_cov_25.966735	405	477	164	2	72	0.0277778
NODE_2085_length_1572_cov_25.966735	405	477	166	2	72	0.0277778
NODE_2085_length_1572_cov_25.966735	405	477	167	2	72	0.0277778
NODE_2085_length_1572_cov_25.966735	405	477	168	4	72	0.0555556
NODE_2085_length_1572_cov_25.966735	405	477	169	3	72	0.0416667
NODE_2085_length_1572_cov_25.966735	405	477	170	4	72	0.0555556
NODE_2085_length_1572_cov_25.966735	405	477	171	4	72	0.0555556
NODE_2085_length_1572_cov_25.966735	405	477	172	1	72	0.0138889
NODE_2085_length_1572_cov_25.966735	405	477	175	2	72	0.0277778
NODE_2085_length_1572_cov_25.966735	405	477	176	1	72	0.0138889
NODE_2085_length_1572_cov_25.966735	405	477	179	4	72	0.0555556
NODE_2085_length_1572_cov_25.966735	405	477	182	1	72	0.0138889
NODE_2085_length_1572_cov_25.966735	405	477	184	1	72	0.0138889
NODE_2085_length_1572_cov_25.966735	405	477	186	1	72	0.0138889
NODE_2085_length_1572_cov_25.966735	405	477	204	1	72	0.0138889
NODE_2085_length_1572_cov_25.966735	405	477	216	1	72	0.0138889
NODE_2085_length_1572_cov_25.966735	405	477	217	1	72	0.0138889
NODE_2085_length_1572_cov_25.966735	405	477	219	1	72	0.0138889
NODE_2085_length_1572_cov_25.966735	405	477	223	1	72	0.0138889
NODE_2085_length_1572_cov_25.966735	405	477	228	2	72	0.0277778
NODE_2085_length_1572_cov_25.966735	405	477	229	3	72	0.0416667
NODE_2085_length_1572_cov_25.966735	405	477	230	2	72	0.0277778
NODE_2085_length_1572_cov_25.966735	405	477	231	3	72	0.0416667
NODE_2085_length_1572_cov_25.966735	405	477	237	1	72	0.0138889
NODE_2085_length_1572_cov_25.966735	405	477	241	1	72	0.0138889
NODE_2085_length_1572_cov_25.966735	405	477	245	1	72	0.0138889
NODE_2085_length_1572_cov_25.966735	405	477	249	1	72	0.0138889
NODE_2085_length_1572_cov_25.966735	405	477	259	1	72	0.0138889
NODE_2085_length_1572_cov_25.966735	405	477	260	1	72	0.0138889
NODE_2085_length_1572_cov_25.966735	405	477	263	1	72	0.0138889
NODE_2085_length_1572_cov_25.966735	1016	1096	0	80	80	1.0000000
NODE_2085_length_1572_cov_25.966735	1069	1149	0	80	80	1.0000000
NODE_2086_length_1572_cov_3.513238	1386	1462	0	13	76	0.1710526
NODE_2086_length_1572_cov_3.513238	1386	1462	2	22	76	0.2894737
NODE_2086_length_1572_cov_3.513238	1386	1462	4	18	76	0.2368421
NODE_2086_length_1572_cov_3.513238	1386	1462	6	23	76	0.3026316
NODE_2090_length_1570_cov_21.745071	700	780	0	6	80	0.0750000
NODE_2090_length_1570_cov_21.745071	700	780	2	3	80	0.0375000
NODE_2090_length_1570_cov_21.745071	700	780	12	71	80	0.8875000
NODE_2090_length_1570_cov_21.745071	753	833	2	17	80	0.2125000
NODE_2090_length_1570_cov_21.745071	753	833	12	53	80	0.6625000
NODE_2090_length_1570_cov_21.745071	753	833	14	10	80	0.1250000
NODE_2091_length_1570_cov_3.276003	387	467	0	80	80	1.0000000
NODE_2091_length_1570_cov_3.276003	440	520	0	80	80	1.0000000
NODE_2093_length_1569_cov_53.941497	741	821	0	80	80	1.0000000
NODE_2093_length_1569_cov_53.941497	794	874	0	57	80	0.7125000
NODE_2093_length_1569_cov_53.941497	794	874	4	23	80	0.2875000
NODE_2093_length_1569_cov_53.941497	870	950	3	28	80	0.3500000
NODE_2093_length_1569_cov_53.941497	870	950	4	52	80	0.6500000
NODE_2093_length_1569_cov_53.941497	923	1003	0	16	80	0.2000000
NODE_2093_length_1569_cov_53.941497	923	1003	3	64	80	0.8000000
NODE_2094_length_1569_cov_12.426531	640	720	0	80	80	1.0000000
NODE_2094_length_1569_cov_12.426531	693	773	0	80	80	1.0000000
NODE_2094_length_1569_cov_12.426531	769	849	0	80	80	1.0000000
NODE_2094_length_1569_cov_12.426531	822	902	0	80	80	1.0000000
NODE_2095_length_1569_cov_12.365986	450	530	2	61	80	0.7625000
NODE_2095_length_1569_cov_12.365986	450	530	4	17	80	0.2125000
NODE_2095_length_1569_cov_12.365986	450	530	6	2	80	0.0250000
NODE_2095_length_1569_cov_12.365986	450	530	2	61	80	0.7625000
NODE_2095_length_1569_cov_12.365986	450	530	4	17	80	0.2125000
NODE_2095_length_1569_cov_12.365986	450	530	6	2	80	0.0250000
NODE_2095_length_1569_cov_12.365986	503	564	2	8	61	0.1311475
NODE_2095_length_1569_cov_12.365986	503	564	4	50	61	0.8196721
NODE_2095_length_1569_cov_12.365986	503	564	6	3	61	0.0491803
NODE_2095_length_1569_cov_12.365986	503	556	2	8	53	0.1509434
NODE_2095_length_1569_cov_12.365986	503	556	4	43	53	0.8113208
NODE_2095_length_1569_cov_12.365986	503	556	6	2	53	0.0377358
NODE_2096_length_1569_cov_11.599320	798	878	0	18	80	0.2250000
NODE_2096_length_1569_cov_11.599320	798	878	2	16	80	0.2000000
NODE_2096_length_1569_cov_11.599320	798	878	4	46	80	0.5750000
NODE_2096_length_1569_cov_11.599320	851	931	0	30	80	0.3750000
NODE_2096_length_1569_cov_11.599320	851	931	4	50	80	0.6250000
NODE_2097_length_1569_cov_10.917687	521	601	0	80	80	1.0000000
NODE_2097_length_1569_cov_10.917687	574	654	0	80	80	1.0000000
NODE_2108_length_1563_cov_15.357240	590	670	0	80	80	1.0000000
NODE_2108_length_1563_cov_15.357240	643	723	0	80	80	1.0000000
NODE_2110_length_1561_cov_18.420657	354	434	0	80	80	1.0000000
NODE_2110_length_1561_cov_18.420657	407	487	0	80	80	1.0000000
NODE_2110_length_1561_cov_18.420657	483	563	0	80	80	1.0000000
NODE_2110_length_1561_cov_18.420657	536	616	0	80	80	1.0000000
NODE_2116_length_1559_cov_7.071233	347	427	0	66	80	0.8250000
NODE_2116_length_1559_cov_7.071233	347	427	2	14	80	0.1750000
NODE_2116_length_1559_cov_7.071233	400	478	0	13	78	0.1666667
NODE_2116_length_1559_cov_7.071233	400	478	2	65	78	0.8333333
NODE_2116_length_1559_cov_7.071233	1187	1238	9	9	51	0.1764706
NODE_2116_length_1559_cov_7.071233	1187	1238	10	42	51	0.8235294
NODE_2118_length_1558_cov_3.486635	338	418	0	80	80	1.0000000
NODE_2118_length_1558_cov_3.486635	391	471	0	80	80	1.0000000
NODE_2119_length_1557_cov_17.089163	542	622	0	80	80	1.0000000
NODE_2119_length_1557_cov_17.089163	595	675	0	80	80	1.0000000
NODE_2120_length_1557_cov_4.639918	0	56	0	56	56	1.0000000
NODE_2120_length_1557_cov_4.639918	49	112	0	63	63	1.0000000
NODE_2120_length_1557_cov_4.639918	85	161	0	76	76	1.0000000
NODE_2123_length_1556_cov_23.289636	456	536	4	80	80	1.0000000
NODE_2123_length_1556_cov_23.289636	509	589	0	19	80	0.2375000
NODE_2123_length_1556_cov_23.289636	509	589	1	5	80	0.0625000
NODE_2123_length_1556_cov_23.289636	509	589	2	27	80	0.3375000
NODE_2123_length_1556_cov_23.289636	509	589	4	29	80	0.3625000
NODE_2123_length_1556_cov_23.289636	681	761	0	80	80	1.0000000
NODE_2123_length_1556_cov_23.289636	734	814	0	80	80	1.0000000
NODE_2123_length_1556_cov_23.289636	1445	1525	87	3	80	0.0375000
NODE_2123_length_1556_cov_23.289636	1445	1525	88	1	80	0.0125000
NODE_2123_length_1556_cov_23.289636	1445	1525	100	2	80	0.0250000
NODE_2123_length_1556_cov_23.289636	1445	1525	102	1	80	0.0125000
NODE_2123_length_1556_cov_23.289636	1445	1525	104	1	80	0.0125000
NODE_2123_length_1556_cov_23.289636	1445	1525	106	11	80	0.1375000
NODE_2123_length_1556_cov_23.289636	1445	1525	107	1	80	0.0125000
NODE_2123_length_1556_cov_23.289636	1445	1525	108	60	80	0.7500000
NODE_2124_length_1556_cov_7.494166	300	380	0	77	80	0.9625000
NODE_2124_length_1556_cov_7.494166	300	380	2	3	80	0.0375000
NODE_2124_length_1556_cov_7.494166	353	433	0	24	80	0.3000000
NODE_2124_length_1556_cov_7.494166	353	433	2	56	80	0.7000000
NODE_2126_length_1555_cov_13.461538	666	746	0	80	80	1.0000000
NODE_2126_length_1555_cov_13.461538	719	799	0	80	80	1.0000000
NODE_2127_length_1554_cov_30.239175	144	226	0	15	82	0.1829268
NODE_2127_length_1554_cov_30.239175	144	226	2	67	82	0.8170732
NODE_2127_length_1554_cov_30.239175	199	279	0	15	80	0.1875000
NODE_2127_length_1554_cov_30.239175	199	279	2	17	80	0.2125000
NODE_2127_length_1554_cov_30.239175	199	279	4	1	80	0.0125000
NODE_2127_length_1554_cov_30.239175	199	279	6	4	80	0.0500000
NODE_2127_length_1554_cov_30.239175	199	279	8	3	80	0.0375000
NODE_2127_length_1554_cov_30.239175	199	279	10	2	80	0.0250000
NODE_2127_length_1554_cov_30.239175	199	279	12	3	80	0.0375000
NODE_2127_length_1554_cov_30.239175	199	279	14	4	80	0.0500000
NODE_2127_length_1554_cov_30.239175	199	279	16	3	80	0.0375000
NODE_2127_length_1554_cov_30.239175	199	279	18	9	80	0.1125000
NODE_2127_length_1554_cov_30.239175	199	279	20	2	80	0.0250000
NODE_2127_length_1554_cov_30.239175	199	279	21	3	80	0.0375000
NODE_2127_length_1554_cov_30.239175	199	279	23	1	80	0.0125000
NODE_2127_length_1554_cov_30.239175	199	279	25	3	80	0.0375000
NODE_2127_length_1554_cov_30.239175	199	279	27	10	80	0.1250000
NODE_2127_length_1554_cov_30.239175	877	903	0	26	26	1.0000000
NODE_2127_length_1554_cov_30.239175	930	1010	0	80	80	1.0000000
NODE_2127_length_1554_cov_30.239175	983	1063	0	80	80	1.0000000
NODE_2128_length_1554_cov_5.381443	1494	1554	4	2	60	0.0333333
NODE_2128_length_1554_cov_5.381443	1494	1554	6	2	60	0.0333333
NODE_2128_length_1554_cov_5.381443	1494	1554	14	1	60	0.0166667
NODE_2128_length_1554_cov_5.381443	1494	1554	15	1	60	0.0166667
NODE_2128_length_1554_cov_5.381443	1494	1554	21	1	60	0.0166667
NODE_2128_length_1554_cov_5.381443	1494	1554	27	1	60	0.0166667
NODE_2128_length_1554_cov_5.381443	1494	1554	29	2	60	0.0333333
NODE_2128_length_1554_cov_5.381443	1494	1554	33	2	60	0.0333333
NODE_2128_length_1554_cov_5.381443	1494	1554	35	1	60	0.0166667
NODE_2128_length_1554_cov_5.381443	1494	1554	37	5	60	0.0833333
NODE_2128_length_1554_cov_5.381443	1494	1554	41	14	60	0.2333333
NODE_2128_length_1554_cov_5.381443	1494	1554	42	28	60	0.4666667
NODE_2132_length_1552_cov_11.367515	379	445	0	21	66	0.3181818
NODE_2132_length_1552_cov_11.367515	379	445	2	45	66	0.6818182
NODE_2132_length_1552_cov_11.367515	418	484	0	34	66	0.5151515
NODE_2132_length_1552_cov_11.367515	418	484	2	32	66	0.4848485
NODE_2138_length_1549_cov_15.480000	1288	1368	0	80	80	1.0000000
NODE_2138_length_1549_cov_15.480000	1341	1421	0	80	80	1.0000000
NODE_2142_length_1548_cov_12.789510	770	850	0	2	80	0.0250000
NODE_2142_length_1548_cov_12.789510	770	850	2	78	80	0.9750000
NODE_2142_length_1548_cov_12.789510	823	903	0	55	80	0.6875000
NODE_2142_length_1548_cov_12.789510	823	903	2	25	80	0.3125000
NODE_2149_length_1546_cov_24.069800	775	855	16	16	80	0.2000000
NODE_2149_length_1546_cov_24.069800	775	855	21	12	80	0.1500000
NODE_2149_length_1546_cov_24.069800	775	855	22	19	80	0.2375000
NODE_2149_length_1546_cov_24.069800	775	855	26	33	80	0.4125000
NODE_2149_length_1546_cov_24.069800	828	908	0	17	80	0.2125000
NODE_2149_length_1546_cov_24.069800	828	908	10	2	80	0.0250000
NODE_2149_length_1546_cov_24.069800	828	908	11	10	80	0.1250000
NODE_2149_length_1546_cov_24.069800	828	908	19	1	80	0.0125000
NODE_2149_length_1546_cov_24.069800	828	908	20	23	80	0.2875000
NODE_2149_length_1546_cov_24.069800	828	908	21	12	80	0.1500000
NODE_2149_length_1546_cov_24.069800	828	908	22	15	80	0.1875000
NODE_2150_length_1546_cov_10.911541	417	497	0	80	80	1.0000000
NODE_2150_length_1546_cov_10.911541	470	550	0	80	80	1.0000000
NODE_2150_length_1546_cov_10.911541	1065	1145	1	71	80	0.8875000
NODE_2150_length_1546_cov_10.911541	1065	1145	2	9	80	0.1125000
NODE_2150_length_1546_cov_10.911541	1118	1198	1	34	80	0.4250000
NODE_2150_length_1546_cov_10.911541	1118	1198	2	46	80	0.5750000
NODE_2155_length_1543_cov_10.400970	480	560	0	17	80	0.2125000
NODE_2155_length_1543_cov_10.400970	480	560	2	63	80	0.7875000
NODE_2155_length_1543_cov_10.400970	533	613	0	16	80	0.2000000
NODE_2155_length_1543_cov_10.400970	533	613	2	64	80	0.8000000
NODE_2156_length_1543_cov_4.532548	43	98	0	55	55	1.0000000
NODE_2162_length_1541_cov_7.316921	523	603	0	30	80	0.3750000
NODE_2162_length_1541_cov_7.316921	523	603	2	50	80	0.6250000
NODE_2162_length_1541_cov_7.316921	576	658	2	82	82	1.0000000
NODE_2165_length_1539_cov_19.067361	334	414	0	80	80	1.0000000
NODE_2165_length_1539_cov_19.067361	387	467	0	80	80	1.0000000
NODE_2165_length_1539_cov_19.067361	463	543	0	80	80	1.0000000
NODE_2165_length_1539_cov_19.067361	516	596	0	80	80	1.0000000
NODE_2171_length_1538_cov_68.273801	604	684	0	80	80	1.0000000
NODE_2171_length_1538_cov_68.273801	657	737	0	80	80	1.0000000
NODE_2172_length_1538_cov_2.402363	1456	1499	0	43	43	1.0000000
NODE_2173_length_1537_cov_39.413074	782	862	0	80	80	1.0000000
NODE_2173_length_1537_cov_39.413074	835	915	0	51	80	0.6375000
NODE_2173_length_1537_cov_39.413074	835	915	8	29	80	0.3625000
NODE_2173_length_1537_cov_39.413074	911	991	8	74	80	0.9250000
NODE_2173_length_1537_cov_39.413074	911	991	9	1	80	0.0125000
NODE_2173_length_1537_cov_39.413074	911	991	21	5	80	0.0625000
NODE_2173_length_1537_cov_39.413074	964	1044	8	21	80	0.2625000
NODE_2173_length_1537_cov_39.413074	964	1044	9	1	80	0.0125000
NODE_2173_length_1537_cov_39.413074	964	1044	13	31	80	0.3875000
NODE_2173_length_1537_cov_39.413074	964	1044	21	27	80	0.3375000
NODE_2174_length_1537_cov_30.412378	739	819	0	80	80	1.0000000
NODE_2174_length_1537_cov_30.412378	792	872	0	80	80	1.0000000
NODE_2174_length_1537_cov_30.412378	868	948	0	80	80	1.0000000
NODE_2174_length_1537_cov_30.412378	921	1001	0	80	80	1.0000000
NODE_2175_length_1537_cov_18.707232	669	749	0	10	80	0.1250000
NODE_2175_length_1537_cov_18.707232	669	749	4	10	80	0.1250000
NODE_2175_length_1537_cov_18.707232	669	749	8	60	80	0.7500000
NODE_2175_length_1537_cov_18.707232	722	802	0	63	80	0.7875000
NODE_2175_length_1537_cov_18.707232	722	802	4	10	80	0.1250000
NODE_2175_length_1537_cov_18.707232	722	802	8	7	80	0.0875000
NODE_2176_length_1536_cov_24.991649	832	912	0	18	80	0.2250000
NODE_2176_length_1536_cov_24.991649	832	912	2	62	80	0.7750000
NODE_2176_length_1536_cov_24.991649	885	965	0	55	80	0.6875000
NODE_2176_length_1536_cov_24.991649	885	965	2	25	80	0.3125000
NODE_2176_length_1536_cov_24.991649	961	1041	0	80	80	1.0000000
NODE_2176_length_1536_cov_24.991649	1014	1094	0	80	80	1.0000000
NODE_2183_length_1535_cov_46.662256	992	1072	0	80	80	1.0000000
NODE_2183_length_1535_cov_46.662256	1045	1125	0	80	80	1.0000000
NODE_2183_length_1535_cov_46.662256	1127	1203	0	38	76	0.5000000
NODE_2183_length_1535_cov_46.662256	1127	1203	2	38	76	0.5000000
NODE_2183_length_1535_cov_46.662256	1176	1256	0	21	80	0.2625000
NODE_2183_length_1535_cov_46.662256	1176	1256	2	59	80	0.7375000
NODE_2184_length_1535_cov_32.610724	992	1072	0	23	80	0.2875000
NODE_2184_length_1535_cov_32.610724	992	1072	2	6	80	0.0750000
NODE_2184_length_1535_cov_32.610724	992	1072	4	51	80	0.6375000
NODE_2184_length_1535_cov_32.610724	1045	1125	4	80	80	1.0000000
NODE_2184_length_1535_cov_32.610724	1121	1201	2	35	80	0.4375000
NODE_2184_length_1535_cov_32.610724	1121	1201	4	45	80	0.5625000
NODE_2184_length_1535_cov_32.610724	1174	1254	2	42	80	0.5250000
NODE_2184_length_1535_cov_32.610724	1174	1254	4	10	80	0.1250000
NODE_2184_length_1535_cov_32.610724	1174	1254	6	28	80	0.3500000
NODE_2185_length_1535_cov_25.406685	619	699	1	22	80	0.2750000
NODE_2185_length_1535_cov_25.406685	619	699	3	18	80	0.2250000
NODE_2185_length_1535_cov_25.406685	619	699	7	10	80	0.1250000
NODE_2185_length_1535_cov_25.406685	619	699	9	23	80	0.2875000
NODE_2185_length_1535_cov_25.406685	619	699	10	3	80	0.0375000
NODE_2185_length_1535_cov_25.406685	619	699	12	4	80	0.0500000
NODE_2185_length_1535_cov_25.406685	672	752	7	4	80	0.0500000
NODE_2185_length_1535_cov_25.406685	672	752	9	21	80	0.2625000
NODE_2185_length_1535_cov_25.406685	672	752	10	6	80	0.0750000
NODE_2185_length_1535_cov_25.406685	672	752	11	12	80	0.1500000
NODE_2185_length_1535_cov_25.406685	672	752	12	37	80	0.4625000
NODE_2190_length_1534_cov_13.542857	439	519	0	80	80	1.0000000
NODE_2190_length_1534_cov_13.542857	492	567	0	75	75	1.0000000
NODE_2197_length_1531_cov_17.336592	324	404	6	13	80	0.1625000
NODE_2197_length_1531_cov_17.336592	324	404	9	1	80	0.0125000
NODE_2197_length_1531_cov_17.336592	324	404	10	50	80	0.6250000
NODE_2197_length_1531_cov_17.336592	324	404	14	6	80	0.0750000
NODE_2197_length_1531_cov_17.336592	324	404	16	10	80	0.1250000
NODE_2198_length_1531_cov_6.267458	606	686	1	80	80	1.0000000
NODE_2198_length_1531_cov_6.267458	659	739	1	38	80	0.4750000
NODE_2198_length_1531_cov_6.267458	659	739	3	34	80	0.4250000
NODE_2198_length_1531_cov_6.267458	659	739	4	8	80	0.1000000
NODE_2199_length_1530_cov_13.514326	323	403	0	80	80	1.0000000
NODE_2199_length_1530_cov_13.514326	376	456	0	80	80	1.0000000
NODE_2199_length_1530_cov_13.514326	1465	1513	0	48	48	1.0000000
NODE_2200_length_1530_cov_9.012579	637	717	0	67	80	0.8375000
NODE_2200_length_1530_cov_9.012579	637	717	10	13	80	0.1625000
NODE_2200_length_1530_cov_9.012579	690	770	0	14	80	0.1750000
NODE_2200_length_1530_cov_9.012579	690	770	10	66	80	0.8250000
NODE_2203_length_1529_cov_21.061538	983	1063	14	80	80	1.0000000
NODE_2203_length_1529_cov_21.061538	1036	1116	0	44	80	0.5500000
NODE_2203_length_1529_cov_21.061538	1036	1116	13	1	80	0.0125000
NODE_2203_length_1529_cov_21.061538	1036	1116	14	35	80	0.4375000
NODE_2205_length_1529_cov_1.380420	219	282	0	35	63	0.5555556
NODE_2205_length_1529_cov_1.380420	219	282	2	10	63	0.1587302
NODE_2205_length_1529_cov_1.380420	219	282	4	18	63	0.2857143
NODE_2205_length_1529_cov_1.380420	272	323	4	51	51	1.0000000
NODE_2206_length_1528_cov_8.578027	449	529	0	77	80	0.9625000
NODE_2206_length_1528_cov_8.578027	449	529	2	3	80	0.0375000
NODE_2206_length_1528_cov_8.578027	502	582	0	80	80	1.0000000
NODE_2210_length_1526_cov_92.265592	986	1066	0	26	80	0.3250000
NODE_2210_length_1526_cov_92.265592	986	1066	2	54	80	0.6750000
NODE_2210_length_1526_cov_92.265592	1039	1119	2	42	80	0.5250000
NODE_2210_length_1526_cov_92.265592	1039	1119	4	2	80	0.0250000
NODE_2210_length_1526_cov_92.265592	1039	1119	6	36	80	0.4500000
NODE_2211_length_1526_cov_4.051857	291	370	0	79	79	1.0000000
NODE_2213_length_1525_cov_20.232118	1014	1090	117	1	76	0.0131579
NODE_2213_length_1525_cov_20.232118	1014	1090	119	2	76	0.0263158
NODE_2213_length_1525_cov_20.232118	1014	1090	121	4	76	0.0526316
NODE_2213_length_1525_cov_20.232118	1014	1090	123	3	76	0.0394737
NODE_2213_length_1525_cov_20.232118	1014	1090	125	4	76	0.0526316
NODE_2213_length_1525_cov_20.232118	1014	1090	127	5	76	0.0657895
NODE_2213_length_1525_cov_20.232118	1014	1090	129	3	76	0.0394737
NODE_2213_length_1525_cov_20.232118	1014	1090	131	1	76	0.0131579
NODE_2213_length_1525_cov_20.232118	1014	1090	133	10	76	0.1315790
NODE_2213_length_1525_cov_20.232118	1014	1090	134	1	76	0.0131579
NODE_2213_length_1525_cov_20.232118	1014	1090	137	1	76	0.0131579
NODE_2213_length_1525_cov_20.232118	1014	1090	139	5	76	0.0657895
NODE_2213_length_1525_cov_20.232118	1014	1090	141	8	76	0.1052632
NODE_2213_length_1525_cov_20.232118	1014	1090	142	2	76	0.0263158
NODE_2213_length_1525_cov_20.232118	1014	1090	143	1	76	0.0131579
NODE_2213_length_1525_cov_20.232118	1014	1090	144	2	76	0.0263158
NODE_2213_length_1525_cov_20.232118	1014	1090	145	1	76	0.0131579
NODE_2213_length_1525_cov_20.232118	1014	1090	146	1	76	0.0131579
NODE_2213_length_1525_cov_20.232118	1014	1090	147	2	76	0.0263158
NODE_2213_length_1525_cov_20.232118	1014	1090	148	7	76	0.0921053
NODE_2213_length_1525_cov_20.232118	1014	1090	149	1	76	0.0131579
NODE_2213_length_1525_cov_20.232118	1014	1090	153	3	76	0.0394737
NODE_2213_length_1525_cov_20.232118	1014	1090	154	1	76	0.0131579
NODE_2213_length_1525_cov_20.232118	1014	1090	155	2	76	0.0263158
NODE_2213_length_1525_cov_20.232118	1014	1090	156	5	76	0.0657895
NODE_2213_length_1525_cov_20.232118	1281	1338	0	57	57	1.0000000
NODE_2214_length_1525_cov_11.421459	804	884	0	80	80	1.0000000
NODE_2214_length_1525_cov_11.421459	857	937	0	80	80	1.0000000
NODE_2217_length_1524_cov_130.874386	171	243	346	1	72	0.0138889
NODE_2217_length_1524_cov_130.874386	171	243	361	1	72	0.0138889
NODE_2217_length_1524_cov_130.874386	171	243	366	2	72	0.0277778
NODE_2217_length_1524_cov_130.874386	171	243	368	1	72	0.0138889
NODE_2217_length_1524_cov_130.874386	171	243	372	2	72	0.0277778
NODE_2217_length_1524_cov_130.874386	171	243	375	1	72	0.0138889
NODE_2217_length_1524_cov_130.874386	171	243	378	1	72	0.0138889
NODE_2217_length_1524_cov_130.874386	171	243	390	1	72	0.0138889
NODE_2217_length_1524_cov_130.874386	171	243	398	1	72	0.0138889
NODE_2217_length_1524_cov_130.874386	171	243	404	1	72	0.0138889
NODE_2217_length_1524_cov_130.874386	171	243	405	1	72	0.0138889
NODE_2217_length_1524_cov_130.874386	171	243	408	1	72	0.0138889
NODE_2217_length_1524_cov_130.874386	171	243	420	1	72	0.0138889
NODE_2217_length_1524_cov_130.874386	171	243	428	1	72	0.0138889
NODE_2217_length_1524_cov_130.874386	171	243	439	2	72	0.0277778
NODE_2217_length_1524_cov_130.874386	171	243	447	1	72	0.0138889
NODE_2217_length_1524_cov_130.874386	171	243	448	1	72	0.0138889
NODE_2217_length_1524_cov_130.874386	171	243	449	1	72	0.0138889
NODE_2217_length_1524_cov_130.874386	171	243	457	1	72	0.0138889
NODE_2217_length_1524_cov_130.874386	171	243	464	1	72	0.0138889
NODE_2217_length_1524_cov_130.874386	171	243	476	1	72	0.0138889
NODE_2217_length_1524_cov_130.874386	171	243	480	1	72	0.0138889
NODE_2217_length_1524_cov_130.874386	171	243	485	1	72	0.0138889
NODE_2217_length_1524_cov_130.874386	171	243	490	1	72	0.0138889
NODE_2217_length_1524_cov_130.874386	171	243	496	1	72	0.0138889
NODE_2217_length_1524_cov_130.874386	171	243	498	1	72	0.0138889
NODE_2217_length_1524_cov_130.874386	171	243	501	2	72	0.0277778
NODE_2217_length_1524_cov_130.874386	171	243	502	2	72	0.0277778
NODE_2217_length_1524_cov_130.874386	171	243	503	1	72	0.0138889
NODE_2217_length_1524_cov_130.874386	171	243	504	1	72	0.0138889
NODE_2217_length_1524_cov_130.874386	171	243	505	2	72	0.0277778
NODE_2217_length_1524_cov_130.874386	171	243	506	1	72	0.0138889
NODE_2217_length_1524_cov_130.874386	171	243	507	3	72	0.0416667
NODE_2217_length_1524_cov_130.874386	171	243	517	2	72	0.0277778
NODE_2217_length_1524_cov_130.874386	171	243	521	2	72	0.0277778
NODE_2217_length_1524_cov_130.874386	171	243	522	2	72	0.0277778
NODE_2217_length_1524_cov_130.874386	171	243	524	1	72	0.0138889
NODE_2217_length_1524_cov_130.874386	171	243	525	1	72	0.0138889
NODE_2217_length_1524_cov_130.874386	171	243	527	1	72	0.0138889
NODE_2217_length_1524_cov_130.874386	171	243	528	2	72	0.0277778
NODE_2217_length_1524_cov_130.874386	171	243	530	1	72	0.0138889
NODE_2217_length_1524_cov_130.874386	171	243	531	1	72	0.0138889
NODE_2217_length_1524_cov_130.874386	171	243	532	2	72	0.0277778
NODE_2217_length_1524_cov_130.874386	171	243	533	2	72	0.0277778
NODE_2217_length_1524_cov_130.874386	171	243	536	1	72	0.0138889
NODE_2217_length_1524_cov_130.874386	171	243	538	1	72	0.0138889
NODE_2217_length_1524_cov_130.874386	171	243	540	1	72	0.0138889
NODE_2217_length_1524_cov_130.874386	171	243	541	1	72	0.0138889
NODE_2217_length_1524_cov_130.874386	171	243	542	3	72	0.0416667
NODE_2217_length_1524_cov_130.874386	171	243	543	1	72	0.0138889
NODE_2217_length_1524_cov_130.874386	171	243	550	1	72	0.0138889
NODE_2217_length_1524_cov_130.874386	171	243	551	2	72	0.0277778
NODE_2217_length_1524_cov_130.874386	171	243	553	1	72	0.0138889
NODE_2217_length_1524_cov_130.874386	171	243	556	1	72	0.0138889
NODE_2217_length_1524_cov_130.874386	171	243	557	1	72	0.0138889
NODE_2217_length_1524_cov_130.874386	191	247	448	1	56	0.0178571
NODE_2217_length_1524_cov_130.874386	191	247	457	1	56	0.0178571
NODE_2217_length_1524_cov_130.874386	191	247	464	1	56	0.0178571
NODE_2217_length_1524_cov_130.874386	191	247	476	1	56	0.0178571
NODE_2217_length_1524_cov_130.874386	191	247	480	1	56	0.0178571
NODE_2217_length_1524_cov_130.874386	191	247	485	1	56	0.0178571
NODE_2217_length_1524_cov_130.874386	191	247	490	1	56	0.0178571
NODE_2217_length_1524_cov_130.874386	191	247	496	1	56	0.0178571
NODE_2217_length_1524_cov_130.874386	191	247	497	1	56	0.0178571
NODE_2217_length_1524_cov_130.874386	191	247	498	1	56	0.0178571
NODE_2217_length_1524_cov_130.874386	191	247	501	2	56	0.0357143
NODE_2217_length_1524_cov_130.874386	191	247	502	2	56	0.0357143
NODE_2217_length_1524_cov_130.874386	191	247	503	1	56	0.0178571
NODE_2217_length_1524_cov_130.874386	191	247	504	1	56	0.0178571
NODE_2217_length_1524_cov_130.874386	191	247	505	3	56	0.0535714
NODE_2217_length_1524_cov_130.874386	191	247	506	1	56	0.0178571
NODE_2217_length_1524_cov_130.874386	191	247	507	5	56	0.0892857
NODE_2217_length_1524_cov_130.874386	191	247	517	2	56	0.0357143
NODE_2217_length_1524_cov_130.874386	191	247	521	2	56	0.0357143
NODE_2217_length_1524_cov_130.874386	191	247	522	2	56	0.0357143
NODE_2217_length_1524_cov_130.874386	191	247	524	1	56	0.0178571
NODE_2217_length_1524_cov_130.874386	191	247	525	1	56	0.0178571
NODE_2217_length_1524_cov_130.874386	191	247	527	1	56	0.0178571
NODE_2217_length_1524_cov_130.874386	191	247	528	2	56	0.0357143
NODE_2217_length_1524_cov_130.874386	191	247	530	1	56	0.0178571
NODE_2217_length_1524_cov_130.874386	191	247	531	1	56	0.0178571
NODE_2217_length_1524_cov_130.874386	191	247	532	2	56	0.0357143
NODE_2217_length_1524_cov_130.874386	191	247	533	2	56	0.0357143
NODE_2217_length_1524_cov_130.874386	191	247	536	1	56	0.0178571
NODE_2217_length_1524_cov_130.874386	191	247	538	1	56	0.0178571
NODE_2217_length_1524_cov_130.874386	191	247	540	1	56	0.0178571
NODE_2217_length_1524_cov_130.874386	191	247	541	1	56	0.0178571
NODE_2217_length_1524_cov_130.874386	191	247	542	3	56	0.0535714
NODE_2217_length_1524_cov_130.874386	191	247	543	1	56	0.0178571
NODE_2217_length_1524_cov_130.874386	191	247	550	1	56	0.0178571
NODE_2217_length_1524_cov_130.874386	191	247	551	2	56	0.0357143
NODE_2217_length_1524_cov_130.874386	191	247	553	1	56	0.0178571
NODE_2217_length_1524_cov_130.874386	191	247	556	1	56	0.0178571
NODE_2217_length_1524_cov_130.874386	191	247	557	1	56	0.0178571
NODE_2217_length_1524_cov_130.874386	219	296	257	1	77	0.0129870
NODE_2217_length_1524_cov_130.874386	219	296	264	1	77	0.0129870
NODE_2217_length_1524_cov_130.874386	219	296	274	1	77	0.0129870
NODE_2217_length_1524_cov_130.874386	219	296	290	1	77	0.0129870
NODE_2217_length_1524_cov_130.874386	219	296	296	1	77	0.0129870
NODE_2217_length_1524_cov_130.874386	219	296	316	1	77	0.0129870
NODE_2217_length_1524_cov_130.874386	219	296	318	1	77	0.0129870
NODE_2217_length_1524_cov_130.874386	219	296	319	1	77	0.0129870
NODE_2217_length_1524_cov_130.874386	219	296	330	1	77	0.0129870
NODE_2217_length_1524_cov_130.874386	219	296	331	1	77	0.0129870
NODE_2217_length_1524_cov_130.874386	219	296	336	1	77	0.0129870
NODE_2217_length_1524_cov_130.874386	219	296	338	1	77	0.0129870
NODE_2217_length_1524_cov_130.874386	219	296	348	1	77	0.0129870
NODE_2217_length_1524_cov_130.874386	219	296	351	1	77	0.0129870
NODE_2217_length_1524_cov_130.874386	219	296	369	1	77	0.0129870
NODE_2217_length_1524_cov_130.874386	219	296	378	1	77	0.0129870
NODE_2217_length_1524_cov_130.874386	219	296	382	1	77	0.0129870
NODE_2217_length_1524_cov_130.874386	219	296	383	1	77	0.0129870
NODE_2217_length_1524_cov_130.874386	219	296	390	1	77	0.0129870
NODE_2217_length_1524_cov_130.874386	219	296	394	1	77	0.0129870
NODE_2217_length_1524_cov_130.874386	219	296	406	1	77	0.0129870
NODE_2217_length_1524_cov_130.874386	219	296	408	1	77	0.0129870
NODE_2217_length_1524_cov_130.874386	219	296	411	1	77	0.0129870
NODE_2217_length_1524_cov_130.874386	219	296	412	4	77	0.0519481
NODE_2217_length_1524_cov_130.874386	219	296	414	1	77	0.0129870
NODE_2217_length_1524_cov_130.874386	219	296	415	1	77	0.0129870
NODE_2217_length_1524_cov_130.874386	219	296	418	1	77	0.0129870
NODE_2217_length_1524_cov_130.874386	219	296	423	1	77	0.0129870
NODE_2217_length_1524_cov_130.874386	219	296	430	1	77	0.0129870
NODE_2217_length_1524_cov_130.874386	219	296	435	1	77	0.0129870
NODE_2217_length_1524_cov_130.874386	219	296	441	1	77	0.0129870
NODE_2217_length_1524_cov_130.874386	219	296	445	2	77	0.0259740
NODE_2217_length_1524_cov_130.874386	219	296	448	1	77	0.0129870
NODE_2217_length_1524_cov_130.874386	219	296	449	1	77	0.0129870
NODE_2217_length_1524_cov_130.874386	219	296	450	3	77	0.0389610
NODE_2217_length_1524_cov_130.874386	219	296	456	2	77	0.0259740
NODE_2217_length_1524_cov_130.874386	219	296	462	1	77	0.0129870
NODE_2217_length_1524_cov_130.874386	219	296	464	1	77	0.0129870
NODE_2217_length_1524_cov_130.874386	219	296	468	1	77	0.0129870
NODE_2217_length_1524_cov_130.874386	219	296	469	1	77	0.0129870
NODE_2217_length_1524_cov_130.874386	219	296	471	1	77	0.0129870
NODE_2217_length_1524_cov_130.874386	219	296	479	1	77	0.0129870
NODE_2217_length_1524_cov_130.874386	219	296	496	1	77	0.0129870
NODE_2217_length_1524_cov_130.874386	219	296	497	1	77	0.0129870
NODE_2217_length_1524_cov_130.874386	219	296	498	1	77	0.0129870
NODE_2217_length_1524_cov_130.874386	219	296	501	2	77	0.0259740
NODE_2217_length_1524_cov_130.874386	219	296	502	2	77	0.0259740
NODE_2217_length_1524_cov_130.874386	219	296	504	1	77	0.0129870
NODE_2217_length_1524_cov_130.874386	219	296	505	3	77	0.0389610
NODE_2217_length_1524_cov_130.874386	219	296	507	5	77	0.0649351
NODE_2217_length_1524_cov_130.874386	219	296	517	2	77	0.0259740
NODE_2217_length_1524_cov_130.874386	219	296	521	2	77	0.0259740
NODE_2217_length_1524_cov_130.874386	219	296	522	1	77	0.0129870
NODE_2217_length_1524_cov_130.874386	219	296	524	1	77	0.0129870
NODE_2217_length_1524_cov_130.874386	219	296	525	1	77	0.0129870
NODE_2217_length_1524_cov_130.874386	219	296	527	1	77	0.0129870
NODE_2217_length_1524_cov_130.874386	219	296	531	1	77	0.0129870
NODE_2217_length_1524_cov_130.874386	219	296	532	2	77	0.0259740
NODE_2217_length_1524_cov_130.874386	219	296	533	1	77	0.0129870
NODE_2217_length_1524_cov_130.874386	253	333	109	1	80	0.0125000
NODE_2217_length_1524_cov_130.874386	253	333	115	1	80	0.0125000
NODE_2217_length_1524_cov_130.874386	253	333	117	1	80	0.0125000
NODE_2217_length_1524_cov_130.874386	253	333	121	1	80	0.0125000
NODE_2217_length_1524_cov_130.874386	253	333	123	1	80	0.0125000
NODE_2217_length_1524_cov_130.874386	253	333	125	1	80	0.0125000
NODE_2217_length_1524_cov_130.874386	253	333	127	2	80	0.0250000
NODE_2217_length_1524_cov_130.874386	253	333	133	1	80	0.0125000
NODE_2217_length_1524_cov_130.874386	253	333	136	3	80	0.0375000
NODE_2217_length_1524_cov_130.874386	253	333	143	1	80	0.0125000
NODE_2217_length_1524_cov_130.874386	253	333	154	1	80	0.0125000
NODE_2217_length_1524_cov_130.874386	253	333	155	1	80	0.0125000
NODE_2217_length_1524_cov_130.874386	253	333	166	1	80	0.0125000
NODE_2217_length_1524_cov_130.874386	253	333	167	2	80	0.0250000
NODE_2217_length_1524_cov_130.874386	253	333	175	1	80	0.0125000
NODE_2217_length_1524_cov_130.874386	253	333	177	1	80	0.0125000
NODE_2217_length_1524_cov_130.874386	253	333	178	1	80	0.0125000
NODE_2217_length_1524_cov_130.874386	253	333	180	1	80	0.0125000
NODE_2217_length_1524_cov_130.874386	253	333	183	2	80	0.0250000
NODE_2217_length_1524_cov_130.874386	253	333	185	1	80	0.0125000
NODE_2217_length_1524_cov_130.874386	253	333	193	1	80	0.0125000
NODE_2217_length_1524_cov_130.874386	253	333	195	1	80	0.0125000
NODE_2217_length_1524_cov_130.874386	253	333	197	1	80	0.0125000
NODE_2217_length_1524_cov_130.874386	253	333	207	1	80	0.0125000
NODE_2217_length_1524_cov_130.874386	253	333	218	1	80	0.0125000
NODE_2217_length_1524_cov_130.874386	253	333	221	1	80	0.0125000
NODE_2217_length_1524_cov_130.874386	253	333	226	1	80	0.0125000
NODE_2217_length_1524_cov_130.874386	253	333	228	1	80	0.0125000
NODE_2217_length_1524_cov_130.874386	253	333	230	1	80	0.0125000
NODE_2217_length_1524_cov_130.874386	253	333	241	2	80	0.0250000
NODE_2217_length_1524_cov_130.874386	253	333	247	1	80	0.0125000
NODE_2217_length_1524_cov_130.874386	253	333	257	1	80	0.0125000
NODE_2217_length_1524_cov_130.874386	253	333	264	1	80	0.0125000
NODE_2217_length_1524_cov_130.874386	253	333	274	1	80	0.0125000
NODE_2217_length_1524_cov_130.874386	253	333	290	1	80	0.0125000
NODE_2217_length_1524_cov_130.874386	253	333	296	1	80	0.0125000
NODE_2217_length_1524_cov_130.874386	253	333	316	1	80	0.0125000
NODE_2217_length_1524_cov_130.874386	253	333	318	1	80	0.0125000
NODE_2217_length_1524_cov_130.874386	253	333	319	1	80	0.0125000
NODE_2217_length_1524_cov_130.874386	253	333	330	1	80	0.0125000
NODE_2217_length_1524_cov_130.874386	253	333	331	1	80	0.0125000
NODE_2217_length_1524_cov_130.874386	253	333	336	1	80	0.0125000
NODE_2217_length_1524_cov_130.874386	253	333	338	1	80	0.0125000
NODE_2217_length_1524_cov_130.874386	253	333	348	1	80	0.0125000
NODE_2217_length_1524_cov_130.874386	253	333	351	1	80	0.0125000
NODE_2217_length_1524_cov_130.874386	253	333	369	1	80	0.0125000
NODE_2217_length_1524_cov_130.874386	253	333	378	1	80	0.0125000
NODE_2217_length_1524_cov_130.874386	253	333	382	1	80	0.0125000
NODE_2217_length_1524_cov_130.874386	253	333	383	1	80	0.0125000
NODE_2217_length_1524_cov_130.874386	253	333	390	1	80	0.0125000
NODE_2217_length_1524_cov_130.874386	253	333	394	1	80	0.0125000
NODE_2217_length_1524_cov_130.874386	253	333	406	1	80	0.0125000
NODE_2217_length_1524_cov_130.874386	253	333	408	1	80	0.0125000
NODE_2217_length_1524_cov_130.874386	253	333	411	1	80	0.0125000
NODE_2217_length_1524_cov_130.874386	253	333	412	4	80	0.0500000
NODE_2217_length_1524_cov_130.874386	253	333	414	1	80	0.0125000
NODE_2217_length_1524_cov_130.874386	253	333	415	1	80	0.0125000
NODE_2217_length_1524_cov_130.874386	253	333	418	1	80	0.0125000
NODE_2217_length_1524_cov_130.874386	253	333	423	1	80	0.0125000
NODE_2217_length_1524_cov_130.874386	253	333	430	1	80	0.0125000
NODE_2217_length_1524_cov_130.874386	253	333	435	1	80	0.0125000
NODE_2217_length_1524_cov_130.874386	253	333	441	1	80	0.0125000
NODE_2217_length_1524_cov_130.874386	253	333	445	2	80	0.0250000
NODE_2217_length_1524_cov_130.874386	253	333	448	1	80	0.0125000
NODE_2217_length_1524_cov_130.874386	253	333	449	1	80	0.0125000
NODE_2217_length_1524_cov_130.874386	253	333	450	3	80	0.0375000
NODE_2217_length_1524_cov_130.874386	253	333	456	2	80	0.0250000
NODE_2217_length_1524_cov_130.874386	306	386	41	2	80	0.0250000
NODE_2217_length_1524_cov_130.874386	306	386	43	1	80	0.0125000
NODE_2217_length_1524_cov_130.874386	306	386	45	1	80	0.0125000
NODE_2217_length_1524_cov_130.874386	306	386	51	7	80	0.0875000
NODE_2217_length_1524_cov_130.874386	306	386	53	1	80	0.0125000
NODE_2217_length_1524_cov_130.874386	306	386	55	2	80	0.0250000
NODE_2217_length_1524_cov_130.874386	306	386	56	3	80	0.0375000
NODE_2217_length_1524_cov_130.874386	306	386	58	1	80	0.0125000
NODE_2217_length_1524_cov_130.874386	306	386	60	2	80	0.0250000
NODE_2217_length_1524_cov_130.874386	306	386	68	1	80	0.0125000
NODE_2217_length_1524_cov_130.874386	306	386	70	4	80	0.0500000
NODE_2217_length_1524_cov_130.874386	306	386	72	4	80	0.0500000
NODE_2217_length_1524_cov_130.874386	306	386	73	1	80	0.0125000
NODE_2217_length_1524_cov_130.874386	306	386	74	1	80	0.0125000
NODE_2217_length_1524_cov_130.874386	306	386	75	1	80	0.0125000
NODE_2217_length_1524_cov_130.874386	306	386	77	2	80	0.0250000
NODE_2217_length_1524_cov_130.874386	306	386	80	1	80	0.0125000
NODE_2217_length_1524_cov_130.874386	306	386	82	2	80	0.0250000
NODE_2217_length_1524_cov_130.874386	306	386	85	1	80	0.0125000
NODE_2217_length_1524_cov_130.874386	306	386	86	1	80	0.0125000
NODE_2217_length_1524_cov_130.874386	306	386	87	1	80	0.0125000
NODE_2217_length_1524_cov_130.874386	306	386	88	1	80	0.0125000
NODE_2217_length_1524_cov_130.874386	306	386	90	2	80	0.0250000
NODE_2217_length_1524_cov_130.874386	306	386	92	1	80	0.0125000
NODE_2217_length_1524_cov_130.874386	306	386	96	2	80	0.0250000
NODE_2217_length_1524_cov_130.874386	306	386	102	1	80	0.0125000
NODE_2217_length_1524_cov_130.874386	306	386	104	2	80	0.0250000
NODE_2217_length_1524_cov_130.874386	306	386	108	2	80	0.0250000
NODE_2217_length_1524_cov_130.874386	306	386	109	3	80	0.0375000
NODE_2217_length_1524_cov_130.874386	306	386	115	1	80	0.0125000
NODE_2217_length_1524_cov_130.874386	306	386	117	1	80	0.0125000
NODE_2217_length_1524_cov_130.874386	306	386	121	1	80	0.0125000
NODE_2217_length_1524_cov_130.874386	306	386	123	1	80	0.0125000
NODE_2217_length_1524_cov_130.874386	306	386	125	1	80	0.0125000
NODE_2217_length_1524_cov_130.874386	306	386	127	2	80	0.0250000
NODE_2217_length_1524_cov_130.874386	306	386	133	1	80	0.0125000
NODE_2217_length_1524_cov_130.874386	306	386	136	3	80	0.0375000
NODE_2217_length_1524_cov_130.874386	306	386	143	1	80	0.0125000
NODE_2217_length_1524_cov_130.874386	306	386	154	1	80	0.0125000
NODE_2217_length_1524_cov_130.874386	306	386	155	1	80	0.0125000
NODE_2217_length_1524_cov_130.874386	306	386	166	1	80	0.0125000
NODE_2217_length_1524_cov_130.874386	306	386	167	2	80	0.0250000
NODE_2217_length_1524_cov_130.874386	306	386	175	1	80	0.0125000
NODE_2217_length_1524_cov_130.874386	306	386	177	1	80	0.0125000
NODE_2217_length_1524_cov_130.874386	306	386	178	1	80	0.0125000
NODE_2217_length_1524_cov_130.874386	306	386	180	1	80	0.0125000
NODE_2217_length_1524_cov_130.874386	306	386	183	2	80	0.0250000
NODE_2217_length_1524_cov_130.874386	306	386	185	1	80	0.0125000
NODE_2217_length_1524_cov_130.874386	306	386	193	1	80	0.0125000
NODE_2217_length_1524_cov_130.874386	306	386	195	1	80	0.0125000
NODE_2219_length_1523_cov_24.115169	366	446	0	46	80	0.5750000
NODE_2219_length_1523_cov_24.115169	366	446	4	34	80	0.4250000
NODE_2219_length_1523_cov_24.115169	419	499	0	80	80	1.0000000
NODE_2219_length_1523_cov_24.115169	495	575	0	80	80	1.0000000
NODE_2219_length_1523_cov_24.115169	548	628	0	80	80	1.0000000
NODE_2223_length_1522_cov_13.278988	361	441	0	80	80	1.0000000
NODE_2223_length_1522_cov_13.278988	414	494	0	32	80	0.4000000
NODE_2223_length_1522_cov_13.278988	414	494	2	48	80	0.6000000
NODE_2225_length_1521_cov_20.965541	772	852	0	66	80	0.8250000
NODE_2225_length_1521_cov_20.965541	772	852	2	14	80	0.1750000
NODE_2225_length_1521_cov_20.965541	825	905	0	13	80	0.1625000
NODE_2225_length_1521_cov_20.965541	825	905	2	67	80	0.8375000
NODE_2226_length_1521_cov_15.381153	907	987	0	6	80	0.0750000
NODE_2226_length_1521_cov_15.381153	907	987	2	58	80	0.7250000
NODE_2226_length_1521_cov_15.381153	907	987	4	16	80	0.2000000
NODE_2226_length_1521_cov_15.381153	960	1040	0	59	80	0.7375000
NODE_2226_length_1521_cov_15.381153	960	1040	2	21	80	0.2625000
NODE_2226_length_1521_cov_15.381153	988	1040	0	52	52	1.0000000
NODE_2227_length_1521_cov_7.682138	525	605	0	57	80	0.7125000
NODE_2227_length_1521_cov_7.682138	525	605	2	23	80	0.2875000
NODE_2227_length_1521_cov_7.682138	578	658	0	80	80	1.0000000
NODE_2236_length_1519_cov_20.792958	714	794	1	39	80	0.4875000
NODE_2236_length_1519_cov_20.792958	714	794	2	41	80	0.5125000
NODE_2236_length_1519_cov_20.792958	767	847	0	51	80	0.6375000
NODE_2236_length_1519_cov_20.792958	767	847	1	29	80	0.3625000
NODE_2239_length_1517_cov_24.074048	413	450	0	37	37	1.0000000
NODE_2239_length_1517_cov_24.074048	842	922	0	80	80	1.0000000
NODE_2239_length_1517_cov_24.074048	895	975	0	80	80	1.0000000
NODE_2240_length_1517_cov_22.897743	383	463	0	53	80	0.6625000
NODE_2240_length_1517_cov_22.897743	383	463	8	27	80	0.3375000
NODE_2240_length_1517_cov_22.897743	436	516	8	80	80	1.0000000
NODE_2241_length_1517_cov_11.781382	381	461	0	19	80	0.2375000
NODE_2241_length_1517_cov_11.781382	381	461	2	3	80	0.0375000
NODE_2241_length_1517_cov_11.781382	381	461	6	1	80	0.0125000
NODE_2241_length_1517_cov_11.781382	381	461	8	19	80	0.2375000
NODE_2241_length_1517_cov_11.781382	381	461	10	38	80	0.4750000
NODE_2241_length_1517_cov_11.781382	434	514	0	11	80	0.1375000
NODE_2241_length_1517_cov_11.781382	434	514	2	12	80	0.1500000
NODE_2241_length_1517_cov_11.781382	434	514	6	3	80	0.0375000
NODE_2241_length_1517_cov_11.781382	434	514	8	22	80	0.2750000
NODE_2241_length_1517_cov_11.781382	434	514	10	32	80	0.4000000
NODE_2243_length_1517_cov_4.944993	393	473	8	48	80	0.6000000
NODE_2243_length_1517_cov_4.944993	393	473	10	32	80	0.4000000
NODE_2243_length_1517_cov_4.944993	446	526	2	1	80	0.0125000
NODE_2243_length_1517_cov_4.944993	446	526	3	6	80	0.0750000
NODE_2243_length_1517_cov_4.944993	446	526	5	6	80	0.0750000
NODE_2243_length_1517_cov_4.944993	446	526	8	41	80	0.5125000
NODE_2243_length_1517_cov_4.944993	446	526	10	26	80	0.3250000
NODE_2247_length_1516_cov_11.177135	230	310	0	80	80	1.0000000
NODE_2247_length_1516_cov_11.177135	283	363	0	80	80	1.0000000
NODE_2248_length_1516_cov_8.608327	580	660	0	41	80	0.5125000
NODE_2248_length_1516_cov_8.608327	580	660	2	39	80	0.4875000
NODE_2248_length_1516_cov_8.608327	633	713	0	80	80	1.0000000
NODE_2250_length_1515_cov_16.990819	333	413	6	11	80	0.1375000
NODE_2250_length_1515_cov_16.990819	333	413	10	14	80	0.1750000
NODE_2250_length_1515_cov_16.990819	333	413	12	8	80	0.1000000
NODE_2250_length_1515_cov_16.990819	333	413	13	1	80	0.0125000
NODE_2250_length_1515_cov_16.990819	333	413	14	2	80	0.0250000
NODE_2250_length_1515_cov_16.990819	333	413	17	1	80	0.0125000
NODE_2250_length_1515_cov_16.990819	333	413	18	8	80	0.1000000
NODE_2250_length_1515_cov_16.990819	333	413	20	2	80	0.0250000
NODE_2250_length_1515_cov_16.990819	333	413	21	2	80	0.0250000
NODE_2250_length_1515_cov_16.990819	333	413	22	2	80	0.0250000
NODE_2250_length_1515_cov_16.990819	333	413	24	1	80	0.0125000
NODE_2250_length_1515_cov_16.990819	333	413	25	1	80	0.0125000
NODE_2250_length_1515_cov_16.990819	333	413	27	3	80	0.0375000
NODE_2250_length_1515_cov_16.990819	333	413	31	1	80	0.0125000
NODE_2250_length_1515_cov_16.990819	333	413	32	3	80	0.0375000
NODE_2250_length_1515_cov_16.990819	333	413	33	2	80	0.0250000
NODE_2250_length_1515_cov_16.990819	333	413	35	2	80	0.0250000
NODE_2250_length_1515_cov_16.990819	333	413	37	5	80	0.0625000
NODE_2250_length_1515_cov_16.990819	333	413	39	3	80	0.0375000
NODE_2250_length_1515_cov_16.990819	333	413	40	2	80	0.0250000
NODE_2250_length_1515_cov_16.990819	333	413	47	2	80	0.0250000
NODE_2250_length_1515_cov_16.990819	333	413	49	1	80	0.0125000
NODE_2250_length_1515_cov_16.990819	333	413	51	2	80	0.0250000
NODE_2250_length_1515_cov_16.990819	333	413	55	1	80	0.0125000
NODE_2250_length_1515_cov_16.990819	386	448	4	16	62	0.2580645
NODE_2250_length_1515_cov_16.990819	386	448	6	30	62	0.4838710
NODE_2250_length_1515_cov_16.990819	386	448	10	14	62	0.2258064
NODE_2250_length_1515_cov_16.990819	386	448	13	1	62	0.0161290
NODE_2250_length_1515_cov_16.990819	386	448	14	1	62	0.0161290
NODE_2258_length_1512_cov_5.111819	506	560	0	54	54	1.0000000
NODE_2258_length_1512_cov_5.111819	677	698	2	21	21	1.0000000
NODE_2258_length_1512_cov_5.111819	677	698	2	21	21	1.0000000
NODE_2258_length_1512_cov_5.111819	1057	1137	0	80	80	1.0000000
NODE_2258_length_1512_cov_5.111819	1110	1190	0	80	80	1.0000000
NODE_2258_length_1512_cov_5.111819	1144	1190	0	46	46	1.0000000
NODE_2259_length_1512_cov_4.251946	132	204	0	72	72	1.0000000
NODE_2262_length_1511_cov_30.963173	787	867	0	80	80	1.0000000
NODE_2262_length_1511_cov_30.963173	840	920	0	80	80	1.0000000
NODE_2262_length_1511_cov_30.963173	916	996	0	14	80	0.1750000
NODE_2262_length_1511_cov_30.963173	916	996	2	66	80	0.8250000
NODE_2262_length_1511_cov_30.963173	969	1059	0	16	90	0.1777778
NODE_2262_length_1511_cov_30.963173	969	1059	2	74	90	0.8222222
NODE_2265_length_1510_cov_24.184975	434	514	4	31	80	0.3875000
NODE_2265_length_1510_cov_24.184975	434	514	6	48	80	0.6000000
NODE_2265_length_1510_cov_24.184975	434	514	10	1	80	0.0125000
NODE_2265_length_1510_cov_24.184975	487	567	4	13	80	0.1625000
NODE_2265_length_1510_cov_24.184975	487	567	6	66	80	0.8250000
NODE_2265_length_1510_cov_24.184975	487	567	10	1	80	0.0125000
NODE_2265_length_1510_cov_24.184975	563	643	4	37	80	0.4625000
NODE_2265_length_1510_cov_24.184975	563	643	6	28	80	0.3500000
NODE_2265_length_1510_cov_24.184975	563	643	8	15	80	0.1875000
NODE_2265_length_1510_cov_24.184975	616	696	0	9	80	0.1125000
NODE_2265_length_1510_cov_24.184975	616	696	2	22	80	0.2750000
NODE_2265_length_1510_cov_24.184975	616	696	4	49	80	0.6125000
NODE_2269_length_1509_cov_51.836170	655	735	0	80	80	1.0000000
NODE_2269_length_1509_cov_51.836170	708	788	0	80	80	1.0000000
NODE_2269_length_1509_cov_51.836170	784	864	0	80	80	1.0000000
NODE_2269_length_1509_cov_51.836170	837	917	0	80	80	1.0000000
NODE_2270_length_1509_cov_16.010638	497	577	0	80	80	1.0000000
NODE_2270_length_1509_cov_16.010638	550	630	0	80	80	1.0000000
NODE_2270_length_1509_cov_16.010638	626	706	0	80	80	1.0000000
NODE_2270_length_1509_cov_16.010638	679	759	0	80	80	1.0000000
NODE_2271_length_1509_cov_8.883688	252	332	0	80	80	1.0000000
NODE_2271_length_1509_cov_8.883688	305	385	0	56	80	0.7000000
NODE_2271_length_1509_cov_8.883688	305	385	2	24	80	0.3000000
NODE_2271_length_1509_cov_8.883688	327	385	0	34	58	0.5862069
NODE_2271_length_1509_cov_8.883688	327	385	2	24	58	0.4137931
NODE_2271_length_1509_cov_8.883688	381	461	2	74	80	0.9250000
NODE_2271_length_1509_cov_8.883688	381	461	4	6	80	0.0750000
NODE_2271_length_1509_cov_8.883688	434	514	2	67	80	0.8375000
NODE_2271_length_1509_cov_8.883688	434	514	4	13	80	0.1625000
NODE_2272_length_1509_cov_5.826950	1029	1109	0	80	80	1.0000000
NODE_2272_length_1509_cov_5.826950	1082	1162	0	80	80	1.0000000
NODE_2277_length_1508_cov_24.176011	765	845	0	80	80	1.0000000
NODE_2277_length_1508_cov_24.176011	818	898	0	80	80	1.0000000
NODE_2290_length_1504_cov_17.449822	596	676	2	47	80	0.5875000
NODE_2290_length_1504_cov_17.449822	596	676	4	33	80	0.4125000
NODE_2290_length_1504_cov_17.449822	649	729	0	24	80	0.3000000
NODE_2290_length_1504_cov_17.449822	649	729	2	45	80	0.5625000
NODE_2290_length_1504_cov_17.449822	649	729	4	11	80	0.1375000
NODE_2293_length_1502_cov_42.989309	559	639	0	80	80	1.0000000
NODE_2293_length_1502_cov_42.989309	612	692	0	80	80	1.0000000
NODE_2294_length_1501_cov_22.828816	421	500	0	54	79	0.6835443
NODE_2294_length_1501_cov_22.828816	421	500	1	25	79	0.3164557
NODE_2294_length_1501_cov_22.828816	473	553	0	28	80	0.3500000
NODE_2294_length_1501_cov_22.828816	473	553	1	52	80	0.6500000
NODE_2294_length_1501_cov_22.828816	549	629	1	80	80	1.0000000
NODE_2294_length_1501_cov_22.828816	602	682	0	31	80	0.3875000
NODE_2294_length_1501_cov_22.828816	602	682	1	49	80	0.6125000
NODE_2295_length_1501_cov_14.422254	973	1053	0	80	80	1.0000000
NODE_2295_length_1501_cov_14.422254	1026	1106	0	80	80	1.0000000
NODE_2296_length_1501_cov_14.060628	225	305	0	80	80	1.0000000
NODE_2296_length_1501_cov_14.060628	278	358	0	80	80	1.0000000
NODE_2296_length_1501_cov_14.060628	986	1066	0	80	80	1.0000000
NODE_2296_length_1501_cov_14.060628	1039	1119	0	80	80	1.0000000
NODE_2300_length_1500_cov_40.056388	619	699	0	80	80	1.0000000
NODE_2300_length_1500_cov_40.056388	672	752	0	80	80	1.0000000
NODE_2305_length_1497_cov_38.344063	1401	1481	38	1	80	0.0125000
NODE_2305_length_1497_cov_38.344063	1401	1481	42	1	80	0.0125000
NODE_2305_length_1497_cov_38.344063	1401	1481	44	1	80	0.0125000
NODE_2305_length_1497_cov_38.344063	1401	1481	50	1	80	0.0125000
NODE_2305_length_1497_cov_38.344063	1401	1481	54	1	80	0.0125000
NODE_2305_length_1497_cov_38.344063	1401	1481	60	1	80	0.0125000
NODE_2305_length_1497_cov_38.344063	1401	1481	64	2	80	0.0250000
NODE_2305_length_1497_cov_38.344063	1401	1481	68	2	80	0.0250000
NODE_2305_length_1497_cov_38.344063	1401	1481	70	1	80	0.0125000
NODE_2305_length_1497_cov_38.344063	1401	1481	76	1	80	0.0125000
NODE_2305_length_1497_cov_38.344063	1401	1481	84	1	80	0.0125000
NODE_2305_length_1497_cov_38.344063	1401	1481	87	2	80	0.0250000
NODE_2305_length_1497_cov_38.344063	1401	1481	91	2	80	0.0250000
NODE_2305_length_1497_cov_38.344063	1401	1481	96	1	80	0.0125000
NODE_2305_length_1497_cov_38.344063	1401	1481	98	1	80	0.0125000
NODE_2305_length_1497_cov_38.344063	1401	1481	102	8	80	0.1000000
NODE_2305_length_1497_cov_38.344063	1401	1481	104	1	80	0.0125000
NODE_2305_length_1497_cov_38.344063	1401	1481	105	2	80	0.0250000
NODE_2305_length_1497_cov_38.344063	1401	1481	107	4	80	0.0500000
NODE_2305_length_1497_cov_38.344063	1401	1481	109	2	80	0.0250000
NODE_2305_length_1497_cov_38.344063	1401	1481	110	4	80	0.0500000
NODE_2305_length_1497_cov_38.344063	1401	1481	112	11	80	0.1375000
NODE_2305_length_1497_cov_38.344063	1401	1481	114	6	80	0.0750000
NODE_2305_length_1497_cov_38.344063	1401	1481	115	2	80	0.0250000
NODE_2305_length_1497_cov_38.344063	1401	1481	118	1	80	0.0125000
NODE_2305_length_1497_cov_38.344063	1401	1481	122	1	80	0.0125000
NODE_2305_length_1497_cov_38.344063	1401	1481	126	3	80	0.0375000
NODE_2305_length_1497_cov_38.344063	1401	1481	128	1	80	0.0125000
NODE_2305_length_1497_cov_38.344063	1401	1481	130	2	80	0.0250000
NODE_2305_length_1497_cov_38.344063	1401	1481	132	1	80	0.0125000
NODE_2305_length_1497_cov_38.344063	1401	1481	134	1	80	0.0125000
NODE_2305_length_1497_cov_38.344063	1401	1481	136	1	80	0.0125000
NODE_2305_length_1497_cov_38.344063	1401	1481	138	2	80	0.0250000
NODE_2305_length_1497_cov_38.344063	1401	1481	143	1	80	0.0125000
NODE_2305_length_1497_cov_38.344063	1401	1481	145	2	80	0.0250000
NODE_2305_length_1497_cov_38.344063	1401	1481	147	1	80	0.0125000
NODE_2305_length_1497_cov_38.344063	1401	1481	149	2	80	0.0250000
NODE_2305_length_1497_cov_38.344063	1401	1481	151	1	80	0.0125000
NODE_2305_length_1497_cov_38.344063	1401	1481	153	1	80	0.0125000
NODE_2308_length_1496_cov_3.936292	0	44	0	44	44	1.0000000
NODE_2308_length_1496_cov_3.936292	17	97	0	80	80	1.0000000
NODE_2311_length_1496_cov_1.103794	405	428	3	20	23	0.8695652
NODE_2311_length_1496_cov_1.103794	405	428	4	3	23	0.1304348
NODE_2313_length_1494_cov_65.437276	460	540	0	16	80	0.2000000
NODE_2313_length_1494_cov_65.437276	460	540	6	64	80	0.8000000
NODE_2313_length_1494_cov_65.437276	513	594	0	70	81	0.8641976
NODE_2313_length_1494_cov_65.437276	513	594	6	11	81	0.1358025
NODE_2313_length_1494_cov_65.437276	787	854	6	18	67	0.2686567
NODE_2313_length_1494_cov_65.437276	787	854	12	13	67	0.1940299
NODE_2313_length_1494_cov_65.437276	787	854	14	36	67	0.5373135
NODE_2313_length_1494_cov_65.437276	827	907	6	4	80	0.0500000
NODE_2313_length_1494_cov_65.437276	827	907	8	43	80	0.5375000
NODE_2313_length_1494_cov_65.437276	827	907	14	33	80	0.4125000
NODE_2316_length_1493_cov_100.467719	947	1028	106	1	81	0.0123457
NODE_2316_length_1493_cov_100.467719	947	1028	109	3	81	0.0370370
NODE_2316_length_1493_cov_100.467719	947	1028	111	2	81	0.0246914
NODE_2316_length_1493_cov_100.467719	947	1028	112	1	81	0.0123457
NODE_2316_length_1493_cov_100.467719	947	1028	113	1	81	0.0123457
NODE_2316_length_1493_cov_100.467719	947	1028	121	1	81	0.0123457
NODE_2316_length_1493_cov_100.467719	947	1028	130	1	81	0.0123457
NODE_2316_length_1493_cov_100.467719	947	1028	132	1	81	0.0123457
NODE_2316_length_1493_cov_100.467719	947	1028	133	1	81	0.0123457
NODE_2316_length_1493_cov_100.467719	947	1028	134	1	81	0.0123457
NODE_2316_length_1493_cov_100.467719	947	1028	135	1	81	0.0123457
NODE_2316_length_1493_cov_100.467719	947	1028	145	1	81	0.0123457
NODE_2316_length_1493_cov_100.467719	947	1028	151	1	81	0.0123457
NODE_2316_length_1493_cov_100.467719	947	1028	158	1	81	0.0123457
NODE_2316_length_1493_cov_100.467719	947	1028	159	1	81	0.0123457
NODE_2316_length_1493_cov_100.467719	947	1028	161	2	81	0.0246914
NODE_2316_length_1493_cov_100.467719	947	1028	164	1	81	0.0123457
NODE_2316_length_1493_cov_100.467719	947	1028	169	1	81	0.0123457
NODE_2316_length_1493_cov_100.467719	947	1028	177	3	81	0.0370370
NODE_2316_length_1493_cov_100.467719	947	1028	181	3	81	0.0370370
NODE_2316_length_1493_cov_100.467719	947	1028	184	1	81	0.0123457
NODE_2316_length_1493_cov_100.467719	947	1028	185	1	81	0.0123457
NODE_2316_length_1493_cov_100.467719	947	1028	186	1	81	0.0123457
NODE_2316_length_1493_cov_100.467719	947	1028	191	1	81	0.0123457
NODE_2316_length_1493_cov_100.467719	947	1028	201	1	81	0.0123457
NODE_2316_length_1493_cov_100.467719	947	1028	211	1	81	0.0123457
NODE_2316_length_1493_cov_100.467719	947	1028	218	1	81	0.0123457
NODE_2316_length_1493_cov_100.467719	947	1028	219	2	81	0.0246914
NODE_2316_length_1493_cov_100.467719	947	1028	221	4	81	0.0493827
NODE_2316_length_1493_cov_100.467719	947	1028	227	2	81	0.0246914
NODE_2316_length_1493_cov_100.467719	947	1028	231	1	81	0.0123457
NODE_2316_length_1493_cov_100.467719	947	1028	234	3	81	0.0370370
NODE_2316_length_1493_cov_100.467719	947	1028	236	1	81	0.0123457
NODE_2316_length_1493_cov_100.467719	947	1028	237	1	81	0.0123457
NODE_2316_length_1493_cov_100.467719	947	1028	244	1	81	0.0123457
NODE_2316_length_1493_cov_100.467719	947	1028	246	1	81	0.0123457
NODE_2316_length_1493_cov_100.467719	947	1028	248	1	81	0.0123457
NODE_2316_length_1493_cov_100.467719	947	1028	252	1	81	0.0123457
NODE_2316_length_1493_cov_100.467719	947	1028	265	1	81	0.0123457
NODE_2316_length_1493_cov_100.467719	947	1028	267	1	81	0.0123457
NODE_2316_length_1493_cov_100.467719	947	1028	271	1	81	0.0123457
NODE_2316_length_1493_cov_100.467719	947	1028	279	1	81	0.0123457
NODE_2316_length_1493_cov_100.467719	947	1028	282	1	81	0.0123457
NODE_2316_length_1493_cov_100.467719	947	1028	286	1	81	0.0123457
NODE_2316_length_1493_cov_100.467719	947	1028	287	1	81	0.0123457
NODE_2316_length_1493_cov_100.467719	947	1028	290	2	81	0.0246914
NODE_2316_length_1493_cov_100.467719	947	1028	291	1	81	0.0123457
NODE_2316_length_1493_cov_100.467719	947	1028	293	2	81	0.0246914
NODE_2316_length_1493_cov_100.467719	947	1028	303	1	81	0.0123457
NODE_2316_length_1493_cov_100.467719	947	1028	307	2	81	0.0246914
NODE_2316_length_1493_cov_100.467719	947	1028	316	1	81	0.0123457
NODE_2316_length_1493_cov_100.467719	947	1028	323	1	81	0.0123457
NODE_2316_length_1493_cov_100.467719	947	1028	324	1	81	0.0123457
NODE_2316_length_1493_cov_100.467719	947	1028	326	1	81	0.0123457
NODE_2316_length_1493_cov_100.467719	947	1028	330	2	81	0.0246914
NODE_2316_length_1493_cov_100.467719	947	1028	332	1	81	0.0123457
NODE_2316_length_1493_cov_100.467719	947	1028	334	1	81	0.0123457
NODE_2316_length_1493_cov_100.467719	947	1028	336	1	81	0.0123457
NODE_2316_length_1493_cov_100.467719	947	1028	356	1	81	0.0123457
NODE_2316_length_1493_cov_100.467719	947	1028	357	2	81	0.0246914
NODE_2316_length_1493_cov_100.467719	947	1028	360	1	81	0.0123457
NODE_2316_length_1493_cov_100.467719	1001	1071	267	1	70	0.0142857
NODE_2316_length_1493_cov_100.467719	1001	1071	271	1	70	0.0142857
NODE_2316_length_1493_cov_100.467719	1001	1071	279	1	70	0.0142857
NODE_2316_length_1493_cov_100.467719	1001	1071	282	1	70	0.0142857
NODE_2316_length_1493_cov_100.467719	1001	1071	286	1	70	0.0142857
NODE_2316_length_1493_cov_100.467719	1001	1071	287	1	70	0.0142857
NODE_2316_length_1493_cov_100.467719	1001	1071	290	2	70	0.0285714
NODE_2316_length_1493_cov_100.467719	1001	1071	291	1	70	0.0142857
NODE_2316_length_1493_cov_100.467719	1001	1071	293	2	70	0.0285714
NODE_2316_length_1493_cov_100.467719	1001	1071	303	1	70	0.0142857
NODE_2316_length_1493_cov_100.467719	1001	1071	307	2	70	0.0285714
NODE_2316_length_1493_cov_100.467719	1001	1071	316	1	70	0.0142857
NODE_2316_length_1493_cov_100.467719	1001	1071	323	1	70	0.0142857
NODE_2316_length_1493_cov_100.467719	1001	1071	324	1	70	0.0142857
NODE_2316_length_1493_cov_100.467719	1001	1071	326	1	70	0.0142857
NODE_2316_length_1493_cov_100.467719	1001	1071	330	2	70	0.0285714
NODE_2316_length_1493_cov_100.467719	1001	1071	332	1	70	0.0142857
NODE_2316_length_1493_cov_100.467719	1001	1071	334	1	70	0.0142857
NODE_2316_length_1493_cov_100.467719	1001	1071	336	1	70	0.0142857
NODE_2316_length_1493_cov_100.467719	1001	1071	356	1	70	0.0142857
NODE_2316_length_1493_cov_100.467719	1001	1071	357	2	70	0.0285714
NODE_2316_length_1493_cov_100.467719	1001	1071	360	1	70	0.0142857
NODE_2316_length_1493_cov_100.467719	1001	1071	377	1	70	0.0142857
NODE_2316_length_1493_cov_100.467719	1001	1071	389	1	70	0.0142857
NODE_2316_length_1493_cov_100.467719	1001	1071	393	3	70	0.0428571
NODE_2316_length_1493_cov_100.467719	1001	1071	397	1	70	0.0142857
NODE_2316_length_1493_cov_100.467719	1001	1071	402	1	70	0.0142857
NODE_2316_length_1493_cov_100.467719	1001	1071	409	1	70	0.0142857
NODE_2316_length_1493_cov_100.467719	1001	1071	411	1	70	0.0142857
NODE_2316_length_1493_cov_100.467719	1001	1071	415	1	70	0.0142857
NODE_2316_length_1493_cov_100.467719	1001	1071	419	1	70	0.0142857
NODE_2316_length_1493_cov_100.467719	1001	1071	420	1	70	0.0142857
NODE_2316_length_1493_cov_100.467719	1001	1071	423	1	70	0.0142857
NODE_2316_length_1493_cov_100.467719	1001	1071	427	1	70	0.0142857
NODE_2316_length_1493_cov_100.467719	1001	1071	428	1	70	0.0142857
NODE_2316_length_1493_cov_100.467719	1001	1071	439	1	70	0.0142857
NODE_2316_length_1493_cov_100.467719	1001	1071	457	1	70	0.0142857
NODE_2316_length_1493_cov_100.467719	1001	1071	485	1	70	0.0142857
NODE_2316_length_1493_cov_100.467719	1001	1071	493	1	70	0.0142857
NODE_2316_length_1493_cov_100.467719	1001	1071	505	1	70	0.0142857
NODE_2316_length_1493_cov_100.467719	1001	1071	507	1	70	0.0142857
NODE_2316_length_1493_cov_100.467719	1001	1071	514	1	70	0.0142857
NODE_2316_length_1493_cov_100.467719	1001	1071	518	1	70	0.0142857
NODE_2316_length_1493_cov_100.467719	1001	1071	520	3	70	0.0428571
NODE_2316_length_1493_cov_100.467719	1001	1071	522	1	70	0.0142857
NODE_2316_length_1493_cov_100.467719	1001	1071	528	2	70	0.0285714
NODE_2316_length_1493_cov_100.467719	1001	1071	530	1	70	0.0142857
NODE_2316_length_1493_cov_100.467719	1001	1071	531	2	70	0.0285714
NODE_2316_length_1493_cov_100.467719	1001	1071	534	1	70	0.0142857
NODE_2316_length_1493_cov_100.467719	1001	1071	535	1	70	0.0142857
NODE_2316_length_1493_cov_100.467719	1001	1071	538	1	70	0.0142857
NODE_2316_length_1493_cov_100.467719	1001	1071	550	1	70	0.0142857
NODE_2316_length_1493_cov_100.467719	1001	1071	562	1	70	0.0142857
NODE_2316_length_1493_cov_100.467719	1001	1071	563	1	70	0.0142857
NODE_2316_length_1493_cov_100.467719	1001	1071	564	1	70	0.0142857
NODE_2316_length_1493_cov_100.467719	1001	1071	566	2	70	0.0285714
NODE_2316_length_1493_cov_100.467719	1001	1071	567	1	70	0.0142857
NODE_2316_length_1493_cov_100.467719	1001	1071	569	1	70	0.0142857
NODE_2316_length_1493_cov_100.467719	1077	1157	591	1	80	0.0125000
NODE_2316_length_1493_cov_100.467719	1077	1157	593	1	80	0.0125000
NODE_2316_length_1493_cov_100.467719	1077	1157	594	1	80	0.0125000
NODE_2316_length_1493_cov_100.467719	1077	1157	595	1	80	0.0125000
NODE_2316_length_1493_cov_100.467719	1077	1157	596	1	80	0.0125000
NODE_2316_length_1493_cov_100.467719	1077	1157	599	1	80	0.0125000
NODE_2316_length_1493_cov_100.467719	1077	1157	607	1	80	0.0125000
NODE_2316_length_1493_cov_100.467719	1077	1157	612	1	80	0.0125000
NODE_2316_length_1493_cov_100.467719	1077	1157	613	1	80	0.0125000
NODE_2316_length_1493_cov_100.467719	1077	1157	615	1	80	0.0125000
NODE_2316_length_1493_cov_100.467719	1077	1157	622	1	80	0.0125000
NODE_2316_length_1493_cov_100.467719	1077	1157	623	2	80	0.0250000
NODE_2316_length_1493_cov_100.467719	1077	1157	629	1	80	0.0125000
NODE_2316_length_1493_cov_100.467719	1077	1157	631	2	80	0.0250000
NODE_2316_length_1493_cov_100.467719	1077	1157	634	1	80	0.0125000
NODE_2316_length_1493_cov_100.467719	1077	1157	641	1	80	0.0125000
NODE_2316_length_1493_cov_100.467719	1077	1157	642	1	80	0.0125000
NODE_2316_length_1493_cov_100.467719	1077	1157	644	1	80	0.0125000
NODE_2316_length_1493_cov_100.467719	1077	1157	651	1	80	0.0125000
NODE_2316_length_1493_cov_100.467719	1077	1157	654	1	80	0.0125000
NODE_2316_length_1493_cov_100.467719	1077	1157	671	2	80	0.0250000
NODE_2316_length_1493_cov_100.467719	1077	1157	672	1	80	0.0125000
NODE_2316_length_1493_cov_100.467719	1077	1157	683	1	80	0.0125000
NODE_2316_length_1493_cov_100.467719	1077	1157	689	1	80	0.0125000
NODE_2316_length_1493_cov_100.467719	1077	1157	697	1	80	0.0125000
NODE_2316_length_1493_cov_100.467719	1077	1157	710	1	80	0.0125000
NODE_2316_length_1493_cov_100.467719	1077	1157	723	2	80	0.0250000
NODE_2316_length_1493_cov_100.467719	1077	1157	724	1	80	0.0125000
NODE_2316_length_1493_cov_100.467719	1077	1157	726	1	80	0.0125000
NODE_2316_length_1493_cov_100.467719	1077	1157	727	1	80	0.0125000
NODE_2316_length_1493_cov_100.467719	1077	1157	731	1	80	0.0125000
NODE_2316_length_1493_cov_100.467719	1077	1157	733	2	80	0.0250000
NODE_2316_length_1493_cov_100.467719	1077	1157	734	1	80	0.0125000
NODE_2316_length_1493_cov_100.467719	1077	1157	746	1	80	0.0125000
NODE_2316_length_1493_cov_100.467719	1077	1157	765	1	80	0.0125000
NODE_2316_length_1493_cov_100.467719	1077	1157	766	1	80	0.0125000
NODE_2316_length_1493_cov_100.467719	1077	1157	767	2	80	0.0250000
NODE_2316_length_1493_cov_100.467719	1077	1157	768	1	80	0.0125000
NODE_2316_length_1493_cov_100.467719	1077	1157	769	2	80	0.0250000
NODE_2316_length_1493_cov_100.467719	1077	1157	771	2	80	0.0250000
NODE_2316_length_1493_cov_100.467719	1077	1157	775	1	80	0.0125000
NODE_2316_length_1493_cov_100.467719	1077	1157	789	1	80	0.0125000
NODE_2316_length_1493_cov_100.467719	1077	1157	790	1	80	0.0125000
NODE_2316_length_1493_cov_100.467719	1077	1157	811	1	80	0.0125000
NODE_2316_length_1493_cov_100.467719	1077	1157	812	1	80	0.0125000
NODE_2316_length_1493_cov_100.467719	1077	1157	821	2	80	0.0250000
NODE_2316_length_1493_cov_100.467719	1077	1157	832	1	80	0.0125000
NODE_2316_length_1493_cov_100.467719	1077	1157	833	1	80	0.0125000
NODE_2316_length_1493_cov_100.467719	1077	1157	844	1	80	0.0125000
NODE_2316_length_1493_cov_100.467719	1077	1157	850	2	80	0.0250000
NODE_2316_length_1493_cov_100.467719	1077	1157	854	1	80	0.0125000
NODE_2316_length_1493_cov_100.467719	1077	1157	855	1	80	0.0125000
NODE_2316_length_1493_cov_100.467719	1077	1157	858	1	80	0.0125000
NODE_2316_length_1493_cov_100.467719	1077	1157	861	3	80	0.0375000
NODE_2316_length_1493_cov_100.467719	1077	1157	862	1	80	0.0125000
NODE_2316_length_1493_cov_100.467719	1077	1157	872	1	80	0.0125000
NODE_2316_length_1493_cov_100.467719	1077	1157	880	2	80	0.0250000
NODE_2316_length_1493_cov_100.467719	1077	1157	885	1	80	0.0125000
NODE_2316_length_1493_cov_100.467719	1077	1157	899	1	80	0.0125000
NODE_2316_length_1493_cov_100.467719	1077	1157	902	3	80	0.0375000
NODE_2316_length_1493_cov_100.467719	1077	1157	906	1	80	0.0125000
NODE_2316_length_1493_cov_100.467719	1077	1157	909	1	80	0.0125000
NODE_2316_length_1493_cov_100.467719	1077	1157	910	1	80	0.0125000
NODE_2316_length_1493_cov_100.467719	1077	1157	911	1	80	0.0125000
NODE_2316_length_1493_cov_100.467719	1077	1157	915	1	80	0.0125000
NODE_2316_length_1493_cov_100.467719	1130	1210	769	1	80	0.0125000
NODE_2316_length_1493_cov_100.467719	1130	1210	806	1	80	0.0125000
NODE_2316_length_1493_cov_100.467719	1130	1210	820	1	80	0.0125000
NODE_2316_length_1493_cov_100.467719	1130	1210	821	2	80	0.0250000
NODE_2316_length_1493_cov_100.467719	1130	1210	831	1	80	0.0125000
NODE_2316_length_1493_cov_100.467719	1130	1210	832	1	80	0.0125000
NODE_2316_length_1493_cov_100.467719	1130	1210	833	1	80	0.0125000
NODE_2316_length_1493_cov_100.467719	1130	1210	834	1	80	0.0125000
NODE_2316_length_1493_cov_100.467719	1130	1210	839	1	80	0.0125000
NODE_2316_length_1493_cov_100.467719	1130	1210	843	1	80	0.0125000
NODE_2316_length_1493_cov_100.467719	1130	1210	844	2	80	0.0250000
NODE_2316_length_1493_cov_100.467719	1130	1210	845	1	80	0.0125000
NODE_2316_length_1493_cov_100.467719	1130	1210	850	2	80	0.0250000
NODE_2316_length_1493_cov_100.467719	1130	1210	851	1	80	0.0125000
NODE_2316_length_1493_cov_100.467719	1130	1210	854	2	80	0.0250000
NODE_2316_length_1493_cov_100.467719	1130	1210	855	2	80	0.0250000
NODE_2316_length_1493_cov_100.467719	1130	1210	858	1	80	0.0125000
NODE_2316_length_1493_cov_100.467719	1130	1210	861	3	80	0.0375000
NODE_2316_length_1493_cov_100.467719	1130	1210	862	1	80	0.0125000
NODE_2316_length_1493_cov_100.467719	1130	1210	872	1	80	0.0125000
NODE_2316_length_1493_cov_100.467719	1130	1210	880	2	80	0.0250000
NODE_2316_length_1493_cov_100.467719	1130	1210	882	1	80	0.0125000
NODE_2316_length_1493_cov_100.467719	1130	1210	885	1	80	0.0125000
NODE_2316_length_1493_cov_100.467719	1130	1210	886	1	80	0.0125000
NODE_2316_length_1493_cov_100.467719	1130	1210	888	1	80	0.0125000
NODE_2316_length_1493_cov_100.467719	1130	1210	890	2	80	0.0250000
NODE_2316_length_1493_cov_100.467719	1130	1210	891	1	80	0.0125000
NODE_2316_length_1493_cov_100.467719	1130	1210	894	2	80	0.0250000
NODE_2316_length_1493_cov_100.467719	1130	1210	897	1	80	0.0125000
NODE_2316_length_1493_cov_100.467719	1130	1210	899	1	80	0.0125000
NODE_2316_length_1493_cov_100.467719	1130	1210	901	2	80	0.0250000
NODE_2316_length_1493_cov_100.467719	1130	1210	902	4	80	0.0500000
NODE_2316_length_1493_cov_100.467719	1130	1210	903	2	80	0.0250000
NODE_2316_length_1493_cov_100.467719	1130	1210	904	1	80	0.0125000
NODE_2316_length_1493_cov_100.467719	1130	1210	905	4	80	0.0500000
NODE_2316_length_1493_cov_100.467719	1130	1210	906	1	80	0.0125000
NODE_2316_length_1493_cov_100.467719	1130	1210	908	1	80	0.0125000
NODE_2316_length_1493_cov_100.467719	1130	1210	909	3	80	0.0375000
NODE_2316_length_1493_cov_100.467719	1130	1210	910	1	80	0.0125000
NODE_2316_length_1493_cov_100.467719	1130	1210	911	1	80	0.0125000
NODE_2316_length_1493_cov_100.467719	1130	1210	912	1	80	0.0125000
NODE_2316_length_1493_cov_100.467719	1130	1210	915	1	80	0.0125000
NODE_2316_length_1493_cov_100.467719	1130	1210	916	4	80	0.0500000
NODE_2316_length_1493_cov_100.467719	1130	1210	917	1	80	0.0125000
NODE_2316_length_1493_cov_100.467719	1130	1210	918	1	80	0.0125000
NODE_2316_length_1493_cov_100.467719	1130	1210	919	1	80	0.0125000
NODE_2316_length_1493_cov_100.467719	1130	1210	920	1	80	0.0125000
NODE_2316_length_1493_cov_100.467719	1130	1210	925	2	80	0.0250000
NODE_2316_length_1493_cov_100.467719	1130	1210	930	1	80	0.0125000
NODE_2316_length_1493_cov_100.467719	1130	1210	936	1	80	0.0125000
NODE_2316_length_1493_cov_100.467719	1130	1210	938	1	80	0.0125000
NODE_2316_length_1493_cov_100.467719	1130	1210	940	1	80	0.0125000
NODE_2316_length_1493_cov_100.467719	1130	1210	941	1	80	0.0125000
NODE_2316_length_1493_cov_100.467719	1130	1210	942	1	80	0.0125000
NODE_2316_length_1493_cov_100.467719	1130	1210	947	1	80	0.0125000
NODE_2316_length_1493_cov_100.467719	1130	1210	948	1	80	0.0125000
NODE_2321_length_1493_cov_1.138451	1341	1420	0	29	79	0.3670886
NODE_2321_length_1493_cov_1.138451	1341	1420	2	14	79	0.1772152
NODE_2321_length_1493_cov_1.138451	1341	1420	4	36	79	0.4556962
NODE_2321_length_1493_cov_1.138451	1341	1420	0	29	79	0.3670886
NODE_2321_length_1493_cov_1.138451	1341	1420	2	14	79	0.1772152
NODE_2321_length_1493_cov_1.138451	1341	1420	4	36	79	0.4556962
NODE_2321_length_1493_cov_1.138451	1393	1459	4	66	66	1.0000000
NODE_2332_length_1490_cov_5.726096	233	295	4	62	62	1.0000000
NODE_2332_length_1490_cov_5.726096	1065	1149	0	84	84	1.0000000
NODE_2333_length_1490_cov_4.687275	318	399	0	81	81	1.0000000
NODE_2333_length_1490_cov_4.687275	372	452	0	80	80	1.0000000
NODE_2338_length_1488_cov_3.734341	1141	1221	0	55	80	0.6875000
NODE_2338_length_1488_cov_3.734341	1141	1221	1	25	80	0.3125000
NODE_2340_length_1487_cov_19.332133	673	753	1	27	80	0.3375000
NODE_2340_length_1487_cov_19.332133	673	753	3	44	80	0.5500000
NODE_2340_length_1487_cov_19.332133	673	753	4	9	80	0.1125000
NODE_2340_length_1487_cov_19.332133	726	806	3	18	80	0.2250000
NODE_2340_length_1487_cov_19.332133	726	806	4	62	80	0.7750000
NODE_2348_length_1484_cov_38.342960	706	786	0	3	80	0.0375000
NODE_2348_length_1484_cov_38.342960	706	786	4	7	80	0.0875000
NODE_2348_length_1484_cov_38.342960	706	786	11	1	80	0.0125000
NODE_2348_length_1484_cov_38.342960	706	786	12	69	80	0.8625000
NODE_2348_length_1484_cov_38.342960	759	839	0	11	80	0.1375000
NODE_2348_length_1484_cov_38.342960	759	839	7	1	80	0.0125000
NODE_2348_length_1484_cov_38.342960	759	839	8	39	80	0.4875000
NODE_2348_length_1484_cov_38.342960	759	839	12	29	80	0.3625000
NODE_2349_length_1484_cov_21.260650	348	428	2	46	80	0.5750000
NODE_2349_length_1484_cov_21.260650	348	428	4	9	80	0.1125000
NODE_2349_length_1484_cov_21.260650	348	428	6	25	80	0.3125000
NODE_2349_length_1484_cov_21.260650	401	481	2	11	80	0.1375000
NODE_2349_length_1484_cov_21.260650	401	481	4	9	80	0.1125000
NODE_2349_length_1484_cov_21.260650	401	481	6	60	80	0.7500000
NODE_2349_length_1484_cov_21.260650	978	1058	0	80	80	1.0000000
NODE_2349_length_1484_cov_21.260650	1031	1111	0	80	80	1.0000000
NODE_2350_length_1484_cov_19.243321	952	1032	1	52	80	0.6500000
NODE_2350_length_1484_cov_19.243321	952	1032	3	19	80	0.2375000
NODE_2350_length_1484_cov_19.243321	952	1032	4	2	80	0.0250000
NODE_2350_length_1484_cov_19.243321	952	1032	5	7	80	0.0875000
NODE_2350_length_1484_cov_19.243321	1005	1085	1	23	80	0.2875000
NODE_2350_length_1484_cov_19.243321	1005	1085	2	14	80	0.1750000
NODE_2350_length_1484_cov_19.243321	1005	1085	3	43	80	0.5375000
NODE_2351_length_1484_cov_9.085199	314	394	2	6	80	0.0750000
NODE_2351_length_1484_cov_9.085199	314	394	6	74	80	0.9250000
NODE_2351_length_1484_cov_9.085199	367	447	0	7	80	0.0875000
NODE_2351_length_1484_cov_9.085199	367	447	1	3	80	0.0375000
NODE_2351_length_1484_cov_9.085199	367	447	2	26	80	0.3250000
NODE_2351_length_1484_cov_9.085199	367	447	6	44	80	0.5500000
NODE_2353_length_1483_cov_21.207370	555	635	0	30	80	0.3750000
NODE_2353_length_1483_cov_21.207370	555	635	2	1	80	0.0125000
NODE_2353_length_1483_cov_21.207370	555	635	4	49	80	0.6125000
NODE_2353_length_1483_cov_21.207370	608	688	0	80	80	1.0000000
NODE_2359_length_1482_cov_20.177874	430	510	0	8	80	0.1000000
NODE_2359_length_1482_cov_20.177874	430	510	4	1	80	0.0125000
NODE_2359_length_1482_cov_20.177874	430	510	10	1	80	0.0125000
NODE_2359_length_1482_cov_20.177874	430	510	11	16	80	0.2000000
NODE_2359_length_1482_cov_20.177874	430	510	13	14	80	0.1750000
NODE_2359_length_1482_cov_20.177874	430	510	14	15	80	0.1875000
NODE_2359_length_1482_cov_20.177874	430	510	20	25	80	0.3125000
NODE_2359_length_1482_cov_20.177874	483	563	11	5	80	0.0625000
NODE_2359_length_1482_cov_20.177874	483	563	14	2	80	0.0250000
NODE_2359_length_1482_cov_20.177874	483	563	15	13	80	0.1625000
NODE_2359_length_1482_cov_20.177874	483	563	17	10	80	0.1250000
NODE_2359_length_1482_cov_20.177874	483	563	18	7	80	0.0875000
NODE_2359_length_1482_cov_20.177874	483	563	20	43	80	0.5375000
NODE_2359_length_1482_cov_20.177874	559	639	0	40	80	0.5000000
NODE_2359_length_1482_cov_20.177874	559	639	4	33	80	0.4125000
NODE_2359_length_1482_cov_20.177874	559	639	11	7	80	0.0875000
NODE_2359_length_1482_cov_20.177874	612	692	0	24	80	0.3000000
NODE_2359_length_1482_cov_20.177874	612	692	4	56	80	0.7000000
NODE_2360_length_1482_cov_13.644252	1000	1080	0	80	80	1.0000000
NODE_2360_length_1482_cov_13.644252	1053	1133	0	80	80	1.0000000
NODE_2361_length_1482_cov_6.157628	525	605	0	11	80	0.1375000
NODE_2361_length_1482_cov_6.157628	525	605	2	69	80	0.8625000
NODE_2361_length_1482_cov_6.157628	578	658	0	22	80	0.2750000
NODE_2361_length_1482_cov_6.157628	578	658	2	58	80	0.7250000
NODE_2361_length_1482_cov_6.157628	1306	1388	10	1	82	0.0121951
NODE_2361_length_1482_cov_6.157628	1306	1388	12	2	82	0.0243902
NODE_2361_length_1482_cov_6.157628	1306	1388	14	9	82	0.1097561
NODE_2361_length_1482_cov_6.157628	1306	1388	16	4	82	0.0487805
NODE_2361_length_1482_cov_6.157628	1306	1388	18	26	82	0.3170732
NODE_2361_length_1482_cov_6.157628	1306	1388	20	40	82	0.4878049
NODE_2364_length_1481_cov_19.238784	480	560	0	80	80	1.0000000
NODE_2364_length_1481_cov_19.238784	533	613	0	80	80	1.0000000
NODE_2365_length_1481_cov_18.139653	706	786	0	41	80	0.5125000
NODE_2365_length_1481_cov_18.139653	706	786	4	39	80	0.4875000
NODE_2365_length_1481_cov_18.139653	759	839	4	35	80	0.4375000
NODE_2365_length_1481_cov_18.139653	759	839	8	45	80	0.5625000
NODE_2367_length_1480_cov_27.552498	762	842	0	80	80	1.0000000
NODE_2367_length_1480_cov_27.552498	815	895	0	80	80	1.0000000
NODE_2367_length_1480_cov_27.552498	891	971	0	80	80	1.0000000
NODE_2367_length_1480_cov_27.552498	944	1024	0	80	80	1.0000000
NODE_2367_length_1480_cov_27.552498	1171	1222	3	4	51	0.0784314
NODE_2367_length_1480_cov_27.552498	1171	1222	11	5	51	0.0980392
NODE_2367_length_1480_cov_27.552498	1171	1222	21	4	51	0.0784314
NODE_2367_length_1480_cov_27.552498	1171	1222	35	3	51	0.0588235
NODE_2367_length_1480_cov_27.552498	1171	1222	36	3	51	0.0588235
NODE_2367_length_1480_cov_27.552498	1171	1222	38	4	51	0.0784314
NODE_2367_length_1480_cov_27.552498	1171	1222	42	5	51	0.0980392
NODE_2367_length_1480_cov_27.552498	1171	1222	49	2	51	0.0392157
NODE_2367_length_1480_cov_27.552498	1171	1222	50	10	51	0.1960784
NODE_2367_length_1480_cov_27.552498	1171	1222	51	1	51	0.0196078
NODE_2367_length_1480_cov_27.552498	1171	1222	54	9	51	0.1764706
NODE_2367_length_1480_cov_27.552498	1171	1222	55	1	51	0.0196078
NODE_2369_length_1480_cov_12.535844	466	546	1	80	80	1.0000000
NODE_2369_length_1480_cov_12.535844	519	599	0	23	80	0.2875000
NODE_2369_length_1480_cov_12.535844	519	599	1	57	80	0.7125000
NODE_2373_length_1479_cov_17.035507	708	788	0	80	80	1.0000000
NODE_2373_length_1479_cov_17.035507	761	841	0	72	80	0.9000000
NODE_2373_length_1479_cov_17.035507	761	841	2	8	80	0.1000000
NODE_2373_length_1479_cov_17.035507	837	917	0	8	80	0.1000000
NODE_2373_length_1479_cov_17.035507	837	917	2	72	80	0.9000000
NODE_2373_length_1479_cov_17.035507	890	970	0	48	80	0.6000000
NODE_2373_length_1479_cov_17.035507	890	970	2	32	80	0.4000000
NODE_2374_length_1479_cov_16.448551	908	988	0	33	80	0.4125000
NODE_2374_length_1479_cov_16.448551	908	988	6	1	80	0.0125000
NODE_2374_length_1479_cov_16.448551	908	988	8	46	80	0.5750000
NODE_2374_length_1479_cov_16.448551	961	1041	0	80	80	1.0000000
NODE_2375_length_1479_cov_5.285507	123	185	5	6	62	0.0967742
NODE_2375_length_1479_cov_5.285507	123	185	6	2	62	0.0322581
NODE_2375_length_1479_cov_5.285507	123	185	7	29	62	0.4677419
NODE_2375_length_1479_cov_5.285507	123	185	8	25	62	0.4032258
NODE_2376_length_1479_cov_2.018841	881	967	2	86	86	1.0000000
NODE_2377_length_1478_cov_32.050761	411	491	0	80	80	1.0000000
NODE_2377_length_1478_cov_32.050761	464	544	0	80	80	1.0000000
NODE_2377_length_1478_cov_32.050761	540	620	0	60	80	0.7500000
NODE_2377_length_1478_cov_32.050761	540	620	18	20	80	0.2500000
NODE_2377_length_1478_cov_32.050761	593	673	0	7	80	0.0875000
NODE_2377_length_1478_cov_32.050761	593	673	18	73	80	0.9125000
NODE_2378_length_1478_cov_27.414793	817	897	0	80	80	1.0000000
NODE_2378_length_1478_cov_27.414793	870	950	0	80	80	1.0000000
NODE_2379_length_1478_cov_23.472081	1212	1241	56	2	29	0.0689655
NODE_2379_length_1478_cov_23.472081	1212	1241	59	1	29	0.0344828
NODE_2379_length_1478_cov_23.472081	1212	1241	62	1	29	0.0344828
NODE_2379_length_1478_cov_23.472081	1212	1241	71	2	29	0.0689655
NODE_2379_length_1478_cov_23.472081	1212	1241	75	1	29	0.0344828
NODE_2379_length_1478_cov_23.472081	1212	1241	77	1	29	0.0344828
NODE_2379_length_1478_cov_23.472081	1212	1241	79	2	29	0.0689655
NODE_2379_length_1478_cov_23.472081	1212	1241	83	1	29	0.0344828
NODE_2379_length_1478_cov_23.472081	1212	1241	89	1	29	0.0344828
NODE_2379_length_1478_cov_23.472081	1212	1241	91	1	29	0.0344828
NODE_2379_length_1478_cov_23.472081	1212	1241	93	1	29	0.0344828
NODE_2379_length_1478_cov_23.472081	1212	1241	94	2	29	0.0689655
NODE_2379_length_1478_cov_23.472081	1212	1241	99	1	29	0.0344828
NODE_2379_length_1478_cov_23.472081	1212	1241	101	1	29	0.0344828
NODE_2379_length_1478_cov_23.472081	1212	1241	105	2	29	0.0689655
NODE_2379_length_1478_cov_23.472081	1212	1241	107	4	29	0.1379310
NODE_2379_length_1478_cov_23.472081	1212	1241	109	1	29	0.0344828
NODE_2379_length_1478_cov_23.472081	1212	1241	115	1	29	0.0344828
NODE_2379_length_1478_cov_23.472081	1212	1241	119	3	29	0.1034483
NODE_2380_length_1478_cov_10.746193	678	758	2	28	80	0.3500000
NODE_2380_length_1478_cov_10.746193	678	758	6	52	80	0.6500000
NODE_2380_length_1478_cov_10.746193	731	811	0	33	80	0.4125000
NODE_2380_length_1478_cov_10.746193	731	811	4	9	80	0.1125000
NODE_2380_length_1478_cov_10.746193	731	811	6	38	80	0.4750000
NODE_2380_length_1478_cov_10.746193	807	892	0	12	85	0.1411765
NODE_2380_length_1478_cov_10.746193	807	892	2	73	85	0.8588235
NODE_2380_length_1478_cov_10.746193	860	945	0	55	85	0.6470588
NODE_2380_length_1478_cov_10.746193	860	945	2	30	85	0.3529412
NODE_2384_length_1476_cov_6.522150	791	871	0	26	80	0.3250000
NODE_2384_length_1476_cov_6.522150	791	871	2	1	80	0.0125000
NODE_2384_length_1476_cov_6.522150	791	871	4	24	80	0.3000000
NODE_2384_length_1476_cov_6.522150	791	871	6	29	80	0.3625000
NODE_2384_length_1476_cov_6.522150	844	924	4	22	80	0.2750000
NODE_2384_length_1476_cov_6.522150	844	924	6	58	80	0.7250000
NODE_2392_length_1474_cov_11.209455	515	595	0	80	80	1.0000000
NODE_2392_length_1474_cov_11.209455	568	648	0	44	80	0.5500000
NODE_2392_length_1474_cov_11.209455	568	648	2	36	80	0.4500000
NODE_2397_length_1472_cov_22.159505	428	508	0	1	80	0.0125000
NODE_2397_length_1472_cov_22.159505	428	508	2	33	80	0.4125000
NODE_2397_length_1472_cov_22.159505	428	508	5	1	80	0.0125000
NODE_2397_length_1472_cov_22.159505	428	508	8	45	80	0.5625000
NODE_2397_length_1472_cov_22.159505	428	508	0	1	80	0.0125000
NODE_2397_length_1472_cov_22.159505	428	508	2	33	80	0.4125000
NODE_2397_length_1472_cov_22.159505	428	508	5	1	80	0.0125000
NODE_2397_length_1472_cov_22.159505	428	508	8	45	80	0.5625000
NODE_2397_length_1472_cov_22.159505	481	561	0	38	80	0.4750000
NODE_2397_length_1472_cov_22.159505	481	561	2	26	80	0.3250000
NODE_2397_length_1472_cov_22.159505	481	561	4	5	80	0.0625000
NODE_2397_length_1472_cov_22.159505	481	561	6	1	80	0.0125000
NODE_2397_length_1472_cov_22.159505	481	561	10	5	80	0.0625000
NODE_2397_length_1472_cov_22.159505	481	561	12	1	80	0.0125000
NODE_2397_length_1472_cov_22.159505	481	561	21	1	80	0.0125000
NODE_2397_length_1472_cov_22.159505	481	561	22	3	80	0.0375000
NODE_2397_length_1472_cov_22.159505	913	993	0	80	80	1.0000000
NODE_2397_length_1472_cov_22.159505	966	1046	0	80	80	1.0000000
NODE_2397_length_1472_cov_22.159505	1042	1122	0	80	80	1.0000000
NODE_2397_length_1472_cov_22.159505	1095	1175	0	80	80	1.0000000
NODE_2398_length_1472_cov_22.018208	523	590	0	33	67	0.4925373
NODE_2398_length_1472_cov_22.018208	523	590	2	34	67	0.5074627
NODE_2398_length_1472_cov_22.018208	563	643	0	80	80	1.0000000
NODE_2398_length_1472_cov_22.018208	639	719	0	80	80	1.0000000
NODE_2398_length_1472_cov_22.018208	692	772	0	80	80	1.0000000
NODE_2404_length_1470_cov_7.042305	5	57	48	1	52	0.0192308
NODE_2404_length_1470_cov_7.042305	5	57	53	1	52	0.0192308
NODE_2404_length_1470_cov_7.042305	5	57	54	2	52	0.0384615
NODE_2404_length_1470_cov_7.042305	5	57	81	1	52	0.0192308
NODE_2404_length_1470_cov_7.042305	5	57	93	2	52	0.0384615
NODE_2404_length_1470_cov_7.042305	5	57	101	1	52	0.0192308
NODE_2404_length_1470_cov_7.042305	5	57	109	1	52	0.0192308
NODE_2404_length_1470_cov_7.042305	5	57	111	1	52	0.0192308
NODE_2404_length_1470_cov_7.042305	5	57	117	2	52	0.0384615
NODE_2404_length_1470_cov_7.042305	5	57	119	1	52	0.0192308
NODE_2404_length_1470_cov_7.042305	5	57	132	2	52	0.0384615
NODE_2404_length_1470_cov_7.042305	5	57	136	2	52	0.0384615
NODE_2404_length_1470_cov_7.042305	5	57	140	2	52	0.0384615
NODE_2404_length_1470_cov_7.042305	5	57	148	1	52	0.0192308
NODE_2404_length_1470_cov_7.042305	5	57	150	32	52	0.6153846
NODE_2405_length_1470_cov_2.185266	199	245	0	46	46	1.0000000
NODE_2407_length_1469_cov_5.683942	834	914	0	80	80	1.0000000
NODE_2407_length_1469_cov_5.683942	887	967	0	80	80	1.0000000
NODE_2410_length_1467_cov_31.231725	1048	1131	0	83	83	1.0000000
NODE_2411_length_1467_cov_19.731725	485	565	3	35	80	0.4375000
NODE_2411_length_1467_cov_19.731725	485	565	5	11	80	0.1375000
NODE_2411_length_1467_cov_19.731725	485	565	7	9	80	0.1125000
NODE_2411_length_1467_cov_19.731725	485	565	8	18	80	0.2250000
NODE_2411_length_1467_cov_19.731725	485	565	9	6	80	0.0750000
NODE_2411_length_1467_cov_19.731725	485	565	10	1	80	0.0125000
NODE_2411_length_1467_cov_19.731725	538	618	7	9	80	0.1125000
NODE_2411_length_1467_cov_19.731725	538	618	8	71	80	0.8875000
NODE_2412_length_1467_cov_11.807749	180	242	10	8	62	0.1290323
NODE_2412_length_1467_cov_11.807749	180	242	12	1	62	0.0161290
NODE_2412_length_1467_cov_11.807749	180	242	14	3	62	0.0483871
NODE_2412_length_1467_cov_11.807749	180	242	16	1	62	0.0161290
NODE_2412_length_1467_cov_11.807749	180	242	18	8	62	0.1290323
NODE_2412_length_1467_cov_11.807749	180	242	20	10	62	0.1612903
NODE_2412_length_1467_cov_11.807749	180	242	22	31	62	0.5000000
NODE_2412_length_1467_cov_11.807749	264	293	3	1	29	0.0344828
NODE_2412_length_1467_cov_11.807749	264	293	5	8	29	0.2758621
NODE_2412_length_1467_cov_11.807749	264	293	9	2	29	0.0689655
NODE_2412_length_1467_cov_11.807749	264	293	13	2	29	0.0689655
NODE_2412_length_1467_cov_11.807749	264	293	14	1	29	0.0344828
NODE_2412_length_1467_cov_11.807749	264	293	17	5	29	0.1724138
NODE_2412_length_1467_cov_11.807749	264	293	19	9	29	0.3103448
NODE_2412_length_1467_cov_11.807749	264	293	21	1	29	0.0344828
NODE_2412_length_1467_cov_11.807749	930	1010	0	33	80	0.4125000
NODE_2412_length_1467_cov_11.807749	930	1010	4	47	80	0.5875000
NODE_2412_length_1467_cov_11.807749	983	1063	4	80	80	1.0000000
NODE_2414_length_1466_cov_41.326993	664	744	18	30	80	0.3750000
NODE_2414_length_1466_cov_41.326993	664	744	19	2	80	0.0250000
NODE_2414_length_1466_cov_41.326993	664	744	23	3	80	0.0375000
NODE_2414_length_1466_cov_41.326993	664	744	24	9	80	0.1125000
NODE_2414_length_1466_cov_41.326993	664	744	26	12	80	0.1500000
NODE_2414_length_1466_cov_41.326993	664	744	27	8	80	0.1000000
NODE_2414_length_1466_cov_41.326993	664	744	28	8	80	0.1000000
NODE_2414_length_1466_cov_41.326993	664	744	30	7	80	0.0875000
NODE_2414_length_1466_cov_41.326993	664	744	31	1	80	0.0125000
NODE_2414_length_1466_cov_41.326993	717	797	4	4	80	0.0500000
NODE_2414_length_1466_cov_41.326993	717	797	10	14	80	0.1750000
NODE_2414_length_1466_cov_41.326993	717	797	11	7	80	0.0875000
NODE_2414_length_1466_cov_41.326993	717	797	12	9	80	0.1125000
NODE_2414_length_1466_cov_41.326993	717	797	14	13	80	0.1625000
NODE_2414_length_1466_cov_41.326993	717	797	18	33	80	0.4125000
NODE_2414_length_1466_cov_41.326993	793	873	2	51	80	0.6375000
NODE_2414_length_1466_cov_41.326993	793	873	4	29	80	0.3625000
NODE_2414_length_1466_cov_41.326993	846	926	0	48	80	0.6000000
NODE_2414_length_1466_cov_41.326993	846	926	2	32	80	0.4000000
NODE_2420_length_1464_cov_6.726740	137	204	10	1	67	0.0149254
NODE_2420_length_1464_cov_6.726740	137	204	12	10	67	0.1492537
NODE_2420_length_1464_cov_6.726740	137	204	15	3	67	0.0447761
NODE_2420_length_1464_cov_6.726740	137	204	17	1	67	0.0149254
NODE_2420_length_1464_cov_6.726740	137	204	19	2	67	0.0298507
NODE_2420_length_1464_cov_6.726740	137	204	27	3	67	0.0447761
NODE_2420_length_1464_cov_6.726740	137	204	28	3	67	0.0447761
NODE_2420_length_1464_cov_6.726740	137	204	29	21	67	0.3134328
NODE_2420_length_1464_cov_6.726740	137	204	31	2	67	0.0298507
NODE_2420_length_1464_cov_6.726740	137	204	32	1	67	0.0149254
NODE_2420_length_1464_cov_6.726740	137	204	33	1	67	0.0149254
NODE_2420_length_1464_cov_6.726740	137	204	35	11	67	0.1641791
NODE_2420_length_1464_cov_6.726740	137	204	37	8	67	0.1194030
NODE_2422_length_1464_cov_2.198535	1301	1363	30	1	62	0.0161290
NODE_2422_length_1464_cov_2.198535	1301	1363	36	1	62	0.0161290
NODE_2422_length_1464_cov_2.198535	1301	1363	37	1	62	0.0161290
NODE_2422_length_1464_cov_2.198535	1301	1363	39	2	62	0.0322581
NODE_2422_length_1464_cov_2.198535	1301	1363	41	1	62	0.0161290
NODE_2422_length_1464_cov_2.198535	1301	1363	42	2	62	0.0322581
NODE_2422_length_1464_cov_2.198535	1301	1363	45	1	62	0.0161290
NODE_2422_length_1464_cov_2.198535	1301	1363	47	2	62	0.0322581
NODE_2422_length_1464_cov_2.198535	1301	1363	49	2	62	0.0322581
NODE_2422_length_1464_cov_2.198535	1301	1363	51	1	62	0.0161290
NODE_2422_length_1464_cov_2.198535	1301	1363	54	1	62	0.0161290
NODE_2422_length_1464_cov_2.198535	1301	1363	56	1	62	0.0161290
NODE_2422_length_1464_cov_2.198535	1301	1363	61	1	62	0.0161290
NODE_2422_length_1464_cov_2.198535	1301	1363	62	1	62	0.0161290
NODE_2422_length_1464_cov_2.198535	1301	1363	66	1	62	0.0161290
NODE_2422_length_1464_cov_2.198535	1301	1363	68	2	62	0.0322581
NODE_2422_length_1464_cov_2.198535	1301	1363	78	1	62	0.0161290
NODE_2422_length_1464_cov_2.198535	1301	1363	79	2	62	0.0322581
NODE_2422_length_1464_cov_2.198535	1301	1363	83	1	62	0.0161290
NODE_2422_length_1464_cov_2.198535	1301	1363	85	1	62	0.0161290
NODE_2422_length_1464_cov_2.198535	1301	1363	89	1	62	0.0161290
NODE_2422_length_1464_cov_2.198535	1301	1363	93	1	62	0.0161290
NODE_2422_length_1464_cov_2.198535	1301	1363	95	1	62	0.0161290
NODE_2422_length_1464_cov_2.198535	1301	1363	106	2	62	0.0322581
NODE_2422_length_1464_cov_2.198535	1301	1363	109	1	62	0.0161290
NODE_2422_length_1464_cov_2.198535	1301	1363	121	1	62	0.0161290
NODE_2422_length_1464_cov_2.198535	1301	1363	123	1	62	0.0161290
NODE_2422_length_1464_cov_2.198535	1301	1363	125	1	62	0.0161290
NODE_2422_length_1464_cov_2.198535	1301	1363	127	2	62	0.0322581
NODE_2422_length_1464_cov_2.198535	1301	1363	129	4	62	0.0645161
NODE_2422_length_1464_cov_2.198535	1301	1363	131	1	62	0.0161290
NODE_2422_length_1464_cov_2.198535	1301	1363	137	10	62	0.1612903
NODE_2422_length_1464_cov_2.198535	1301	1363	139	6	62	0.0967742
NODE_2422_length_1464_cov_2.198535	1301	1363	140	4	62	0.0645161
NODE_2425_length_1463_cov_15.345308	314	394	0	34	80	0.4250000
NODE_2425_length_1463_cov_15.345308	314	394	2	46	80	0.5750000
NODE_2425_length_1463_cov_15.345308	367	447	0	11	80	0.1375000
NODE_2425_length_1463_cov_15.345308	367	447	2	69	80	0.8625000
NODE_2427_length_1462_cov_18.082172	418	498	0	80	80	1.0000000
NODE_2427_length_1462_cov_18.082172	471	551	0	80	80	1.0000000
NODE_2427_length_1462_cov_18.082172	1036	1116	0	80	80	1.0000000
NODE_2427_length_1462_cov_18.082172	1089	1169	0	80	80	1.0000000
NODE_2428_length_1462_cov_1.792370	1247	1319	2	72	72	1.0000000
NODE_2428_length_1462_cov_1.792370	1305	1374	0	53	69	0.7681159
NODE_2428_length_1462_cov_1.792370	1305	1374	2	16	69	0.2318841
NODE_2433_length_1460_cov_23.927994	852	932	0	18	80	0.2250000
NODE_2433_length_1460_cov_23.927994	852	932	2	4	80	0.0500000
NODE_2433_length_1460_cov_23.927994	852	932	6	25	80	0.3125000
NODE_2433_length_1460_cov_23.927994	852	932	10	33	80	0.4125000
NODE_2433_length_1460_cov_23.927994	905	985	0	23	80	0.2875000
NODE_2433_length_1460_cov_23.927994	905	985	2	18	80	0.2250000
NODE_2433_length_1460_cov_23.927994	905	985	6	6	80	0.0750000
NODE_2433_length_1460_cov_23.927994	905	985	8	2	80	0.0250000
NODE_2433_length_1460_cov_23.927994	905	985	10	31	80	0.3875000
NODE_2436_length_1459_cov_43.600000	535	615	1	14	80	0.1750000
NODE_2436_length_1459_cov_43.600000	535	615	2	10	80	0.1250000
NODE_2436_length_1459_cov_43.600000	535	615	12	56	80	0.7000000
NODE_2436_length_1459_cov_43.600000	588	668	11	34	80	0.4250000
NODE_2436_length_1459_cov_43.600000	588	668	12	28	80	0.3500000
NODE_2436_length_1459_cov_43.600000	588	668	15	18	80	0.2250000
NODE_2436_length_1459_cov_43.600000	664	744	8	26	80	0.3250000
NODE_2436_length_1459_cov_43.600000	664	744	9	29	80	0.3625000
NODE_2436_length_1459_cov_43.600000	664	744	15	6	80	0.0750000
NODE_2436_length_1459_cov_43.600000	664	744	18	1	80	0.0125000
NODE_2436_length_1459_cov_43.600000	664	744	19	18	80	0.2250000
NODE_2436_length_1459_cov_43.600000	717	797	8	8	80	0.1000000
NODE_2436_length_1459_cov_43.600000	717	797	9	72	80	0.9000000
NODE_2437_length_1459_cov_32.276471	865	945	0	80	80	1.0000000
NODE_2437_length_1459_cov_32.276471	918	998	0	47	80	0.5875000
NODE_2437_length_1459_cov_32.276471	918	998	2	33	80	0.4125000
NODE_2437_length_1459_cov_32.276471	994	1074	0	35	80	0.4375000
NODE_2437_length_1459_cov_32.276471	994	1074	2	45	80	0.5625000
NODE_2437_length_1459_cov_32.276471	1047	1127	0	80	80	1.0000000
NODE_2441_length_1458_cov_2.184695	1361	1441	4	57	80	0.7125000
NODE_2441_length_1458_cov_2.184695	1361	1441	6	23	80	0.2875000
NODE_2442_length_1457_cov_19.687040	834	914	0	46	80	0.5750000
NODE_2442_length_1457_cov_19.687040	834	914	2	34	80	0.4250000
NODE_2442_length_1457_cov_19.687040	887	967	0	80	80	1.0000000
NODE_2442_length_1457_cov_19.687040	963	1043	0	80	80	1.0000000
NODE_2442_length_1457_cov_19.687040	1016	1096	0	80	80	1.0000000
NODE_2444_length_1457_cov_14.944772	754	834	4	6	80	0.0750000
NODE_2444_length_1457_cov_14.944772	754	834	6	23	80	0.2875000
NODE_2444_length_1457_cov_14.944772	754	834	15	11	80	0.1375000
NODE_2444_length_1457_cov_14.944772	754	834	16	1	80	0.0125000
NODE_2444_length_1457_cov_14.944772	754	834	17	3	80	0.0375000
NODE_2444_length_1457_cov_14.944772	754	834	18	36	80	0.4500000
NODE_2444_length_1457_cov_14.944772	807	887	13	37	80	0.4625000
NODE_2444_length_1457_cov_14.944772	807	887	15	27	80	0.3375000
NODE_2444_length_1457_cov_14.944772	807	887	17	3	80	0.0375000
NODE_2444_length_1457_cov_14.944772	807	887	18	13	80	0.1625000
NODE_2445_length_1457_cov_10.168630	827	907	0	80	80	1.0000000
NODE_2445_length_1457_cov_10.168630	880	960	0	78	80	0.9750000
NODE_2445_length_1457_cov_10.168630	880	960	2	2	80	0.0250000
NODE_2445_length_1457_cov_10.168630	956	1036	0	2	80	0.0250000
NODE_2445_length_1457_cov_10.168630	956	1036	2	78	80	0.9750000
NODE_2445_length_1457_cov_10.168630	1009	1089	0	20	80	0.2500000
NODE_2445_length_1457_cov_10.168630	1009	1089	2	60	80	0.7500000
NODE_2448_length_1456_cov_13.675755	557	637	0	21	80	0.2625000
NODE_2448_length_1456_cov_13.675755	557	637	2	38	80	0.4750000
NODE_2448_length_1456_cov_13.675755	557	637	6	21	80	0.2625000
NODE_2448_length_1456_cov_13.675755	610	690	2	6	80	0.0750000
NODE_2448_length_1456_cov_13.675755	610	690	4	7	80	0.0875000
NODE_2448_length_1456_cov_13.675755	610	690	6	67	80	0.8375000
NODE_2449_length_1456_cov_11.109064	951	1031	0	80	80	1.0000000
NODE_2449_length_1456_cov_11.109064	1004	1084	0	80	80	1.0000000
NODE_2452_length_1456_cov_3.137067	374	410	0	14	36	0.3888889
NODE_2452_length_1456_cov_3.137067	374	410	2	22	36	0.6111111
NODE_2454_length_1456_cov_1.889462	35	99	0	63	64	0.9843750
NODE_2454_length_1456_cov_1.889462	35	99	4	1	64	0.0156250
NODE_2456_length_1455_cov_60.874631	369	449	0	80	80	1.0000000
NODE_2456_length_1455_cov_60.874631	422	502	0	80	80	1.0000000
NODE_2456_length_1455_cov_60.874631	498	578	0	80	80	1.0000000
NODE_2456_length_1455_cov_60.874631	551	631	0	80	80	1.0000000
NODE_2458_length_1455_cov_35.253687	615	695	0	36	80	0.4500000
NODE_2458_length_1455_cov_35.253687	615	695	2	44	80	0.5500000
NODE_2458_length_1455_cov_35.253687	668	748	0	34	80	0.4250000
NODE_2458_length_1455_cov_35.253687	668	748	2	46	80	0.5750000
NODE_2458_length_1455_cov_35.253687	744	824	0	65	80	0.8125000
NODE_2458_length_1455_cov_35.253687	744	824	2	15	80	0.1875000
NODE_2458_length_1455_cov_35.253687	797	877	0	12	80	0.1500000
NODE_2458_length_1455_cov_35.253687	797	877	2	30	80	0.3750000
NODE_2458_length_1455_cov_35.253687	797	877	3	1	80	0.0125000
NODE_2458_length_1455_cov_35.253687	797	877	4	20	80	0.2500000
NODE_2458_length_1455_cov_35.253687	797	877	6	17	80	0.2125000
NODE_2465_length_1452_cov_7.101256	976	1056	0	80	80	1.0000000
NODE_2465_length_1452_cov_7.101256	1029	1109	0	80	80	1.0000000
NODE_2465_length_1452_cov_7.101256	1105	1185	0	80	80	1.0000000
NODE_2465_length_1452_cov_7.101256	1158	1238	0	80	80	1.0000000
NODE_2470_length_1451_cov_23.880178	439	520	4	23	81	0.2839506
NODE_2470_length_1451_cov_23.880178	439	520	5	38	81	0.4691358
NODE_2470_length_1451_cov_23.880178	439	520	7	18	81	0.2222222
NODE_2470_length_1451_cov_23.880178	439	520	11	2	81	0.0246914
NODE_2470_length_1451_cov_23.880178	493	573	0	51	80	0.6375000
NODE_2470_length_1451_cov_23.880178	493	573	4	1	80	0.0125000
NODE_2470_length_1451_cov_23.880178	493	573	5	28	80	0.3500000
NODE_2471_length_1451_cov_16.249260	422	502	0	14	80	0.1750000
NODE_2471_length_1451_cov_16.249260	422	502	2	66	80	0.8250000
NODE_2471_length_1451_cov_16.249260	475	555	0	6	80	0.0750000
NODE_2471_length_1451_cov_16.249260	475	555	2	74	80	0.9250000
NODE_2472_length_1451_cov_8.663462	908	988	0	80	80	1.0000000
NODE_2472_length_1451_cov_8.663462	961	1040	0	79	79	1.0000000
NODE_2474_length_1451_cov_5.219675	897	977	0	80	80	1.0000000
NODE_2474_length_1451_cov_5.219675	950	1030	0	80	80	1.0000000
NODE_2477_length_1450_cov_20.371577	611	691	0	17	80	0.2125000
NODE_2477_length_1450_cov_20.371577	611	691	2	63	80	0.7875000
NODE_2477_length_1450_cov_20.371577	664	744	0	8	80	0.1000000
NODE_2477_length_1450_cov_20.371577	664	744	1	1	80	0.0125000
NODE_2477_length_1450_cov_20.371577	664	744	2	71	80	0.8875000
NODE_2482_length_1449_cov_24.665926	432	512	0	80	80	1.0000000
NODE_2482_length_1449_cov_24.665926	485	565	0	80	80	1.0000000
NODE_2482_length_1449_cov_24.665926	561	643	0	82	82	1.0000000
NODE_2482_length_1449_cov_24.665926	616	696	0	80	80	1.0000000
NODE_2485_length_1448_cov_20.587102	904	984	0	43	80	0.5375000
NODE_2485_length_1448_cov_20.587102	904	984	2	37	80	0.4625000
NODE_2485_length_1448_cov_20.587102	957	1037	0	19	80	0.2375000
NODE_2485_length_1448_cov_20.587102	957	1037	2	61	80	0.7625000
NODE_2487_length_1448_cov_8.693847	537	617	0	80	80	1.0000000
NODE_2487_length_1448_cov_8.693847	590	670	0	80	80	1.0000000
NODE_2488_length_1447_cov_21.391691	519	599	0	80	80	1.0000000
NODE_2488_length_1447_cov_21.391691	572	652	0	80	80	1.0000000
NODE_2488_length_1447_cov_21.391691	648	728	0	80	80	1.0000000
NODE_2488_length_1447_cov_21.391691	701	781	0	80	80	1.0000000
NODE_2491_length_1447_cov_2.262611	1268	1325	14	1	57	0.0175439
NODE_2491_length_1447_cov_2.262611	1268	1325	16	2	57	0.0350877
NODE_2491_length_1447_cov_2.262611	1268	1325	18	1	57	0.0175439
NODE_2491_length_1447_cov_2.262611	1268	1325	20	1	57	0.0175439
NODE_2491_length_1447_cov_2.262611	1268	1325	35	1	57	0.0175439
NODE_2491_length_1447_cov_2.262611	1268	1325	36	7	57	0.1228070
NODE_2491_length_1447_cov_2.262611	1268	1325	40	1	57	0.0175439
NODE_2491_length_1447_cov_2.262611	1268	1325	42	4	57	0.0701754
NODE_2491_length_1447_cov_2.262611	1268	1325	49	5	57	0.0877193
NODE_2491_length_1447_cov_2.262611	1268	1325	51	1	57	0.0175439
NODE_2491_length_1447_cov_2.262611	1268	1325	53	1	57	0.0175439
NODE_2491_length_1447_cov_2.262611	1268	1325	57	1	57	0.0175439
NODE_2491_length_1447_cov_2.262611	1268	1325	60	2	57	0.0350877
NODE_2491_length_1447_cov_2.262611	1268	1325	62	1	57	0.0175439
NODE_2491_length_1447_cov_2.262611	1268	1325	68	1	57	0.0175439
NODE_2491_length_1447_cov_2.262611	1268	1325	73	2	57	0.0350877
NODE_2491_length_1447_cov_2.262611	1268	1325	77	2	57	0.0350877
NODE_2491_length_1447_cov_2.262611	1268	1325	79	2	57	0.0350877
NODE_2491_length_1447_cov_2.262611	1268	1325	81	4	57	0.0701754
NODE_2491_length_1447_cov_2.262611	1268	1325	83	1	57	0.0175439
NODE_2491_length_1447_cov_2.262611	1268	1325	84	3	57	0.0526316
NODE_2491_length_1447_cov_2.262611	1268	1325	86	8	57	0.1403509
NODE_2491_length_1447_cov_2.262611	1268	1325	90	5	57	0.0877193
NODE_2491_length_1447_cov_2.262611	1321	1378	80	1	57	0.0175439
NODE_2491_length_1447_cov_2.262611	1321	1378	86	9	57	0.1578947
NODE_2491_length_1447_cov_2.262611	1321	1378	88	4	57	0.0701754
NODE_2491_length_1447_cov_2.262611	1321	1378	90	10	57	0.1754386
NODE_2491_length_1447_cov_2.262611	1321	1378	92	33	57	0.5789474
NODE_2494_length_1445_cov_22.052006	759	839	0	80	80	1.0000000
NODE_2494_length_1445_cov_22.052006	812	892	0	80	80	1.0000000
NODE_2494_length_1445_cov_22.052006	888	968	0	80	80	1.0000000
NODE_2494_length_1445_cov_22.052006	941	1021	0	80	80	1.0000000
NODE_2495_length_1445_cov_13.378900	584	664	0	78	80	0.9750000
NODE_2495_length_1445_cov_13.378900	584	664	4	2	80	0.0250000
NODE_2495_length_1445_cov_13.378900	637	717	0	80	80	1.0000000
NODE_2501_length_1443_cov_7.628720	480	560	0	80	80	1.0000000
NODE_2501_length_1443_cov_7.628720	533	613	0	80	80	1.0000000
NODE_2501_length_1443_cov_7.628720	609	689	0	80	80	1.0000000
NODE_2501_length_1443_cov_7.628720	662	742	0	80	80	1.0000000
NODE_2502_length_1443_cov_4.843006	924	1004	0	80	80	1.0000000
NODE_2502_length_1443_cov_4.843006	977	1057	0	80	80	1.0000000
NODE_2508_length_1442_cov_24.551750	427	507	0	7	80	0.0875000
NODE_2508_length_1442_cov_24.551750	427	507	2	4	80	0.0500000
NODE_2508_length_1442_cov_24.551750	427	507	4	69	80	0.8625000
NODE_2508_length_1442_cov_24.551750	480	560	0	60	80	0.7500000
NODE_2508_length_1442_cov_24.551750	480	560	2	4	80	0.0500000
NODE_2508_length_1442_cov_24.551750	480	560	4	16	80	0.2000000
NODE_2508_length_1442_cov_24.551750	556	636	0	7	80	0.0875000
NODE_2508_length_1442_cov_24.551750	556	636	2	73	80	0.9125000
NODE_2508_length_1442_cov_24.551750	609	689	0	2	80	0.0250000
NODE_2508_length_1442_cov_24.551750	609	689	2	78	80	0.9750000
NODE_2509_length_1442_cov_24.032762	424	504	0	80	80	1.0000000
NODE_2509_length_1442_cov_24.032762	477	557	0	80	80	1.0000000
NODE_2511_length_1441_cov_16.528316	963	1043	0	80	80	1.0000000
NODE_2511_length_1441_cov_16.528316	1016	1096	0	68	80	0.8500000
NODE_2511_length_1441_cov_16.528316	1016	1096	2	12	80	0.1500000
NODE_2512_length_1441_cov_3.781669	80	156	0	76	76	1.0000000
NODE_2512_length_1441_cov_3.781669	129	209	0	80	80	1.0000000
NODE_2515_length_1440_cov_34.523490	446	526	0	1	80	0.0125000
NODE_2515_length_1440_cov_34.523490	446	526	3	13	80	0.1625000
NODE_2515_length_1440_cov_34.523490	446	526	4	31	80	0.3875000
NODE_2515_length_1440_cov_34.523490	446	526	8	35	80	0.4375000
NODE_2515_length_1440_cov_34.523490	499	576	4	46	77	0.5974026
NODE_2515_length_1440_cov_34.523490	499	576	8	31	77	0.4025974
NODE_2515_length_1440_cov_34.523490	576	654	4	4	78	0.0512821
NODE_2515_length_1440_cov_34.523490	576	654	19	1	78	0.0128205
NODE_2515_length_1440_cov_34.523490	576	654	20	39	78	0.5000000
NODE_2515_length_1440_cov_34.523490	576	654	22	3	78	0.0384615
NODE_2515_length_1440_cov_34.523490	576	654	24	1	78	0.0128205
NODE_2515_length_1440_cov_34.523490	576	654	28	15	78	0.1923077
NODE_2515_length_1440_cov_34.523490	576	654	30	15	78	0.1923077
NODE_2515_length_1440_cov_34.523490	627	707	27	9	80	0.1125000
NODE_2515_length_1440_cov_34.523490	627	707	28	12	80	0.1500000
NODE_2515_length_1440_cov_34.523490	627	707	30	31	80	0.3875000
NODE_2515_length_1440_cov_34.523490	627	707	31	1	80	0.0125000
NODE_2515_length_1440_cov_34.523490	627	707	33	8	80	0.1000000
NODE_2515_length_1440_cov_34.523490	627	707	34	19	80	0.2375000
NODE_2516_length_1440_cov_20.372110	776	856	0	17	80	0.2125000
NODE_2516_length_1440_cov_20.372110	776	856	3	40	80	0.5000000
NODE_2516_length_1440_cov_20.372110	776	856	6	23	80	0.2875000
NODE_2516_length_1440_cov_20.372110	829	909	0	70	80	0.8750000
NODE_2516_length_1440_cov_20.372110	829	909	3	10	80	0.1250000
NODE_2516_length_1440_cov_20.372110	905	985	0	80	80	1.0000000
NODE_2516_length_1440_cov_20.372110	958	1038	0	80	80	1.0000000
NODE_2517_length_1440_cov_14.476510	586	615	2	29	29	1.0000000
NODE_2517_length_1440_cov_14.476510	666	695	3	29	29	1.0000000
NODE_2517_length_1440_cov_14.476510	1295	1359	249	1	64	0.0156250
NODE_2517_length_1440_cov_14.476510	1295	1359	260	1	64	0.0156250
NODE_2517_length_1440_cov_14.476510	1295	1359	261	1	64	0.0156250
NODE_2517_length_1440_cov_14.476510	1295	1359	265	1	64	0.0156250
NODE_2517_length_1440_cov_14.476510	1295	1359	267	9	64	0.1406250
NODE_2517_length_1440_cov_14.476510	1295	1359	268	2	64	0.0312500
NODE_2517_length_1440_cov_14.476510	1295	1359	273	2	64	0.0312500
NODE_2517_length_1440_cov_14.476510	1295	1359	290	1	64	0.0156250
NODE_2517_length_1440_cov_14.476510	1295	1359	294	2	64	0.0312500
NODE_2517_length_1440_cov_14.476510	1295	1359	295	5	64	0.0781250
NODE_2517_length_1440_cov_14.476510	1295	1359	296	9	64	0.1406250
NODE_2517_length_1440_cov_14.476510	1295	1359	300	1	64	0.0156250
NODE_2517_length_1440_cov_14.476510	1295	1359	302	1	64	0.0156250
NODE_2517_length_1440_cov_14.476510	1295	1359	305	1	64	0.0156250
NODE_2517_length_1440_cov_14.476510	1295	1359	307	4	64	0.0625000
NODE_2517_length_1440_cov_14.476510	1295	1359	311	1	64	0.0156250
NODE_2517_length_1440_cov_14.476510	1295	1359	312	3	64	0.0468750
NODE_2517_length_1440_cov_14.476510	1295	1359	314	3	64	0.0468750
NODE_2517_length_1440_cov_14.476510	1295	1359	315	12	64	0.1875000
NODE_2517_length_1440_cov_14.476510	1295	1359	316	4	64	0.0625000
NODE_2518_length_1440_cov_9.049217	384	464	0	12	80	0.1500000
NODE_2518_length_1440_cov_9.049217	384	464	3	1	80	0.0125000
NODE_2518_length_1440_cov_9.049217	384	464	4	67	80	0.8375000
NODE_2518_length_1440_cov_9.049217	437	517	0	32	80	0.4000000
NODE_2518_length_1440_cov_9.049217	437	517	4	48	80	0.6000000
NODE_2520_length_1439_cov_11.784328	898	978	0	80	80	1.0000000
NODE_2520_length_1439_cov_11.784328	951	1031	0	80	80	1.0000000
NODE_2525_length_1438_cov_41.481703	671	751	0	11	80	0.1375000
NODE_2525_length_1438_cov_41.481703	671	751	1	50	80	0.6250000
NODE_2525_length_1438_cov_41.481703	671	751	3	19	80	0.2375000
NODE_2525_length_1438_cov_41.481703	724	804	1	8	80	0.1000000
NODE_2525_length_1438_cov_41.481703	724	804	3	72	80	0.9000000
NODE_2529_length_1437_cov_14.449178	815	895	0	23	80	0.2875000
NODE_2529_length_1437_cov_14.449178	815	895	2	57	80	0.7125000
NODE_2529_length_1437_cov_14.449178	868	948	0	18	80	0.2250000
NODE_2529_length_1437_cov_14.449178	868	948	2	62	80	0.7750000
NODE_2529_length_1437_cov_14.449178	944	1024	0	80	80	1.0000000
NODE_2529_length_1437_cov_14.449178	997	1077	0	80	80	1.0000000
NODE_2532_length_1436_cov_96.256545	1145	1225	0	80	80	1.0000000
NODE_2532_length_1436_cov_96.256545	1198	1278	0	80	80	1.0000000
NODE_2532_length_1436_cov_96.256545	1274	1354	0	80	80	1.0000000
NODE_2532_length_1436_cov_96.256545	1327	1407	0	80	80	1.0000000
NODE_2536_length_1435_cov_21.468563	783	863	0	80	80	1.0000000
NODE_2536_length_1435_cov_21.468563	836	916	0	80	80	1.0000000
NODE_2536_length_1435_cov_21.468563	912	992	0	80	80	1.0000000
NODE_2536_length_1435_cov_21.468563	965	1045	0	80	80	1.0000000
NODE_2537_length_1435_cov_18.593563	1123	1203	0	11	80	0.1375000
NODE_2537_length_1435_cov_18.593563	1123	1203	1	20	80	0.2500000
NODE_2537_length_1435_cov_18.593563	1123	1203	2	11	80	0.1375000
NODE_2537_length_1435_cov_18.593563	1123	1203	4	32	80	0.4000000
NODE_2537_length_1435_cov_18.593563	1123	1203	6	6	80	0.0750000
NODE_2537_length_1435_cov_18.593563	1176	1256	0	43	80	0.5375000
NODE_2537_length_1435_cov_18.593563	1176	1256	1	27	80	0.3375000
NODE_2537_length_1435_cov_18.593563	1176	1256	3	2	80	0.0250000
NODE_2537_length_1435_cov_18.593563	1176	1256	4	3	80	0.0375000
NODE_2537_length_1435_cov_18.593563	1176	1256	10	2	80	0.0250000
NODE_2537_length_1435_cov_18.593563	1176	1256	11	3	80	0.0375000
NODE_2538_length_1435_cov_5.828593	299	379	0	6	80	0.0750000
NODE_2538_length_1435_cov_5.828593	299	379	2	74	80	0.9250000
NODE_2538_length_1435_cov_5.828593	352	432	0	59	80	0.7375000
NODE_2538_length_1435_cov_5.828593	352	432	2	21	80	0.2625000
NODE_2540_length_1434_cov_17.610487	1023	1103	0	80	80	1.0000000
NODE_2540_length_1434_cov_17.610487	1076	1156	0	80	80	1.0000000
NODE_2540_length_1434_cov_17.610487	1152	1232	0	80	80	1.0000000
NODE_2540_length_1434_cov_17.610487	1205	1285	0	80	80	1.0000000
NODE_2541_length_1434_cov_9.845693	846	926	0	49	80	0.6125000
NODE_2541_length_1434_cov_9.845693	846	926	2	31	80	0.3875000
NODE_2541_length_1434_cov_9.845693	899	978	2	79	79	1.0000000
NODE_2544_length_1433_cov_36.452774	538	618	1	49	80	0.6125000
NODE_2544_length_1433_cov_36.452774	538	618	3	29	80	0.3625000
NODE_2544_length_1433_cov_36.452774	538	618	5	2	80	0.0250000
NODE_2544_length_1433_cov_36.452774	591	671	0	30	80	0.3750000
NODE_2544_length_1433_cov_36.452774	591	671	1	50	80	0.6250000
NODE_2544_length_1433_cov_36.452774	667	747	0	63	80	0.7875000
NODE_2544_length_1433_cov_36.452774	667	747	1	11	80	0.1375000
NODE_2544_length_1433_cov_36.452774	667	747	5	6	80	0.0750000
NODE_2544_length_1433_cov_36.452774	720	800	0	10	80	0.1250000
NODE_2544_length_1433_cov_36.452774	720	800	1	11	80	0.1375000
NODE_2544_length_1433_cov_36.452774	720	800	5	59	80	0.7375000
NODE_2550_length_1431_cov_7.409159	513	593	0	33	80	0.4125000
NODE_2550_length_1431_cov_7.409159	513	593	2	23	80	0.2875000
NODE_2550_length_1431_cov_7.409159	513	593	4	24	80	0.3000000
NODE_2550_length_1431_cov_7.409159	566	646	2	3	80	0.0375000
NODE_2550_length_1431_cov_7.409159	566	646	4	34	80	0.4250000
NODE_2550_length_1431_cov_7.409159	566	646	6	43	80	0.5375000
NODE_2551_length_1431_cov_6.721471	1074	1154	0	80	80	1.0000000
NODE_2551_length_1431_cov_6.721471	1127	1207	0	80	80	1.0000000
NODE_2552_length_1430_cov_32.643877	753	833	0	80	80	1.0000000
NODE_2552_length_1430_cov_32.643877	806	886	0	80	80	1.0000000
NODE_2552_length_1430_cov_32.643877	882	962	0	80	80	1.0000000
NODE_2552_length_1430_cov_32.643877	935	1016	0	27	81	0.3333333
NODE_2552_length_1430_cov_32.643877	935	1016	2	54	81	0.6666667
NODE_2557_length_1428_cov_5.895410	340	416	0	76	76	1.0000000
NODE_2557_length_1428_cov_5.895410	393	476	0	83	83	1.0000000
NODE_2560_length_1427_cov_38.919428	707	787	2	57	80	0.7125000
NODE_2560_length_1427_cov_38.919428	707	787	5	17	80	0.2125000
NODE_2560_length_1427_cov_38.919428	707	787	6	6	80	0.0750000
NODE_2560_length_1427_cov_38.919428	760	840	2	4	80	0.0500000
NODE_2560_length_1427_cov_38.919428	760	840	4	52	80	0.6500000
NODE_2560_length_1427_cov_38.919428	760	840	5	18	80	0.2250000
NODE_2560_length_1427_cov_38.919428	760	840	6	6	80	0.0750000
NODE_2560_length_1427_cov_38.919428	836	916	0	63	80	0.7875000
NODE_2560_length_1427_cov_38.919428	836	916	4	17	80	0.2125000
NODE_2560_length_1427_cov_38.919428	889	969	0	31	80	0.3875000
NODE_2560_length_1427_cov_38.919428	889	969	2	49	80	0.6125000
NODE_2561_length_1427_cov_19.442771	808	888	0	41	80	0.5125000
NODE_2561_length_1427_cov_19.442771	808	888	4	6	80	0.0750000
NODE_2561_length_1427_cov_19.442771	808	888	8	33	80	0.4125000
NODE_2561_length_1427_cov_19.442771	861	941	8	80	80	1.0000000
NODE_2561_length_1427_cov_19.442771	937	1017	0	57	80	0.7125000
NODE_2561_length_1427_cov_19.442771	937	1017	4	16	80	0.2000000
NODE_2561_length_1427_cov_19.442771	937	1017	8	7	80	0.0875000
NODE_2561_length_1427_cov_19.442771	990	1070	0	80	80	1.0000000
NODE_2562_length_1427_cov_10.490964	728	808	0	80	80	1.0000000
NODE_2562_length_1427_cov_10.490964	781	861	0	80	80	1.0000000
NODE_2562_length_1427_cov_10.490964	857	937	0	80	80	1.0000000
NODE_2562_length_1427_cov_10.490964	910	990	0	80	80	1.0000000
NODE_2563_length_1427_cov_9.929217	646	726	0	80	80	1.0000000
NODE_2563_length_1427_cov_9.929217	699	779	0	80	80	1.0000000
NODE_2563_length_1427_cov_9.929217	775	855	0	80	80	1.0000000
NODE_2563_length_1427_cov_9.929217	828	908	0	80	80	1.0000000
NODE_2563_length_1427_cov_9.929217	1248	1324	0	14	76	0.1842105
NODE_2563_length_1427_cov_9.929217	1248	1324	2	62	76	0.8157895
NODE_2563_length_1427_cov_9.929217	1301	1376	0	53	75	0.7066666
NODE_2563_length_1427_cov_9.929217	1301	1376	2	22	75	0.2933333
NODE_2564_length_1427_cov_3.122741	1336	1399	0	63	63	1.0000000
NODE_2570_length_1426_cov_36.580256	422	502	0	80	80	1.0000000
NODE_2570_length_1426_cov_36.580256	475	555	0	80	80	1.0000000
NODE_2570_length_1426_cov_36.580256	551	631	0	80	80	1.0000000
NODE_2570_length_1426_cov_36.580256	604	684	0	75	80	0.9375000
NODE_2570_length_1426_cov_36.580256	604	684	2	5	80	0.0625000
NODE_2574_length_1425_cov_25.524133	561	641	30	65	80	0.8125000
NODE_2574_length_1425_cov_25.524133	561	641	31	15	80	0.1875000
NODE_2574_length_1425_cov_25.524133	614	694	16	10	80	0.1250000
NODE_2574_length_1425_cov_25.524133	614	694	29	1	80	0.0125000
NODE_2574_length_1425_cov_25.524133	614	694	30	19	80	0.2375000
NODE_2574_length_1425_cov_25.524133	614	694	31	50	80	0.6250000
NODE_2575_length_1425_cov_10.175716	361	441	2	23	80	0.2875000
NODE_2575_length_1425_cov_10.175716	361	441	10	57	80	0.7125000
NODE_2575_length_1425_cov_10.175716	414	494	10	80	80	1.0000000
NODE_2587_length_1423_cov_31.158610	862	942	0	7	80	0.0875000
NODE_2587_length_1423_cov_31.158610	862	942	5	1	80	0.0125000
NODE_2587_length_1423_cov_31.158610	862	942	6	72	80	0.9000000
NODE_2587_length_1423_cov_31.158610	915	995	0	60	80	0.7500000
NODE_2587_length_1423_cov_31.158610	915	995	5	1	80	0.0125000
NODE_2587_length_1423_cov_31.158610	915	995	6	19	80	0.2375000
NODE_2588_length_1423_cov_30.731873	764	844	4	80	80	1.0000000
NODE_2588_length_1423_cov_30.731873	817	897	0	52	80	0.6500000
NODE_2588_length_1423_cov_30.731873	817	897	3	1	80	0.0125000
NODE_2588_length_1423_cov_30.731873	817	897	4	27	80	0.3375000
NODE_2596_length_1421_cov_8.285930	136	212	134	1	76	0.0131579
NODE_2596_length_1421_cov_8.285930	136	212	136	5	76	0.0657895
NODE_2596_length_1421_cov_8.285930	136	212	138	1	76	0.0131579
NODE_2596_length_1421_cov_8.285930	136	212	140	1	76	0.0131579
NODE_2596_length_1421_cov_8.285930	136	212	141	1	76	0.0131579
NODE_2596_length_1421_cov_8.285930	136	212	142	5	76	0.0657895
NODE_2596_length_1421_cov_8.285930	136	212	143	7	76	0.0921053
NODE_2596_length_1421_cov_8.285930	136	212	144	1	76	0.0131579
NODE_2596_length_1421_cov_8.285930	136	212	145	7	76	0.0921053
NODE_2596_length_1421_cov_8.285930	136	212	147	2	76	0.0263158
NODE_2596_length_1421_cov_8.285930	136	212	159	1	76	0.0131579
NODE_2596_length_1421_cov_8.285930	136	212	166	1	76	0.0131579
NODE_2596_length_1421_cov_8.285930	136	212	167	2	76	0.0263158
NODE_2596_length_1421_cov_8.285930	136	212	170	2	76	0.0263158
NODE_2596_length_1421_cov_8.285930	136	212	171	1	76	0.0131579
NODE_2596_length_1421_cov_8.285930	136	212	173	2	76	0.0263158
NODE_2596_length_1421_cov_8.285930	136	212	175	1	76	0.0131579
NODE_2596_length_1421_cov_8.285930	136	212	179	1	76	0.0131579
NODE_2596_length_1421_cov_8.285930	136	212	187	2	76	0.0263158
NODE_2596_length_1421_cov_8.285930	136	212	189	1	76	0.0131579
NODE_2596_length_1421_cov_8.285930	136	212	193	1	76	0.0131579
NODE_2596_length_1421_cov_8.285930	136	212	195	2	76	0.0263158
NODE_2596_length_1421_cov_8.285930	136	212	196	1	76	0.0131579
NODE_2596_length_1421_cov_8.285930	136	212	199	4	76	0.0526316
NODE_2596_length_1421_cov_8.285930	136	212	200	1	76	0.0131579
NODE_2596_length_1421_cov_8.285930	136	212	204	4	76	0.0526316
NODE_2596_length_1421_cov_8.285930	136	212	205	1	76	0.0131579
NODE_2596_length_1421_cov_8.285930	136	212	206	2	76	0.0263158
NODE_2596_length_1421_cov_8.285930	136	212	208	1	76	0.0131579
NODE_2596_length_1421_cov_8.285930	136	212	209	2	76	0.0263158
NODE_2596_length_1421_cov_8.285930	136	212	210	3	76	0.0394737
NODE_2596_length_1421_cov_8.285930	136	212	212	2	76	0.0263158
NODE_2596_length_1421_cov_8.285930	136	212	213	3	76	0.0394737
NODE_2596_length_1421_cov_8.285930	136	212	215	1	76	0.0131579
NODE_2596_length_1421_cov_8.285930	136	212	216	2	76	0.0263158
NODE_2596_length_1421_cov_8.285930	136	212	218	1	76	0.0131579
NODE_2598_length_1421_cov_2.574130	22	102	8	80	80	1.0000000
NODE_2598_length_1421_cov_2.574130	75	132	0	1	57	0.0175439
NODE_2598_length_1421_cov_2.574130	75	132	4	21	57	0.3684210
NODE_2598_length_1421_cov_2.574130	75	132	6	2	57	0.0350877
NODE_2598_length_1421_cov_2.574130	75	132	8	33	57	0.5789474
NODE_2599_length_1420_cov_256.442846	60	140	4	48	80	0.6000000
NODE_2599_length_1420_cov_256.442846	60	140	6	13	80	0.1625000
NODE_2599_length_1420_cov_256.442846	60	140	8	11	80	0.1375000
NODE_2599_length_1420_cov_256.442846	60	140	10	8	80	0.1000000
NODE_2599_length_1420_cov_256.442846	1294	1360	16	8	66	0.1212121
NODE_2599_length_1420_cov_256.442846	1294	1360	18	2	66	0.0303030
NODE_2599_length_1420_cov_256.442846	1294	1360	20	6	66	0.0909091
NODE_2599_length_1420_cov_256.442846	1294	1360	24	1	66	0.0151515
NODE_2599_length_1420_cov_256.442846	1294	1360	26	1	66	0.0151515
NODE_2599_length_1420_cov_256.442846	1294	1360	28	48	66	0.7272727
NODE_2600_length_1420_cov_7.547313	628	708	0	80	80	1.0000000
NODE_2600_length_1420_cov_7.547313	681	761	0	80	80	1.0000000
NODE_2602_length_1420_cov_2.051476	972	1039	0	67	67	1.0000000
NODE_2604_length_1419_cov_46.997727	1230	1305	9	30	75	0.4000000
NODE_2604_length_1419_cov_46.997727	1230	1305	16	24	75	0.3200000
NODE_2604_length_1419_cov_46.997727	1230	1305	18	21	75	0.2800000
NODE_2604_length_1419_cov_46.997727	1278	1332	16	6	54	0.1111111
NODE_2604_length_1419_cov_46.997727	1278	1332	18	34	54	0.6296296
NODE_2604_length_1419_cov_46.997727	1278	1332	20	14	54	0.2592593
NODE_2609_length_1418_cov_11.373010	432	512	0	80	80	1.0000000
NODE_2609_length_1418_cov_11.373010	485	556	0	71	71	1.0000000
NODE_2615_length_1417_cov_12.477997	354	399	0	45	45	1.0000000
NODE_2616_length_1417_cov_11.120637	794	874	0	34	80	0.4250000
NODE_2616_length_1417_cov_11.120637	794	874	2	46	80	0.5750000
NODE_2616_length_1417_cov_11.120637	847	927	0	60	80	0.7500000
NODE_2616_length_1417_cov_11.120637	847	927	2	20	80	0.2500000
NODE_2625_length_1415_cov_51.375380	423	503	0	56	80	0.7000000
NODE_2625_length_1415_cov_51.375380	423	503	2	24	80	0.3000000
NODE_2625_length_1415_cov_51.375380	476	556	0	17	80	0.2125000
NODE_2625_length_1415_cov_51.375380	476	556	2	63	80	0.7875000
NODE_2625_length_1415_cov_51.375380	552	632	0	80	80	1.0000000
NODE_2625_length_1415_cov_51.375380	605	683	0	78	78	1.0000000
NODE_2626_length_1415_cov_38.272036	513	593	2	13	80	0.1625000
NODE_2626_length_1415_cov_38.272036	513	593	4	67	80	0.8375000
NODE_2626_length_1415_cov_38.272036	566	646	0	17	80	0.2125000
NODE_2626_length_1415_cov_38.272036	566	646	2	49	80	0.6125000
NODE_2626_length_1415_cov_38.272036	566	646	4	14	80	0.1750000
NODE_2627_length_1415_cov_17.232523	642	722	0	24	80	0.3000000
NODE_2627_length_1415_cov_17.232523	642	722	4	56	80	0.7000000
NODE_2627_length_1415_cov_17.232523	695	775	0	4	80	0.0500000
NODE_2627_length_1415_cov_17.232523	695	775	4	76	80	0.9500000
NODE_2629_length_1414_cov_5.307985	1026	1106	4	19	80	0.2375000
NODE_2629_length_1414_cov_5.307985	1026	1106	6	61	80	0.7625000
NODE_2629_length_1414_cov_5.307985	1079	1159	0	35	80	0.4375000
NODE_2629_length_1414_cov_5.307985	1079	1159	2	18	80	0.2250000
NODE_2629_length_1414_cov_5.307985	1079	1159	4	19	80	0.2375000
NODE_2629_length_1414_cov_5.307985	1079	1159	6	8	80	0.1000000
NODE_2637_length_1412_cov_17.723534	875	955	2	1	80	0.0125000
NODE_2637_length_1412_cov_17.723534	875	955	4	75	80	0.9375000
NODE_2637_length_1412_cov_17.723534	875	955	6	4	80	0.0500000
NODE_2637_length_1412_cov_17.723534	928	1008	0	40	80	0.5000000
NODE_2637_length_1412_cov_17.723534	928	1008	4	40	80	0.5000000
NODE_2641_length_1411_cov_34.004573	516	596	0	80	80	1.0000000
NODE_2641_length_1411_cov_34.004573	569	649	0	59	80	0.7375000
NODE_2641_length_1411_cov_34.004573	569	649	4	21	80	0.2625000
NODE_2641_length_1411_cov_34.004573	645	725	4	80	80	1.0000000
NODE_2641_length_1411_cov_34.004573	698	778	0	44	80	0.5500000
NODE_2641_length_1411_cov_34.004573	698	778	2	6	80	0.0750000
NODE_2641_length_1411_cov_34.004573	698	778	3	1	80	0.0125000
NODE_2641_length_1411_cov_34.004573	698	778	4	29	80	0.3625000
NODE_2643_length_1409_cov_25.380153	828	908	3	6	80	0.0750000
NODE_2643_length_1409_cov_25.380153	828	908	4	4	80	0.0500000
NODE_2643_length_1409_cov_25.380153	828	908	6	36	80	0.4500000
NODE_2643_length_1409_cov_25.380153	828	908	8	23	80	0.2875000
NODE_2643_length_1409_cov_25.380153	828	908	10	6	80	0.0750000
NODE_2643_length_1409_cov_25.380153	828	908	12	5	80	0.0625000
NODE_2643_length_1409_cov_25.380153	881	961	8	17	80	0.2125000
NODE_2643_length_1409_cov_25.380153	881	961	10	24	80	0.3000000
NODE_2643_length_1409_cov_25.380153	881	961	12	39	80	0.4875000
NODE_2644_length_1409_cov_13.028244	349	405	58	7	56	0.1250000
NODE_2644_length_1409_cov_13.028244	349	405	61	2	56	0.0357143
NODE_2644_length_1409_cov_13.028244	349	405	63	1	56	0.0178571
NODE_2644_length_1409_cov_13.028244	349	405	64	2	56	0.0357143
NODE_2644_length_1409_cov_13.028244	349	405	65	4	56	0.0714286
NODE_2644_length_1409_cov_13.028244	349	405	66	12	56	0.2142857
NODE_2644_length_1409_cov_13.028244	349	405	67	1	56	0.0178571
NODE_2644_length_1409_cov_13.028244	349	405	69	3	56	0.0535714
NODE_2644_length_1409_cov_13.028244	349	405	70	15	56	0.2678571
NODE_2644_length_1409_cov_13.028244	349	405	71	2	56	0.0357143
NODE_2644_length_1409_cov_13.028244	349	405	72	3	56	0.0535714
NODE_2644_length_1409_cov_13.028244	349	405	73	1	56	0.0178571
NODE_2644_length_1409_cov_13.028244	349	405	79	3	56	0.0535714
NODE_2644_length_1409_cov_13.028244	416	482	46	3	66	0.0454545
NODE_2644_length_1409_cov_13.028244	416	482	48	8	66	0.1212121
NODE_2644_length_1409_cov_13.028244	416	482	50	8	66	0.1212121
NODE_2644_length_1409_cov_13.028244	416	482	51	7	66	0.1060606
NODE_2644_length_1409_cov_13.028244	416	482	54	14	66	0.2121212
NODE_2644_length_1409_cov_13.028244	416	482	55	2	66	0.0303030
NODE_2644_length_1409_cov_13.028244	416	482	56	10	66	0.1515152
NODE_2644_length_1409_cov_13.028244	416	482	57	5	66	0.0757576
NODE_2644_length_1409_cov_13.028244	416	482	58	4	66	0.0606061
NODE_2644_length_1409_cov_13.028244	416	482	59	2	66	0.0303030
NODE_2644_length_1409_cov_13.028244	416	482	60	1	66	0.0151515
NODE_2644_length_1409_cov_13.028244	416	482	62	2	66	0.0303030
NODE_2648_length_1408_cov_6.261268	492	572	0	80	80	1.0000000
NODE_2648_length_1408_cov_6.261268	545	625	0	80	80	1.0000000
NODE_2652_length_1407_cov_27.711009	772	852	13	7	80	0.0875000
NODE_2652_length_1407_cov_27.711009	772	852	14	3	80	0.0375000
NODE_2652_length_1407_cov_27.711009	772	852	15	8	80	0.1000000
NODE_2652_length_1407_cov_27.711009	772	852	17	5	80	0.0625000
NODE_2652_length_1407_cov_27.711009	772	852	23	10	80	0.1250000
NODE_2652_length_1407_cov_27.711009	772	852	24	47	80	0.5875000
NODE_2652_length_1407_cov_27.711009	825	905	3	12	80	0.1500000
NODE_2652_length_1407_cov_27.711009	825	905	4	13	80	0.1625000
NODE_2652_length_1407_cov_27.711009	825	905	14	2	80	0.0250000
NODE_2652_length_1407_cov_27.711009	825	905	20	22	80	0.2750000
NODE_2652_length_1407_cov_27.711009	825	905	24	31	80	0.3875000
NODE_2653_length_1407_cov_24.387615	586	666	2	80	80	1.0000000
NODE_2653_length_1407_cov_24.387615	639	719	0	39	80	0.4875000
NODE_2653_length_1407_cov_24.387615	639	719	2	41	80	0.5125000
NODE_2653_length_1407_cov_24.387615	715	795	0	9	80	0.1125000
NODE_2653_length_1407_cov_24.387615	715	795	2	1	80	0.0125000
NODE_2653_length_1407_cov_24.387615	715	795	3	12	80	0.1500000
NODE_2653_length_1407_cov_24.387615	715	795	6	58	80	0.7250000
NODE_2653_length_1407_cov_24.387615	768	848	6	46	80	0.5750000
NODE_2653_length_1407_cov_24.387615	768	848	8	34	80	0.4250000
NODE_2654_length_1407_cov_19.022936	551	629	14	4	78	0.0512821
NODE_2654_length_1407_cov_19.022936	551	629	15	1	78	0.0128205
NODE_2654_length_1407_cov_19.022936	551	629	20	5	78	0.0641026
NODE_2654_length_1407_cov_19.022936	551	629	21	26	78	0.3333333
NODE_2654_length_1407_cov_19.022936	551	629	25	19	78	0.2435897
NODE_2654_length_1407_cov_19.022936	551	629	26	23	78	0.2948718
NODE_2654_length_1407_cov_19.022936	602	665	1	1	63	0.0158730
NODE_2654_length_1407_cov_19.022936	602	665	2	3	63	0.0476190
NODE_2654_length_1407_cov_19.022936	602	665	6	11	63	0.1746032
NODE_2654_length_1407_cov_19.022936	602	665	7	15	63	0.2380952
NODE_2654_length_1407_cov_19.022936	602	665	15	1	63	0.0158730
NODE_2654_length_1407_cov_19.022936	602	665	16	6	63	0.0952381
NODE_2654_length_1407_cov_19.022936	602	665	21	26	63	0.4126984
NODE_2655_length_1407_cov_11.266820	813	893	0	80	80	1.0000000
NODE_2655_length_1407_cov_11.266820	866	946	0	80	80	1.0000000
NODE_2655_length_1407_cov_11.266820	942	1022	0	80	80	1.0000000
NODE_2655_length_1407_cov_11.266820	995	1075	0	80	80	1.0000000
NODE_2657_length_1406_cov_7.247896	761	841	0	80	80	1.0000000
NODE_2657_length_1406_cov_7.247896	814	894	0	80	80	1.0000000
NODE_2659_length_1404_cov_23.406130	826	906	4	80	80	1.0000000
NODE_2659_length_1404_cov_23.406130	879	959	0	6	80	0.0750000
NODE_2659_length_1404_cov_23.406130	879	959	2	33	80	0.4125000
NODE_2659_length_1404_cov_23.406130	879	959	4	41	80	0.5125000
NODE_2659_length_1404_cov_23.406130	955	1035	0	4	80	0.0500000
NODE_2659_length_1404_cov_23.406130	955	1035	2	76	80	0.9500000
NODE_2659_length_1404_cov_23.406130	1008	1088	0	15	80	0.1875000
NODE_2659_length_1404_cov_23.406130	1008	1088	2	65	80	0.8125000
NODE_2666_length_1403_cov_14.331288	325	405	0	80	80	1.0000000
NODE_2666_length_1403_cov_14.331288	378	458	0	80	80	1.0000000
NODE_2666_length_1403_cov_14.331288	454	534	0	80	80	1.0000000
NODE_2666_length_1403_cov_14.331288	454	534	0	80	80	1.0000000
NODE_2666_length_1403_cov_14.331288	454	524	0	70	70	1.0000000
NODE_2666_length_1403_cov_14.331288	507	587	0	79	80	0.9875000
NODE_2666_length_1403_cov_14.331288	507	587	2	1	80	0.0125000
NODE_2666_length_1403_cov_14.331288	507	579	0	72	72	1.0000000
NODE_2668_length_1402_cov_29.095165	610	690	0	26	80	0.3250000
NODE_2668_length_1402_cov_29.095165	610	690	2	54	80	0.6750000
NODE_2668_length_1402_cov_29.095165	663	743	0	36	80	0.4500000
NODE_2668_length_1402_cov_29.095165	663	743	2	44	80	0.5500000
NODE_2669_length_1402_cov_23.411358	528	608	0	80	80	1.0000000
NODE_2669_length_1402_cov_23.411358	581	661	0	80	80	1.0000000
NODE_2669_length_1402_cov_23.411358	657	737	0	20	80	0.2500000
NODE_2669_length_1402_cov_23.411358	657	737	4	1	80	0.0125000
NODE_2669_length_1402_cov_23.411358	657	737	7	1	80	0.0125000
NODE_2669_length_1402_cov_23.411358	657	737	8	58	80	0.7250000
NODE_2669_length_1402_cov_23.411358	710	790	5	10	80	0.1250000
NODE_2669_length_1402_cov_23.411358	710	790	7	42	80	0.5250000
NODE_2669_length_1402_cov_23.411358	710	790	8	28	80	0.3500000
NODE_2670_length_1402_cov_11.732924	661	741	0	80	80	1.0000000
NODE_2670_length_1402_cov_11.732924	714	794	0	80	80	1.0000000
NODE_2671_length_1402_cov_9.929394	766	846	0	12	80	0.1500000
NODE_2671_length_1402_cov_9.929394	766	846	2	2	80	0.0250000
NODE_2671_length_1402_cov_9.929394	766	846	6	66	80	0.8250000
NODE_2671_length_1402_cov_9.929394	819	899	6	80	80	1.0000000
NODE_2677_length_1401_cov_35.754992	825	905	0	80	80	1.0000000
NODE_2677_length_1401_cov_35.754992	878	958	0	80	80	1.0000000
NODE_2678_length_1401_cov_10.811828	539	619	0	80	80	1.0000000
NODE_2678_length_1401_cov_10.811828	592	672	0	80	80	1.0000000
NODE_2679_length_1401_cov_5.438556	241	321	0	59	80	0.7375000
NODE_2679_length_1401_cov_5.438556	241	321	4	21	80	0.2625000
NODE_2679_length_1401_cov_5.438556	294	374	0	13	80	0.1625000
NODE_2679_length_1401_cov_5.438556	294	374	4	67	80	0.8375000
NODE_2683_length_1400_cov_16.680246	813	893	0	80	80	1.0000000
NODE_2683_length_1400_cov_16.680246	866	946	0	80	80	1.0000000
NODE_2684_length_1400_cov_8.166795	53	133	0	21	80	0.2625000
NODE_2684_length_1400_cov_8.166795	53	133	2	21	80	0.2625000
NODE_2684_length_1400_cov_8.166795	53	133	4	23	80	0.2875000
NODE_2684_length_1400_cov_8.166795	53	133	6	15	80	0.1875000
NODE_2684_length_1400_cov_8.166795	106	186	4	19	80	0.2375000
NODE_2684_length_1400_cov_8.166795	106	186	6	61	80	0.7625000
NODE_2694_length_1397_cov_25.549307	869	918	19	2	49	0.0408163
NODE_2694_length_1397_cov_25.549307	869	918	21	6	49	0.1224490
NODE_2694_length_1397_cov_25.549307	869	918	22	5	49	0.1020408
NODE_2694_length_1397_cov_25.549307	869	918	23	2	49	0.0408163
NODE_2694_length_1397_cov_25.549307	869	918	25	9	49	0.1836735
NODE_2694_length_1397_cov_25.549307	869	918	28	8	49	0.1632653
NODE_2694_length_1397_cov_25.549307	869	918	29	17	49	0.3469388
NODE_2694_length_1397_cov_25.549307	891	971	8	4	80	0.0500000
NODE_2694_length_1397_cov_25.549307	891	971	12	8	80	0.1000000
NODE_2694_length_1397_cov_25.549307	891	971	22	13	80	0.1625000
NODE_2694_length_1397_cov_25.549307	891	971	24	3	80	0.0375000
NODE_2694_length_1397_cov_25.549307	891	971	25	4	80	0.0500000
NODE_2694_length_1397_cov_25.549307	891	971	26	1	80	0.0125000
NODE_2694_length_1397_cov_25.549307	891	971	27	8	80	0.1000000
NODE_2694_length_1397_cov_25.549307	891	971	28	22	80	0.2750000
NODE_2694_length_1397_cov_25.549307	891	971	29	17	80	0.2125000
NODE_2695_length_1397_cov_14.395223	672	752	0	6	80	0.0750000
NODE_2695_length_1397_cov_14.395223	672	752	1	74	80	0.9250000
NODE_2695_length_1397_cov_14.395223	725	805	1	80	80	1.0000000
NODE_2695_length_1397_cov_14.395223	801	881	0	12	80	0.1500000
NODE_2695_length_1397_cov_14.395223	801	881	1	68	80	0.8500000
NODE_2695_length_1397_cov_14.395223	854	934	0	65	80	0.8125000
NODE_2695_length_1397_cov_14.395223	854	934	1	15	80	0.1875000
NODE_2699_length_1396_cov_21.656130	825	905	2	80	80	1.0000000
NODE_2699_length_1396_cov_21.656130	878	958	0	10	80	0.1250000
NODE_2699_length_1396_cov_21.656130	878	958	1	26	80	0.3250000
NODE_2699_length_1396_cov_21.656130	878	958	2	44	80	0.5500000
NODE_2700_length_1396_cov_18.108712	560	640	0	50	80	0.6250000
NODE_2700_length_1396_cov_18.108712	560	640	4	30	80	0.3750000
NODE_2700_length_1396_cov_18.108712	613	693	4	80	80	1.0000000
NODE_2701_length_1396_cov_16.208944	136	198	51	1	62	0.0161290
NODE_2701_length_1396_cov_16.208944	136	198	61	1	62	0.0161290
NODE_2701_length_1396_cov_16.208944	136	198	63	1	62	0.0161290
NODE_2701_length_1396_cov_16.208944	136	198	64	2	62	0.0322581
NODE_2701_length_1396_cov_16.208944	136	198	65	6	62	0.0967742
NODE_2701_length_1396_cov_16.208944	136	198	68	1	62	0.0161290
NODE_2701_length_1396_cov_16.208944	136	198	72	1	62	0.0161290
NODE_2701_length_1396_cov_16.208944	136	198	75	3	62	0.0483871
NODE_2701_length_1396_cov_16.208944	136	198	77	2	62	0.0322581
NODE_2701_length_1396_cov_16.208944	136	198	79	1	62	0.0161290
NODE_2701_length_1396_cov_16.208944	136	198	80	2	62	0.0322581
NODE_2701_length_1396_cov_16.208944	136	198	82	2	62	0.0322581
NODE_2701_length_1396_cov_16.208944	136	198	88	2	62	0.0322581
NODE_2701_length_1396_cov_16.208944	136	198	91	1	62	0.0161290
NODE_2701_length_1396_cov_16.208944	136	198	96	2	62	0.0322581
NODE_2701_length_1396_cov_16.208944	136	198	97	1	62	0.0161290
NODE_2701_length_1396_cov_16.208944	136	198	101	1	62	0.0161290
NODE_2701_length_1396_cov_16.208944	136	198	103	2	62	0.0322581
NODE_2701_length_1396_cov_16.208944	136	198	117	2	62	0.0322581
NODE_2701_length_1396_cov_16.208944	136	198	121	1	62	0.0161290
NODE_2701_length_1396_cov_16.208944	136	198	123	1	62	0.0161290
NODE_2701_length_1396_cov_16.208944	136	198	129	1	62	0.0161290
NODE_2701_length_1396_cov_16.208944	136	198	139	2	62	0.0322581
NODE_2701_length_1396_cov_16.208944	136	198	141	1	62	0.0161290
NODE_2701_length_1396_cov_16.208944	136	198	147	1	62	0.0161290
NODE_2701_length_1396_cov_16.208944	136	198	151	1	62	0.0161290
NODE_2701_length_1396_cov_16.208944	136	198	155	1	62	0.0161290
NODE_2701_length_1396_cov_16.208944	136	198	158	1	62	0.0161290
NODE_2701_length_1396_cov_16.208944	136	198	162	2	62	0.0322581
NODE_2701_length_1396_cov_16.208944	136	198	164	1	62	0.0161290
NODE_2701_length_1396_cov_16.208944	136	198	166	1	62	0.0161290
NODE_2701_length_1396_cov_16.208944	136	198	173	1	62	0.0161290
NODE_2701_length_1396_cov_16.208944	136	198	174	1	62	0.0161290
NODE_2701_length_1396_cov_16.208944	136	198	176	1	62	0.0161290
NODE_2701_length_1396_cov_16.208944	136	198	178	2	62	0.0322581
NODE_2701_length_1396_cov_16.208944	136	198	180	1	62	0.0161290
NODE_2701_length_1396_cov_16.208944	136	198	185	1	62	0.0161290
NODE_2701_length_1396_cov_16.208944	136	198	187	2	62	0.0322581
NODE_2701_length_1396_cov_16.208944	136	198	190	1	62	0.0161290
NODE_2701_length_1396_cov_16.208944	136	198	193	2	62	0.0322581
NODE_2701_length_1396_cov_16.208944	136	198	196	1	62	0.0161290
NODE_2701_length_1396_cov_16.208944	136	198	199	1	62	0.0161290
NODE_2701_length_1396_cov_16.208944	848	928	0	14	80	0.1750000
NODE_2701_length_1396_cov_16.208944	848	928	2	66	80	0.8250000
NODE_2701_length_1396_cov_16.208944	901	981	0	67	80	0.8375000
NODE_2701_length_1396_cov_16.208944	901	981	2	13	80	0.1625000
NODE_2701_length_1396_cov_16.208944	977	1057	0	80	80	1.0000000
NODE_2701_length_1396_cov_16.208944	1030	1110	0	80	80	1.0000000
NODE_2702_length_1396_cov_9.196608	428	508	0	80	80	1.0000000
NODE_2702_length_1396_cov_9.196608	481	561	0	80	80	1.0000000
NODE_2712_length_1394_cov_29.602317	349	415	0	61	66	0.9242424
NODE_2712_length_1394_cov_29.602317	349	415	2	5	66	0.0757576
NODE_2712_length_1394_cov_29.602317	349	416	0	62	67	0.9253731
NODE_2712_length_1394_cov_29.602317	349	416	2	5	67	0.0746269
NODE_2712_length_1394_cov_29.602317	1117	1197	2	23	80	0.2875000
NODE_2712_length_1394_cov_29.602317	1117	1197	6	23	80	0.2875000
NODE_2712_length_1394_cov_29.602317	1117	1197	8	11	80	0.1375000
NODE_2712_length_1394_cov_29.602317	1117	1197	16	6	80	0.0750000
NODE_2712_length_1394_cov_29.602317	1117	1197	18	17	80	0.2125000
NODE_2712_length_1394_cov_29.602317	1170	1250	6	4	80	0.0500000
NODE_2712_length_1394_cov_29.602317	1170	1250	14	18	80	0.2250000
NODE_2712_length_1394_cov_29.602317	1170	1250	16	6	80	0.0750000
NODE_2712_length_1394_cov_29.602317	1170	1250	18	52	80	0.6500000
NODE_2713_length_1394_cov_6.291892	313	393	0	45	80	0.5625000
NODE_2713_length_1394_cov_6.291892	313	393	2	35	80	0.4375000
NODE_2713_length_1394_cov_6.291892	366	446	0	8	80	0.1000000
NODE_2713_length_1394_cov_6.291892	366	446	2	72	80	0.9000000
NODE_2716_length_1393_cov_14.635240	1286	1339	0	53	53	1.0000000
NODE_2717_length_1393_cov_12.032457	737	817	0	80	80	1.0000000
NODE_2717_length_1393_cov_12.032457	790	870	0	80	80	1.0000000
NODE_2720_length_1392_cov_5.898685	270	350	0	56	80	0.7000000
NODE_2720_length_1392_cov_5.898685	270	350	2	24	80	0.3000000
NODE_2720_length_1392_cov_5.898685	323	399	0	3	76	0.0394737
NODE_2720_length_1392_cov_5.898685	323	399	2	73	76	0.9605263
NODE_2723_length_1391_cov_35.921827	415	495	0	80	80	1.0000000
NODE_2723_length_1391_cov_35.921827	468	548	0	76	80	0.9500000
NODE_2723_length_1391_cov_35.921827	468	548	4	4	80	0.0500000
NODE_2723_length_1391_cov_35.921827	544	624	4	8	80	0.1000000
NODE_2723_length_1391_cov_35.921827	544	624	10	72	80	0.9000000
NODE_2723_length_1391_cov_35.921827	597	677	0	7	80	0.0875000
NODE_2723_length_1391_cov_35.921827	597	677	4	10	80	0.1250000
NODE_2723_length_1391_cov_35.921827	597	677	10	63	80	0.7875000
NODE_2729_length_1390_cov_16.326878	550	630	0	49	80	0.6125000
NODE_2729_length_1390_cov_16.326878	550	630	2	31	80	0.3875000
NODE_2729_length_1390_cov_16.326878	603	683	0	30	80	0.3750000
NODE_2729_length_1390_cov_16.326878	603	683	6	50	80	0.6250000
NODE_2731_length_1389_cov_29.772093	780	860	0	80	80	1.0000000
NODE_2731_length_1389_cov_29.772093	833	913	0	80	80	1.0000000
NODE_2732_length_1389_cov_12.858140	821	901	0	80	80	1.0000000
NODE_2732_length_1389_cov_12.858140	874	954	0	71	80	0.8875000
NODE_2732_length_1389_cov_12.858140	874	954	2	9	80	0.1125000
NODE_2735_length_1388_cov_14.641583	529	610	0	81	81	1.0000000
NODE_2735_length_1388_cov_14.641583	583	660	0	42	77	0.5454546
NODE_2735_length_1388_cov_14.641583	583	660	2	35	77	0.4545455
NODE_2736_length_1388_cov_5.168348	427	499	40	1	72	0.0138889
NODE_2736_length_1388_cov_5.168348	427	499	42	3	72	0.0416667
NODE_2736_length_1388_cov_5.168348	427	499	43	2	72	0.0277778
NODE_2736_length_1388_cov_5.168348	427	499	44	3	72	0.0416667
NODE_2736_length_1388_cov_5.168348	427	499	45	15	72	0.2083333
NODE_2736_length_1388_cov_5.168348	427	499	46	11	72	0.1527778
NODE_2736_length_1388_cov_5.168348	427	499	47	25	72	0.3472222
NODE_2736_length_1388_cov_5.168348	427	499	48	7	72	0.0972222
NODE_2736_length_1388_cov_5.168348	427	499	49	1	72	0.0138889
NODE_2736_length_1388_cov_5.168348	427	499	51	1	72	0.0138889
NODE_2736_length_1388_cov_5.168348	427	499	52	1	72	0.0138889
NODE_2736_length_1388_cov_5.168348	427	499	53	2	72	0.0277778
NODE_2742_length_1386_cov_55.384615	559	639	0	13	80	0.1625000
NODE_2742_length_1386_cov_55.384615	559	639	2	67	80	0.8375000
NODE_2742_length_1386_cov_55.384615	612	692	0	38	80	0.4750000
NODE_2742_length_1386_cov_55.384615	612	692	2	14	80	0.1750000
NODE_2742_length_1386_cov_55.384615	612	692	13	28	80	0.3500000
NODE_2742_length_1386_cov_55.384615	688	768	13	18	80	0.2250000
NODE_2742_length_1386_cov_55.384615	688	768	14	41	80	0.5125000
NODE_2742_length_1386_cov_55.384615	688	768	16	7	80	0.0875000
NODE_2742_length_1386_cov_55.384615	688	768	19	1	80	0.0125000
NODE_2742_length_1386_cov_55.384615	688	768	20	13	80	0.1625000
NODE_2742_length_1386_cov_55.384615	741	821	6	21	80	0.2625000
NODE_2742_length_1386_cov_55.384615	741	821	14	6	80	0.0750000
NODE_2742_length_1386_cov_55.384615	741	821	16	7	80	0.0875000
NODE_2742_length_1386_cov_55.384615	741	821	19	17	80	0.2125000
NODE_2742_length_1386_cov_55.384615	741	821	20	29	80	0.3625000
NODE_2744_length_1386_cov_13.181041	549	629	0	80	80	1.0000000
NODE_2744_length_1386_cov_13.181041	602	682	0	80	80	1.0000000
NODE_2748_length_1385_cov_41.636081	968	1048	0	80	80	1.0000000
NODE_2748_length_1385_cov_41.636081	1021	1101	0	80	80	1.0000000
NODE_2749_length_1385_cov_38.877138	707	787	0	4	80	0.0500000
NODE_2749_length_1385_cov_38.877138	707	787	7	26	80	0.3250000
NODE_2749_length_1385_cov_38.877138	707	787	9	21	80	0.2625000
NODE_2749_length_1385_cov_38.877138	707	787	10	29	80	0.3625000
NODE_2749_length_1385_cov_38.877138	760	840	2	12	80	0.1500000
NODE_2749_length_1385_cov_38.877138	760	840	7	19	80	0.2375000
NODE_2749_length_1385_cov_38.877138	760	840	9	24	80	0.3000000
NODE_2749_length_1385_cov_38.877138	760	840	10	25	80	0.3125000
NODE_2749_length_1385_cov_38.877138	836	916	2	22	80	0.2750000
NODE_2749_length_1385_cov_38.877138	836	916	4	58	80	0.7250000
NODE_2749_length_1385_cov_38.877138	889	969	0	31	80	0.3875000
NODE_2749_length_1385_cov_38.877138	889	969	2	2	80	0.0250000
NODE_2749_length_1385_cov_38.877138	889	969	4	47	80	0.5875000
NODE_2751_length_1385_cov_4.608865	844	904	0	60	60	1.0000000
NODE_2758_length_1384_cov_10.574319	865	922	0	57	57	1.0000000
NODE_2758_length_1384_cov_10.574319	933	1013	0	80	80	1.0000000
NODE_2758_length_1384_cov_10.574319	986	1066	0	80	80	1.0000000
NODE_2759_length_1383_cov_10.710280	414	493	0	79	79	1.0000000
NODE_2759_length_1383_cov_10.710280	466	546	0	80	80	1.0000000
NODE_2763_length_1382_cov_12.521434	837	917	0	20	80	0.2500000
NODE_2763_length_1382_cov_12.521434	837	917	2	60	80	0.7500000
NODE_2763_length_1382_cov_12.521434	890	970	0	37	80	0.4625000
NODE_2763_length_1382_cov_12.521434	890	970	2	43	80	0.5375000
NODE_2764_length_1382_cov_5.074045	1028	1108	0	27	80	0.3375000
NODE_2764_length_1382_cov_5.074045	1028	1108	2	53	80	0.6625000
NODE_2764_length_1382_cov_5.074045	1081	1161	0	80	80	1.0000000
NODE_2771_length_1381_cov_7.796412	307	387	0	80	80	1.0000000
NODE_2771_length_1381_cov_7.796412	360	440	0	56	80	0.7000000
NODE_2771_length_1381_cov_7.796412	360	440	2	24	80	0.3000000
NODE_2775_length_1380_cov_12.804059	835	915	2	9	80	0.1125000
NODE_2775_length_1380_cov_12.804059	835	915	4	4	80	0.0500000
NODE_2775_length_1380_cov_12.804059	835	915	5	26	80	0.3250000
NODE_2775_length_1380_cov_12.804059	835	915	6	41	80	0.5125000
NODE_2775_length_1380_cov_12.804059	888	968	4	41	80	0.5125000
NODE_2775_length_1380_cov_12.804059	888	968	6	39	80	0.4875000
NODE_2782_length_1378_cov_25.362002	368	448	0	80	80	1.0000000
NODE_2782_length_1378_cov_25.362002	421	501	0	53	80	0.6625000
NODE_2782_length_1378_cov_25.362002	421	501	4	27	80	0.3375000
NODE_2782_length_1378_cov_25.362002	497	577	0	3	80	0.0375000
NODE_2782_length_1378_cov_25.362002	497	577	4	77	80	0.9625000
NODE_2782_length_1378_cov_25.362002	550	630	0	56	80	0.7000000
NODE_2782_length_1378_cov_25.362002	550	630	4	24	80	0.3000000
NODE_2783_length_1378_cov_20.508210	318	338	17	4	20	0.2000000
NODE_2783_length_1378_cov_20.508210	318	338	19	16	20	0.8000000
NODE_2783_length_1378_cov_20.508210	318	391	17	4	73	0.0547945
NODE_2783_length_1378_cov_20.508210	318	391	19	16	73	0.2191781
NODE_2783_length_1378_cov_20.508210	318	391	20	12	73	0.1643836
NODE_2783_length_1378_cov_20.508210	318	391	22	10	73	0.1369863
NODE_2783_length_1378_cov_20.508210	318	391	24	15	73	0.2054795
NODE_2783_length_1378_cov_20.508210	318	391	25	4	73	0.0547945
NODE_2783_length_1378_cov_20.508210	318	391	26	10	73	0.1369863
NODE_2783_length_1378_cov_20.508210	318	391	27	1	73	0.0136986
NODE_2783_length_1378_cov_20.508210	318	391	28	1	73	0.0136986
NODE_2785_length_1377_cov_103.832551	1259	1299	62	1	40	0.0250000
NODE_2785_length_1377_cov_103.832551	1259	1299	64	2	40	0.0500000
NODE_2785_length_1377_cov_103.832551	1259	1299	71	1	40	0.0250000
NODE_2785_length_1377_cov_103.832551	1259	1299	72	1	40	0.0250000
NODE_2785_length_1377_cov_103.832551	1259	1299	73	1	40	0.0250000
NODE_2785_length_1377_cov_103.832551	1259	1299	74	1	40	0.0250000
NODE_2785_length_1377_cov_103.832551	1259	1299	75	1	40	0.0250000
NODE_2785_length_1377_cov_103.832551	1259	1299	77	9	40	0.2250000
NODE_2785_length_1377_cov_103.832551	1259	1299	78	11	40	0.2750000
NODE_2785_length_1377_cov_103.832551	1259	1299	80	2	40	0.0500000
NODE_2785_length_1377_cov_103.832551	1259	1299	81	10	40	0.2500000
NODE_2788_length_1376_cov_7.967110	904	984	0	9	80	0.1125000
NODE_2788_length_1376_cov_7.967110	904	984	2	71	80	0.8875000
NODE_2788_length_1376_cov_7.967110	957	1037	0	46	80	0.5750000
NODE_2788_length_1376_cov_7.967110	957	1037	2	34	80	0.4250000
NODE_2798_length_1373_cov_52.691523	524	606	3	5	82	0.0609756
NODE_2798_length_1373_cov_52.691523	524	606	4	40	82	0.4878049
NODE_2798_length_1373_cov_52.691523	524	606	5	37	82	0.4512195
NODE_2798_length_1373_cov_52.691523	579	659	0	8	80	0.1000000
NODE_2798_length_1373_cov_52.691523	579	659	2	42	80	0.5250000
NODE_2798_length_1373_cov_52.691523	579	659	5	30	80	0.3750000
NODE_2799_length_1373_cov_20.880691	987	1067	12	2	80	0.0250000
NODE_2799_length_1373_cov_20.880691	987	1067	14	22	80	0.2750000
NODE_2799_length_1373_cov_20.880691	987	1067	15	35	80	0.4375000
NODE_2799_length_1373_cov_20.880691	987	1067	16	11	80	0.1375000
NODE_2799_length_1373_cov_20.880691	987	1067	18	10	80	0.1250000
NODE_2799_length_1373_cov_20.880691	1116	1195	2	5	79	0.0632911
NODE_2799_length_1373_cov_20.880691	1116	1195	4	2	79	0.0253165
NODE_2799_length_1373_cov_20.880691	1116	1195	8	3	79	0.0379747
NODE_2799_length_1373_cov_20.880691	1116	1195	9	1	79	0.0126582
NODE_2799_length_1373_cov_20.880691	1116	1195	10	13	79	0.1645570
NODE_2799_length_1373_cov_20.880691	1116	1195	12	1	79	0.0126582
NODE_2799_length_1373_cov_20.880691	1116	1195	14	7	79	0.0886076
NODE_2799_length_1373_cov_20.880691	1116	1195	16	9	79	0.1139240
NODE_2799_length_1373_cov_20.880691	1116	1195	18	19	79	0.2405063
NODE_2799_length_1373_cov_20.880691	1116	1195	19	1	79	0.0126582
NODE_2799_length_1373_cov_20.880691	1116	1195	20	18	79	0.2278481
NODE_2799_length_1373_cov_20.880691	1168	1248	18	22	80	0.2750000
NODE_2799_length_1373_cov_20.880691	1168	1248	19	2	80	0.0250000
NODE_2799_length_1373_cov_20.880691	1168	1248	20	10	80	0.1250000
NODE_2799_length_1373_cov_20.880691	1168	1248	21	23	80	0.2875000
NODE_2799_length_1373_cov_20.880691	1168	1248	23	23	80	0.2875000
NODE_2800_length_1373_cov_12.694662	94	167	27	6	73	0.0821918
NODE_2800_length_1373_cov_12.694662	94	167	28	4	73	0.0547945
NODE_2800_length_1373_cov_12.694662	94	167	29	3	73	0.0410959
NODE_2800_length_1373_cov_12.694662	94	167	30	9	73	0.1232877
NODE_2800_length_1373_cov_12.694662	94	167	31	1	73	0.0136986
NODE_2800_length_1373_cov_12.694662	94	167	33	3	73	0.0410959
NODE_2800_length_1373_cov_12.694662	94	167	34	3	73	0.0410959
NODE_2800_length_1373_cov_12.694662	94	167	35	4	73	0.0547945
NODE_2800_length_1373_cov_12.694662	94	167	38	3	73	0.0410959
NODE_2800_length_1373_cov_12.694662	94	167	40	2	73	0.0273973
NODE_2800_length_1373_cov_12.694662	94	167	42	4	73	0.0547945
NODE_2800_length_1373_cov_12.694662	94	167	44	5	73	0.0684932
NODE_2800_length_1373_cov_12.694662	94	167	52	2	73	0.0273973
NODE_2800_length_1373_cov_12.694662	94	167	54	2	73	0.0273973
NODE_2800_length_1373_cov_12.694662	94	167	56	2	73	0.0273973
NODE_2800_length_1373_cov_12.694662	94	167	57	2	73	0.0273973
NODE_2800_length_1373_cov_12.694662	94	167	58	3	73	0.0410959
NODE_2800_length_1373_cov_12.694662	94	167	65	1	73	0.0136986
NODE_2800_length_1373_cov_12.694662	94	167	71	1	73	0.0136986
NODE_2800_length_1373_cov_12.694662	94	167	75	1	73	0.0136986
NODE_2800_length_1373_cov_12.694662	94	167	76	2	73	0.0273973
NODE_2800_length_1373_cov_12.694662	94	167	79	2	73	0.0273973
NODE_2800_length_1373_cov_12.694662	94	167	80	1	73	0.0136986
NODE_2800_length_1373_cov_12.694662	94	167	81	3	73	0.0410959
NODE_2800_length_1373_cov_12.694662	94	167	83	4	73	0.0547945
NODE_2800_length_1373_cov_12.694662	140	224	44	1	84	0.0119048
NODE_2800_length_1373_cov_12.694662	140	224	52	2	84	0.0238095
NODE_2800_length_1373_cov_12.694662	140	224	54	2	84	0.0238095
NODE_2800_length_1373_cov_12.694662	140	224	56	2	84	0.0238095
NODE_2800_length_1373_cov_12.694662	140	224	57	2	84	0.0238095
NODE_2800_length_1373_cov_12.694662	140	224	58	3	84	0.0357143
NODE_2800_length_1373_cov_12.694662	140	224	65	1	84	0.0119048
NODE_2800_length_1373_cov_12.694662	140	224	71	1	84	0.0119048
NODE_2800_length_1373_cov_12.694662	140	224	75	1	84	0.0119048
NODE_2800_length_1373_cov_12.694662	140	224	76	2	84	0.0238095
NODE_2800_length_1373_cov_12.694662	140	224	78	3	84	0.0357143
NODE_2800_length_1373_cov_12.694662	140	224	79	4	84	0.0476190
NODE_2800_length_1373_cov_12.694662	140	224	80	3	84	0.0357143
NODE_2800_length_1373_cov_12.694662	140	224	81	7	84	0.0833333
NODE_2800_length_1373_cov_12.694662	140	224	82	3	84	0.0357143
NODE_2800_length_1373_cov_12.694662	140	224	83	4	84	0.0476190
NODE_2800_length_1373_cov_12.694662	140	224	86	4	84	0.0476190
NODE_2800_length_1373_cov_12.694662	140	224	88	1	84	0.0119048
NODE_2800_length_1373_cov_12.694662	140	224	89	4	84	0.0476190
NODE_2800_length_1373_cov_12.694662	140	224	91	1	84	0.0119048
NODE_2800_length_1373_cov_12.694662	140	224	94	2	84	0.0238095
NODE_2800_length_1373_cov_12.694662	140	224	96	3	84	0.0357143
NODE_2800_length_1373_cov_12.694662	140	224	98	6	84	0.0714286
NODE_2800_length_1373_cov_12.694662	140	224	100	5	84	0.0595238
NODE_2800_length_1373_cov_12.694662	140	224	101	1	84	0.0119048
NODE_2800_length_1373_cov_12.694662	140	224	102	5	84	0.0595238
NODE_2800_length_1373_cov_12.694662	140	224	104	4	84	0.0476190
NODE_2800_length_1373_cov_12.694662	140	224	105	1	84	0.0119048
NODE_2800_length_1373_cov_12.694662	140	224	107	1	84	0.0119048
NODE_2800_length_1373_cov_12.694662	140	224	108	2	84	0.0238095
NODE_2800_length_1373_cov_12.694662	140	224	112	3	84	0.0357143
NODE_2800_length_1373_cov_12.694662	1214	1286	24	7	72	0.0972222
NODE_2800_length_1373_cov_12.694662	1214	1286	26	1	72	0.0138889
NODE_2800_length_1373_cov_12.694662	1214	1286	28	13	72	0.1805556
NODE_2800_length_1373_cov_12.694662	1214	1286	32	8	72	0.1111111
NODE_2800_length_1373_cov_12.694662	1214	1286	34	1	72	0.0138889
NODE_2800_length_1373_cov_12.694662	1214	1286	35	1	72	0.0138889
NODE_2800_length_1373_cov_12.694662	1214	1286	36	41	72	0.5694444
NODE_2800_length_1373_cov_12.694662	1267	1339	18	21	72	0.2916667
NODE_2800_length_1373_cov_12.694662	1267	1339	28	45	72	0.6250000
NODE_2800_length_1373_cov_12.694662	1267	1339	32	6	72	0.0833333
NODE_2801_length_1372_cov_25.408484	665	745	0	80	80	1.0000000
NODE_2801_length_1372_cov_25.408484	718	798	0	80	80	1.0000000
NODE_2802_length_1372_cov_17.123331	647	727	0	80	80	1.0000000
NODE_2802_length_1372_cov_17.123331	700	780	0	80	80	1.0000000
NODE_2802_length_1372_cov_17.123331	776	856	0	80	80	1.0000000
NODE_2802_length_1372_cov_17.123331	829	909	0	80	80	1.0000000
NODE_2803_length_1372_cov_14.418696	211	291	0	51	80	0.6375000
NODE_2803_length_1372_cov_14.418696	211	291	2	29	80	0.3625000
NODE_2803_length_1372_cov_14.418696	264	344	0	32	80	0.4000000
NODE_2803_length_1372_cov_14.418696	264	344	2	48	80	0.6000000
NODE_2806_length_1371_cov_39.366352	715	795	4	29	80	0.3625000
NODE_2806_length_1371_cov_39.366352	715	795	6	13	80	0.1625000
NODE_2806_length_1371_cov_39.366352	715	795	8	5	80	0.0625000
NODE_2806_length_1371_cov_39.366352	715	795	10	33	80	0.4125000
NODE_2806_length_1371_cov_39.366352	768	848	2	5	80	0.0625000
NODE_2806_length_1371_cov_39.366352	768	848	4	4	80	0.0500000
NODE_2806_length_1371_cov_39.366352	768	848	6	13	80	0.1625000
NODE_2806_length_1371_cov_39.366352	768	848	10	37	80	0.4625000
NODE_2806_length_1371_cov_39.366352	768	848	12	21	80	0.2625000
NODE_2807_length_1371_cov_36.961478	371	455	0	56	84	0.6666667
NODE_2807_length_1371_cov_36.961478	371	455	2	28	84	0.3333333
NODE_2807_length_1371_cov_36.961478	424	508	0	3	84	0.0357143
NODE_2807_length_1371_cov_36.961478	424	508	2	46	84	0.5476190
NODE_2807_length_1371_cov_36.961478	424	508	4	4	84	0.0476190
NODE_2807_length_1371_cov_36.961478	424	508	7	1	84	0.0119048
NODE_2807_length_1371_cov_36.961478	424	508	8	30	84	0.3571429
NODE_2807_length_1371_cov_36.961478	504	584	4	32	80	0.4000000
NODE_2807_length_1371_cov_36.961478	504	584	6	38	80	0.4750000
NODE_2807_length_1371_cov_36.961478	504	584	8	10	80	0.1250000
NODE_2807_length_1371_cov_36.961478	557	637	4	60	80	0.7500000
NODE_2807_length_1371_cov_36.961478	557	637	8	20	80	0.2500000
NODE_2808_length_1371_cov_16.944182	459	539	0	80	80	1.0000000
NODE_2808_length_1371_cov_16.944182	512	592	0	80	80	1.0000000
NODE_2808_length_1371_cov_16.944182	588	668	0	67	80	0.8375000
NODE_2808_length_1371_cov_16.944182	588	668	2	13	80	0.1625000
NODE_2808_length_1371_cov_16.944182	641	721	0	14	80	0.1750000
NODE_2808_length_1371_cov_16.944182	641	721	2	66	80	0.8250000
NODE_2812_length_1370_cov_11.627065	502	582	0	80	80	1.0000000
NODE_2812_length_1370_cov_11.627065	555	635	0	80	80	1.0000000
NODE_2812_length_1370_cov_11.627065	631	711	0	18	80	0.2250000
NODE_2812_length_1370_cov_11.627065	631	711	1	62	80	0.7750000
NODE_2812_length_1370_cov_11.627065	684	764	1	80	80	1.0000000
NODE_2813_length_1369_cov_27.937795	597	677	0	80	80	1.0000000
NODE_2813_length_1369_cov_27.937795	650	730	0	80	80	1.0000000
NODE_2820_length_1368_cov_35.148148	546	626	0	57	80	0.7125000
NODE_2820_length_1368_cov_35.148148	546	626	2	23	80	0.2875000
NODE_2820_length_1368_cov_35.148148	599	679	0	62	80	0.7750000
NODE_2820_length_1368_cov_35.148148	599	679	2	18	80	0.2250000
NODE_2821_length_1368_cov_27.847912	486	559	0	4	73	0.0547945
NODE_2821_length_1368_cov_27.847912	486	559	2	69	73	0.9452055
NODE_2821_length_1368_cov_27.847912	532	612	0	44	80	0.5500000
NODE_2821_length_1368_cov_27.847912	532	612	2	36	80	0.4500000
NODE_2821_length_1368_cov_27.847912	608	688	0	80	80	1.0000000
NODE_2821_length_1368_cov_27.847912	661	741	0	80	80	1.0000000
NODE_2822_length_1368_cov_26.832151	458	538	0	80	80	1.0000000
NODE_2822_length_1368_cov_26.832151	511	591	0	80	80	1.0000000
NODE_2822_length_1368_cov_26.832151	587	667	0	22	80	0.2750000
NODE_2822_length_1368_cov_26.832151	587	667	2	58	80	0.7250000
NODE_2822_length_1368_cov_26.832151	640	720	0	52	80	0.6500000
NODE_2822_length_1368_cov_26.832151	640	720	2	28	80	0.3500000
NODE_2823_length_1368_cov_18.205674	603	683	0	80	80	1.0000000
NODE_2823_length_1368_cov_18.205674	656	736	0	80	80	1.0000000
NODE_2826_length_1367_cov_576.769716	799	879	652	1	80	0.0125000
NODE_2826_length_1367_cov_576.769716	799	879	654	1	80	0.0125000
NODE_2826_length_1367_cov_576.769716	799	879	672	1	80	0.0125000
NODE_2826_length_1367_cov_576.769716	799	879	675	1	80	0.0125000
NODE_2826_length_1367_cov_576.769716	799	879	677	1	80	0.0125000
NODE_2826_length_1367_cov_576.769716	799	879	680	2	80	0.0250000
NODE_2826_length_1367_cov_576.769716	799	879	686	1	80	0.0125000
NODE_2826_length_1367_cov_576.769716	799	879	688	1	80	0.0125000
NODE_2826_length_1367_cov_576.769716	799	879	690	2	80	0.0250000
NODE_2826_length_1367_cov_576.769716	799	879	693	1	80	0.0125000
NODE_2826_length_1367_cov_576.769716	799	879	694	1	80	0.0125000
NODE_2826_length_1367_cov_576.769716	799	879	696	1	80	0.0125000
NODE_2826_length_1367_cov_576.769716	799	879	697	1	80	0.0125000
NODE_2826_length_1367_cov_576.769716	799	879	698	1	80	0.0125000
NODE_2826_length_1367_cov_576.769716	799	879	700	2	80	0.0250000
NODE_2826_length_1367_cov_576.769716	799	879	701	1	80	0.0125000
NODE_2826_length_1367_cov_576.769716	799	879	703	2	80	0.0250000
NODE_2826_length_1367_cov_576.769716	799	879	705	1	80	0.0125000
NODE_2826_length_1367_cov_576.769716	799	879	706	1	80	0.0125000
NODE_2826_length_1367_cov_576.769716	799	879	707	1	80	0.0125000
NODE_2826_length_1367_cov_576.769716	799	879	708	2	80	0.0250000
NODE_2826_length_1367_cov_576.769716	799	879	710	1	80	0.0125000
NODE_2826_length_1367_cov_576.769716	799	879	714	1	80	0.0125000
NODE_2826_length_1367_cov_576.769716	799	879	722	1	80	0.0125000
NODE_2826_length_1367_cov_576.769716	799	879	726	1	80	0.0125000
NODE_2826_length_1367_cov_576.769716	799	879	727	1	80	0.0125000
NODE_2826_length_1367_cov_576.769716	799	879	731	1	80	0.0125000
NODE_2826_length_1367_cov_576.769716	799	879	733	1	80	0.0125000
NODE_2826_length_1367_cov_576.769716	799	879	745	2	80	0.0250000
NODE_2826_length_1367_cov_576.769716	799	879	747	1	80	0.0125000
NODE_2826_length_1367_cov_576.769716	799	879	749	1	80	0.0125000
NODE_2826_length_1367_cov_576.769716	799	879	751	1	80	0.0125000
NODE_2826_length_1367_cov_576.769716	799	879	755	1	80	0.0125000
NODE_2826_length_1367_cov_576.769716	799	879	778	1	80	0.0125000
NODE_2826_length_1367_cov_576.769716	799	879	795	1	80	0.0125000
NODE_2826_length_1367_cov_576.769716	799	879	814	1	80	0.0125000
NODE_2826_length_1367_cov_576.769716	799	879	817	1	80	0.0125000
NODE_2826_length_1367_cov_576.769716	799	879	872	1	80	0.0125000
NODE_2826_length_1367_cov_576.769716	799	879	876	1	80	0.0125000
NODE_2826_length_1367_cov_576.769716	799	879	878	1	80	0.0125000
NODE_2826_length_1367_cov_576.769716	799	879	882	1	80	0.0125000
NODE_2826_length_1367_cov_576.769716	799	879	887	1	80	0.0125000
NODE_2826_length_1367_cov_576.769716	799	879	914	1	80	0.0125000
NODE_2826_length_1367_cov_576.769716	799	879	938	1	80	0.0125000
NODE_2826_length_1367_cov_576.769716	799	879	941	1	80	0.0125000
NODE_2826_length_1367_cov_576.769716	799	879	945	1	80	0.0125000
NODE_2826_length_1367_cov_576.769716	799	879	949	1	80	0.0125000
NODE_2826_length_1367_cov_576.769716	799	879	960	1	80	0.0125000
NODE_2826_length_1367_cov_576.769716	799	879	1027	1	80	0.0125000
NODE_2826_length_1367_cov_576.769716	799	879	1072	1	80	0.0125000
NODE_2826_length_1367_cov_576.769716	799	879	1111	1	80	0.0125000
NODE_2826_length_1367_cov_576.769716	799	879	1164	1	80	0.0125000
NODE_2826_length_1367_cov_576.769716	799	879	1168	1	80	0.0125000
NODE_2826_length_1367_cov_576.769716	799	879	1201	1	80	0.0125000
NODE_2826_length_1367_cov_576.769716	799	879	1263	1	80	0.0125000
NODE_2826_length_1367_cov_576.769716	799	879	1268	1	80	0.0125000
NODE_2826_length_1367_cov_576.769716	799	879	1306	1	80	0.0125000
NODE_2826_length_1367_cov_576.769716	799	879	1355	1	80	0.0125000
NODE_2826_length_1367_cov_576.769716	799	879	1365	1	80	0.0125000
NODE_2826_length_1367_cov_576.769716	799	879	1536	1	80	0.0125000
NODE_2826_length_1367_cov_576.769716	799	879	1543	1	80	0.0125000
NODE_2826_length_1367_cov_576.769716	799	879	1549	1	80	0.0125000
NODE_2826_length_1367_cov_576.769716	799	879	1656	1	80	0.0125000
NODE_2826_length_1367_cov_576.769716	799	879	1675	1	80	0.0125000
NODE_2826_length_1367_cov_576.769716	799	879	1806	1	80	0.0125000
NODE_2826_length_1367_cov_576.769716	799	879	1813	1	80	0.0125000
NODE_2826_length_1367_cov_576.769716	799	879	1843	1	80	0.0125000
NODE_2826_length_1367_cov_576.769716	799	879	1871	1	80	0.0125000
NODE_2826_length_1367_cov_576.769716	799	879	1961	1	80	0.0125000
NODE_2826_length_1367_cov_576.769716	799	879	1976	1	80	0.0125000
NODE_2826_length_1367_cov_576.769716	799	879	1996	1	80	0.0125000
NODE_2826_length_1367_cov_576.769716	799	879	2007	1	80	0.0125000
NODE_2826_length_1367_cov_576.769716	799	879	2010	1	80	0.0125000
NODE_2826_length_1367_cov_576.769716	799	879	2011	1	80	0.0125000
NODE_2826_length_1367_cov_576.769716	852	932	960	1	80	0.0125000
NODE_2826_length_1367_cov_576.769716	852	932	1027	1	80	0.0125000
NODE_2826_length_1367_cov_576.769716	852	932	1072	1	80	0.0125000
NODE_2826_length_1367_cov_576.769716	852	932	1111	1	80	0.0125000
NODE_2826_length_1367_cov_576.769716	852	932	1164	1	80	0.0125000
NODE_2826_length_1367_cov_576.769716	852	932	1168	1	80	0.0125000
NODE_2826_length_1367_cov_576.769716	852	932	1201	1	80	0.0125000
NODE_2826_length_1367_cov_576.769716	852	932	1263	1	80	0.0125000
NODE_2826_length_1367_cov_576.769716	852	932	1268	1	80	0.0125000
NODE_2826_length_1367_cov_576.769716	852	932	1306	1	80	0.0125000
NODE_2826_length_1367_cov_576.769716	852	932	1355	1	80	0.0125000
NODE_2826_length_1367_cov_576.769716	852	932	1365	1	80	0.0125000
NODE_2826_length_1367_cov_576.769716	852	932	1536	1	80	0.0125000
NODE_2826_length_1367_cov_576.769716	852	932	1543	1	80	0.0125000
NODE_2826_length_1367_cov_576.769716	852	932	1549	1	80	0.0125000
NODE_2826_length_1367_cov_576.769716	852	932	1656	1	80	0.0125000
NODE_2826_length_1367_cov_576.769716	852	932	1675	1	80	0.0125000
NODE_2826_length_1367_cov_576.769716	852	932	1806	1	80	0.0125000
NODE_2826_length_1367_cov_576.769716	852	932	1813	1	80	0.0125000
NODE_2826_length_1367_cov_576.769716	852	932	1843	1	80	0.0125000
NODE_2826_length_1367_cov_576.769716	852	932	1871	1	80	0.0125000
NODE_2826_length_1367_cov_576.769716	852	932	1961	1	80	0.0125000
NODE_2826_length_1367_cov_576.769716	852	932	1976	1	80	0.0125000
NODE_2826_length_1367_cov_576.769716	852	932	1996	1	80	0.0125000
NODE_2826_length_1367_cov_576.769716	852	932	2007	1	80	0.0125000
NODE_2826_length_1367_cov_576.769716	852	932	2010	1	80	0.0125000
NODE_2826_length_1367_cov_576.769716	852	932	2011	1	80	0.0125000
NODE_2826_length_1367_cov_576.769716	852	932	2015	1	80	0.0125000
NODE_2826_length_1367_cov_576.769716	852	932	2029	1	80	0.0125000
NODE_2826_length_1367_cov_576.769716	852	932	2042	1	80	0.0125000
NODE_2826_length_1367_cov_576.769716	852	932	2103	1	80	0.0125000
NODE_2826_length_1367_cov_576.769716	852	932	2130	1	80	0.0125000
NODE_2826_length_1367_cov_576.769716	852	932	2156	1	80	0.0125000
NODE_2826_length_1367_cov_576.769716	852	932	2207	1	80	0.0125000
NODE_2826_length_1367_cov_576.769716	852	932	2249	1	80	0.0125000
NODE_2826_length_1367_cov_576.769716	852	932	2269	1	80	0.0125000
NODE_2826_length_1367_cov_576.769716	852	932	2367	1	80	0.0125000
NODE_2826_length_1367_cov_576.769716	852	932	2398	1	80	0.0125000
NODE_2826_length_1367_cov_576.769716	852	932	2418	1	80	0.0125000
NODE_2826_length_1367_cov_576.769716	852	932	2436	1	80	0.0125000
NODE_2826_length_1367_cov_576.769716	852	932	2458	1	80	0.0125000
NODE_2826_length_1367_cov_576.769716	852	932	2461	1	80	0.0125000
NODE_2826_length_1367_cov_576.769716	852	932	2471	1	80	0.0125000
NODE_2826_length_1367_cov_576.769716	852	932	2476	2	80	0.0250000
NODE_2826_length_1367_cov_576.769716	852	932	2477	1	80	0.0125000
NODE_2826_length_1367_cov_576.769716	852	932	2478	1	80	0.0125000
NODE_2826_length_1367_cov_576.769716	852	932	2480	1	80	0.0125000
NODE_2826_length_1367_cov_576.769716	852	932	2484	1	80	0.0125000
NODE_2826_length_1367_cov_576.769716	852	932	2485	1	80	0.0125000
NODE_2826_length_1367_cov_576.769716	852	932	2487	1	80	0.0125000
NODE_2826_length_1367_cov_576.769716	852	932	2489	4	80	0.0500000
NODE_2826_length_1367_cov_576.769716	852	932	2490	1	80	0.0125000
NODE_2826_length_1367_cov_576.769716	852	932	2492	1	80	0.0125000
NODE_2826_length_1367_cov_576.769716	852	932	2493	1	80	0.0125000
NODE_2826_length_1367_cov_576.769716	852	932	2495	1	80	0.0125000
NODE_2826_length_1367_cov_576.769716	852	932	2500	2	80	0.0250000
NODE_2826_length_1367_cov_576.769716	852	932	2502	2	80	0.0250000
NODE_2826_length_1367_cov_576.769716	852	932	2506	1	80	0.0125000
NODE_2826_length_1367_cov_576.769716	852	932	2507	1	80	0.0125000
NODE_2826_length_1367_cov_576.769716	852	932	2508	9	80	0.1125000
NODE_2826_length_1367_cov_576.769716	852	932	2511	1	80	0.0125000
NODE_2826_length_1367_cov_576.769716	852	932	2513	1	80	0.0125000
NODE_2826_length_1367_cov_576.769716	852	932	2516	2	80	0.0250000
NODE_2826_length_1367_cov_576.769716	852	932	2517	1	80	0.0125000
NODE_2826_length_1367_cov_576.769716	852	932	2526	1	80	0.0125000
NODE_2826_length_1367_cov_576.769716	900	980	1769	1	80	0.0125000
NODE_2826_length_1367_cov_576.769716	900	980	1936	1	80	0.0125000
NODE_2826_length_1367_cov_576.769716	900	980	1956	1	80	0.0125000
NODE_2826_length_1367_cov_576.769716	900	980	2027	1	80	0.0125000
NODE_2826_length_1367_cov_576.769716	900	980	2119	1	80	0.0125000
NODE_2826_length_1367_cov_576.769716	900	980	2133	1	80	0.0125000
NODE_2826_length_1367_cov_576.769716	900	980	2141	1	80	0.0125000
NODE_2826_length_1367_cov_576.769716	900	980	2147	1	80	0.0125000
NODE_2826_length_1367_cov_576.769716	900	980	2160	1	80	0.0125000
NODE_2826_length_1367_cov_576.769716	900	980	2169	1	80	0.0125000
NODE_2826_length_1367_cov_576.769716	900	980	2235	1	80	0.0125000
NODE_2826_length_1367_cov_576.769716	900	980	2292	1	80	0.0125000
NODE_2826_length_1367_cov_576.769716	900	980	2300	1	80	0.0125000
NODE_2826_length_1367_cov_576.769716	900	980	2304	1	80	0.0125000
NODE_2826_length_1367_cov_576.769716	900	980	2307	1	80	0.0125000
NODE_2826_length_1367_cov_576.769716	900	980	2309	1	80	0.0125000
NODE_2826_length_1367_cov_576.769716	900	980	2315	1	80	0.0125000
NODE_2826_length_1367_cov_576.769716	900	980	2316	1	80	0.0125000
NODE_2826_length_1367_cov_576.769716	900	980	2321	1	80	0.0125000
NODE_2826_length_1367_cov_576.769716	900	980	2328	1	80	0.0125000
NODE_2826_length_1367_cov_576.769716	900	980	2334	1	80	0.0125000
NODE_2826_length_1367_cov_576.769716	900	980	2336	1	80	0.0125000
NODE_2826_length_1367_cov_576.769716	900	980	2349	2	80	0.0250000
NODE_2826_length_1367_cov_576.769716	900	980	2379	1	80	0.0125000
NODE_2826_length_1367_cov_576.769716	900	980	2385	1	80	0.0125000
NODE_2826_length_1367_cov_576.769716	900	980	2387	1	80	0.0125000
NODE_2826_length_1367_cov_576.769716	900	980	2388	1	80	0.0125000
NODE_2826_length_1367_cov_576.769716	900	980	2390	1	80	0.0125000
NODE_2826_length_1367_cov_576.769716	900	980	2394	1	80	0.0125000
NODE_2826_length_1367_cov_576.769716	900	980	2395	1	80	0.0125000
NODE_2826_length_1367_cov_576.769716	900	980	2398	1	80	0.0125000
NODE_2826_length_1367_cov_576.769716	900	980	2403	1	80	0.0125000
NODE_2826_length_1367_cov_576.769716	900	980	2409	1	80	0.0125000
NODE_2826_length_1367_cov_576.769716	900	980	2410	1	80	0.0125000
NODE_2826_length_1367_cov_576.769716	900	980	2431	1	80	0.0125000
NODE_2826_length_1367_cov_576.769716	900	980	2441	1	80	0.0125000
NODE_2826_length_1367_cov_576.769716	900	980	2442	1	80	0.0125000
NODE_2826_length_1367_cov_576.769716	900	980	2452	1	80	0.0125000
NODE_2826_length_1367_cov_576.769716	900	980	2453	1	80	0.0125000
NODE_2826_length_1367_cov_576.769716	900	980	2455	1	80	0.0125000
NODE_2826_length_1367_cov_576.769716	900	980	2458	3	80	0.0375000
NODE_2826_length_1367_cov_576.769716	900	980	2459	3	80	0.0375000
NODE_2826_length_1367_cov_576.769716	900	980	2460	2	80	0.0250000
NODE_2826_length_1367_cov_576.769716	900	980	2461	1	80	0.0125000
NODE_2826_length_1367_cov_576.769716	900	980	2471	1	80	0.0125000
NODE_2826_length_1367_cov_576.769716	900	980	2476	2	80	0.0250000
NODE_2826_length_1367_cov_576.769716	900	980	2478	1	80	0.0125000
NODE_2826_length_1367_cov_576.769716	900	980	2480	1	80	0.0125000
NODE_2826_length_1367_cov_576.769716	900	980	2484	1	80	0.0125000
NODE_2826_length_1367_cov_576.769716	900	980	2485	1	80	0.0125000
NODE_2826_length_1367_cov_576.769716	900	980	2487	1	80	0.0125000
NODE_2826_length_1367_cov_576.769716	900	980	2489	3	80	0.0375000
NODE_2826_length_1367_cov_576.769716	900	980	2490	1	80	0.0125000
NODE_2826_length_1367_cov_576.769716	900	980	2492	1	80	0.0125000
NODE_2826_length_1367_cov_576.769716	900	980	2493	1	80	0.0125000
NODE_2826_length_1367_cov_576.769716	900	980	2495	1	80	0.0125000
NODE_2826_length_1367_cov_576.769716	900	980	2500	1	80	0.0125000
NODE_2826_length_1367_cov_576.769716	900	980	2502	1	80	0.0125000
NODE_2826_length_1367_cov_576.769716	900	980	2506	1	80	0.0125000
NODE_2826_length_1367_cov_576.769716	900	980	2507	1	80	0.0125000
NODE_2826_length_1367_cov_576.769716	900	980	2508	5	80	0.0625000
NODE_2826_length_1367_cov_576.769716	900	980	2511	1	80	0.0125000
NODE_2826_length_1367_cov_576.769716	900	980	2513	1	80	0.0125000
NODE_2826_length_1367_cov_576.769716	900	980	2516	2	80	0.0250000
NODE_2826_length_1367_cov_576.769716	900	980	2517	1	80	0.0125000
NODE_2826_length_1367_cov_576.769716	900	980	2526	1	80	0.0125000
NODE_2826_length_1367_cov_576.769716	905	927	2478	1	22	0.0454545
NODE_2826_length_1367_cov_576.769716	905	927	2480	1	22	0.0454545
NODE_2826_length_1367_cov_576.769716	905	927	2484	1	22	0.0454545
NODE_2826_length_1367_cov_576.769716	905	927	2485	1	22	0.0454545
NODE_2826_length_1367_cov_576.769716	905	927	2487	1	22	0.0454545
NODE_2826_length_1367_cov_576.769716	905	927	2489	3	22	0.1363636
NODE_2826_length_1367_cov_576.769716	905	927	2490	1	22	0.0454545
NODE_2826_length_1367_cov_576.769716	905	927	2492	1	22	0.0454545
NODE_2826_length_1367_cov_576.769716	905	927	2493	1	22	0.0454545
NODE_2826_length_1367_cov_576.769716	905	927	2495	1	22	0.0454545
NODE_2826_length_1367_cov_576.769716	905	927	2500	1	22	0.0454545
NODE_2826_length_1367_cov_576.769716	905	927	2502	1	22	0.0454545
NODE_2826_length_1367_cov_576.769716	905	927	2507	1	22	0.0454545
NODE_2826_length_1367_cov_576.769716	905	927	2508	1	22	0.0454545
NODE_2826_length_1367_cov_576.769716	905	927	2511	1	22	0.0454545
NODE_2826_length_1367_cov_576.769716	905	927	2513	1	22	0.0454545
NODE_2826_length_1367_cov_576.769716	905	927	2516	2	22	0.0909091
NODE_2826_length_1367_cov_576.769716	905	927	2517	1	22	0.0454545
NODE_2826_length_1367_cov_576.769716	905	927	2526	1	22	0.0454545
NODE_2826_length_1367_cov_576.769716	1051	1131	92	1	80	0.0125000
NODE_2826_length_1367_cov_576.769716	1051	1131	93	1	80	0.0125000
NODE_2826_length_1367_cov_576.769716	1051	1131	95	3	80	0.0375000
NODE_2826_length_1367_cov_576.769716	1051	1131	97	3	80	0.0375000
NODE_2826_length_1367_cov_576.769716	1051	1131	101	1	80	0.0125000
NODE_2826_length_1367_cov_576.769716	1051	1131	102	3	80	0.0375000
NODE_2826_length_1367_cov_576.769716	1051	1131	106	1	80	0.0125000
NODE_2826_length_1367_cov_576.769716	1051	1131	107	1	80	0.0125000
NODE_2826_length_1367_cov_576.769716	1051	1131	108	5	80	0.0625000
NODE_2826_length_1367_cov_576.769716	1051	1131	109	1	80	0.0125000
NODE_2826_length_1367_cov_576.769716	1051	1131	111	1	80	0.0125000
NODE_2826_length_1367_cov_576.769716	1051	1131	117	1	80	0.0125000
NODE_2826_length_1367_cov_576.769716	1051	1131	118	1	80	0.0125000
NODE_2826_length_1367_cov_576.769716	1051	1131	119	1	80	0.0125000
NODE_2826_length_1367_cov_576.769716	1051	1131	123	1	80	0.0125000
NODE_2826_length_1367_cov_576.769716	1051	1131	128	1	80	0.0125000
NODE_2826_length_1367_cov_576.769716	1051	1131	131	2	80	0.0250000
NODE_2826_length_1367_cov_576.769716	1051	1131	140	1	80	0.0125000
NODE_2826_length_1367_cov_576.769716	1051	1131	144	1	80	0.0125000
NODE_2826_length_1367_cov_576.769716	1051	1131	148	1	80	0.0125000
NODE_2826_length_1367_cov_576.769716	1051	1131	151	1	80	0.0125000
NODE_2826_length_1367_cov_576.769716	1051	1131	152	1	80	0.0125000
NODE_2826_length_1367_cov_576.769716	1051	1131	159	1	80	0.0125000
NODE_2826_length_1367_cov_576.769716	1051	1131	160	1	80	0.0125000
NODE_2826_length_1367_cov_576.769716	1051	1131	162	1	80	0.0125000
NODE_2826_length_1367_cov_576.769716	1051	1131	167	1	80	0.0125000
NODE_2826_length_1367_cov_576.769716	1051	1131	170	1	80	0.0125000
NODE_2826_length_1367_cov_576.769716	1051	1131	172	1	80	0.0125000
NODE_2826_length_1367_cov_576.769716	1051	1131	174	1	80	0.0125000
NODE_2826_length_1367_cov_576.769716	1051	1131	184	1	80	0.0125000
NODE_2826_length_1367_cov_576.769716	1051	1131	186	1	80	0.0125000
NODE_2826_length_1367_cov_576.769716	1051	1131	193	1	80	0.0125000
NODE_2826_length_1367_cov_576.769716	1051	1131	199	1	80	0.0125000
NODE_2826_length_1367_cov_576.769716	1051	1131	206	1	80	0.0125000
NODE_2826_length_1367_cov_576.769716	1051	1131	214	1	80	0.0125000
NODE_2826_length_1367_cov_576.769716	1051	1131	216	2	80	0.0250000
NODE_2826_length_1367_cov_576.769716	1051	1131	222	1	80	0.0125000
NODE_2826_length_1367_cov_576.769716	1051	1131	224	1	80	0.0125000
NODE_2826_length_1367_cov_576.769716	1051	1131	227	1	80	0.0125000
NODE_2826_length_1367_cov_576.769716	1051	1131	228	1	80	0.0125000
NODE_2826_length_1367_cov_576.769716	1051	1131	237	1	80	0.0125000
NODE_2826_length_1367_cov_576.769716	1051	1131	239	1	80	0.0125000
NODE_2826_length_1367_cov_576.769716	1051	1131	241	1	80	0.0125000
NODE_2826_length_1367_cov_576.769716	1051	1131	242	1	80	0.0125000
NODE_2826_length_1367_cov_576.769716	1051	1131	244	3	80	0.0375000
NODE_2826_length_1367_cov_576.769716	1051	1131	245	2	80	0.0250000
NODE_2826_length_1367_cov_576.769716	1051	1131	249	2	80	0.0250000
NODE_2826_length_1367_cov_576.769716	1051	1131	253	1	80	0.0125000
NODE_2826_length_1367_cov_576.769716	1051	1131	261	2	80	0.0250000
NODE_2826_length_1367_cov_576.769716	1051	1131	264	2	80	0.0250000
NODE_2826_length_1367_cov_576.769716	1051	1131	270	1	80	0.0125000
NODE_2826_length_1367_cov_576.769716	1051	1131	275	1	80	0.0125000
NODE_2826_length_1367_cov_576.769716	1051	1131	284	2	80	0.0250000
NODE_2826_length_1367_cov_576.769716	1051	1131	285	2	80	0.0250000
NODE_2826_length_1367_cov_576.769716	1051	1131	287	1	80	0.0125000
NODE_2826_length_1367_cov_576.769716	1051	1131	292	2	80	0.0250000
NODE_2826_length_1367_cov_576.769716	1051	1131	294	1	80	0.0125000
NODE_2826_length_1367_cov_576.769716	1051	1131	297	2	80	0.0250000
NODE_2826_length_1367_cov_576.769716	1104	1184	239	1	80	0.0125000
NODE_2826_length_1367_cov_576.769716	1104	1184	241	1	80	0.0125000
NODE_2826_length_1367_cov_576.769716	1104	1184	242	1	80	0.0125000
NODE_2826_length_1367_cov_576.769716	1104	1184	244	3	80	0.0375000
NODE_2826_length_1367_cov_576.769716	1104	1184	245	2	80	0.0250000
NODE_2826_length_1367_cov_576.769716	1104	1184	249	2	80	0.0250000
NODE_2826_length_1367_cov_576.769716	1104	1184	253	1	80	0.0125000
NODE_2826_length_1367_cov_576.769716	1104	1184	261	2	80	0.0250000
NODE_2826_length_1367_cov_576.769716	1104	1184	264	2	80	0.0250000
NODE_2826_length_1367_cov_576.769716	1104	1184	270	1	80	0.0125000
NODE_2826_length_1367_cov_576.769716	1104	1184	275	1	80	0.0125000
NODE_2826_length_1367_cov_576.769716	1104	1184	284	2	80	0.0250000
NODE_2826_length_1367_cov_576.769716	1104	1184	285	2	80	0.0250000
NODE_2826_length_1367_cov_576.769716	1104	1184	287	1	80	0.0125000
NODE_2826_length_1367_cov_576.769716	1104	1184	292	2	80	0.0250000
NODE_2826_length_1367_cov_576.769716	1104	1184	294	1	80	0.0125000
NODE_2826_length_1367_cov_576.769716	1104	1184	297	2	80	0.0250000
NODE_2826_length_1367_cov_576.769716	1104	1184	300	1	80	0.0125000
NODE_2826_length_1367_cov_576.769716	1104	1184	301	1	80	0.0125000
NODE_2826_length_1367_cov_576.769716	1104	1184	304	1	80	0.0125000
NODE_2826_length_1367_cov_576.769716	1104	1184	307	7	80	0.0875000
NODE_2826_length_1367_cov_576.769716	1104	1184	309	2	80	0.0250000
NODE_2826_length_1367_cov_576.769716	1104	1184	312	1	80	0.0125000
NODE_2826_length_1367_cov_576.769716	1104	1184	315	1	80	0.0125000
NODE_2826_length_1367_cov_576.769716	1104	1184	327	1	80	0.0125000
NODE_2826_length_1367_cov_576.769716	1104	1184	330	1	80	0.0125000
NODE_2826_length_1367_cov_576.769716	1104	1184	334	1	80	0.0125000
NODE_2826_length_1367_cov_576.769716	1104	1184	336	2	80	0.0250000
NODE_2826_length_1367_cov_576.769716	1104	1184	344	1	80	0.0125000
NODE_2826_length_1367_cov_576.769716	1104	1184	354	1	80	0.0125000
NODE_2826_length_1367_cov_576.769716	1104	1184	363	1	80	0.0125000
NODE_2826_length_1367_cov_576.769716	1104	1184	372	1	80	0.0125000
NODE_2826_length_1367_cov_576.769716	1104	1184	378	1	80	0.0125000
NODE_2826_length_1367_cov_576.769716	1104	1184	384	1	80	0.0125000
NODE_2826_length_1367_cov_576.769716	1104	1184	386	1	80	0.0125000
NODE_2826_length_1367_cov_576.769716	1104	1184	393	2	80	0.0250000
NODE_2826_length_1367_cov_576.769716	1104	1184	397	2	80	0.0250000
NODE_2826_length_1367_cov_576.769716	1104	1184	398	1	80	0.0125000
NODE_2826_length_1367_cov_576.769716	1104	1184	399	2	80	0.0250000
NODE_2826_length_1367_cov_576.769716	1104	1184	401	1	80	0.0125000
NODE_2826_length_1367_cov_576.769716	1104	1184	404	1	80	0.0125000
NODE_2826_length_1367_cov_576.769716	1104	1184	411	1	80	0.0125000
NODE_2826_length_1367_cov_576.769716	1104	1184	415	1	80	0.0125000
NODE_2826_length_1367_cov_576.769716	1104	1184	419	1	80	0.0125000
NODE_2826_length_1367_cov_576.769716	1104	1184	430	1	80	0.0125000
NODE_2826_length_1367_cov_576.769716	1104	1184	445	1	80	0.0125000
NODE_2826_length_1367_cov_576.769716	1104	1184	446	3	80	0.0375000
NODE_2826_length_1367_cov_576.769716	1104	1184	448	1	80	0.0125000
NODE_2826_length_1367_cov_576.769716	1104	1184	459	2	80	0.0250000
NODE_2826_length_1367_cov_576.769716	1104	1184	467	1	80	0.0125000
NODE_2826_length_1367_cov_576.769716	1104	1184	471	1	80	0.0125000
NODE_2826_length_1367_cov_576.769716	1104	1184	472	1	80	0.0125000
NODE_2826_length_1367_cov_576.769716	1104	1184	473	1	80	0.0125000
NODE_2826_length_1367_cov_576.769716	1104	1184	476	1	80	0.0125000
NODE_2826_length_1367_cov_576.769716	1104	1184	477	1	80	0.0125000
NODE_2826_length_1367_cov_576.769716	1104	1184	482	1	80	0.0125000
NODE_2827_length_1367_cov_152.824921	513	593	2	63	80	0.7875000
NODE_2827_length_1367_cov_152.824921	513	593	4	17	80	0.2125000
NODE_2827_length_1367_cov_152.824921	566	646	0	40	80	0.5000000
NODE_2827_length_1367_cov_152.824921	566	646	2	40	80	0.5000000
NODE_2827_length_1367_cov_152.824921	642	722	0	80	80	1.0000000
NODE_2827_length_1367_cov_152.824921	695	775	0	35	80	0.4375000
NODE_2827_length_1367_cov_152.824921	695	775	2	45	80	0.5625000
NODE_2829_length_1367_cov_2.947161	250	326	1	6	76	0.0789474
NODE_2829_length_1367_cov_2.947161	250	326	3	3	76	0.0394737
NODE_2829_length_1367_cov_2.947161	250	326	4	4	76	0.0526316
NODE_2829_length_1367_cov_2.947161	250	326	7	11	76	0.1447368
NODE_2829_length_1367_cov_2.947161	250	326	9	21	76	0.2763158
NODE_2829_length_1367_cov_2.947161	250	326	13	10	76	0.1315790
NODE_2829_length_1367_cov_2.947161	250	326	17	4	76	0.0526316
NODE_2829_length_1367_cov_2.947161	250	326	18	3	76	0.0394737
NODE_2829_length_1367_cov_2.947161	250	326	20	14	76	0.1842105
NODE_2831_length_1366_cov_82.742699	198	278	0	80	80	1.0000000
NODE_2831_length_1366_cov_82.742699	251	331	0	80	80	1.0000000
NODE_2832_length_1366_cov_36.659037	577	657	0	80	80	1.0000000
NODE_2832_length_1366_cov_36.659037	630	710	0	80	80	1.0000000
NODE_2834_length_1366_cov_2.320442	47	116	4	2	69	0.0289855
NODE_2834_length_1366_cov_2.320442	47	116	6	67	69	0.9710145
NODE_2834_length_1366_cov_2.320442	1122	1202	1	7	80	0.0875000
NODE_2834_length_1366_cov_2.320442	1122	1202	2	10	80	0.1250000
NODE_2834_length_1366_cov_2.320442	1122	1202	3	18	80	0.2250000
NODE_2834_length_1366_cov_2.320442	1122	1202	4	3	80	0.0375000
NODE_2834_length_1366_cov_2.320442	1122	1202	5	10	80	0.1250000
NODE_2834_length_1366_cov_2.320442	1122	1202	6	4	80	0.0500000
NODE_2834_length_1366_cov_2.320442	1122	1202	8	21	80	0.2625000
NODE_2834_length_1366_cov_2.320442	1122	1202	12	7	80	0.0875000
NODE_2834_length_1366_cov_2.320442	1175	1255	8	20	80	0.2500000
NODE_2834_length_1366_cov_2.320442	1175	1255	12	15	80	0.1875000
NODE_2834_length_1366_cov_2.320442	1175	1255	14	1	80	0.0125000
NODE_2834_length_1366_cov_2.320442	1175	1255	16	2	80	0.0250000
NODE_2834_length_1366_cov_2.320442	1175	1255	18	1	80	0.0125000
NODE_2834_length_1366_cov_2.320442	1175	1255	20	13	80	0.1625000
NODE_2834_length_1366_cov_2.320442	1175	1255	22	9	80	0.1125000
NODE_2834_length_1366_cov_2.320442	1175	1255	24	6	80	0.0750000
NODE_2834_length_1366_cov_2.320442	1175	1255	26	1	80	0.0125000
NODE_2834_length_1366_cov_2.320442	1175	1255	28	2	80	0.0250000
NODE_2834_length_1366_cov_2.320442	1175	1255	30	1	80	0.0125000
NODE_2834_length_1366_cov_2.320442	1175	1255	37	1	80	0.0125000
NODE_2834_length_1366_cov_2.320442	1175	1255	39	2	80	0.0250000
NODE_2834_length_1366_cov_2.320442	1175	1255	41	3	80	0.0375000
NODE_2834_length_1366_cov_2.320442	1175	1255	43	3	80	0.0375000
NODE_2834_length_1366_cov_2.320442	1251	1331	25	4	80	0.0500000
NODE_2834_length_1366_cov_2.320442	1251	1331	27	2	80	0.0250000
NODE_2834_length_1366_cov_2.320442	1251	1331	29	5	80	0.0625000
NODE_2834_length_1366_cov_2.320442	1251	1331	31	5	80	0.0625000
NODE_2834_length_1366_cov_2.320442	1251	1331	33	7	80	0.0875000
NODE_2834_length_1366_cov_2.320442	1251	1331	37	1	80	0.0125000
NODE_2834_length_1366_cov_2.320442	1251	1331	39	8	80	0.1000000
NODE_2834_length_1366_cov_2.320442	1251	1331	41	11	80	0.1375000
NODE_2834_length_1366_cov_2.320442	1251	1331	43	37	80	0.4625000
NODE_2835_length_1365_cov_25.540284	432	509	8	49	77	0.6363636
NODE_2835_length_1365_cov_25.540284	432	509	10	12	77	0.1558442
NODE_2835_length_1365_cov_25.540284	432	509	11	10	77	0.1298701
NODE_2835_length_1365_cov_25.540284	432	509	12	6	77	0.0779221
NODE_2835_length_1365_cov_25.540284	482	562	4	51	80	0.6375000
NODE_2835_length_1365_cov_25.540284	482	562	10	11	80	0.1375000
NODE_2835_length_1365_cov_25.540284	482	562	11	12	80	0.1500000
NODE_2835_length_1365_cov_25.540284	482	562	12	6	80	0.0750000
NODE_2835_length_1365_cov_25.540284	558	635	2	60	77	0.7792208
NODE_2835_length_1365_cov_25.540284	558	635	4	17	77	0.2207792
NODE_2835_length_1365_cov_25.540284	625	688	0	42	63	0.6666667
NODE_2835_length_1365_cov_25.540284	625	688	1	2	63	0.0317460
NODE_2835_length_1365_cov_25.540284	625	688	2	19	63	0.3015873
NODE_2838_length_1364_cov_15.222134	120	191	15	3	71	0.0422535
NODE_2838_length_1364_cov_15.222134	120	191	17	2	71	0.0281690
NODE_2838_length_1364_cov_15.222134	120	191	19	2	71	0.0281690
NODE_2838_length_1364_cov_15.222134	120	191	23	2	71	0.0281690
NODE_2838_length_1364_cov_15.222134	120	191	25	12	71	0.1690141
NODE_2838_length_1364_cov_15.222134	120	191	31	4	71	0.0563380
NODE_2838_length_1364_cov_15.222134	120	191	37	1	71	0.0140845
NODE_2838_length_1364_cov_15.222134	120	191	41	2	71	0.0281690
NODE_2838_length_1364_cov_15.222134	120	191	43	1	71	0.0140845
NODE_2838_length_1364_cov_15.222134	120	191	54	1	71	0.0140845
NODE_2838_length_1364_cov_15.222134	120	191	56	3	71	0.0422535
NODE_2838_length_1364_cov_15.222134	120	191	59	4	71	0.0563380
NODE_2838_length_1364_cov_15.222134	120	191	60	1	71	0.0140845
NODE_2838_length_1364_cov_15.222134	120	191	61	3	71	0.0422535
NODE_2838_length_1364_cov_15.222134	120	191	62	2	71	0.0281690
NODE_2838_length_1364_cov_15.222134	120	191	63	1	71	0.0140845
NODE_2838_length_1364_cov_15.222134	120	191	64	8	71	0.1126761
NODE_2838_length_1364_cov_15.222134	120	191	65	2	71	0.0281690
NODE_2838_length_1364_cov_15.222134	120	191	68	4	71	0.0563380
NODE_2838_length_1364_cov_15.222134	120	191	72	4	71	0.0563380
NODE_2838_length_1364_cov_15.222134	120	191	74	4	71	0.0563380
NODE_2838_length_1364_cov_15.222134	120	191	76	5	71	0.0704225
NODE_2839_length_1364_cov_7.456917	843	923	0	80	80	1.0000000
NODE_2839_length_1364_cov_7.456917	896	976	0	80	80	1.0000000
NODE_2840_length_1364_cov_5.055336	239	290	0	51	51	1.0000000
NODE_2840_length_1364_cov_5.055336	263	343	0	80	80	1.0000000
NODE_2846_length_1363_cov_19.442247	615	695	4	11	80	0.1375000
NODE_2846_length_1363_cov_19.442247	615	695	6	11	80	0.1375000
NODE_2846_length_1363_cov_19.442247	615	695	15	13	80	0.1625000
NODE_2846_length_1363_cov_19.442247	615	695	16	45	80	0.5625000
NODE_2846_length_1363_cov_19.442247	668	748	4	7	80	0.0875000
NODE_2846_length_1363_cov_19.442247	668	748	12	8	80	0.1000000
NODE_2846_length_1363_cov_19.442247	668	748	14	17	80	0.2125000
NODE_2846_length_1363_cov_19.442247	668	748	15	17	80	0.2125000
NODE_2846_length_1363_cov_19.442247	668	748	16	29	80	0.3625000
NODE_2846_length_1363_cov_19.442247	668	748	17	2	80	0.0250000
NODE_2847_length_1363_cov_13.575949	619	699	2	39	80	0.4875000
NODE_2847_length_1363_cov_13.575949	619	699	4	41	80	0.5125000
NODE_2847_length_1363_cov_13.575949	672	752	2	68	80	0.8500000
NODE_2847_length_1363_cov_13.575949	672	752	4	12	80	0.1500000
NODE_2850_length_1362_cov_15.796516	898	978	0	80	80	1.0000000
NODE_2850_length_1362_cov_15.796516	951	1031	0	80	80	1.0000000
NODE_2855_length_1361_cov_24.574485	528	608	0	50	80	0.6250000
NODE_2855_length_1361_cov_24.574485	528	608	8	30	80	0.3750000
NODE_2855_length_1361_cov_24.574485	581	661	6	21	80	0.2625000
NODE_2855_length_1361_cov_24.574485	581	661	8	59	80	0.7375000
NODE_2856_length_1361_cov_20.148970	866	946	0	80	80	1.0000000
NODE_2856_length_1361_cov_20.148970	919	999	0	80	80	1.0000000
NODE_2858_length_1361_cov_10.530903	1139	1219	4	15	80	0.1875000
NODE_2858_length_1361_cov_10.530903	1139	1219	6	65	80	0.8125000
NODE_2858_length_1361_cov_10.530903	1139	1219	4	15	80	0.1875000
NODE_2858_length_1361_cov_10.530903	1139	1219	6	65	80	0.8125000
NODE_2858_length_1361_cov_10.530903	1192	1277	0	27	85	0.3176471
NODE_2858_length_1361_cov_10.530903	1192	1277	2	6	85	0.0705882
NODE_2858_length_1361_cov_10.530903	1192	1277	6	52	85	0.6117647
NODE_2858_length_1361_cov_10.530903	1273	1353	0	80	80	1.0000000
NODE_2858_length_1361_cov_10.530903	1273	1353	0	80	80	1.0000000
NODE_2858_length_1361_cov_10.530903	1273	1353	0	80	80	1.0000000
NODE_2858_length_1361_cov_10.530903	1273	1353	0	80	80	1.0000000
NODE_2858_length_1361_cov_10.530903	1273	1353	0	80	80	1.0000000
NODE_2858_length_1361_cov_10.530903	1273	1353	0	80	80	1.0000000
NODE_2859_length_1360_cov_42.789056	351	431	0	52	80	0.6500000
NODE_2859_length_1360_cov_42.789056	351	431	10	22	80	0.2750000
NODE_2859_length_1360_cov_42.789056	351	431	16	6	80	0.0750000
NODE_2859_length_1360_cov_42.789056	404	484	10	21	80	0.2625000
NODE_2859_length_1360_cov_42.789056	404	484	15	17	80	0.2125000
NODE_2859_length_1360_cov_42.789056	404	484	16	42	80	0.5250000
NODE_2860_length_1360_cov_26.407613	531	611	0	4	80	0.0500000
NODE_2860_length_1360_cov_26.407613	531	611	2	5	80	0.0625000
NODE_2860_length_1360_cov_26.407613	531	611	10	1	80	0.0125000
NODE_2860_length_1360_cov_26.407613	531	611	14	5	80	0.0625000
NODE_2860_length_1360_cov_26.407613	531	611	24	41	80	0.5125000
NODE_2860_length_1360_cov_26.407613	531	611	32	24	80	0.3000000
NODE_2860_length_1360_cov_26.407613	584	669	16	14	85	0.1647059
NODE_2860_length_1360_cov_26.407613	584	669	24	25	85	0.2941177
NODE_2860_length_1360_cov_26.407613	584	669	28	5	85	0.0588235
NODE_2860_length_1360_cov_26.407613	584	669	30	16	85	0.1882353
NODE_2860_length_1360_cov_26.407613	584	669	32	25	85	0.2941177
NODE_2861_length_1360_cov_16.182395	796	876	1	39	80	0.4875000
NODE_2861_length_1360_cov_16.182395	796	876	3	33	80	0.4125000
NODE_2861_length_1360_cov_16.182395	796	876	4	8	80	0.1000000
NODE_2861_length_1360_cov_16.182395	849	929	1	5	80	0.0625000
NODE_2861_length_1360_cov_16.182395	849	929	3	67	80	0.8375000
NODE_2861_length_1360_cov_16.182395	849	929	4	8	80	0.1000000
NODE_2861_length_1360_cov_16.182395	925	1005	0	5	80	0.0625000
NODE_2861_length_1360_cov_16.182395	925	1005	1	75	80	0.9375000
NODE_2861_length_1360_cov_16.182395	978	1058	0	58	80	0.7250000
NODE_2861_length_1360_cov_16.182395	978	1058	1	22	80	0.2750000
NODE_2862_length_1360_cov_12.763680	582	662	0	80	80	1.0000000
NODE_2862_length_1360_cov_12.763680	635	715	0	80	80	1.0000000
NODE_2866_length_1359_cov_41.324603	674	754	0	33	80	0.4125000
NODE_2866_length_1359_cov_41.324603	674	754	2	47	80	0.5875000
NODE_2866_length_1359_cov_41.324603	727	807	0	80	80	1.0000000
NODE_2866_length_1359_cov_41.324603	803	883	0	80	80	1.0000000
NODE_2866_length_1359_cov_41.324603	856	936	0	80	80	1.0000000
NODE_2871_length_1358_cov_23.427323	292	372	0	80	80	1.0000000
NODE_2871_length_1358_cov_23.427323	345	425	0	80	80	1.0000000
NODE_2872_length_1358_cov_19.489277	411	491	0	80	80	1.0000000
NODE_2872_length_1358_cov_19.489277	464	544	0	80	80	1.0000000
NODE_2875_length_1357_cov_15.962639	732	812	0	80	80	1.0000000
NODE_2875_length_1357_cov_15.962639	785	865	0	80	80	1.0000000
NODE_2879_length_1354_cov_9.854980	735	815	0	10	80	0.1250000
NODE_2879_length_1354_cov_9.854980	735	815	2	70	80	0.8750000
NODE_2879_length_1354_cov_9.854980	788	868	0	16	80	0.2000000
NODE_2879_length_1354_cov_9.854980	788	868	2	64	80	0.8000000
NODE_2882_length_1353_cov_32.982456	708	788	0	80	80	1.0000000
NODE_2882_length_1353_cov_32.982456	761	841	0	80	80	1.0000000
NODE_2883_length_1353_cov_21.775120	493	573	0	80	80	1.0000000
NODE_2883_length_1353_cov_21.775120	546	626	0	74	80	0.9250000
NODE_2883_length_1353_cov_21.775120	546	626	2	6	80	0.0750000
NODE_2884_length_1353_cov_18.201754	696	776	2	20	80	0.2500000
NODE_2884_length_1353_cov_18.201754	696	776	5	36	80	0.4500000
NODE_2884_length_1353_cov_18.201754	696	776	6	24	80	0.3000000
NODE_2884_length_1353_cov_18.201754	749	829	1	11	80	0.1375000
NODE_2884_length_1353_cov_18.201754	749	829	2	62	80	0.7750000
NODE_2884_length_1353_cov_18.201754	749	829	6	7	80	0.0875000
NODE_2888_length_1352_cov_26.942538	455	535	0	24	80	0.3000000
NODE_2888_length_1352_cov_26.942538	455	535	4	56	80	0.7000000
NODE_2888_length_1352_cov_26.942538	508	588	0	5	80	0.0625000
NODE_2888_length_1352_cov_26.942538	508	588	2	13	80	0.1625000
NODE_2888_length_1352_cov_26.942538	508	588	4	62	80	0.7750000
NODE_2889_length_1352_cov_17.189944	717	797	0	80	80	1.0000000
NODE_2889_length_1352_cov_17.189944	770	850	0	73	80	0.9125000
NODE_2889_length_1352_cov_17.189944	770	850	2	7	80	0.0875000
NODE_2890_length_1352_cov_15.752594	640	720	0	80	80	1.0000000
NODE_2890_length_1352_cov_15.752594	693	773	0	80	80	1.0000000
NODE_2891_length_1352_cov_10.699920	237	317	0	80	80	1.0000000
NODE_2891_length_1352_cov_10.699920	290	370	0	80	80	1.0000000
NODE_2894_length_1351_cov_32.325879	561	641	0	80	80	1.0000000
NODE_2894_length_1351_cov_32.325879	614	694	0	80	80	1.0000000
NODE_2895_length_1351_cov_16.861022	97	162	39	1	65	0.0153846
NODE_2895_length_1351_cov_16.861022	97	162	40	1	65	0.0153846
NODE_2895_length_1351_cov_16.861022	97	162	42	1	65	0.0153846
NODE_2895_length_1351_cov_16.861022	97	162	46	1	65	0.0153846
NODE_2895_length_1351_cov_16.861022	97	162	56	2	65	0.0307692
NODE_2895_length_1351_cov_16.861022	97	162	71	1	65	0.0153846
NODE_2895_length_1351_cov_16.861022	97	162	72	6	65	0.0923077
NODE_2895_length_1351_cov_16.861022	97	162	78	4	65	0.0615385
NODE_2895_length_1351_cov_16.861022	97	162	80	2	65	0.0307692
NODE_2895_length_1351_cov_16.861022	97	162	82	1	65	0.0153846
NODE_2895_length_1351_cov_16.861022	97	162	84	1	65	0.0153846
NODE_2895_length_1351_cov_16.861022	97	162	86	7	65	0.1076923
NODE_2895_length_1351_cov_16.861022	97	162	88	14	65	0.2153846
NODE_2895_length_1351_cov_16.861022	97	162	89	22	65	0.3384615
NODE_2895_length_1351_cov_16.861022	97	162	90	1	65	0.0153846
NODE_2896_length_1351_cov_9.894569	331	411	0	80	80	1.0000000
NODE_2896_length_1351_cov_9.894569	384	464	0	80	80	1.0000000
NODE_2897_length_1351_cov_8.699681	1055	1137	0	75	82	0.9146342
NODE_2897_length_1351_cov_8.699681	1055	1137	24	1	82	0.0121951
NODE_2897_length_1351_cov_8.699681	1055	1137	25	1	82	0.0121951
NODE_2897_length_1351_cov_8.699681	1055	1137	29	5	82	0.0609756
NODE_2897_length_1351_cov_8.699681	1110	1175	0	65	65	1.0000000
NODE_2898_length_1351_cov_2.931310	68	148	40	1	80	0.0125000
NODE_2898_length_1351_cov_2.931310	68	148	42	1	80	0.0125000
NODE_2898_length_1351_cov_2.931310	68	148	44	3	80	0.0375000
NODE_2898_length_1351_cov_2.931310	68	148	45	9	80	0.1125000
NODE_2898_length_1351_cov_2.931310	68	148	47	3	80	0.0375000
NODE_2898_length_1351_cov_2.931310	68	148	49	1	80	0.0125000
NODE_2898_length_1351_cov_2.931310	68	148	51	2	80	0.0250000
NODE_2898_length_1351_cov_2.931310	68	148	53	7	80	0.0875000
NODE_2898_length_1351_cov_2.931310	68	148	57	5	80	0.0625000
NODE_2898_length_1351_cov_2.931310	68	148	59	8	80	0.1000000
NODE_2898_length_1351_cov_2.931310	68	148	61	2	80	0.0250000
NODE_2898_length_1351_cov_2.931310	68	148	64	10	80	0.1250000
NODE_2898_length_1351_cov_2.931310	68	148	65	9	80	0.1125000
NODE_2898_length_1351_cov_2.931310	68	148	66	7	80	0.0875000
NODE_2898_length_1351_cov_2.931310	68	148	67	12	80	0.1500000
NODE_2898_length_1351_cov_2.931310	495	528	0	33	33	1.0000000
NODE_2899_length_1350_cov_18.274181	424	504	0	51	80	0.6375000
NODE_2899_length_1350_cov_18.274181	424	504	2	29	80	0.3625000
NODE_2899_length_1350_cov_18.274181	477	557	2	48	80	0.6000000
NODE_2899_length_1350_cov_18.274181	477	557	10	5	80	0.0625000
NODE_2899_length_1350_cov_18.274181	477	557	15	10	80	0.1250000
NODE_2899_length_1350_cov_18.274181	477	557	16	12	80	0.1500000
NODE_2899_length_1350_cov_18.274181	477	557	17	5	80	0.0625000
NODE_2899_length_1350_cov_18.274181	553	633	15	31	80	0.3875000
NODE_2899_length_1350_cov_18.274181	553	633	16	29	80	0.3625000
NODE_2899_length_1350_cov_18.274181	553	633	20	20	80	0.2500000
NODE_2899_length_1350_cov_18.274181	606	686	4	6	80	0.0750000
NODE_2899_length_1350_cov_18.274181	606	686	11	5	80	0.0625000
NODE_2899_length_1350_cov_18.274181	606	686	16	7	80	0.0875000
NODE_2899_length_1350_cov_18.274181	606	686	19	1	80	0.0125000
NODE_2899_length_1350_cov_18.274181	606	686	20	61	80	0.7625000
NODE_2900_length_1350_cov_8.053557	737	817	0	80	80	1.0000000
NODE_2900_length_1350_cov_8.053557	790	870	0	80	80	1.0000000
NODE_2903_length_1349_cov_23.782400	839	919	0	80	80	1.0000000
NODE_2903_length_1349_cov_23.782400	892	972	0	80	80	1.0000000
NODE_2903_length_1349_cov_23.782400	968	1048	0	43	80	0.5375000
NODE_2903_length_1349_cov_23.782400	968	1048	2	37	80	0.4625000
NODE_2903_length_1349_cov_23.782400	1021	1101	2	80	80	1.0000000
NODE_2904_length_1349_cov_17.776800	811	891	0	80	80	1.0000000
NODE_2904_length_1349_cov_17.776800	864	944	0	80	80	1.0000000
NODE_2905_length_1349_cov_16.468800	828	908	0	80	80	1.0000000
NODE_2905_length_1349_cov_16.468800	881	961	0	80	80	1.0000000
NODE_2908_length_1348_cov_22.731785	468	548	0	66	80	0.8250000
NODE_2908_length_1348_cov_22.731785	468	548	4	14	80	0.1750000
NODE_2908_length_1348_cov_22.731785	521	601	0	13	80	0.1625000
NODE_2908_length_1348_cov_22.731785	521	601	4	67	80	0.8375000
NODE_2909_length_1348_cov_20.778223	517	597	0	80	80	1.0000000
NODE_2909_length_1348_cov_20.778223	570	650	0	80	80	1.0000000
NODE_2910_length_1348_cov_11.180144	673	753	0	15	80	0.1875000
NODE_2910_length_1348_cov_11.180144	673	753	2	40	80	0.5000000
NODE_2910_length_1348_cov_11.180144	673	753	4	25	80	0.3125000
NODE_2910_length_1348_cov_11.180144	726	806	2	27	80	0.3375000
NODE_2910_length_1348_cov_11.180144	726	806	4	53	80	0.6625000
NODE_2916_length_1347_cov_45.906250	683	763	0	80	80	1.0000000
NODE_2916_length_1347_cov_45.906250	736	816	0	80	80	1.0000000
NODE_2916_length_1347_cov_45.906250	812	892	0	80	80	1.0000000
NODE_2916_length_1347_cov_45.906250	865	945	0	80	80	1.0000000
NODE_2917_length_1347_cov_41.643429	439	519	4	9	80	0.1125000
NODE_2917_length_1347_cov_41.643429	439	519	6	16	80	0.2000000
NODE_2917_length_1347_cov_41.643429	439	519	8	20	80	0.2500000
NODE_2917_length_1347_cov_41.643429	439	519	10	35	80	0.4375000
NODE_2917_length_1347_cov_41.643429	492	572	0	42	80	0.5250000
NODE_2917_length_1347_cov_41.643429	492	572	2	9	80	0.1125000
NODE_2917_length_1347_cov_41.643429	492	572	4	11	80	0.1375000
NODE_2917_length_1347_cov_41.643429	492	572	6	16	80	0.2000000
NODE_2917_length_1347_cov_41.643429	492	572	8	2	80	0.0250000
NODE_2918_length_1347_cov_19.941506	458	538	0	80	80	1.0000000
NODE_2918_length_1347_cov_19.941506	511	591	0	80	80	1.0000000
NODE_2918_length_1347_cov_19.941506	587	667	0	80	80	1.0000000
NODE_2918_length_1347_cov_19.941506	640	720	0	80	80	1.0000000
NODE_2919_length_1347_cov_16.520833	713	793	0	80	80	1.0000000
NODE_2919_length_1347_cov_16.520833	766	846	0	80	80	1.0000000
NODE_2920_length_1347_cov_15.967147	638	718	0	80	80	1.0000000
NODE_2920_length_1347_cov_15.967147	691	771	0	80	80	1.0000000
NODE_2925_length_1346_cov_13.112269	429	509	0	80	80	1.0000000
NODE_2925_length_1346_cov_13.112269	482	562	0	80	80	1.0000000
NODE_2928_length_1345_cov_32.099518	629	709	2	60	80	0.7500000
NODE_2928_length_1345_cov_32.099518	629	709	4	20	80	0.2500000
NODE_2928_length_1345_cov_32.099518	682	762	2	70	80	0.8750000
NODE_2928_length_1345_cov_32.099518	682	762	4	10	80	0.1250000
NODE_2929_length_1345_cov_19.837881	723	803	0	80	80	1.0000000
NODE_2929_length_1345_cov_19.837881	776	856	0	80	80	1.0000000
NODE_2930_length_1345_cov_14.262440	361	441	0	80	80	1.0000000
NODE_2930_length_1345_cov_14.262440	414	494	0	80	80	1.0000000
NODE_2930_length_1345_cov_14.262440	490	570	0	80	80	1.0000000
NODE_2930_length_1345_cov_14.262440	543	623	0	33	80	0.4125000
NODE_2930_length_1345_cov_14.262440	543	623	4	47	80	0.5875000
NODE_2931_length_1345_cov_14.103531	950	1030	0	80	80	1.0000000
NODE_2931_length_1345_cov_14.103531	1003	1083	0	80	80	1.0000000
NODE_2934_length_1344_cov_15.013655	345	425	0	41	80	0.5125000
NODE_2934_length_1344_cov_15.013655	345	425	1	39	80	0.4875000
NODE_2934_length_1344_cov_15.013655	398	478	1	53	80	0.6625000
NODE_2934_length_1344_cov_15.013655	398	478	2	27	80	0.3375000
NODE_2935_length_1344_cov_11.383133	519	599	0	80	80	1.0000000
NODE_2935_length_1344_cov_11.383133	572	652	0	80	80	1.0000000
NODE_2935_length_1344_cov_11.383133	648	728	0	41	80	0.5125000
NODE_2935_length_1344_cov_11.383133	648	728	4	4	80	0.0500000
NODE_2935_length_1344_cov_11.383133	648	728	6	35	80	0.4375000
NODE_2935_length_1344_cov_11.383133	701	781	4	18	80	0.2250000
NODE_2935_length_1344_cov_11.383133	701	781	6	62	80	0.7750000
NODE_2936_length_1344_cov_10.924498	529	609	0	60	80	0.7500000
NODE_2936_length_1344_cov_10.924498	529	609	2	20	80	0.2500000
NODE_2936_length_1344_cov_10.924498	582	662	0	80	80	1.0000000
NODE_2937_length_1344_cov_5.531727	920	975	0	55	55	1.0000000
NODE_2942_length_1343_cov_36.005627	150	230	51	1	80	0.0125000
NODE_2942_length_1343_cov_36.005627	150	230	53	1	80	0.0125000
NODE_2942_length_1343_cov_36.005627	150	230	59	3	80	0.0375000
NODE_2942_length_1343_cov_36.005627	150	230	62	2	80	0.0250000
NODE_2942_length_1343_cov_36.005627	150	230	64	1	80	0.0125000
NODE_2942_length_1343_cov_36.005627	150	230	68	3	80	0.0375000
NODE_2942_length_1343_cov_36.005627	150	230	70	6	80	0.0750000
NODE_2942_length_1343_cov_36.005627	150	230	76	3	80	0.0375000
NODE_2942_length_1343_cov_36.005627	150	230	80	2	80	0.0250000
NODE_2942_length_1343_cov_36.005627	150	230	82	10	80	0.1250000
NODE_2942_length_1343_cov_36.005627	150	230	86	10	80	0.1250000
NODE_2942_length_1343_cov_36.005627	150	230	90	6	80	0.0750000
NODE_2942_length_1343_cov_36.005627	150	230	91	17	80	0.2125000
NODE_2942_length_1343_cov_36.005627	150	230	92	5	80	0.0625000
NODE_2942_length_1343_cov_36.005627	150	230	94	4	80	0.0500000
NODE_2942_length_1343_cov_36.005627	150	230	97	1	80	0.0125000
NODE_2942_length_1343_cov_36.005627	150	230	98	5	80	0.0625000
NODE_2942_length_1343_cov_36.005627	286	366	0	65	80	0.8125000
NODE_2942_length_1343_cov_36.005627	286	366	1	15	80	0.1875000
NODE_2942_length_1343_cov_36.005627	339	419	0	80	80	1.0000000
NODE_2942_length_1343_cov_36.005627	415	495	0	80	80	1.0000000
NODE_2942_length_1343_cov_36.005627	468	548	0	80	80	1.0000000
NODE_2943_length_1343_cov_26.826367	782	862	0	80	80	1.0000000
NODE_2943_length_1343_cov_26.826367	835	915	0	80	80	1.0000000
NODE_2944_length_1343_cov_19.353698	799	879	0	80	80	1.0000000
NODE_2944_length_1343_cov_19.353698	852	932	0	80	80	1.0000000
NODE_2944_length_1343_cov_19.353698	928	1008	0	80	80	1.0000000
NODE_2944_length_1343_cov_19.353698	981	1061	0	80	80	1.0000000
NODE_2945_length_1343_cov_15.717846	745	825	0	80	80	1.0000000
NODE_2945_length_1343_cov_15.717846	798	878	0	80	80	1.0000000
NODE_2949_length_1342_cov_30.491553	456	536	7	49	80	0.6125000
NODE_2949_length_1342_cov_30.491553	456	536	11	12	80	0.1500000
NODE_2949_length_1342_cov_30.491553	456	536	13	9	80	0.1125000
NODE_2949_length_1342_cov_30.491553	456	536	14	10	80	0.1250000
NODE_2949_length_1342_cov_30.491553	509	589	3	6	80	0.0750000
NODE_2949_length_1342_cov_30.491553	509	589	9	10	80	0.1250000
NODE_2949_length_1342_cov_30.491553	509	589	11	8	80	0.1000000
NODE_2949_length_1342_cov_30.491553	509	589	13	17	80	0.2125000
NODE_2949_length_1342_cov_30.491553	509	589	14	39	80	0.4875000
NODE_2949_length_1342_cov_30.491553	585	665	1	42	80	0.5250000
NODE_2949_length_1342_cov_30.491553	585	665	3	8	80	0.1000000
NODE_2949_length_1342_cov_30.491553	585	665	5	22	80	0.2750000
NODE_2949_length_1342_cov_30.491553	585	665	7	8	80	0.1000000
NODE_2949_length_1342_cov_30.491553	638	718	4	21	80	0.2625000
NODE_2949_length_1342_cov_30.491553	638	718	5	19	80	0.2375000
NODE_2949_length_1342_cov_30.491553	638	718	6	21	80	0.2625000
NODE_2949_length_1342_cov_30.491553	638	718	7	19	80	0.2375000
NODE_2950_length_1342_cov_26.796460	538	618	0	80	80	1.0000000
NODE_2950_length_1342_cov_26.796460	591	671	0	80	80	1.0000000
NODE_2950_length_1342_cov_26.796460	667	747	0	80	80	1.0000000
NODE_2950_length_1342_cov_26.796460	720	800	0	32	80	0.4000000
NODE_2950_length_1342_cov_26.796460	720	800	2	48	80	0.6000000
NODE_2951_length_1342_cov_22.769912	298	378	0	80	80	1.0000000
NODE_2951_length_1342_cov_22.769912	351	431	0	80	80	1.0000000
NODE_2951_length_1342_cov_22.769912	427	507	0	80	80	1.0000000
NODE_2951_length_1342_cov_22.769912	480	560	0	80	80	1.0000000
NODE_2953_length_1341_cov_22.449275	494	574	0	21	80	0.2625000
NODE_2953_length_1341_cov_22.449275	494	574	1	33	80	0.4125000
NODE_2953_length_1341_cov_22.449275	494	574	4	26	80	0.3250000
NODE_2953_length_1341_cov_22.449275	547	627	1	38	80	0.4750000
NODE_2953_length_1341_cov_22.449275	547	627	2	42	80	0.5250000
NODE_2953_length_1341_cov_22.449275	623	703	1	12	80	0.1500000
NODE_2953_length_1341_cov_22.449275	623	703	2	68	80	0.8500000
NODE_2953_length_1341_cov_22.449275	676	755	0	20	79	0.2531646
NODE_2953_length_1341_cov_22.449275	676	755	1	44	79	0.5569620
NODE_2953_length_1341_cov_22.449275	676	755	2	15	79	0.1898734
NODE_2954_length_1341_cov_14.497585	415	495	0	35	80	0.4375000
NODE_2954_length_1341_cov_14.497585	415	495	2	45	80	0.5625000
NODE_2954_length_1341_cov_14.497585	468	548	0	8	80	0.1000000
NODE_2954_length_1341_cov_14.497585	468	548	2	72	80	0.9000000
NODE_2954_length_1341_cov_14.497585	544	624	0	80	80	1.0000000
NODE_2954_length_1341_cov_14.497585	597	677	0	80	80	1.0000000
NODE_2960_length_1340_cov_9.460113	531	611	0	80	80	1.0000000
NODE_2960_length_1340_cov_9.460113	584	664	0	80	80	1.0000000
NODE_2961_length_1340_cov_6.511684	735	815	0	80	80	1.0000000
NODE_2961_length_1340_cov_6.511684	788	868	0	80	80	1.0000000
NODE_2966_length_1339_cov_22.725000	751	831	0	80	80	1.0000000
NODE_2966_length_1339_cov_22.725000	804	884	0	80	80	1.0000000
NODE_2967_length_1339_cov_9.322581	329	409	0	80	80	1.0000000
NODE_2967_length_1339_cov_9.322581	382	462	0	80	80	1.0000000
NODE_2970_length_1338_cov_31.740920	527	607	0	9	80	0.1125000
NODE_2970_length_1338_cov_31.740920	527	607	2	24	80	0.3000000
NODE_2970_length_1338_cov_31.740920	527	607	4	47	80	0.5875000
NODE_2970_length_1338_cov_31.740920	580	660	0	20	80	0.2500000
NODE_2970_length_1338_cov_31.740920	580	660	2	2	80	0.0250000
NODE_2970_length_1338_cov_31.740920	580	660	4	58	80	0.7250000
NODE_2970_length_1338_cov_31.740920	656	736	0	45	80	0.5625000
NODE_2970_length_1338_cov_31.740920	656	736	1	13	80	0.1625000
NODE_2970_length_1338_cov_31.740920	656	736	3	22	80	0.2750000
NODE_2970_length_1338_cov_31.740920	709	789	1	5	80	0.0625000
NODE_2970_length_1338_cov_31.740920	709	789	3	75	80	0.9375000
NODE_2971_length_1338_cov_21.254237	639	719	0	80	80	1.0000000
NODE_2971_length_1338_cov_21.254237	692	772	0	80	80	1.0000000
NODE_2974_length_1337_cov_32.307754	739	819	2	80	80	1.0000000
NODE_2974_length_1337_cov_32.307754	792	872	1	19	80	0.2375000
NODE_2974_length_1337_cov_32.307754	792	872	2	61	80	0.7625000
NODE_2975_length_1337_cov_30.412763	465	545	0	80	80	1.0000000
NODE_2975_length_1337_cov_30.412763	518	598	0	65	80	0.8125000
NODE_2975_length_1337_cov_30.412763	518	598	22	1	80	0.0125000
NODE_2975_length_1337_cov_30.412763	518	598	42	2	80	0.0250000
NODE_2975_length_1337_cov_30.412763	518	598	60	2	80	0.0250000
NODE_2975_length_1337_cov_30.412763	518	598	62	2	80	0.0250000
NODE_2975_length_1337_cov_30.412763	518	598	70	2	80	0.0250000
NODE_2975_length_1337_cov_30.412763	518	598	72	2	80	0.0250000
NODE_2975_length_1337_cov_30.412763	518	598	74	1	80	0.0125000
NODE_2975_length_1337_cov_30.412763	518	598	75	1	80	0.0125000
NODE_2975_length_1337_cov_30.412763	518	598	77	2	80	0.0250000
NODE_2976_length_1337_cov_12.760905	560	640	0	60	80	0.7500000
NODE_2976_length_1337_cov_12.760905	560	640	2	20	80	0.2500000
NODE_2976_length_1337_cov_12.760905	613	693	0	80	80	1.0000000
NODE_2977_length_1337_cov_9.463651	724	804	0	17	80	0.2125000
NODE_2977_length_1337_cov_9.463651	724	804	4	63	80	0.7875000
NODE_2977_length_1337_cov_9.463651	777	857	0	1	80	0.0125000
NODE_2977_length_1337_cov_9.463651	777	857	4	79	80	0.9875000
NODE_2979_length_1337_cov_4.540388	216	296	0	80	80	1.0000000
NODE_2979_length_1337_cov_4.540388	272	349	0	77	77	1.0000000
NODE_2981_length_1336_cov_28.161681	394	474	0	48	80	0.6000000
NODE_2981_length_1336_cov_28.161681	394	474	2	32	80	0.4000000
NODE_2981_length_1336_cov_28.161681	447	527	2	80	80	1.0000000
NODE_2981_length_1336_cov_28.161681	523	603	0	50	80	0.6250000
NODE_2981_length_1336_cov_28.161681	523	603	2	30	80	0.3750000
NODE_2981_length_1336_cov_28.161681	576	656	0	80	80	1.0000000
NODE_2982_length_1336_cov_7.860954	17	98	2	25	81	0.3086420
NODE_2982_length_1336_cov_7.860954	17	98	8	56	81	0.6913580
NODE_2984_length_1336_cov_1.689572	1229	1289	4	59	60	0.9833333
NODE_2984_length_1336_cov_1.689572	1229	1289	6	1	60	0.0166667
NODE_2984_length_1336_cov_1.689572	1262	1336	0	19	74	0.2567568
NODE_2984_length_1336_cov_1.689572	1262	1336	4	55	74	0.7432432
NODE_2985_length_1335_cov_19.547735	530	607	0	12	77	0.1558442
NODE_2985_length_1335_cov_19.547735	530	607	2	65	77	0.8441558
NODE_2985_length_1335_cov_19.547735	582	660	0	36	78	0.4615385
NODE_2985_length_1335_cov_19.547735	582	660	2	42	78	0.5384616
NODE_2985_length_1335_cov_19.547735	656	736	0	23	80	0.2875000
NODE_2985_length_1335_cov_19.547735	656	736	2	57	80	0.7125000
NODE_2985_length_1335_cov_19.547735	709	789	0	17	80	0.2125000
NODE_2985_length_1335_cov_19.547735	709	789	2	63	80	0.7875000
NODE_2986_length_1335_cov_15.383495	419	499	2	80	80	1.0000000
NODE_2986_length_1335_cov_15.383495	472	552	0	51	80	0.6375000
NODE_2986_length_1335_cov_15.383495	472	552	2	29	80	0.3625000
NODE_2986_length_1335_cov_15.383495	548	628	0	80	80	1.0000000
NODE_2986_length_1335_cov_15.383495	601	681	0	80	80	1.0000000
NODE_2991_length_1333_cov_27.372771	493	573	0	80	80	1.0000000
NODE_2991_length_1333_cov_27.372771	546	626	0	80	80	1.0000000
NODE_2996_length_1332_cov_18.978913	648	728	2	70	80	0.8750000
NODE_2996_length_1332_cov_18.978913	648	728	3	2	80	0.0250000
NODE_2996_length_1332_cov_18.978913	648	728	4	8	80	0.1000000
NODE_2996_length_1332_cov_18.978913	701	781	2	80	80	1.0000000
NODE_2996_length_1332_cov_18.978913	777	857	2	23	80	0.2875000
NODE_2996_length_1332_cov_18.978913	777	857	3	2	80	0.0250000
NODE_2996_length_1332_cov_18.978913	777	857	4	55	80	0.6875000
NODE_2996_length_1332_cov_18.978913	830	910	0	13	80	0.1625000
NODE_2996_length_1332_cov_18.978913	830	910	2	5	80	0.0625000
NODE_2996_length_1332_cov_18.978913	830	910	4	62	80	0.7750000
NODE_2997_length_1332_cov_3.112733	87	151	4	26	64	0.4062500
NODE_2997_length_1332_cov_3.112733	87	151	5	3	64	0.0468750
NODE_2997_length_1332_cov_3.112733	87	151	6	23	64	0.3593750
NODE_2997_length_1332_cov_3.112733	87	151	8	1	64	0.0156250
NODE_2997_length_1332_cov_3.112733	87	151	9	1	64	0.0156250
NODE_2997_length_1332_cov_3.112733	87	151	10	1	64	0.0156250
NODE_2997_length_1332_cov_3.112733	87	151	12	1	64	0.0156250
NODE_2997_length_1332_cov_3.112733	87	151	14	2	64	0.0312500
NODE_2997_length_1332_cov_3.112733	87	151	16	6	64	0.0937500
NODE_3000_length_1331_cov_16.831981	392	472	0	80	80	1.0000000
NODE_3000_length_1331_cov_16.831981	445	525	0	80	80	1.0000000
NODE_3000_length_1331_cov_16.831981	521	601	0	33	80	0.4125000
NODE_3000_length_1331_cov_16.831981	521	601	4	34	80	0.4250000
NODE_3000_length_1331_cov_16.831981	521	601	6	13	80	0.1625000
NODE_3000_length_1331_cov_16.831981	574	654	4	48	80	0.6000000
NODE_3000_length_1331_cov_16.831981	574	654	6	23	80	0.2875000
NODE_3000_length_1331_cov_16.831981	574	654	8	9	80	0.1125000
NODE_3001_length_1331_cov_12.841721	871	951	1	80	80	1.0000000
NODE_3001_length_1331_cov_12.841721	924	1004	1	80	80	1.0000000
NODE_3004_length_1331_cov_2.090097	0	76	0	76	76	1.0000000
NODE_3004_length_1331_cov_2.090097	49	98	0	49	49	1.0000000
NODE_3007_length_1330_cov_48.993501	278	358	0	39	80	0.4875000
NODE_3007_length_1330_cov_48.993501	278	358	2	41	80	0.5125000
NODE_3007_length_1330_cov_48.993501	331	411	0	37	80	0.4625000
NODE_3007_length_1330_cov_48.993501	331	411	2	43	80	0.5375000
NODE_3007_length_1330_cov_48.993501	742	822	0	80	80	1.0000000
NODE_3007_length_1330_cov_48.993501	795	875	0	80	80	1.0000000
NODE_3008_length_1330_cov_11.037368	407	487	0	80	80	1.0000000
NODE_3008_length_1330_cov_11.037368	460	540	0	80	80	1.0000000
NODE_3008_length_1330_cov_11.037368	536	617	0	81	81	1.0000000
NODE_3008_length_1330_cov_11.037368	590	670	0	80	80	1.0000000
NODE_3009_length_1330_cov_9.026807	551	631	13	16	80	0.2000000
NODE_3009_length_1330_cov_9.026807	551	631	14	64	80	0.8000000
NODE_3009_length_1330_cov_9.026807	604	684	0	16	80	0.2000000
NODE_3009_length_1330_cov_9.026807	604	684	12	1	80	0.0125000
NODE_3009_length_1330_cov_9.026807	604	684	14	63	80	0.7875000
NODE_3011_length_1329_cov_17.036585	691	771	0	53	80	0.6625000
NODE_3011_length_1329_cov_17.036585	691	771	4	27	80	0.3375000
NODE_3011_length_1329_cov_17.036585	744	824	0	80	80	1.0000000
NODE_3011_length_1329_cov_17.036585	820	900	0	48	80	0.6000000
NODE_3011_length_1329_cov_17.036585	820	900	4	32	80	0.4000000
NODE_3011_length_1329_cov_17.036585	873	953	4	80	80	1.0000000
NODE_3012_length_1329_cov_16.341463	428	476	12	1	48	0.0208333
NODE_3012_length_1329_cov_16.341463	428	476	21	2	48	0.0416667
NODE_3012_length_1329_cov_16.341463	428	476	30	4	48	0.0833333
NODE_3012_length_1329_cov_16.341463	428	476	32	6	48	0.1250000
NODE_3012_length_1329_cov_16.341463	428	476	34	2	48	0.0416667
NODE_3012_length_1329_cov_16.341463	428	476	40	1	48	0.0208333
NODE_3012_length_1329_cov_16.341463	428	476	44	3	48	0.0625000
NODE_3012_length_1329_cov_16.341463	428	476	48	1	48	0.0208333
NODE_3012_length_1329_cov_16.341463	428	476	52	1	48	0.0208333
NODE_3012_length_1329_cov_16.341463	428	476	54	2	48	0.0416667
NODE_3012_length_1329_cov_16.341463	428	476	55	2	48	0.0416667
NODE_3012_length_1329_cov_16.341463	428	476	59	6	48	0.1250000
NODE_3012_length_1329_cov_16.341463	428	476	63	1	48	0.0208333
NODE_3012_length_1329_cov_16.341463	428	476	67	1	48	0.0208333
NODE_3012_length_1329_cov_16.341463	428	476	69	1	48	0.0208333
NODE_3012_length_1329_cov_16.341463	428	476	71	1	48	0.0208333
NODE_3012_length_1329_cov_16.341463	428	476	73	1	48	0.0208333
NODE_3012_length_1329_cov_16.341463	428	476	76	2	48	0.0416667
NODE_3012_length_1329_cov_16.341463	428	476	83	2	48	0.0416667
NODE_3012_length_1329_cov_16.341463	428	476	85	1	48	0.0208333
NODE_3012_length_1329_cov_16.341463	428	476	88	1	48	0.0208333
NODE_3012_length_1329_cov_16.341463	428	476	92	2	48	0.0416667
NODE_3012_length_1329_cov_16.341463	428	476	95	1	48	0.0208333
NODE_3012_length_1329_cov_16.341463	428	476	97	1	48	0.0208333
NODE_3012_length_1329_cov_16.341463	428	476	108	2	48	0.0416667
NODE_3013_length_1329_cov_5.620325	888	955	0	67	67	1.0000000
NODE_3013_length_1329_cov_5.620325	941	999	0	32	58	0.5517241
NODE_3013_length_1329_cov_5.620325	941	999	4	26	58	0.4482759
NODE_3017_length_1328_cov_12.954434	794	874	0	9	80	0.1125000
NODE_3017_length_1328_cov_12.954434	794	874	4	71	80	0.8875000
NODE_3017_length_1328_cov_12.954434	847	927	0	15	80	0.1875000
NODE_3017_length_1328_cov_12.954434	847	927	4	65	80	0.8125000
NODE_3018_length_1328_cov_8.810415	762	842	0	13	80	0.1625000
NODE_3018_length_1328_cov_8.810415	762	842	6	67	80	0.8375000
NODE_3018_length_1328_cov_8.810415	815	895	0	66	80	0.8250000
NODE_3018_length_1328_cov_8.810415	815	895	6	14	80	0.1750000
NODE_3021_length_1327_cov_15.938925	260	340	0	41	80	0.5125000
NODE_3021_length_1327_cov_15.938925	260	340	2	39	80	0.4875000
NODE_3021_length_1327_cov_15.938925	313	393	0	8	80	0.1000000
NODE_3021_length_1327_cov_15.938925	313	393	2	72	80	0.9000000
NODE_3022_length_1327_cov_7.274430	159	235	0	76	76	1.0000000
NODE_3022_length_1327_cov_7.274430	774	854	0	80	80	1.0000000
NODE_3022_length_1327_cov_7.274430	827	890	0	63	63	1.0000000
NODE_3023_length_1327_cov_6.486156	896	976	0	33	80	0.4125000
NODE_3023_length_1327_cov_6.486156	896	976	2	47	80	0.5875000
NODE_3023_length_1327_cov_6.486156	949	1029	0	2	80	0.0250000
NODE_3023_length_1327_cov_6.486156	949	1029	2	78	80	0.9750000
NODE_3029_length_1326_cov_32.382233	571	651	0	80	80	1.0000000
NODE_3029_length_1326_cov_32.382233	624	704	0	59	80	0.7375000
NODE_3029_length_1326_cov_32.382233	624	704	2	21	80	0.2625000
NODE_3030_length_1326_cov_30.614507	760	840	2	20	80	0.2500000
NODE_3030_length_1326_cov_30.614507	760	840	6	60	80	0.7500000
NODE_3030_length_1326_cov_30.614507	813	893	0	47	80	0.5875000
NODE_3030_length_1326_cov_30.614507	813	893	4	2	80	0.0250000
NODE_3030_length_1326_cov_30.614507	813	893	6	31	80	0.3875000
NODE_3031_length_1326_cov_30.304808	488	568	0	46	80	0.5750000
NODE_3031_length_1326_cov_30.304808	488	568	2	34	80	0.4250000
NODE_3031_length_1326_cov_30.304808	541	621	0	80	80	1.0000000
NODE_3031_length_1326_cov_30.304808	617	697	0	11	80	0.1375000
NODE_3031_length_1326_cov_30.304808	617	697	2	69	80	0.8625000
NODE_3031_length_1326_cov_30.304808	670	750	2	80	80	1.0000000
NODE_3032_length_1326_cov_10.913610	238	318	0	80	80	1.0000000
NODE_3032_length_1326_cov_10.913610	291	371	0	80	80	1.0000000
NODE_3036_length_1325_cov_38.136215	0	46	0	46	46	1.0000000
NODE_3036_length_1325_cov_38.136215	19	99	0	78	80	0.9750000
NODE_3036_length_1325_cov_38.136215	19	99	2	2	80	0.0250000
NODE_3036_length_1325_cov_38.136215	948	1022	8	17	74	0.2297297
NODE_3036_length_1325_cov_38.136215	948	1022	10	9	74	0.1216216
NODE_3036_length_1325_cov_38.136215	948	1022	12	8	74	0.1081081
NODE_3036_length_1325_cov_38.136215	948	1022	13	22	74	0.2972973
NODE_3036_length_1325_cov_38.136215	948	1022	14	1	74	0.0135135
NODE_3036_length_1325_cov_38.136215	948	1022	15	7	74	0.0945946
NODE_3036_length_1325_cov_38.136215	948	1022	16	8	74	0.1081081
NODE_3036_length_1325_cov_38.136215	948	1022	17	2	74	0.0270270
NODE_3036_length_1325_cov_38.136215	1001	1063	13	34	62	0.5483871
NODE_3036_length_1325_cov_38.136215	1001	1063	15	5	62	0.0806452
NODE_3036_length_1325_cov_38.136215	1001	1063	16	1	62	0.0161290
NODE_3036_length_1325_cov_38.136215	1001	1063	19	2	62	0.0322581
NODE_3036_length_1325_cov_38.136215	1001	1063	21	1	62	0.0161290
NODE_3036_length_1325_cov_38.136215	1001	1063	23	1	62	0.0161290
NODE_3036_length_1325_cov_38.136215	1001	1063	25	1	62	0.0161290
NODE_3036_length_1325_cov_38.136215	1001	1063	28	1	62	0.0161290
NODE_3036_length_1325_cov_38.136215	1001	1063	31	1	62	0.0161290
NODE_3036_length_1325_cov_38.136215	1001	1063	35	8	62	0.1290323
NODE_3036_length_1325_cov_38.136215	1001	1063	39	1	62	0.0161290
NODE_3036_length_1325_cov_38.136215	1001	1063	41	2	62	0.0322581
NODE_3036_length_1325_cov_38.136215	1001	1063	42	4	62	0.0645161
NODE_3037_length_1325_cov_29.201468	613	693	0	80	80	1.0000000
NODE_3037_length_1325_cov_29.201468	666	746	0	80	80	1.0000000
NODE_3038_length_1325_cov_11.902121	697	777	0	80	80	1.0000000
NODE_3038_length_1325_cov_11.902121	750	830	0	80	80	1.0000000
NODE_3039_length_1325_cov_7.876835	645	725	0	80	80	1.0000000
NODE_3039_length_1325_cov_7.876835	698	778	0	80	80	1.0000000
NODE_3040_length_1325_cov_3.774062	1157	1218	0	59	61	0.9672131
NODE_3040_length_1325_cov_3.774062	1157	1218	2	1	61	0.0163934
NODE_3040_length_1325_cov_3.774062	1157	1218	15	1	61	0.0163934
NODE_3040_length_1325_cov_3.774062	1191	1271	0	80	80	1.0000000
NODE_3041_length_1325_cov_2.896411	0	58	0	25	58	0.4310345
NODE_3041_length_1325_cov_2.896411	0	58	2	33	58	0.5689655
NODE_3041_length_1325_cov_2.896411	8	67	0	17	59	0.2881356
NODE_3041_length_1325_cov_2.896411	8	67	2	42	59	0.7118644
NODE_3046_length_1324_cov_30.340408	939	1019	6	10	80	0.1250000
NODE_3046_length_1324_cov_30.340408	939	1019	7	23	80	0.2875000
NODE_3046_length_1324_cov_30.340408	939	1019	8	21	80	0.2625000
NODE_3046_length_1324_cov_30.340408	939	1019	11	18	80	0.2250000
NODE_3046_length_1324_cov_30.340408	939	1019	12	3	80	0.0375000
NODE_3046_length_1324_cov_30.340408	939	1019	14	1	80	0.0125000
NODE_3046_length_1324_cov_30.340408	939	1019	15	4	80	0.0500000
NODE_3046_length_1324_cov_30.340408	992	1072	6	63	80	0.7875000
NODE_3046_length_1324_cov_30.340408	992	1072	7	17	80	0.2125000
NODE_3047_length_1324_cov_7.391020	742	822	0	80	80	1.0000000
NODE_3047_length_1324_cov_7.391020	795	875	0	80	80	1.0000000
NODE_3053_length_1323_cov_30.600490	392	472	0	47	80	0.5875000
NODE_3053_length_1323_cov_30.600490	392	472	1	33	80	0.4125000
NODE_3053_length_1323_cov_30.600490	445	525	1	46	80	0.5750000
NODE_3053_length_1323_cov_30.600490	445	525	2	30	80	0.3750000
NODE_3053_length_1323_cov_30.600490	445	525	3	4	80	0.0500000
NODE_3053_length_1323_cov_30.600490	521	601	3	27	80	0.3375000
NODE_3053_length_1323_cov_30.600490	521	601	4	45	80	0.5625000
NODE_3053_length_1323_cov_30.600490	521	601	5	8	80	0.1000000
NODE_3053_length_1323_cov_30.600490	574	654	3	4	80	0.0500000
NODE_3053_length_1323_cov_30.600490	574	654	4	28	80	0.3500000
NODE_3053_length_1323_cov_30.600490	574	654	5	48	80	0.6000000
NODE_3054_length_1323_cov_20.888889	758	838	9	25	80	0.3125000
NODE_3054_length_1323_cov_20.888889	758	838	10	28	80	0.3500000
NODE_3054_length_1323_cov_20.888889	758	838	13	27	80	0.3375000
NODE_3054_length_1323_cov_20.888889	811	891	4	51	80	0.6375000
NODE_3054_length_1323_cov_20.888889	811	891	13	29	80	0.3625000
NODE_3061_length_1322_cov_8.988553	287	368	0	81	81	1.0000000
NODE_3061_length_1322_cov_8.988553	341	421	0	80	80	1.0000000
NODE_3061_length_1322_cov_8.988553	417	497	0	80	80	1.0000000
NODE_3061_length_1322_cov_8.988553	470	550	0	80	80	1.0000000
NODE_3068_length_1321_cov_57.885434	359	439	0	76	80	0.9500000
NODE_3068_length_1321_cov_57.885434	359	439	2	4	80	0.0500000
NODE_3068_length_1321_cov_57.885434	412	492	0	23	80	0.2875000
NODE_3068_length_1321_cov_57.885434	412	492	2	12	80	0.1500000
NODE_3068_length_1321_cov_57.885434	412	492	3	21	80	0.2625000
NODE_3068_length_1321_cov_57.885434	412	492	4	24	80	0.3000000
NODE_3068_length_1321_cov_57.885434	488	568	2	8	80	0.1000000
NODE_3068_length_1321_cov_57.885434	488	568	4	59	80	0.7375000
NODE_3068_length_1321_cov_57.885434	488	568	12	2	80	0.0250000
NODE_3068_length_1321_cov_57.885434	488	568	13	6	80	0.0750000
NODE_3068_length_1321_cov_57.885434	488	568	17	5	80	0.0625000
NODE_3068_length_1321_cov_57.885434	541	621	2	8	80	0.1000000
NODE_3068_length_1321_cov_57.885434	541	621	4	6	80	0.0750000
NODE_3068_length_1321_cov_57.885434	541	621	12	2	80	0.0250000
NODE_3068_length_1321_cov_57.885434	541	621	13	6	80	0.0750000
NODE_3068_length_1321_cov_57.885434	541	621	16	13	80	0.1625000
NODE_3068_length_1321_cov_57.885434	541	621	17	45	80	0.5625000
NODE_3071_length_1320_cov_70.753481	432	512	0	3	80	0.0375000
NODE_3071_length_1320_cov_70.753481	432	512	11	1	80	0.0125000
NODE_3071_length_1320_cov_70.753481	432	512	13	18	80	0.2250000
NODE_3071_length_1320_cov_70.753481	432	512	14	58	80	0.7250000
NODE_3071_length_1320_cov_70.753481	485	565	0	13	80	0.1625000
NODE_3071_length_1320_cov_70.753481	485	565	2	43	80	0.5375000
NODE_3071_length_1320_cov_70.753481	485	565	11	1	80	0.0125000
NODE_3071_length_1320_cov_70.753481	485	565	13	4	80	0.0500000
NODE_3071_length_1320_cov_70.753481	485	565	14	19	80	0.2375000
NODE_3071_length_1320_cov_70.753481	561	641	2	68	80	0.8500000
NODE_3071_length_1320_cov_70.753481	561	641	4	12	80	0.1500000
NODE_3071_length_1320_cov_70.753481	614	694	0	16	80	0.2000000
NODE_3071_length_1320_cov_70.753481	614	694	2	64	80	0.8000000
NODE_3072_length_1320_cov_39.149058	715	795	2	16	80	0.2000000
NODE_3072_length_1320_cov_39.149058	715	795	4	47	80	0.5875000
NODE_3072_length_1320_cov_39.149058	715	795	6	17	80	0.2125000
NODE_3072_length_1320_cov_39.149058	768	848	0	11	80	0.1375000
NODE_3072_length_1320_cov_39.149058	768	848	2	58	80	0.7250000
NODE_3072_length_1320_cov_39.149058	768	848	4	11	80	0.1375000
NODE_3072_length_1320_cov_39.149058	844	924	0	9	80	0.1125000
NODE_3072_length_1320_cov_39.149058	844	924	4	71	80	0.8875000
NODE_3072_length_1320_cov_39.149058	897	977	0	28	80	0.3500000
NODE_3072_length_1320_cov_39.149058	897	977	4	52	80	0.6500000
NODE_3073_length_1320_cov_19.175266	707	783	0	76	76	1.0000000
NODE_3073_length_1320_cov_19.175266	760	840	0	80	80	1.0000000
NODE_3074_length_1320_cov_11.224406	860	940	0	35	80	0.4375000
NODE_3074_length_1320_cov_11.224406	860	940	4	5	80	0.0625000
NODE_3074_length_1320_cov_11.224406	860	940	8	19	80	0.2375000
NODE_3074_length_1320_cov_11.224406	860	940	10	21	80	0.2625000
NODE_3074_length_1320_cov_11.224406	913	993	6	21	80	0.2625000
NODE_3074_length_1320_cov_11.224406	913	993	8	6	80	0.0750000
NODE_3074_length_1320_cov_11.224406	913	993	10	53	80	0.6625000
NODE_3075_length_1320_cov_11.036036	760	840	0	80	80	1.0000000
NODE_3075_length_1320_cov_11.036036	813	893	0	80	80	1.0000000
NODE_3076_length_1320_cov_8.357084	800	880	0	59	80	0.7375000
NODE_3076_length_1320_cov_8.357084	800	880	2	21	80	0.2625000
NODE_3076_length_1320_cov_8.357084	853	933	0	80	80	1.0000000
NODE_3080_length_1319_cov_27.098361	630	710	1	29	80	0.3625000
NODE_3080_length_1319_cov_27.098361	630	710	7	51	80	0.6375000
NODE_3080_length_1319_cov_27.098361	683	763	0	2	80	0.0250000
NODE_3080_length_1319_cov_27.098361	683	763	1	78	80	0.9750000
NODE_3081_length_1319_cov_22.992623	490	570	4	54	80	0.6750000
NODE_3081_length_1319_cov_22.992623	490	570	8	5	80	0.0625000
NODE_3081_length_1319_cov_22.992623	490	570	12	10	80	0.1250000
NODE_3081_length_1319_cov_22.992623	490	570	14	11	80	0.1375000
NODE_3081_length_1319_cov_22.992623	543	623	4	10	80	0.1250000
NODE_3081_length_1319_cov_22.992623	543	623	8	9	80	0.1125000
NODE_3081_length_1319_cov_22.992623	543	623	10	29	80	0.3625000
NODE_3081_length_1319_cov_22.992623	543	623	12	10	80	0.1250000
NODE_3081_length_1319_cov_22.992623	543	623	14	22	80	0.2750000
NODE_3086_length_1318_cov_13.624282	642	722	0	80	80	1.0000000
NODE_3086_length_1318_cov_13.624282	695	775	0	80	80	1.0000000
NODE_3086_length_1318_cov_13.624282	771	851	0	80	80	1.0000000
NODE_3086_length_1318_cov_13.624282	824	904	0	80	80	1.0000000
NODE_3089_length_1317_cov_162.041872	66	143	16	5	77	0.0649351
NODE_3089_length_1317_cov_162.041872	66	143	18	5	77	0.0649351
NODE_3089_length_1317_cov_162.041872	66	143	20	9	77	0.1168831
NODE_3089_length_1317_cov_162.041872	66	143	22	1	77	0.0129870
NODE_3089_length_1317_cov_162.041872	66	143	24	17	77	0.2207792
NODE_3089_length_1317_cov_162.041872	66	143	26	1	77	0.0129870
NODE_3089_length_1317_cov_162.041872	66	143	27	1	77	0.0129870
NODE_3089_length_1317_cov_162.041872	66	143	28	4	77	0.0519481
NODE_3089_length_1317_cov_162.041872	66	143	34	31	77	0.4025974
NODE_3089_length_1317_cov_162.041872	66	143	123	1	77	0.0129870
NODE_3089_length_1317_cov_162.041872	66	143	159	1	77	0.0129870
NODE_3089_length_1317_cov_162.041872	66	143	185	1	77	0.0129870
NODE_3090_length_1317_cov_19.736453	675	755	0	52	80	0.6500000
NODE_3090_length_1317_cov_19.736453	675	755	2	28	80	0.3500000
NODE_3090_length_1317_cov_19.736453	728	808	0	9	80	0.1125000
NODE_3090_length_1317_cov_19.736453	728	808	2	71	80	0.8875000
NODE_3090_length_1317_cov_19.736453	804	884	0	80	80	1.0000000
NODE_3090_length_1317_cov_19.736453	857	937	0	80	80	1.0000000
NODE_3092_length_1317_cov_2.203612	779	859	4	10	80	0.1250000
NODE_3092_length_1317_cov_2.203612	779	859	6	7	80	0.0875000
NODE_3092_length_1317_cov_2.203612	779	859	8	2	80	0.0250000
NODE_3092_length_1317_cov_2.203612	779	859	9	1	80	0.0125000
NODE_3092_length_1317_cov_2.203612	779	859	10	8	80	0.1000000
NODE_3092_length_1317_cov_2.203612	779	859	11	2	80	0.0250000
NODE_3092_length_1317_cov_2.203612	779	859	12	26	80	0.3250000
NODE_3092_length_1317_cov_2.203612	779	859	13	9	80	0.1125000
NODE_3092_length_1317_cov_2.203612	779	859	15	3	80	0.0375000
NODE_3092_length_1317_cov_2.203612	779	859	16	9	80	0.1125000
NODE_3092_length_1317_cov_2.203612	779	859	18	3	80	0.0375000
NODE_3095_length_1316_cov_25.377157	557	637	0	80	80	1.0000000
NODE_3095_length_1316_cov_25.377157	610	690	0	80	80	1.0000000
NODE_3096_length_1316_cov_15.891537	446	526	0	57	80	0.7125000
NODE_3096_length_1316_cov_15.891537	446	526	2	23	80	0.2875000
NODE_3096_length_1316_cov_15.891537	499	579	0	15	80	0.1875000
NODE_3096_length_1316_cov_15.891537	499	579	2	65	80	0.8125000
NODE_3096_length_1316_cov_15.891537	575	655	0	19	80	0.2375000
NODE_3096_length_1316_cov_15.891537	575	655	2	61	80	0.7625000
NODE_3096_length_1316_cov_15.891537	628	708	0	15	80	0.1875000
NODE_3096_length_1316_cov_15.891537	628	708	2	65	80	0.8125000
NODE_3101_length_1315_cov_24.136513	592	672	0	43	80	0.5375000
NODE_3101_length_1315_cov_24.136513	592	672	4	37	80	0.4625000
NODE_3101_length_1315_cov_24.136513	645	725	4	80	80	1.0000000
NODE_3105_length_1314_cov_38.391770	647	727	2	24	80	0.3000000
NODE_3105_length_1314_cov_38.391770	647	727	6	37	80	0.4625000
NODE_3105_length_1314_cov_38.391770	647	727	7	1	80	0.0125000
NODE_3105_length_1314_cov_38.391770	647	727	8	18	80	0.2250000
NODE_3105_length_1314_cov_38.391770	700	780	0	15	80	0.1875000
NODE_3105_length_1314_cov_38.391770	700	780	6	65	80	0.8125000
NODE_3105_length_1314_cov_38.391770	776	856	0	80	80	1.0000000
NODE_3105_length_1314_cov_38.391770	829	909	0	80	80	1.0000000
NODE_3106_length_1314_cov_30.167078	736	816	0	32	80	0.4000000
NODE_3106_length_1314_cov_30.167078	736	816	8	48	80	0.6000000
NODE_3106_length_1314_cov_30.167078	789	869	0	27	80	0.3375000
NODE_3106_length_1314_cov_30.167078	789	869	8	53	80	0.6625000
NODE_3107_length_1314_cov_11.221399	523	603	0	60	80	0.7500000
NODE_3107_length_1314_cov_11.221399	523	603	2	9	80	0.1125000
NODE_3107_length_1314_cov_11.221399	523	603	3	1	80	0.0125000
NODE_3107_length_1314_cov_11.221399	523	603	4	10	80	0.1250000
NODE_3107_length_1314_cov_11.221399	576	656	0	48	80	0.6000000
NODE_3107_length_1314_cov_11.221399	576	656	1	32	80	0.4000000
NODE_3114_length_1313_cov_29.315486	463	543	0	80	80	1.0000000
NODE_3114_length_1313_cov_29.315486	516	596	0	50	80	0.6250000
NODE_3114_length_1313_cov_29.315486	516	596	2	30	80	0.3750000
NODE_3115_length_1313_cov_25.144975	709	789	0	3	80	0.0375000
NODE_3115_length_1313_cov_25.144975	709	789	2	77	80	0.9625000
NODE_3115_length_1313_cov_25.144975	762	842	0	52	80	0.6500000
NODE_3115_length_1313_cov_25.144975	762	842	2	28	80	0.3500000
NODE_3115_length_1313_cov_25.144975	838	918	0	80	80	1.0000000
NODE_3115_length_1313_cov_25.144975	891	971	0	80	80	1.0000000
NODE_3118_length_1312_cov_20.378401	138	218	0	80	80	1.0000000
NODE_3118_length_1312_cov_20.378401	191	271	0	80	80	1.0000000
NODE_3121_length_1311_cov_38.468647	584	664	2	5	80	0.0625000
NODE_3121_length_1311_cov_38.468647	584	664	3	51	80	0.6375000
NODE_3121_length_1311_cov_38.468647	584	664	4	24	80	0.3000000
NODE_3121_length_1311_cov_38.468647	637	717	2	47	80	0.5875000
NODE_3121_length_1311_cov_38.468647	637	717	3	6	80	0.0750000
NODE_3121_length_1311_cov_38.468647	637	717	4	27	80	0.3375000
NODE_3121_length_1311_cov_38.468647	713	793	2	8	80	0.1000000
NODE_3121_length_1311_cov_38.468647	713	793	3	72	80	0.9000000
NODE_3121_length_1311_cov_38.468647	766	846	0	41	80	0.5125000
NODE_3121_length_1311_cov_38.468647	766	846	2	20	80	0.2500000
NODE_3121_length_1311_cov_38.468647	766	846	3	19	80	0.2375000
NODE_3125_length_1310_cov_37.739884	679	759	4	41	80	0.5125000
NODE_3125_length_1310_cov_37.739884	679	759	69	24	80	0.3000000
NODE_3125_length_1310_cov_37.739884	679	759	71	15	80	0.1875000
NODE_3125_length_1310_cov_37.739884	683	763	4	37	80	0.4625000
NODE_3125_length_1310_cov_37.739884	683	763	69	24	80	0.3000000
NODE_3125_length_1310_cov_37.739884	683	763	71	19	80	0.2375000
NODE_3125_length_1310_cov_37.739884	732	816	61	11	84	0.1309524
NODE_3125_length_1310_cov_37.739884	732	816	62	2	84	0.0238095
NODE_3125_length_1310_cov_37.739884	732	816	63	3	84	0.0357143
NODE_3125_length_1310_cov_37.739884	732	816	65	13	84	0.1547619
NODE_3125_length_1310_cov_37.739884	732	816	66	1	84	0.0119048
NODE_3125_length_1310_cov_37.739884	732	816	69	33	84	0.3928571
NODE_3125_length_1310_cov_37.739884	732	816	70	7	84	0.0833333
NODE_3125_length_1310_cov_37.739884	732	816	71	14	84	0.1666667
NODE_3125_length_1310_cov_37.739884	736	816	61	11	80	0.1375000
NODE_3125_length_1310_cov_37.739884	736	816	62	2	80	0.0250000
NODE_3125_length_1310_cov_37.739884	736	816	63	3	80	0.0375000
NODE_3125_length_1310_cov_37.739884	736	816	65	13	80	0.1625000
NODE_3125_length_1310_cov_37.739884	736	816	66	1	80	0.0125000
NODE_3125_length_1310_cov_37.739884	736	816	69	29	80	0.3625000
NODE_3125_length_1310_cov_37.739884	736	816	70	7	80	0.0875000
NODE_3125_length_1310_cov_37.739884	736	816	71	14	80	0.1750000
NODE_3125_length_1310_cov_37.739884	812	892	2	24	80	0.3000000
NODE_3125_length_1310_cov_37.739884	812	892	4	40	80	0.5000000
NODE_3125_length_1310_cov_37.739884	812	892	6	11	80	0.1375000
NODE_3125_length_1310_cov_37.739884	812	892	60	1	80	0.0125000
NODE_3125_length_1310_cov_37.739884	812	892	61	4	80	0.0500000
NODE_3125_length_1310_cov_37.739884	865	945	2	11	80	0.1375000
NODE_3125_length_1310_cov_37.739884	865	945	4	69	80	0.8625000
NODE_3126_length_1310_cov_12.245252	615	695	1	12	80	0.1500000
NODE_3126_length_1310_cov_12.245252	615	695	2	22	80	0.2750000
NODE_3126_length_1310_cov_12.245252	615	695	4	46	80	0.5750000
NODE_3126_length_1310_cov_12.245252	668	748	0	51	80	0.6375000
NODE_3126_length_1310_cov_12.245252	668	748	1	14	80	0.1750000
NODE_3126_length_1310_cov_12.245252	668	748	2	15	80	0.1875000
NODE_3127_length_1310_cov_10.184971	422	502	0	80	80	1.0000000
NODE_3127_length_1310_cov_10.184971	475	555	0	80	80	1.0000000
NODE_3128_length_1310_cov_3.186623	876	956	0	80	80	1.0000000
NODE_3128_length_1310_cov_3.186623	929	1009	0	80	80	1.0000000
NODE_3131_length_1310_cov_0.757225	1255	1310	0	21	55	0.3818182
NODE_3131_length_1310_cov_0.757225	1255	1310	2	7	55	0.1272727
NODE_3131_length_1310_cov_0.757225	1255	1310	4	27	55	0.4909091
NODE_3132_length_1309_cov_34.942149	474	554	12	80	80	1.0000000
NODE_3132_length_1309_cov_34.942149	527	607	0	40	80	0.5000000
NODE_3132_length_1309_cov_34.942149	527	607	12	40	80	0.5000000
NODE_3132_length_1309_cov_34.942149	603	683	0	80	80	1.0000000
NODE_3132_length_1309_cov_34.942149	656	736	0	80	80	1.0000000
NODE_3133_length_1309_cov_10.571074	839	921	0	82	82	1.0000000
NODE_3133_length_1309_cov_10.571074	894	974	0	80	80	1.0000000
NODE_3135_length_1308_cov_43.461538	330	410	2	80	80	1.0000000
NODE_3135_length_1308_cov_43.461538	383	463	1	9	80	0.1125000
NODE_3135_length_1308_cov_43.461538	383	463	2	71	80	0.8875000
NODE_3145_length_1307_cov_11.290563	595	673	2	78	78	1.0000000
NODE_3145_length_1307_cov_11.290563	646	726	0	21	80	0.2625000
NODE_3145_length_1307_cov_11.290563	646	726	2	59	80	0.7375000
NODE_3146_length_1307_cov_8.653146	430	510	0	80	80	1.0000000
NODE_3146_length_1307_cov_8.653146	483	563	0	80	80	1.0000000
NODE_3153_length_1306_cov_26.813587	369	449	0	80	80	1.0000000
NODE_3153_length_1306_cov_26.813587	422	502	0	80	80	1.0000000
NODE_3153_length_1306_cov_26.813587	498	578	0	20	80	0.2500000
NODE_3153_length_1306_cov_26.813587	498	578	2	60	80	0.7500000
NODE_3153_length_1306_cov_26.813587	551	631	0	26	80	0.3250000
NODE_3153_length_1306_cov_26.813587	551	631	2	54	80	0.6750000
NODE_3154_length_1306_cov_24.904722	634	714	0	80	80	1.0000000
NODE_3154_length_1306_cov_24.904722	687	767	0	80	80	1.0000000
NODE_3155_length_1306_cov_18.274234	388	468	0	44	80	0.5500000
NODE_3155_length_1306_cov_18.274234	388	468	2	27	80	0.3375000
NODE_3155_length_1306_cov_18.274234	388	468	4	9	80	0.1125000
NODE_3155_length_1306_cov_18.274234	441	521	2	45	80	0.5625000
NODE_3155_length_1306_cov_18.274234	441	521	4	35	80	0.4375000
NODE_3156_length_1306_cov_15.176471	1214	1294	0	80	80	1.0000000
NODE_3157_length_1306_cov_12.699254	458	538	0	80	80	1.0000000
NODE_3157_length_1306_cov_12.699254	511	591	0	80	80	1.0000000
NODE_3158_length_1306_cov_9.958575	630	710	0	10	80	0.1250000
NODE_3158_length_1306_cov_9.958575	630	710	2	70	80	0.8750000
NODE_3158_length_1306_cov_9.958575	683	764	0	5	81	0.0617284
NODE_3158_length_1306_cov_9.958575	683	764	2	76	81	0.9382716
NODE_3159_length_1306_cov_2.739851	1206	1246	0	40	40	1.0000000
NODE_3168_length_1304_cov_28.444813	511	591	0	17	80	0.2125000
NODE_3168_length_1304_cov_28.444813	511	591	6	63	80	0.7875000
NODE_3168_length_1304_cov_28.444813	564	644	0	5	80	0.0625000
NODE_3168_length_1304_cov_28.444813	564	644	6	75	80	0.9375000
NODE_3168_length_1304_cov_28.444813	640	720	0	43	80	0.5375000
NODE_3168_length_1304_cov_28.444813	640	720	2	37	80	0.4625000
NODE_3168_length_1304_cov_28.444813	693	773	2	33	80	0.4125000
NODE_3168_length_1304_cov_28.444813	693	773	6	6	80	0.0750000
NODE_3168_length_1304_cov_28.444813	693	773	8	41	80	0.5125000
NODE_3169_length_1304_cov_27.137759	575	655	0	80	80	1.0000000
NODE_3169_length_1304_cov_27.137759	628	708	0	65	80	0.8125000
NODE_3169_length_1304_cov_27.137759	628	708	4	15	80	0.1875000
NODE_3169_length_1304_cov_27.137759	704	784	4	46	80	0.5750000
NODE_3169_length_1304_cov_27.137759	704	784	6	2	80	0.0250000
NODE_3169_length_1304_cov_27.137759	704	784	10	32	80	0.4000000
NODE_3169_length_1304_cov_27.137759	757	837	4	17	80	0.2125000
NODE_3169_length_1304_cov_27.137759	757	837	6	5	80	0.0625000
NODE_3169_length_1304_cov_27.137759	757	837	9	2	80	0.0250000
NODE_3169_length_1304_cov_27.137759	757	837	10	56	80	0.7000000
NODE_3171_length_1303_cov_36.546512	458	538	1	42	80	0.5250000
NODE_3171_length_1303_cov_36.546512	458	538	2	38	80	0.4750000
NODE_3171_length_1303_cov_36.546512	511	591	2	52	80	0.6500000
NODE_3171_length_1303_cov_36.546512	511	591	6	28	80	0.3500000
NODE_3171_length_1303_cov_36.546512	587	667	5	12	80	0.1500000
NODE_3171_length_1303_cov_36.546512	587	667	6	6	80	0.0750000
NODE_3171_length_1303_cov_36.546512	587	667	12	10	80	0.1250000
NODE_3171_length_1303_cov_36.546512	587	667	13	46	80	0.5750000
NODE_3171_length_1303_cov_36.546512	587	667	14	6	80	0.0750000
NODE_3171_length_1303_cov_36.546512	640	720	2	7	80	0.0875000
NODE_3171_length_1303_cov_36.546512	640	720	10	39	80	0.4875000
NODE_3171_length_1303_cov_36.546512	640	720	12	10	80	0.1250000
NODE_3171_length_1303_cov_36.546512	640	720	13	11	80	0.1375000
NODE_3171_length_1303_cov_36.546512	640	720	14	13	80	0.1625000
NODE_3174_length_1302_cov_22.265170	747	827	2	22	80	0.2750000
NODE_3174_length_1302_cov_22.265170	747	827	4	4	80	0.0500000
NODE_3174_length_1302_cov_22.265170	747	827	6	54	80	0.6750000
NODE_3174_length_1302_cov_22.265170	800	880	0	48	80	0.6000000
NODE_3174_length_1302_cov_22.265170	800	880	2	27	80	0.3375000
NODE_3174_length_1302_cov_22.265170	800	880	6	5	80	0.0625000
NODE_3175_length_1302_cov_16.199501	480	560	1	58	80	0.7250000
NODE_3175_length_1302_cov_16.199501	480	560	2	22	80	0.2750000
NODE_3175_length_1302_cov_16.199501	533	613	1	80	80	1.0000000
NODE_3176_length_1302_cov_6.953450	687	767	0	80	80	1.0000000
NODE_3176_length_1302_cov_6.953450	740	820	0	80	80	1.0000000
NODE_3179_length_1301_cov_31.711314	401	481	2	48	80	0.6000000
NODE_3179_length_1301_cov_31.711314	401	481	3	1	80	0.0125000
NODE_3179_length_1301_cov_31.711314	401	481	4	31	80	0.3875000
NODE_3179_length_1301_cov_31.711314	454	534	1	2	80	0.0250000
NODE_3179_length_1301_cov_31.711314	454	534	2	4	80	0.0500000
NODE_3179_length_1301_cov_31.711314	454	534	3	52	80	0.6500000
NODE_3179_length_1301_cov_31.711314	454	534	4	22	80	0.2750000
NODE_3181_length_1301_cov_5.529950	246	326	0	80	80	1.0000000
NODE_3181_length_1301_cov_5.529950	299	379	0	45	80	0.5625000
NODE_3181_length_1301_cov_5.529950	299	379	2	35	80	0.4375000
NODE_3186_length_1300_cov_39.109908	602	682	0	80	80	1.0000000
NODE_3186_length_1300_cov_39.109908	655	735	0	80	80	1.0000000
NODE_3187_length_1300_cov_34.360533	586	666	0	22	80	0.2750000
NODE_3187_length_1300_cov_34.360533	586	666	2	58	80	0.7250000
NODE_3187_length_1300_cov_34.360533	639	719	0	9	80	0.1125000
NODE_3187_length_1300_cov_34.360533	639	719	2	71	80	0.8875000
NODE_3188_length_1300_cov_4.659450	454	535	0	7	81	0.0864198
NODE_3188_length_1300_cov_4.659450	454	535	2	74	81	0.9135802
NODE_3188_length_1300_cov_4.659450	508	588	2	80	80	1.0000000
NODE_3189_length_1299_cov_29.071667	452	532	5	17	80	0.2125000
NODE_3189_length_1299_cov_29.071667	452	532	6	45	80	0.5625000
NODE_3189_length_1299_cov_29.071667	452	532	7	18	80	0.2250000
NODE_3190_length_1299_cov_23.600833	818	898	0	80	80	1.0000000
NODE_3190_length_1299_cov_23.600833	871	951	0	80	80	1.0000000
NODE_3191_length_1299_cov_23.169167	625	705	0	26	80	0.3250000
NODE_3191_length_1299_cov_23.169167	625	705	1	20	80	0.2500000
NODE_3191_length_1299_cov_23.169167	625	705	2	34	80	0.4250000
NODE_3191_length_1299_cov_23.169167	678	758	0	7	80	0.0875000
NODE_3191_length_1299_cov_23.169167	678	758	1	73	80	0.9125000
NODE_3191_length_1299_cov_23.169167	754	834	1	36	80	0.4500000
NODE_3191_length_1299_cov_23.169167	754	834	2	44	80	0.5500000
NODE_3191_length_1299_cov_23.169167	807	887	1	52	80	0.6500000
NODE_3191_length_1299_cov_23.169167	807	887	2	28	80	0.3500000
NODE_3192_length_1299_cov_19.315000	306	386	0	80	80	1.0000000
NODE_3192_length_1299_cov_19.315000	359	439	0	80	80	1.0000000
NODE_3192_length_1299_cov_19.315000	435	515	0	80	80	1.0000000
NODE_3192_length_1299_cov_19.315000	488	568	0	80	80	1.0000000
NODE_3193_length_1299_cov_13.691667	540	620	0	18	80	0.2250000
NODE_3193_length_1299_cov_13.691667	540	620	6	35	80	0.4375000
NODE_3193_length_1299_cov_13.691667	540	620	8	27	80	0.3375000
NODE_3193_length_1299_cov_13.691667	593	673	0	16	80	0.2000000
NODE_3193_length_1299_cov_13.691667	593	673	6	9	80	0.1125000
NODE_3193_length_1299_cov_13.691667	593	673	8	55	80	0.6875000
NODE_3195_length_1298_cov_58.277731	679	759	0	27	80	0.3375000
NODE_3195_length_1298_cov_58.277731	679	759	4	53	80	0.6625000
NODE_3195_length_1298_cov_58.277731	732	812	0	80	80	1.0000000
NODE_3195_length_1298_cov_58.277731	808	888	0	31	80	0.3875000
NODE_3195_length_1298_cov_58.277731	808	888	6	49	80	0.6125000
NODE_3195_length_1298_cov_58.277731	861	941	6	80	80	1.0000000
NODE_3196_length_1298_cov_31.319433	375	455	0	80	80	1.0000000
NODE_3196_length_1298_cov_31.319433	428	508	0	80	80	1.0000000
NODE_3196_length_1298_cov_31.319433	504	584	0	54	80	0.6750000
NODE_3196_length_1298_cov_31.319433	504	584	2	26	80	0.3250000
NODE_3196_length_1298_cov_31.319433	557	637	0	20	80	0.2500000
NODE_3196_length_1298_cov_31.319433	557	637	2	60	80	0.7500000
NODE_3197_length_1298_cov_2.158465	294	360	0	66	66	1.0000000
NODE_3201_length_1296_cov_34.778613	620	700	0	80	80	1.0000000
NODE_3201_length_1296_cov_34.778613	673	753	0	80	80	1.0000000
NODE_3202_length_1296_cov_28.726817	671	751	0	29	80	0.3625000
NODE_3202_length_1296_cov_28.726817	671	751	2	51	80	0.6375000
NODE_3202_length_1296_cov_28.726817	724	804	0	55	80	0.6875000
NODE_3202_length_1296_cov_28.726817	724	804	2	25	80	0.3125000
NODE_3202_length_1296_cov_28.726817	800	880	0	57	80	0.7125000
NODE_3202_length_1296_cov_28.726817	800	880	2	23	80	0.2875000
NODE_3202_length_1296_cov_28.726817	853	933	0	4	80	0.0500000
NODE_3202_length_1296_cov_28.726817	853	933	2	76	80	0.9500000
NODE_3205_length_1295_cov_10.661371	818	898	0	80	80	1.0000000
NODE_3205_length_1295_cov_10.661371	871	951	0	80	80	1.0000000
NODE_3211_length_1294_cov_15.098745	353	433	0	80	80	1.0000000
NODE_3211_length_1294_cov_15.098745	406	486	0	80	80	1.0000000
NODE_3216_length_1293_cov_26.580402	595	675	0	80	80	1.0000000
NODE_3216_length_1293_cov_26.580402	648	728	0	80	80	1.0000000
NODE_3216_length_1293_cov_26.580402	724	804	0	80	80	1.0000000
NODE_3216_length_1293_cov_26.580402	777	857	0	80	80	1.0000000
NODE_3217_length_1293_cov_9.252094	1187	1207	4	20	20	1.0000000
NODE_3220_length_1293_cov_2.118090	1131	1195	0	22	64	0.3437500
NODE_3220_length_1293_cov_2.118090	1131	1195	1	42	64	0.6562500
NODE_3220_length_1293_cov_2.118090	1184	1248	1	64	64	1.0000000
NODE_3224_length_1292_cov_50.158424	402	482	0	6	80	0.0750000
NODE_3224_length_1292_cov_50.158424	402	482	2	17	80	0.2125000
NODE_3224_length_1292_cov_50.158424	402	482	6	57	80	0.7125000
NODE_3224_length_1292_cov_50.158424	455	535	0	2	80	0.0250000
NODE_3224_length_1292_cov_50.158424	455	535	2	15	80	0.1875000
NODE_3224_length_1292_cov_50.158424	455	535	6	63	80	0.7875000
NODE_3224_length_1292_cov_50.158424	531	611	0	78	80	0.9750000
NODE_3224_length_1292_cov_50.158424	531	611	2	2	80	0.0250000
NODE_3224_length_1292_cov_50.158424	584	664	0	80	80	1.0000000
NODE_3225_length_1292_cov_36.535624	670	750	0	69	80	0.8625000
NODE_3225_length_1292_cov_36.535624	670	750	8	11	80	0.1375000
NODE_3225_length_1292_cov_36.535624	723	803	0	16	80	0.2000000
NODE_3225_length_1292_cov_36.535624	723	803	8	64	80	0.8000000
NODE_3226_length_1292_cov_24.523889	420	500	0	80	80	1.0000000
NODE_3226_length_1292_cov_24.523889	473	553	0	47	80	0.5875000
NODE_3226_length_1292_cov_24.523889	473	553	2	33	80	0.4125000
NODE_3232_length_1291_cov_8.734060	623	703	0	80	80	1.0000000
NODE_3232_length_1291_cov_8.734060	676	756	0	80	80	1.0000000
NODE_3233_length_1291_cov_8.625839	756	836	0	80	80	1.0000000
NODE_3233_length_1291_cov_8.625839	809	889	0	80	80	1.0000000
NODE_3236_length_1290_cov_24.120067	497	577	0	80	80	1.0000000
NODE_3236_length_1290_cov_24.120067	550	630	0	80	80	1.0000000
NODE_3236_length_1290_cov_24.120067	626	706	0	80	80	1.0000000
NODE_3236_length_1290_cov_24.120067	679	759	0	80	80	1.0000000
NODE_3237_length_1290_cov_18.874895	671	751	0	80	80	1.0000000
NODE_3237_length_1290_cov_18.874895	724	804	0	80	80	1.0000000
NODE_3238_length_1290_cov_11.627204	573	653	0	39	80	0.4875000
NODE_3238_length_1290_cov_11.627204	573	653	1	1	80	0.0125000
NODE_3238_length_1290_cov_11.627204	573	653	2	27	80	0.3375000
NODE_3238_length_1290_cov_11.627204	573	653	4	1	80	0.0125000
NODE_3238_length_1290_cov_11.627204	573	653	10	12	80	0.1500000
NODE_3238_length_1290_cov_11.627204	626	706	2	14	80	0.1750000
NODE_3238_length_1290_cov_11.627204	626	706	4	1	80	0.0125000
NODE_3238_length_1290_cov_11.627204	626	706	8	1	80	0.0125000
NODE_3238_length_1290_cov_11.627204	626	706	10	64	80	0.8000000
NODE_3239_length_1290_cov_11.215785	373	453	0	80	80	1.0000000
NODE_3239_length_1290_cov_11.215785	426	506	0	80	80	1.0000000
NODE_3240_length_1290_cov_8.752309	788	868	0	80	80	1.0000000
NODE_3240_length_1290_cov_8.752309	841	921	0	80	80	1.0000000
NODE_3242_length_1289_cov_47.476471	919	999	0	80	80	1.0000000
NODE_3242_length_1289_cov_47.476471	972	1052	0	80	80	1.0000000
NODE_3243_length_1289_cov_18.497479	688	768	0	7	80	0.0875000
NODE_3243_length_1289_cov_18.497479	688	768	2	73	80	0.9125000
NODE_3243_length_1289_cov_18.497479	741	821	0	31	80	0.3875000
NODE_3243_length_1289_cov_18.497479	741	821	2	49	80	0.6125000
NODE_3243_length_1289_cov_18.497479	817	893	0	76	76	1.0000000
NODE_3243_length_1289_cov_18.497479	878	958	0	80	80	1.0000000
NODE_3244_length_1289_cov_11.692437	574	654	0	24	80	0.3000000
NODE_3244_length_1289_cov_11.692437	574	654	1	46	80	0.5750000
NODE_3244_length_1289_cov_11.692437	574	654	2	10	80	0.1250000
NODE_3244_length_1289_cov_11.692437	627	707	1	17	80	0.2125000
NODE_3244_length_1289_cov_11.692437	627	707	2	63	80	0.7875000
NODE_3244_length_1289_cov_11.692437	703	783	1	35	80	0.4375000
NODE_3244_length_1289_cov_11.692437	703	783	2	45	80	0.5625000
NODE_3244_length_1289_cov_11.692437	756	836	0	42	80	0.5250000
NODE_3244_length_1289_cov_11.692437	756	836	1	38	80	0.4750000
NODE_3249_length_1288_cov_29.369218	711	791	6	11	80	0.1375000
NODE_3249_length_1288_cov_29.369218	711	791	8	5	80	0.0625000
NODE_3249_length_1288_cov_29.369218	711	791	11	18	80	0.2250000
NODE_3249_length_1288_cov_29.369218	711	791	12	23	80	0.2875000
NODE_3249_length_1288_cov_29.369218	711	791	14	6	80	0.0750000
NODE_3249_length_1288_cov_29.369218	711	791	15	2	80	0.0250000
NODE_3249_length_1288_cov_29.369218	711	791	16	1	80	0.0125000
NODE_3249_length_1288_cov_29.369218	711	791	17	14	80	0.1750000
NODE_3249_length_1288_cov_29.369218	764	844	6	11	80	0.1375000
NODE_3249_length_1288_cov_29.369218	764	844	8	58	80	0.7250000
NODE_3249_length_1288_cov_29.369218	764	844	16	1	80	0.0125000
NODE_3249_length_1288_cov_29.369218	764	844	17	10	80	0.1250000
NODE_3250_length_1288_cov_6.207738	735	815	0	38	80	0.4750000
NODE_3250_length_1288_cov_6.207738	735	815	10	41	80	0.5125000
NODE_3250_length_1288_cov_6.207738	735	815	14	1	80	0.0125000
NODE_3250_length_1288_cov_6.207738	788	868	10	26	80	0.3250000
NODE_3250_length_1288_cov_6.207738	788	868	14	54	80	0.6750000
NODE_3255_length_1288_cov_1.731707	1017	1095	4	24	78	0.3076923
NODE_3255_length_1288_cov_1.731707	1017	1095	6	15	78	0.1923077
NODE_3255_length_1288_cov_1.731707	1017	1095	8	6	78	0.0769231
NODE_3255_length_1288_cov_1.731707	1017	1095	9	33	78	0.4230769
NODE_3261_length_1287_cov_29.186027	730	810	0	80	80	1.0000000
NODE_3261_length_1287_cov_29.186027	783	863	0	80	80	1.0000000
NODE_3262_length_1287_cov_22.747475	168	248	4	72	80	0.9000000
NODE_3262_length_1287_cov_22.747475	168	248	8	8	80	0.1000000
NODE_3262_length_1287_cov_22.747475	221	301	4	80	80	1.0000000
NODE_3263_length_1287_cov_19.478956	575	655	2	80	80	1.0000000
NODE_3263_length_1287_cov_19.478956	628	708	0	37	80	0.4625000
NODE_3263_length_1287_cov_19.478956	628	708	2	43	80	0.5375000
NODE_3266_length_1286_cov_27.128054	428	508	8	23	80	0.2875000
NODE_3266_length_1286_cov_27.128054	428	508	10	57	80	0.7125000
NODE_3266_length_1286_cov_27.128054	481	561	2	26	80	0.3250000
NODE_3266_length_1286_cov_27.128054	481	561	6	6	80	0.0750000
NODE_3266_length_1286_cov_27.128054	481	561	7	1	80	0.0125000
NODE_3266_length_1286_cov_27.128054	481	561	8	43	80	0.5375000
NODE_3266_length_1286_cov_27.128054	481	561	10	4	80	0.0500000
NODE_3266_length_1286_cov_27.128054	557	637	6	80	80	1.0000000
NODE_3266_length_1286_cov_27.128054	610	690	6	80	80	1.0000000
NODE_3267_length_1286_cov_12.192081	647	727	0	80	80	1.0000000
NODE_3267_length_1286_cov_12.192081	700	780	0	80	80	1.0000000
NODE_3267_length_1286_cov_12.192081	776	856	0	80	80	1.0000000
NODE_3267_length_1286_cov_12.192081	829	909	0	62	80	0.7750000
NODE_3267_length_1286_cov_12.192081	829	909	2	18	80	0.2250000
NODE_3268_length_1286_cov_8.338669	577	657	0	80	80	1.0000000
NODE_3268_length_1286_cov_8.338669	630	710	0	80	80	1.0000000
NODE_3273_length_1285_cov_40.282462	751	831	0	36	80	0.4500000
NODE_3273_length_1285_cov_40.282462	751	831	6	26	80	0.3250000
NODE_3273_length_1285_cov_40.282462	751	831	9	2	80	0.0250000
NODE_3273_length_1285_cov_40.282462	751	831	10	16	80	0.2000000
NODE_3273_length_1285_cov_40.282462	804	884	6	9	80	0.1125000
NODE_3273_length_1285_cov_40.282462	804	884	9	2	80	0.0250000
NODE_3273_length_1285_cov_40.282462	804	884	10	69	80	0.8625000
NODE_3274_length_1285_cov_15.422428	647	727	0	80	80	1.0000000
NODE_3274_length_1285_cov_15.422428	700	780	0	80	80	1.0000000
NODE_3275_length_1285_cov_6.620573	589	669	2	49	80	0.6125000
NODE_3275_length_1285_cov_6.620573	589	669	4	31	80	0.3875000
NODE_3275_length_1285_cov_6.620573	642	722	4	80	80	1.0000000
NODE_3279_length_1284_cov_5.637975	294	374	0	7	80	0.0875000
NODE_3279_length_1284_cov_5.637975	294	374	2	73	80	0.9125000
NODE_3279_length_1284_cov_5.637975	347	427	0	58	80	0.7250000
NODE_3279_length_1284_cov_5.637975	347	427	2	22	80	0.2750000
NODE_3283_length_1283_cov_10.070101	408	488	0	80	80	1.0000000
NODE_3283_length_1283_cov_10.070101	461	541	0	80	80	1.0000000
NODE_3288_length_1282_cov_37.786137	649	729	0	7	80	0.0875000
NODE_3288_length_1282_cov_37.786137	649	729	2	73	80	0.9125000
NODE_3288_length_1282_cov_37.786137	702	782	0	10	80	0.1250000
NODE_3288_length_1282_cov_37.786137	702	782	2	70	80	0.8750000
NODE_3288_length_1282_cov_37.786137	778	858	0	22	80	0.2750000
NODE_3288_length_1282_cov_37.786137	778	858	4	39	80	0.4875000
NODE_3288_length_1282_cov_37.786137	778	858	6	19	80	0.2375000
NODE_3288_length_1282_cov_37.786137	831	911	2	46	80	0.5750000
NODE_3288_length_1282_cov_37.786137	831	911	4	8	80	0.1000000
NODE_3288_length_1282_cov_37.786137	831	911	6	26	80	0.3250000
NODE_3289_length_1282_cov_25.900254	85	167	16	7	82	0.0853659
NODE_3289_length_1282_cov_25.900254	85	167	20	2	82	0.0243902
NODE_3289_length_1282_cov_25.900254	85	167	22	3	82	0.0365854
NODE_3289_length_1282_cov_25.900254	85	167	28	1	82	0.0121951
NODE_3289_length_1282_cov_25.900254	85	167	30	5	82	0.0609756
NODE_3289_length_1282_cov_25.900254	85	167	35	2	82	0.0243902
NODE_3289_length_1282_cov_25.900254	85	167	37	2	82	0.0243902
NODE_3289_length_1282_cov_25.900254	85	167	39	10	82	0.1219512
NODE_3289_length_1282_cov_25.900254	85	167	41	6	82	0.0731707
NODE_3289_length_1282_cov_25.900254	85	167	43	4	82	0.0487805
NODE_3289_length_1282_cov_25.900254	85	167	45	4	82	0.0487805
NODE_3289_length_1282_cov_25.900254	85	167	47	4	82	0.0487805
NODE_3289_length_1282_cov_25.900254	85	167	48	3	82	0.0365854
NODE_3289_length_1282_cov_25.900254	85	167	50	10	82	0.1219512
NODE_3289_length_1282_cov_25.900254	85	167	51	1	82	0.0121951
NODE_3289_length_1282_cov_25.900254	85	167	52	18	82	0.2195122
NODE_3289_length_1282_cov_25.900254	140	183	9	2	43	0.0465116
NODE_3289_length_1282_cov_25.900254	140	183	11	12	43	0.2790698
NODE_3289_length_1282_cov_25.900254	140	183	13	1	43	0.0232558
NODE_3289_length_1282_cov_25.900254	140	183	14	1	43	0.0232558
NODE_3289_length_1282_cov_25.900254	140	183	16	7	43	0.1627907
NODE_3289_length_1282_cov_25.900254	140	183	20	2	43	0.0465116
NODE_3289_length_1282_cov_25.900254	140	183	22	3	43	0.0697674
NODE_3289_length_1282_cov_25.900254	140	183	28	1	43	0.0232558
NODE_3289_length_1282_cov_25.900254	140	183	30	5	43	0.1162791
NODE_3289_length_1282_cov_25.900254	140	183	35	2	43	0.0465116
NODE_3289_length_1282_cov_25.900254	140	183	37	2	43	0.0465116
NODE_3289_length_1282_cov_25.900254	140	183	39	5	43	0.1162791
NODE_3289_length_1282_cov_25.900254	1006	1086	13	3	80	0.0375000
NODE_3289_length_1282_cov_25.900254	1006	1086	16	12	80	0.1500000
NODE_3289_length_1282_cov_25.900254	1006	1086	18	4	80	0.0500000
NODE_3289_length_1282_cov_25.900254	1006	1086	21	1	80	0.0125000
NODE_3289_length_1282_cov_25.900254	1006	1086	22	1	80	0.0125000
NODE_3289_length_1282_cov_25.900254	1006	1086	31	1	80	0.0125000
NODE_3289_length_1282_cov_25.900254	1006	1086	32	1	80	0.0125000
NODE_3289_length_1282_cov_25.900254	1006	1086	33	3	80	0.0375000
NODE_3289_length_1282_cov_25.900254	1006	1086	38	1	80	0.0125000
NODE_3289_length_1282_cov_25.900254	1006	1086	39	11	80	0.1375000
NODE_3289_length_1282_cov_25.900254	1006	1086	43	1	80	0.0125000
NODE_3289_length_1282_cov_25.900254	1006	1086	47	8	80	0.1000000
NODE_3289_length_1282_cov_25.900254	1006	1086	48	2	80	0.0250000
NODE_3289_length_1282_cov_25.900254	1006	1086	50	5	80	0.0625000
NODE_3289_length_1282_cov_25.900254	1006	1086	51	1	80	0.0125000
NODE_3289_length_1282_cov_25.900254	1006	1086	52	5	80	0.0625000
NODE_3289_length_1282_cov_25.900254	1006	1086	54	20	80	0.2500000
NODE_3289_length_1282_cov_25.900254	1006	1086	13	3	80	0.0375000
NODE_3289_length_1282_cov_25.900254	1006	1086	16	12	80	0.1500000
NODE_3289_length_1282_cov_25.900254	1006	1086	18	4	80	0.0500000
NODE_3289_length_1282_cov_25.900254	1006	1086	21	1	80	0.0125000
NODE_3289_length_1282_cov_25.900254	1006	1086	22	1	80	0.0125000
NODE_3289_length_1282_cov_25.900254	1006	1086	31	1	80	0.0125000
NODE_3289_length_1282_cov_25.900254	1006	1086	32	1	80	0.0125000
NODE_3289_length_1282_cov_25.900254	1006	1086	33	3	80	0.0375000
NODE_3289_length_1282_cov_25.900254	1006	1086	38	1	80	0.0125000
NODE_3289_length_1282_cov_25.900254	1006	1086	39	11	80	0.1375000
NODE_3289_length_1282_cov_25.900254	1006	1086	43	1	80	0.0125000
NODE_3289_length_1282_cov_25.900254	1006	1086	47	8	80	0.1000000
NODE_3289_length_1282_cov_25.900254	1006	1086	48	2	80	0.0250000
NODE_3289_length_1282_cov_25.900254	1006	1086	50	5	80	0.0625000
NODE_3289_length_1282_cov_25.900254	1006	1086	51	1	80	0.0125000
NODE_3289_length_1282_cov_25.900254	1006	1086	52	5	80	0.0625000
NODE_3289_length_1282_cov_25.900254	1006	1086	54	20	80	0.2500000
NODE_3289_length_1282_cov_25.900254	1015	1086	13	3	71	0.0422535
NODE_3289_length_1282_cov_25.900254	1015	1086	16	7	71	0.0985916
NODE_3289_length_1282_cov_25.900254	1015	1086	21	1	71	0.0140845
NODE_3289_length_1282_cov_25.900254	1015	1086	22	1	71	0.0140845
NODE_3289_length_1282_cov_25.900254	1015	1086	31	1	71	0.0140845
NODE_3289_length_1282_cov_25.900254	1015	1086	32	1	71	0.0140845
NODE_3289_length_1282_cov_25.900254	1015	1086	33	3	71	0.0422535
NODE_3289_length_1282_cov_25.900254	1015	1086	38	1	71	0.0140845
NODE_3289_length_1282_cov_25.900254	1015	1086	39	11	71	0.1549296
NODE_3289_length_1282_cov_25.900254	1015	1086	43	1	71	0.0140845
NODE_3289_length_1282_cov_25.900254	1015	1086	47	8	71	0.1126761
NODE_3289_length_1282_cov_25.900254	1015	1086	48	2	71	0.0281690
NODE_3289_length_1282_cov_25.900254	1015	1086	50	5	71	0.0704225
NODE_3289_length_1282_cov_25.900254	1015	1086	51	1	71	0.0140845
NODE_3289_length_1282_cov_25.900254	1015	1086	52	5	71	0.0704225
NODE_3289_length_1282_cov_25.900254	1015	1086	54	20	71	0.2816902
NODE_3290_length_1282_cov_14.600169	429	477	0	48	48	1.0000000
NODE_3290_length_1282_cov_14.600169	708	788	0	80	80	1.0000000
NODE_3291_length_1282_cov_8.017751	343	420	0	77	77	1.0000000
NODE_3292_length_1282_cov_5.092984	239	319	0	80	80	1.0000000
NODE_3292_length_1282_cov_5.092984	292	372	0	80	80	1.0000000
NODE_3295_length_1281_cov_31.342640	470	550	0	46	80	0.5750000
NODE_3295_length_1281_cov_31.342640	470	550	2	34	80	0.4250000
NODE_3295_length_1281_cov_31.342640	523	603	0	80	80	1.0000000
NODE_3295_length_1281_cov_31.342640	599	679	0	80	80	1.0000000
NODE_3295_length_1281_cov_31.342640	652	732	0	80	80	1.0000000
NODE_3296_length_1281_cov_25.482234	474	554	4	80	80	1.0000000
NODE_3296_length_1281_cov_25.482234	527	607	0	3	80	0.0375000
NODE_3296_length_1281_cov_25.482234	527	607	3	16	80	0.2000000
NODE_3296_length_1281_cov_25.482234	527	607	4	61	80	0.7625000
NODE_3297_length_1281_cov_14.617597	809	887	0	78	78	1.0000000
NODE_3297_length_1281_cov_14.617597	860	940	0	80	80	1.0000000
NODE_3298_length_1281_cov_12.065144	655	735	2	11	80	0.1375000
NODE_3298_length_1281_cov_12.065144	655	735	4	19	80	0.2375000
NODE_3298_length_1281_cov_12.065144	655	735	5	1	80	0.0125000
NODE_3298_length_1281_cov_12.065144	655	735	6	49	80	0.6125000
NODE_3298_length_1281_cov_12.065144	708	788	4	72	80	0.9000000
NODE_3298_length_1281_cov_12.065144	708	788	5	1	80	0.0125000
NODE_3298_length_1281_cov_12.065144	708	788	6	7	80	0.0875000
NODE_3299_length_1281_cov_9.235195	408	488	0	80	80	1.0000000
NODE_3299_length_1281_cov_9.235195	461	541	0	80	80	1.0000000
NODE_3300_length_1281_cov_7.153976	469	549	0	80	80	1.0000000
NODE_3300_length_1281_cov_7.153976	522	602	0	80	80	1.0000000
NODE_3307_length_1280_cov_24.231160	418	498	0	80	80	1.0000000
NODE_3307_length_1280_cov_24.231160	471	551	0	80	80	1.0000000
NODE_3307_length_1280_cov_24.231160	547	627	0	35	80	0.4375000
NODE_3307_length_1280_cov_24.231160	547	627	2	21	80	0.2625000
NODE_3307_length_1280_cov_24.231160	547	627	4	9	80	0.1125000
NODE_3307_length_1280_cov_24.231160	547	627	6	15	80	0.1875000
NODE_3307_length_1280_cov_24.231160	600	680	2	3	80	0.0375000
NODE_3307_length_1280_cov_24.231160	600	680	4	19	80	0.2375000
NODE_3307_length_1280_cov_24.231160	600	680	6	58	80	0.7250000
NODE_3308_length_1280_cov_5.908552	1077	1138	15	1	61	0.0163934
NODE_3308_length_1280_cov_5.908552	1077	1138	23	1	61	0.0163934
NODE_3308_length_1280_cov_5.908552	1077	1138	27	1	61	0.0163934
NODE_3308_length_1280_cov_5.908552	1077	1138	31	1	61	0.0163934
NODE_3308_length_1280_cov_5.908552	1077	1138	39	2	61	0.0327869
NODE_3308_length_1280_cov_5.908552	1077	1138	45	1	61	0.0163934
NODE_3308_length_1280_cov_5.908552	1077	1138	46	3	61	0.0491803
NODE_3308_length_1280_cov_5.908552	1077	1138	55	1	61	0.0163934
NODE_3308_length_1280_cov_5.908552	1077	1138	57	1	61	0.0163934
NODE_3308_length_1280_cov_5.908552	1077	1138	62	1	61	0.0163934
NODE_3308_length_1280_cov_5.908552	1077	1138	70	1	61	0.0163934
NODE_3308_length_1280_cov_5.908552	1077	1138	74	1	61	0.0163934
NODE_3308_length_1280_cov_5.908552	1077	1138	78	1	61	0.0163934
NODE_3308_length_1280_cov_5.908552	1077	1138	79	1	61	0.0163934
NODE_3308_length_1280_cov_5.908552	1077	1138	81	2	61	0.0327869
NODE_3308_length_1280_cov_5.908552	1077	1138	85	1	61	0.0163934
NODE_3308_length_1280_cov_5.908552	1077	1138	86	1	61	0.0163934
NODE_3308_length_1280_cov_5.908552	1077	1138	90	1	61	0.0163934
NODE_3308_length_1280_cov_5.908552	1077	1138	92	5	61	0.0819672
NODE_3308_length_1280_cov_5.908552	1077	1138	103	1	61	0.0163934
NODE_3308_length_1280_cov_5.908552	1077	1138	105	1	61	0.0163934
NODE_3308_length_1280_cov_5.908552	1077	1138	111	1	61	0.0163934
NODE_3308_length_1280_cov_5.908552	1077	1138	118	2	61	0.0327869
NODE_3308_length_1280_cov_5.908552	1077	1138	121	1	61	0.0163934
NODE_3308_length_1280_cov_5.908552	1077	1138	124	1	61	0.0163934
NODE_3308_length_1280_cov_5.908552	1077	1138	126	1	61	0.0163934
NODE_3308_length_1280_cov_5.908552	1077	1138	127	1	61	0.0163934
NODE_3308_length_1280_cov_5.908552	1077	1138	138	1	61	0.0163934
NODE_3308_length_1280_cov_5.908552	1077	1138	140	1	61	0.0163934
NODE_3308_length_1280_cov_5.908552	1077	1138	144	3	61	0.0491803
NODE_3308_length_1280_cov_5.908552	1077	1138	146	2	61	0.0327869
NODE_3308_length_1280_cov_5.908552	1077	1138	148	1	61	0.0163934
NODE_3308_length_1280_cov_5.908552	1077	1138	152	1	61	0.0163934
NODE_3308_length_1280_cov_5.908552	1077	1138	160	1	61	0.0163934
NODE_3308_length_1280_cov_5.908552	1077	1138	164	1	61	0.0163934
NODE_3308_length_1280_cov_5.908552	1077	1138	168	2	61	0.0327869
NODE_3308_length_1280_cov_5.908552	1077	1138	169	3	61	0.0491803
NODE_3308_length_1280_cov_5.908552	1077	1138	173	4	61	0.0655738
NODE_3308_length_1280_cov_5.908552	1077	1138	175	2	61	0.0327869
NODE_3308_length_1280_cov_5.908552	1077	1138	176	2	61	0.0327869
NODE_3308_length_1280_cov_5.908552	1077	1138	178	1	61	0.0163934
NODE_3311_length_1279_cov_16.840678	749	829	12	80	80	1.0000000
NODE_3311_length_1279_cov_16.840678	802	882	0	9	80	0.1125000
NODE_3311_length_1279_cov_16.840678	802	882	12	71	80	0.8875000
NODE_3312_length_1279_cov_3.772881	951	981	0	30	30	1.0000000
NODE_3317_length_1278_cov_45.991518	411	491	0	80	80	1.0000000
NODE_3317_length_1278_cov_45.991518	464	530	0	66	66	1.0000000
NODE_3318_length_1278_cov_37.164546	447	527	8	67	80	0.8375000
NODE_3318_length_1278_cov_37.164546	447	527	10	13	80	0.1625000
NODE_3318_length_1278_cov_37.164546	500	580	2	22	80	0.2750000
NODE_3318_length_1278_cov_37.164546	500	580	6	20	80	0.2500000
NODE_3318_length_1278_cov_37.164546	500	580	8	14	80	0.1750000
NODE_3318_length_1278_cov_37.164546	500	580	9	10	80	0.1250000
NODE_3318_length_1278_cov_37.164546	500	580	10	14	80	0.1750000
NODE_3318_length_1278_cov_37.164546	576	656	0	12	80	0.1500000
NODE_3318_length_1278_cov_37.164546	576	656	2	25	80	0.3125000
NODE_3318_length_1278_cov_37.164546	576	656	4	20	80	0.2500000
NODE_3318_length_1278_cov_37.164546	576	656	9	1	80	0.0125000
NODE_3318_length_1278_cov_37.164546	576	656	10	10	80	0.1250000
NODE_3318_length_1278_cov_37.164546	576	656	11	12	80	0.1500000
NODE_3318_length_1278_cov_37.164546	629	709	4	4	80	0.0500000
NODE_3318_length_1278_cov_37.164546	629	709	9	1	80	0.0125000
NODE_3318_length_1278_cov_37.164546	629	709	10	22	80	0.2750000
NODE_3318_length_1278_cov_37.164546	629	709	11	53	80	0.6625000
NODE_3319_length_1278_cov_12.505513	522	602	0	80	80	1.0000000
NODE_3319_length_1278_cov_12.505513	575	655	0	80	80	1.0000000
NODE_3320_length_1278_cov_12.171332	212	292	0	67	80	0.8375000
NODE_3320_length_1278_cov_12.171332	212	292	6	13	80	0.1625000
NODE_3320_length_1278_cov_12.171332	265	344	0	14	79	0.1772152
NODE_3320_length_1278_cov_12.171332	265	344	6	65	79	0.8227848
NODE_3329_length_1277_cov_21.407470	667	717	0	49	50	0.9800000
NODE_3329_length_1277_cov_21.407470	667	717	4	1	50	0.0200000
NODE_3329_length_1277_cov_21.407470	690	770	0	80	80	1.0000000
NODE_3330_length_1277_cov_18.111205	834	914	0	80	80	1.0000000
NODE_3330_length_1277_cov_18.111205	887	967	0	80	80	1.0000000
NODE_3331_length_1277_cov_12.449066	276	356	0	80	80	1.0000000
NODE_3331_length_1277_cov_12.449066	329	409	0	80	80	1.0000000
NODE_3331_length_1277_cov_12.449066	405	485	0	69	80	0.8625000
NODE_3331_length_1277_cov_12.449066	405	485	2	11	80	0.1375000
NODE_3331_length_1277_cov_12.449066	458	538	0	16	80	0.2000000
NODE_3331_length_1277_cov_12.449066	458	538	2	14	80	0.1750000
NODE_3331_length_1277_cov_12.449066	458	538	4	50	80	0.6250000
NODE_3337_length_1276_cov_21.446899	526	606	0	80	80	1.0000000
NODE_3337_length_1276_cov_21.446899	579	659	0	80	80	1.0000000
NODE_3337_length_1276_cov_21.446899	655	735	0	29	80	0.3625000
NODE_3337_length_1276_cov_21.446899	655	735	1	1	80	0.0125000
NODE_3337_length_1276_cov_21.446899	655	735	2	1	80	0.0125000
NODE_3337_length_1276_cov_21.446899	655	735	4	1	80	0.0125000
NODE_3337_length_1276_cov_21.446899	655	735	5	2	80	0.0250000
NODE_3337_length_1276_cov_21.446899	655	735	6	46	80	0.5750000
NODE_3337_length_1276_cov_21.446899	708	788	6	80	80	1.0000000
NODE_3346_length_1275_cov_35.471939	632	712	0	80	80	1.0000000
NODE_3346_length_1275_cov_35.471939	685	765	0	80	80	1.0000000
NODE_3347_length_1275_cov_19.910714	361	441	0	30	80	0.3750000
NODE_3347_length_1275_cov_19.910714	361	441	5	2	80	0.0250000
NODE_3347_length_1275_cov_19.910714	361	441	7	20	80	0.2500000
NODE_3347_length_1275_cov_19.910714	361	441	8	28	80	0.3500000
NODE_3347_length_1275_cov_19.910714	414	494	6	15	80	0.1875000
NODE_3347_length_1275_cov_19.910714	414	494	8	45	80	0.5625000
NODE_3347_length_1275_cov_19.910714	414	494	10	4	80	0.0500000
NODE_3347_length_1275_cov_19.910714	414	494	12	16	80	0.2000000
NODE_3347_length_1275_cov_19.910714	879	949	0	21	70	0.3000000
NODE_3347_length_1275_cov_19.910714	879	949	4	30	70	0.4285714
NODE_3347_length_1275_cov_19.910714	879	949	6	19	70	0.2714286
NODE_3351_length_1274_cov_23.404255	427	507	0	80	80	1.0000000
NODE_3351_length_1274_cov_23.404255	480	560	0	27	80	0.3375000
NODE_3351_length_1274_cov_23.404255	480	560	1	2	80	0.0250000
NODE_3351_length_1274_cov_23.404255	480	560	2	51	80	0.6375000
NODE_3351_length_1274_cov_23.404255	556	636	2	80	80	1.0000000
NODE_3351_length_1274_cov_23.404255	609	689	0	26	80	0.3250000
NODE_3351_length_1274_cov_23.404255	609	689	1	2	80	0.0250000
NODE_3351_length_1274_cov_23.404255	609	689	2	52	80	0.6500000
NODE_3352_length_1274_cov_20.178723	545	625	2	34	80	0.4250000
NODE_3352_length_1274_cov_20.178723	545	625	3	46	80	0.5750000
NODE_3352_length_1274_cov_20.178723	598	678	1	34	80	0.4250000
NODE_3352_length_1274_cov_20.178723	598	678	3	46	80	0.5750000
NODE_3354_length_1274_cov_2.019574	841	907	0	66	66	1.0000000
NODE_3354_length_1274_cov_2.019574	894	961	0	67	67	1.0000000
NODE_3361_length_1273_cov_42.349233	337	417	0	18	80	0.2250000
NODE_3361_length_1273_cov_42.349233	337	417	2	62	80	0.7750000
NODE_3361_length_1273_cov_42.349233	390	470	0	11	80	0.1375000
NODE_3361_length_1273_cov_42.349233	390	470	2	69	80	0.8625000
NODE_3361_length_1273_cov_42.349233	466	546	0	35	80	0.4375000
NODE_3361_length_1273_cov_42.349233	466	546	2	45	80	0.5625000
NODE_3361_length_1273_cov_42.349233	519	599	2	80	80	1.0000000
NODE_3364_length_1273_cov_4.404600	407	487	0	80	80	1.0000000
NODE_3364_length_1273_cov_4.404600	460	540	0	80	80	1.0000000
NODE_3368_length_1272_cov_28.887468	588	668	0	3	80	0.0375000
NODE_3368_length_1272_cov_28.887468	588	668	1	37	80	0.4625000
NODE_3368_length_1272_cov_28.887468	588	668	2	24	80	0.3000000
NODE_3368_length_1272_cov_28.887468	588	668	4	16	80	0.2000000
NODE_3368_length_1272_cov_28.887468	641	721	2	11	80	0.1375000
NODE_3368_length_1272_cov_28.887468	641	721	4	68	80	0.8500000
NODE_3368_length_1272_cov_28.887468	641	721	6	1	80	0.0125000
NODE_3369_length_1272_cov_11.290708	366	447	6	5	81	0.0617284
NODE_3369_length_1272_cov_11.290708	366	447	8	5	81	0.0617284
NODE_3369_length_1272_cov_11.290708	366	447	10	71	81	0.8765432
NODE_3375_length_1270_cov_13.617421	365	445	0	80	80	1.0000000
NODE_3375_length_1270_cov_13.617421	396	473	0	77	77	1.0000000
NODE_3375_length_1270_cov_13.617421	418	498	0	80	80	1.0000000
NODE_3375_length_1270_cov_13.617421	449	473	0	24	24	1.0000000
NODE_3375_length_1270_cov_13.617421	465	498	0	33	33	1.0000000
NODE_3376_length_1270_cov_11.645602	294	374	0	80	80	1.0000000
NODE_3376_length_1270_cov_11.645602	347	427	0	80	80	1.0000000
NODE_3377_length_1270_cov_2.495303	74	131	11	1	57	0.0175439
NODE_3377_length_1270_cov_2.495303	74	131	13	10	57	0.1754386
NODE_3377_length_1270_cov_2.495303	74	131	15	7	57	0.1228070
NODE_3377_length_1270_cov_2.495303	74	131	16	8	57	0.1403509
NODE_3377_length_1270_cov_2.495303	74	131	17	31	57	0.5438597
NODE_3378_length_1269_cov_55.070940	492	569	0	1	77	0.0129870
NODE_3378_length_1269_cov_55.070940	492	569	6	5	77	0.0649351
NODE_3378_length_1269_cov_55.070940	492	569	8	71	77	0.9220779
NODE_3378_length_1269_cov_55.070940	545	625	0	21	80	0.2625000
NODE_3378_length_1269_cov_55.070940	545	625	2	11	80	0.1375000
NODE_3378_length_1269_cov_55.070940	545	625	6	17	80	0.2125000
NODE_3378_length_1269_cov_55.070940	545	625	8	31	80	0.3875000
NODE_3378_length_1269_cov_55.070940	621	701	0	43	80	0.5375000
NODE_3378_length_1269_cov_55.070940	621	701	6	37	80	0.4625000
NODE_3378_length_1269_cov_55.070940	674	754	0	17	80	0.2125000
NODE_3378_length_1269_cov_55.070940	674	754	6	63	80	0.7875000
NODE_3379_length_1269_cov_22.154701	1152	1216	14	10	64	0.1562500
NODE_3379_length_1269_cov_22.154701	1152	1216	15	37	64	0.5781250
NODE_3379_length_1269_cov_22.154701	1152	1216	16	17	64	0.2656250
NODE_3379_length_1269_cov_22.154701	1152	1216	14	10	64	0.1562500
NODE_3379_length_1269_cov_22.154701	1152	1216	15	37	64	0.5781250
NODE_3379_length_1269_cov_22.154701	1152	1216	16	17	64	0.2656250
NODE_3379_length_1269_cov_22.154701	1152	1216	14	10	64	0.1562500
NODE_3379_length_1269_cov_22.154701	1152	1216	15	37	64	0.5781250
NODE_3379_length_1269_cov_22.154701	1152	1216	16	17	64	0.2656250
NODE_3379_length_1269_cov_22.154701	1189	1269	0	2	80	0.0250000
NODE_3379_length_1269_cov_22.154701	1189	1269	4	7	80	0.0875000
NODE_3379_length_1269_cov_22.154701	1189	1269	6	2	80	0.0250000
NODE_3379_length_1269_cov_22.154701	1189	1269	10	4	80	0.0500000
NODE_3379_length_1269_cov_22.154701	1189	1269	14	48	80	0.6000000
NODE_3379_length_1269_cov_22.154701	1189	1269	16	17	80	0.2125000
NODE_3379_length_1269_cov_22.154701	1189	1269	0	2	80	0.0250000
NODE_3379_length_1269_cov_22.154701	1189	1269	4	7	80	0.0875000
NODE_3379_length_1269_cov_22.154701	1189	1269	6	2	80	0.0250000
NODE_3379_length_1269_cov_22.154701	1189	1269	10	4	80	0.0500000
NODE_3379_length_1269_cov_22.154701	1189	1269	14	48	80	0.6000000
NODE_3379_length_1269_cov_22.154701	1189	1269	16	17	80	0.2125000
NODE_3380_length_1269_cov_18.753846	317	398	0	11	81	0.1358025
NODE_3380_length_1269_cov_18.753846	317	398	3	24	81	0.2962963
NODE_3380_length_1269_cov_18.753846	317	398	4	36	81	0.4444444
NODE_3380_length_1269_cov_18.753846	317	398	6	10	81	0.1234568
NODE_3381_length_1269_cov_12.637607	580	660	0	80	80	1.0000000
NODE_3381_length_1269_cov_12.637607	633	713	0	80	80	1.0000000
NODE_3381_length_1269_cov_12.637607	709	729	0	20	20	1.0000000
NODE_3381_length_1269_cov_12.637607	709	789	0	37	80	0.4625000
NODE_3381_length_1269_cov_12.637607	709	789	2	43	80	0.5375000
NODE_3381_length_1269_cov_12.637607	762	842	0	27	80	0.3375000
NODE_3381_length_1269_cov_12.637607	762	842	2	53	80	0.6625000
NODE_3382_length_1269_cov_10.552137	765	845	2	80	80	1.0000000
NODE_3382_length_1269_cov_10.552137	818	898	1	21	80	0.2625000
NODE_3382_length_1269_cov_10.552137	818	898	2	59	80	0.7375000
NODE_3391_length_1268_cov_12.862275	300	350	13	1	50	0.0200000
NODE_3391_length_1268_cov_12.862275	300	350	17	2	50	0.0400000
NODE_3391_length_1268_cov_12.862275	300	350	19	2	50	0.0400000
NODE_3391_length_1268_cov_12.862275	300	350	21	4	50	0.0800000
NODE_3391_length_1268_cov_12.862275	300	350	23	3	50	0.0600000
NODE_3391_length_1268_cov_12.862275	300	350	24	5	50	0.1000000
NODE_3391_length_1268_cov_12.862275	300	350	26	2	50	0.0400000
NODE_3391_length_1268_cov_12.862275	300	350	28	11	50	0.2200000
NODE_3391_length_1268_cov_12.862275	300	350	31	5	50	0.1000000
NODE_3391_length_1268_cov_12.862275	300	350	33	1	50	0.0200000
NODE_3391_length_1268_cov_12.862275	300	350	36	1	50	0.0200000
NODE_3391_length_1268_cov_12.862275	300	350	47	4	50	0.0800000
NODE_3391_length_1268_cov_12.862275	300	350	48	3	50	0.0600000
NODE_3391_length_1268_cov_12.862275	300	350	50	1	50	0.0200000
NODE_3391_length_1268_cov_12.862275	300	350	52	3	50	0.0600000
NODE_3391_length_1268_cov_12.862275	300	350	56	2	50	0.0400000
NODE_3392_length_1268_cov_9.523524	265	345	0	80	80	1.0000000
NODE_3392_length_1268_cov_9.523524	318	398	0	80	80	1.0000000
NODE_3393_length_1267_cov_21.315068	299	379	0	51	80	0.6375000
NODE_3393_length_1267_cov_21.315068	299	379	2	29	80	0.3625000
NODE_3393_length_1267_cov_21.315068	352	432	0	80	80	1.0000000
NODE_3393_length_1267_cov_21.315068	698	778	0	80	80	1.0000000
NODE_3393_length_1267_cov_21.315068	751	831	0	38	80	0.4750000
NODE_3393_length_1267_cov_21.315068	751	831	3	7	80	0.0875000
NODE_3393_length_1267_cov_21.315068	751	831	6	35	80	0.4375000
NODE_3394_length_1267_cov_14.880137	606	686	0	60	80	0.7500000
NODE_3394_length_1267_cov_14.880137	606	686	10	20	80	0.2500000
NODE_3394_length_1267_cov_14.880137	659	739	0	7	80	0.0875000
NODE_3394_length_1267_cov_14.880137	659	739	10	73	80	0.9125000
NODE_3397_length_1266_cov_20.584404	357	437	0	20	80	0.2500000
NODE_3397_length_1266_cov_20.584404	357	437	4	60	80	0.7500000
NODE_3397_length_1266_cov_20.584404	410	490	0	73	80	0.9125000
NODE_3397_length_1266_cov_20.584404	410	490	4	7	80	0.0875000
NODE_3398_length_1266_cov_16.571551	359	435	0	76	76	1.0000000
NODE_3398_length_1266_cov_16.571551	408	488	0	80	80	1.0000000
NODE_3399_length_1266_cov_14.218509	517	595	0	29	78	0.3717949
NODE_3399_length_1266_cov_14.218509	517	595	2	49	78	0.6282051
NODE_3399_length_1266_cov_14.218509	568	648	0	46	80	0.5750000
NODE_3399_length_1266_cov_14.218509	568	648	2	34	80	0.4250000
NODE_3399_length_1266_cov_14.218509	644	724	0	36	80	0.4500000
NODE_3399_length_1266_cov_14.218509	644	724	4	21	80	0.2625000
NODE_3399_length_1266_cov_14.218509	644	724	6	23	80	0.2875000
NODE_3399_length_1266_cov_14.218509	697	777	2	20	80	0.2500000
NODE_3399_length_1266_cov_14.218509	697	777	4	4	80	0.0500000
NODE_3399_length_1266_cov_14.218509	697	777	6	56	80	0.7000000
NODE_3403_length_1265_cov_9.807890	429	509	0	80	80	1.0000000
NODE_3403_length_1265_cov_9.807890	482	562	0	80	80	1.0000000
NODE_3404_length_1265_cov_8.233276	160	207	0	6	47	0.1276596
NODE_3404_length_1265_cov_8.233276	160	207	2	5	47	0.1063830
NODE_3404_length_1265_cov_8.233276	160	207	4	9	47	0.1914894
NODE_3404_length_1265_cov_8.233276	160	207	10	1	47	0.0212766
NODE_3404_length_1265_cov_8.233276	160	207	12	24	47	0.5106383
NODE_3404_length_1265_cov_8.233276	160	207	14	2	47	0.0425532
NODE_3404_length_1265_cov_8.233276	1004	1058	0	54	54	1.0000000
NODE_3406_length_1265_cov_3.941681	503	583	0	47	80	0.5875000
NODE_3406_length_1265_cov_3.941681	503	583	1	2	80	0.0250000
NODE_3406_length_1265_cov_3.941681	503	583	2	31	80	0.3875000
NODE_3406_length_1265_cov_3.941681	556	636	0	80	80	1.0000000
NODE_3408_length_1264_cov_8.024034	290	370	0	80	80	1.0000000
NODE_3408_length_1264_cov_8.024034	343	423	0	80	80	1.0000000
NODE_3413_length_1263_cov_8.566151	698	778	0	29	80	0.3625000
NODE_3413_length_1263_cov_8.566151	698	778	2	51	80	0.6375000
NODE_3413_length_1263_cov_8.566151	751	831	2	80	80	1.0000000
NODE_3413_length_1263_cov_8.566151	833	910	0	77	77	1.0000000
NODE_3413_length_1263_cov_8.566151	883	963	0	80	80	1.0000000
NODE_3414_length_1263_cov_7.376289	1060	1140	7	20	80	0.2500000
NODE_3414_length_1263_cov_7.376289	1060	1140	8	60	80	0.7500000
NODE_3414_length_1263_cov_7.376289	1113	1213	0	9	100	0.0900000
NODE_3414_length_1263_cov_7.376289	1113	1213	7	1	100	0.0100000
NODE_3414_length_1263_cov_7.376289	1113	1213	8	90	100	0.9000000
NODE_3416_length_1263_cov_1.827320	227	307	0	21	80	0.2625000
NODE_3416_length_1263_cov_1.827320	227	307	4	59	80	0.7375000
NODE_3416_length_1263_cov_1.827320	280	360	3	40	80	0.5000000
NODE_3416_length_1263_cov_1.827320	280	360	4	40	80	0.5000000
NODE_3418_length_1262_cov_17.416165	404	484	2	71	80	0.8875000
NODE_3418_length_1262_cov_17.416165	404	484	4	9	80	0.1125000
NODE_3418_length_1262_cov_17.416165	457	537	0	9	80	0.1125000
NODE_3418_length_1262_cov_17.416165	457	537	2	68	80	0.8500000
NODE_3418_length_1262_cov_17.416165	457	537	4	3	80	0.0375000
NODE_3419_length_1262_cov_15.268272	648	728	0	80	80	1.0000000
NODE_3419_length_1262_cov_15.268272	701	781	0	80	80	1.0000000
NODE_3419_length_1262_cov_15.268272	777	857	0	80	80	1.0000000
NODE_3419_length_1262_cov_15.268272	830	910	0	80	80	1.0000000
NODE_3424_length_1261_cov_1.777969	272	318	0	46	46	1.0000000
NODE_3425_length_1260_cov_55.640827	499	579	0	25	80	0.3125000
NODE_3425_length_1260_cov_55.640827	499	579	2	55	80	0.6875000
NODE_3425_length_1260_cov_55.640827	552	632	0	3	80	0.0375000
NODE_3425_length_1260_cov_55.640827	552	632	2	77	80	0.9625000
NODE_3425_length_1260_cov_55.640827	628	708	0	79	80	0.9875000
NODE_3425_length_1260_cov_55.640827	628	708	2	1	80	0.0125000
NODE_3425_length_1260_cov_55.640827	681	761	0	80	80	1.0000000
NODE_3426_length_1260_cov_12.242894	427	507	0	57	80	0.7125000
NODE_3426_length_1260_cov_12.242894	427	507	2	23	80	0.2875000
NODE_3426_length_1260_cov_12.242894	480	560	0	30	80	0.3750000
NODE_3426_length_1260_cov_12.242894	480	560	2	50	80	0.6250000
NODE_3436_length_1259_cov_15.381897	509	589	0	5	80	0.0625000
NODE_3436_length_1259_cov_15.381897	509	589	2	75	80	0.9375000
NODE_3436_length_1259_cov_15.381897	562	642	2	80	80	1.0000000
NODE_3439_length_1258_cov_33.519413	608	688	0	80	80	1.0000000
NODE_3439_length_1258_cov_33.519413	661	741	0	80	80	1.0000000
NODE_3440_length_1258_cov_22.569456	583	663	6	27	80	0.3375000
NODE_3440_length_1258_cov_22.569456	583	663	9	19	80	0.2375000
NODE_3440_length_1258_cov_22.569456	583	663	10	34	80	0.4250000
NODE_3440_length_1258_cov_22.569456	636	716	0	30	80	0.3750000
NODE_3440_length_1258_cov_22.569456	636	716	6	50	80	0.6250000
NODE_3441_length_1258_cov_18.747196	308	388	0	80	80	1.0000000
NODE_3441_length_1258_cov_18.747196	361	441	0	80	80	1.0000000
NODE_3441_length_1258_cov_18.747196	437	517	0	80	80	1.0000000
NODE_3441_length_1258_cov_18.747196	490	570	0	80	80	1.0000000
NODE_3442_length_1258_cov_13.699741	332	412	0	80	80	1.0000000
NODE_3442_length_1258_cov_13.699741	385	465	0	80	80	1.0000000
NODE_3447_length_1257_cov_34.029361	567	647	0	17	80	0.2125000
NODE_3447_length_1257_cov_34.029361	567	647	8	30	80	0.3750000
NODE_3447_length_1257_cov_34.029361	567	647	9	24	80	0.3000000
NODE_3447_length_1257_cov_34.029361	567	647	10	9	80	0.1125000
NODE_3447_length_1257_cov_34.029361	620	700	0	17	80	0.2125000
NODE_3447_length_1257_cov_34.029361	620	700	1	31	80	0.3875000
NODE_3447_length_1257_cov_34.029361	620	700	2	22	80	0.2750000
NODE_3447_length_1257_cov_34.029361	620	700	8	10	80	0.1250000
NODE_3447_length_1257_cov_34.029361	696	776	2	80	80	1.0000000
NODE_3447_length_1257_cov_34.029361	749	829	0	1	80	0.0125000
NODE_3447_length_1257_cov_34.029361	749	829	1	31	80	0.3875000
NODE_3447_length_1257_cov_34.029361	749	829	2	48	80	0.6000000
NODE_3449_length_1257_cov_7.892919	317	397	0	80	80	1.0000000
NODE_3449_length_1257_cov_7.892919	370	450	0	80	80	1.0000000
NODE_3452_length_1256_cov_50.506482	389	469	0	80	80	1.0000000
NODE_3452_length_1256_cov_50.506482	442	522	0	80	80	1.0000000
NODE_3452_length_1256_cov_50.506482	518	598	0	15	80	0.1875000
NODE_3452_length_1256_cov_50.506482	518	598	3	30	80	0.3750000
NODE_3452_length_1256_cov_50.506482	518	598	4	35	80	0.4375000
NODE_3452_length_1256_cov_50.506482	571	651	0	36	80	0.4500000
NODE_3452_length_1256_cov_50.506482	571	651	3	44	80	0.5500000
NODE_3453_length_1256_cov_25.944685	754	834	0	12	80	0.1500000
NODE_3453_length_1256_cov_25.944685	754	834	2	68	80	0.8500000
NODE_3453_length_1256_cov_25.944685	807	887	0	33	80	0.4125000
NODE_3453_length_1256_cov_25.944685	807	887	2	47	80	0.5875000
NODE_3455_length_1256_cov_21.720830	713	793	0	80	80	1.0000000
NODE_3455_length_1256_cov_21.720830	766	846	0	80	80	1.0000000
NODE_3456_length_1256_cov_14.242005	595	675	0	34	80	0.4250000
NODE_3456_length_1256_cov_14.242005	595	675	2	22	80	0.2750000
NODE_3456_length_1256_cov_14.242005	595	675	4	24	80	0.3000000
NODE_3456_length_1256_cov_14.242005	648	728	0	80	80	1.0000000
NODE_3457_length_1256_cov_5.870354	879	959	0	80	80	1.0000000
NODE_3463_length_1255_cov_37.271626	458	538	0	80	80	1.0000000
NODE_3463_length_1255_cov_37.271626	511	591	0	80	80	1.0000000
NODE_3463_length_1255_cov_37.271626	587	667	0	80	80	1.0000000
NODE_3463_length_1255_cov_37.271626	640	720	0	80	80	1.0000000
NODE_3464_length_1255_cov_21.374567	516	596	0	80	80	1.0000000
NODE_3464_length_1255_cov_21.374567	569	649	0	80	80	1.0000000
NODE_3464_length_1255_cov_21.374567	645	725	0	80	80	1.0000000
NODE_3464_length_1255_cov_21.374567	698	778	0	80	80	1.0000000
NODE_3465_length_1255_cov_18.391869	521	601	0	33	80	0.4125000
NODE_3465_length_1255_cov_18.391869	521	601	4	47	80	0.5875000
NODE_3465_length_1255_cov_18.391869	574	654	4	80	80	1.0000000
NODE_3466_length_1255_cov_4.096021	1194	1242	0	48	48	1.0000000
NODE_3469_length_1254_cov_32.470996	612	692	0	11	80	0.1375000
NODE_3469_length_1254_cov_32.470996	612	692	2	69	80	0.8625000
NODE_3469_length_1254_cov_32.470996	665	745	0	56	80	0.7000000
NODE_3469_length_1254_cov_32.470996	665	745	2	24	80	0.3000000
NODE_3470_length_1254_cov_26.449351	488	568	0	80	80	1.0000000
NODE_3470_length_1254_cov_26.449351	541	621	0	80	80	1.0000000
NODE_3471_length_1254_cov_22.032035	531	611	0	42	80	0.5250000
NODE_3471_length_1254_cov_22.032035	531	611	2	38	80	0.4750000
NODE_3471_length_1254_cov_22.032035	584	664	0	7	80	0.0875000
NODE_3471_length_1254_cov_22.032035	584	664	2	73	80	0.9125000
NODE_3479_length_1253_cov_16.916811	651	731	0	80	80	1.0000000
NODE_3479_length_1253_cov_16.916811	704	784	0	61	80	0.7625000
NODE_3479_length_1253_cov_16.916811	704	784	6	19	80	0.2375000
NODE_3479_length_1253_cov_16.916811	780	860	6	80	80	1.0000000
NODE_3479_length_1253_cov_16.916811	833	913	0	1	80	0.0125000
NODE_3479_length_1253_cov_16.916811	833	913	6	79	80	0.9875000
NODE_3480_length_1253_cov_13.816291	811	891	0	21	80	0.2625000
NODE_3480_length_1253_cov_13.816291	811	891	2	59	80	0.7375000
NODE_3481_length_1253_cov_9.067591	306	386	2	24	80	0.3000000
NODE_3481_length_1253_cov_9.067591	306	386	4	3	80	0.0375000
NODE_3481_length_1253_cov_9.067591	306	386	6	2	80	0.0250000
NODE_3481_length_1253_cov_9.067591	306	386	7	1	80	0.0125000
NODE_3481_length_1253_cov_9.067591	306	386	8	50	80	0.6250000
NODE_3481_length_1253_cov_9.067591	359	439	0	20	80	0.2500000
NODE_3481_length_1253_cov_9.067591	359	439	4	7	80	0.0875000
NODE_3481_length_1253_cov_9.067591	359	439	6	28	80	0.3500000
NODE_3481_length_1253_cov_9.067591	359	439	7	1	80	0.0125000
NODE_3481_length_1253_cov_9.067591	359	439	8	24	80	0.3000000
NODE_3487_length_1252_cov_57.745880	477	557	0	80	80	1.0000000
NODE_3487_length_1252_cov_57.745880	530	610	0	80	80	1.0000000
NODE_3487_length_1252_cov_57.745880	606	686	0	27	80	0.3375000
NODE_3487_length_1252_cov_57.745880	606	686	2	19	80	0.2375000
NODE_3487_length_1252_cov_57.745880	606	686	3	11	80	0.1375000
NODE_3487_length_1252_cov_57.745880	606	686	5	10	80	0.1250000
NODE_3487_length_1252_cov_57.745880	606	686	6	13	80	0.1625000
NODE_3487_length_1252_cov_57.745880	659	739	3	4	80	0.0500000
NODE_3487_length_1252_cov_57.745880	659	739	4	1	80	0.0125000
NODE_3487_length_1252_cov_57.745880	659	739	5	10	80	0.1250000
NODE_3487_length_1252_cov_57.745880	659	739	6	65	80	0.8125000
NODE_3488_length_1252_cov_56.694709	594	674	0	7	80	0.0875000
NODE_3488_length_1252_cov_56.694709	594	674	2	73	80	0.9125000
NODE_3488_length_1252_cov_56.694709	647	727	0	17	80	0.2125000
NODE_3488_length_1252_cov_56.694709	647	727	1	1	80	0.0125000
NODE_3488_length_1252_cov_56.694709	647	727	2	62	80	0.7750000
NODE_3488_length_1252_cov_56.694709	723	803	0	42	80	0.5250000
NODE_3488_length_1252_cov_56.694709	723	803	2	38	80	0.4750000
NODE_3488_length_1252_cov_56.694709	785	847	2	62	62	1.0000000
NODE_3489_length_1252_cov_34.023417	468	548	0	52	80	0.6500000
NODE_3489_length_1252_cov_34.023417	468	548	8	28	80	0.3500000
NODE_3489_length_1252_cov_34.023417	521	601	8	80	80	1.0000000
NODE_3489_length_1252_cov_34.023417	597	677	0	34	80	0.4250000
NODE_3489_length_1252_cov_34.023417	597	677	8	46	80	0.5750000
NODE_3489_length_1252_cov_34.023417	650	730	0	59	80	0.7375000
NODE_3489_length_1252_cov_34.023417	650	730	2	21	80	0.2625000
NODE_3490_length_1252_cov_9.316565	573	653	3	12	80	0.1500000
NODE_3490_length_1252_cov_9.316565	573	653	5	9	80	0.1125000
NODE_3490_length_1252_cov_9.316565	573	653	8	25	80	0.3125000
NODE_3490_length_1252_cov_9.316565	573	653	10	34	80	0.4250000
NODE_3490_length_1252_cov_9.316565	626	706	4	15	80	0.1875000
NODE_3490_length_1252_cov_9.316565	626	706	6	21	80	0.2625000
NODE_3490_length_1252_cov_9.316565	626	706	8	29	80	0.3625000
NODE_3490_length_1252_cov_9.316565	626	706	10	15	80	0.1875000
NODE_3491_length_1252_cov_8.295750	602	682	2	47	80	0.5875000
NODE_3491_length_1252_cov_8.295750	602	682	4	8	80	0.1000000
NODE_3491_length_1252_cov_8.295750	602	682	5	1	80	0.0125000
NODE_3491_length_1252_cov_8.295750	602	682	6	24	80	0.3000000
NODE_3491_length_1252_cov_8.295750	655	735	4	61	80	0.7625000
NODE_3491_length_1252_cov_8.295750	655	735	6	19	80	0.2375000
NODE_3494_length_1251_cov_17.513889	579	659	0	80	80	1.0000000
NODE_3494_length_1251_cov_17.513889	632	712	0	80	80	1.0000000
NODE_3494_length_1251_cov_17.513889	708	788	0	80	80	1.0000000
NODE_3494_length_1251_cov_17.513889	761	841	0	76	80	0.9500000
NODE_3494_length_1251_cov_17.513889	761	841	1	1	80	0.0125000
NODE_3494_length_1251_cov_17.513889	761	841	2	3	80	0.0375000
NODE_3497_length_1251_cov_3.139757	0	76	0	76	76	1.0000000
NODE_3497_length_1251_cov_3.139757	49	98	0	45	49	0.9183673
NODE_3497_length_1251_cov_3.139757	49	98	2	2	49	0.0408163
NODE_3497_length_1251_cov_3.139757	49	98	6	2	49	0.0408163
NODE_3501_length_1250_cov_25.133797	325	405	0	12	80	0.1500000
NODE_3501_length_1250_cov_25.133797	325	405	2	68	80	0.8500000
NODE_3501_length_1250_cov_25.133797	378	458	0	65	80	0.8125000
NODE_3501_length_1250_cov_25.133797	378	458	2	15	80	0.1875000
NODE_3503_length_1250_cov_11.471764	652	733	0	81	81	1.0000000
NODE_3503_length_1250_cov_11.471764	706	786	0	80	80	1.0000000
NODE_3505_length_1249_cov_45.772174	543	623	0	43	80	0.5375000
NODE_3505_length_1249_cov_45.772174	543	623	2	37	80	0.4625000
NODE_3505_length_1249_cov_45.772174	596	676	2	80	80	1.0000000
NODE_3505_length_1249_cov_45.772174	672	749	0	28	77	0.3636364
NODE_3505_length_1249_cov_45.772174	672	749	2	49	77	0.6363636
NODE_3505_length_1249_cov_45.772174	729	802	0	29	73	0.3972603
NODE_3505_length_1249_cov_45.772174	729	802	2	44	73	0.6027398
NODE_3506_length_1249_cov_35.670435	515	595	0	80	80	1.0000000
NODE_3506_length_1249_cov_35.670435	568	648	0	80	80	1.0000000
NODE_3506_length_1249_cov_35.670435	644	724	0	80	80	1.0000000
NODE_3506_length_1249_cov_35.670435	697	777	0	80	80	1.0000000
NODE_3507_length_1249_cov_34.616522	576	656	0	35	80	0.4375000
NODE_3507_length_1249_cov_34.616522	576	656	4	45	80	0.5625000
NODE_3507_length_1249_cov_34.616522	629	709	0	11	80	0.1375000
NODE_3507_length_1249_cov_34.616522	629	709	4	69	80	0.8625000
NODE_3507_length_1249_cov_34.616522	705	785	0	80	80	1.0000000
NODE_3507_length_1249_cov_34.616522	758	838	0	80	80	1.0000000
NODE_3508_length_1249_cov_19.592174	461	541	0	80	80	1.0000000
NODE_3508_length_1249_cov_19.592174	514	594	0	80	80	1.0000000
NODE_3508_length_1249_cov_19.592174	860	940	0	80	80	1.0000000
NODE_3508_length_1249_cov_19.592174	913	993	0	80	80	1.0000000
NODE_3509_length_1249_cov_14.926957	1153	1219	1	66	66	1.0000000
NODE_3509_length_1249_cov_14.926957	1192	1249	0	10	57	0.1754386
NODE_3509_length_1249_cov_14.926957	1192	1249	1	47	57	0.8245614
NODE_3509_length_1249_cov_14.926957	1192	1247	0	8	55	0.1454545
NODE_3509_length_1249_cov_14.926957	1192	1247	1	47	55	0.8545455
NODE_3509_length_1249_cov_14.926957	1192	1249	0	10	57	0.1754386
NODE_3509_length_1249_cov_14.926957	1192	1249	1	47	57	0.8245614
NODE_3510_length_1249_cov_7.682609	757	837	0	7	80	0.0875000
NODE_3510_length_1249_cov_7.682609	757	837	2	73	80	0.9125000
NODE_3510_length_1249_cov_7.682609	810	890	0	58	80	0.7250000
NODE_3510_length_1249_cov_7.682609	810	890	2	22	80	0.2750000
NODE_3514_length_1248_cov_14.351610	469	549	0	59	80	0.7375000
NODE_3514_length_1248_cov_14.351610	469	549	4	21	80	0.2625000
NODE_3514_length_1248_cov_14.351610	522	602	0	6	80	0.0750000
NODE_3514_length_1248_cov_14.351610	522	602	4	74	80	0.9250000
NODE_3514_length_1248_cov_14.351610	598	678	0	53	80	0.6625000
NODE_3514_length_1248_cov_14.351610	598	678	4	27	80	0.3375000
NODE_3514_length_1248_cov_14.351610	651	731	0	80	80	1.0000000
NODE_3515_length_1248_cov_11.181027	303	383	0	80	80	1.0000000
NODE_3515_length_1248_cov_11.181027	356	436	0	80	80	1.0000000
NODE_3515_length_1248_cov_11.181027	432	512	0	80	80	1.0000000
NODE_3515_length_1248_cov_11.181027	485	565	0	80	80	1.0000000
NODE_3516_length_1248_cov_4.372498	17	98	0	81	81	1.0000000
NODE_3516_length_1248_cov_4.372498	94	152	0	58	58	1.0000000
NODE_3517_length_1248_cov_2.356832	952	1032	0	10	80	0.1250000
NODE_3517_length_1248_cov_2.356832	952	1032	1	19	80	0.2375000
NODE_3517_length_1248_cov_2.356832	952	1032	2	51	80	0.6375000
NODE_3517_length_1248_cov_2.356832	1005	1085	2	80	80	1.0000000
NODE_3518_length_1248_cov_2.283725	1102	1151	2	49	49	1.0000000
NODE_3522_length_1247_cov_25.355401	487	567	0	80	80	1.0000000
NODE_3522_length_1247_cov_25.355401	540	620	0	80	80	1.0000000
NODE_3522_length_1247_cov_25.355401	616	696	0	80	80	1.0000000
NODE_3522_length_1247_cov_25.355401	669	749	0	80	80	1.0000000
NODE_3528_length_1246_cov_30.231909	433	513	0	80	80	1.0000000
NODE_3528_length_1246_cov_30.231909	486	566	0	80	80	1.0000000
NODE_3528_length_1246_cov_30.231909	562	642	0	80	80	1.0000000
NODE_3528_length_1246_cov_30.231909	615	695	0	80	80	1.0000000
NODE_3529_length_1246_cov_13.847428	497	577	0	80	80	1.0000000
NODE_3529_length_1246_cov_13.847428	550	630	0	80	80	1.0000000
NODE_3535_length_1245_cov_31.472949	443	523	0	80	80	1.0000000
NODE_3535_length_1245_cov_31.472949	496	576	0	80	80	1.0000000
NODE_3536_length_1245_cov_30.068935	771	841	0	70	70	1.0000000
NODE_3537_length_1245_cov_24.765271	668	748	0	80	80	1.0000000
NODE_3537_length_1245_cov_24.765271	721	801	0	80	80	1.0000000
NODE_3537_length_1245_cov_24.765271	797	877	0	23	80	0.2875000
NODE_3537_length_1245_cov_24.765271	797	877	2	57	80	0.7125000
NODE_3537_length_1245_cov_24.765271	850	930	0	28	80	0.3500000
NODE_3537_length_1245_cov_24.765271	850	930	2	52	80	0.6500000
NODE_3538_length_1245_cov_16.854276	655	735	0	80	80	1.0000000
NODE_3538_length_1245_cov_16.854276	701	771	0	70	70	1.0000000
NODE_3538_length_1245_cov_16.854276	708	788	0	80	80	1.0000000
NODE_3540_length_1245_cov_1.187609	1148	1194	0	46	46	1.0000000
NODE_3540_length_1245_cov_1.187609	1167	1245	0	78	78	1.0000000
NODE_3541_length_1244_cov_52.633188	501	581	0	62	80	0.7750000
NODE_3541_length_1244_cov_52.633188	501	581	6	18	80	0.2250000
NODE_3541_length_1244_cov_52.633188	554	634	0	9	80	0.1125000
NODE_3541_length_1244_cov_52.633188	554	634	6	71	80	0.8875000
NODE_3541_length_1244_cov_52.633188	630	710	0	63	80	0.7875000
NODE_3541_length_1244_cov_52.633188	630	710	6	17	80	0.2125000
NODE_3541_length_1244_cov_52.633188	683	763	0	80	80	1.0000000
NODE_3542_length_1244_cov_33.889956	445	525	0	80	80	1.0000000
NODE_3542_length_1244_cov_33.889956	498	578	0	80	80	1.0000000
NODE_3542_length_1244_cov_33.889956	574	654	0	62	80	0.7750000
NODE_3542_length_1244_cov_33.889956	574	654	4	18	80	0.2250000
NODE_3542_length_1244_cov_33.889956	627	707	0	9	80	0.1125000
NODE_3542_length_1244_cov_33.889956	627	707	4	71	80	0.8875000
NODE_3543_length_1244_cov_16.798253	644	724	5	29	80	0.3625000
NODE_3543_length_1244_cov_16.798253	644	724	6	22	80	0.2750000
NODE_3543_length_1244_cov_16.798253	644	724	9	29	80	0.3625000
NODE_3543_length_1244_cov_16.798253	697	777	0	4	80	0.0500000
NODE_3543_length_1244_cov_16.798253	697	777	4	36	80	0.4500000
NODE_3543_length_1244_cov_16.798253	697	777	8	1	80	0.0125000
NODE_3543_length_1244_cov_16.798253	697	777	9	39	80	0.4875000
NODE_3544_length_1244_cov_1.735371	276	347	0	71	71	1.0000000
NODE_3544_length_1244_cov_1.735371	276	347	0	71	71	1.0000000
NODE_3544_length_1244_cov_1.735371	320	400	0	80	80	1.0000000
NODE_3544_length_1244_cov_1.735371	320	400	0	80	80	1.0000000
NODE_3548_length_1243_cov_34.284965	774	854	0	6	80	0.0750000
NODE_3548_length_1243_cov_34.284965	774	854	2	74	80	0.9250000
NODE_3548_length_1243_cov_34.284965	827	907	0	6	80	0.0750000
NODE_3548_length_1243_cov_34.284965	827	907	2	74	80	0.9250000
NODE_3552_length_1242_cov_29.665792	539	619	0	23	80	0.2875000
NODE_3552_length_1242_cov_29.665792	539	619	2	52	80	0.6500000
NODE_3552_length_1242_cov_29.665792	539	619	4	5	80	0.0625000
NODE_3552_length_1242_cov_29.665792	592	672	0	76	80	0.9500000
NODE_3552_length_1242_cov_29.665792	592	672	2	4	80	0.0500000
NODE_3553_length_1242_cov_28.304462	506	586	0	80	80	1.0000000
NODE_3553_length_1242_cov_28.304462	559	639	0	80	80	1.0000000
NODE_3553_length_1242_cov_28.304462	635	715	0	55	80	0.6875000
NODE_3553_length_1242_cov_28.304462	635	715	2	25	80	0.3125000
NODE_3553_length_1242_cov_28.304462	688	768	0	2	80	0.0250000
NODE_3553_length_1242_cov_28.304462	688	768	2	78	80	0.9750000
NODE_3554_length_1242_cov_16.383202	704	784	0	49	80	0.6125000
NODE_3554_length_1242_cov_16.383202	704	784	2	1	80	0.0125000
NODE_3554_length_1242_cov_16.383202	704	784	4	30	80	0.3750000
NODE_3554_length_1242_cov_16.383202	757	837	0	9	80	0.1125000
NODE_3554_length_1242_cov_16.383202	757	837	2	4	80	0.0500000
NODE_3554_length_1242_cov_16.383202	757	837	4	67	80	0.8375000
NODE_3555_length_1242_cov_8.081365	688	768	0	21	80	0.2625000
NODE_3555_length_1242_cov_8.081365	688	768	2	59	80	0.7375000
NODE_3555_length_1242_cov_8.081365	741	821	0	74	80	0.9250000
NODE_3555_length_1242_cov_8.081365	741	821	2	6	80	0.0750000
NODE_3561_length_1241_cov_36.544658	602	682	0	80	80	1.0000000
NODE_3561_length_1241_cov_36.544658	655	735	0	80	80	1.0000000
NODE_3562_length_1241_cov_19.894921	676	756	2	65	80	0.8125000
NODE_3562_length_1241_cov_19.894921	676	756	4	15	80	0.1875000
NODE_3562_length_1241_cov_19.894921	729	809	2	50	80	0.6250000
NODE_3562_length_1241_cov_19.894921	729	809	4	30	80	0.3750000
NODE_3569_length_1240_cov_38.375110	483	563	0	80	80	1.0000000
NODE_3569_length_1240_cov_38.375110	536	616	0	80	80	1.0000000
NODE_3569_length_1240_cov_38.375110	612	692	0	80	80	1.0000000
NODE_3569_length_1240_cov_38.375110	665	745	0	80	80	1.0000000
NODE_3570_length_1240_cov_24.975460	625	705	2	47	80	0.5875000
NODE_3570_length_1240_cov_24.975460	625	705	4	6	80	0.0750000
NODE_3570_length_1240_cov_24.975460	625	705	6	27	80	0.3375000
NODE_3570_length_1240_cov_24.975460	678	758	0	19	80	0.2375000
NODE_3570_length_1240_cov_24.975460	678	758	4	26	80	0.3250000
NODE_3570_length_1240_cov_24.975460	678	758	6	35	80	0.4375000
NODE_3571_length_1240_cov_23.812445	731	811	0	80	80	1.0000000
NODE_3571_length_1240_cov_23.812445	784	864	0	44	80	0.5500000
NODE_3571_length_1240_cov_23.812445	784	864	2	36	80	0.4500000
NODE_3576_length_1239_cov_37.657895	399	479	0	73	80	0.9125000
NODE_3576_length_1239_cov_37.657895	399	479	2	7	80	0.0875000
NODE_3576_length_1239_cov_37.657895	452	532	0	20	80	0.2500000
NODE_3576_length_1239_cov_37.657895	452	532	2	60	80	0.7500000
NODE_3576_length_1239_cov_37.657895	528	608	0	64	80	0.8000000
NODE_3576_length_1239_cov_37.657895	528	608	2	16	80	0.2000000
NODE_3576_length_1239_cov_37.657895	581	661	0	80	80	1.0000000
NODE_3577_length_1239_cov_14.984211	398	478	0	80	80	1.0000000
NODE_3577_length_1239_cov_14.984211	451	531	0	80	80	1.0000000
NODE_3577_length_1239_cov_14.984211	771	825	0	54	54	1.0000000
NODE_3577_length_1239_cov_14.984211	798	878	0	80	80	1.0000000
NODE_3578_length_1239_cov_13.312281	806	886	0	80	80	1.0000000
NODE_3578_length_1239_cov_13.312281	859	939	0	80	80	1.0000000
NODE_3579_length_1239_cov_7.116667	444	524	0	80	80	1.0000000
NODE_3579_length_1239_cov_7.116667	497	577	0	80	80	1.0000000
NODE_3582_length_1238_cov_33.830553	625	705	0	80	80	1.0000000
NODE_3582_length_1238_cov_33.830553	678	758	0	80	80	1.0000000
NODE_3583_length_1238_cov_8.163301	664	744	7	1	80	0.0125000
NODE_3583_length_1238_cov_8.163301	664	744	8	62	80	0.7750000
NODE_3583_length_1238_cov_8.163301	664	744	9	17	80	0.2125000
NODE_3583_length_1238_cov_8.163301	717	797	6	5	80	0.0625000
NODE_3583_length_1238_cov_8.163301	717	797	8	46	80	0.5750000
NODE_3583_length_1238_cov_8.163301	717	797	10	7	80	0.0875000
NODE_3583_length_1238_cov_8.163301	717	797	12	22	80	0.2750000
NODE_3586_length_1237_cov_24.562390	447	527	4	21	80	0.2625000
NODE_3586_length_1237_cov_24.562390	447	527	6	16	80	0.2000000
NODE_3586_length_1237_cov_24.562390	447	527	12	7	80	0.0875000
NODE_3586_length_1237_cov_24.562390	447	527	14	11	80	0.1375000
NODE_3586_length_1237_cov_24.562390	447	527	15	2	80	0.0250000
NODE_3586_length_1237_cov_24.562390	447	527	17	2	80	0.0250000
NODE_3586_length_1237_cov_24.562390	447	527	18	21	80	0.2625000
NODE_3586_length_1237_cov_24.562390	500	580	10	17	80	0.2125000
NODE_3586_length_1237_cov_24.562390	500	580	12	21	80	0.2625000
NODE_3586_length_1237_cov_24.562390	500	580	14	26	80	0.3250000
NODE_3586_length_1237_cov_24.562390	500	580	18	16	80	0.2000000
NODE_3587_length_1237_cov_9.297012	515	595	0	6	80	0.0750000
NODE_3587_length_1237_cov_9.297012	515	595	2	8	80	0.1000000
NODE_3587_length_1237_cov_9.297012	515	595	4	66	80	0.8250000
NODE_3587_length_1237_cov_9.297012	568	648	0	1	80	0.0125000
NODE_3587_length_1237_cov_9.297012	568	648	1	24	80	0.3000000
NODE_3587_length_1237_cov_9.297012	568	648	2	22	80	0.2750000
NODE_3587_length_1237_cov_9.297012	568	648	4	33	80	0.4125000
NODE_3594_length_1236_cov_46.661390	632	712	20	5	80	0.0625000
NODE_3594_length_1236_cov_46.661390	632	712	22	41	80	0.5125000
NODE_3594_length_1236_cov_46.661390	632	712	26	20	80	0.2500000
NODE_3594_length_1236_cov_46.661390	632	712	28	2	80	0.0250000
NODE_3594_length_1236_cov_46.661390	632	712	30	12	80	0.1500000
NODE_3594_length_1236_cov_46.661390	685	765	25	13	80	0.1625000
NODE_3594_length_1236_cov_46.661390	685	765	26	53	80	0.6625000
NODE_3594_length_1236_cov_46.661390	685	765	28	2	80	0.0250000
NODE_3594_length_1236_cov_46.661390	685	765	30	12	80	0.1500000
NODE_3595_length_1236_cov_8.625330	735	815	0	24	80	0.3000000
NODE_3595_length_1236_cov_8.625330	735	815	2	7	80	0.0875000
NODE_3595_length_1236_cov_8.625330	735	815	4	49	80	0.6125000
NODE_3595_length_1236_cov_8.625330	788	868	0	11	80	0.1375000
NODE_3595_length_1236_cov_8.625330	788	868	2	15	80	0.1875000
NODE_3595_length_1236_cov_8.625330	788	868	4	54	80	0.6750000
NODE_3597_length_1235_cov_31.619718	331	411	0	15	80	0.1875000
NODE_3597_length_1235_cov_31.619718	331	411	4	65	80	0.8125000
NODE_3597_length_1235_cov_31.619718	384	464	0	66	80	0.8250000
NODE_3597_length_1235_cov_31.619718	384	464	4	14	80	0.1750000
NODE_3598_length_1235_cov_20.252641	559	639	0	80	80	1.0000000
NODE_3598_length_1235_cov_20.252641	612	692	0	80	80	1.0000000
NODE_3598_length_1235_cov_20.252641	688	768	0	80	80	1.0000000
NODE_3598_length_1235_cov_20.252641	741	821	0	80	80	1.0000000
NODE_3599_length_1235_cov_18.462148	695	775	0	14	80	0.1750000
NODE_3599_length_1235_cov_18.462148	695	775	2	66	80	0.8250000
NODE_3599_length_1235_cov_18.462148	748	828	0	42	80	0.5250000
NODE_3599_length_1235_cov_18.462148	748	828	2	38	80	0.4750000
NODE_3600_length_1235_cov_8.696303	765	845	0	63	80	0.7875000
NODE_3600_length_1235_cov_8.696303	765	845	4	17	80	0.2125000
NODE_3600_length_1235_cov_8.696303	818	898	0	14	80	0.1750000
NODE_3600_length_1235_cov_8.696303	818	898	4	66	80	0.8250000
NODE_3601_length_1235_cov_5.580106	544	624	0	36	80	0.4500000
NODE_3601_length_1235_cov_5.580106	544	624	2	44	80	0.5500000
NODE_3601_length_1235_cov_5.580106	597	677	2	36	80	0.4500000
NODE_3601_length_1235_cov_5.580106	597	677	4	16	80	0.2000000
NODE_3601_length_1235_cov_5.580106	597	677	6	28	80	0.3500000
NODE_3608_length_1234_cov_27.136564	528	608	0	80	80	1.0000000
NODE_3608_length_1234_cov_27.136564	581	661	0	80	80	1.0000000
NODE_3611_length_1233_cov_64.374780	497	577	0	80	80	1.0000000
NODE_3611_length_1233_cov_64.374780	550	630	0	80	80	1.0000000
NODE_3611_length_1233_cov_64.374780	626	706	0	27	80	0.3375000
NODE_3611_length_1233_cov_64.374780	626	706	1	1	80	0.0125000
NODE_3611_length_1233_cov_64.374780	626	706	2	52	80	0.6500000
NODE_3611_length_1233_cov_64.374780	679	759	2	80	80	1.0000000
NODE_3612_length_1233_cov_52.833333	654	734	0	67	80	0.8375000
NODE_3612_length_1233_cov_52.833333	654	734	4	13	80	0.1625000
NODE_3612_length_1233_cov_52.833333	707	787	0	14	80	0.1750000
NODE_3612_length_1233_cov_52.833333	707	787	4	17	80	0.2125000
NODE_3612_length_1233_cov_52.833333	707	787	6	5	80	0.0625000
NODE_3612_length_1233_cov_52.833333	707	787	9	14	80	0.1750000
NODE_3612_length_1233_cov_52.833333	707	787	10	30	80	0.3750000
NODE_3613_length_1233_cov_18.096120	522	602	0	3	80	0.0375000
NODE_3613_length_1233_cov_18.096120	522	602	2	25	80	0.3125000
NODE_3613_length_1233_cov_18.096120	522	602	4	20	80	0.2500000
NODE_3613_length_1233_cov_18.096120	522	602	6	32	80	0.4000000
NODE_3613_length_1233_cov_18.096120	575	655	0	15	80	0.1875000
NODE_3613_length_1233_cov_18.096120	575	655	2	14	80	0.1750000
NODE_3613_length_1233_cov_18.096120	575	655	4	28	80	0.3500000
NODE_3613_length_1233_cov_18.096120	575	655	6	23	80	0.2875000
NODE_3613_length_1233_cov_18.096120	651	731	0	80	80	1.0000000
NODE_3613_length_1233_cov_18.096120	704	784	0	80	80	1.0000000
NODE_3614_length_1233_cov_15.360670	585	656	0	71	71	1.0000000
NODE_3614_length_1233_cov_15.360670	631	709	0	78	78	1.0000000
NODE_3620_length_1232_cov_62.112974	552	632	0	80	80	1.0000000
NODE_3620_length_1232_cov_62.112974	605	694	0	89	89	1.0000000
NODE_3620_length_1232_cov_62.112974	690	770	0	80	80	1.0000000
NODE_3620_length_1232_cov_62.112974	743	823	0	53	80	0.6625000
NODE_3620_length_1232_cov_62.112974	743	823	4	27	80	0.3375000
NODE_3621_length_1232_cov_34.635481	469	549	1	48	80	0.6000000
NODE_3621_length_1232_cov_34.635481	469	549	7	1	80	0.0125000
NODE_3621_length_1232_cov_34.635481	469	549	10	2	80	0.0250000
NODE_3621_length_1232_cov_34.635481	469	549	11	23	80	0.2875000
NODE_3621_length_1232_cov_34.635481	469	549	12	6	80	0.0750000
NODE_3621_length_1232_cov_34.635481	522	602	6	4	80	0.0500000
NODE_3621_length_1232_cov_34.635481	522	602	10	2	80	0.0250000
NODE_3621_length_1232_cov_34.635481	522	602	11	19	80	0.2375000
NODE_3621_length_1232_cov_34.635481	522	602	12	55	80	0.6875000
NODE_3622_length_1232_cov_16.362754	774	854	0	80	80	1.0000000
NODE_3622_length_1232_cov_16.362754	827	907	0	80	80	1.0000000
NODE_3623_length_1232_cov_13.395410	234	315	0	2	81	0.0246914
NODE_3623_length_1232_cov_13.395410	234	315	1	15	81	0.1851852
NODE_3623_length_1232_cov_13.395410	234	315	2	40	81	0.4938272
NODE_3623_length_1232_cov_13.395410	234	315	6	24	81	0.2962963
NODE_3623_length_1232_cov_13.395410	287	368	0	55	81	0.6790124
NODE_3623_length_1232_cov_13.395410	287	368	1	15	81	0.1851852
NODE_3623_length_1232_cov_13.395410	287	368	2	11	81	0.1358025
NODE_3623_length_1232_cov_13.395410	364	444	0	80	80	1.0000000
NODE_3623_length_1232_cov_13.395410	417	497	0	80	80	1.0000000
NODE_3625_length_1231_cov_47.606890	509	589	0	52	80	0.6500000
NODE_3625_length_1231_cov_47.606890	509	589	2	2	80	0.0250000
NODE_3625_length_1231_cov_47.606890	509	589	4	26	80	0.3250000
NODE_3625_length_1231_cov_47.606890	562	642	2	1	80	0.0125000
NODE_3625_length_1231_cov_47.606890	562	642	4	79	80	0.9875000
NODE_3625_length_1231_cov_47.606890	638	718	2	49	80	0.6125000
NODE_3625_length_1231_cov_47.606890	638	718	4	31	80	0.3875000
NODE_3625_length_1231_cov_47.606890	691	771	0	12	80	0.1500000
NODE_3625_length_1231_cov_47.606890	691	771	2	68	80	0.8500000
NODE_3626_length_1231_cov_27.498233	698	777	4	7	79	0.0886076
NODE_3626_length_1231_cov_27.498233	698	777	5	1	79	0.0126582
NODE_3626_length_1231_cov_27.498233	698	777	6	6	79	0.0759494
NODE_3626_length_1231_cov_27.498233	698	777	7	8	79	0.1012658
NODE_3626_length_1231_cov_27.498233	698	777	8	57	79	0.7215190
NODE_3626_length_1231_cov_27.498233	750	830	4	13	80	0.1625000
NODE_3626_length_1231_cov_27.498233	750	830	6	31	80	0.3875000
NODE_3626_length_1231_cov_27.498233	750	830	8	33	80	0.4125000
NODE_3626_length_1231_cov_27.498233	750	830	10	3	80	0.0375000
NODE_3627_length_1231_cov_21.245583	673	753	2	80	80	1.0000000
NODE_3627_length_1231_cov_21.245583	726	806	0	44	80	0.5500000
NODE_3627_length_1231_cov_21.245583	726	806	2	36	80	0.4500000
NODE_3627_length_1231_cov_21.245583	802	882	0	31	80	0.3875000
NODE_3627_length_1231_cov_21.245583	802	882	4	49	80	0.6125000
NODE_3627_length_1231_cov_21.245583	860	935	0	11	75	0.1466667
NODE_3627_length_1231_cov_21.245583	860	935	2	28	75	0.3733333
NODE_3627_length_1231_cov_21.245583	860	935	4	36	75	0.4800000
NODE_3628_length_1231_cov_9.895760	515	595	0	35	80	0.4375000
NODE_3628_length_1231_cov_9.895760	515	595	4	27	80	0.3375000
NODE_3628_length_1231_cov_9.895760	515	595	6	18	80	0.2250000
NODE_3628_length_1231_cov_9.895760	568	648	0	50	80	0.6250000
NODE_3628_length_1231_cov_9.895760	568	648	2	11	80	0.1375000
NODE_3628_length_1231_cov_9.895760	568	648	4	19	80	0.2375000
NODE_3630_length_1230_cov_43.705570	412	492	9	1	80	0.0125000
NODE_3630_length_1230_cov_43.705570	412	492	11	33	80	0.4125000
NODE_3630_length_1230_cov_43.705570	412	492	12	23	80	0.2875000
NODE_3630_length_1230_cov_43.705570	412	492	13	10	80	0.1250000
NODE_3630_length_1230_cov_43.705570	412	492	14	13	80	0.1625000
NODE_3630_length_1230_cov_43.705570	465	545	0	28	80	0.3500000
NODE_3630_length_1230_cov_43.705570	465	545	2	3	80	0.0375000
NODE_3630_length_1230_cov_43.705570	465	545	7	1	80	0.0125000
NODE_3630_length_1230_cov_43.705570	465	545	9	22	80	0.2750000
NODE_3630_length_1230_cov_43.705570	465	545	11	26	80	0.3250000
NODE_3631_length_1230_cov_43.663130	501	581	0	38	80	0.4750000
NODE_3631_length_1230_cov_43.663130	501	581	10	21	80	0.2625000
NODE_3631_length_1230_cov_43.663130	501	581	14	21	80	0.2625000
NODE_3631_length_1230_cov_43.663130	554	634	4	13	80	0.1625000
NODE_3631_length_1230_cov_43.663130	554	634	10	6	80	0.0750000
NODE_3631_length_1230_cov_43.663130	554	634	14	61	80	0.7625000
NODE_3632_length_1230_cov_33.173298	315	395	0	80	80	1.0000000
NODE_3632_length_1230_cov_33.173298	368	448	0	80	80	1.0000000
NODE_3633_length_1230_cov_12.939876	201	281	0	11	80	0.1375000
NODE_3633_length_1230_cov_12.939876	201	281	6	18	80	0.2250000
NODE_3633_length_1230_cov_12.939876	201	281	8	51	80	0.6375000
NODE_3633_length_1230_cov_12.939876	218	273	6	12	55	0.2181818
NODE_3633_length_1230_cov_12.939876	218	273	8	43	55	0.7818182
NODE_3633_length_1230_cov_12.939876	254	334	0	14	80	0.1750000
NODE_3633_length_1230_cov_12.939876	254	334	2	20	80	0.2500000
NODE_3633_length_1230_cov_12.939876	254	334	8	46	80	0.5750000
NODE_3633_length_1230_cov_12.939876	330	410	0	80	80	1.0000000
NODE_3633_length_1230_cov_12.939876	383	463	0	80	80	1.0000000
NODE_3634_length_1230_cov_5.155615	248	328	2	8	80	0.1000000
NODE_3634_length_1230_cov_5.155615	248	328	4	72	80	0.9000000
NODE_3634_length_1230_cov_5.155615	301	381	2	61	80	0.7625000
NODE_3634_length_1230_cov_5.155615	301	381	4	19	80	0.2375000
NODE_3640_length_1229_cov_30.214159	341	421	2	80	80	1.0000000
NODE_3640_length_1229_cov_30.214159	394	474	2	32	80	0.4000000
NODE_3640_length_1229_cov_30.214159	394	474	3	5	80	0.0625000
NODE_3640_length_1229_cov_30.214159	394	474	4	43	80	0.5375000
NODE_3641_length_1229_cov_23.165487	376	456	0	14	80	0.1750000
NODE_3641_length_1229_cov_23.165487	376	456	2	66	80	0.8250000
NODE_3641_length_1229_cov_23.165487	429	509	0	67	80	0.8375000
NODE_3641_length_1229_cov_23.165487	429	509	2	13	80	0.1625000
NODE_3641_length_1229_cov_23.165487	505	585	0	80	80	1.0000000
NODE_3641_length_1229_cov_23.165487	558	638	0	80	80	1.0000000
NODE_3642_length_1229_cov_19.376991	484	564	0	30	80	0.3750000
NODE_3642_length_1229_cov_19.376991	484	564	19	23	80	0.2875000
NODE_3642_length_1229_cov_19.376991	484	564	20	27	80	0.3375000
NODE_3642_length_1229_cov_19.376991	537	614	17	13	77	0.1688312
NODE_3642_length_1229_cov_19.376991	537	614	18	23	77	0.2987013
NODE_3642_length_1229_cov_19.376991	537	614	19	17	77	0.2207792
NODE_3642_length_1229_cov_19.376991	537	614	20	24	77	0.3116883
NODE_3643_length_1229_cov_11.799115	670	748	0	70	78	0.8974359
NODE_3643_length_1229_cov_11.799115	670	748	2	8	78	0.1025641
NODE_3643_length_1229_cov_11.799115	728	801	0	73	73	1.0000000
NODE_3644_length_1229_cov_8.140708	970	1050	0	80	80	1.0000000
NODE_3644_length_1229_cov_8.140708	1023	1103	0	80	80	1.0000000
NODE_3646_length_1229_cov_3.654867	765	840	0	75	75	1.0000000
NODE_3646_length_1229_cov_3.654867	813	893	0	80	80	1.0000000
NODE_3652_length_1229_cov_0.949558	1034	1079	0	43	45	0.9555556
NODE_3652_length_1229_cov_0.949558	1034	1079	2	2	45	0.0444444
NODE_3652_length_1229_cov_0.949558	1090	1130	0	3	40	0.0750000
NODE_3652_length_1229_cov_0.949558	1090	1130	1	1	40	0.0250000
NODE_3652_length_1229_cov_0.949558	1090	1130	4	36	40	0.9000000
NODE_3654_length_1228_cov_22.622675	604	684	4	4	80	0.0500000
NODE_3654_length_1228_cov_22.622675	604	684	6	6	80	0.0750000
NODE_3654_length_1228_cov_22.622675	604	684	8	12	80	0.1500000
NODE_3654_length_1228_cov_22.622675	604	684	10	49	80	0.6125000
NODE_3654_length_1228_cov_22.622675	604	684	12	9	80	0.1125000
NODE_3654_length_1228_cov_22.622675	657	738	0	19	81	0.2345679
NODE_3654_length_1228_cov_22.622675	657	738	2	13	81	0.1604938
NODE_3654_length_1228_cov_22.622675	657	738	4	26	81	0.3209876
NODE_3654_length_1228_cov_22.622675	657	738	6	6	81	0.0740741
NODE_3654_length_1228_cov_22.622675	657	738	10	17	81	0.2098765
NODE_3655_length_1228_cov_17.900797	423	503	0	80	80	1.0000000
NODE_3655_length_1228_cov_17.900797	423	503	0	80	80	1.0000000
NODE_3655_length_1228_cov_17.900797	423	503	0	80	80	1.0000000
NODE_3655_length_1228_cov_17.900797	476	538	0	62	62	1.0000000
NODE_3655_length_1228_cov_17.900797	476	538	0	62	62	1.0000000
NODE_3655_length_1228_cov_17.900797	476	538	0	62	62	1.0000000
NODE_3655_length_1228_cov_17.900797	476	556	0	80	80	1.0000000
NODE_3656_length_1228_cov_14.554473	367	447	0	80	80	1.0000000
NODE_3656_length_1228_cov_14.554473	420	500	0	80	80	1.0000000
NODE_3657_length_1228_cov_10.021258	661	741	0	5	80	0.0625000
NODE_3657_length_1228_cov_10.021258	661	741	2	75	80	0.9375000
NODE_3657_length_1228_cov_10.021258	714	794	0	2	80	0.0250000
NODE_3657_length_1228_cov_10.021258	714	794	2	78	80	0.9750000
NODE_3660_length_1228_cov_3.987600	1139	1219	0	80	80	1.0000000
NODE_3662_length_1227_cov_29.002660	423	503	0	80	80	1.0000000
NODE_3662_length_1227_cov_29.002660	476	556	0	80	80	1.0000000
NODE_3663_length_1227_cov_17.479610	759	839	0	80	80	1.0000000
NODE_3663_length_1227_cov_17.479610	812	892	0	80	80	1.0000000
NODE_3666_length_1227_cov_3.808511	120	186	2	1	66	0.0151515
NODE_3666_length_1227_cov_3.808511	120	186	6	6	66	0.0909091
NODE_3666_length_1227_cov_3.808511	120	186	10	7	66	0.1060606
NODE_3666_length_1227_cov_3.808511	120	186	13	15	66	0.2272727
NODE_3666_length_1227_cov_3.808511	120	186	16	4	66	0.0606061
NODE_3666_length_1227_cov_3.808511	120	186	18	17	66	0.2575758
NODE_3666_length_1227_cov_3.808511	120	186	20	16	66	0.2424242
NODE_3666_length_1227_cov_3.808511	173	239	16	4	66	0.0606061
NODE_3666_length_1227_cov_3.808511	173	239	18	27	66	0.4090909
NODE_3666_length_1227_cov_3.808511	173	239	20	35	66	0.5303030
NODE_3666_length_1227_cov_3.808511	229	299	3	13	70	0.1857143
NODE_3666_length_1227_cov_3.808511	229	299	5	2	70	0.0285714
NODE_3666_length_1227_cov_3.808511	229	299	8	22	70	0.3142857
NODE_3666_length_1227_cov_3.808511	229	299	10	3	70	0.0428571
NODE_3666_length_1227_cov_3.808511	229	299	12	6	70	0.0857143
NODE_3666_length_1227_cov_3.808511	229	299	14	2	70	0.0285714
NODE_3666_length_1227_cov_3.808511	229	299	17	1	70	0.0142857
NODE_3666_length_1227_cov_3.808511	229	299	18	21	70	0.3000000
NODE_3672_length_1226_cov_23.792369	579	659	4	3	80	0.0375000
NODE_3672_length_1226_cov_23.792369	579	659	6	16	80	0.2000000
NODE_3672_length_1226_cov_23.792369	579	659	8	25	80	0.3125000
NODE_3672_length_1226_cov_23.792369	579	659	11	9	80	0.1125000
NODE_3672_length_1226_cov_23.792369	579	659	12	27	80	0.3375000
NODE_3672_length_1226_cov_23.792369	632	712	0	25	80	0.3125000
NODE_3672_length_1226_cov_23.792369	632	712	4	31	80	0.3875000
NODE_3672_length_1226_cov_23.792369	632	712	6	16	80	0.2000000
NODE_3672_length_1226_cov_23.792369	632	712	11	8	80	0.1000000
NODE_3672_length_1226_cov_23.792369	708	788	0	80	80	1.0000000
NODE_3672_length_1226_cov_23.792369	761	839	0	78	78	1.0000000
NODE_3673_length_1226_cov_5.620231	463	543	0	80	80	1.0000000
NODE_3673_length_1226_cov_5.620231	516	596	0	80	80	1.0000000
NODE_3674_length_1226_cov_4.881988	582	662	0	69	80	0.8625000
NODE_3674_length_1226_cov_4.881988	582	662	2	11	80	0.1375000
NODE_3674_length_1226_cov_4.881988	635	715	0	22	80	0.2750000
NODE_3674_length_1226_cov_4.881988	635	715	2	58	80	0.7250000
NODE_3682_length_1225_cov_55.596803	637	717	1	3	80	0.0375000
NODE_3682_length_1225_cov_55.596803	637	717	3	77	80	0.9625000
NODE_3682_length_1225_cov_55.596803	690	770	2	4	80	0.0500000
NODE_3682_length_1225_cov_55.596803	690	770	3	76	80	0.9500000
NODE_3682_length_1225_cov_55.596803	766	846	0	56	80	0.7000000
NODE_3682_length_1225_cov_55.596803	766	846	2	24	80	0.3000000
NODE_3682_length_1225_cov_55.596803	819	899	0	80	80	1.0000000
NODE_3683_length_1225_cov_35.189165	661	742	2	14	81	0.1728395
NODE_3683_length_1225_cov_35.189165	661	742	12	2	81	0.0246914
NODE_3683_length_1225_cov_35.189165	661	742	14	29	81	0.3580247
NODE_3683_length_1225_cov_35.189165	661	742	15	1	81	0.0123457
NODE_3683_length_1225_cov_35.189165	661	742	16	35	81	0.4320988
NODE_3683_length_1225_cov_35.189165	714	795	0	33	81	0.4074074
NODE_3683_length_1225_cov_35.189165	714	795	2	34	81	0.4197531
NODE_3683_length_1225_cov_35.189165	714	795	12	2	81	0.0246914
NODE_3683_length_1225_cov_35.189165	714	795	15	1	81	0.0123457
NODE_3683_length_1225_cov_35.189165	714	795	16	11	81	0.1358025
NODE_3684_length_1225_cov_33.755773	456	535	0	79	79	1.0000000
NODE_3684_length_1225_cov_33.755773	508	588	0	80	80	1.0000000
NODE_3685_length_1225_cov_30.116341	566	646	2	33	80	0.4125000
NODE_3685_length_1225_cov_30.116341	566	646	4	47	80	0.5875000
NODE_3685_length_1225_cov_30.116341	619	699	2	38	80	0.4750000
NODE_3685_length_1225_cov_30.116341	619	699	4	42	80	0.5250000
NODE_3685_length_1225_cov_30.116341	695	775	2	58	80	0.7250000
NODE_3685_length_1225_cov_30.116341	695	775	4	22	80	0.2750000
NODE_3685_length_1225_cov_30.116341	748	828	0	4	80	0.0500000
NODE_3685_length_1225_cov_30.116341	748	828	2	72	80	0.9000000
NODE_3685_length_1225_cov_30.116341	748	828	4	4	80	0.0500000
NODE_3686_length_1225_cov_29.177620	195	275	0	42	80	0.5250000
NODE_3686_length_1225_cov_29.177620	195	275	2	38	80	0.4750000
NODE_3686_length_1225_cov_29.177620	248	328	0	13	80	0.1625000
NODE_3686_length_1225_cov_29.177620	248	328	2	67	80	0.8375000
NODE_3687_length_1225_cov_26.849023	588	668	4	16	80	0.2000000
NODE_3687_length_1225_cov_26.849023	588	668	8	64	80	0.8000000
NODE_3687_length_1225_cov_26.849023	641	721	0	18	80	0.2250000
NODE_3687_length_1225_cov_26.849023	641	721	4	31	80	0.3875000
NODE_3687_length_1225_cov_26.849023	641	721	8	31	80	0.3875000
NODE_3687_length_1225_cov_26.849023	717	797	0	73	80	0.9125000
NODE_3687_length_1225_cov_26.849023	717	797	5	7	80	0.0875000
NODE_3687_length_1225_cov_26.849023	770	850	0	20	80	0.2500000
NODE_3687_length_1225_cov_26.849023	770	850	5	41	80	0.5125000
NODE_3687_length_1225_cov_26.849023	770	850	6	19	80	0.2375000
NODE_3688_length_1225_cov_24.444938	386	466	0	80	80	1.0000000
NODE_3688_length_1225_cov_24.444938	439	519	0	80	80	1.0000000
NODE_3690_length_1225_cov_19.369449	491	571	0	23	80	0.2875000
NODE_3690_length_1225_cov_19.369449	491	571	2	57	80	0.7125000
NODE_3690_length_1225_cov_19.369449	544	624	0	76	80	0.9500000
NODE_3690_length_1225_cov_19.369449	544	624	2	4	80	0.0500000
NODE_3690_length_1225_cov_19.369449	620	700	0	80	80	1.0000000
NODE_3690_length_1225_cov_19.369449	673	753	0	29	80	0.3625000
NODE_3690_length_1225_cov_19.369449	673	753	2	51	80	0.6375000
NODE_3691_length_1225_cov_13.281528	462	542	0	80	80	1.0000000
NODE_3691_length_1225_cov_13.281528	515	595	0	80	80	1.0000000
NODE_3691_length_1225_cov_13.281528	591	671	0	80	80	1.0000000
NODE_3691_length_1225_cov_13.281528	644	724	0	48	80	0.6000000
NODE_3691_length_1225_cov_13.281528	644	724	1	6	80	0.0750000
NODE_3691_length_1225_cov_13.281528	644	724	2	26	80	0.3250000
NODE_3692_length_1225_cov_10.887211	566	646	0	41	80	0.5125000
NODE_3692_length_1225_cov_10.887211	566	646	4	39	80	0.4875000
NODE_3692_length_1225_cov_10.887211	619	699	0	1	80	0.0125000
NODE_3692_length_1225_cov_10.887211	619	699	4	79	80	0.9875000
NODE_3696_length_1224_cov_24.568889	613	693	0	50	80	0.6250000
NODE_3696_length_1224_cov_24.568889	613	693	2	29	80	0.3625000
NODE_3696_length_1224_cov_24.568889	613	693	5	1	80	0.0125000
NODE_3696_length_1224_cov_24.568889	666	746	0	26	80	0.3250000
NODE_3696_length_1224_cov_24.568889	666	746	5	1	80	0.0125000
NODE_3696_length_1224_cov_24.568889	666	746	6	53	80	0.6625000
NODE_3697_length_1224_cov_17.538667	762	842	0	80	80	1.0000000
NODE_3697_length_1224_cov_17.538667	815	895	0	34	80	0.4250000
NODE_3697_length_1224_cov_17.538667	815	895	2	46	80	0.5750000
NODE_3698_length_1224_cov_14.138667	389	469	1	63	80	0.7875000
NODE_3698_length_1224_cov_14.138667	389	469	3	17	80	0.2125000
NODE_3698_length_1224_cov_14.138667	442	522	1	10	80	0.1250000
NODE_3698_length_1224_cov_14.138667	442	522	3	44	80	0.5500000
NODE_3698_length_1224_cov_14.138667	442	522	4	26	80	0.3250000
NODE_3699_length_1224_cov_11.358222	704	784	0	80	80	1.0000000
NODE_3699_length_1224_cov_11.358222	757	837	0	80	80	1.0000000
NODE_3700_length_1224_cov_6.963556	516	581	0	65	65	1.0000000
NODE_3705_length_1223_cov_44.608541	548	630	0	20	82	0.2439024
NODE_3705_length_1223_cov_44.608541	548	630	2	62	82	0.7560976
NODE_3705_length_1223_cov_44.608541	601	683	0	73	82	0.8902439
NODE_3705_length_1223_cov_44.608541	601	683	2	9	82	0.1097561
NODE_3705_length_1223_cov_44.608541	679	759	0	33	80	0.4125000
NODE_3705_length_1223_cov_44.608541	679	759	2	47	80	0.5875000
NODE_3705_length_1223_cov_44.608541	732	812	0	19	80	0.2375000
NODE_3705_length_1223_cov_44.608541	732	812	2	61	80	0.7625000
NODE_3706_length_1223_cov_26.730427	508	588	1	4	80	0.0500000
NODE_3706_length_1223_cov_26.730427	508	588	3	40	80	0.5000000
NODE_3706_length_1223_cov_26.730427	508	588	5	7	80	0.0875000
NODE_3706_length_1223_cov_26.730427	508	588	6	29	80	0.3625000
NODE_3706_length_1223_cov_26.730427	561	641	3	24	80	0.3000000
NODE_3706_length_1223_cov_26.730427	561	641	4	28	80	0.3500000
NODE_3706_length_1223_cov_26.730427	561	641	6	28	80	0.3500000
NODE_3707_length_1223_cov_18.902135	460	540	0	80	80	1.0000000
NODE_3707_length_1223_cov_18.902135	513	593	0	80	80	1.0000000
NODE_3708_length_1223_cov_6.989324	707	778	1	5	71	0.0704225
NODE_3708_length_1223_cov_6.989324	707	778	2	18	71	0.2535211
NODE_3708_length_1223_cov_6.989324	707	778	4	6	71	0.0845070
NODE_3708_length_1223_cov_6.989324	707	778	6	42	71	0.5915493
NODE_3710_length_1223_cov_5.251779	666	746	0	80	80	1.0000000
NODE_3710_length_1223_cov_5.251779	719	799	0	68	80	0.8500000
NODE_3710_length_1223_cov_5.251779	719	799	2	12	80	0.1500000
NODE_3710_length_1223_cov_5.251779	795	875	2	20	80	0.2500000
NODE_3710_length_1223_cov_5.251779	795	875	6	41	80	0.5125000
NODE_3710_length_1223_cov_5.251779	795	875	10	3	80	0.0375000
NODE_3710_length_1223_cov_5.251779	795	875	12	16	80	0.2000000
NODE_3710_length_1223_cov_5.251779	848	928	6	14	80	0.1750000
NODE_3710_length_1223_cov_5.251779	848	928	8	25	80	0.3125000
NODE_3710_length_1223_cov_5.251779	848	928	10	3	80	0.0375000
NODE_3710_length_1223_cov_5.251779	848	928	11	1	80	0.0125000
NODE_3710_length_1223_cov_5.251779	848	928	12	37	80	0.4625000
NODE_3716_length_1222_cov_18.406946	273	353	0	80	80	1.0000000
NODE_3716_length_1222_cov_18.406946	326	406	0	80	80	1.0000000
NODE_3720_length_1221_cov_33.261141	505	577	0	48	72	0.6666667
NODE_3720_length_1221_cov_33.261141	505	577	2	24	72	0.3333333
NODE_3720_length_1221_cov_33.261141	558	637	0	79	79	1.0000000
NODE_3720_length_1221_cov_33.261141	633	713	0	80	80	1.0000000
NODE_3720_length_1221_cov_33.261141	686	766	0	80	80	1.0000000
NODE_3721_length_1221_cov_19.466132	541	621	0	80	80	1.0000000
NODE_3721_length_1221_cov_19.466132	594	674	0	42	80	0.5250000
NODE_3721_length_1221_cov_19.466132	594	674	2	38	80	0.4750000
NODE_3722_length_1221_cov_15.940285	788	868	0	80	80	1.0000000
NODE_3722_length_1221_cov_15.940285	841	921	0	80	80	1.0000000
NODE_3722_length_1221_cov_15.940285	917	997	0	80	80	1.0000000
NODE_3722_length_1221_cov_15.940285	970	1050	0	80	80	1.0000000
NODE_3723_length_1221_cov_15.796791	484	564	4	80	80	1.0000000
NODE_3723_length_1221_cov_15.796791	537	617	0	39	80	0.4875000
NODE_3723_length_1221_cov_15.796791	537	617	4	41	80	0.5125000
NODE_3724_length_1221_cov_15.312834	342	415	6	39	73	0.5342466
NODE_3724_length_1221_cov_15.312834	342	415	10	34	73	0.4657534
NODE_3724_length_1221_cov_15.312834	395	474	0	27	79	0.3417721
NODE_3724_length_1221_cov_15.312834	395	474	4	5	79	0.0632911
NODE_3724_length_1221_cov_15.312834	395	474	10	47	79	0.5949367
NODE_3725_length_1221_cov_9.695187	988	1068	0	9	80	0.1125000
NODE_3725_length_1221_cov_9.695187	988	1068	1	2	80	0.0250000
NODE_3725_length_1221_cov_9.695187	988	1068	2	69	80	0.8625000
NODE_3725_length_1221_cov_9.695187	1041	1100	2	42	59	0.7118644
NODE_3725_length_1221_cov_9.695187	1041	1100	4	17	59	0.2881356
NODE_3726_length_1221_cov_9.043672	695	775	0	80	80	1.0000000
NODE_3726_length_1221_cov_9.043672	748	828	0	80	80	1.0000000
NODE_3727_length_1221_cov_7.946524	147	227	0	42	80	0.5250000
NODE_3727_length_1221_cov_7.946524	147	227	2	38	80	0.4750000
NODE_3727_length_1221_cov_7.946524	200	280	2	63	80	0.7875000
NODE_3727_length_1221_cov_7.946524	200	280	4	17	80	0.2125000
NODE_3728_length_1221_cov_5.122103	248	328	0	80	80	1.0000000
NODE_3728_length_1221_cov_5.122103	301	381	0	80	80	1.0000000
NODE_3736_length_1220_cov_44.501338	319	399	0	80	80	1.0000000
NODE_3736_length_1220_cov_44.501338	372	452	0	66	80	0.8250000
NODE_3736_length_1220_cov_44.501338	372	452	3	1	80	0.0125000
NODE_3736_length_1220_cov_44.501338	372	452	4	13	80	0.1625000
NODE_3736_length_1220_cov_44.501338	448	528	4	13	80	0.1625000
NODE_3736_length_1220_cov_44.501338	448	528	6	16	80	0.2000000
NODE_3736_length_1220_cov_44.501338	448	528	8	19	80	0.2375000
NODE_3736_length_1220_cov_44.501338	448	528	9	1	80	0.0125000
NODE_3736_length_1220_cov_44.501338	448	528	10	31	80	0.3875000
NODE_3736_length_1220_cov_44.501338	501	581	2	23	80	0.2875000
NODE_3736_length_1220_cov_44.501338	501	581	6	46	80	0.5750000
NODE_3736_length_1220_cov_44.501338	501	581	9	1	80	0.0125000
NODE_3736_length_1220_cov_44.501338	501	581	10	10	80	0.1250000
NODE_3737_length_1220_cov_43.868867	720	800	0	37	80	0.4625000
NODE_3737_length_1220_cov_43.868867	720	800	4	43	80	0.5375000
NODE_3737_length_1220_cov_43.868867	773	853	0	5	80	0.0625000
NODE_3737_length_1220_cov_43.868867	773	853	4	75	80	0.9375000
NODE_3738_length_1220_cov_41.900089	593	673	2	63	80	0.7875000
NODE_3738_length_1220_cov_41.900089	593	673	3	1	80	0.0125000
NODE_3738_length_1220_cov_41.900089	593	673	6	16	80	0.2000000
NODE_3738_length_1220_cov_41.900089	646	726	2	11	80	0.1375000
NODE_3738_length_1220_cov_41.900089	646	726	6	69	80	0.8625000
NODE_3738_length_1220_cov_41.900089	722	802	0	52	80	0.6500000
NODE_3738_length_1220_cov_41.900089	722	802	2	11	80	0.1375000
NODE_3738_length_1220_cov_41.900089	722	802	6	17	80	0.2125000
NODE_3738_length_1220_cov_41.900089	775	855	0	80	80	1.0000000
NODE_3739_length_1220_cov_15.485281	395	475	0	34	80	0.4250000
NODE_3739_length_1220_cov_15.485281	395	475	2	5	80	0.0625000
NODE_3739_length_1220_cov_15.485281	395	475	7	1	80	0.0125000
NODE_3739_length_1220_cov_15.485281	395	475	8	40	80	0.5000000
NODE_3739_length_1220_cov_15.485281	448	528	6	30	80	0.3750000
NODE_3739_length_1220_cov_15.485281	448	528	8	50	80	0.6250000
NODE_3745_length_1219_cov_30.493750	643	723	0	80	80	1.0000000
NODE_3745_length_1219_cov_30.493750	696	776	0	80	80	1.0000000
NODE_3745_length_1219_cov_30.493750	772	852	0	80	80	1.0000000
NODE_3745_length_1219_cov_30.493750	825	905	0	80	80	1.0000000
NODE_3746_length_1219_cov_24.991071	566	646	0	80	80	1.0000000
NODE_3746_length_1219_cov_24.991071	619	699	0	80	80	1.0000000
NODE_3746_length_1219_cov_24.991071	695	775	0	80	80	1.0000000
NODE_3746_length_1219_cov_24.991071	748	828	0	80	80	1.0000000
NODE_3747_length_1219_cov_24.728571	465	545	0	80	80	1.0000000
NODE_3747_length_1219_cov_24.728571	518	598	0	80	80	1.0000000
NODE_3747_length_1219_cov_24.728571	594	674	0	80	80	1.0000000
NODE_3747_length_1219_cov_24.728571	647	727	0	80	80	1.0000000
NODE_3748_length_1219_cov_11.130357	535	615	0	80	80	1.0000000
NODE_3748_length_1219_cov_11.130357	588	668	0	80	80	1.0000000
NODE_3749_length_1219_cov_9.696429	734	814	0	80	80	1.0000000
NODE_3749_length_1219_cov_9.696429	787	867	0	80	80	1.0000000
NODE_3754_length_1218_cov_40.159071	554	634	0	80	80	1.0000000
NODE_3754_length_1218_cov_40.159071	607	687	0	80	80	1.0000000
NODE_3754_length_1218_cov_40.159071	683	763	0	80	80	1.0000000
NODE_3754_length_1218_cov_40.159071	736	816	0	27	80	0.3375000
NODE_3754_length_1218_cov_40.159071	736	816	2	53	80	0.6625000
NODE_3765_length_1216_cov_99.538944	44	124	188	1	80	0.0125000
NODE_3765_length_1216_cov_99.538944	44	124	191	1	80	0.0125000
NODE_3765_length_1216_cov_99.538944	44	124	197	1	80	0.0125000
NODE_3765_length_1216_cov_99.538944	44	124	202	1	80	0.0125000
NODE_3765_length_1216_cov_99.538944	44	124	208	2	80	0.0250000
NODE_3765_length_1216_cov_99.538944	44	124	215	2	80	0.0250000
NODE_3765_length_1216_cov_99.538944	44	124	219	1	80	0.0125000
NODE_3765_length_1216_cov_99.538944	44	124	221	1	80	0.0125000
NODE_3765_length_1216_cov_99.538944	44	124	237	1	80	0.0125000
NODE_3765_length_1216_cov_99.538944	44	124	243	1	80	0.0125000
NODE_3765_length_1216_cov_99.538944	44	124	245	1	80	0.0125000
NODE_3765_length_1216_cov_99.538944	44	124	247	1	80	0.0125000
NODE_3765_length_1216_cov_99.538944	44	124	251	1	80	0.0125000
NODE_3765_length_1216_cov_99.538944	44	124	255	1	80	0.0125000
NODE_3765_length_1216_cov_99.538944	44	124	265	1	80	0.0125000
NODE_3765_length_1216_cov_99.538944	44	124	267	2	80	0.0250000
NODE_3765_length_1216_cov_99.538944	44	124	270	1	80	0.0125000
NODE_3765_length_1216_cov_99.538944	44	124	271	1	80	0.0125000
NODE_3765_length_1216_cov_99.538944	44	124	272	1	80	0.0125000
NODE_3765_length_1216_cov_99.538944	44	124	279	1	80	0.0125000
NODE_3765_length_1216_cov_99.538944	44	124	287	1	80	0.0125000
NODE_3765_length_1216_cov_99.538944	44	124	289	1	80	0.0125000
NODE_3765_length_1216_cov_99.538944	44	124	300	1	80	0.0125000
NODE_3765_length_1216_cov_99.538944	44	124	304	2	80	0.0250000
NODE_3765_length_1216_cov_99.538944	44	124	315	1	80	0.0125000
NODE_3765_length_1216_cov_99.538944	44	124	319	1	80	0.0125000
NODE_3765_length_1216_cov_99.538944	44	124	326	1	80	0.0125000
NODE_3765_length_1216_cov_99.538944	44	124	328	2	80	0.0250000
NODE_3765_length_1216_cov_99.538944	44	124	330	1	80	0.0125000
NODE_3765_length_1216_cov_99.538944	44	124	336	3	80	0.0375000
NODE_3765_length_1216_cov_99.538944	44	124	342	1	80	0.0125000
NODE_3765_length_1216_cov_99.538944	44	124	350	1	80	0.0125000
NODE_3765_length_1216_cov_99.538944	44	124	361	2	80	0.0250000
NODE_3765_length_1216_cov_99.538944	44	124	363	1	80	0.0125000
NODE_3765_length_1216_cov_99.538944	44	124	368	1	80	0.0125000
NODE_3765_length_1216_cov_99.538944	44	124	370	1	80	0.0125000
NODE_3765_length_1216_cov_99.538944	44	124	371	1	80	0.0125000
NODE_3765_length_1216_cov_99.538944	44	124	375	1	80	0.0125000
NODE_3765_length_1216_cov_99.538944	44	124	379	1	80	0.0125000
NODE_3765_length_1216_cov_99.538944	44	124	387	1	80	0.0125000
NODE_3765_length_1216_cov_99.538944	44	124	391	4	80	0.0500000
NODE_3765_length_1216_cov_99.538944	44	124	397	1	80	0.0125000
NODE_3765_length_1216_cov_99.538944	44	124	402	1	80	0.0125000
NODE_3765_length_1216_cov_99.538944	44	124	410	1	80	0.0125000
NODE_3765_length_1216_cov_99.538944	44	124	415	1	80	0.0125000
NODE_3765_length_1216_cov_99.538944	44	124	417	1	80	0.0125000
NODE_3765_length_1216_cov_99.538944	44	124	419	1	80	0.0125000
NODE_3765_length_1216_cov_99.538944	44	124	420	2	80	0.0250000
NODE_3765_length_1216_cov_99.538944	44	124	425	3	80	0.0375000
NODE_3765_length_1216_cov_99.538944	44	124	426	1	80	0.0125000
NODE_3765_length_1216_cov_99.538944	44	124	427	4	80	0.0500000
NODE_3765_length_1216_cov_99.538944	44	124	428	2	80	0.0250000
NODE_3765_length_1216_cov_99.538944	44	124	429	2	80	0.0250000
NODE_3765_length_1216_cov_99.538944	44	124	430	1	80	0.0125000
NODE_3765_length_1216_cov_99.538944	44	124	431	3	80	0.0375000
NODE_3765_length_1216_cov_99.538944	44	124	432	3	80	0.0375000
NODE_3765_length_1216_cov_99.538944	44	124	434	1	80	0.0125000
NODE_3765_length_1216_cov_99.538944	97	157	402	1	60	0.0166667
NODE_3765_length_1216_cov_99.538944	97	157	410	1	60	0.0166667
NODE_3765_length_1216_cov_99.538944	97	157	411	1	60	0.0166667
NODE_3765_length_1216_cov_99.538944	97	157	415	1	60	0.0166667
NODE_3765_length_1216_cov_99.538944	97	157	417	2	60	0.0333333
NODE_3765_length_1216_cov_99.538944	97	157	419	2	60	0.0333333
NODE_3765_length_1216_cov_99.538944	97	157	420	2	60	0.0333333
NODE_3765_length_1216_cov_99.538944	97	157	421	1	60	0.0166667
NODE_3765_length_1216_cov_99.538944	97	157	422	1	60	0.0166667
NODE_3765_length_1216_cov_99.538944	97	157	424	1	60	0.0166667
NODE_3765_length_1216_cov_99.538944	97	157	425	3	60	0.0500000
NODE_3765_length_1216_cov_99.538944	97	157	426	1	60	0.0166667
NODE_3765_length_1216_cov_99.538944	97	157	427	4	60	0.0666667
NODE_3765_length_1216_cov_99.538944	97	157	428	3	60	0.0500000
NODE_3765_length_1216_cov_99.538944	97	157	429	5	60	0.0833333
NODE_3765_length_1216_cov_99.538944	97	157	430	2	60	0.0333333
NODE_3765_length_1216_cov_99.538944	97	157	431	3	60	0.0500000
NODE_3765_length_1216_cov_99.538944	97	157	432	4	60	0.0666667
NODE_3765_length_1216_cov_99.538944	97	157	434	2	60	0.0333333
NODE_3765_length_1216_cov_99.538944	97	157	435	1	60	0.0166667
NODE_3765_length_1216_cov_99.538944	97	157	437	1	60	0.0166667
NODE_3765_length_1216_cov_99.538944	97	157	438	4	60	0.0666667
NODE_3765_length_1216_cov_99.538944	97	157	440	3	60	0.0500000
NODE_3765_length_1216_cov_99.538944	97	157	442	5	60	0.0833333
NODE_3765_length_1216_cov_99.538944	97	157	444	1	60	0.0166667
NODE_3765_length_1216_cov_99.538944	97	157	446	3	60	0.0500000
NODE_3765_length_1216_cov_99.538944	97	157	447	2	60	0.0333333
NODE_3765_length_1216_cov_99.538944	824	903	170	2	79	0.0253165
NODE_3765_length_1216_cov_99.538944	824	903	171	2	79	0.0253165
NODE_3765_length_1216_cov_99.538944	824	903	172	3	79	0.0379747
NODE_3765_length_1216_cov_99.538944	824	903	173	5	79	0.0632911
NODE_3765_length_1216_cov_99.538944	824	903	175	4	79	0.0506329
NODE_3765_length_1216_cov_99.538944	824	903	177	3	79	0.0379747
NODE_3765_length_1216_cov_99.538944	824	903	179	1	79	0.0126582
NODE_3765_length_1216_cov_99.538944	824	903	183	2	79	0.0253165
NODE_3765_length_1216_cov_99.538944	824	903	186	1	79	0.0126582
NODE_3765_length_1216_cov_99.538944	824	903	187	1	79	0.0126582
NODE_3765_length_1216_cov_99.538944	824	903	189	2	79	0.0253165
NODE_3765_length_1216_cov_99.538944	824	903	191	1	79	0.0126582
NODE_3765_length_1216_cov_99.538944	824	903	192	2	79	0.0253165
NODE_3765_length_1216_cov_99.538944	824	903	197	1	79	0.0126582
NODE_3765_length_1216_cov_99.538944	824	903	199	2	79	0.0253165
NODE_3765_length_1216_cov_99.538944	824	903	203	1	79	0.0126582
NODE_3765_length_1216_cov_99.538944	824	903	205	1	79	0.0126582
NODE_3765_length_1216_cov_99.538944	824	903	207	1	79	0.0126582
NODE_3765_length_1216_cov_99.538944	824	903	209	2	79	0.0253165
NODE_3765_length_1216_cov_99.538944	824	903	211	1	79	0.0126582
NODE_3765_length_1216_cov_99.538944	824	903	217	1	79	0.0126582
NODE_3765_length_1216_cov_99.538944	824	903	218	1	79	0.0126582
NODE_3765_length_1216_cov_99.538944	824	903	222	1	79	0.0126582
NODE_3765_length_1216_cov_99.538944	824	903	223	1	79	0.0126582
NODE_3765_length_1216_cov_99.538944	824	903	224	4	79	0.0506329
NODE_3765_length_1216_cov_99.538944	824	903	225	1	79	0.0126582
NODE_3765_length_1216_cov_99.538944	824	903	226	2	79	0.0253165
NODE_3765_length_1216_cov_99.538944	824	903	228	3	79	0.0379747
NODE_3765_length_1216_cov_99.538944	824	903	230	4	79	0.0506329
NODE_3765_length_1216_cov_99.538944	824	903	234	1	79	0.0126582
NODE_3765_length_1216_cov_99.538944	824	903	236	4	79	0.0506329
NODE_3765_length_1216_cov_99.538944	824	903	237	4	79	0.0506329
NODE_3765_length_1216_cov_99.538944	824	903	238	4	79	0.0506329
NODE_3765_length_1216_cov_99.538944	824	903	240	6	79	0.0759494
NODE_3765_length_1216_cov_99.538944	824	903	241	2	79	0.0253165
NODE_3765_length_1216_cov_99.538944	824	903	242	1	79	0.0126582
NODE_3765_length_1216_cov_99.538944	824	903	243	1	79	0.0126582
NODE_3766_length_1216_cov_15.855864	668	748	0	80	80	1.0000000
NODE_3766_length_1216_cov_15.855864	721	801	0	80	80	1.0000000
NODE_3767_length_1216_cov_4.128917	720	800	0	80	80	1.0000000
NODE_3767_length_1216_cov_4.128917	773	853	0	80	80	1.0000000
NODE_3774_length_1215_cov_32.293011	411	491	18	2	80	0.0250000
NODE_3774_length_1215_cov_32.293011	411	491	24	57	80	0.7125000
NODE_3774_length_1215_cov_32.293011	411	491	26	21	80	0.2625000
NODE_3774_length_1215_cov_32.293011	464	544	15	6	80	0.0750000
NODE_3774_length_1215_cov_32.293011	464	544	16	22	80	0.2750000
NODE_3774_length_1215_cov_32.293011	464	544	17	20	80	0.2500000
NODE_3774_length_1215_cov_32.293011	464	544	18	7	80	0.0875000
NODE_3774_length_1215_cov_32.293011	464	544	24	25	80	0.3125000
NODE_3775_length_1215_cov_24.177419	729	809	0	17	80	0.2125000
NODE_3775_length_1215_cov_24.177419	729	809	2	63	80	0.7875000
NODE_3775_length_1215_cov_24.177419	782	862	2	47	80	0.5875000
NODE_3775_length_1215_cov_24.177419	782	862	4	33	80	0.4125000
NODE_3776_length_1215_cov_21.566308	645	725	0	80	80	1.0000000
NODE_3776_length_1215_cov_21.566308	698	778	0	80	80	1.0000000
NODE_3777_length_1215_cov_19.278674	630	710	0	13	80	0.1625000
NODE_3777_length_1215_cov_19.278674	630	710	6	67	80	0.8375000
NODE_3777_length_1215_cov_19.278674	683	763	0	66	80	0.8250000
NODE_3777_length_1215_cov_19.278674	683	763	6	14	80	0.1750000
NODE_3778_length_1215_cov_15.074373	664	744	0	33	80	0.4125000
NODE_3778_length_1215_cov_15.074373	664	744	2	47	80	0.5875000
NODE_3778_length_1215_cov_15.074373	717	797	0	80	80	1.0000000
NODE_3779_length_1215_cov_5.932796	507	587	0	80	80	1.0000000
NODE_3779_length_1215_cov_5.932796	560	640	0	80	80	1.0000000
NODE_3787_length_1214_cov_26.771300	420	500	57	2	80	0.0250000
NODE_3787_length_1214_cov_26.771300	420	500	61	3	80	0.0375000
NODE_3787_length_1214_cov_26.771300	420	500	66	2	80	0.0250000
NODE_3787_length_1214_cov_26.771300	420	500	67	1	80	0.0125000
NODE_3787_length_1214_cov_26.771300	420	500	77	1	80	0.0125000
NODE_3787_length_1214_cov_26.771300	420	500	94	1	80	0.0125000
NODE_3787_length_1214_cov_26.771300	420	500	103	1	80	0.0125000
NODE_3787_length_1214_cov_26.771300	420	500	106	1	80	0.0125000
NODE_3787_length_1214_cov_26.771300	420	500	110	3	80	0.0375000
NODE_3787_length_1214_cov_26.771300	420	500	113	1	80	0.0125000
NODE_3787_length_1214_cov_26.771300	420	500	123	1	80	0.0125000
NODE_3787_length_1214_cov_26.771300	420	500	129	1	80	0.0125000
NODE_3787_length_1214_cov_26.771300	420	500	136	1	80	0.0125000
NODE_3787_length_1214_cov_26.771300	420	500	143	5	80	0.0625000
NODE_3787_length_1214_cov_26.771300	420	500	147	1	80	0.0125000
NODE_3787_length_1214_cov_26.771300	420	500	157	3	80	0.0375000
NODE_3787_length_1214_cov_26.771300	420	500	158	1	80	0.0125000
NODE_3787_length_1214_cov_26.771300	420	500	159	1	80	0.0125000
NODE_3787_length_1214_cov_26.771300	420	500	167	1	80	0.0125000
NODE_3787_length_1214_cov_26.771300	420	500	169	1	80	0.0125000
NODE_3787_length_1214_cov_26.771300	420	500	171	2	80	0.0250000
NODE_3787_length_1214_cov_26.771300	420	500	174	4	80	0.0500000
NODE_3787_length_1214_cov_26.771300	420	500	178	1	80	0.0125000
NODE_3787_length_1214_cov_26.771300	420	500	180	2	80	0.0250000
NODE_3787_length_1214_cov_26.771300	420	500	182	4	80	0.0500000
NODE_3787_length_1214_cov_26.771300	420	500	186	2	80	0.0250000
NODE_3787_length_1214_cov_26.771300	420	500	188	1	80	0.0125000
NODE_3787_length_1214_cov_26.771300	420	500	192	1	80	0.0125000
NODE_3787_length_1214_cov_26.771300	420	500	196	1	80	0.0125000
NODE_3787_length_1214_cov_26.771300	420	500	197	2	80	0.0250000
NODE_3787_length_1214_cov_26.771300	420	500	198	4	80	0.0500000
NODE_3787_length_1214_cov_26.771300	420	500	200	6	80	0.0750000
NODE_3787_length_1214_cov_26.771300	420	500	202	6	80	0.0750000
NODE_3787_length_1214_cov_26.771300	420	500	204	12	80	0.1500000
NODE_3787_length_1214_cov_26.771300	473	553	35	1	80	0.0125000
NODE_3787_length_1214_cov_26.771300	473	553	64	1	80	0.0125000
NODE_3787_length_1214_cov_26.771300	473	553	72	3	80	0.0375000
NODE_3787_length_1214_cov_26.771300	473	553	78	2	80	0.0250000
NODE_3787_length_1214_cov_26.771300	473	553	82	2	80	0.0250000
NODE_3787_length_1214_cov_26.771300	473	553	84	3	80	0.0375000
NODE_3787_length_1214_cov_26.771300	473	553	88	1	80	0.0125000
NODE_3787_length_1214_cov_26.771300	473	553	90	4	80	0.0500000
NODE_3787_length_1214_cov_26.771300	473	553	96	1	80	0.0125000
NODE_3787_length_1214_cov_26.771300	473	553	98	1	80	0.0125000
NODE_3787_length_1214_cov_26.771300	473	553	108	1	80	0.0125000
NODE_3787_length_1214_cov_26.771300	473	553	116	2	80	0.0250000
NODE_3787_length_1214_cov_26.771300	473	553	117	1	80	0.0125000
NODE_3787_length_1214_cov_26.771300	473	553	121	2	80	0.0250000
NODE_3787_length_1214_cov_26.771300	473	553	139	1	80	0.0125000
NODE_3787_length_1214_cov_26.771300	473	553	148	3	80	0.0375000
NODE_3787_length_1214_cov_26.771300	473	553	150	1	80	0.0125000
NODE_3787_length_1214_cov_26.771300	473	553	157	1	80	0.0125000
NODE_3787_length_1214_cov_26.771300	473	553	159	2	80	0.0250000
NODE_3787_length_1214_cov_26.771300	473	553	164	1	80	0.0125000
NODE_3787_length_1214_cov_26.771300	473	553	166	1	80	0.0125000
NODE_3787_length_1214_cov_26.771300	473	553	174	1	80	0.0125000
NODE_3787_length_1214_cov_26.771300	473	553	180	4	80	0.0500000
NODE_3787_length_1214_cov_26.771300	473	553	181	1	80	0.0125000
NODE_3787_length_1214_cov_26.771300	473	553	183	4	80	0.0500000
NODE_3787_length_1214_cov_26.771300	473	553	185	1	80	0.0125000
NODE_3787_length_1214_cov_26.771300	473	553	190	3	80	0.0375000
NODE_3787_length_1214_cov_26.771300	473	553	192	2	80	0.0250000
NODE_3787_length_1214_cov_26.771300	473	553	193	1	80	0.0125000
NODE_3787_length_1214_cov_26.771300	473	553	198	5	80	0.0625000
NODE_3787_length_1214_cov_26.771300	473	553	200	5	80	0.0625000
NODE_3787_length_1214_cov_26.771300	473	553	202	6	80	0.0750000
NODE_3787_length_1214_cov_26.771300	473	553	204	12	80	0.1500000
NODE_3788_length_1214_cov_24.555157	480	560	0	76	80	0.9500000
NODE_3788_length_1214_cov_24.555157	480	560	2	4	80	0.0500000
NODE_3788_length_1214_cov_24.555157	533	613	0	23	80	0.2875000
NODE_3788_length_1214_cov_24.555157	533	613	2	57	80	0.7125000
NODE_3789_length_1214_cov_23.167713	623	703	0	33	80	0.4125000
NODE_3789_length_1214_cov_23.167713	623	703	4	15	80	0.1875000
NODE_3789_length_1214_cov_23.167713	623	703	8	32	80	0.4000000
NODE_3789_length_1214_cov_23.167713	676	756	0	64	80	0.8000000
NODE_3789_length_1214_cov_23.167713	676	756	2	16	80	0.2000000
NODE_3790_length_1214_cov_18.452915	555	635	0	80	80	1.0000000
NODE_3790_length_1214_cov_18.452915	608	688	0	80	80	1.0000000
NODE_3790_length_1214_cov_18.452915	684	764	0	80	80	1.0000000
NODE_3790_length_1214_cov_18.452915	737	817	0	80	80	1.0000000
NODE_3791_length_1214_cov_8.906726	206	286	0	80	80	1.0000000
NODE_3791_length_1214_cov_8.906726	259	339	0	80	80	1.0000000
NODE_3792_length_1214_cov_3.686996	415	495	0	80	80	1.0000000
NODE_3792_length_1214_cov_3.686996	468	548	0	80	80	1.0000000
NODE_3799_length_1214_cov_0.967713	1049	1129	167	1	80	0.0125000
NODE_3799_length_1214_cov_0.967713	1049	1129	173	1	80	0.0125000
NODE_3799_length_1214_cov_0.967713	1049	1129	178	1	80	0.0125000
NODE_3799_length_1214_cov_0.967713	1049	1129	188	1	80	0.0125000
NODE_3799_length_1214_cov_0.967713	1049	1129	205	1	80	0.0125000
NODE_3799_length_1214_cov_0.967713	1049	1129	218	1	80	0.0125000
NODE_3799_length_1214_cov_0.967713	1049	1129	221	1	80	0.0125000
NODE_3799_length_1214_cov_0.967713	1049	1129	223	1	80	0.0125000
NODE_3799_length_1214_cov_0.967713	1049	1129	251	1	80	0.0125000
NODE_3799_length_1214_cov_0.967713	1049	1129	260	1	80	0.0125000
NODE_3799_length_1214_cov_0.967713	1049	1129	265	1	80	0.0125000
NODE_3799_length_1214_cov_0.967713	1049	1129	274	1	80	0.0125000
NODE_3799_length_1214_cov_0.967713	1049	1129	294	1	80	0.0125000
NODE_3799_length_1214_cov_0.967713	1049	1129	314	1	80	0.0125000
NODE_3799_length_1214_cov_0.967713	1049	1129	320	1	80	0.0125000
NODE_3799_length_1214_cov_0.967713	1049	1129	325	1	80	0.0125000
NODE_3799_length_1214_cov_0.967713	1049	1129	326	2	80	0.0250000
NODE_3799_length_1214_cov_0.967713	1049	1129	327	3	80	0.0375000
NODE_3799_length_1214_cov_0.967713	1049	1129	328	1	80	0.0125000
NODE_3799_length_1214_cov_0.967713	1049	1129	331	2	80	0.0250000
NODE_3799_length_1214_cov_0.967713	1049	1129	332	4	80	0.0500000
NODE_3799_length_1214_cov_0.967713	1049	1129	333	2	80	0.0250000
NODE_3799_length_1214_cov_0.967713	1049	1129	334	2	80	0.0250000
NODE_3799_length_1214_cov_0.967713	1049	1129	339	3	80	0.0375000
NODE_3799_length_1214_cov_0.967713	1049	1129	341	1	80	0.0125000
NODE_3799_length_1214_cov_0.967713	1049	1129	346	1	80	0.0125000
NODE_3799_length_1214_cov_0.967713	1049	1129	348	2	80	0.0250000
NODE_3799_length_1214_cov_0.967713	1049	1129	350	3	80	0.0375000
NODE_3799_length_1214_cov_0.967713	1049	1129	352	4	80	0.0500000
NODE_3799_length_1214_cov_0.967713	1049	1129	358	2	80	0.0250000
NODE_3799_length_1214_cov_0.967713	1049	1129	361	6	80	0.0750000
NODE_3799_length_1214_cov_0.967713	1049	1129	362	3	80	0.0375000
NODE_3799_length_1214_cov_0.967713	1049	1129	364	3	80	0.0375000
NODE_3799_length_1214_cov_0.967713	1049	1129	368	1	80	0.0125000
NODE_3799_length_1214_cov_0.967713	1049	1129	369	1	80	0.0125000
NODE_3799_length_1214_cov_0.967713	1049	1129	371	1	80	0.0125000
NODE_3799_length_1214_cov_0.967713	1049	1129	373	1	80	0.0125000
NODE_3799_length_1214_cov_0.967713	1049	1129	375	1	80	0.0125000
NODE_3799_length_1214_cov_0.967713	1049	1129	377	1	80	0.0125000
NODE_3799_length_1214_cov_0.967713	1049	1129	381	4	80	0.0500000
NODE_3799_length_1214_cov_0.967713	1049	1129	383	9	80	0.1125000
NODE_3799_length_1214_cov_0.967713	1049	1129	385	1	80	0.0125000
NODE_3800_length_1213_cov_19.524237	499	579	0	80	80	1.0000000
NODE_3800_length_1213_cov_19.524237	552	632	0	80	80	1.0000000
NODE_3806_length_1212_cov_32.663073	688	768	0	80	80	1.0000000
NODE_3806_length_1212_cov_32.663073	741	821	0	80	80	1.0000000
NODE_3807_length_1212_cov_15.981132	33	113	14	2	80	0.0250000
NODE_3807_length_1212_cov_15.981132	33	113	16	3	80	0.0375000
NODE_3807_length_1212_cov_15.981132	33	113	18	5	80	0.0625000
NODE_3807_length_1212_cov_15.981132	33	113	20	10	80	0.1250000
NODE_3807_length_1212_cov_15.981132	33	113	22	60	80	0.7500000
NODE_3807_length_1212_cov_15.981132	511	591	0	80	80	1.0000000
NODE_3807_length_1212_cov_15.981132	564	637	0	73	73	1.0000000
NODE_3813_length_1211_cov_30.513489	561	641	0	80	80	1.0000000
NODE_3813_length_1211_cov_30.513489	614	694	0	80	80	1.0000000
NODE_3813_length_1211_cov_30.513489	690	770	0	5	80	0.0625000
NODE_3813_length_1211_cov_30.513489	690	770	2	75	80	0.9375000
NODE_3813_length_1211_cov_30.513489	743	823	0	51	80	0.6375000
NODE_3813_length_1211_cov_30.513489	743	823	2	29	80	0.3625000
NODE_3815_length_1211_cov_10.073741	380	460	0	80	80	1.0000000
NODE_3815_length_1211_cov_10.073741	433	513	0	80	80	1.0000000
NODE_3816_length_1211_cov_7.561151	598	678	0	38	80	0.4750000
NODE_3816_length_1211_cov_7.561151	598	678	4	42	80	0.5250000
NODE_3816_length_1211_cov_7.561151	651	731	0	39	80	0.4875000
NODE_3816_length_1211_cov_7.561151	651	731	2	41	80	0.5125000
NODE_3820_length_1210_cov_49.743474	398	478	0	66	80	0.8250000
NODE_3820_length_1210_cov_49.743474	398	478	2	14	80	0.1750000
NODE_3820_length_1210_cov_49.743474	451	531	0	31	80	0.3875000
NODE_3820_length_1210_cov_49.743474	451	531	2	49	80	0.6125000
NODE_3821_length_1210_cov_15.647165	647	727	0	15	80	0.1875000
NODE_3821_length_1210_cov_15.647165	647	727	2	65	80	0.8125000
NODE_3821_length_1210_cov_15.647165	700	780	0	65	80	0.8125000
NODE_3821_length_1210_cov_15.647165	700	780	2	15	80	0.1875000
NODE_3822_length_1210_cov_11.194419	794	874	0	80	80	1.0000000
NODE_3822_length_1210_cov_11.194419	847	927	0	80	80	1.0000000
NODE_3826_length_1209_cov_24.504505	582	662	4	15	80	0.1875000
NODE_3826_length_1209_cov_24.504505	582	662	6	65	80	0.8125000
NODE_3826_length_1209_cov_24.504505	635	715	0	19	80	0.2375000
NODE_3826_length_1209_cov_24.504505	635	715	2	2	80	0.0250000
NODE_3826_length_1209_cov_24.504505	635	715	4	47	80	0.5875000
NODE_3826_length_1209_cov_24.504505	635	715	6	12	80	0.1500000
NODE_3826_length_1209_cov_24.504505	711	791	0	80	80	1.0000000
NODE_3826_length_1209_cov_24.504505	764	844	0	80	80	1.0000000
NODE_3827_length_1209_cov_21.846847	520	600	0	80	80	1.0000000
NODE_3827_length_1209_cov_21.846847	573	653	0	80	80	1.0000000
NODE_3827_length_1209_cov_21.846847	649	729	0	80	80	1.0000000
NODE_3827_length_1209_cov_21.846847	702	782	0	80	80	1.0000000
NODE_3828_length_1209_cov_9.026126	782	862	2	80	80	1.0000000
NODE_3828_length_1209_cov_9.026126	835	915	0	10	80	0.1250000
NODE_3828_length_1209_cov_9.026126	835	915	1	17	80	0.2125000
NODE_3828_length_1209_cov_9.026126	835	915	2	53	80	0.6625000
NODE_3830_length_1209_cov_5.721622	926	1006	2	58	80	0.7250000
NODE_3830_length_1209_cov_5.721622	926	1006	4	22	80	0.2750000
NODE_3830_length_1209_cov_5.721622	979	1059	2	58	80	0.7250000
NODE_3830_length_1209_cov_5.721622	979	1059	4	22	80	0.2750000
NODE_3833_length_1208_cov_40.717764	886	966	111	1	80	0.0125000
NODE_3833_length_1208_cov_40.717764	886	966	112	2	80	0.0250000
NODE_3833_length_1208_cov_40.717764	886	966	113	1	80	0.0125000
NODE_3833_length_1208_cov_40.717764	886	966	115	3	80	0.0375000
NODE_3833_length_1208_cov_40.717764	886	966	119	1	80	0.0125000
NODE_3833_length_1208_cov_40.717764	886	966	123	1	80	0.0125000
NODE_3833_length_1208_cov_40.717764	886	966	126	2	80	0.0250000
NODE_3833_length_1208_cov_40.717764	886	966	127	1	80	0.0125000
NODE_3833_length_1208_cov_40.717764	886	966	128	1	80	0.0125000
NODE_3833_length_1208_cov_40.717764	886	966	132	2	80	0.0250000
NODE_3833_length_1208_cov_40.717764	886	966	133	2	80	0.0250000
NODE_3833_length_1208_cov_40.717764	886	966	134	1	80	0.0125000
NODE_3833_length_1208_cov_40.717764	886	966	135	1	80	0.0125000
NODE_3833_length_1208_cov_40.717764	886	966	136	2	80	0.0250000
NODE_3833_length_1208_cov_40.717764	886	966	138	3	80	0.0375000
NODE_3833_length_1208_cov_40.717764	886	966	139	1	80	0.0125000
NODE_3833_length_1208_cov_40.717764	886	966	140	2	80	0.0250000
NODE_3833_length_1208_cov_40.717764	886	966	142	1	80	0.0125000
NODE_3833_length_1208_cov_40.717764	886	966	143	3	80	0.0375000
NODE_3833_length_1208_cov_40.717764	886	966	144	1	80	0.0125000
NODE_3833_length_1208_cov_40.717764	886	966	147	1	80	0.0125000
NODE_3833_length_1208_cov_40.717764	886	966	154	4	80	0.0500000
NODE_3833_length_1208_cov_40.717764	886	966	156	1	80	0.0125000
NODE_3833_length_1208_cov_40.717764	886	966	160	1	80	0.0125000
NODE_3833_length_1208_cov_40.717764	886	966	162	1	80	0.0125000
NODE_3833_length_1208_cov_40.717764	886	966	163	1	80	0.0125000
NODE_3833_length_1208_cov_40.717764	886	966	166	1	80	0.0125000
NODE_3833_length_1208_cov_40.717764	886	966	167	1	80	0.0125000
NODE_3833_length_1208_cov_40.717764	886	966	168	2	80	0.0250000
NODE_3833_length_1208_cov_40.717764	886	966	169	1	80	0.0125000
NODE_3833_length_1208_cov_40.717764	886	966	170	1	80	0.0125000
NODE_3833_length_1208_cov_40.717764	886	966	176	2	80	0.0250000
NODE_3833_length_1208_cov_40.717764	886	966	177	2	80	0.0250000
NODE_3833_length_1208_cov_40.717764	886	966	179	1	80	0.0125000
NODE_3833_length_1208_cov_40.717764	886	966	180	1	80	0.0125000
NODE_3833_length_1208_cov_40.717764	886	966	195	1	80	0.0125000
NODE_3833_length_1208_cov_40.717764	886	966	205	1	80	0.0125000
NODE_3833_length_1208_cov_40.717764	886	966	218	1	80	0.0125000
NODE_3833_length_1208_cov_40.717764	886	966	227	1	80	0.0125000
NODE_3833_length_1208_cov_40.717764	886	966	233	1	80	0.0125000
NODE_3833_length_1208_cov_40.717764	886	966	239	1	80	0.0125000
NODE_3833_length_1208_cov_40.717764	886	966	248	1	80	0.0125000
NODE_3833_length_1208_cov_40.717764	886	966	253	1	80	0.0125000
NODE_3833_length_1208_cov_40.717764	886	966	260	1	80	0.0125000
NODE_3833_length_1208_cov_40.717764	886	966	265	1	80	0.0125000
NODE_3833_length_1208_cov_40.717764	886	966	269	1	80	0.0125000
NODE_3833_length_1208_cov_40.717764	886	966	275	1	80	0.0125000
NODE_3833_length_1208_cov_40.717764	886	966	282	1	80	0.0125000
NODE_3833_length_1208_cov_40.717764	886	966	284	1	80	0.0125000
NODE_3833_length_1208_cov_40.717764	886	966	296	1	80	0.0125000
NODE_3833_length_1208_cov_40.717764	886	966	300	1	80	0.0125000
NODE_3833_length_1208_cov_40.717764	886	966	306	1	80	0.0125000
NODE_3833_length_1208_cov_40.717764	886	966	307	1	80	0.0125000
NODE_3833_length_1208_cov_40.717764	886	966	315	1	80	0.0125000
NODE_3833_length_1208_cov_40.717764	886	966	325	1	80	0.0125000
NODE_3833_length_1208_cov_40.717764	886	966	332	1	80	0.0125000
NODE_3833_length_1208_cov_40.717764	886	966	336	1	80	0.0125000
NODE_3833_length_1208_cov_40.717764	886	966	349	1	80	0.0125000
NODE_3833_length_1208_cov_40.717764	886	966	352	1	80	0.0125000
NODE_3833_length_1208_cov_40.717764	886	966	357	1	80	0.0125000
NODE_3833_length_1208_cov_40.717764	886	966	376	1	80	0.0125000
NODE_3833_length_1208_cov_40.717764	886	966	387	1	80	0.0125000
NODE_3833_length_1208_cov_40.717764	939	985	195	1	46	0.0217391
NODE_3833_length_1208_cov_40.717764	939	985	205	1	46	0.0217391
NODE_3833_length_1208_cov_40.717764	939	985	218	1	46	0.0217391
NODE_3833_length_1208_cov_40.717764	939	985	227	1	46	0.0217391
NODE_3833_length_1208_cov_40.717764	939	985	233	1	46	0.0217391
NODE_3833_length_1208_cov_40.717764	939	985	239	1	46	0.0217391
NODE_3833_length_1208_cov_40.717764	939	985	248	1	46	0.0217391
NODE_3833_length_1208_cov_40.717764	939	985	253	1	46	0.0217391
NODE_3833_length_1208_cov_40.717764	939	985	260	1	46	0.0217391
NODE_3833_length_1208_cov_40.717764	939	985	265	1	46	0.0217391
NODE_3833_length_1208_cov_40.717764	939	985	269	1	46	0.0217391
NODE_3833_length_1208_cov_40.717764	939	985	275	1	46	0.0217391
NODE_3833_length_1208_cov_40.717764	939	985	282	1	46	0.0217391
NODE_3833_length_1208_cov_40.717764	939	985	284	1	46	0.0217391
NODE_3833_length_1208_cov_40.717764	939	985	296	1	46	0.0217391
NODE_3833_length_1208_cov_40.717764	939	985	300	1	46	0.0217391
NODE_3833_length_1208_cov_40.717764	939	985	306	1	46	0.0217391
NODE_3833_length_1208_cov_40.717764	939	985	307	1	46	0.0217391
NODE_3833_length_1208_cov_40.717764	939	985	315	1	46	0.0217391
NODE_3833_length_1208_cov_40.717764	939	985	325	1	46	0.0217391
NODE_3833_length_1208_cov_40.717764	939	985	332	1	46	0.0217391
NODE_3833_length_1208_cov_40.717764	939	985	336	1	46	0.0217391
NODE_3833_length_1208_cov_40.717764	939	985	349	1	46	0.0217391
NODE_3833_length_1208_cov_40.717764	939	985	352	1	46	0.0217391
NODE_3833_length_1208_cov_40.717764	939	985	357	1	46	0.0217391
NODE_3833_length_1208_cov_40.717764	939	985	376	1	46	0.0217391
NODE_3833_length_1208_cov_40.717764	939	985	387	1	46	0.0217391
NODE_3833_length_1208_cov_40.717764	939	985	389	1	46	0.0217391
NODE_3833_length_1208_cov_40.717764	939	985	391	1	46	0.0217391
NODE_3833_length_1208_cov_40.717764	939	985	398	1	46	0.0217391
NODE_3833_length_1208_cov_40.717764	939	985	415	1	46	0.0217391
NODE_3833_length_1208_cov_40.717764	939	985	423	1	46	0.0217391
NODE_3833_length_1208_cov_40.717764	939	985	436	1	46	0.0217391
NODE_3833_length_1208_cov_40.717764	939	985	438	1	46	0.0217391
NODE_3833_length_1208_cov_40.717764	939	985	453	1	46	0.0217391
NODE_3833_length_1208_cov_40.717764	939	985	460	1	46	0.0217391
NODE_3833_length_1208_cov_40.717764	939	985	464	1	46	0.0217391
NODE_3833_length_1208_cov_40.717764	939	985	468	1	46	0.0217391
NODE_3833_length_1208_cov_40.717764	939	985	473	1	46	0.0217391
NODE_3833_length_1208_cov_40.717764	939	985	474	1	46	0.0217391
NODE_3833_length_1208_cov_40.717764	939	985	482	1	46	0.0217391
NODE_3833_length_1208_cov_40.717764	939	985	485	1	46	0.0217391
NODE_3833_length_1208_cov_40.717764	939	985	488	1	46	0.0217391
NODE_3833_length_1208_cov_40.717764	939	985	498	1	46	0.0217391
NODE_3833_length_1208_cov_40.717764	939	985	500	2	46	0.0434783
NODE_3834_length_1208_cov_28.528404	614	694	0	80	80	1.0000000
NODE_3834_length_1208_cov_28.528404	667	747	0	80	80	1.0000000
NODE_3835_length_1208_cov_19.688007	682	762	0	80	80	1.0000000
NODE_3835_length_1208_cov_19.688007	735	815	0	80	80	1.0000000
NODE_3836_length_1208_cov_18.577096	455	535	0	77	80	0.9625000
NODE_3836_length_1208_cov_18.577096	455	535	4	3	80	0.0375000
NODE_3836_length_1208_cov_18.577096	508	588	0	24	80	0.3000000
NODE_3836_length_1208_cov_18.577096	508	588	4	56	80	0.7000000
NODE_3836_length_1208_cov_18.577096	584	664	4	31	80	0.3875000
NODE_3836_length_1208_cov_18.577096	584	664	6	49	80	0.6125000
NODE_3836_length_1208_cov_18.577096	637	717	2	46	80	0.5750000
NODE_3836_length_1208_cov_18.577096	637	717	6	34	80	0.4250000
NODE_3837_length_1208_cov_12.733995	766	846	0	80	80	1.0000000
NODE_3837_length_1208_cov_12.733995	819	899	0	80	80	1.0000000
NODE_3837_length_1208_cov_12.733995	895	975	0	80	80	1.0000000
NODE_3837_length_1208_cov_12.733995	948	1028	0	80	80	1.0000000
NODE_3838_length_1207_cov_20.461191	874	954	1	25	80	0.3125000
NODE_3838_length_1207_cov_20.461191	874	954	2	44	80	0.5500000
NODE_3838_length_1207_cov_20.461191	874	954	4	11	80	0.1375000
NODE_3838_length_1207_cov_20.461191	927	1007	0	42	80	0.5250000
NODE_3838_length_1207_cov_20.461191	927	1007	1	36	80	0.4500000
NODE_3838_length_1207_cov_20.461191	927	1007	2	2	80	0.0250000
NODE_3846_length_1206_cov_59.851852	540	620	0	80	80	1.0000000
NODE_3846_length_1206_cov_59.851852	593	673	0	80	80	1.0000000
NODE_3846_length_1206_cov_59.851852	669	749	0	80	80	1.0000000
NODE_3846_length_1206_cov_59.851852	722	802	0	80	80	1.0000000
NODE_3847_length_1206_cov_23.752484	669	749	0	80	80	1.0000000
NODE_3847_length_1206_cov_23.752484	722	802	0	80	80	1.0000000
NODE_3848_length_1206_cov_21.226739	585	665	0	80	80	1.0000000
NODE_3848_length_1206_cov_21.226739	638	718	0	80	80	1.0000000
NODE_3855_length_1205_cov_23.990054	355	435	0	8	80	0.1000000
NODE_3855_length_1205_cov_23.990054	355	435	12	12	80	0.1500000
NODE_3855_length_1205_cov_23.990054	355	435	17	14	80	0.1750000
NODE_3855_length_1205_cov_23.990054	355	435	18	43	80	0.5375000
NODE_3855_length_1205_cov_23.990054	355	435	22	3	80	0.0375000
NODE_3855_length_1205_cov_23.990054	408	488	6	16	80	0.2000000
NODE_3855_length_1205_cov_23.990054	408	488	18	25	80	0.3125000
NODE_3855_length_1205_cov_23.990054	408	488	22	39	80	0.4875000
NODE_3856_length_1205_cov_10.473779	780	860	0	6	80	0.0750000
NODE_3856_length_1205_cov_10.473779	780	860	2	74	80	0.9250000
NODE_3856_length_1205_cov_10.473779	833	913	0	24	80	0.3000000
NODE_3856_length_1205_cov_10.473779	833	913	2	56	80	0.7000000
NODE_3863_length_1204_cov_19.396380	537	617	2	80	80	1.0000000
NODE_3863_length_1204_cov_19.396380	590	670	2	80	80	1.0000000
NODE_3864_length_1204_cov_17.716742	448	528	0	80	80	1.0000000
NODE_3864_length_1204_cov_17.716742	501	581	0	80	80	1.0000000
NODE_3865_length_1204_cov_15.206335	426	506	0	80	80	1.0000000
NODE_3865_length_1204_cov_15.206335	479	559	0	80	80	1.0000000
NODE_3866_length_1204_cov_14.097738	632	712	0	14	80	0.1750000
NODE_3866_length_1204_cov_14.097738	632	712	2	66	80	0.8250000
NODE_3866_length_1204_cov_14.097738	685	765	0	67	80	0.8375000
NODE_3866_length_1204_cov_14.097738	685	765	2	13	80	0.1625000
NODE_3867_length_1204_cov_11.971946	549	629	0	32	80	0.4000000
NODE_3867_length_1204_cov_11.971946	549	629	2	48	80	0.6000000
NODE_3867_length_1204_cov_11.971946	602	682	0	80	80	1.0000000
NODE_3867_length_1204_cov_11.971946	678	758	0	51	80	0.6375000
NODE_3867_length_1204_cov_11.971946	678	758	2	29	80	0.3625000
NODE_3867_length_1204_cov_11.971946	731	811	2	80	80	1.0000000
NODE_3868_length_1204_cov_11.665158	499	579	0	80	80	1.0000000
NODE_3868_length_1204_cov_11.665158	552	632	0	80	80	1.0000000
NODE_3869_length_1204_cov_7.028959	637	717	0	80	80	1.0000000
NODE_3869_length_1204_cov_7.028959	690	770	0	80	80	1.0000000
NODE_3870_length_1204_cov_4.677828	807	887	0	80	80	1.0000000
NODE_3870_length_1204_cov_4.677828	860	940	0	57	80	0.7125000
NODE_3870_length_1204_cov_4.677828	860	940	2	23	80	0.2875000
NODE_3873_length_1203_cov_46.789855	515	595	6	19	80	0.2375000
NODE_3873_length_1203_cov_46.789855	515	595	8	61	80	0.7625000
NODE_3873_length_1203_cov_46.789855	568	648	0	9	80	0.1125000
NODE_3873_length_1203_cov_46.789855	568	648	2	2	80	0.0250000
NODE_3873_length_1203_cov_46.789855	568	648	4	40	80	0.5000000
NODE_3873_length_1203_cov_46.789855	568	648	6	21	80	0.2625000
NODE_3873_length_1203_cov_46.789855	568	648	8	8	80	0.1000000
NODE_3873_length_1203_cov_46.789855	644	724	0	15	80	0.1875000
NODE_3873_length_1203_cov_46.789855	644	724	2	34	80	0.4250000
NODE_3873_length_1203_cov_46.789855	644	724	4	31	80	0.3875000
NODE_3873_length_1203_cov_46.789855	697	777	0	68	80	0.8500000
NODE_3873_length_1203_cov_46.789855	697	777	2	12	80	0.1500000
NODE_3874_length_1203_cov_44.029891	471	551	0	80	80	1.0000000
NODE_3874_length_1203_cov_44.029891	524	604	0	80	80	1.0000000
NODE_3874_length_1203_cov_44.029891	600	680	0	20	80	0.2500000
NODE_3874_length_1203_cov_44.029891	600	680	2	60	80	0.7500000
NODE_3874_length_1203_cov_44.029891	653	733	0	46	80	0.5750000
NODE_3874_length_1203_cov_44.029891	653	733	2	34	80	0.4250000
NODE_3875_length_1203_cov_23.790761	308	388	0	5	80	0.0625000
NODE_3875_length_1203_cov_23.790761	308	388	2	49	80	0.6125000
NODE_3875_length_1203_cov_23.790761	308	388	6	26	80	0.3250000
NODE_3875_length_1203_cov_23.790761	361	441	0	58	80	0.7250000
NODE_3875_length_1203_cov_23.790761	361	441	2	22	80	0.2750000
NODE_3875_length_1203_cov_23.790761	437	517	0	76	80	0.9500000
NODE_3875_length_1203_cov_23.790761	437	517	2	4	80	0.0500000
NODE_3875_length_1203_cov_23.790761	490	570	0	23	80	0.2875000
NODE_3875_length_1203_cov_23.790761	490	570	2	57	80	0.7125000
NODE_3876_length_1203_cov_19.498188	336	416	0	11	80	0.1375000
NODE_3876_length_1203_cov_19.498188	336	416	2	69	80	0.8625000
NODE_3876_length_1203_cov_19.498188	389	469	0	64	80	0.8000000
NODE_3876_length_1203_cov_19.498188	389	469	2	16	80	0.2000000
NODE_3877_length_1203_cov_10.996377	317	397	0	80	80	1.0000000
NODE_3877_length_1203_cov_10.996377	370	450	0	80	80	1.0000000
NODE_3878_length_1203_cov_5.747283	725	805	0	80	80	1.0000000
NODE_3878_length_1203_cov_5.747283	778	858	0	80	80	1.0000000
NODE_3881_length_1202_cov_39.333636	475	555	0	80	80	1.0000000
NODE_3881_length_1202_cov_39.333636	528	608	0	36	80	0.4500000
NODE_3881_length_1202_cov_39.333636	528	608	2	44	80	0.5500000
NODE_3881_length_1202_cov_39.333636	604	684	0	18	80	0.2250000
NODE_3881_length_1202_cov_39.333636	604	684	2	45	80	0.5625000
NODE_3881_length_1202_cov_39.333636	604	684	4	17	80	0.2125000
NODE_3881_length_1202_cov_39.333636	657	737	0	10	80	0.1250000
NODE_3881_length_1202_cov_39.333636	657	737	4	70	80	0.8750000
NODE_3882_length_1202_cov_17.556664	599	679	0	13	80	0.1625000
NODE_3882_length_1202_cov_17.556664	599	679	2	54	80	0.6750000
NODE_3882_length_1202_cov_17.556664	599	679	4	13	80	0.1625000
NODE_3882_length_1202_cov_17.556664	652	732	2	63	80	0.7875000
NODE_3882_length_1202_cov_17.556664	652	732	4	17	80	0.2125000
NODE_3883_length_1202_cov_12.338169	634	714	1	6	80	0.0750000
NODE_3883_length_1202_cov_12.338169	634	714	3	47	80	0.5875000
NODE_3883_length_1202_cov_12.338169	634	714	4	27	80	0.3375000
NODE_3883_length_1202_cov_12.338169	687	767	0	26	80	0.3250000
NODE_3883_length_1202_cov_12.338169	687	767	1	12	80	0.1500000
NODE_3883_length_1202_cov_12.338169	687	767	2	21	80	0.2625000
NODE_3883_length_1202_cov_12.338169	687	767	3	21	80	0.2625000
NODE_3884_length_1202_cov_11.800544	520	600	1	9	80	0.1125000
NODE_3884_length_1202_cov_11.800544	520	600	2	71	80	0.8875000
NODE_3884_length_1202_cov_11.800544	573	653	0	1	80	0.0125000
NODE_3884_length_1202_cov_11.800544	573	653	1	61	80	0.7625000
NODE_3884_length_1202_cov_11.800544	573	653	2	18	80	0.2250000
NODE_3887_length_1201_cov_12.161525	434	514	0	13	80	0.1625000
NODE_3887_length_1201_cov_12.161525	434	514	2	1	80	0.0125000
NODE_3887_length_1201_cov_12.161525	434	514	4	47	80	0.5875000
NODE_3887_length_1201_cov_12.161525	434	514	6	19	80	0.2375000
NODE_3887_length_1201_cov_12.161525	487	567	2	54	80	0.6750000
NODE_3887_length_1201_cov_12.161525	487	567	4	7	80	0.0875000
NODE_3887_length_1201_cov_12.161525	487	567	6	19	80	0.2375000
NODE_3888_length_1201_cov_12.046279	643	723	0	78	80	0.9750000
NODE_3888_length_1201_cov_12.046279	643	723	2	2	80	0.0250000
NODE_3888_length_1201_cov_12.046279	696	776	0	80	80	1.0000000
NODE_3891_length_1200_cov_76.694823	630	710	1	32	80	0.4000000
NODE_3891_length_1200_cov_76.694823	630	710	2	36	80	0.4500000
NODE_3891_length_1200_cov_76.694823	630	710	3	12	80	0.1500000
NODE_3891_length_1200_cov_76.694823	683	763	2	80	80	1.0000000
NODE_3891_length_1200_cov_76.694823	759	839	0	13	80	0.1625000
NODE_3891_length_1200_cov_76.694823	759	839	1	44	80	0.5500000
NODE_3891_length_1200_cov_76.694823	759	839	2	23	80	0.2875000
NODE_3891_length_1200_cov_76.694823	812	892	0	66	80	0.8250000
NODE_3891_length_1200_cov_76.694823	812	892	1	14	80	0.1750000
NODE_3892_length_1200_cov_16.881926	827	902	0	28	75	0.3733333
NODE_3892_length_1200_cov_16.881926	827	902	1	1	75	0.0133333
NODE_3892_length_1200_cov_16.881926	827	902	2	14	75	0.1866667
NODE_3892_length_1200_cov_16.881926	827	902	6	6	75	0.0800000
NODE_3892_length_1200_cov_16.881926	827	902	8	1	75	0.0133333
NODE_3892_length_1200_cov_16.881926	827	902	9	7	75	0.0933333
NODE_3892_length_1200_cov_16.881926	827	902	11	9	75	0.1200000
NODE_3892_length_1200_cov_16.881926	827	902	12	9	75	0.1200000
NODE_3892_length_1200_cov_16.881926	828	904	0	27	76	0.3552631
NODE_3892_length_1200_cov_16.881926	828	904	1	1	76	0.0131579
NODE_3892_length_1200_cov_16.881926	828	904	2	14	76	0.1842105
NODE_3892_length_1200_cov_16.881926	828	904	6	6	76	0.0789474
NODE_3892_length_1200_cov_16.881926	828	904	8	1	76	0.0131579
NODE_3892_length_1200_cov_16.881926	828	904	9	7	76	0.0921053
NODE_3892_length_1200_cov_16.881926	828	904	11	9	76	0.1184211
NODE_3892_length_1200_cov_16.881926	828	904	12	11	76	0.1447368
NODE_3892_length_1200_cov_16.881926	841	907	0	14	66	0.2121212
NODE_3892_length_1200_cov_16.881926	841	907	1	1	66	0.0151515
NODE_3892_length_1200_cov_16.881926	841	907	2	14	66	0.2121212
NODE_3892_length_1200_cov_16.881926	841	907	6	6	66	0.0909091
NODE_3892_length_1200_cov_16.881926	841	907	8	1	66	0.0151515
NODE_3892_length_1200_cov_16.881926	841	907	9	7	66	0.1060606
NODE_3892_length_1200_cov_16.881926	841	907	11	9	66	0.1363636
NODE_3892_length_1200_cov_16.881926	841	907	12	14	66	0.2121212
NODE_3892_length_1200_cov_16.881926	880	957	9	4	77	0.0519481
NODE_3892_length_1200_cov_16.881926	880	957	11	9	77	0.1168831
NODE_3892_length_1200_cov_16.881926	880	957	12	18	77	0.2337662
NODE_3892_length_1200_cov_16.881926	880	957	14	1	77	0.0129870
NODE_3892_length_1200_cov_16.881926	880	957	16	23	77	0.2987013
NODE_3892_length_1200_cov_16.881926	880	957	17	1	77	0.0129870
NODE_3892_length_1200_cov_16.881926	880	957	21	3	77	0.0389610
NODE_3892_length_1200_cov_16.881926	880	957	22	2	77	0.0259740
NODE_3892_length_1200_cov_16.881926	880	957	31	1	77	0.0129870
NODE_3892_length_1200_cov_16.881926	880	957	33	2	77	0.0259740
NODE_3892_length_1200_cov_16.881926	880	957	34	7	77	0.0909091
NODE_3892_length_1200_cov_16.881926	880	957	35	6	77	0.0779221
NODE_3892_length_1200_cov_16.881926	880	957	9	4	77	0.0519481
NODE_3892_length_1200_cov_16.881926	880	957	11	9	77	0.1168831
NODE_3892_length_1200_cov_16.881926	880	957	12	18	77	0.2337662
NODE_3892_length_1200_cov_16.881926	880	957	14	1	77	0.0129870
NODE_3892_length_1200_cov_16.881926	880	957	16	23	77	0.2987013
NODE_3892_length_1200_cov_16.881926	880	957	17	1	77	0.0129870
NODE_3892_length_1200_cov_16.881926	880	957	21	3	77	0.0389610
NODE_3892_length_1200_cov_16.881926	880	957	22	2	77	0.0259740
NODE_3892_length_1200_cov_16.881926	880	957	31	1	77	0.0129870
NODE_3892_length_1200_cov_16.881926	880	957	33	2	77	0.0259740
NODE_3892_length_1200_cov_16.881926	880	957	34	7	77	0.0909091
NODE_3892_length_1200_cov_16.881926	880	957	35	6	77	0.0779221
NODE_3892_length_1200_cov_16.881926	880	957	9	4	77	0.0519481
NODE_3892_length_1200_cov_16.881926	880	957	11	9	77	0.1168831
NODE_3892_length_1200_cov_16.881926	880	957	12	18	77	0.2337662
NODE_3892_length_1200_cov_16.881926	880	957	14	1	77	0.0129870
NODE_3892_length_1200_cov_16.881926	880	957	16	23	77	0.2987013
NODE_3892_length_1200_cov_16.881926	880	957	17	1	77	0.0129870
NODE_3892_length_1200_cov_16.881926	880	957	21	3	77	0.0389610
NODE_3892_length_1200_cov_16.881926	880	957	22	2	77	0.0259740
NODE_3892_length_1200_cov_16.881926	880	957	31	1	77	0.0129870
NODE_3892_length_1200_cov_16.881926	880	957	33	2	77	0.0259740
NODE_3892_length_1200_cov_16.881926	880	957	34	7	77	0.0909091
NODE_3892_length_1200_cov_16.881926	880	957	35	6	77	0.0779221
NODE_3893_length_1200_cov_15.374205	605	685	0	7	80	0.0875000
NODE_3893_length_1200_cov_15.374205	605	685	2	52	80	0.6500000
NODE_3893_length_1200_cov_15.374205	605	685	4	21	80	0.2625000
NODE_3893_length_1200_cov_15.374205	658	738	2	6	80	0.0750000
NODE_3893_length_1200_cov_15.374205	658	738	4	74	80	0.9250000
NODE_3894_length_1200_cov_12.953678	486	550	17	5	64	0.0781250
NODE_3894_length_1200_cov_12.953678	486	550	19	2	64	0.0312500
NODE_3894_length_1200_cov_12.953678	486	550	21	2	64	0.0312500
NODE_3894_length_1200_cov_12.953678	486	550	22	4	64	0.0625000
NODE_3894_length_1200_cov_12.953678	486	550	24	7	64	0.1093750
NODE_3894_length_1200_cov_12.953678	486	550	26	44	64	0.6875000
NODE_3899_length_1199_cov_14.843636	222	302	0	16	80	0.2000000
NODE_3899_length_1199_cov_14.843636	222	302	8	11	80	0.1375000
NODE_3899_length_1199_cov_14.843636	222	302	9	2	80	0.0250000
NODE_3899_length_1199_cov_14.843636	222	302	10	51	80	0.6375000
NODE_3899_length_1199_cov_14.843636	275	355	10	42	80	0.5250000
NODE_3899_length_1199_cov_14.843636	275	355	12	38	80	0.4750000
NODE_3900_length_1199_cov_12.005455	383	463	0	80	80	1.0000000
NODE_3900_length_1199_cov_12.005455	436	516	0	80	80	1.0000000
NODE_3900_length_1199_cov_12.005455	512	592	0	80	80	1.0000000
NODE_3900_length_1199_cov_12.005455	565	645	0	80	80	1.0000000
NODE_3902_length_1198_cov_36.830755	619	699	0	19	80	0.2375000
NODE_3902_length_1198_cov_36.830755	619	699	2	61	80	0.7625000
NODE_3902_length_1198_cov_36.830755	672	752	0	37	80	0.4625000
NODE_3902_length_1198_cov_36.830755	672	752	2	43	80	0.5375000
NODE_3903_length_1198_cov_22.864422	719	799	0	80	80	1.0000000
NODE_3903_length_1198_cov_22.864422	772	852	0	80	80	1.0000000
NODE_3904_length_1198_cov_17.619654	260	340	2	80	80	1.0000000
NODE_3904_length_1198_cov_17.619654	313	392	0	39	79	0.4936709
NODE_3904_length_1198_cov_17.619654	313	392	2	40	79	0.5063291
NODE_3905_length_1198_cov_10.148317	718	798	0	80	80	1.0000000
NODE_3905_length_1198_cov_10.148317	771	851	0	80	80	1.0000000
NODE_3906_length_1198_cov_6.733394	549	629	0	22	80	0.2750000
NODE_3906_length_1198_cov_6.733394	549	629	2	58	80	0.7250000
NODE_3906_length_1198_cov_6.733394	602	682	0	19	80	0.2375000
NODE_3906_length_1198_cov_6.733394	602	682	2	61	80	0.7625000
NODE_3912_length_1197_cov_27.653005	417	497	0	80	80	1.0000000
NODE_3912_length_1197_cov_27.653005	470	550	0	27	80	0.3375000
NODE_3912_length_1197_cov_27.653005	470	550	2	53	80	0.6625000
NODE_3912_length_1197_cov_27.653005	546	626	2	69	80	0.8625000
NODE_3912_length_1197_cov_27.653005	546	626	4	11	80	0.1375000
NODE_3912_length_1197_cov_27.653005	599	679	2	20	80	0.2500000
NODE_3912_length_1197_cov_27.653005	599	679	4	60	80	0.7500000
NODE_3913_length_1197_cov_14.653916	490	570	0	80	80	1.0000000
NODE_3913_length_1197_cov_14.653916	543	623	0	70	80	0.8750000
NODE_3913_length_1197_cov_14.653916	543	623	2	10	80	0.1250000
NODE_3921_length_1196_cov_26.169553	298	378	2	32	80	0.4000000
NODE_3921_length_1196_cov_26.169553	298	378	4	48	80	0.6000000
NODE_3921_length_1196_cov_26.169553	351	431	2	19	80	0.2375000
NODE_3921_length_1196_cov_26.169553	351	431	4	61	80	0.7625000
NODE_3921_length_1196_cov_26.169553	427	507	0	71	80	0.8875000
NODE_3921_length_1196_cov_26.169553	427	507	2	9	80	0.1125000
NODE_3921_length_1196_cov_26.169553	480	560	0	80	80	1.0000000
NODE_3922_length_1196_cov_21.755697	521	601	0	80	80	1.0000000
NODE_3922_length_1196_cov_21.755697	574	654	0	80	80	1.0000000
NODE_3922_length_1196_cov_21.755697	650	730	0	80	80	1.0000000
NODE_3922_length_1196_cov_21.755697	703	783	0	80	80	1.0000000
NODE_3923_length_1196_cov_5.966272	556	636	0	2	80	0.0250000
NODE_3923_length_1196_cov_5.966272	556	636	7	50	80	0.6250000
NODE_3923_length_1196_cov_5.966272	556	636	8	28	80	0.3500000
NODE_3923_length_1196_cov_5.966272	609	689	0	16	80	0.2000000
NODE_3923_length_1196_cov_5.966272	609	689	7	64	80	0.8000000
NODE_3927_length_1195_cov_69.056569	474	554	0	80	80	1.0000000
NODE_3927_length_1195_cov_69.056569	527	607	0	80	80	1.0000000
NODE_3927_length_1195_cov_69.056569	603	683	0	80	80	1.0000000
NODE_3927_length_1195_cov_69.056569	656	736	0	80	80	1.0000000
NODE_3928_length_1195_cov_65.062044	579	659	0	80	80	1.0000000
NODE_3928_length_1195_cov_65.062044	632	712	0	78	80	0.9750000
NODE_3928_length_1195_cov_65.062044	632	712	2	2	80	0.0250000
NODE_3928_length_1195_cov_65.062044	708	788	0	2	80	0.0250000
NODE_3928_length_1195_cov_65.062044	708	788	2	12	80	0.1500000
NODE_3928_length_1195_cov_65.062044	708	788	10	56	80	0.7000000
NODE_3928_length_1195_cov_65.062044	708	788	12	10	80	0.1250000
NODE_3928_length_1195_cov_65.062044	761	841	2	14	80	0.1750000
NODE_3928_length_1195_cov_65.062044	761	841	4	7	80	0.0875000
NODE_3928_length_1195_cov_65.062044	761	841	10	17	80	0.2125000
NODE_3928_length_1195_cov_65.062044	761	841	12	42	80	0.5250000
NODE_3929_length_1195_cov_23.187044	460	540	0	80	80	1.0000000
NODE_3929_length_1195_cov_23.187044	513	593	0	80	80	1.0000000
NODE_3930_length_1195_cov_18.983577	521	601	0	1	80	0.0125000
NODE_3930_length_1195_cov_18.983577	521	601	2	79	80	0.9875000
NODE_3930_length_1195_cov_18.983577	574	654	0	54	80	0.6750000
NODE_3930_length_1195_cov_18.983577	574	654	2	26	80	0.3250000
NODE_3931_length_1195_cov_14.119526	726	806	0	80	80	1.0000000
NODE_3931_length_1195_cov_14.119526	779	859	0	80	80	1.0000000
NODE_3931_length_1195_cov_14.119526	855	935	0	80	80	1.0000000
NODE_3931_length_1195_cov_14.119526	908	988	0	80	80	1.0000000
NODE_3932_length_1195_cov_13.805657	759	839	2	60	80	0.7500000
NODE_3932_length_1195_cov_13.805657	759	839	4	20	80	0.2500000
NODE_3932_length_1195_cov_13.805657	812	892	2	16	80	0.2000000
NODE_3932_length_1195_cov_13.805657	812	892	4	64	80	0.8000000
NODE_3938_length_1195_cov_1.969891	912	992	0	22	80	0.2750000
NODE_3938_length_1195_cov_1.969891	912	992	3	9	80	0.1125000
NODE_3938_length_1195_cov_1.969891	912	992	11	8	80	0.1000000
NODE_3938_length_1195_cov_1.969891	912	992	16	13	80	0.1625000
NODE_3938_length_1195_cov_1.969891	912	992	17	1	80	0.0125000
NODE_3938_length_1195_cov_1.969891	912	992	23	8	80	0.1000000
NODE_3938_length_1195_cov_1.969891	912	992	24	19	80	0.2375000
NODE_3938_length_1195_cov_1.969891	912	992	0	22	80	0.2750000
NODE_3938_length_1195_cov_1.969891	912	992	3	9	80	0.1125000
NODE_3938_length_1195_cov_1.969891	912	992	11	8	80	0.1000000
NODE_3938_length_1195_cov_1.969891	912	992	16	13	80	0.1625000
NODE_3938_length_1195_cov_1.969891	912	992	17	1	80	0.0125000
NODE_3938_length_1195_cov_1.969891	912	992	23	8	80	0.1000000
NODE_3938_length_1195_cov_1.969891	912	992	24	19	80	0.2375000
NODE_3941_length_1194_cov_40.157991	237	317	0	3	80	0.0375000
NODE_3941_length_1194_cov_40.157991	237	317	2	77	80	0.9625000
NODE_3941_length_1194_cov_40.157991	290	370	0	26	80	0.3250000
NODE_3941_length_1194_cov_40.157991	290	370	2	54	80	0.6750000
NODE_3946_length_1193_cov_34.295247	443	523	0	80	80	1.0000000
NODE_3946_length_1193_cov_34.295247	496	576	0	80	80	1.0000000
NODE_3947_length_1193_cov_16.930530	124	154	0	23	30	0.7666667
NODE_3947_length_1193_cov_16.930530	124	154	2	7	30	0.2333333
NODE_3947_length_1193_cov_16.930530	390	470	1	4	80	0.0500000
NODE_3947_length_1193_cov_16.930530	390	470	5	27	80	0.3375000
NODE_3947_length_1193_cov_16.930530	390	470	6	49	80	0.6125000
NODE_3947_length_1193_cov_16.930530	443	523	0	45	80	0.5625000
NODE_3947_length_1193_cov_16.930530	443	523	1	12	80	0.1500000
NODE_3947_length_1193_cov_16.930530	443	523	5	23	80	0.2875000
NODE_3949_length_1192_cov_26.803294	205	285	1	12	80	0.1500000
NODE_3949_length_1192_cov_26.803294	205	285	3	2	80	0.0250000
NODE_3949_length_1192_cov_26.803294	205	285	6	19	80	0.2375000
NODE_3949_length_1192_cov_26.803294	205	285	7	47	80	0.5875000
NODE_3949_length_1192_cov_26.803294	258	338	1	65	80	0.8125000
NODE_3949_length_1192_cov_26.803294	258	338	3	2	80	0.0250000
NODE_3949_length_1192_cov_26.803294	258	338	7	13	80	0.1625000
NODE_3949_length_1192_cov_26.803294	334	414	0	40	80	0.5000000
NODE_3949_length_1192_cov_26.803294	334	414	1	40	80	0.5000000
NODE_3949_length_1192_cov_26.803294	387	467	0	80	80	1.0000000
NODE_3950_length_1192_cov_23.228728	487	567	0	80	80	1.0000000
NODE_3950_length_1192_cov_23.228728	540	620	0	80	80	1.0000000
NODE_3950_length_1192_cov_23.228728	616	696	0	80	80	1.0000000
NODE_3950_length_1192_cov_23.228728	669	749	0	80	80	1.0000000
NODE_3951_length_1192_cov_18.314730	613	693	0	80	80	1.0000000
NODE_3951_length_1192_cov_18.314730	666	746	0	80	80	1.0000000
NODE_3951_length_1192_cov_18.314730	742	822	0	80	80	1.0000000
NODE_3951_length_1192_cov_18.314730	795	875	0	80	80	1.0000000
NODE_3952_length_1192_cov_14.888381	622	702	0	11	80	0.1375000
NODE_3952_length_1192_cov_14.888381	622	702	2	69	80	0.8625000
NODE_3952_length_1192_cov_14.888381	675	755	0	1	80	0.0125000
NODE_3952_length_1192_cov_14.888381	675	755	2	79	80	0.9875000
NODE_3952_length_1192_cov_14.888381	751	831	0	40	80	0.5000000
NODE_3952_length_1192_cov_14.888381	751	831	2	40	80	0.5000000
NODE_3952_length_1192_cov_14.888381	804	884	0	80	80	1.0000000
NODE_3953_length_1192_cov_9.995425	161	241	0	80	80	1.0000000
NODE_3953_length_1192_cov_9.995425	214	294	0	80	80	1.0000000
NODE_3954_length_1192_cov_5.078683	749	829	4	9	80	0.1125000
NODE_3954_length_1192_cov_5.078683	749	829	7	1	80	0.0125000
NODE_3954_length_1192_cov_5.078683	749	829	9	2	80	0.0250000
NODE_3954_length_1192_cov_5.078683	749	829	11	1	80	0.0125000
NODE_3954_length_1192_cov_5.078683	749	829	15	2	80	0.0250000
NODE_3954_length_1192_cov_5.078683	749	829	17	8	80	0.1000000
NODE_3954_length_1192_cov_5.078683	749	829	18	47	80	0.5875000
NODE_3954_length_1192_cov_5.078683	749	829	22	10	80	0.1250000
NODE_3954_length_1192_cov_5.078683	802	882	8	1	80	0.0125000
NODE_3954_length_1192_cov_5.078683	802	882	12	10	80	0.1250000
NODE_3954_length_1192_cov_5.078683	802	882	13	1	80	0.0125000
NODE_3954_length_1192_cov_5.078683	802	882	14	24	80	0.3000000
NODE_3954_length_1192_cov_5.078683	802	882	16	8	80	0.1000000
NODE_3954_length_1192_cov_5.078683	802	882	18	21	80	0.2625000
NODE_3954_length_1192_cov_5.078683	802	882	22	15	80	0.1875000
NODE_3960_length_1192_cov_0.614822	1046	1126	0	23	80	0.2875000
NODE_3960_length_1192_cov_0.614822	1046	1126	2	57	80	0.7125000
NODE_3961_length_1191_cov_55.466117	392	472	4	80	80	1.0000000
NODE_3961_length_1191_cov_55.466117	445	525	0	22	80	0.2750000
NODE_3961_length_1191_cov_55.466117	445	525	4	58	80	0.7250000
NODE_3961_length_1191_cov_55.466117	521	601	0	36	80	0.4500000
NODE_3961_length_1191_cov_55.466117	521	601	2	44	80	0.5500000
NODE_3961_length_1191_cov_55.466117	574	654	2	80	80	1.0000000
NODE_3963_length_1191_cov_20.677656	695	775	0	80	80	1.0000000
NODE_3963_length_1191_cov_20.677656	748	828	0	80	80	1.0000000
NODE_3964_length_1191_cov_9.074176	420	500	0	4	80	0.0500000
NODE_3964_length_1191_cov_9.074176	420	500	2	76	80	0.9500000
NODE_3964_length_1191_cov_9.074176	473	553	0	51	80	0.6375000
NODE_3964_length_1191_cov_9.074176	473	553	2	29	80	0.3625000
NODE_3968_length_1190_cov_40.916590	521	601	12	5	80	0.0625000
NODE_3968_length_1190_cov_40.916590	521	601	14	2	80	0.0250000
NODE_3968_length_1190_cov_40.916590	521	601	15	1	80	0.0125000
NODE_3968_length_1190_cov_40.916590	521	601	16	72	80	0.9000000
NODE_3968_length_1190_cov_40.916590	574	654	0	28	80	0.3500000
NODE_3968_length_1190_cov_40.916590	574	654	2	20	80	0.2500000
NODE_3968_length_1190_cov_40.916590	574	654	12	10	80	0.1250000
NODE_3968_length_1190_cov_40.916590	574	654	15	1	80	0.0125000
NODE_3968_length_1190_cov_40.916590	574	654	16	21	80	0.2625000
NODE_3968_length_1190_cov_40.916590	650	730	0	54	80	0.6750000
NODE_3968_length_1190_cov_40.916590	650	730	2	26	80	0.3250000
NODE_3968_length_1190_cov_40.916590	703	783	0	1	80	0.0125000
NODE_3968_length_1190_cov_40.916590	703	783	2	79	80	0.9875000
NODE_3969_length_1190_cov_20.715857	257	337	0	80	80	1.0000000
NODE_3969_length_1190_cov_20.715857	310	390	0	80	80	1.0000000
NODE_3970_length_1190_cov_19.724106	296	376	0	80	80	1.0000000
NODE_3970_length_1190_cov_19.724106	349	429	0	36	80	0.4500000
NODE_3970_length_1190_cov_19.724106	349	429	4	44	80	0.5500000
NODE_3973_length_1190_cov_2.698442	1022	1070	8	29	48	0.6041667
NODE_3973_length_1190_cov_2.698442	1022	1070	10	19	48	0.3958333
NODE_3973_length_1190_cov_2.698442	1075	1123	2	19	48	0.3958333
NODE_3973_length_1190_cov_2.698442	1075	1123	4	19	48	0.3958333
NODE_3973_length_1190_cov_2.698442	1075	1123	8	10	48	0.2083333
NODE_3977_length_1189_cov_29.193578	576	656	0	4	80	0.0500000
NODE_3977_length_1189_cov_29.193578	576	656	2	76	80	0.9500000
NODE_3977_length_1189_cov_29.193578	629	709	0	31	80	0.3875000
NODE_3977_length_1189_cov_29.193578	629	709	2	49	80	0.6125000
NODE_3978_length_1189_cov_13.484404	315	341	0	26	26	1.0000000
NODE_3978_length_1189_cov_13.484404	366	446	0	80	80	1.0000000
NODE_3984_length_1188_cov_19.278237	396	476	0	26	80	0.3250000
NODE_3984_length_1188_cov_19.278237	396	476	10	5	80	0.0625000
NODE_3984_length_1188_cov_19.278237	396	476	11	3	80	0.0375000
NODE_3984_length_1188_cov_19.278237	396	476	12	8	80	0.1000000
NODE_3984_length_1188_cov_19.278237	396	476	22	4	80	0.0500000
NODE_3984_length_1188_cov_19.278237	396	476	23	34	80	0.4250000
NODE_3984_length_1188_cov_19.278237	449	529	23	47	80	0.5875000
NODE_3984_length_1188_cov_19.278237	449	529	24	6	80	0.0750000
NODE_3984_length_1188_cov_19.278237	449	529	25	27	80	0.3375000
NODE_3990_length_1187_cov_63.185662	529	609	0	80	80	1.0000000
NODE_3990_length_1187_cov_63.185662	582	662	0	28	80	0.3500000
NODE_3990_length_1187_cov_63.185662	582	662	1	14	80	0.1750000
NODE_3990_length_1187_cov_63.185662	582	662	2	38	80	0.4750000
NODE_3990_length_1187_cov_63.185662	658	738	2	14	80	0.1750000
NODE_3990_length_1187_cov_63.185662	658	738	7	1	80	0.0125000
NODE_3990_length_1187_cov_63.185662	658	738	8	3	80	0.0375000
NODE_3990_length_1187_cov_63.185662	658	738	12	62	80	0.7750000
NODE_3990_length_1187_cov_63.185662	711	791	0	17	80	0.2125000
NODE_3990_length_1187_cov_63.185662	711	791	1	14	80	0.1750000
NODE_3990_length_1187_cov_63.185662	711	791	2	2	80	0.0250000
NODE_3990_length_1187_cov_63.185662	711	791	6	10	80	0.1250000
NODE_3990_length_1187_cov_63.185662	711	791	12	37	80	0.4625000
NODE_3991_length_1187_cov_36.926471	432	512	4	10	80	0.1250000
NODE_3991_length_1187_cov_36.926471	432	512	6	29	80	0.3625000
NODE_3991_length_1187_cov_36.926471	432	512	8	39	80	0.4875000
NODE_3991_length_1187_cov_36.926471	432	512	10	2	80	0.0250000
NODE_3991_length_1187_cov_36.926471	485	565	0	5	80	0.0625000
NODE_3991_length_1187_cov_36.926471	485	565	4	58	80	0.7250000
NODE_3991_length_1187_cov_36.926471	485	565	6	17	80	0.2125000
NODE_3991_length_1187_cov_36.926471	561	641	0	80	80	1.0000000
NODE_3991_length_1187_cov_36.926471	614	694	0	80	80	1.0000000
NODE_3992_length_1187_cov_20.383272	492	572	0	80	80	1.0000000
NODE_3992_length_1187_cov_20.383272	545	625	0	80	80	1.0000000
NODE_3993_length_1187_cov_17.941176	377	457	0	27	80	0.3375000
NODE_3993_length_1187_cov_17.941176	377	457	2	53	80	0.6625000
NODE_3993_length_1187_cov_17.941176	430	510	0	25	80	0.3125000
NODE_3993_length_1187_cov_17.941176	430	510	2	55	80	0.6875000
NODE_3993_length_1187_cov_17.941176	506	586	0	32	80	0.4000000
NODE_3993_length_1187_cov_17.941176	506	586	2	48	80	0.6000000
NODE_3993_length_1187_cov_17.941176	559	639	2	80	80	1.0000000
NODE_3997_length_1186_cov_59.606256	338	418	0	80	80	1.0000000
NODE_3997_length_1186_cov_59.606256	391	471	0	80	80	1.0000000
NODE_3997_length_1186_cov_59.606256	480	551	0	71	71	1.0000000
NODE_3997_length_1186_cov_59.606256	524	604	0	80	80	1.0000000
NODE_3998_length_1186_cov_34.937443	582	662	1	9	80	0.1125000
NODE_3998_length_1186_cov_34.937443	582	662	2	71	80	0.8875000
NODE_3998_length_1186_cov_34.937443	635	715	1	62	80	0.7750000
NODE_3998_length_1186_cov_34.937443	635	715	2	18	80	0.2250000
NODE_3998_length_1186_cov_34.937443	711	791	1	12	80	0.1500000
NODE_3998_length_1186_cov_34.937443	711	791	2	61	80	0.7625000
NODE_3998_length_1186_cov_34.937443	711	791	3	7	80	0.0875000
NODE_3998_length_1186_cov_34.937443	764	844	0	49	80	0.6125000
NODE_3998_length_1186_cov_34.937443	764	844	2	31	80	0.3875000
NODE_3999_length_1186_cov_29.840846	511	591	0	80	80	1.0000000
NODE_3999_length_1186_cov_29.840846	564	644	0	80	80	1.0000000
NODE_3999_length_1186_cov_29.840846	640	720	0	80	80	1.0000000
NODE_3999_length_1186_cov_29.840846	693	773	0	80	80	1.0000000
NODE_4000_length_1186_cov_13.108556	578	658	0	80	80	1.0000000
NODE_4000_length_1186_cov_13.108556	631	711	0	80	80	1.0000000
NODE_4001_length_1186_cov_12.867525	404	484	0	15	80	0.1875000
NODE_4001_length_1186_cov_12.867525	404	484	2	65	80	0.8125000
NODE_4001_length_1186_cov_12.867525	457	534	0	65	77	0.8441558
NODE_4001_length_1186_cov_12.867525	457	534	2	12	77	0.1558442
NODE_4001_length_1186_cov_12.867525	536	613	0	60	77	0.7792208
NODE_4001_length_1186_cov_12.867525	536	613	1	17	77	0.2207792
NODE_4001_length_1186_cov_12.867525	586	666	0	10	80	0.1250000
NODE_4001_length_1186_cov_12.867525	586	666	1	31	80	0.3875000
NODE_4001_length_1186_cov_12.867525	586	666	2	26	80	0.3250000
NODE_4001_length_1186_cov_12.867525	586	666	4	13	80	0.1625000
NODE_4002_length_1186_cov_12.135235	643	723	0	80	80	1.0000000
NODE_4002_length_1186_cov_12.135235	696	776	0	80	80	1.0000000
NODE_4012_length_1185_cov_36.974217	423	503	0	52	80	0.6500000
NODE_4012_length_1185_cov_36.974217	423	503	2	24	80	0.3000000
NODE_4012_length_1185_cov_36.974217	423	503	4	4	80	0.0500000
NODE_4012_length_1185_cov_36.974217	476	556	2	28	80	0.3500000
NODE_4012_length_1185_cov_36.974217	476	556	4	52	80	0.6500000
NODE_4013_length_1185_cov_28.410681	448	528	0	5	80	0.0625000
NODE_4013_length_1185_cov_28.410681	448	528	2	75	80	0.9375000
NODE_4013_length_1185_cov_28.410681	501	581	0	58	80	0.7250000
NODE_4013_length_1185_cov_28.410681	501	581	2	22	80	0.2750000
NODE_4014_length_1185_cov_19.768877	411	491	0	80	80	1.0000000
NODE_4014_length_1185_cov_19.768877	464	544	0	80	80	1.0000000
NODE_4014_length_1185_cov_19.768877	540	620	0	52	80	0.6500000
NODE_4014_length_1185_cov_19.768877	540	620	2	28	80	0.3500000
NODE_4014_length_1185_cov_19.768877	593	673	2	80	80	1.0000000
NODE_4015_length_1185_cov_14.490792	379	459	4	43	80	0.5375000
NODE_4015_length_1185_cov_14.490792	379	459	6	2	80	0.0250000
NODE_4015_length_1185_cov_14.490792	379	459	10	35	80	0.4375000
NODE_4015_length_1185_cov_14.490792	432	512	0	7	80	0.0875000
NODE_4015_length_1185_cov_14.490792	432	512	6	48	80	0.6000000
NODE_4015_length_1185_cov_14.490792	432	512	10	25	80	0.3125000
NODE_4016_length_1185_cov_13.686004	677	757	2	58	80	0.7250000
NODE_4016_length_1185_cov_13.686004	677	757	8	13	80	0.1625000
NODE_4016_length_1185_cov_13.686004	677	757	10	9	80	0.1125000
NODE_4016_length_1185_cov_13.686004	730	810	2	5	80	0.0625000
NODE_4016_length_1185_cov_13.686004	730	810	8	66	80	0.8250000
NODE_4016_length_1185_cov_13.686004	730	810	10	9	80	0.1125000
NODE_4017_length_1185_cov_12.362799	711	791	0	14	80	0.1750000
NODE_4017_length_1185_cov_12.362799	711	791	6	66	80	0.8250000
NODE_4017_length_1185_cov_12.362799	764	844	0	6	80	0.0750000
NODE_4017_length_1185_cov_12.362799	764	844	6	74	80	0.9250000
NODE_4024_length_1184_cov_30.061751	416	497	0	76	81	0.9382716
NODE_4024_length_1184_cov_30.061751	416	497	3	5	81	0.0617284
NODE_4024_length_1184_cov_30.061751	470	550	0	22	80	0.2750000
NODE_4024_length_1184_cov_30.061751	470	550	3	58	80	0.7250000
NODE_4024_length_1184_cov_30.061751	546	627	3	12	81	0.1481481
NODE_4024_length_1184_cov_30.061751	546	627	6	69	81	0.8518519
NODE_4024_length_1184_cov_30.061751	600	680	3	38	80	0.4750000
NODE_4024_length_1184_cov_30.061751	600	680	6	42	80	0.5250000
NODE_4025_length_1184_cov_19.544700	550	630	0	80	80	1.0000000
NODE_4025_length_1184_cov_19.544700	603	683	0	80	80	1.0000000
NODE_4025_length_1184_cov_19.544700	679	759	0	80	80	1.0000000
NODE_4025_length_1184_cov_19.544700	732	812	0	80	80	1.0000000
NODE_4026_length_1184_cov_9.129954	624	704	0	31	80	0.3875000
NODE_4026_length_1184_cov_9.129954	624	704	2	49	80	0.6125000
NODE_4026_length_1184_cov_9.129954	677	757	0	33	80	0.4125000
NODE_4026_length_1184_cov_9.129954	677	757	2	47	80	0.5875000
NODE_4031_length_1183_cov_17.260148	545	625	0	62	80	0.7750000
NODE_4031_length_1183_cov_17.260148	545	625	2	18	80	0.2250000
NODE_4031_length_1183_cov_17.260148	598	678	0	9	80	0.1125000
NODE_4031_length_1183_cov_17.260148	598	678	2	71	80	0.8875000
NODE_4031_length_1183_cov_17.260148	674	754	0	73	80	0.9125000
NODE_4031_length_1183_cov_17.260148	674	754	2	7	80	0.0875000
NODE_4031_length_1183_cov_17.260148	727	807	0	80	80	1.0000000
NODE_4032_length_1183_cov_9.777675	484	564	0	80	80	1.0000000
NODE_4032_length_1183_cov_9.777675	537	617	0	80	80	1.0000000
NODE_4033_length_1183_cov_6.847786	711	791	0	80	80	1.0000000
NODE_4033_length_1183_cov_6.847786	764	844	0	80	80	1.0000000
NODE_4033_length_1183_cov_6.847786	840	920	0	80	80	1.0000000
NODE_4033_length_1183_cov_6.847786	893	973	0	68	80	0.8500000
NODE_4033_length_1183_cov_6.847786	893	973	2	12	80	0.1500000
NODE_4035_length_1183_cov_2.680812	59	139	4	8	80	0.1000000
NODE_4035_length_1183_cov_2.680812	59	139	6	6	80	0.0750000
NODE_4035_length_1183_cov_2.680812	59	139	8	66	80	0.8250000
NODE_4040_length_1182_cov_64.600185	588	668	2	3	80	0.0375000
NODE_4040_length_1182_cov_64.600185	588	668	6	23	80	0.2875000
NODE_4040_length_1182_cov_64.600185	588	668	8	4	80	0.0500000
NODE_4040_length_1182_cov_64.600185	588	668	10	50	80	0.6250000
NODE_4040_length_1182_cov_64.600185	641	721	2	32	80	0.4000000
NODE_4040_length_1182_cov_64.600185	641	721	5	3	80	0.0375000
NODE_4040_length_1182_cov_64.600185	641	721	6	7	80	0.0875000
NODE_4040_length_1182_cov_64.600185	641	721	8	4	80	0.0500000
NODE_4040_length_1182_cov_64.600185	641	721	10	34	80	0.4250000
NODE_4040_length_1182_cov_64.600185	717	797	0	48	80	0.6000000
NODE_4040_length_1182_cov_64.600185	717	797	2	32	80	0.4000000
NODE_4040_length_1182_cov_64.600185	770	849	0	79	79	1.0000000
NODE_4041_length_1182_cov_18.584488	487	557	6	20	70	0.2857143
NODE_4041_length_1182_cov_18.584488	487	557	8	27	70	0.3857143
NODE_4041_length_1182_cov_18.584488	487	557	10	23	70	0.3285714
NODE_4041_length_1182_cov_18.584488	536	612	0	8	76	0.1052632
NODE_4041_length_1182_cov_18.584488	536	612	2	17	76	0.2236842
NODE_4041_length_1182_cov_18.584488	536	612	4	28	76	0.3684210
NODE_4041_length_1182_cov_18.584488	536	612	10	23	76	0.3026316
NODE_4041_length_1182_cov_18.584488	608	688	0	75	80	0.9375000
NODE_4041_length_1182_cov_18.584488	608	688	2	5	80	0.0625000
NODE_4041_length_1182_cov_18.584488	671	741	0	18	70	0.2571429
NODE_4041_length_1182_cov_18.584488	671	741	2	52	70	0.7428572
NODE_4042_length_1182_cov_18.075716	598	678	0	80	80	1.0000000
NODE_4042_length_1182_cov_18.075716	651	731	0	80	80	1.0000000
NODE_4042_length_1182_cov_18.075716	727	807	0	80	80	1.0000000
NODE_4042_length_1182_cov_18.075716	780	860	0	80	80	1.0000000
NODE_4043_length_1182_cov_8.716528	464	544	0	42	80	0.5250000
NODE_4043_length_1182_cov_8.716528	464	544	2	38	80	0.4750000
NODE_4043_length_1182_cov_8.716528	517	597	2	80	80	1.0000000
NODE_4044_length_1182_cov_4.109880	793	873	0	80	80	1.0000000
NODE_4044_length_1182_cov_4.109880	846	926	0	80	80	1.0000000
NODE_4045_length_1182_cov_3.433980	1052	1100	0	9	48	0.1875000
NODE_4045_length_1182_cov_3.433980	1052	1100	2	39	48	0.8125000
NODE_4050_length_1181_cov_13.856747	687	767	0	26	80	0.3250000
NODE_4050_length_1181_cov_13.856747	687	767	2	54	80	0.6750000
NODE_4050_length_1181_cov_13.856747	740	820	2	80	80	1.0000000
NODE_4051_length_1181_cov_8.239372	735	815	0	80	80	1.0000000
NODE_4059_length_1180_cov_46.345051	695	775	0	80	80	1.0000000
NODE_4059_length_1180_cov_46.345051	748	828	0	80	80	1.0000000
NODE_4066_length_1179_cov_93.272222	660	740	215	1	80	0.0125000
NODE_4066_length_1179_cov_93.272222	660	740	219	1	80	0.0125000
NODE_4066_length_1179_cov_93.272222	660	740	221	1	80	0.0125000
NODE_4066_length_1179_cov_93.272222	660	740	227	5	80	0.0625000
NODE_4066_length_1179_cov_93.272222	660	740	229	2	80	0.0250000
NODE_4066_length_1179_cov_93.272222	660	740	230	3	80	0.0375000
NODE_4066_length_1179_cov_93.272222	660	740	232	1	80	0.0125000
NODE_4066_length_1179_cov_93.272222	660	740	237	3	80	0.0375000
NODE_4066_length_1179_cov_93.272222	660	740	239	1	80	0.0125000
NODE_4066_length_1179_cov_93.272222	660	740	244	1	80	0.0125000
NODE_4066_length_1179_cov_93.272222	660	740	248	4	80	0.0500000
NODE_4066_length_1179_cov_93.272222	660	740	250	2	80	0.0250000
NODE_4066_length_1179_cov_93.272222	660	740	251	1	80	0.0125000
NODE_4066_length_1179_cov_93.272222	660	740	252	3	80	0.0375000
NODE_4066_length_1179_cov_93.272222	660	740	260	1	80	0.0125000
NODE_4066_length_1179_cov_93.272222	660	740	264	1	80	0.0125000
NODE_4066_length_1179_cov_93.272222	660	740	266	1	80	0.0125000
NODE_4066_length_1179_cov_93.272222	660	740	268	2	80	0.0250000
NODE_4066_length_1179_cov_93.272222	660	740	270	1	80	0.0125000
NODE_4066_length_1179_cov_93.272222	660	740	271	2	80	0.0250000
NODE_4066_length_1179_cov_93.272222	660	740	273	3	80	0.0375000
NODE_4066_length_1179_cov_93.272222	660	740	274	2	80	0.0250000
NODE_4066_length_1179_cov_93.272222	660	740	275	8	80	0.1000000
NODE_4066_length_1179_cov_93.272222	660	740	276	4	80	0.0500000
NODE_4066_length_1179_cov_93.272222	660	740	277	2	80	0.0250000
NODE_4066_length_1179_cov_93.272222	660	740	278	2	80	0.0250000
NODE_4066_length_1179_cov_93.272222	660	740	279	2	80	0.0250000
NODE_4066_length_1179_cov_93.272222	660	740	281	3	80	0.0375000
NODE_4066_length_1179_cov_93.272222	660	740	283	2	80	0.0250000
NODE_4066_length_1179_cov_93.272222	660	740	289	3	80	0.0375000
NODE_4066_length_1179_cov_93.272222	660	740	290	1	80	0.0125000
NODE_4066_length_1179_cov_93.272222	660	740	291	1	80	0.0125000
NODE_4066_length_1179_cov_93.272222	660	740	292	1	80	0.0125000
NODE_4066_length_1179_cov_93.272222	660	740	293	2	80	0.0250000
NODE_4066_length_1179_cov_93.272222	660	740	295	1	80	0.0125000
NODE_4066_length_1179_cov_93.272222	660	740	296	1	80	0.0125000
NODE_4066_length_1179_cov_93.272222	660	740	297	5	80	0.0625000
NODE_4066_length_1179_cov_93.272222	713	793	114	2	80	0.0250000
NODE_4066_length_1179_cov_93.272222	713	793	116	1	80	0.0125000
NODE_4066_length_1179_cov_93.272222	713	793	120	1	80	0.0125000
NODE_4066_length_1179_cov_93.272222	713	793	121	1	80	0.0125000
NODE_4066_length_1179_cov_93.272222	713	793	129	1	80	0.0125000
NODE_4066_length_1179_cov_93.272222	713	793	134	1	80	0.0125000
NODE_4066_length_1179_cov_93.272222	713	793	142	2	80	0.0250000
NODE_4066_length_1179_cov_93.272222	713	793	143	1	80	0.0125000
NODE_4066_length_1179_cov_93.272222	713	793	145	1	80	0.0125000
NODE_4066_length_1179_cov_93.272222	713	793	158	1	80	0.0125000
NODE_4066_length_1179_cov_93.272222	713	793	162	2	80	0.0250000
NODE_4066_length_1179_cov_93.272222	713	793	164	1	80	0.0125000
NODE_4066_length_1179_cov_93.272222	713	793	166	1	80	0.0125000
NODE_4066_length_1179_cov_93.272222	713	793	174	1	80	0.0125000
NODE_4066_length_1179_cov_93.272222	713	793	175	3	80	0.0375000
NODE_4066_length_1179_cov_93.272222	713	793	187	5	80	0.0625000
NODE_4066_length_1179_cov_93.272222	713	793	188	4	80	0.0500000
NODE_4066_length_1179_cov_93.272222	713	793	189	2	80	0.0250000
NODE_4066_length_1179_cov_93.272222	713	793	190	3	80	0.0375000
NODE_4066_length_1179_cov_93.272222	713	793	191	1	80	0.0125000
NODE_4066_length_1179_cov_93.272222	713	793	192	4	80	0.0500000
NODE_4066_length_1179_cov_93.272222	713	793	194	1	80	0.0125000
NODE_4066_length_1179_cov_93.272222	713	793	195	3	80	0.0375000
NODE_4066_length_1179_cov_93.272222	713	793	196	7	80	0.0875000
NODE_4066_length_1179_cov_93.272222	713	793	200	1	80	0.0125000
NODE_4066_length_1179_cov_93.272222	713	793	202	2	80	0.0250000
NODE_4066_length_1179_cov_93.272222	713	793	215	1	80	0.0125000
NODE_4066_length_1179_cov_93.272222	713	793	219	1	80	0.0125000
NODE_4066_length_1179_cov_93.272222	713	793	221	1	80	0.0125000
NODE_4066_length_1179_cov_93.272222	713	793	227	5	80	0.0625000
NODE_4066_length_1179_cov_93.272222	713	793	229	2	80	0.0250000
NODE_4066_length_1179_cov_93.272222	713	793	230	3	80	0.0375000
NODE_4066_length_1179_cov_93.272222	713	793	232	1	80	0.0125000
NODE_4066_length_1179_cov_93.272222	713	793	237	3	80	0.0375000
NODE_4066_length_1179_cov_93.272222	713	793	239	1	80	0.0125000
NODE_4066_length_1179_cov_93.272222	713	793	244	1	80	0.0125000
NODE_4066_length_1179_cov_93.272222	713	793	248	4	80	0.0500000
NODE_4066_length_1179_cov_93.272222	713	793	250	2	80	0.0250000
NODE_4066_length_1179_cov_93.272222	713	793	252	2	80	0.0250000
NODE_4067_length_1179_cov_55.355556	547	627	0	9	80	0.1125000
NODE_4067_length_1179_cov_55.355556	547	627	2	43	80	0.5375000
NODE_4067_length_1179_cov_55.355556	547	627	4	21	80	0.2625000
NODE_4067_length_1179_cov_55.355556	547	627	6	7	80	0.0875000
NODE_4067_length_1179_cov_55.355556	600	680	4	20	80	0.2500000
NODE_4067_length_1179_cov_55.355556	600	680	6	34	80	0.4250000
NODE_4067_length_1179_cov_55.355556	600	680	8	26	80	0.3250000
NODE_4068_length_1179_cov_29.712037	613	693	0	9	80	0.1125000
NODE_4068_length_1179_cov_29.712037	613	693	7	39	80	0.4875000
NODE_4068_length_1179_cov_29.712037	613	693	8	32	80	0.4000000
NODE_4068_length_1179_cov_29.712037	666	746	0	23	80	0.2875000
NODE_4068_length_1179_cov_29.712037	666	746	8	57	80	0.7125000
NODE_4069_length_1179_cov_26.767593	483	563	8	26	80	0.3250000
NODE_4069_length_1179_cov_26.767593	483	563	12	54	80	0.6750000
NODE_4069_length_1179_cov_26.767593	536	616	0	24	80	0.3000000
NODE_4069_length_1179_cov_26.767593	536	616	4	12	80	0.1500000
NODE_4069_length_1179_cov_26.767593	536	616	11	13	80	0.1625000
NODE_4069_length_1179_cov_26.767593	536	616	12	31	80	0.3875000
NODE_4069_length_1179_cov_26.767593	612	692	0	80	80	1.0000000
NODE_4069_length_1179_cov_26.767593	665	745	0	80	80	1.0000000
NODE_4070_length_1179_cov_22.249074	581	661	0	6	80	0.0750000
NODE_4070_length_1179_cov_22.249074	581	661	4	19	80	0.2375000
NODE_4070_length_1179_cov_22.249074	581	661	6	12	80	0.1500000
NODE_4070_length_1179_cov_22.249074	581	661	8	43	80	0.5375000
NODE_4070_length_1179_cov_22.249074	634	714	0	59	80	0.7375000
NODE_4070_length_1179_cov_22.249074	634	714	4	19	80	0.2375000
NODE_4070_length_1179_cov_22.249074	634	714	6	2	80	0.0250000
NODE_4071_length_1179_cov_16.538889	498	568	4	40	70	0.5714286
NODE_4071_length_1179_cov_16.538889	498	568	6	7	70	0.1000000
NODE_4071_length_1179_cov_16.538889	498	568	8	23	70	0.3285714
NODE_4072_length_1179_cov_15.442593	535	615	0	80	80	1.0000000
NODE_4072_length_1179_cov_15.442593	588	668	0	80	80	1.0000000
NODE_4076_length_1179_cov_2.419444	1108	1155	0	47	47	1.0000000
NODE_4078_length_1179_cov_1.009259	944	1024	0	80	80	1.0000000
NODE_4078_length_1179_cov_1.009259	997	1077	0	80	80	1.0000000
NODE_4079_length_1178_cov_42.484708	423	503	0	80	80	1.0000000
NODE_4079_length_1178_cov_42.484708	476	556	0	80	80	1.0000000
NODE_4079_length_1178_cov_42.484708	552	632	0	80	80	1.0000000
NODE_4079_length_1178_cov_42.484708	605	685	0	80	80	1.0000000
NODE_4080_length_1178_cov_15.332715	215	295	0	80	80	1.0000000
NODE_4080_length_1178_cov_15.332715	268	348	0	80	80	1.0000000
NODE_4081_length_1178_cov_11.403151	527	607	0	80	80	1.0000000
NODE_4081_length_1178_cov_11.403151	580	660	0	80	80	1.0000000
NODE_4084_length_1177_cov_34.920223	369	449	0	80	80	1.0000000
NODE_4084_length_1177_cov_34.920223	422	502	0	80	80	1.0000000
NODE_4084_length_1177_cov_34.920223	498	578	0	80	80	1.0000000
NODE_4084_length_1177_cov_34.920223	551	631	0	80	80	1.0000000
NODE_4085_length_1177_cov_12.186456	481	561	0	41	80	0.5125000
NODE_4085_length_1177_cov_12.186456	481	561	6	39	80	0.4875000
NODE_4085_length_1177_cov_12.186456	534	614	0	80	80	1.0000000
NODE_4085_length_1177_cov_12.186456	610	690	0	69	80	0.8625000
NODE_4085_length_1177_cov_12.186456	610	690	2	11	80	0.1375000
NODE_4085_length_1177_cov_12.186456	663	743	0	16	80	0.2000000
NODE_4085_length_1177_cov_12.186456	663	743	2	64	80	0.8000000
NODE_4086_length_1177_cov_11.926716	443	523	0	60	80	0.7500000
NODE_4086_length_1177_cov_11.926716	443	523	2	20	80	0.2500000
NODE_4086_length_1177_cov_11.926716	496	578	0	7	82	0.0853659
NODE_4086_length_1177_cov_11.926716	496	578	2	75	82	0.9146342
NODE_4088_length_1177_cov_5.923933	358	438	0	80	80	1.0000000
NODE_4088_length_1177_cov_5.923933	411	491	0	80	80	1.0000000
NODE_4089_length_1177_cov_5.775510	760	840	0	80	80	1.0000000
NODE_4089_length_1177_cov_5.775510	813	893	0	80	80	1.0000000
NODE_4096_length_1176_cov_26.994429	377	457	0	80	80	1.0000000
NODE_4096_length_1176_cov_26.994429	430	510	0	78	80	0.9750000
NODE_4096_length_1176_cov_26.994429	430	510	2	2	80	0.0250000
NODE_4096_length_1176_cov_26.994429	506	586	0	2	80	0.0250000
NODE_4096_length_1176_cov_26.994429	506	586	2	78	80	0.9750000
NODE_4096_length_1176_cov_26.994429	559	639	0	52	80	0.6500000
NODE_4096_length_1176_cov_26.994429	559	639	2	28	80	0.3500000
NODE_4097_length_1176_cov_15.766945	531	611	0	80	80	1.0000000
NODE_4097_length_1176_cov_15.766945	584	664	0	80	80	1.0000000
NODE_4098_length_1176_cov_14.882080	628	708	0	23	80	0.2875000
NODE_4098_length_1176_cov_14.882080	628	708	2	57	80	0.7125000
NODE_4098_length_1176_cov_14.882080	681	761	2	27	80	0.3375000
NODE_4098_length_1176_cov_14.882080	681	761	4	53	80	0.6625000
NODE_4099_length_1176_cov_10.692665	392	472	0	45	80	0.5625000
NODE_4099_length_1176_cov_10.692665	392	472	4	35	80	0.4375000
NODE_4099_length_1176_cov_10.692665	445	525	0	13	80	0.1625000
NODE_4099_length_1176_cov_10.692665	445	525	4	67	80	0.8375000
NODE_4106_length_1175_cov_50.754647	526	606	0	76	80	0.9500000
NODE_4106_length_1175_cov_50.754647	526	606	2	4	80	0.0500000
NODE_4106_length_1175_cov_50.754647	579	659	0	80	80	1.0000000
NODE_4107_length_1175_cov_42.638476	327	407	10	20	80	0.2500000
NODE_4107_length_1175_cov_42.638476	327	407	15	1	80	0.0125000
NODE_4107_length_1175_cov_42.638476	327	407	17	21	80	0.2625000
NODE_4107_length_1175_cov_42.638476	327	407	18	9	80	0.1125000
NODE_4107_length_1175_cov_42.638476	327	407	19	7	80	0.0875000
NODE_4107_length_1175_cov_42.638476	327	407	23	22	80	0.2750000
NODE_4107_length_1175_cov_42.638476	380	460	19	5	80	0.0625000
NODE_4107_length_1175_cov_42.638476	380	460	21	6	80	0.0750000
NODE_4107_length_1175_cov_42.638476	380	460	22	13	80	0.1625000
NODE_4107_length_1175_cov_42.638476	380	460	23	44	80	0.5500000
NODE_4107_length_1175_cov_42.638476	380	460	24	12	80	0.1500000
NODE_4107_length_1175_cov_42.638476	456	536	0	4	80	0.0500000
NODE_4107_length_1175_cov_42.638476	456	536	2	35	80	0.4375000
NODE_4107_length_1175_cov_42.638476	456	536	9	2	80	0.0250000
NODE_4107_length_1175_cov_42.638476	456	536	10	23	80	0.2875000
NODE_4107_length_1175_cov_42.638476	456	536	14	1	80	0.0125000
NODE_4107_length_1175_cov_42.638476	456	536	21	15	80	0.1875000
NODE_4107_length_1175_cov_42.638476	509	589	0	27	80	0.3375000
NODE_4107_length_1175_cov_42.638476	509	589	2	53	80	0.6625000
NODE_4108_length_1175_cov_40.217472	437	517	0	71	80	0.8875000
NODE_4108_length_1175_cov_40.217472	437	517	4	9	80	0.1125000
NODE_4108_length_1175_cov_40.217472	490	570	0	18	80	0.2250000
NODE_4108_length_1175_cov_40.217472	490	570	4	62	80	0.7750000
NODE_4108_length_1175_cov_40.217472	566	646	0	12	80	0.1500000
NODE_4108_length_1175_cov_40.217472	566	646	3	1	80	0.0125000
NODE_4108_length_1175_cov_40.217472	566	646	4	67	80	0.8375000
NODE_4108_length_1175_cov_40.217472	619	699	2	11	80	0.1375000
NODE_4108_length_1175_cov_40.217472	619	699	3	1	80	0.0125000
NODE_4108_length_1175_cov_40.217472	619	699	4	58	80	0.7250000
NODE_4108_length_1175_cov_40.217472	619	699	6	10	80	0.1250000
NODE_4109_length_1175_cov_12.834572	775	855	0	22	80	0.2750000
NODE_4109_length_1175_cov_12.834572	775	855	2	58	80	0.7250000
NODE_4109_length_1175_cov_12.834572	828	908	0	36	80	0.4500000
NODE_4109_length_1175_cov_12.834572	828	908	2	44	80	0.5500000
NODE_4115_length_1174_cov_20.569302	433	513	2	17	80	0.2125000
NODE_4115_length_1174_cov_20.569302	433	513	4	63	80	0.7875000
NODE_4115_length_1174_cov_20.569302	486	566	0	31	80	0.3875000
NODE_4115_length_1174_cov_20.569302	486	566	2	22	80	0.2750000
NODE_4115_length_1174_cov_20.569302	486	566	4	27	80	0.3375000
NODE_4115_length_1174_cov_20.569302	562	642	0	80	80	1.0000000
NODE_4115_length_1174_cov_20.569302	615	695	0	80	80	1.0000000
NODE_4116_length_1174_cov_18.797209	578	658	0	60	80	0.7500000
NODE_4116_length_1174_cov_18.797209	578	658	2	20	80	0.2500000
NODE_4116_length_1174_cov_18.797209	631	711	0	7	80	0.0875000
NODE_4116_length_1174_cov_18.797209	631	711	2	73	80	0.9125000
NODE_4117_length_1174_cov_17.486512	589	669	0	24	80	0.3000000
NODE_4117_length_1174_cov_17.486512	589	669	2	56	80	0.7000000
NODE_4117_length_1174_cov_17.486512	642	722	2	53	80	0.6625000
NODE_4117_length_1174_cov_17.486512	642	722	4	27	80	0.3375000
NODE_4118_length_1174_cov_15.888372	570	650	0	80	80	1.0000000
NODE_4118_length_1174_cov_15.888372	623	703	0	80	80	1.0000000
NODE_4118_length_1174_cov_15.888372	699	779	0	80	80	1.0000000
NODE_4118_length_1174_cov_15.888372	752	832	0	80	80	1.0000000
NODE_4124_length_1174_cov_1.536744	1066	1115	0	49	49	1.0000000
NODE_4124_length_1174_cov_1.536744	1088	1168	0	80	80	1.0000000
NODE_4128_length_1173_cov_29.562384	455	535	0	80	80	1.0000000
NODE_4128_length_1173_cov_29.562384	508	588	0	80	80	1.0000000
NODE_4128_length_1173_cov_29.562384	584	664	0	80	80	1.0000000
NODE_4128_length_1173_cov_29.562384	637	717	0	51	80	0.6375000
NODE_4128_length_1173_cov_29.562384	637	717	2	29	80	0.3625000
NODE_4129_length_1173_cov_25.206704	395	475	0	29	80	0.3625000
NODE_4129_length_1173_cov_25.206704	395	475	6	51	80	0.6375000
NODE_4129_length_1173_cov_25.206704	448	528	0	80	80	1.0000000
NODE_4130_length_1173_cov_9.486965	693	773	12	24	80	0.3000000
NODE_4130_length_1173_cov_9.486965	693	773	14	44	80	0.5500000
NODE_4130_length_1173_cov_9.486965	693	773	16	12	80	0.1500000
NODE_4130_length_1173_cov_9.486965	746	826	6	33	80	0.4125000
NODE_4130_length_1173_cov_9.486965	746	826	12	44	80	0.5500000
NODE_4130_length_1173_cov_9.486965	746	826	14	3	80	0.0375000
NODE_4131_length_1173_cov_7.946927	201	281	0	80	80	1.0000000
NODE_4131_length_1173_cov_7.946927	254	334	0	80	80	1.0000000
NODE_4136_length_1172_cov_37.177074	527	607	0	80	80	1.0000000
NODE_4136_length_1172_cov_37.177074	580	660	0	80	80	1.0000000
NODE_4137_length_1172_cov_20.397018	677	757	0	80	80	1.0000000
NODE_4137_length_1172_cov_20.397018	730	810	0	80	80	1.0000000
NODE_4138_length_1172_cov_15.018639	460	540	0	80	80	1.0000000
NODE_4138_length_1172_cov_15.018639	513	593	0	80	80	1.0000000
NODE_4139_length_1172_cov_13.199441	622	702	0	80	80	1.0000000
NODE_4139_length_1172_cov_13.199441	675	755	0	80	80	1.0000000
NODE_4140_length_1172_cov_10.720410	499	579	2	24	80	0.3000000
NODE_4140_length_1172_cov_10.720410	499	579	4	56	80	0.7000000
NODE_4140_length_1172_cov_10.720410	552	632	0	37	80	0.4625000
NODE_4140_length_1172_cov_10.720410	552	632	2	24	80	0.3000000
NODE_4140_length_1172_cov_10.720410	552	632	4	19	80	0.2375000
NODE_4140_length_1172_cov_10.720410	628	708	0	26	80	0.3250000
NODE_4140_length_1172_cov_10.720410	628	708	8	54	80	0.6750000
NODE_4140_length_1172_cov_10.720410	681	761	8	49	80	0.6125000
NODE_4140_length_1172_cov_10.720410	681	761	10	31	80	0.3875000
NODE_4141_length_1172_cov_10.574091	951	1021	14	9	70	0.1285714
NODE_4141_length_1172_cov_10.574091	951	1021	16	8	70	0.1142857
NODE_4141_length_1172_cov_10.574091	951	1021	19	1	70	0.0142857
NODE_4141_length_1172_cov_10.574091	951	1021	20	36	70	0.5142857
NODE_4141_length_1172_cov_10.574091	951	1021	22	16	70	0.2285714
NODE_4142_length_1172_cov_9.204101	276	356	0	80	80	1.0000000
NODE_4142_length_1172_cov_9.204101	329	409	0	80	80	1.0000000
NODE_4148_length_1171_cov_13.311567	666	746	0	14	80	0.1750000
NODE_4148_length_1171_cov_13.311567	666	746	2	30	80	0.3750000
NODE_4148_length_1171_cov_13.311567	666	746	4	36	80	0.4500000
NODE_4148_length_1171_cov_13.311567	719	803	2	15	84	0.1785714
NODE_4148_length_1171_cov_13.311567	719	803	4	69	84	0.8214286
NODE_4149_length_1171_cov_9.154851	198	278	0	80	80	1.0000000
NODE_4149_length_1171_cov_9.154851	251	331	0	80	80	1.0000000
NODE_4157_length_1170_cov_65.480859	402	482	0	80	80	1.0000000
NODE_4157_length_1170_cov_65.480859	455	535	0	80	80	1.0000000
NODE_4158_length_1170_cov_35.283847	704	784	0	3	80	0.0375000
NODE_4158_length_1170_cov_35.283847	704	784	1	77	80	0.9625000
NODE_4158_length_1170_cov_35.283847	757	837	1	80	80	1.0000000
NODE_4159_length_1170_cov_23.600373	450	530	0	80	80	1.0000000
NODE_4159_length_1170_cov_23.600373	503	583	0	80	80	1.0000000
NODE_4159_length_1170_cov_23.600373	579	659	0	80	80	1.0000000
NODE_4159_length_1170_cov_23.600373	632	705	0	73	73	1.0000000
NODE_4160_length_1170_cov_19.783380	325	405	0	80	80	1.0000000
NODE_4160_length_1170_cov_19.783380	378	458	0	80	80	1.0000000
NODE_4168_length_1169_cov_61.689720	464	544	6	12	80	0.1500000
NODE_4168_length_1169_cov_61.689720	464	544	10	11	80	0.1375000
NODE_4168_length_1169_cov_61.689720	464	544	12	23	80	0.2875000
NODE_4168_length_1169_cov_61.689720	464	544	14	18	80	0.2250000
NODE_4168_length_1169_cov_61.689720	464	544	20	16	80	0.2000000
NODE_4168_length_1169_cov_61.689720	517	597	4	4	80	0.0500000
NODE_4168_length_1169_cov_61.689720	517	597	6	5	80	0.0625000
NODE_4168_length_1169_cov_61.689720	517	597	8	12	80	0.1500000
NODE_4168_length_1169_cov_61.689720	517	597	10	15	80	0.1875000
NODE_4168_length_1169_cov_61.689720	517	597	14	11	80	0.1375000
NODE_4168_length_1169_cov_61.689720	517	597	16	14	80	0.1750000
NODE_4168_length_1169_cov_61.689720	517	597	20	19	80	0.2375000
NODE_4168_length_1169_cov_61.689720	593	673	0	24	80	0.3000000
NODE_4168_length_1169_cov_61.689720	593	673	4	56	80	0.7000000
NODE_4168_length_1169_cov_61.689720	646	726	0	77	80	0.9625000
NODE_4168_length_1169_cov_61.689720	646	726	4	3	80	0.0375000
NODE_4169_length_1169_cov_55.247664	640	720	8	17	80	0.2125000
NODE_4169_length_1169_cov_55.247664	640	720	12	46	80	0.5750000
NODE_4169_length_1169_cov_55.247664	640	720	16	17	80	0.2125000
NODE_4169_length_1169_cov_55.247664	693	773	8	32	80	0.4000000
NODE_4169_length_1169_cov_55.247664	693	773	10	16	80	0.2000000
NODE_4169_length_1169_cov_55.247664	693	773	12	10	80	0.1250000
NODE_4169_length_1169_cov_55.247664	693	773	16	22	80	0.2750000
NODE_4170_length_1169_cov_39.016822	447	527	2	16	80	0.2000000
NODE_4170_length_1169_cov_39.016822	447	527	4	47	80	0.5875000
NODE_4170_length_1169_cov_39.016822	447	527	6	17	80	0.2125000
NODE_4170_length_1169_cov_39.016822	500	580	0	19	80	0.2375000
NODE_4170_length_1169_cov_39.016822	500	580	4	61	80	0.7625000
NODE_4170_length_1169_cov_39.016822	576	656	0	80	80	1.0000000
NODE_4170_length_1169_cov_39.016822	629	709	0	80	80	1.0000000
NODE_4171_length_1169_cov_35.383178	582	662	0	80	80	1.0000000
NODE_4171_length_1169_cov_35.383178	635	715	0	80	80	1.0000000
NODE_4173_length_1169_cov_12.010280	338	418	0	76	80	0.9500000
NODE_4173_length_1169_cov_12.010280	338	418	2	4	80	0.0500000
NODE_4173_length_1169_cov_12.010280	391	471	0	23	80	0.2875000
NODE_4173_length_1169_cov_12.010280	391	471	2	57	80	0.7125000
NODE_4175_length_1169_cov_4.172897	74	135	0	61	61	1.0000000
NODE_4175_length_1169_cov_4.172897	74	135	0	61	61	1.0000000
NODE_4175_length_1169_cov_4.172897	74	135	0	61	61	1.0000000
NODE_4183_length_1168_cov_27.350795	517	597	0	43	80	0.5375000
NODE_4183_length_1168_cov_27.350795	517	597	8	37	80	0.4625000
NODE_4183_length_1168_cov_27.350795	570	650	8	80	80	1.0000000
NODE_4183_length_1168_cov_27.350795	646	726	0	4	80	0.0500000
NODE_4183_length_1168_cov_27.350795	646	726	6	43	80	0.5375000
NODE_4183_length_1168_cov_27.350795	646	726	7	6	80	0.0750000
NODE_4183_length_1168_cov_27.350795	646	726	8	23	80	0.2875000
NODE_4183_length_1168_cov_27.350795	646	726	10	4	80	0.0500000
NODE_4183_length_1168_cov_27.350795	699	779	6	10	80	0.1250000
NODE_4183_length_1168_cov_27.350795	699	779	7	6	80	0.0750000
NODE_4183_length_1168_cov_27.350795	699	779	8	47	80	0.5875000
NODE_4183_length_1168_cov_27.350795	699	779	9	1	80	0.0125000
NODE_4183_length_1168_cov_27.350795	699	779	10	16	80	0.2000000
NODE_4184_length_1168_cov_25.777362	672	752	0	80	80	1.0000000
NODE_4184_length_1168_cov_25.777362	725	805	0	80	80	1.0000000
NODE_4185_length_1168_cov_25.295603	543	623	2	19	80	0.2375000
NODE_4185_length_1168_cov_25.295603	543	623	5	1	80	0.0125000
NODE_4185_length_1168_cov_25.295603	543	623	6	23	80	0.2875000
NODE_4185_length_1168_cov_25.295603	543	623	8	19	80	0.2375000
NODE_4185_length_1168_cov_25.295603	543	623	10	18	80	0.2250000
NODE_4185_length_1168_cov_25.295603	596	676	4	10	80	0.1250000
NODE_4185_length_1168_cov_25.295603	596	676	8	62	80	0.7750000
NODE_4185_length_1168_cov_25.295603	596	676	10	8	80	0.1000000
NODE_4185_length_1168_cov_25.295603	672	752	0	29	80	0.3625000
NODE_4185_length_1168_cov_25.295603	672	752	2	36	80	0.4500000
NODE_4185_length_1168_cov_25.295603	672	752	3	1	80	0.0125000
NODE_4185_length_1168_cov_25.295603	672	752	4	14	80	0.1750000
NODE_4185_length_1168_cov_25.295603	725	804	2	79	79	1.0000000
NODE_4186_length_1168_cov_20.202058	434	514	0	80	80	1.0000000
NODE_4186_length_1168_cov_20.202058	487	567	0	37	80	0.4625000
NODE_4186_length_1168_cov_20.202058	487	567	1	28	80	0.3500000
NODE_4186_length_1168_cov_20.202058	487	567	3	15	80	0.1875000
NODE_4187_length_1168_cov_16.787652	405	485	13	7	80	0.0875000
NODE_4187_length_1168_cov_16.787652	405	485	15	6	80	0.0750000
NODE_4187_length_1168_cov_16.787652	405	485	21	20	80	0.2500000
NODE_4187_length_1168_cov_16.787652	405	485	22	21	80	0.2625000
NODE_4187_length_1168_cov_16.787652	405	485	23	17	80	0.2125000
NODE_4187_length_1168_cov_16.787652	405	485	25	9	80	0.1125000
NODE_4187_length_1168_cov_16.787652	458	538	5	23	80	0.2875000
NODE_4187_length_1168_cov_16.787652	458	538	11	5	80	0.0625000
NODE_4187_length_1168_cov_16.787652	458	538	15	1	80	0.0125000
NODE_4187_length_1168_cov_16.787652	458	538	21	14	80	0.1750000
NODE_4187_length_1168_cov_16.787652	458	538	22	15	80	0.1875000
NODE_4187_length_1168_cov_16.787652	458	538	23	22	80	0.2750000
NODE_4188_length_1168_cov_10.079514	722	802	2	5	80	0.0625000
NODE_4188_length_1168_cov_10.079514	722	802	6	75	80	0.9375000
NODE_4188_length_1168_cov_10.079514	775	855	0	47	80	0.5875000
NODE_4188_length_1168_cov_10.079514	775	855	4	6	80	0.0750000
NODE_4188_length_1168_cov_10.079514	775	855	6	27	80	0.3375000
NODE_4198_length_1167_cov_27.961610	591	671	10	12	80	0.1500000
NODE_4198_length_1167_cov_27.961610	591	671	12	21	80	0.2625000
NODE_4198_length_1167_cov_27.961610	591	671	14	21	80	0.2625000
NODE_4198_length_1167_cov_27.961610	591	671	16	26	80	0.3250000
NODE_4198_length_1167_cov_27.961610	644	724	2	5	80	0.0625000
NODE_4198_length_1167_cov_27.961610	644	724	4	11	80	0.1375000
NODE_4198_length_1167_cov_27.961610	644	724	6	2	80	0.0250000
NODE_4198_length_1167_cov_27.961610	644	724	10	12	80	0.1500000
NODE_4198_length_1167_cov_27.961610	644	724	11	2	80	0.0250000
NODE_4198_length_1167_cov_27.961610	644	724	12	48	80	0.6000000
NODE_4199_length_1167_cov_12.393258	670	750	0	80	80	1.0000000
NODE_4199_length_1167_cov_12.393258	723	803	0	80	80	1.0000000
NODE_4200_length_1167_cov_11.189139	434	514	0	80	80	1.0000000
NODE_4200_length_1167_cov_11.189139	487	567	0	80	80	1.0000000
NODE_4201_length_1167_cov_7.998127	711	791	0	30	80	0.3750000
NODE_4201_length_1167_cov_7.998127	711	791	2	50	80	0.6250000
NODE_4201_length_1167_cov_7.998127	764	844	0	22	80	0.2750000
NODE_4201_length_1167_cov_7.998127	764	844	2	58	80	0.7250000
NODE_4206_length_1166_cov_313.815370	444	524	167	7	80	0.0875000
NODE_4206_length_1166_cov_313.815370	444	524	174	1	80	0.0125000
NODE_4206_length_1166_cov_313.815370	444	524	175	4	80	0.0500000
NODE_4206_length_1166_cov_313.815370	444	524	180	1	80	0.0125000
NODE_4206_length_1166_cov_313.815370	444	524	236	1	80	0.0125000
NODE_4206_length_1166_cov_313.815370	444	524	245	1	80	0.0125000
NODE_4206_length_1166_cov_313.815370	444	524	299	1	80	0.0125000
NODE_4206_length_1166_cov_313.815370	444	524	335	1	80	0.0125000
NODE_4206_length_1166_cov_313.815370	444	524	338	1	80	0.0125000
NODE_4206_length_1166_cov_313.815370	444	524	339	1	80	0.0125000
NODE_4206_length_1166_cov_313.815370	444	524	346	1	80	0.0125000
NODE_4206_length_1166_cov_313.815370	444	524	354	1	80	0.0125000
NODE_4206_length_1166_cov_313.815370	444	524	356	1	80	0.0125000
NODE_4206_length_1166_cov_313.815370	444	524	359	3	80	0.0375000
NODE_4206_length_1166_cov_313.815370	444	524	377	1	80	0.0125000
NODE_4206_length_1166_cov_313.815370	444	524	381	2	80	0.0250000
NODE_4206_length_1166_cov_313.815370	444	524	409	2	80	0.0250000
NODE_4206_length_1166_cov_313.815370	444	524	414	1	80	0.0125000
NODE_4206_length_1166_cov_313.815370	444	524	423	1	80	0.0125000
NODE_4206_length_1166_cov_313.815370	444	524	429	1	80	0.0125000
NODE_4206_length_1166_cov_313.815370	444	524	478	1	80	0.0125000
NODE_4206_length_1166_cov_313.815370	444	524	486	1	80	0.0125000
NODE_4206_length_1166_cov_313.815370	444	524	520	1	80	0.0125000
NODE_4206_length_1166_cov_313.815370	444	524	539	1	80	0.0125000
NODE_4206_length_1166_cov_313.815370	444	524	544	1	80	0.0125000
NODE_4206_length_1166_cov_313.815370	444	524	565	1	80	0.0125000
NODE_4206_length_1166_cov_313.815370	444	524	576	2	80	0.0250000
NODE_4206_length_1166_cov_313.815370	444	524	590	1	80	0.0125000
NODE_4206_length_1166_cov_313.815370	444	524	599	2	80	0.0250000
NODE_4206_length_1166_cov_313.815370	444	524	607	1	80	0.0125000
NODE_4206_length_1166_cov_313.815370	444	524	612	1	80	0.0125000
NODE_4206_length_1166_cov_313.815370	444	524	614	1	80	0.0125000
NODE_4206_length_1166_cov_313.815370	444	524	616	1	80	0.0125000
NODE_4206_length_1166_cov_313.815370	444	524	619	1	80	0.0125000
NODE_4206_length_1166_cov_313.815370	444	524	624	1	80	0.0125000
NODE_4206_length_1166_cov_313.815370	444	524	630	1	80	0.0125000
NODE_4206_length_1166_cov_313.815370	444	524	637	1	80	0.0125000
NODE_4206_length_1166_cov_313.815370	444	524	651	2	80	0.0250000
NODE_4206_length_1166_cov_313.815370	444	524	662	1	80	0.0125000
NODE_4206_length_1166_cov_313.815370	444	524	668	1	80	0.0125000
NODE_4206_length_1166_cov_313.815370	444	524	681	1	80	0.0125000
NODE_4206_length_1166_cov_313.815370	444	524	692	1	80	0.0125000
NODE_4206_length_1166_cov_313.815370	444	524	702	1	80	0.0125000
NODE_4206_length_1166_cov_313.815370	444	524	719	1	80	0.0125000
NODE_4206_length_1166_cov_313.815370	444	524	744	1	80	0.0125000
NODE_4206_length_1166_cov_313.815370	444	524	746	1	80	0.0125000
NODE_4206_length_1166_cov_313.815370	444	524	754	1	80	0.0125000
NODE_4206_length_1166_cov_313.815370	444	524	781	1	80	0.0125000
NODE_4206_length_1166_cov_313.815370	444	524	782	1	80	0.0125000
NODE_4206_length_1166_cov_313.815370	444	524	791	1	80	0.0125000
NODE_4206_length_1166_cov_313.815370	444	524	808	1	80	0.0125000
NODE_4206_length_1166_cov_313.815370	444	524	824	1	80	0.0125000
NODE_4206_length_1166_cov_313.815370	444	524	839	1	80	0.0125000
NODE_4206_length_1166_cov_313.815370	444	524	840	1	80	0.0125000
NODE_4206_length_1166_cov_313.815370	444	524	852	1	80	0.0125000
NODE_4206_length_1166_cov_313.815370	444	524	855	1	80	0.0125000
NODE_4206_length_1166_cov_313.815370	444	524	865	1	80	0.0125000
NODE_4206_length_1166_cov_313.815370	444	524	871	1	80	0.0125000
NODE_4206_length_1166_cov_313.815370	444	524	875	1	80	0.0125000
NODE_4206_length_1166_cov_313.815370	444	524	882	3	80	0.0375000
NODE_4206_length_1166_cov_313.815370	444	524	883	1	80	0.0125000
NODE_4206_length_1166_cov_313.815370	444	524	885	1	80	0.0125000
NODE_4206_length_1166_cov_313.815370	444	524	167	7	80	0.0875000
NODE_4206_length_1166_cov_313.815370	444	524	174	1	80	0.0125000
NODE_4206_length_1166_cov_313.815370	444	524	175	4	80	0.0500000
NODE_4206_length_1166_cov_313.815370	444	524	180	1	80	0.0125000
NODE_4206_length_1166_cov_313.815370	444	524	236	1	80	0.0125000
NODE_4206_length_1166_cov_313.815370	444	524	245	1	80	0.0125000
NODE_4206_length_1166_cov_313.815370	444	524	299	1	80	0.0125000
NODE_4206_length_1166_cov_313.815370	444	524	335	1	80	0.0125000
NODE_4206_length_1166_cov_313.815370	444	524	338	1	80	0.0125000
NODE_4206_length_1166_cov_313.815370	444	524	339	1	80	0.0125000
NODE_4206_length_1166_cov_313.815370	444	524	346	1	80	0.0125000
NODE_4206_length_1166_cov_313.815370	444	524	354	1	80	0.0125000
NODE_4206_length_1166_cov_313.815370	444	524	356	1	80	0.0125000
NODE_4206_length_1166_cov_313.815370	444	524	359	3	80	0.0375000
NODE_4206_length_1166_cov_313.815370	444	524	377	1	80	0.0125000
NODE_4206_length_1166_cov_313.815370	444	524	381	2	80	0.0250000
NODE_4206_length_1166_cov_313.815370	444	524	409	2	80	0.0250000
NODE_4206_length_1166_cov_313.815370	444	524	414	1	80	0.0125000
NODE_4206_length_1166_cov_313.815370	444	524	423	1	80	0.0125000
NODE_4206_length_1166_cov_313.815370	444	524	429	1	80	0.0125000
NODE_4206_length_1166_cov_313.815370	444	524	478	1	80	0.0125000
NODE_4206_length_1166_cov_313.815370	444	524	486	1	80	0.0125000
NODE_4206_length_1166_cov_313.815370	444	524	520	1	80	0.0125000
NODE_4206_length_1166_cov_313.815370	444	524	539	1	80	0.0125000
NODE_4206_length_1166_cov_313.815370	444	524	544	1	80	0.0125000
NODE_4206_length_1166_cov_313.815370	444	524	565	1	80	0.0125000
NODE_4206_length_1166_cov_313.815370	444	524	576	2	80	0.0250000
NODE_4206_length_1166_cov_313.815370	444	524	590	1	80	0.0125000
NODE_4206_length_1166_cov_313.815370	444	524	599	2	80	0.0250000
NODE_4206_length_1166_cov_313.815370	444	524	607	1	80	0.0125000
NODE_4206_length_1166_cov_313.815370	444	524	612	1	80	0.0125000
NODE_4206_length_1166_cov_313.815370	444	524	614	1	80	0.0125000
NODE_4206_length_1166_cov_313.815370	444	524	616	1	80	0.0125000
NODE_4206_length_1166_cov_313.815370	444	524	619	1	80	0.0125000
NODE_4206_length_1166_cov_313.815370	444	524	624	1	80	0.0125000
NODE_4206_length_1166_cov_313.815370	444	524	630	1	80	0.0125000
NODE_4206_length_1166_cov_313.815370	444	524	637	1	80	0.0125000
NODE_4206_length_1166_cov_313.815370	444	524	651	2	80	0.0250000
NODE_4206_length_1166_cov_313.815370	444	524	662	1	80	0.0125000
NODE_4206_length_1166_cov_313.815370	444	524	668	1	80	0.0125000
NODE_4206_length_1166_cov_313.815370	444	524	681	1	80	0.0125000
NODE_4206_length_1166_cov_313.815370	444	524	692	1	80	0.0125000
NODE_4206_length_1166_cov_313.815370	444	524	702	1	80	0.0125000
NODE_4206_length_1166_cov_313.815370	444	524	719	1	80	0.0125000
NODE_4206_length_1166_cov_313.815370	444	524	744	1	80	0.0125000
NODE_4206_length_1166_cov_313.815370	444	524	746	1	80	0.0125000
NODE_4206_length_1166_cov_313.815370	444	524	754	1	80	0.0125000
NODE_4206_length_1166_cov_313.815370	444	524	781	1	80	0.0125000
NODE_4206_length_1166_cov_313.815370	444	524	782	1	80	0.0125000
NODE_4206_length_1166_cov_313.815370	444	524	791	1	80	0.0125000
NODE_4206_length_1166_cov_313.815370	444	524	808	1	80	0.0125000
NODE_4206_length_1166_cov_313.815370	444	524	824	1	80	0.0125000
NODE_4206_length_1166_cov_313.815370	444	524	839	1	80	0.0125000
NODE_4206_length_1166_cov_313.815370	444	524	840	1	80	0.0125000
NODE_4206_length_1166_cov_313.815370	444	524	852	1	80	0.0125000
NODE_4206_length_1166_cov_313.815370	444	524	855	1	80	0.0125000
NODE_4206_length_1166_cov_313.815370	444	524	865	1	80	0.0125000
NODE_4206_length_1166_cov_313.815370	444	524	871	1	80	0.0125000
NODE_4206_length_1166_cov_313.815370	444	524	875	1	80	0.0125000
NODE_4206_length_1166_cov_313.815370	444	524	882	3	80	0.0375000
NODE_4206_length_1166_cov_313.815370	444	524	883	1	80	0.0125000
NODE_4206_length_1166_cov_313.815370	444	524	885	1	80	0.0125000
NODE_4206_length_1166_cov_313.815370	444	524	167	7	80	0.0875000
NODE_4206_length_1166_cov_313.815370	444	524	174	1	80	0.0125000
NODE_4206_length_1166_cov_313.815370	444	524	175	4	80	0.0500000
NODE_4206_length_1166_cov_313.815370	444	524	180	1	80	0.0125000
NODE_4206_length_1166_cov_313.815370	444	524	236	1	80	0.0125000
NODE_4206_length_1166_cov_313.815370	444	524	245	1	80	0.0125000
NODE_4206_length_1166_cov_313.815370	444	524	299	1	80	0.0125000
NODE_4206_length_1166_cov_313.815370	444	524	335	1	80	0.0125000
NODE_4206_length_1166_cov_313.815370	444	524	338	1	80	0.0125000
NODE_4206_length_1166_cov_313.815370	444	524	339	1	80	0.0125000
NODE_4206_length_1166_cov_313.815370	444	524	346	1	80	0.0125000
NODE_4206_length_1166_cov_313.815370	444	524	354	1	80	0.0125000
NODE_4206_length_1166_cov_313.815370	444	524	356	1	80	0.0125000
NODE_4206_length_1166_cov_313.815370	444	524	359	3	80	0.0375000
NODE_4206_length_1166_cov_313.815370	444	524	377	1	80	0.0125000
NODE_4206_length_1166_cov_313.815370	444	524	381	2	80	0.0250000
NODE_4206_length_1166_cov_313.815370	444	524	409	2	80	0.0250000
NODE_4206_length_1166_cov_313.815370	444	524	414	1	80	0.0125000
NODE_4206_length_1166_cov_313.815370	444	524	423	1	80	0.0125000
NODE_4206_length_1166_cov_313.815370	444	524	429	1	80	0.0125000
NODE_4206_length_1166_cov_313.815370	444	524	478	1	80	0.0125000
NODE_4206_length_1166_cov_313.815370	444	524	486	1	80	0.0125000
NODE_4206_length_1166_cov_313.815370	444	524	520	1	80	0.0125000
NODE_4206_length_1166_cov_313.815370	444	524	539	1	80	0.0125000
NODE_4206_length_1166_cov_313.815370	444	524	544	1	80	0.0125000
NODE_4206_length_1166_cov_313.815370	444	524	565	1	80	0.0125000
NODE_4206_length_1166_cov_313.815370	444	524	576	2	80	0.0250000
NODE_4206_length_1166_cov_313.815370	444	524	590	1	80	0.0125000
NODE_4206_length_1166_cov_313.815370	444	524	599	2	80	0.0250000
NODE_4206_length_1166_cov_313.815370	444	524	607	1	80	0.0125000
NODE_4206_length_1166_cov_313.815370	444	524	612	1	80	0.0125000
NODE_4206_length_1166_cov_313.815370	444	524	614	1	80	0.0125000
NODE_4206_length_1166_cov_313.815370	444	524	616	1	80	0.0125000
NODE_4206_length_1166_cov_313.815370	444	524	619	1	80	0.0125000
NODE_4206_length_1166_cov_313.815370	444	524	624	1	80	0.0125000
NODE_4206_length_1166_cov_313.815370	444	524	630	1	80	0.0125000
NODE_4206_length_1166_cov_313.815370	444	524	637	1	80	0.0125000
NODE_4206_length_1166_cov_313.815370	444	524	651	2	80	0.0250000
NODE_4206_length_1166_cov_313.815370	444	524	662	1	80	0.0125000
NODE_4206_length_1166_cov_313.815370	444	524	668	1	80	0.0125000
NODE_4206_length_1166_cov_313.815370	444	524	681	1	80	0.0125000
NODE_4206_length_1166_cov_313.815370	444	524	692	1	80	0.0125000
NODE_4206_length_1166_cov_313.815370	444	524	702	1	80	0.0125000
NODE_4206_length_1166_cov_313.815370	444	524	719	1	80	0.0125000
NODE_4206_length_1166_cov_313.815370	444	524	744	1	80	0.0125000
NODE_4206_length_1166_cov_313.815370	444	524	746	1	80	0.0125000
NODE_4206_length_1166_cov_313.815370	444	524	754	1	80	0.0125000
NODE_4206_length_1166_cov_313.815370	444	524	781	1	80	0.0125000
NODE_4206_length_1166_cov_313.815370	444	524	782	1	80	0.0125000
NODE_4206_length_1166_cov_313.815370	444	524	791	1	80	0.0125000
NODE_4206_length_1166_cov_313.815370	444	524	808	1	80	0.0125000
NODE_4206_length_1166_cov_313.815370	444	524	824	1	80	0.0125000
NODE_4206_length_1166_cov_313.815370	444	524	839	1	80	0.0125000
NODE_4206_length_1166_cov_313.815370	444	524	840	1	80	0.0125000
NODE_4206_length_1166_cov_313.815370	444	524	852	1	80	0.0125000
NODE_4206_length_1166_cov_313.815370	444	524	855	1	80	0.0125000
NODE_4206_length_1166_cov_313.815370	444	524	865	1	80	0.0125000
NODE_4206_length_1166_cov_313.815370	444	524	871	1	80	0.0125000
NODE_4206_length_1166_cov_313.815370	444	524	875	1	80	0.0125000
NODE_4206_length_1166_cov_313.815370	444	524	882	3	80	0.0375000
NODE_4206_length_1166_cov_313.815370	444	524	883	1	80	0.0125000
NODE_4206_length_1166_cov_313.815370	444	524	885	1	80	0.0125000
NODE_4206_length_1166_cov_313.815370	444	524	167	7	80	0.0875000
NODE_4206_length_1166_cov_313.815370	444	524	174	1	80	0.0125000
NODE_4206_length_1166_cov_313.815370	444	524	175	4	80	0.0500000
NODE_4206_length_1166_cov_313.815370	444	524	180	1	80	0.0125000
NODE_4206_length_1166_cov_313.815370	444	524	236	1	80	0.0125000
NODE_4206_length_1166_cov_313.815370	444	524	245	1	80	0.0125000
NODE_4206_length_1166_cov_313.815370	444	524	299	1	80	0.0125000
NODE_4206_length_1166_cov_313.815370	444	524	335	1	80	0.0125000
NODE_4206_length_1166_cov_313.815370	444	524	338	1	80	0.0125000
NODE_4206_length_1166_cov_313.815370	444	524	339	1	80	0.0125000
NODE_4206_length_1166_cov_313.815370	444	524	346	1	80	0.0125000
NODE_4206_length_1166_cov_313.815370	444	524	354	1	80	0.0125000
NODE_4206_length_1166_cov_313.815370	444	524	356	1	80	0.0125000
NODE_4206_length_1166_cov_313.815370	444	524	359	3	80	0.0375000
NODE_4206_length_1166_cov_313.815370	444	524	377	1	80	0.0125000
NODE_4206_length_1166_cov_313.815370	444	524	381	2	80	0.0250000
NODE_4206_length_1166_cov_313.815370	444	524	409	2	80	0.0250000
NODE_4206_length_1166_cov_313.815370	444	524	414	1	80	0.0125000
NODE_4206_length_1166_cov_313.815370	444	524	423	1	80	0.0125000
NODE_4206_length_1166_cov_313.815370	444	524	429	1	80	0.0125000
NODE_4206_length_1166_cov_313.815370	444	524	478	1	80	0.0125000
NODE_4206_length_1166_cov_313.815370	444	524	486	1	80	0.0125000
NODE_4206_length_1166_cov_313.815370	444	524	520	1	80	0.0125000
NODE_4206_length_1166_cov_313.815370	444	524	539	1	80	0.0125000
NODE_4206_length_1166_cov_313.815370	444	524	544	1	80	0.0125000
NODE_4206_length_1166_cov_313.815370	444	524	565	1	80	0.0125000
NODE_4206_length_1166_cov_313.815370	444	524	576	2	80	0.0250000
NODE_4206_length_1166_cov_313.815370	444	524	590	1	80	0.0125000
NODE_4206_length_1166_cov_313.815370	444	524	599	2	80	0.0250000
NODE_4206_length_1166_cov_313.815370	444	524	607	1	80	0.0125000
NODE_4206_length_1166_cov_313.815370	444	524	612	1	80	0.0125000
NODE_4206_length_1166_cov_313.815370	444	524	614	1	80	0.0125000
NODE_4206_length_1166_cov_313.815370	444	524	616	1	80	0.0125000
NODE_4206_length_1166_cov_313.815370	444	524	619	1	80	0.0125000
NODE_4206_length_1166_cov_313.815370	444	524	624	1	80	0.0125000
NODE_4206_length_1166_cov_313.815370	444	524	630	1	80	0.0125000
NODE_4206_length_1166_cov_313.815370	444	524	637	1	80	0.0125000
NODE_4206_length_1166_cov_313.815370	444	524	651	2	80	0.0250000
NODE_4206_length_1166_cov_313.815370	444	524	662	1	80	0.0125000
NODE_4206_length_1166_cov_313.815370	444	524	668	1	80	0.0125000
NODE_4206_length_1166_cov_313.815370	444	524	681	1	80	0.0125000
NODE_4206_length_1166_cov_313.815370	444	524	692	1	80	0.0125000
NODE_4206_length_1166_cov_313.815370	444	524	702	1	80	0.0125000
NODE_4206_length_1166_cov_313.815370	444	524	719	1	80	0.0125000
NODE_4206_length_1166_cov_313.815370	444	524	744	1	80	0.0125000
NODE_4206_length_1166_cov_313.815370	444	524	746	1	80	0.0125000
NODE_4206_length_1166_cov_313.815370	444	524	754	1	80	0.0125000
NODE_4206_length_1166_cov_313.815370	444	524	781	1	80	0.0125000
NODE_4206_length_1166_cov_313.815370	444	524	782	1	80	0.0125000
NODE_4206_length_1166_cov_313.815370	444	524	791	1	80	0.0125000
NODE_4206_length_1166_cov_313.815370	444	524	808	1	80	0.0125000
NODE_4206_length_1166_cov_313.815370	444	524	824	1	80	0.0125000
NODE_4206_length_1166_cov_313.815370	444	524	839	1	80	0.0125000
NODE_4206_length_1166_cov_313.815370	444	524	840	1	80	0.0125000
NODE_4206_length_1166_cov_313.815370	444	524	852	1	80	0.0125000
NODE_4206_length_1166_cov_313.815370	444	524	855	1	80	0.0125000
NODE_4206_length_1166_cov_313.815370	444	524	865	1	80	0.0125000
NODE_4206_length_1166_cov_313.815370	444	524	871	1	80	0.0125000
NODE_4206_length_1166_cov_313.815370	444	524	875	1	80	0.0125000
NODE_4206_length_1166_cov_313.815370	444	524	882	3	80	0.0375000
NODE_4206_length_1166_cov_313.815370	444	524	883	1	80	0.0125000
NODE_4206_length_1166_cov_313.815370	444	524	885	1	80	0.0125000
NODE_4206_length_1166_cov_313.815370	444	524	167	7	80	0.0875000
NODE_4206_length_1166_cov_313.815370	444	524	174	1	80	0.0125000
NODE_4206_length_1166_cov_313.815370	444	524	175	4	80	0.0500000
NODE_4206_length_1166_cov_313.815370	444	524	180	1	80	0.0125000
NODE_4206_length_1166_cov_313.815370	444	524	236	1	80	0.0125000
NODE_4206_length_1166_cov_313.815370	444	524	245	1	80	0.0125000
NODE_4206_length_1166_cov_313.815370	444	524	299	1	80	0.0125000
NODE_4206_length_1166_cov_313.815370	444	524	335	1	80	0.0125000
NODE_4206_length_1166_cov_313.815370	444	524	338	1	80	0.0125000
NODE_4206_length_1166_cov_313.815370	444	524	339	1	80	0.0125000
NODE_4206_length_1166_cov_313.815370	444	524	346	1	80	0.0125000
NODE_4206_length_1166_cov_313.815370	444	524	354	1	80	0.0125000
NODE_4206_length_1166_cov_313.815370	444	524	356	1	80	0.0125000
NODE_4206_length_1166_cov_313.815370	444	524	359	3	80	0.0375000
NODE_4206_length_1166_cov_313.815370	444	524	377	1	80	0.0125000
NODE_4206_length_1166_cov_313.815370	444	524	381	2	80	0.0250000
NODE_4206_length_1166_cov_313.815370	444	524	409	2	80	0.0250000
NODE_4206_length_1166_cov_313.815370	444	524	414	1	80	0.0125000
NODE_4206_length_1166_cov_313.815370	444	524	423	1	80	0.0125000
NODE_4206_length_1166_cov_313.815370	444	524	429	1	80	0.0125000
NODE_4206_length_1166_cov_313.815370	444	524	478	1	80	0.0125000
NODE_4206_length_1166_cov_313.815370	444	524	486	1	80	0.0125000
NODE_4206_length_1166_cov_313.815370	444	524	520	1	80	0.0125000
NODE_4206_length_1166_cov_313.815370	444	524	539	1	80	0.0125000
NODE_4206_length_1166_cov_313.815370	444	524	544	1	80	0.0125000
NODE_4206_length_1166_cov_313.815370	444	524	565	1	80	0.0125000
NODE_4206_length_1166_cov_313.815370	444	524	576	2	80	0.0250000
NODE_4206_length_1166_cov_313.815370	444	524	590	1	80	0.0125000
NODE_4206_length_1166_cov_313.815370	444	524	599	2	80	0.0250000
NODE_4206_length_1166_cov_313.815370	444	524	607	1	80	0.0125000
NODE_4206_length_1166_cov_313.815370	444	524	612	1	80	0.0125000
NODE_4206_length_1166_cov_313.815370	444	524	614	1	80	0.0125000
NODE_4206_length_1166_cov_313.815370	444	524	616	1	80	0.0125000
NODE_4206_length_1166_cov_313.815370	444	524	619	1	80	0.0125000
NODE_4206_length_1166_cov_313.815370	444	524	624	1	80	0.0125000
NODE_4206_length_1166_cov_313.815370	444	524	630	1	80	0.0125000
NODE_4206_length_1166_cov_313.815370	444	524	637	1	80	0.0125000
NODE_4206_length_1166_cov_313.815370	444	524	651	2	80	0.0250000
NODE_4206_length_1166_cov_313.815370	444	524	662	1	80	0.0125000
NODE_4206_length_1166_cov_313.815370	444	524	668	1	80	0.0125000
NODE_4206_length_1166_cov_313.815370	444	524	681	1	80	0.0125000
NODE_4206_length_1166_cov_313.815370	444	524	692	1	80	0.0125000
NODE_4206_length_1166_cov_313.815370	444	524	702	1	80	0.0125000
NODE_4206_length_1166_cov_313.815370	444	524	719	1	80	0.0125000
NODE_4206_length_1166_cov_313.815370	444	524	744	1	80	0.0125000
NODE_4206_length_1166_cov_313.815370	444	524	746	1	80	0.0125000
NODE_4206_length_1166_cov_313.815370	444	524	754	1	80	0.0125000
NODE_4206_length_1166_cov_313.815370	444	524	781	1	80	0.0125000
NODE_4206_length_1166_cov_313.815370	444	524	782	1	80	0.0125000
NODE_4206_length_1166_cov_313.815370	444	524	791	1	80	0.0125000
NODE_4206_length_1166_cov_313.815370	444	524	808	1	80	0.0125000
NODE_4206_length_1166_cov_313.815370	444	524	824	1	80	0.0125000
NODE_4206_length_1166_cov_313.815370	444	524	839	1	80	0.0125000
NODE_4206_length_1166_cov_313.815370	444	524	840	1	80	0.0125000
NODE_4206_length_1166_cov_313.815370	444	524	852	1	80	0.0125000
NODE_4206_length_1166_cov_313.815370	444	524	855	1	80	0.0125000
NODE_4206_length_1166_cov_313.815370	444	524	865	1	80	0.0125000
NODE_4206_length_1166_cov_313.815370	444	524	871	1	80	0.0125000
NODE_4206_length_1166_cov_313.815370	444	524	875	1	80	0.0125000
NODE_4206_length_1166_cov_313.815370	444	524	882	3	80	0.0375000
NODE_4206_length_1166_cov_313.815370	444	524	883	1	80	0.0125000
NODE_4206_length_1166_cov_313.815370	444	524	885	1	80	0.0125000
NODE_4206_length_1166_cov_313.815370	444	524	167	7	80	0.0875000
NODE_4206_length_1166_cov_313.815370	444	524	174	1	80	0.0125000
NODE_4206_length_1166_cov_313.815370	444	524	175	4	80	0.0500000
NODE_4206_length_1166_cov_313.815370	444	524	180	1	80	0.0125000
NODE_4206_length_1166_cov_313.815370	444	524	236	1	80	0.0125000
NODE_4206_length_1166_cov_313.815370	444	524	245	1	80	0.0125000
NODE_4206_length_1166_cov_313.815370	444	524	299	1	80	0.0125000
NODE_4206_length_1166_cov_313.815370	444	524	335	1	80	0.0125000
NODE_4206_length_1166_cov_313.815370	444	524	338	1	80	0.0125000
NODE_4206_length_1166_cov_313.815370	444	524	339	1	80	0.0125000
NODE_4206_length_1166_cov_313.815370	444	524	346	1	80	0.0125000
NODE_4206_length_1166_cov_313.815370	444	524	354	1	80	0.0125000
NODE_4206_length_1166_cov_313.815370	444	524	356	1	80	0.0125000
NODE_4206_length_1166_cov_313.815370	444	524	359	3	80	0.0375000
NODE_4206_length_1166_cov_313.815370	444	524	377	1	80	0.0125000
NODE_4206_length_1166_cov_313.815370	444	524	381	2	80	0.0250000
NODE_4206_length_1166_cov_313.815370	444	524	409	2	80	0.0250000
NODE_4206_length_1166_cov_313.815370	444	524	414	1	80	0.0125000
NODE_4206_length_1166_cov_313.815370	444	524	423	1	80	0.0125000
NODE_4206_length_1166_cov_313.815370	444	524	429	1	80	0.0125000
NODE_4206_length_1166_cov_313.815370	444	524	478	1	80	0.0125000
NODE_4206_length_1166_cov_313.815370	444	524	486	1	80	0.0125000
NODE_4206_length_1166_cov_313.815370	444	524	520	1	80	0.0125000
NODE_4206_length_1166_cov_313.815370	444	524	539	1	80	0.0125000
NODE_4206_length_1166_cov_313.815370	444	524	544	1	80	0.0125000
NODE_4206_length_1166_cov_313.815370	444	524	565	1	80	0.0125000
NODE_4206_length_1166_cov_313.815370	444	524	576	2	80	0.0250000
NODE_4206_length_1166_cov_313.815370	444	524	590	1	80	0.0125000
NODE_4206_length_1166_cov_313.815370	444	524	599	2	80	0.0250000
NODE_4206_length_1166_cov_313.815370	444	524	607	1	80	0.0125000
NODE_4206_length_1166_cov_313.815370	444	524	612	1	80	0.0125000
NODE_4206_length_1166_cov_313.815370	444	524	614	1	80	0.0125000
NODE_4206_length_1166_cov_313.815370	444	524	616	1	80	0.0125000
NODE_4206_length_1166_cov_313.815370	444	524	619	1	80	0.0125000
NODE_4206_length_1166_cov_313.815370	444	524	624	1	80	0.0125000
NODE_4206_length_1166_cov_313.815370	444	524	630	1	80	0.0125000
NODE_4206_length_1166_cov_313.815370	444	524	637	1	80	0.0125000
NODE_4206_length_1166_cov_313.815370	444	524	651	2	80	0.0250000
NODE_4206_length_1166_cov_313.815370	444	524	662	1	80	0.0125000
NODE_4206_length_1166_cov_313.815370	444	524	668	1	80	0.0125000
NODE_4206_length_1166_cov_313.815370	444	524	681	1	80	0.0125000
NODE_4206_length_1166_cov_313.815370	444	524	692	1	80	0.0125000
NODE_4206_length_1166_cov_313.815370	444	524	702	1	80	0.0125000
NODE_4206_length_1166_cov_313.815370	444	524	719	1	80	0.0125000
NODE_4206_length_1166_cov_313.815370	444	524	744	1	80	0.0125000
NODE_4206_length_1166_cov_313.815370	444	524	746	1	80	0.0125000
NODE_4206_length_1166_cov_313.815370	444	524	754	1	80	0.0125000
NODE_4206_length_1166_cov_313.815370	444	524	781	1	80	0.0125000
NODE_4206_length_1166_cov_313.815370	444	524	782	1	80	0.0125000
NODE_4206_length_1166_cov_313.815370	444	524	791	1	80	0.0125000
NODE_4206_length_1166_cov_313.815370	444	524	808	1	80	0.0125000
NODE_4206_length_1166_cov_313.815370	444	524	824	1	80	0.0125000
NODE_4206_length_1166_cov_313.815370	444	524	839	1	80	0.0125000
NODE_4206_length_1166_cov_313.815370	444	524	840	1	80	0.0125000
NODE_4206_length_1166_cov_313.815370	444	524	852	1	80	0.0125000
NODE_4206_length_1166_cov_313.815370	444	524	855	1	80	0.0125000
NODE_4206_length_1166_cov_313.815370	444	524	865	1	80	0.0125000
NODE_4206_length_1166_cov_313.815370	444	524	871	1	80	0.0125000
NODE_4206_length_1166_cov_313.815370	444	524	875	1	80	0.0125000
NODE_4206_length_1166_cov_313.815370	444	524	882	3	80	0.0375000
NODE_4206_length_1166_cov_313.815370	444	524	883	1	80	0.0125000
NODE_4206_length_1166_cov_313.815370	444	524	885	1	80	0.0125000
NODE_4206_length_1166_cov_313.815370	497	577	651	1	80	0.0125000
NODE_4206_length_1166_cov_313.815370	497	577	662	1	80	0.0125000
NODE_4206_length_1166_cov_313.815370	497	577	668	1	80	0.0125000
NODE_4206_length_1166_cov_313.815370	497	577	681	1	80	0.0125000
NODE_4206_length_1166_cov_313.815370	497	577	692	1	80	0.0125000
NODE_4206_length_1166_cov_313.815370	497	577	702	1	80	0.0125000
NODE_4206_length_1166_cov_313.815370	497	577	719	1	80	0.0125000
NODE_4206_length_1166_cov_313.815370	497	577	744	1	80	0.0125000
NODE_4206_length_1166_cov_313.815370	497	577	746	1	80	0.0125000
NODE_4206_length_1166_cov_313.815370	497	577	754	1	80	0.0125000
NODE_4206_length_1166_cov_313.815370	497	577	781	1	80	0.0125000
NODE_4206_length_1166_cov_313.815370	497	577	782	1	80	0.0125000
NODE_4206_length_1166_cov_313.815370	497	577	791	1	80	0.0125000
NODE_4206_length_1166_cov_313.815370	497	577	808	1	80	0.0125000
NODE_4206_length_1166_cov_313.815370	497	577	824	1	80	0.0125000
NODE_4206_length_1166_cov_313.815370	497	577	839	5	80	0.0625000
NODE_4206_length_1166_cov_313.815370	497	577	840	1	80	0.0125000
NODE_4206_length_1166_cov_313.815370	497	577	846	1	80	0.0125000
NODE_4206_length_1166_cov_313.815370	497	577	847	3	80	0.0375000
NODE_4206_length_1166_cov_313.815370	497	577	848	3	80	0.0375000
NODE_4206_length_1166_cov_313.815370	497	577	849	2	80	0.0250000
NODE_4206_length_1166_cov_313.815370	497	577	851	1	80	0.0125000
NODE_4206_length_1166_cov_313.815370	497	577	852	1	80	0.0125000
NODE_4206_length_1166_cov_313.815370	497	577	854	1	80	0.0125000
NODE_4206_length_1166_cov_313.815370	497	577	855	2	80	0.0250000
NODE_4206_length_1166_cov_313.815370	497	577	860	1	80	0.0125000
NODE_4206_length_1166_cov_313.815370	497	577	863	2	80	0.0250000
NODE_4206_length_1166_cov_313.815370	497	577	864	1	80	0.0125000
NODE_4206_length_1166_cov_313.815370	497	577	865	1	80	0.0125000
NODE_4206_length_1166_cov_313.815370	497	577	866	2	80	0.0250000
NODE_4206_length_1166_cov_313.815370	497	577	867	1	80	0.0125000
NODE_4206_length_1166_cov_313.815370	497	577	868	1	80	0.0125000
NODE_4206_length_1166_cov_313.815370	497	577	869	5	80	0.0625000
NODE_4206_length_1166_cov_313.815370	497	577	870	12	80	0.1500000
NODE_4206_length_1166_cov_313.815370	497	577	871	5	80	0.0625000
NODE_4206_length_1166_cov_313.815370	497	577	872	1	80	0.0125000
NODE_4206_length_1166_cov_313.815370	497	577	873	2	80	0.0250000
NODE_4206_length_1166_cov_313.815370	497	577	874	1	80	0.0125000
NODE_4206_length_1166_cov_313.815370	497	577	875	2	80	0.0250000
NODE_4206_length_1166_cov_313.815370	497	577	880	1	80	0.0125000
NODE_4206_length_1166_cov_313.815370	497	577	882	3	80	0.0375000
NODE_4206_length_1166_cov_313.815370	497	577	883	2	80	0.0250000
NODE_4206_length_1166_cov_313.815370	497	577	884	1	80	0.0125000
NODE_4206_length_1166_cov_313.815370	497	577	885	1	80	0.0125000
NODE_4206_length_1166_cov_313.815370	497	577	651	1	80	0.0125000
NODE_4206_length_1166_cov_313.815370	497	577	662	1	80	0.0125000
NODE_4206_length_1166_cov_313.815370	497	577	668	1	80	0.0125000
NODE_4206_length_1166_cov_313.815370	497	577	681	1	80	0.0125000
NODE_4206_length_1166_cov_313.815370	497	577	692	1	80	0.0125000
NODE_4206_length_1166_cov_313.815370	497	577	702	1	80	0.0125000
NODE_4206_length_1166_cov_313.815370	497	577	719	1	80	0.0125000
NODE_4206_length_1166_cov_313.815370	497	577	744	1	80	0.0125000
NODE_4206_length_1166_cov_313.815370	497	577	746	1	80	0.0125000
NODE_4206_length_1166_cov_313.815370	497	577	754	1	80	0.0125000
NODE_4206_length_1166_cov_313.815370	497	577	781	1	80	0.0125000
NODE_4206_length_1166_cov_313.815370	497	577	782	1	80	0.0125000
NODE_4206_length_1166_cov_313.815370	497	577	791	1	80	0.0125000
NODE_4206_length_1166_cov_313.815370	497	577	808	1	80	0.0125000
NODE_4206_length_1166_cov_313.815370	497	577	824	1	80	0.0125000
NODE_4206_length_1166_cov_313.815370	497	577	839	5	80	0.0625000
NODE_4206_length_1166_cov_313.815370	497	577	840	1	80	0.0125000
NODE_4206_length_1166_cov_313.815370	497	577	846	1	80	0.0125000
NODE_4206_length_1166_cov_313.815370	497	577	847	3	80	0.0375000
NODE_4206_length_1166_cov_313.815370	497	577	848	3	80	0.0375000
NODE_4206_length_1166_cov_313.815370	497	577	849	2	80	0.0250000
NODE_4206_length_1166_cov_313.815370	497	577	851	1	80	0.0125000
NODE_4206_length_1166_cov_313.815370	497	577	852	1	80	0.0125000
NODE_4206_length_1166_cov_313.815370	497	577	854	1	80	0.0125000
NODE_4206_length_1166_cov_313.815370	497	577	855	2	80	0.0250000
NODE_4206_length_1166_cov_313.815370	497	577	860	1	80	0.0125000
NODE_4206_length_1166_cov_313.815370	497	577	863	2	80	0.0250000
NODE_4206_length_1166_cov_313.815370	497	577	864	1	80	0.0125000
NODE_4206_length_1166_cov_313.815370	497	577	865	1	80	0.0125000
NODE_4206_length_1166_cov_313.815370	497	577	866	2	80	0.0250000
NODE_4206_length_1166_cov_313.815370	497	577	867	1	80	0.0125000
NODE_4206_length_1166_cov_313.815370	497	577	868	1	80	0.0125000
NODE_4206_length_1166_cov_313.815370	497	577	869	5	80	0.0625000
NODE_4206_length_1166_cov_313.815370	497	577	870	12	80	0.1500000
NODE_4206_length_1166_cov_313.815370	497	577	871	5	80	0.0625000
NODE_4206_length_1166_cov_313.815370	497	577	872	1	80	0.0125000
NODE_4206_length_1166_cov_313.815370	497	577	873	2	80	0.0250000
NODE_4206_length_1166_cov_313.815370	497	577	874	1	80	0.0125000
NODE_4206_length_1166_cov_313.815370	497	577	875	2	80	0.0250000
NODE_4206_length_1166_cov_313.815370	497	577	880	1	80	0.0125000
NODE_4206_length_1166_cov_313.815370	497	577	882	3	80	0.0375000
NODE_4206_length_1166_cov_313.815370	497	577	883	2	80	0.0250000
NODE_4206_length_1166_cov_313.815370	497	577	884	1	80	0.0125000
NODE_4206_length_1166_cov_313.815370	497	577	885	1	80	0.0125000
NODE_4206_length_1166_cov_313.815370	497	577	651	1	80	0.0125000
NODE_4206_length_1166_cov_313.815370	497	577	662	1	80	0.0125000
NODE_4206_length_1166_cov_313.815370	497	577	668	1	80	0.0125000
NODE_4206_length_1166_cov_313.815370	497	577	681	1	80	0.0125000
NODE_4206_length_1166_cov_313.815370	497	577	692	1	80	0.0125000
NODE_4206_length_1166_cov_313.815370	497	577	702	1	80	0.0125000
NODE_4206_length_1166_cov_313.815370	497	577	719	1	80	0.0125000
NODE_4206_length_1166_cov_313.815370	497	577	744	1	80	0.0125000
NODE_4206_length_1166_cov_313.815370	497	577	746	1	80	0.0125000
NODE_4206_length_1166_cov_313.815370	497	577	754	1	80	0.0125000
NODE_4206_length_1166_cov_313.815370	497	577	781	1	80	0.0125000
NODE_4206_length_1166_cov_313.815370	497	577	782	1	80	0.0125000
NODE_4206_length_1166_cov_313.815370	497	577	791	1	80	0.0125000
NODE_4206_length_1166_cov_313.815370	497	577	808	1	80	0.0125000
NODE_4206_length_1166_cov_313.815370	497	577	824	1	80	0.0125000
NODE_4206_length_1166_cov_313.815370	497	577	839	5	80	0.0625000
NODE_4206_length_1166_cov_313.815370	497	577	840	1	80	0.0125000
NODE_4206_length_1166_cov_313.815370	497	577	846	1	80	0.0125000
NODE_4206_length_1166_cov_313.815370	497	577	847	3	80	0.0375000
NODE_4206_length_1166_cov_313.815370	497	577	848	3	80	0.0375000
NODE_4206_length_1166_cov_313.815370	497	577	849	2	80	0.0250000
NODE_4206_length_1166_cov_313.815370	497	577	851	1	80	0.0125000
NODE_4206_length_1166_cov_313.815370	497	577	852	1	80	0.0125000
NODE_4206_length_1166_cov_313.815370	497	577	854	1	80	0.0125000
NODE_4206_length_1166_cov_313.815370	497	577	855	2	80	0.0250000
NODE_4206_length_1166_cov_313.815370	497	577	860	1	80	0.0125000
NODE_4206_length_1166_cov_313.815370	497	577	863	2	80	0.0250000
NODE_4206_length_1166_cov_313.815370	497	577	864	1	80	0.0125000
NODE_4206_length_1166_cov_313.815370	497	577	865	1	80	0.0125000
NODE_4206_length_1166_cov_313.815370	497	577	866	2	80	0.0250000
NODE_4206_length_1166_cov_313.815370	497	577	867	1	80	0.0125000
NODE_4206_length_1166_cov_313.815370	497	577	868	1	80	0.0125000
NODE_4206_length_1166_cov_313.815370	497	577	869	5	80	0.0625000
NODE_4206_length_1166_cov_313.815370	497	577	870	12	80	0.1500000
NODE_4206_length_1166_cov_313.815370	497	577	871	5	80	0.0625000
NODE_4206_length_1166_cov_313.815370	497	577	872	1	80	0.0125000
NODE_4206_length_1166_cov_313.815370	497	577	873	2	80	0.0250000
NODE_4206_length_1166_cov_313.815370	497	577	874	1	80	0.0125000
NODE_4206_length_1166_cov_313.815370	497	577	875	2	80	0.0250000
NODE_4206_length_1166_cov_313.815370	497	577	880	1	80	0.0125000
NODE_4206_length_1166_cov_313.815370	497	577	882	3	80	0.0375000
NODE_4206_length_1166_cov_313.815370	497	577	883	2	80	0.0250000
NODE_4206_length_1166_cov_313.815370	497	577	884	1	80	0.0125000
NODE_4206_length_1166_cov_313.815370	497	577	885	1	80	0.0125000
NODE_4206_length_1166_cov_313.815370	497	577	651	1	80	0.0125000
NODE_4206_length_1166_cov_313.815370	497	577	662	1	80	0.0125000
NODE_4206_length_1166_cov_313.815370	497	577	668	1	80	0.0125000
NODE_4206_length_1166_cov_313.815370	497	577	681	1	80	0.0125000
NODE_4206_length_1166_cov_313.815370	497	577	692	1	80	0.0125000
NODE_4206_length_1166_cov_313.815370	497	577	702	1	80	0.0125000
NODE_4206_length_1166_cov_313.815370	497	577	719	1	80	0.0125000
NODE_4206_length_1166_cov_313.815370	497	577	744	1	80	0.0125000
NODE_4206_length_1166_cov_313.815370	497	577	746	1	80	0.0125000
NODE_4206_length_1166_cov_313.815370	497	577	754	1	80	0.0125000
NODE_4206_length_1166_cov_313.815370	497	577	781	1	80	0.0125000
NODE_4206_length_1166_cov_313.815370	497	577	782	1	80	0.0125000
NODE_4206_length_1166_cov_313.815370	497	577	791	1	80	0.0125000
NODE_4206_length_1166_cov_313.815370	497	577	808	1	80	0.0125000
NODE_4206_length_1166_cov_313.815370	497	577	824	1	80	0.0125000
NODE_4206_length_1166_cov_313.815370	497	577	839	5	80	0.0625000
NODE_4206_length_1166_cov_313.815370	497	577	840	1	80	0.0125000
NODE_4206_length_1166_cov_313.815370	497	577	846	1	80	0.0125000
NODE_4206_length_1166_cov_313.815370	497	577	847	3	80	0.0375000
NODE_4206_length_1166_cov_313.815370	497	577	848	3	80	0.0375000
NODE_4206_length_1166_cov_313.815370	497	577	849	2	80	0.0250000
NODE_4206_length_1166_cov_313.815370	497	577	851	1	80	0.0125000
NODE_4206_length_1166_cov_313.815370	497	577	852	1	80	0.0125000
NODE_4206_length_1166_cov_313.815370	497	577	854	1	80	0.0125000
NODE_4206_length_1166_cov_313.815370	497	577	855	2	80	0.0250000
NODE_4206_length_1166_cov_313.815370	497	577	860	1	80	0.0125000
NODE_4206_length_1166_cov_313.815370	497	577	863	2	80	0.0250000
NODE_4206_length_1166_cov_313.815370	497	577	864	1	80	0.0125000
NODE_4206_length_1166_cov_313.815370	497	577	865	1	80	0.0125000
NODE_4206_length_1166_cov_313.815370	497	577	866	2	80	0.0250000
NODE_4206_length_1166_cov_313.815370	497	577	867	1	80	0.0125000
NODE_4206_length_1166_cov_313.815370	497	577	868	1	80	0.0125000
NODE_4206_length_1166_cov_313.815370	497	577	869	5	80	0.0625000
NODE_4206_length_1166_cov_313.815370	497	577	870	12	80	0.1500000
NODE_4206_length_1166_cov_313.815370	497	577	871	5	80	0.0625000
NODE_4206_length_1166_cov_313.815370	497	577	872	1	80	0.0125000
NODE_4206_length_1166_cov_313.815370	497	577	873	2	80	0.0250000
NODE_4206_length_1166_cov_313.815370	497	577	874	1	80	0.0125000
NODE_4206_length_1166_cov_313.815370	497	577	875	2	80	0.0250000
NODE_4206_length_1166_cov_313.815370	497	577	880	1	80	0.0125000
NODE_4206_length_1166_cov_313.815370	497	577	882	3	80	0.0375000
NODE_4206_length_1166_cov_313.815370	497	577	883	2	80	0.0250000
NODE_4206_length_1166_cov_313.815370	497	577	884	1	80	0.0125000
NODE_4206_length_1166_cov_313.815370	497	577	885	1	80	0.0125000
NODE_4206_length_1166_cov_313.815370	497	577	651	1	80	0.0125000
NODE_4206_length_1166_cov_313.815370	497	577	662	1	80	0.0125000
NODE_4206_length_1166_cov_313.815370	497	577	668	1	80	0.0125000
NODE_4206_length_1166_cov_313.815370	497	577	681	1	80	0.0125000
NODE_4206_length_1166_cov_313.815370	497	577	692	1	80	0.0125000
NODE_4206_length_1166_cov_313.815370	497	577	702	1	80	0.0125000
NODE_4206_length_1166_cov_313.815370	497	577	719	1	80	0.0125000
NODE_4206_length_1166_cov_313.815370	497	577	744	1	80	0.0125000
NODE_4206_length_1166_cov_313.815370	497	577	746	1	80	0.0125000
NODE_4206_length_1166_cov_313.815370	497	577	754	1	80	0.0125000
NODE_4206_length_1166_cov_313.815370	497	577	781	1	80	0.0125000
NODE_4206_length_1166_cov_313.815370	497	577	782	1	80	0.0125000
NODE_4206_length_1166_cov_313.815370	497	577	791	1	80	0.0125000
NODE_4206_length_1166_cov_313.815370	497	577	808	1	80	0.0125000
NODE_4206_length_1166_cov_313.815370	497	577	824	1	80	0.0125000
NODE_4206_length_1166_cov_313.815370	497	577	839	5	80	0.0625000
NODE_4206_length_1166_cov_313.815370	497	577	840	1	80	0.0125000
NODE_4206_length_1166_cov_313.815370	497	577	846	1	80	0.0125000
NODE_4206_length_1166_cov_313.815370	497	577	847	3	80	0.0375000
NODE_4206_length_1166_cov_313.815370	497	577	848	3	80	0.0375000
NODE_4206_length_1166_cov_313.815370	497	577	849	2	80	0.0250000
NODE_4206_length_1166_cov_313.815370	497	577	851	1	80	0.0125000
NODE_4206_length_1166_cov_313.815370	497	577	852	1	80	0.0125000
NODE_4206_length_1166_cov_313.815370	497	577	854	1	80	0.0125000
NODE_4206_length_1166_cov_313.815370	497	577	855	2	80	0.0250000
NODE_4206_length_1166_cov_313.815370	497	577	860	1	80	0.0125000
NODE_4206_length_1166_cov_313.815370	497	577	863	2	80	0.0250000
NODE_4206_length_1166_cov_313.815370	497	577	864	1	80	0.0125000
NODE_4206_length_1166_cov_313.815370	497	577	865	1	80	0.0125000
NODE_4206_length_1166_cov_313.815370	497	577	866	2	80	0.0250000
NODE_4206_length_1166_cov_313.815370	497	577	867	1	80	0.0125000
NODE_4206_length_1166_cov_313.815370	497	577	868	1	80	0.0125000
NODE_4206_length_1166_cov_313.815370	497	577	869	5	80	0.0625000
NODE_4206_length_1166_cov_313.815370	497	577	870	12	80	0.1500000
NODE_4206_length_1166_cov_313.815370	497	577	871	5	80	0.0625000
NODE_4206_length_1166_cov_313.815370	497	577	872	1	80	0.0125000
NODE_4206_length_1166_cov_313.815370	497	577	873	2	80	0.0250000
NODE_4206_length_1166_cov_313.815370	497	577	874	1	80	0.0125000
NODE_4206_length_1166_cov_313.815370	497	577	875	2	80	0.0250000
NODE_4206_length_1166_cov_313.815370	497	577	880	1	80	0.0125000
NODE_4206_length_1166_cov_313.815370	497	577	882	3	80	0.0375000
NODE_4206_length_1166_cov_313.815370	497	577	883	2	80	0.0250000
NODE_4206_length_1166_cov_313.815370	497	577	884	1	80	0.0125000
NODE_4206_length_1166_cov_313.815370	497	577	885	1	80	0.0125000
NODE_4206_length_1166_cov_313.815370	497	577	651	1	80	0.0125000
NODE_4206_length_1166_cov_313.815370	497	577	662	1	80	0.0125000
NODE_4206_length_1166_cov_313.815370	497	577	668	1	80	0.0125000
NODE_4206_length_1166_cov_313.815370	497	577	681	1	80	0.0125000
NODE_4206_length_1166_cov_313.815370	497	577	692	1	80	0.0125000
NODE_4206_length_1166_cov_313.815370	497	577	702	1	80	0.0125000
NODE_4206_length_1166_cov_313.815370	497	577	719	1	80	0.0125000
NODE_4206_length_1166_cov_313.815370	497	577	744	1	80	0.0125000
NODE_4206_length_1166_cov_313.815370	497	577	746	1	80	0.0125000
NODE_4206_length_1166_cov_313.815370	497	577	754	1	80	0.0125000
NODE_4206_length_1166_cov_313.815370	497	577	781	1	80	0.0125000
NODE_4206_length_1166_cov_313.815370	497	577	782	1	80	0.0125000
NODE_4206_length_1166_cov_313.815370	497	577	791	1	80	0.0125000
NODE_4206_length_1166_cov_313.815370	497	577	808	1	80	0.0125000
NODE_4206_length_1166_cov_313.815370	497	577	824	1	80	0.0125000
NODE_4206_length_1166_cov_313.815370	497	577	839	5	80	0.0625000
NODE_4206_length_1166_cov_313.815370	497	577	840	1	80	0.0125000
NODE_4206_length_1166_cov_313.815370	497	577	846	1	80	0.0125000
NODE_4206_length_1166_cov_313.815370	497	577	847	3	80	0.0375000
NODE_4206_length_1166_cov_313.815370	497	577	848	3	80	0.0375000
NODE_4206_length_1166_cov_313.815370	497	577	849	2	80	0.0250000
NODE_4206_length_1166_cov_313.815370	497	577	851	1	80	0.0125000
NODE_4206_length_1166_cov_313.815370	497	577	852	1	80	0.0125000
NODE_4206_length_1166_cov_313.815370	497	577	854	1	80	0.0125000
NODE_4206_length_1166_cov_313.815370	497	577	855	2	80	0.0250000
NODE_4206_length_1166_cov_313.815370	497	577	860	1	80	0.0125000
NODE_4206_length_1166_cov_313.815370	497	577	863	2	80	0.0250000
NODE_4206_length_1166_cov_313.815370	497	577	864	1	80	0.0125000
NODE_4206_length_1166_cov_313.815370	497	577	865	1	80	0.0125000
NODE_4206_length_1166_cov_313.815370	497	577	866	2	80	0.0250000
NODE_4206_length_1166_cov_313.815370	497	577	867	1	80	0.0125000
NODE_4206_length_1166_cov_313.815370	497	577	868	1	80	0.0125000
NODE_4206_length_1166_cov_313.815370	497	577	869	5	80	0.0625000
NODE_4206_length_1166_cov_313.815370	497	577	870	12	80	0.1500000
NODE_4206_length_1166_cov_313.815370	497	577	871	5	80	0.0625000
NODE_4206_length_1166_cov_313.815370	497	577	872	1	80	0.0125000
NODE_4206_length_1166_cov_313.815370	497	577	873	2	80	0.0250000
NODE_4206_length_1166_cov_313.815370	497	577	874	1	80	0.0125000
NODE_4206_length_1166_cov_313.815370	497	577	875	2	80	0.0250000
NODE_4206_length_1166_cov_313.815370	497	577	880	1	80	0.0125000
NODE_4206_length_1166_cov_313.815370	497	577	882	3	80	0.0375000
NODE_4206_length_1166_cov_313.815370	497	577	883	2	80	0.0250000
NODE_4206_length_1166_cov_313.815370	497	577	884	1	80	0.0125000
NODE_4206_length_1166_cov_313.815370	497	577	885	1	80	0.0125000
NODE_4206_length_1166_cov_313.815370	497	568	651	1	71	0.0140845
NODE_4206_length_1166_cov_313.815370	497	568	662	1	71	0.0140845
NODE_4206_length_1166_cov_313.815370	497	568	668	1	71	0.0140845
NODE_4206_length_1166_cov_313.815370	497	568	681	1	71	0.0140845
NODE_4206_length_1166_cov_313.815370	497	568	692	1	71	0.0140845
NODE_4206_length_1166_cov_313.815370	497	568	702	1	71	0.0140845
NODE_4206_length_1166_cov_313.815370	497	568	719	1	71	0.0140845
NODE_4206_length_1166_cov_313.815370	497	568	744	1	71	0.0140845
NODE_4206_length_1166_cov_313.815370	497	568	746	1	71	0.0140845
NODE_4206_length_1166_cov_313.815370	497	568	754	1	71	0.0140845
NODE_4206_length_1166_cov_313.815370	497	568	781	1	71	0.0140845
NODE_4206_length_1166_cov_313.815370	497	568	782	1	71	0.0140845
NODE_4206_length_1166_cov_313.815370	497	568	791	1	71	0.0140845
NODE_4206_length_1166_cov_313.815370	497	568	808	1	71	0.0140845
NODE_4206_length_1166_cov_313.815370	497	568	824	1	71	0.0140845
NODE_4206_length_1166_cov_313.815370	497	568	839	5	71	0.0704225
NODE_4206_length_1166_cov_313.815370	497	568	840	1	71	0.0140845
NODE_4206_length_1166_cov_313.815370	497	568	846	1	71	0.0140845
NODE_4206_length_1166_cov_313.815370	497	568	851	1	71	0.0140845
NODE_4206_length_1166_cov_313.815370	497	568	852	1	71	0.0140845
NODE_4206_length_1166_cov_313.815370	497	568	854	1	71	0.0140845
NODE_4206_length_1166_cov_313.815370	497	568	855	2	71	0.0281690
NODE_4206_length_1166_cov_313.815370	497	568	860	1	71	0.0140845
NODE_4206_length_1166_cov_313.815370	497	568	863	2	71	0.0281690
NODE_4206_length_1166_cov_313.815370	497	568	864	1	71	0.0140845
NODE_4206_length_1166_cov_313.815370	497	568	865	1	71	0.0140845
NODE_4206_length_1166_cov_313.815370	497	568	866	2	71	0.0281690
NODE_4206_length_1166_cov_313.815370	497	568	867	1	71	0.0140845
NODE_4206_length_1166_cov_313.815370	497	568	868	1	71	0.0140845
NODE_4206_length_1166_cov_313.815370	497	568	869	5	71	0.0704225
NODE_4206_length_1166_cov_313.815370	497	568	870	11	71	0.1549296
NODE_4206_length_1166_cov_313.815370	497	568	871	5	71	0.0704225
NODE_4206_length_1166_cov_313.815370	497	568	872	1	71	0.0140845
NODE_4206_length_1166_cov_313.815370	497	568	873	2	71	0.0281690
NODE_4206_length_1166_cov_313.815370	497	568	874	1	71	0.0140845
NODE_4206_length_1166_cov_313.815370	497	568	875	2	71	0.0281690
NODE_4206_length_1166_cov_313.815370	497	568	880	1	71	0.0140845
NODE_4206_length_1166_cov_313.815370	497	568	882	3	71	0.0422535
NODE_4206_length_1166_cov_313.815370	497	568	883	2	71	0.0281690
NODE_4206_length_1166_cov_313.815370	497	568	884	1	71	0.0140845
NODE_4206_length_1166_cov_313.815370	497	568	885	1	71	0.0140845
NODE_4206_length_1166_cov_313.815370	500	570	681	1	70	0.0142857
NODE_4206_length_1166_cov_313.815370	500	570	692	1	70	0.0142857
NODE_4206_length_1166_cov_313.815370	500	570	702	1	70	0.0142857
NODE_4206_length_1166_cov_313.815370	500	570	719	1	70	0.0142857
NODE_4206_length_1166_cov_313.815370	500	570	744	1	70	0.0142857
NODE_4206_length_1166_cov_313.815370	500	570	746	1	70	0.0142857
NODE_4206_length_1166_cov_313.815370	500	570	754	1	70	0.0142857
NODE_4206_length_1166_cov_313.815370	500	570	781	1	70	0.0142857
NODE_4206_length_1166_cov_313.815370	500	570	782	1	70	0.0142857
NODE_4206_length_1166_cov_313.815370	500	570	791	1	70	0.0142857
NODE_4206_length_1166_cov_313.815370	500	570	808	1	70	0.0142857
NODE_4206_length_1166_cov_313.815370	500	570	824	1	70	0.0142857
NODE_4206_length_1166_cov_313.815370	500	570	839	5	70	0.0714286
NODE_4206_length_1166_cov_313.815370	500	570	840	1	70	0.0142857
NODE_4206_length_1166_cov_313.815370	500	570	846	1	70	0.0142857
NODE_4206_length_1166_cov_313.815370	500	570	849	1	70	0.0142857
NODE_4206_length_1166_cov_313.815370	500	570	851	1	70	0.0142857
NODE_4206_length_1166_cov_313.815370	500	570	852	1	70	0.0142857
NODE_4206_length_1166_cov_313.815370	500	570	854	1	70	0.0142857
NODE_4206_length_1166_cov_313.815370	500	570	855	2	70	0.0285714
NODE_4206_length_1166_cov_313.815370	500	570	860	1	70	0.0142857
NODE_4206_length_1166_cov_313.815370	500	570	863	2	70	0.0285714
NODE_4206_length_1166_cov_313.815370	500	570	864	1	70	0.0142857
NODE_4206_length_1166_cov_313.815370	500	570	865	1	70	0.0142857
NODE_4206_length_1166_cov_313.815370	500	570	866	2	70	0.0285714
NODE_4206_length_1166_cov_313.815370	500	570	867	1	70	0.0142857
NODE_4206_length_1166_cov_313.815370	500	570	868	1	70	0.0142857
NODE_4206_length_1166_cov_313.815370	500	570	869	5	70	0.0714286
NODE_4206_length_1166_cov_313.815370	500	570	870	12	70	0.1714286
NODE_4206_length_1166_cov_313.815370	500	570	871	5	70	0.0714286
NODE_4206_length_1166_cov_313.815370	500	570	872	1	70	0.0142857
NODE_4206_length_1166_cov_313.815370	500	570	873	2	70	0.0285714
NODE_4206_length_1166_cov_313.815370	500	570	874	1	70	0.0142857
NODE_4206_length_1166_cov_313.815370	500	570	875	2	70	0.0285714
NODE_4206_length_1166_cov_313.815370	500	570	880	1	70	0.0142857
NODE_4206_length_1166_cov_313.815370	500	570	882	3	70	0.0428571
NODE_4206_length_1166_cov_313.815370	500	570	883	2	70	0.0285714
NODE_4206_length_1166_cov_313.815370	500	570	884	1	70	0.0142857
NODE_4206_length_1166_cov_313.815370	500	570	885	1	70	0.0142857
NODE_4206_length_1166_cov_313.815370	997	1077	0	14	80	0.1750000
NODE_4206_length_1166_cov_313.815370	997	1077	6	32	80	0.4000000
NODE_4206_length_1166_cov_313.815370	997	1077	7	14	80	0.1750000
NODE_4206_length_1166_cov_313.815370	997	1077	8	20	80	0.2500000
NODE_4206_length_1166_cov_313.815370	1050	1130	2	14	80	0.1750000
NODE_4206_length_1166_cov_313.815370	1050	1130	6	1	80	0.0125000
NODE_4206_length_1166_cov_313.815370	1050	1130	7	52	80	0.6500000
NODE_4206_length_1166_cov_313.815370	1050	1130	8	13	80	0.1625000
NODE_4206_length_1166_cov_313.815370	1050	1130	2	14	80	0.1750000
NODE_4206_length_1166_cov_313.815370	1050	1130	6	1	80	0.0125000
NODE_4206_length_1166_cov_313.815370	1050	1130	7	52	80	0.6500000
NODE_4206_length_1166_cov_313.815370	1050	1130	8	13	80	0.1625000
NODE_4206_length_1166_cov_313.815370	1050	1121	2	5	71	0.0704225
NODE_4206_length_1166_cov_313.815370	1050	1121	6	1	71	0.0140845
NODE_4206_length_1166_cov_313.815370	1050	1121	7	52	71	0.7323943
NODE_4206_length_1166_cov_313.815370	1050	1121	8	13	71	0.1830986
NODE_4207_length_1166_cov_25.107779	561	641	2	80	80	1.0000000
NODE_4207_length_1166_cov_25.107779	614	694	0	16	80	0.2000000
NODE_4207_length_1166_cov_25.107779	614	694	2	64	80	0.8000000
NODE_4209_length_1166_cov_18.820056	325	405	0	80	80	1.0000000
NODE_4209_length_1166_cov_18.820056	378	458	0	80	80	1.0000000
NODE_4210_length_1166_cov_18.404873	676	756	0	80	80	1.0000000
NODE_4210_length_1166_cov_18.404873	729	809	0	80	80	1.0000000
NODE_4214_length_1166_cov_1.893158	0	71	0	71	71	1.0000000
NODE_4214_length_1166_cov_1.893158	44	99	0	55	55	1.0000000
NODE_4218_length_1165_cov_29.402439	497	577	0	15	80	0.1875000
NODE_4218_length_1165_cov_29.402439	497	577	2	65	80	0.8125000
NODE_4218_length_1165_cov_29.402439	550	630	0	68	80	0.8500000
NODE_4218_length_1165_cov_29.402439	550	630	2	12	80	0.1500000
NODE_4218_length_1165_cov_29.402439	626	706	0	80	80	1.0000000
NODE_4218_length_1165_cov_29.402439	679	759	0	80	80	1.0000000
NODE_4219_length_1165_cov_28.366792	663	743	2	10	80	0.1250000
NODE_4219_length_1165_cov_28.366792	663	743	8	28	80	0.3500000
NODE_4219_length_1165_cov_28.366792	663	743	18	9	80	0.1125000
NODE_4219_length_1165_cov_28.366792	663	743	20	33	80	0.4125000
NODE_4219_length_1165_cov_28.366792	716	796	12	37	80	0.4625000
NODE_4219_length_1165_cov_28.366792	716	796	18	25	80	0.3125000
NODE_4219_length_1165_cov_28.366792	716	796	20	18	80	0.2250000
NODE_4220_length_1165_cov_23.841463	631	711	0	80	80	1.0000000
NODE_4220_length_1165_cov_23.841463	684	765	0	81	81	1.0000000
NODE_4220_length_1165_cov_23.841463	761	841	0	80	80	1.0000000
NODE_4220_length_1165_cov_23.841463	814	894	0	80	80	1.0000000
NODE_4221_length_1165_cov_21.883677	482	562	0	27	80	0.3375000
NODE_4221_length_1165_cov_21.883677	482	562	4	22	80	0.2750000
NODE_4221_length_1165_cov_21.883677	482	562	8	31	80	0.3875000
NODE_4221_length_1165_cov_21.883677	535	615	8	80	80	1.0000000
NODE_4222_length_1165_cov_14.591932	295	375	2	80	80	1.0000000
NODE_4222_length_1165_cov_14.591932	348	428	0	40	80	0.5000000
NODE_4222_length_1165_cov_14.591932	348	428	2	40	80	0.5000000
NODE_4223_length_1165_cov_13.683865	502	582	0	80	80	1.0000000
NODE_4223_length_1165_cov_13.683865	555	635	0	80	80	1.0000000
NODE_4224_length_1165_cov_7.915572	383	463	0	80	80	1.0000000
NODE_4224_length_1165_cov_7.915572	436	516	0	80	80	1.0000000
NODE_4225_length_1165_cov_7.466229	552	632	0	80	80	1.0000000
NODE_4225_length_1165_cov_7.466229	605	685	0	80	80	1.0000000
NODE_4226_length_1165_cov_5.617261	676	756	0	80	80	1.0000000
NODE_4226_length_1165_cov_5.617261	729	809	0	75	80	0.9375000
NODE_4226_length_1165_cov_5.617261	729	809	4	5	80	0.0625000
NODE_4227_length_1165_cov_3.658537	554	602	1	32	48	0.6666667
NODE_4227_length_1165_cov_3.658537	554	602	2	7	48	0.1458333
NODE_4227_length_1165_cov_3.658537	554	602	3	9	48	0.1875000
NODE_4233_length_1164_cov_55.273239	459	539	2	80	80	1.0000000
NODE_4233_length_1164_cov_55.273239	512	592	0	20	80	0.2500000
NODE_4233_length_1164_cov_55.273239	512	592	1	5	80	0.0625000
NODE_4233_length_1164_cov_55.273239	512	592	2	55	80	0.6875000
NODE_4234_length_1164_cov_44.183099	571	651	0	6	80	0.0750000
NODE_4234_length_1164_cov_44.183099	571	651	2	59	80	0.7375000
NODE_4234_length_1164_cov_44.183099	571	651	4	15	80	0.1875000
NODE_4234_length_1164_cov_44.183099	624	704	2	65	80	0.8125000
NODE_4234_length_1164_cov_44.183099	624	704	4	15	80	0.1875000
NODE_4234_length_1164_cov_44.183099	700	780	2	8	80	0.1000000
NODE_4234_length_1164_cov_44.183099	700	780	3	35	80	0.4375000
NODE_4234_length_1164_cov_44.183099	700	780	5	37	80	0.4625000
NODE_4234_length_1164_cov_44.183099	753	833	2	10	80	0.1250000
NODE_4234_length_1164_cov_44.183099	753	833	3	12	80	0.1500000
NODE_4234_length_1164_cov_44.183099	753	833	5	20	80	0.2500000
NODE_4234_length_1164_cov_44.183099	753	833	6	38	80	0.4750000
NODE_4235_length_1164_cov_14.277934	1029	1109	16	1	80	0.0125000
NODE_4235_length_1164_cov_14.277934	1029	1109	18	5	80	0.0625000
NODE_4235_length_1164_cov_14.277934	1029	1109	38	1	80	0.0125000
NODE_4235_length_1164_cov_14.277934	1029	1109	40	1	80	0.0125000
NODE_4235_length_1164_cov_14.277934	1029	1109	41	2	80	0.0250000
NODE_4235_length_1164_cov_14.277934	1029	1109	56	6	80	0.0750000
NODE_4235_length_1164_cov_14.277934	1029	1109	62	3	80	0.0375000
NODE_4235_length_1164_cov_14.277934	1029	1109	65	1	80	0.0125000
NODE_4235_length_1164_cov_14.277934	1029	1109	69	1	80	0.0125000
NODE_4235_length_1164_cov_14.277934	1029	1109	70	4	80	0.0500000
NODE_4235_length_1164_cov_14.277934	1029	1109	71	10	80	0.1250000
NODE_4235_length_1164_cov_14.277934	1029	1109	72	4	80	0.0500000
NODE_4235_length_1164_cov_14.277934	1029	1109	75	18	80	0.2250000
NODE_4235_length_1164_cov_14.277934	1029	1109	76	1	80	0.0125000
NODE_4235_length_1164_cov_14.277934	1029	1109	78	9	80	0.1125000
NODE_4235_length_1164_cov_14.277934	1029	1109	79	13	80	0.1625000
NODE_4235_length_1164_cov_14.277934	1097	1162	0	13	65	0.2000000
NODE_4235_length_1164_cov_14.277934	1097	1162	4	18	65	0.2769231
NODE_4235_length_1164_cov_14.277934	1097	1162	11	1	65	0.0153846
NODE_4235_length_1164_cov_14.277934	1097	1162	12	17	65	0.2615385
NODE_4235_length_1164_cov_14.277934	1097	1162	16	5	65	0.0769231
NODE_4235_length_1164_cov_14.277934	1097	1162	18	5	65	0.0769231
NODE_4235_length_1164_cov_14.277934	1097	1162	38	1	65	0.0153846
NODE_4235_length_1164_cov_14.277934	1097	1162	40	1	65	0.0153846
NODE_4235_length_1164_cov_14.277934	1097	1162	41	2	65	0.0307692
NODE_4235_length_1164_cov_14.277934	1097	1162	56	2	65	0.0307692
NODE_4236_length_1164_cov_12.880751	415	495	0	80	80	1.0000000
NODE_4236_length_1164_cov_12.880751	468	548	0	80	80	1.0000000
NODE_4237_length_1164_cov_6.924883	415	495	0	26	80	0.3250000
NODE_4237_length_1164_cov_6.924883	415	495	2	54	80	0.6750000
NODE_4237_length_1164_cov_6.924883	468	548	0	48	80	0.6000000
NODE_4237_length_1164_cov_6.924883	468	548	2	32	80	0.4000000
NODE_4245_length_1163_cov_36.315789	458	538	0	19	80	0.2375000
NODE_4245_length_1163_cov_36.315789	458	538	2	29	80	0.3625000
NODE_4245_length_1163_cov_36.315789	458	538	4	32	80	0.4000000
NODE_4245_length_1163_cov_36.315789	511	591	0	72	80	0.9000000
NODE_4245_length_1163_cov_36.315789	511	591	2	8	80	0.1000000
NODE_4245_length_1163_cov_36.315789	587	667	0	80	80	1.0000000
NODE_4245_length_1163_cov_36.315789	640	720	0	80	80	1.0000000
NODE_4246_length_1163_cov_29.466165	542	622	0	20	80	0.2500000
NODE_4246_length_1163_cov_29.466165	542	622	2	60	80	0.7500000
NODE_4246_length_1163_cov_29.466165	595	675	0	41	80	0.5125000
NODE_4246_length_1163_cov_29.466165	595	675	2	39	80	0.4875000
NODE_4246_length_1163_cov_29.466165	671	751	0	80	80	1.0000000
NODE_4246_length_1163_cov_29.466165	724	804	0	40	80	0.5000000
NODE_4246_length_1163_cov_29.466165	724	804	2	40	80	0.5000000
NODE_4247_length_1163_cov_15.107143	668	748	0	44	80	0.5500000
NODE_4247_length_1163_cov_15.107143	668	748	2	36	80	0.4500000
NODE_4247_length_1163_cov_15.107143	721	801	0	13	80	0.1625000
NODE_4247_length_1163_cov_15.107143	721	801	2	67	80	0.8375000
NODE_4248_length_1163_cov_14.347744	540	620	0	80	80	1.0000000
NODE_4248_length_1163_cov_14.347744	593	673	0	80	80	1.0000000
NODE_4249_length_1163_cov_11.650376	354	434	0	56	80	0.7000000
NODE_4249_length_1163_cov_11.650376	354	434	7	24	80	0.3000000
NODE_4249_length_1163_cov_11.650376	407	487	0	3	80	0.0375000
NODE_4249_length_1163_cov_11.650376	407	487	7	77	80	0.9625000
NODE_4249_length_1163_cov_11.650376	738	818	0	29	80	0.3625000
NODE_4249_length_1163_cov_11.650376	738	818	2	51	80	0.6375000
NODE_4249_length_1163_cov_11.650376	791	871	2	80	80	1.0000000
NODE_4253_length_1162_cov_30.049859	359	439	6	32	80	0.4000000
NODE_4253_length_1162_cov_30.049859	359	439	15	1	80	0.0125000
NODE_4253_length_1162_cov_30.049859	359	439	16	47	80	0.5875000
NODE_4253_length_1162_cov_30.049859	412	492	0	11	80	0.1375000
NODE_4253_length_1162_cov_30.049859	412	492	10	17	80	0.2125000
NODE_4253_length_1162_cov_30.049859	412	492	11	1	80	0.0125000
NODE_4253_length_1162_cov_30.049859	412	492	16	51	80	0.6375000
NODE_4254_length_1162_cov_25.960489	440	520	0	66	80	0.8250000
NODE_4254_length_1162_cov_25.960489	440	520	2	14	80	0.1750000
NODE_4254_length_1162_cov_25.960489	493	573	0	45	80	0.5625000
NODE_4254_length_1162_cov_25.960489	493	573	2	35	80	0.4375000
NODE_4254_length_1162_cov_25.960489	569	649	0	80	80	1.0000000
NODE_4254_length_1162_cov_25.960489	622	702	0	80	80	1.0000000
NODE_4255_length_1162_cov_24.843838	523	603	0	18	80	0.2250000
NODE_4255_length_1162_cov_24.843838	523	603	19	1	80	0.0125000
NODE_4255_length_1162_cov_24.843838	523	603	20	61	80	0.7625000
NODE_4255_length_1162_cov_24.843838	576	656	0	4	80	0.0500000
NODE_4255_length_1162_cov_24.843838	576	656	18	2	80	0.0250000
NODE_4255_length_1162_cov_24.843838	576	656	19	28	80	0.3500000
NODE_4255_length_1162_cov_24.843838	576	656	20	46	80	0.5750000
NODE_4255_length_1162_cov_24.843838	652	732	0	80	80	1.0000000
NODE_4255_length_1162_cov_24.843838	705	785	0	80	80	1.0000000
NODE_4257_length_1162_cov_17.131703	302	382	0	3	80	0.0375000
NODE_4257_length_1162_cov_17.131703	302	382	2	77	80	0.9625000
NODE_4257_length_1162_cov_17.131703	355	435	2	54	80	0.6750000
NODE_4257_length_1162_cov_17.131703	355	435	4	26	80	0.3250000
NODE_4257_length_1162_cov_17.131703	431	511	2	80	80	1.0000000
NODE_4257_length_1162_cov_17.131703	484	564	0	45	80	0.5625000
NODE_4257_length_1162_cov_17.131703	484	564	2	35	80	0.4375000
NODE_4258_length_1162_cov_14.766698	630	710	0	80	80	1.0000000
NODE_4258_length_1162_cov_14.766698	683	763	0	80	80	1.0000000
NODE_4259_length_1162_cov_13.968015	423	503	0	80	80	1.0000000
NODE_4259_length_1162_cov_13.968015	476	556	0	80	80	1.0000000
NODE_4264_length_1162_cov_1.977422	855	926	0	71	71	1.0000000
NODE_4264_length_1162_cov_1.977422	908	977	0	69	69	1.0000000
NODE_4264_length_1162_cov_1.977422	908	977	0	69	69	1.0000000
NODE_4266_length_1161_cov_33.312618	456	536	0	5	80	0.0625000
NODE_4266_length_1161_cov_33.312618	456	536	2	75	80	0.9375000
NODE_4266_length_1161_cov_33.312618	509	587	0	20	78	0.2564103
NODE_4266_length_1161_cov_33.312618	509	587	2	58	78	0.7435898
NODE_4267_length_1161_cov_30.466102	594	674	0	80	80	1.0000000
NODE_4267_length_1161_cov_30.466102	647	727	0	80	80	1.0000000
NODE_4268_length_1161_cov_29.628060	426	506	0	64	80	0.8000000
NODE_4268_length_1161_cov_29.628060	426	506	4	16	80	0.2000000
NODE_4268_length_1161_cov_29.628060	479	559	0	80	80	1.0000000
NODE_4268_length_1161_cov_29.628060	603	683	0	80	80	1.0000000
NODE_4268_length_1161_cov_29.628060	656	736	0	80	80	1.0000000
NODE_4269_length_1161_cov_22.923729	492	572	0	80	80	1.0000000
NODE_4269_length_1161_cov_22.923729	545	625	0	80	80	1.0000000
NODE_4269_length_1161_cov_22.923729	621	701	0	80	80	1.0000000
NODE_4269_length_1161_cov_22.923729	674	754	0	80	80	1.0000000
NODE_4270_length_1161_cov_20.184557	480	560	0	80	80	1.0000000
NODE_4270_length_1161_cov_20.184557	533	613	0	80	80	1.0000000
NODE_4271_length_1161_cov_17.437853	375	455	0	80	80	1.0000000
NODE_4271_length_1161_cov_17.437853	428	508	0	80	80	1.0000000
NODE_4272_length_1161_cov_14.062147	375	455	0	67	80	0.8375000
NODE_4272_length_1161_cov_14.062147	375	455	4	13	80	0.1625000
NODE_4272_length_1161_cov_14.062147	428	508	0	14	80	0.1750000
NODE_4272_length_1161_cov_14.062147	428	508	4	66	80	0.8250000
NODE_4273_length_1161_cov_12.304143	381	461	0	80	80	1.0000000
NODE_4273_length_1161_cov_12.304143	434	514	0	80	80	1.0000000
NODE_4274_length_1161_cov_10.297552	598	678	0	80	80	1.0000000
NODE_4274_length_1161_cov_10.297552	651	731	0	80	80	1.0000000
NODE_4283_length_1160_cov_86.515551	613	693	2	36	80	0.4500000
NODE_4283_length_1160_cov_86.515551	613	693	157	1	80	0.0125000
NODE_4283_length_1160_cov_86.515551	613	693	162	14	80	0.1750000
NODE_4283_length_1160_cov_86.515551	613	693	165	3	80	0.0375000
NODE_4283_length_1160_cov_86.515551	613	693	167	11	80	0.1375000
NODE_4283_length_1160_cov_86.515551	613	693	168	15	80	0.1875000
NODE_4283_length_1160_cov_86.515551	666	746	165	1	80	0.0125000
NODE_4283_length_1160_cov_86.515551	666	746	167	11	80	0.1375000
NODE_4283_length_1160_cov_86.515551	666	746	168	20	80	0.2500000
NODE_4283_length_1160_cov_86.515551	666	746	169	1	80	0.0125000
NODE_4283_length_1160_cov_86.515551	666	746	170	1	80	0.0125000
NODE_4283_length_1160_cov_86.515551	666	746	172	9	80	0.1125000
NODE_4283_length_1160_cov_86.515551	666	746	174	4	80	0.0500000
NODE_4283_length_1160_cov_86.515551	666	746	175	1	80	0.0125000
NODE_4283_length_1160_cov_86.515551	666	746	180	1	80	0.0125000
NODE_4283_length_1160_cov_86.515551	666	746	181	1	80	0.0125000
NODE_4283_length_1160_cov_86.515551	666	746	182	5	80	0.0625000
NODE_4283_length_1160_cov_86.515551	666	746	190	1	80	0.0125000
NODE_4283_length_1160_cov_86.515551	666	746	191	1	80	0.0125000
NODE_4283_length_1160_cov_86.515551	666	746	192	1	80	0.0125000
NODE_4283_length_1160_cov_86.515551	666	746	194	3	80	0.0375000
NODE_4283_length_1160_cov_86.515551	666	746	195	5	80	0.0625000
NODE_4283_length_1160_cov_86.515551	666	746	196	10	80	0.1250000
NODE_4283_length_1160_cov_86.515551	666	746	197	2	80	0.0250000
NODE_4283_length_1160_cov_86.515551	666	746	198	2	80	0.0250000
NODE_4284_length_1160_cov_29.272385	526	606	0	8	80	0.1000000
NODE_4284_length_1160_cov_29.272385	526	606	2	72	80	0.9000000
NODE_4284_length_1160_cov_29.272385	579	659	0	61	80	0.7625000
NODE_4284_length_1160_cov_29.272385	579	659	2	19	80	0.2375000
NODE_4285_length_1160_cov_21.391140	767	847	0	5	80	0.0625000
NODE_4285_length_1160_cov_21.391140	767	847	2	36	80	0.4500000
NODE_4285_length_1160_cov_21.391140	767	847	7	39	80	0.4875000
NODE_4296_length_1159_cov_147.794340	911	991	101	1	80	0.0125000
NODE_4296_length_1159_cov_147.794340	911	991	103	2	80	0.0250000
NODE_4296_length_1159_cov_147.794340	911	991	107	1	80	0.0125000
NODE_4296_length_1159_cov_147.794340	911	991	108	2	80	0.0250000
NODE_4296_length_1159_cov_147.794340	911	991	109	1	80	0.0125000
NODE_4296_length_1159_cov_147.794340	911	991	111	3	80	0.0375000
NODE_4296_length_1159_cov_147.794340	911	991	113	2	80	0.0250000
NODE_4296_length_1159_cov_147.794340	911	991	115	5	80	0.0625000
NODE_4296_length_1159_cov_147.794340	911	991	117	4	80	0.0500000
NODE_4296_length_1159_cov_147.794340	911	991	118	1	80	0.0125000
NODE_4296_length_1159_cov_147.794340	911	991	119	3	80	0.0375000
NODE_4296_length_1159_cov_147.794340	911	991	121	3	80	0.0375000
NODE_4296_length_1159_cov_147.794340	911	991	129	1	80	0.0125000
NODE_4296_length_1159_cov_147.794340	911	991	133	1	80	0.0125000
NODE_4296_length_1159_cov_147.794340	911	991	139	1	80	0.0125000
NODE_4296_length_1159_cov_147.794340	911	991	143	2	80	0.0250000
NODE_4296_length_1159_cov_147.794340	911	991	147	1	80	0.0125000
NODE_4296_length_1159_cov_147.794340	911	991	149	1	80	0.0125000
NODE_4296_length_1159_cov_147.794340	911	991	151	2	80	0.0250000
NODE_4296_length_1159_cov_147.794340	911	991	153	1	80	0.0125000
NODE_4296_length_1159_cov_147.794340	911	991	159	1	80	0.0125000
NODE_4296_length_1159_cov_147.794340	911	991	167	8	80	0.1000000
NODE_4296_length_1159_cov_147.794340	911	991	169	3	80	0.0375000
NODE_4296_length_1159_cov_147.794340	911	991	171	2	80	0.0250000
NODE_4296_length_1159_cov_147.794340	911	991	173	3	80	0.0375000
NODE_4296_length_1159_cov_147.794340	911	991	175	6	80	0.0750000
NODE_4296_length_1159_cov_147.794340	911	991	177	6	80	0.0750000
NODE_4296_length_1159_cov_147.794340	911	991	179	1	80	0.0125000
NODE_4296_length_1159_cov_147.794340	911	991	180	1	80	0.0125000
NODE_4296_length_1159_cov_147.794340	911	991	182	5	80	0.0625000
NODE_4296_length_1159_cov_147.794340	911	991	184	4	80	0.0500000
NODE_4296_length_1159_cov_147.794340	911	991	186	2	80	0.0250000
NODE_4296_length_1159_cov_147.794340	964	1044	86	2	80	0.0250000
NODE_4296_length_1159_cov_147.794340	964	1044	88	1	80	0.0125000
NODE_4296_length_1159_cov_147.794340	964	1044	90	1	80	0.0125000
NODE_4296_length_1159_cov_147.794340	964	1044	99	1	80	0.0125000
NODE_4296_length_1159_cov_147.794340	964	1044	104	4	80	0.0500000
NODE_4296_length_1159_cov_147.794340	964	1044	108	1	80	0.0125000
NODE_4296_length_1159_cov_147.794340	964	1044	110	2	80	0.0250000
NODE_4296_length_1159_cov_147.794340	964	1044	116	1	80	0.0125000
NODE_4296_length_1159_cov_147.794340	964	1044	118	2	80	0.0250000
NODE_4296_length_1159_cov_147.794340	964	1044	122	3	80	0.0375000
NODE_4296_length_1159_cov_147.794340	964	1044	123	1	80	0.0125000
NODE_4296_length_1159_cov_147.794340	964	1044	124	4	80	0.0500000
NODE_4296_length_1159_cov_147.794340	964	1044	135	4	80	0.0500000
NODE_4296_length_1159_cov_147.794340	964	1044	137	3	80	0.0375000
NODE_4296_length_1159_cov_147.794340	964	1044	139	1	80	0.0125000
NODE_4296_length_1159_cov_147.794340	964	1044	143	3	80	0.0375000
NODE_4296_length_1159_cov_147.794340	964	1044	145	2	80	0.0250000
NODE_4296_length_1159_cov_147.794340	964	1044	147	1	80	0.0125000
NODE_4296_length_1159_cov_147.794340	964	1044	149	1	80	0.0125000
NODE_4296_length_1159_cov_147.794340	964	1044	151	2	80	0.0250000
NODE_4296_length_1159_cov_147.794340	964	1044	153	1	80	0.0125000
NODE_4296_length_1159_cov_147.794340	964	1044	165	3	80	0.0375000
NODE_4296_length_1159_cov_147.794340	964	1044	167	5	80	0.0625000
NODE_4296_length_1159_cov_147.794340	964	1044	169	5	80	0.0625000
NODE_4296_length_1159_cov_147.794340	964	1044	171	3	80	0.0375000
NODE_4296_length_1159_cov_147.794340	964	1044	173	4	80	0.0500000
NODE_4296_length_1159_cov_147.794340	964	1044	175	3	80	0.0375000
NODE_4296_length_1159_cov_147.794340	964	1044	177	4	80	0.0500000
NODE_4296_length_1159_cov_147.794340	964	1044	179	1	80	0.0125000
NODE_4296_length_1159_cov_147.794340	964	1044	182	5	80	0.0625000
NODE_4296_length_1159_cov_147.794340	964	1044	184	4	80	0.0500000
NODE_4296_length_1159_cov_147.794340	964	1044	186	2	80	0.0250000
NODE_4297_length_1159_cov_57.566981	457	537	0	40	80	0.5000000
NODE_4297_length_1159_cov_57.566981	457	537	2	40	80	0.5000000
NODE_4297_length_1159_cov_57.566981	510	590	0	13	80	0.1625000
NODE_4297_length_1159_cov_57.566981	510	590	2	67	80	0.8375000
NODE_4297_length_1159_cov_57.566981	586	666	0	80	80	1.0000000
NODE_4297_length_1159_cov_57.566981	639	719	0	29	80	0.3625000
NODE_4297_length_1159_cov_57.566981	639	719	4	5	80	0.0625000
NODE_4297_length_1159_cov_57.566981	639	719	5	46	80	0.5750000
NODE_4298_length_1159_cov_44.053774	329	409	0	71	80	0.8875000
NODE_4298_length_1159_cov_44.053774	329	409	4	9	80	0.1125000
NODE_4298_length_1159_cov_44.053774	382	462	0	18	80	0.2250000
NODE_4298_length_1159_cov_44.053774	382	462	4	51	80	0.6375000
NODE_4298_length_1159_cov_44.053774	382	462	6	11	80	0.1375000
NODE_4298_length_1159_cov_44.053774	458	538	2	45	80	0.5625000
NODE_4298_length_1159_cov_44.053774	458	538	6	35	80	0.4375000
NODE_4298_length_1159_cov_44.053774	511	591	0	8	80	0.1000000
NODE_4298_length_1159_cov_44.053774	511	591	2	72	80	0.9000000
NODE_4299_length_1159_cov_40.194340	391	471	0	4	80	0.0500000
NODE_4299_length_1159_cov_40.194340	391	471	5	2	80	0.0250000
NODE_4299_length_1159_cov_40.194340	391	471	6	43	80	0.5375000
NODE_4299_length_1159_cov_40.194340	391	471	8	31	80	0.3875000
NODE_4299_length_1159_cov_40.194340	444	524	8	44	80	0.5500000
NODE_4299_length_1159_cov_40.194340	444	524	12	18	80	0.2250000
NODE_4299_length_1159_cov_40.194340	444	524	14	2	80	0.0250000
NODE_4299_length_1159_cov_40.194340	444	524	16	16	80	0.2000000
NODE_4301_length_1159_cov_25.919811	456	536	4	80	80	1.0000000
NODE_4301_length_1159_cov_25.919811	509	591	0	49	82	0.5975610
NODE_4301_length_1159_cov_25.919811	509	591	4	33	82	0.4024390
NODE_4302_length_1159_cov_18.306604	538	618	0	17	80	0.2125000
NODE_4302_length_1159_cov_18.306604	538	618	2	63	80	0.7875000
NODE_4302_length_1159_cov_18.306604	591	671	0	70	80	0.8750000
NODE_4302_length_1159_cov_18.306604	591	671	2	10	80	0.1250000
NODE_4303_length_1159_cov_14.457547	358	438	0	80	80	1.0000000
NODE_4303_length_1159_cov_14.457547	411	491	0	80	80	1.0000000
NODE_4304_length_1159_cov_11.566981	625	705	2	1	80	0.0125000
NODE_4304_length_1159_cov_11.566981	625	705	8	68	80	0.8500000
NODE_4304_length_1159_cov_11.566981	625	705	10	11	80	0.1375000
NODE_4304_length_1159_cov_11.566981	678	758	0	31	80	0.3875000
NODE_4304_length_1159_cov_11.566981	678	758	2	13	80	0.1625000
NODE_4304_length_1159_cov_11.566981	678	758	8	36	80	0.4500000
NODE_4305_length_1159_cov_9.927358	278	358	0	20	80	0.2500000
NODE_4305_length_1159_cov_9.927358	278	358	2	60	80	0.7500000
NODE_4305_length_1159_cov_9.927358	331	411	0	73	80	0.9125000
NODE_4305_length_1159_cov_9.927358	331	411	2	7	80	0.0875000
NODE_4314_length_1159_cov_1.568868	513	562	2	29	49	0.5918368
NODE_4314_length_1159_cov_1.568868	513	562	4	20	49	0.4081633
NODE_4316_length_1158_cov_33.529745	357	437	0	80	80	1.0000000
NODE_4316_length_1158_cov_33.529745	410	490	0	80	80	1.0000000
NODE_4316_length_1158_cov_33.529745	486	566	0	11	80	0.1375000
NODE_4316_length_1158_cov_33.529745	486	566	2	68	80	0.8500000
NODE_4316_length_1158_cov_33.529745	486	566	3	1	80	0.0125000
NODE_4316_length_1158_cov_33.529745	539	619	2	26	80	0.3250000
NODE_4316_length_1158_cov_33.529745	539	619	3	54	80	0.6750000
NODE_4317_length_1158_cov_31.368272	416	496	0	35	80	0.4375000
NODE_4317_length_1158_cov_31.368272	416	496	2	45	80	0.5625000
NODE_4317_length_1158_cov_31.368272	469	549	0	80	80	1.0000000
NODE_4317_length_1158_cov_31.368272	545	626	0	81	81	1.0000000
NODE_4317_length_1158_cov_31.368272	599	679	0	80	80	1.0000000
NODE_4318_length_1158_cov_31.240793	430	510	0	80	80	1.0000000
NODE_4318_length_1158_cov_31.240793	483	563	0	80	80	1.0000000
NODE_4318_length_1158_cov_31.240793	559	639	0	74	80	0.9250000
NODE_4318_length_1158_cov_31.240793	559	639	2	4	80	0.0500000
NODE_4318_length_1158_cov_31.240793	559	639	4	2	80	0.0250000
NODE_4318_length_1158_cov_31.240793	612	692	0	21	80	0.2625000
NODE_4318_length_1158_cov_31.240793	612	692	2	4	80	0.0500000
NODE_4318_length_1158_cov_31.240793	612	692	4	55	80	0.6875000
NODE_4319_length_1158_cov_29.216242	405	485	0	80	80	1.0000000
NODE_4319_length_1158_cov_29.216242	458	538	0	80	80	1.0000000
NODE_4320_length_1158_cov_25.245515	500	580	0	80	80	1.0000000
NODE_4320_length_1158_cov_25.245515	553	633	0	80	80	1.0000000
NODE_4320_length_1158_cov_25.245515	629	709	0	37	80	0.4625000
NODE_4320_length_1158_cov_25.245515	629	709	2	43	80	0.5375000
NODE_4320_length_1158_cov_25.245515	682	762	2	80	80	1.0000000
NODE_4321_length_1158_cov_16.566572	396	476	0	60	80	0.7500000
NODE_4321_length_1158_cov_16.566572	396	476	4	14	80	0.1750000
NODE_4321_length_1158_cov_16.566572	396	476	10	6	80	0.0750000
NODE_4321_length_1158_cov_16.566572	449	529	0	7	80	0.0875000
NODE_4321_length_1158_cov_16.566572	449	529	4	14	80	0.1750000
NODE_4321_length_1158_cov_16.566572	449	529	10	59	80	0.7375000
NODE_4322_length_1158_cov_13.092540	372	452	0	80	80	1.0000000
NODE_4322_length_1158_cov_13.092540	425	505	0	80	80	1.0000000
NODE_4322_length_1158_cov_13.092540	735	815	0	80	80	1.0000000
NODE_4322_length_1158_cov_13.092540	788	868	0	80	80	1.0000000
NODE_4323_length_1158_cov_7.408876	656	736	0	80	80	1.0000000
NODE_4323_length_1158_cov_7.408876	709	789	0	80	80	1.0000000
NODE_4324_length_1158_cov_6.242682	239	310	2	71	71	1.0000000
NODE_4325_length_1158_cov_6.043437	531	611	0	80	80	1.0000000
NODE_4325_length_1158_cov_6.043437	584	634	0	50	50	1.0000000
NODE_4326_length_1158_cov_5.855524	324	404	0	72	80	0.9000000
NODE_4326_length_1158_cov_5.855524	324	404	2	8	80	0.1000000
NODE_4326_length_1158_cov_5.855524	377	457	0	80	80	1.0000000
NODE_4329_length_1157_cov_32.233459	472	552	4	22	80	0.2750000
NODE_4329_length_1157_cov_32.233459	472	552	8	13	80	0.1625000
NODE_4329_length_1157_cov_32.233459	472	552	9	11	80	0.1375000
NODE_4329_length_1157_cov_32.233459	472	552	10	28	80	0.3500000
NODE_4329_length_1157_cov_32.233459	472	552	11	6	80	0.0750000
NODE_4329_length_1157_cov_32.233459	525	605	0	17	80	0.2125000
NODE_4329_length_1157_cov_32.233459	525	605	2	1	80	0.0125000
NODE_4329_length_1157_cov_32.233459	525	605	4	57	80	0.7125000
NODE_4329_length_1157_cov_32.233459	525	605	8	5	80	0.0625000
NODE_4329_length_1157_cov_32.233459	601	681	0	80	80	1.0000000
NODE_4329_length_1157_cov_32.233459	654	734	0	80	80	1.0000000
NODE_4330_length_1157_cov_6.438563	765	788	1	23	23	1.0000000
NODE_4332_length_1157_cov_4.068053	221	292	0	71	71	1.0000000
NODE_4333_length_1156_cov_46.381268	328	408	0	80	80	1.0000000
NODE_4333_length_1156_cov_46.381268	381	461	0	80	80	1.0000000
NODE_4333_length_1156_cov_46.381268	457	537	0	50	80	0.6250000
NODE_4333_length_1156_cov_46.381268	457	537	4	21	80	0.2625000
NODE_4333_length_1156_cov_46.381268	457	537	6	9	80	0.1125000
NODE_4333_length_1156_cov_46.381268	510	590	4	18	80	0.2250000
NODE_4333_length_1156_cov_46.381268	510	590	6	62	80	0.7750000
NODE_4334_length_1156_cov_32.198675	378	458	2	80	80	1.0000000
NODE_4334_length_1156_cov_32.198675	431	511	0	2	80	0.0250000
NODE_4334_length_1156_cov_32.198675	431	511	2	78	80	0.9750000
NODE_4334_length_1156_cov_32.198675	507	587	0	32	80	0.4000000
NODE_4334_length_1156_cov_32.198675	507	587	2	48	80	0.6000000
NODE_4334_length_1156_cov_32.198675	560	641	0	40	81	0.4938272
NODE_4334_length_1156_cov_32.198675	560	641	2	41	81	0.5061728
NODE_4335_length_1156_cov_12.683065	593	673	0	80	80	1.0000000
NODE_4335_length_1156_cov_12.683065	646	726	0	80	80	1.0000000
NODE_4336_length_1156_cov_9.287606	680	760	0	11	80	0.1375000
NODE_4336_length_1156_cov_9.287606	680	760	2	28	80	0.3500000
NODE_4336_length_1156_cov_9.287606	680	760	4	41	80	0.5125000
NODE_4336_length_1156_cov_9.287606	733	813	2	7	80	0.0875000
NODE_4336_length_1156_cov_9.287606	733	813	4	73	80	0.9125000
NODE_4339_length_1155_cov_19.570076	437	517	0	80	80	1.0000000
NODE_4339_length_1155_cov_19.570076	490	570	0	80	80	1.0000000
NODE_4340_length_1155_cov_18.666667	332	412	1	41	80	0.5125000
NODE_4340_length_1155_cov_18.666667	332	412	2	39	80	0.4875000
NODE_4340_length_1155_cov_18.666667	385	465	2	80	80	1.0000000
NODE_4346_length_1154_cov_61.769668	488	568	0	19	80	0.2375000
NODE_4346_length_1154_cov_61.769668	488	568	2	61	80	0.7625000
NODE_4346_length_1154_cov_61.769668	541	621	0	27	80	0.3375000
NODE_4346_length_1154_cov_61.769668	541	621	2	8	80	0.1000000
NODE_4346_length_1154_cov_61.769668	541	621	4	17	80	0.2125000
NODE_4346_length_1154_cov_61.769668	541	621	6	2	80	0.0250000
NODE_4346_length_1154_cov_61.769668	541	621	8	26	80	0.3250000
NODE_4347_length_1154_cov_50.909005	409	489	0	3	80	0.0375000
NODE_4347_length_1154_cov_50.909005	409	489	2	77	80	0.9625000
NODE_4347_length_1154_cov_50.909005	462	542	0	56	80	0.7000000
NODE_4347_length_1154_cov_50.909005	462	542	2	24	80	0.3000000
NODE_4347_length_1154_cov_50.909005	538	618	0	80	80	1.0000000
NODE_4347_length_1154_cov_50.909005	591	671	0	80	80	1.0000000
NODE_4348_length_1154_cov_28.941232	695	775	1	2	80	0.0250000
NODE_4348_length_1154_cov_28.941232	695	775	2	31	80	0.3875000
NODE_4348_length_1154_cov_28.941232	695	775	6	10	80	0.1250000
NODE_4348_length_1154_cov_28.941232	695	775	8	37	80	0.4625000
NODE_4348_length_1154_cov_28.941232	748	828	0	12	80	0.1500000
NODE_4348_length_1154_cov_28.941232	748	828	6	51	80	0.6375000
NODE_4348_length_1154_cov_28.941232	748	828	8	17	80	0.2125000
NODE_4349_length_1154_cov_13.765877	322	402	1	22	80	0.2750000
NODE_4349_length_1154_cov_13.765877	322	402	7	58	80	0.7250000
NODE_4349_length_1154_cov_13.765877	375	455	1	75	80	0.9375000
NODE_4349_length_1154_cov_13.765877	375	455	7	5	80	0.0625000
NODE_4351_length_1154_cov_5.930806	497	577	0	80	80	1.0000000
NODE_4351_length_1154_cov_5.930806	550	622	0	72	72	1.0000000
NODE_4357_length_1153_cov_65.486717	416	496	0	80	80	1.0000000
NODE_4357_length_1153_cov_65.486717	469	549	0	76	80	0.9500000
NODE_4357_length_1153_cov_65.486717	469	549	2	4	80	0.0500000
NODE_4357_length_1153_cov_65.486717	545	625	2	10	80	0.1250000
NODE_4357_length_1153_cov_65.486717	545	625	10	50	80	0.6250000
NODE_4357_length_1153_cov_65.486717	545	625	12	20	80	0.2500000
NODE_4357_length_1153_cov_65.486717	598	678	0	14	80	0.1750000
NODE_4357_length_1153_cov_65.486717	598	678	8	25	80	0.3125000
NODE_4357_length_1153_cov_65.486717	598	678	10	38	80	0.4750000
NODE_4357_length_1153_cov_65.486717	598	678	12	3	80	0.0375000
NODE_4358_length_1153_cov_50.733397	404	484	0	10	80	0.1250000
NODE_4358_length_1153_cov_50.733397	404	484	2	30	80	0.3750000
NODE_4358_length_1153_cov_50.733397	404	484	4	40	80	0.5000000
NODE_4358_length_1153_cov_50.733397	457	537	0	63	80	0.7875000
NODE_4358_length_1153_cov_50.733397	457	537	2	17	80	0.2125000
NODE_4358_length_1153_cov_50.733397	533	613	0	11	80	0.1375000
NODE_4358_length_1153_cov_50.733397	533	613	6	69	80	0.8625000
NODE_4358_length_1153_cov_50.733397	586	666	0	13	80	0.1625000
NODE_4358_length_1153_cov_50.733397	586	666	6	67	80	0.8375000
NODE_4359_length_1153_cov_26.131879	493	573	1	80	80	1.0000000
NODE_4359_length_1153_cov_26.131879	546	626	0	20	80	0.2500000
NODE_4359_length_1153_cov_26.131879	546	626	1	60	80	0.7500000
NODE_4360_length_1153_cov_10.195446	500	580	12	31	80	0.3875000
NODE_4360_length_1153_cov_10.195446	500	580	14	49	80	0.6125000
NODE_4360_length_1153_cov_10.195446	553	633	0	36	80	0.4500000
NODE_4360_length_1153_cov_10.195446	553	633	2	1	80	0.0125000
NODE_4360_length_1153_cov_10.195446	553	633	13	1	80	0.0125000
NODE_4360_length_1153_cov_10.195446	553	633	14	42	80	0.5250000
NODE_4361_length_1153_cov_8.286528	558	638	0	66	80	0.8250000
NODE_4361_length_1153_cov_8.286528	558	638	2	14	80	0.1750000
NODE_4361_length_1153_cov_8.286528	611	691	0	13	80	0.1625000
NODE_4361_length_1153_cov_8.286528	611	691	2	67	80	0.8375000
NODE_4368_length_1152_cov_19.800570	553	633	4	17	80	0.2125000
NODE_4368_length_1152_cov_19.800570	553	633	8	31	80	0.3875000
NODE_4368_length_1152_cov_19.800570	553	633	12	32	80	0.4000000
NODE_4368_length_1152_cov_19.800570	606	686	4	8	80	0.1000000
NODE_4368_length_1152_cov_19.800570	606	686	6	24	80	0.3000000
NODE_4368_length_1152_cov_19.800570	606	686	8	14	80	0.1750000
NODE_4368_length_1152_cov_19.800570	606	686	12	34	80	0.4250000
NODE_4369_length_1152_cov_19.365622	490	570	0	80	80	1.0000000
NODE_4369_length_1152_cov_19.365622	543	623	0	80	80	1.0000000
NODE_4370_length_1152_cov_18.654321	594	674	2	24	80	0.3000000
NODE_4370_length_1152_cov_18.654321	594	674	4	18	80	0.2250000
NODE_4370_length_1152_cov_18.654321	594	674	6	38	80	0.4750000
NODE_4370_length_1152_cov_18.654321	647	727	0	39	80	0.4875000
NODE_4370_length_1152_cov_18.654321	647	727	4	32	80	0.4000000
NODE_4370_length_1152_cov_18.654321	647	727	6	9	80	0.1125000
NODE_4371_length_1152_cov_18.075024	377	457	0	80	80	1.0000000
NODE_4371_length_1152_cov_18.075024	430	510	0	80	80	1.0000000
NODE_4371_length_1152_cov_18.075024	506	586	0	80	80	1.0000000
NODE_4371_length_1152_cov_18.075024	559	639	0	51	80	0.6375000
NODE_4371_length_1152_cov_18.075024	559	639	2	29	80	0.3625000
NODE_4373_length_1152_cov_16.047483	543	623	0	36	80	0.4500000
NODE_4373_length_1152_cov_16.047483	543	623	2	44	80	0.5500000
NODE_4373_length_1152_cov_16.047483	596	676	2	80	80	1.0000000
NODE_4373_length_1152_cov_16.047483	672	752	0	44	80	0.5500000
NODE_4373_length_1152_cov_16.047483	672	752	2	36	80	0.4500000
NODE_4373_length_1152_cov_16.047483	725	805	0	80	80	1.0000000
NODE_4374_length_1152_cov_13.981007	583	663	0	80	80	1.0000000
NODE_4374_length_1152_cov_13.981007	636	716	0	80	80	1.0000000
NODE_4380_length_1151_cov_30.469582	479	559	0	80	80	1.0000000
NODE_4380_length_1151_cov_30.469582	532	612	0	80	80	1.0000000
NODE_4381_length_1151_cov_26.650190	567	647	0	52	80	0.6500000
NODE_4381_length_1151_cov_26.650190	567	647	2	28	80	0.3500000
NODE_4381_length_1151_cov_26.650190	620	700	2	80	80	1.0000000
NODE_4382_length_1151_cov_26.375475	441	521	7	14	80	0.1750000
NODE_4382_length_1151_cov_26.375475	441	521	9	36	80	0.4500000
NODE_4382_length_1151_cov_26.375475	441	521	11	30	80	0.3750000
NODE_4382_length_1151_cov_26.375475	494	574	0	13	80	0.1625000
NODE_4382_length_1151_cov_26.375475	494	574	2	4	80	0.0500000
NODE_4382_length_1151_cov_26.375475	494	574	7	13	80	0.1625000
NODE_4382_length_1151_cov_26.375475	494	574	9	34	80	0.4250000
NODE_4382_length_1151_cov_26.375475	494	574	10	16	80	0.2000000
NODE_4382_length_1151_cov_26.375475	570	650	0	80	80	1.0000000
NODE_4382_length_1151_cov_26.375475	623	703	0	80	80	1.0000000
NODE_4383_length_1151_cov_23.614068	590	670	0	10	80	0.1250000
NODE_4383_length_1151_cov_23.614068	590	670	3	70	80	0.8750000
NODE_4383_length_1151_cov_23.614068	643	721	3	78	78	1.0000000
NODE_4384_length_1151_cov_18.693916	355	435	4	20	80	0.2500000
NODE_4384_length_1151_cov_18.693916	355	435	6	19	80	0.2375000
NODE_4384_length_1151_cov_18.693916	355	435	8	41	80	0.5125000
NODE_4384_length_1151_cov_18.693916	408	491	2	18	83	0.2168675
NODE_4384_length_1151_cov_18.693916	408	491	4	3	83	0.0361446
NODE_4384_length_1151_cov_18.693916	408	491	6	8	83	0.0963855
NODE_4384_length_1151_cov_18.693916	408	491	8	54	83	0.6506024
NODE_4385_length_1151_cov_16.093156	474	554	0	49	80	0.6125000
NODE_4385_length_1151_cov_16.093156	474	554	8	31	80	0.3875000
NODE_4385_length_1151_cov_16.093156	527	607	8	80	80	1.0000000
NODE_4386_length_1151_cov_13.782319	400	482	0	80	82	0.9756098
NODE_4386_length_1151_cov_13.782319	400	482	2	2	82	0.0243902
NODE_4386_length_1151_cov_13.782319	450	535	0	85	85	1.0000000
NODE_4392_length_1150_cov_38.601332	563	643	0	80	80	1.0000000
NODE_4392_length_1150_cov_38.601332	616	696	0	80	80	1.0000000
NODE_4392_length_1150_cov_38.601332	692	772	0	25	80	0.3125000
NODE_4392_length_1150_cov_38.601332	692	772	6	55	80	0.6875000
NODE_4392_length_1150_cov_38.601332	745	825	0	5	80	0.0625000
NODE_4392_length_1150_cov_38.601332	745	825	6	75	80	0.9375000
NODE_4393_length_1150_cov_15.741199	497	578	0	81	81	1.0000000
NODE_4393_length_1150_cov_15.741199	550	631	0	81	81	1.0000000
NODE_4394_length_1150_cov_11.132255	795	875	0	40	80	0.5000000
NODE_4394_length_1150_cov_11.132255	795	875	2	40	80	0.5000000
NODE_4394_length_1150_cov_11.132255	848	928	0	13	80	0.1625000
NODE_4394_length_1150_cov_11.132255	848	928	2	67	80	0.8375000
NODE_4395_length_1150_cov_9.253092	583	663	0	80	80	1.0000000
NODE_4395_length_1150_cov_9.253092	636	716	0	80	80	1.0000000
NODE_4398_length_1149_cov_17.289524	644	695	0	51	51	1.0000000
NODE_4399_length_1149_cov_13.805714	584	664	1	5	80	0.0625000
NODE_4399_length_1149_cov_13.805714	584	664	2	44	80	0.5500000
NODE_4399_length_1149_cov_13.805714	584	664	4	31	80	0.3875000
NODE_4399_length_1149_cov_13.805714	637	717	4	80	80	1.0000000
NODE_4399_length_1149_cov_13.805714	713	793	0	54	80	0.6750000
NODE_4399_length_1149_cov_13.805714	713	793	1	20	80	0.2500000
NODE_4399_length_1149_cov_13.805714	713	793	2	2	80	0.0250000
NODE_4399_length_1149_cov_13.805714	713	793	4	4	80	0.0500000
NODE_4399_length_1149_cov_13.805714	766	846	0	43	80	0.5375000
NODE_4399_length_1149_cov_13.805714	766	846	2	37	80	0.4625000
NODE_4407_length_1148_cov_27.674929	387	467	2	59	80	0.7375000
NODE_4407_length_1148_cov_27.674929	387	467	4	21	80	0.2625000
NODE_4407_length_1148_cov_27.674929	440	520	0	10	80	0.1250000
NODE_4407_length_1148_cov_27.674929	440	520	2	57	80	0.7125000
NODE_4407_length_1148_cov_27.674929	440	520	4	13	80	0.1625000
NODE_4408_length_1148_cov_13.275500	136	216	8	11	80	0.1375000
NODE_4408_length_1148_cov_13.275500	136	216	9	1	80	0.0125000
NODE_4408_length_1148_cov_13.275500	136	216	10	10	80	0.1250000
NODE_4408_length_1148_cov_13.275500	136	216	12	9	80	0.1125000
NODE_4408_length_1148_cov_13.275500	136	216	13	10	80	0.1250000
NODE_4408_length_1148_cov_13.275500	136	216	15	4	80	0.0500000
NODE_4408_length_1148_cov_13.275500	136	216	16	34	80	0.4250000
NODE_4408_length_1148_cov_13.275500	136	216	17	1	80	0.0125000
NODE_4408_length_1148_cov_13.275500	189	268	8	14	79	0.1772152
NODE_4408_length_1148_cov_13.275500	189	268	10	23	79	0.2911392
NODE_4408_length_1148_cov_13.275500	189	268	12	10	79	0.1265823
NODE_4408_length_1148_cov_13.275500	189	268	13	15	79	0.1898734
NODE_4408_length_1148_cov_13.275500	189	268	15	4	79	0.0506329
NODE_4408_length_1148_cov_13.275500	189	268	16	12	79	0.1518987
NODE_4408_length_1148_cov_13.275500	189	268	17	1	79	0.0126582
NODE_4409_length_1148_cov_10.613918	506	586	0	24	80	0.3000000
NODE_4409_length_1148_cov_10.613918	506	586	1	4	80	0.0500000
NODE_4409_length_1148_cov_10.613918	506	586	3	5	80	0.0625000
NODE_4409_length_1148_cov_10.613918	506	586	4	47	80	0.5875000
NODE_4409_length_1148_cov_10.613918	559	639	2	19	80	0.2375000
NODE_4409_length_1148_cov_10.613918	559	639	4	61	80	0.7625000
NODE_4415_length_1147_cov_33.543893	378	458	0	18	80	0.2250000
NODE_4415_length_1147_cov_33.543893	378	458	2	34	80	0.4250000
NODE_4415_length_1147_cov_33.543893	378	458	6	28	80	0.3500000
NODE_4415_length_1147_cov_33.543893	431	511	4	49	80	0.6125000
NODE_4415_length_1147_cov_33.543893	431	511	6	31	80	0.3875000
NODE_4416_length_1147_cov_26.858779	254	334	0	80	80	1.0000000
NODE_4416_length_1147_cov_26.858779	307	387	0	80	80	1.0000000
NODE_4416_length_1147_cov_26.858779	383	463	0	80	80	1.0000000
NODE_4416_length_1147_cov_26.858779	436	516	0	80	80	1.0000000
NODE_4417_length_1147_cov_24.227099	606	686	1	30	80	0.3750000
NODE_4417_length_1147_cov_24.227099	606	686	2	30	80	0.3750000
NODE_4417_length_1147_cov_24.227099	606	686	4	20	80	0.2500000
NODE_4417_length_1147_cov_24.227099	659	739	0	25	80	0.3125000
NODE_4417_length_1147_cov_24.227099	659	739	1	55	80	0.6875000
NODE_4417_length_1147_cov_24.227099	735	815	0	80	80	1.0000000
NODE_4417_length_1147_cov_24.227099	788	868	0	80	80	1.0000000
NODE_4418_length_1147_cov_16.559160	417	497	0	3	80	0.0375000
NODE_4418_length_1147_cov_16.559160	417	497	2	57	80	0.7125000
NODE_4418_length_1147_cov_16.559160	417	497	8	8	80	0.1000000
NODE_4418_length_1147_cov_16.559160	417	497	10	12	80	0.1500000
NODE_4418_length_1147_cov_16.559160	470	550	2	7	80	0.0875000
NODE_4418_length_1147_cov_16.559160	470	550	8	61	80	0.7625000
NODE_4418_length_1147_cov_16.559160	470	550	10	12	80	0.1500000
NODE_4428_length_1146_cov_52.393505	411	491	0	18	80	0.2250000
NODE_4428_length_1146_cov_52.393505	411	491	4	13	80	0.1625000
NODE_4428_length_1146_cov_52.393505	411	491	6	49	80	0.6125000
NODE_4428_length_1146_cov_52.393505	464	544	0	27	80	0.3375000
NODE_4428_length_1146_cov_52.393505	464	544	6	53	80	0.6625000
NODE_4428_length_1146_cov_52.393505	540	620	0	80	80	1.0000000
NODE_4428_length_1146_cov_52.393505	593	673	0	80	80	1.0000000
NODE_4429_length_1146_cov_46.364852	233	313	0	71	80	0.8875000
NODE_4429_length_1146_cov_46.364852	233	313	2	9	80	0.1125000
NODE_4429_length_1146_cov_46.364852	286	366	0	80	80	1.0000000
NODE_4430_length_1146_cov_26.159503	476	556	0	80	80	1.0000000
NODE_4430_length_1146_cov_26.159503	529	609	0	80	80	1.0000000
NODE_4430_length_1146_cov_26.159503	605	685	0	80	80	1.0000000
NODE_4430_length_1146_cov_26.159503	658	738	0	80	80	1.0000000
NODE_4431_length_1146_cov_14.210124	343	423	0	80	80	1.0000000
NODE_4431_length_1146_cov_14.210124	396	476	0	80	80	1.0000000
NODE_4432_length_1146_cov_13.479465	425	501	0	76	76	1.0000000
NODE_4432_length_1146_cov_13.479465	505	565	0	60	60	1.0000000
NODE_4432_length_1146_cov_13.479465	561	641	0	80	80	1.0000000
NODE_4432_length_1146_cov_13.479465	614	694	0	80	80	1.0000000
NODE_4438_length_1145_cov_49.566922	395	470	0	75	75	1.0000000
NODE_4438_length_1145_cov_49.566922	443	523	0	80	80	1.0000000
NODE_4439_length_1145_cov_38.191205	497	576	0	79	79	1.0000000
NODE_4439_length_1145_cov_38.191205	549	629	0	45	80	0.5625000
NODE_4439_length_1145_cov_38.191205	549	629	4	35	80	0.4375000
NODE_4440_length_1145_cov_26.929254	468	548	0	80	80	1.0000000
NODE_4440_length_1145_cov_26.929254	521	601	0	30	80	0.3750000
NODE_4440_length_1145_cov_26.929254	521	601	5	1	80	0.0125000
NODE_4440_length_1145_cov_26.929254	521	601	6	49	80	0.6125000
NODE_4441_length_1145_cov_20.121415	508	588	0	80	80	1.0000000
NODE_4441_length_1145_cov_20.121415	561	641	0	53	80	0.6625000
NODE_4441_length_1145_cov_20.121415	561	641	2	22	80	0.2750000
NODE_4441_length_1145_cov_20.121415	561	641	4	5	80	0.0625000
NODE_4442_length_1145_cov_11.753346	527	605	0	9	78	0.1153846
NODE_4442_length_1145_cov_11.753346	527	605	4	69	78	0.8846154
NODE_4442_length_1145_cov_11.753346	578	659	0	63	81	0.7777778
NODE_4442_length_1145_cov_11.753346	578	659	4	18	81	0.2222222
NODE_4443_length_1145_cov_9.571702	93	173	0	80	80	1.0000000
NODE_4443_length_1145_cov_9.571702	146	226	0	80	80	1.0000000
NODE_4455_length_1143_cov_42.255747	380	460	0	80	80	1.0000000
NODE_4455_length_1143_cov_42.255747	433	513	0	80	80	1.0000000
NODE_4455_length_1143_cov_42.255747	509	589	0	22	80	0.2750000
NODE_4455_length_1143_cov_42.255747	509	589	1	10	80	0.1250000
NODE_4455_length_1143_cov_42.255747	509	589	2	48	80	0.6000000
NODE_4455_length_1143_cov_42.255747	562	642	0	40	80	0.5000000
NODE_4455_length_1143_cov_42.255747	562	642	2	40	80	0.5000000
NODE_4456_length_1143_cov_22.076628	526	606	0	19	80	0.2375000
NODE_4456_length_1143_cov_22.076628	526	606	2	61	80	0.7625000
NODE_4456_length_1143_cov_22.076628	579	659	0	16	80	0.2000000
NODE_4456_length_1143_cov_22.076628	579	659	2	64	80	0.8000000
NODE_4457_length_1143_cov_19.106322	565	645	0	80	80	1.0000000
NODE_4457_length_1143_cov_19.106322	618	698	0	80	80	1.0000000
NODE_4458_length_1143_cov_16.223180	638	719	0	64	81	0.7901235
NODE_4458_length_1143_cov_16.223180	638	719	2	17	81	0.2098765
NODE_4458_length_1143_cov_16.223180	692	772	0	10	80	0.1250000
NODE_4458_length_1143_cov_16.223180	692	772	2	70	80	0.8750000
NODE_4459_length_1143_cov_13.961686	634	714	8	3	80	0.0375000
NODE_4459_length_1143_cov_13.961686	634	714	10	77	80	0.9625000
NODE_4459_length_1143_cov_13.961686	687	767	0	16	80	0.2000000
NODE_4459_length_1143_cov_13.961686	687	767	8	15	80	0.1875000
NODE_4459_length_1143_cov_13.961686	687	767	10	49	80	0.6125000
NODE_4459_length_1143_cov_13.961686	763	843	0	37	80	0.4625000
NODE_4459_length_1143_cov_13.961686	763	843	2	43	80	0.5375000
NODE_4459_length_1143_cov_13.961686	816	896	0	38	80	0.4750000
NODE_4459_length_1143_cov_13.961686	816	896	2	42	80	0.5250000
NODE_4460_length_1143_cov_12.782567	328	409	0	81	81	1.0000000
NODE_4460_length_1143_cov_12.782567	381	462	0	81	81	1.0000000
NODE_4460_length_1143_cov_12.782567	458	538	0	68	80	0.8500000
NODE_4460_length_1143_cov_12.782567	458	538	4	12	80	0.1500000
NODE_4460_length_1143_cov_12.782567	511	591	0	15	80	0.1875000
NODE_4460_length_1143_cov_12.782567	511	591	4	52	80	0.6500000
NODE_4460_length_1143_cov_12.782567	511	591	6	13	80	0.1625000
NODE_4461_length_1143_cov_8.287356	692	772	0	42	80	0.5250000
NODE_4461_length_1143_cov_8.287356	692	772	4	38	80	0.4750000
NODE_4461_length_1143_cov_8.287356	745	825	4	80	80	1.0000000
NODE_4463_length_1143_cov_2.197318	988	1057	8	18	69	0.2608696
NODE_4463_length_1143_cov_2.197318	988	1057	10	3	69	0.0434783
NODE_4463_length_1143_cov_2.197318	988	1057	13	9	69	0.1304348
NODE_4463_length_1143_cov_2.197318	988	1057	14	8	69	0.1159420
NODE_4463_length_1143_cov_2.197318	988	1057	18	1	69	0.0144928
NODE_4463_length_1143_cov_2.197318	988	1057	20	30	69	0.4347826
NODE_4466_length_1142_cov_28.364334	613	693	0	80	80	1.0000000
NODE_4466_length_1142_cov_28.364334	666	746	0	80	80	1.0000000
NODE_4467_length_1142_cov_21.669223	518	598	2	36	80	0.4500000
NODE_4467_length_1142_cov_21.669223	518	598	4	44	80	0.5500000
NODE_4467_length_1142_cov_21.669223	571	651	2	13	80	0.1625000
NODE_4467_length_1142_cov_21.669223	571	651	4	48	80	0.6000000
NODE_4467_length_1142_cov_21.669223	571	651	6	19	80	0.2375000
NODE_4468_length_1142_cov_19.007670	411	491	0	80	80	1.0000000
NODE_4468_length_1142_cov_19.007670	464	544	0	80	80	1.0000000
NODE_4474_length_1141_cov_12.500960	17	97	0	26	80	0.3250000
NODE_4474_length_1141_cov_12.500960	17	97	4	27	80	0.3375000
NODE_4474_length_1141_cov_12.500960	17	97	6	2	80	0.0250000
NODE_4474_length_1141_cov_12.500960	17	97	8	25	80	0.3125000
NODE_4474_length_1141_cov_12.500960	17	97	0	26	80	0.3250000
NODE_4474_length_1141_cov_12.500960	17	97	4	27	80	0.3375000
NODE_4474_length_1141_cov_12.500960	17	97	6	2	80	0.0250000
NODE_4474_length_1141_cov_12.500960	17	97	8	25	80	0.3125000
NODE_4474_length_1141_cov_12.500960	17	97	0	26	80	0.3250000
NODE_4474_length_1141_cov_12.500960	17	97	4	27	80	0.3375000
NODE_4474_length_1141_cov_12.500960	17	97	6	2	80	0.0250000
NODE_4474_length_1141_cov_12.500960	17	97	8	25	80	0.3125000
NODE_4474_length_1141_cov_12.500960	17	97	0	26	80	0.3250000
NODE_4474_length_1141_cov_12.500960	17	97	4	27	80	0.3375000
NODE_4474_length_1141_cov_12.500960	17	97	6	2	80	0.0250000
NODE_4474_length_1141_cov_12.500960	17	97	8	25	80	0.3125000
NODE_4474_length_1141_cov_12.500960	70	132	4	7	62	0.1129032
NODE_4474_length_1141_cov_12.500960	70	132	6	2	62	0.0322581
NODE_4474_length_1141_cov_12.500960	70	132	8	53	62	0.8548387
NODE_4474_length_1141_cov_12.500960	70	132	4	7	62	0.1129032
NODE_4474_length_1141_cov_12.500960	70	132	6	2	62	0.0322581
NODE_4474_length_1141_cov_12.500960	70	132	8	53	62	0.8548387
NODE_4474_length_1141_cov_12.500960	70	132	4	7	62	0.1129032
NODE_4474_length_1141_cov_12.500960	70	132	6	2	62	0.0322581
NODE_4474_length_1141_cov_12.500960	70	132	8	53	62	0.8548387
NODE_4474_length_1141_cov_12.500960	70	132	4	7	62	0.1129032
NODE_4474_length_1141_cov_12.500960	70	132	6	2	62	0.0322581
NODE_4474_length_1141_cov_12.500960	70	132	8	53	62	0.8548387
NODE_4475_length_1141_cov_7.197697	54	134	0	12	80	0.1500000
NODE_4475_length_1141_cov_7.197697	54	134	10	68	80	0.8500000
NODE_4475_length_1141_cov_7.197697	107	187	0	12	80	0.1500000
NODE_4475_length_1141_cov_7.197697	107	187	10	68	80	0.8500000
NODE_4475_length_1141_cov_7.197697	573	653	0	80	80	1.0000000
NODE_4475_length_1141_cov_7.197697	626	707	0	57	81	0.7037037
NODE_4475_length_1141_cov_7.197697	626	707	2	24	81	0.2962963
NODE_4476_length_1141_cov_5.428023	411	491	0	80	80	1.0000000
NODE_4476_length_1141_cov_5.428023	464	544	0	80	80	1.0000000
NODE_4482_length_1140_cov_39.383285	451	531	2	80	80	1.0000000
NODE_4482_length_1140_cov_39.383285	504	584	2	71	80	0.8875000
NODE_4482_length_1140_cov_39.383285	504	584	4	9	80	0.1125000
NODE_4482_length_1140_cov_39.383285	580	660	2	80	80	1.0000000
NODE_4482_length_1140_cov_39.383285	633	713	0	6	80	0.0750000
NODE_4482_length_1140_cov_39.383285	633	713	2	74	80	0.9250000
NODE_4483_length_1140_cov_19.493756	543	623	0	80	80	1.0000000
NODE_4483_length_1140_cov_19.493756	596	676	0	80	80	1.0000000
NODE_4484_length_1140_cov_18.341018	347	427	0	74	80	0.9250000
NODE_4484_length_1140_cov_18.341018	347	427	2	6	80	0.0750000
NODE_4484_length_1140_cov_18.341018	400	480	0	21	80	0.2625000
NODE_4484_length_1140_cov_18.341018	400	480	2	59	80	0.7375000
NODE_4484_length_1140_cov_18.341018	476	556	2	9	80	0.1125000
NODE_4484_length_1140_cov_18.341018	476	556	4	42	80	0.5250000
NODE_4484_length_1140_cov_18.341018	476	556	6	10	80	0.1250000
NODE_4484_length_1140_cov_18.341018	476	556	8	19	80	0.2375000
NODE_4484_length_1140_cov_18.341018	529	609	4	8	80	0.1000000
NODE_4484_length_1140_cov_18.341018	529	609	6	6	80	0.0750000
NODE_4484_length_1140_cov_18.341018	529	609	8	38	80	0.4750000
NODE_4484_length_1140_cov_18.341018	529	609	10	28	80	0.3500000
NODE_4494_length_1139_cov_26.812500	410	490	0	80	80	1.0000000
NODE_4494_length_1139_cov_26.812500	463	543	0	80	80	1.0000000
NODE_4494_length_1139_cov_26.812500	539	619	0	80	80	1.0000000
NODE_4494_length_1139_cov_26.812500	592	672	0	80	80	1.0000000
NODE_4495_length_1139_cov_26.323077	308	388	0	80	80	1.0000000
NODE_4495_length_1139_cov_26.323077	361	441	0	80	80	1.0000000
NODE_4495_length_1139_cov_26.323077	437	517	0	71	80	0.8875000
NODE_4495_length_1139_cov_26.323077	437	517	2	9	80	0.1125000
NODE_4495_length_1139_cov_26.323077	490	570	0	28	80	0.3500000
NODE_4495_length_1139_cov_26.323077	490	570	2	52	80	0.6500000
NODE_4496_length_1139_cov_15.223077	530	610	0	80	80	1.0000000
NODE_4496_length_1139_cov_15.223077	583	663	0	80	80	1.0000000
NODE_4505_length_1138_cov_74.599615	480	560	0	80	80	1.0000000
NODE_4505_length_1138_cov_74.599615	533	613	0	80	80	1.0000000
NODE_4505_length_1138_cov_74.599615	609	689	0	80	80	1.0000000
NODE_4505_length_1138_cov_74.599615	662	742	0	80	80	1.0000000
NODE_4506_length_1138_cov_29.407122	559	639	0	80	80	1.0000000
NODE_4506_length_1138_cov_29.407122	612	692	0	80	80	1.0000000
NODE_4506_length_1138_cov_29.407122	688	768	0	80	80	1.0000000
NODE_4506_length_1138_cov_29.407122	741	821	0	80	80	1.0000000
NODE_4507_length_1138_cov_18.326275	454	534	0	19	80	0.2375000
NODE_4507_length_1138_cov_18.326275	454	534	2	61	80	0.7625000
NODE_4507_length_1138_cov_18.326275	507	587	2	80	80	1.0000000
NODE_4507_length_1138_cov_18.326275	583	663	0	72	80	0.9000000
NODE_4507_length_1138_cov_18.326275	583	663	2	8	80	0.1000000
NODE_4507_length_1138_cov_18.326275	636	716	0	80	80	1.0000000
NODE_4509_length_1138_cov_11.834456	291	371	0	37	80	0.4625000
NODE_4509_length_1138_cov_11.834456	291	371	2	43	80	0.5375000
NODE_4509_length_1138_cov_11.834456	344	424	0	33	80	0.4125000
NODE_4509_length_1138_cov_11.834456	344	424	2	47	80	0.5875000
NODE_4510_length_1138_cov_10.923003	318	398	0	2	80	0.0250000
NODE_4510_length_1138_cov_10.923003	318	398	2	78	80	0.9750000
NODE_4510_length_1138_cov_10.923003	371	451	0	39	80	0.4875000
NODE_4510_length_1138_cov_10.923003	371	451	2	41	80	0.5125000
NODE_4517_length_1137_cov_23.983622	470	550	0	80	80	1.0000000
NODE_4517_length_1137_cov_23.983622	523	603	0	80	80	1.0000000
NODE_4517_length_1137_cov_23.983622	599	679	0	80	80	1.0000000
NODE_4517_length_1137_cov_23.983622	652	732	0	80	80	1.0000000
NODE_4518_length_1137_cov_22.877649	405	485	0	77	80	0.9625000
NODE_4518_length_1137_cov_22.877649	405	485	2	3	80	0.0375000
NODE_4518_length_1137_cov_22.877649	458	538	0	24	80	0.3000000
NODE_4518_length_1137_cov_22.877649	458	538	2	56	80	0.7000000
NODE_4518_length_1137_cov_22.877649	534	614	0	31	80	0.3875000
NODE_4518_length_1137_cov_22.877649	534	614	2	49	80	0.6125000
NODE_4518_length_1137_cov_22.877649	587	667	0	14	80	0.1750000
NODE_4518_length_1137_cov_22.877649	587	667	2	16	80	0.2000000
NODE_4518_length_1137_cov_22.877649	587	667	4	50	80	0.6250000
NODE_4519_length_1137_cov_21.570328	383	463	0	80	80	1.0000000
NODE_4519_length_1137_cov_21.570328	436	516	0	80	80	1.0000000
NODE_4520_length_1137_cov_18.560694	665	745	0	80	80	1.0000000
NODE_4520_length_1137_cov_18.560694	718	798	0	80	80	1.0000000
NODE_4521_length_1137_cov_18.505780	557	637	0	1	80	0.0125000
NODE_4521_length_1137_cov_18.505780	557	637	3	1	80	0.0125000
NODE_4521_length_1137_cov_18.505780	557	637	4	78	80	0.9750000
NODE_4521_length_1137_cov_18.505780	610	690	0	26	80	0.3250000
NODE_4521_length_1137_cov_18.505780	610	690	4	54	80	0.6750000
NODE_4521_length_1137_cov_18.505780	686	766	0	80	80	1.0000000
NODE_4521_length_1137_cov_18.505780	739	819	0	80	80	1.0000000
NODE_4523_length_1137_cov_11.866089	313	393	0	22	80	0.2750000
NODE_4523_length_1137_cov_11.866089	313	393	2	46	80	0.5750000
NODE_4523_length_1137_cov_11.866089	313	393	4	12	80	0.1500000
NODE_4523_length_1137_cov_11.866089	366	446	0	75	80	0.9375000
NODE_4523_length_1137_cov_11.866089	366	446	2	5	80	0.0625000
NODE_4523_length_1137_cov_11.866089	442	522	0	80	80	1.0000000
NODE_4523_length_1137_cov_11.866089	495	575	0	80	80	1.0000000
NODE_4524_length_1137_cov_5.594412	144	224	0	6	80	0.0750000
NODE_4524_length_1137_cov_5.594412	144	224	2	60	80	0.7500000
NODE_4524_length_1137_cov_5.594412	144	224	4	14	80	0.1750000
NODE_4524_length_1137_cov_5.594412	197	277	0	1	80	0.0125000
NODE_4524_length_1137_cov_5.594412	197	277	2	12	80	0.1500000
NODE_4524_length_1137_cov_5.594412	197	277	4	67	80	0.8375000
NODE_4532_length_1136_cov_42.827387	445	525	2	14	80	0.1750000
NODE_4532_length_1136_cov_42.827387	445	525	4	39	80	0.4875000
NODE_4532_length_1136_cov_42.827387	445	525	6	27	80	0.3375000
NODE_4532_length_1136_cov_42.827387	498	578	0	24	80	0.3000000
NODE_4532_length_1136_cov_42.827387	498	578	2	43	80	0.5375000
NODE_4532_length_1136_cov_42.827387	498	578	6	13	80	0.1625000
NODE_4532_length_1136_cov_42.827387	574	654	0	80	80	1.0000000
NODE_4532_length_1136_cov_42.827387	627	707	0	80	80	1.0000000
NODE_4533_length_1136_cov_30.940212	534	614	0	80	80	1.0000000
NODE_4533_length_1136_cov_30.940212	587	667	0	80	80	1.0000000
NODE_4533_length_1136_cov_30.940212	663	743	0	15	80	0.1875000
NODE_4533_length_1136_cov_30.940212	663	743	2	41	80	0.5125000
NODE_4533_length_1136_cov_30.940212	663	743	4	16	80	0.2000000
NODE_4533_length_1136_cov_30.940212	663	743	8	8	80	0.1000000
NODE_4533_length_1136_cov_30.940212	716	796	2	3	80	0.0375000
NODE_4533_length_1136_cov_30.940212	716	796	4	29	80	0.3625000
NODE_4533_length_1136_cov_30.940212	716	796	6	24	80	0.3000000
NODE_4533_length_1136_cov_30.940212	716	796	8	24	80	0.3000000
NODE_4534_length_1136_cov_30.797493	557	637	0	25	80	0.3125000
NODE_4534_length_1136_cov_30.797493	557	637	6	55	80	0.6875000
NODE_4534_length_1136_cov_30.797493	610	691	0	79	81	0.9753087
NODE_4534_length_1136_cov_30.797493	610	691	6	2	81	0.0246914
NODE_4534_length_1136_cov_30.797493	687	767	0	71	80	0.8875000
NODE_4534_length_1136_cov_30.797493	687	767	2	9	80	0.1125000
NODE_4534_length_1136_cov_30.797493	740	820	0	18	80	0.2250000
NODE_4534_length_1136_cov_30.797493	740	820	2	62	80	0.7750000
NODE_4535_length_1136_cov_23.142719	704	784	0	35	80	0.4375000
NODE_4535_length_1136_cov_23.142719	704	784	2	45	80	0.5625000
NODE_4535_length_1136_cov_23.142719	757	837	0	36	80	0.4500000
NODE_4535_length_1136_cov_23.142719	757	837	2	44	80	0.5500000
NODE_4536_length_1136_cov_21.798457	570	651	0	81	81	1.0000000
NODE_4536_length_1136_cov_21.798457	624	704	0	80	80	1.0000000
NODE_4537_length_1136_cov_21.109932	460	532	0	72	72	1.0000000
NODE_4537_length_1136_cov_21.109932	505	585	0	80	80	1.0000000
NODE_4538_length_1136_cov_20.528447	19	99	16	5	80	0.0625000
NODE_4538_length_1136_cov_20.528447	19	99	24	46	80	0.5750000
NODE_4538_length_1136_cov_20.528447	19	99	26	1	80	0.0125000
NODE_4538_length_1136_cov_20.528447	19	99	27	8	80	0.1000000
NODE_4538_length_1136_cov_20.528447	19	99	30	20	80	0.2500000
NODE_4538_length_1136_cov_20.528447	19	99	16	5	80	0.0625000
NODE_4538_length_1136_cov_20.528447	19	99	24	46	80	0.5750000
NODE_4538_length_1136_cov_20.528447	19	99	26	1	80	0.0125000
NODE_4538_length_1136_cov_20.528447	19	99	27	8	80	0.1000000
NODE_4538_length_1136_cov_20.528447	19	99	30	20	80	0.2500000
NODE_4538_length_1136_cov_20.528447	28	99	24	42	71	0.5915493
NODE_4538_length_1136_cov_20.528447	28	99	26	1	71	0.0140845
NODE_4538_length_1136_cov_20.528447	28	99	27	8	71	0.1126761
NODE_4538_length_1136_cov_20.528447	28	99	30	20	71	0.2816902
NODE_4538_length_1136_cov_20.528447	877	912	5	35	35	1.0000000
NODE_4538_length_1136_cov_20.528447	879	921	5	35	42	0.8333333
NODE_4538_length_1136_cov_20.528447	879	921	10	7	42	0.1666667
NODE_4539_length_1136_cov_14.921890	657	737	0	80	80	1.0000000
NODE_4539_length_1136_cov_14.921890	710	790	0	80	80	1.0000000
NODE_4556_length_1135_cov_100.121622	454	534	0	23	80	0.2875000
NODE_4556_length_1135_cov_100.121622	454	534	4	57	80	0.7125000
NODE_4556_length_1135_cov_100.121622	507	587	0	17	80	0.2125000
NODE_4556_length_1135_cov_100.121622	507	587	4	63	80	0.7875000
NODE_4556_length_1135_cov_100.121622	583	663	0	80	80	1.0000000
NODE_4556_length_1135_cov_100.121622	636	719	0	83	83	1.0000000
NODE_4557_length_1135_cov_34.523166	313	393	1	16	80	0.2000000
NODE_4557_length_1135_cov_34.523166	313	393	2	23	80	0.2875000
NODE_4557_length_1135_cov_34.523166	313	393	5	1	80	0.0125000
NODE_4557_length_1135_cov_34.523166	313	393	6	40	80	0.5000000
NODE_4557_length_1135_cov_34.523166	366	446	1	9	80	0.1125000
NODE_4557_length_1135_cov_34.523166	366	446	5	23	80	0.2875000
NODE_4557_length_1135_cov_34.523166	366	446	6	48	80	0.6000000
NODE_4558_length_1135_cov_20.735521	484	564	0	80	80	1.0000000
NODE_4558_length_1135_cov_20.735521	537	617	0	80	80	1.0000000
NODE_4558_length_1135_cov_20.735521	613	693	0	80	80	1.0000000
NODE_4558_length_1135_cov_20.735521	666	746	0	80	80	1.0000000
NODE_4559_length_1135_cov_9.644788	620	700	0	80	80	1.0000000
NODE_4559_length_1135_cov_9.644788	673	753	0	80	80	1.0000000
NODE_4562_length_1135_cov_2.990347	349	429	0	50	80	0.6250000
NODE_4562_length_1135_cov_2.990347	349	429	4	30	80	0.3750000
NODE_4562_length_1135_cov_2.990347	402	482	2	1	80	0.0125000
NODE_4562_length_1135_cov_2.990347	402	482	4	40	80	0.5000000
NODE_4562_length_1135_cov_2.990347	402	482	6	39	80	0.4875000
NODE_4571_length_1134_cov_34.784541	478	558	0	10	80	0.1250000
NODE_4571_length_1134_cov_34.784541	478	558	1	8	80	0.1000000
NODE_4571_length_1134_cov_34.784541	478	558	3	62	80	0.7750000
NODE_4571_length_1134_cov_34.784541	531	611	1	52	80	0.6500000
NODE_4571_length_1134_cov_34.784541	531	611	3	28	80	0.3500000
NODE_4571_length_1134_cov_34.784541	607	687	1	57	80	0.7125000
NODE_4571_length_1134_cov_34.784541	607	687	2	21	80	0.2625000
NODE_4571_length_1134_cov_34.784541	607	687	8	2	80	0.0250000
NODE_4571_length_1134_cov_34.784541	660	740	1	17	80	0.2125000
NODE_4571_length_1134_cov_34.784541	660	740	2	8	80	0.1000000
NODE_4571_length_1134_cov_34.784541	660	740	8	38	80	0.4750000
NODE_4571_length_1134_cov_34.784541	660	740	9	17	80	0.2125000
NODE_4572_length_1134_cov_28.524638	511	591	0	58	80	0.7250000
NODE_4572_length_1134_cov_28.524638	511	591	2	22	80	0.2750000
NODE_4572_length_1134_cov_28.524638	564	644	0	5	80	0.0625000
NODE_4572_length_1134_cov_28.524638	564	644	2	75	80	0.9375000
NODE_4572_length_1134_cov_28.524638	640	720	2	13	80	0.1625000
NODE_4572_length_1134_cov_28.524638	640	720	4	44	80	0.5500000
NODE_4572_length_1134_cov_28.524638	640	720	6	23	80	0.2875000
NODE_4572_length_1134_cov_28.524638	693	773	2	26	80	0.3250000
NODE_4572_length_1134_cov_28.524638	693	773	4	13	80	0.1625000
NODE_4572_length_1134_cov_28.524638	693	773	6	41	80	0.5125000
NODE_4576_length_1134_cov_2.619324	606	686	0	80	80	1.0000000
NODE_4576_length_1134_cov_2.619324	659	739	0	80	80	1.0000000
NODE_4584_length_1133_cov_5.563830	292	372	0	33	80	0.4125000
NODE_4584_length_1133_cov_5.563830	292	372	4	47	80	0.5875000
NODE_4584_length_1133_cov_5.563830	345	425	0	26	80	0.3250000
NODE_4584_length_1133_cov_5.563830	345	425	4	54	80	0.6750000
NODE_4584_length_1133_cov_5.563830	904	966	0	9	62	0.1451613
NODE_4584_length_1133_cov_5.563830	904	966	6	53	62	0.8548387
NODE_4592_length_1132_cov_23.121007	485	565	0	76	80	0.9500000
NODE_4592_length_1132_cov_23.121007	485	565	2	4	80	0.0500000
NODE_4592_length_1132_cov_23.121007	538	618	0	23	80	0.2875000
NODE_4592_length_1132_cov_23.121007	538	618	2	4	80	0.0500000
NODE_4592_length_1132_cov_23.121007	538	618	4	53	80	0.6625000
NODE_4592_length_1132_cov_23.121007	618	664	2	1	46	0.0217391
NODE_4592_length_1132_cov_23.121007	618	664	4	29	46	0.6304348
NODE_4592_length_1132_cov_23.121007	618	664	6	16	46	0.3478261
NODE_4592_length_1132_cov_23.121007	700	751	0	2	51	0.0392157
NODE_4592_length_1132_cov_23.121007	700	751	4	49	51	0.9607843
NODE_4593_length_1132_cov_19.377541	595	675	2	80	80	1.0000000
NODE_4593_length_1132_cov_19.377541	648	728	0	33	80	0.4125000
NODE_4593_length_1132_cov_19.377541	648	728	2	47	80	0.5875000
NODE_4594_length_1132_cov_18.872217	363	443	0	80	80	1.0000000
NODE_4594_length_1132_cov_18.872217	416	496	0	38	80	0.4750000
NODE_4594_length_1132_cov_18.872217	416	496	2	42	80	0.5250000
NODE_4595_length_1132_cov_11.242982	474	554	0	24	80	0.3000000
NODE_4595_length_1132_cov_11.242982	474	554	2	56	80	0.7000000
NODE_4595_length_1132_cov_11.242982	527	607	0	46	80	0.5750000
NODE_4595_length_1132_cov_11.242982	527	607	2	34	80	0.4250000
NODE_4596_length_1132_cov_7.356244	354	434	0	33	80	0.4125000
NODE_4596_length_1132_cov_7.356244	354	434	3	1	80	0.0125000
NODE_4596_length_1132_cov_7.356244	354	434	4	46	80	0.5750000
NODE_4596_length_1132_cov_7.356244	407	487	0	2	80	0.0250000
NODE_4596_length_1132_cov_7.356244	407	487	4	78	80	0.9750000
NODE_4597_length_1132_cov_6.214908	269	349	0	80	80	1.0000000
NODE_4597_length_1132_cov_6.214908	322	402	0	80	80	1.0000000
NODE_4606_length_1131_cov_36.161822	478	558	0	80	80	1.0000000
NODE_4606_length_1131_cov_36.161822	531	611	0	80	80	1.0000000
NODE_4606_length_1131_cov_36.161822	607	687	0	73	80	0.9125000
NODE_4606_length_1131_cov_36.161822	607	687	4	7	80	0.0875000
NODE_4606_length_1131_cov_36.161822	660	740	0	20	80	0.2500000
NODE_4606_length_1131_cov_36.161822	660	740	4	23	80	0.2875000
NODE_4606_length_1131_cov_36.161822	660	740	6	36	80	0.4500000
NODE_4606_length_1131_cov_36.161822	660	740	8	1	80	0.0125000
NODE_4607_length_1131_cov_31.907946	390	470	0	80	80	1.0000000
NODE_4607_length_1131_cov_31.907946	443	523	0	80	80	1.0000000
NODE_4607_length_1131_cov_31.907946	519	599	0	31	80	0.3875000
NODE_4607_length_1131_cov_31.907946	519	599	2	49	80	0.6125000
NODE_4607_length_1131_cov_31.907946	572	652	0	24	80	0.3000000
NODE_4607_length_1131_cov_31.907946	572	652	2	56	80	0.7000000
NODE_4608_length_1131_cov_26.827519	464	544	2	62	80	0.7750000
NODE_4608_length_1131_cov_26.827519	464	544	3	4	80	0.0500000
NODE_4608_length_1131_cov_26.827519	464	544	4	14	80	0.1750000
NODE_4608_length_1131_cov_26.827519	517	597	2	9	80	0.1125000
NODE_4608_length_1131_cov_26.827519	517	597	3	22	80	0.2750000
NODE_4608_length_1131_cov_26.827519	517	597	4	49	80	0.6125000
NODE_4609_length_1131_cov_20.441860	555	635	4	80	80	1.0000000
NODE_4609_length_1131_cov_20.441860	608	688	0	48	80	0.6000000
NODE_4609_length_1131_cov_20.441860	608	688	4	32	80	0.4000000
NODE_4610_length_1131_cov_12.517442	420	500	0	22	80	0.2750000
NODE_4610_length_1131_cov_12.517442	420	500	2	58	80	0.7250000
NODE_4610_length_1131_cov_12.517442	473	553	0	74	80	0.9250000
NODE_4610_length_1131_cov_12.517442	473	553	2	6	80	0.0750000
NODE_4611_length_1131_cov_10.912791	429	509	2	80	80	1.0000000
NODE_4611_length_1131_cov_10.912791	482	562	0	52	80	0.6500000
NODE_4611_length_1131_cov_10.912791	482	562	2	28	80	0.3500000
NODE_4620_length_1130_cov_43.354995	742	822	2	5	80	0.0625000
NODE_4620_length_1130_cov_43.354995	742	822	6	10	80	0.1250000
NODE_4620_length_1130_cov_43.354995	742	822	8	65	80	0.8125000
NODE_4620_length_1130_cov_43.354995	795	875	0	37	80	0.4625000
NODE_4620_length_1130_cov_43.354995	795	875	4	4	80	0.0500000
NODE_4620_length_1130_cov_43.354995	795	875	6	20	80	0.2500000
NODE_4620_length_1130_cov_43.354995	795	875	8	19	80	0.2375000
NODE_4621_length_1130_cov_13.097963	642	722	0	14	80	0.1750000
NODE_4621_length_1130_cov_13.097963	642	722	3	16	80	0.2000000
NODE_4621_length_1130_cov_13.097963	642	722	4	1	80	0.0125000
NODE_4621_length_1130_cov_13.097963	642	722	5	15	80	0.1875000
NODE_4621_length_1130_cov_13.097963	642	722	6	19	80	0.2375000
NODE_4621_length_1130_cov_13.097963	642	722	15	15	80	0.1875000
NODE_4621_length_1130_cov_13.097963	695	775	5	12	80	0.1500000
NODE_4621_length_1130_cov_13.097963	695	775	10	15	80	0.1875000
NODE_4621_length_1130_cov_13.097963	695	775	13	6	80	0.0750000
NODE_4621_length_1130_cov_13.097963	695	775	14	1	80	0.0125000
NODE_4621_length_1130_cov_13.097963	695	775	15	46	80	0.5750000
NODE_4626_length_1129_cov_31.088350	396	476	40	34	80	0.4250000
NODE_4626_length_1129_cov_31.088350	396	476	41	35	80	0.4375000
NODE_4626_length_1129_cov_31.088350	396	476	42	11	80	0.1375000
NODE_4626_length_1129_cov_31.088350	449	529	0	18	80	0.2250000
NODE_4626_length_1129_cov_31.088350	449	529	26	9	80	0.1125000
NODE_4626_length_1129_cov_31.088350	449	529	38	11	80	0.1375000
NODE_4626_length_1129_cov_31.088350	449	529	39	1	80	0.0125000
NODE_4626_length_1129_cov_31.088350	449	529	40	41	80	0.5125000
NODE_4627_length_1129_cov_20.591262	450	530	0	80	80	1.0000000
NODE_4627_length_1129_cov_20.591262	503	583	0	80	80	1.0000000
NODE_4628_length_1129_cov_16.934951	261	341	0	38	80	0.4750000
NODE_4628_length_1129_cov_16.934951	261	341	1	12	80	0.1500000
NODE_4628_length_1129_cov_16.934951	261	341	2	30	80	0.3750000
NODE_4628_length_1129_cov_16.934951	314	394	2	31	80	0.3875000
NODE_4628_length_1129_cov_16.934951	314	394	4	45	80	0.5625000
NODE_4628_length_1129_cov_16.934951	314	394	6	4	80	0.0500000
NODE_4629_length_1129_cov_9.441748	665	738	0	73	73	1.0000000
NODE_4629_length_1129_cov_9.441748	711	791	0	80	80	1.0000000
NODE_4630_length_1129_cov_9.260194	658	738	0	80	80	1.0000000
NODE_4630_length_1129_cov_9.260194	711	791	0	80	80	1.0000000
NODE_4631_length_1129_cov_5.055340	759	839	0	20	80	0.2500000
NODE_4631_length_1129_cov_5.055340	759	839	5	50	80	0.6250000
NODE_4631_length_1129_cov_5.055340	759	839	7	10	80	0.1250000
NODE_4638_length_1128_cov_48.099125	588	668	2	38	80	0.4750000
NODE_4638_length_1128_cov_48.099125	588	668	6	12	80	0.1500000
NODE_4638_length_1128_cov_48.099125	588	668	7	4	80	0.0500000
NODE_4638_length_1128_cov_48.099125	588	668	8	26	80	0.3250000
NODE_4638_length_1128_cov_48.099125	641	721	0	13	80	0.1625000
NODE_4638_length_1128_cov_48.099125	641	721	2	67	80	0.8375000
NODE_4640_length_1128_cov_26.230321	455	535	0	35	80	0.4375000
NODE_4640_length_1128_cov_26.230321	455	535	2	45	80	0.5625000
NODE_4640_length_1128_cov_26.230321	508	588	0	80	80	1.0000000
NODE_4640_length_1128_cov_26.230321	584	664	0	80	80	1.0000000
NODE_4640_length_1128_cov_26.230321	637	718	0	81	81	1.0000000
NODE_4641_length_1128_cov_26.031098	594	674	0	80	80	1.0000000
NODE_4641_length_1128_cov_26.031098	647	727	0	80	80	1.0000000
NODE_4642_length_1128_cov_25.869776	465	538	6	73	73	1.0000000
NODE_4642_length_1128_cov_25.869776	601	674	0	25	73	0.3424658
NODE_4642_length_1128_cov_25.869776	601	674	3	48	73	0.6575342
NODE_4642_length_1128_cov_25.869776	647	723	3	76	76	1.0000000
NODE_4643_length_1128_cov_24.185617	350	430	0	80	80	1.0000000
NODE_4643_length_1128_cov_24.185617	403	483	0	80	80	1.0000000
NODE_4644_length_1128_cov_18.537415	335	415	0	80	80	1.0000000
NODE_4644_length_1128_cov_18.537415	388	468	0	80	80	1.0000000
NODE_4645_length_1128_cov_9.345967	690	770	0	33	80	0.4125000
NODE_4645_length_1128_cov_9.345967	690	770	2	8	80	0.1000000
NODE_4645_length_1128_cov_9.345967	690	770	4	39	80	0.4875000
NODE_4645_length_1128_cov_9.345967	743	823	0	3	80	0.0375000
NODE_4645_length_1128_cov_9.345967	743	823	2	7	80	0.0875000
NODE_4645_length_1128_cov_9.345967	743	823	4	70	80	0.8750000
NODE_4647_length_1128_cov_3.920311	675	725	0	50	50	1.0000000
NODE_4647_length_1128_cov_3.920311	698	778	0	80	80	1.0000000
NODE_4648_length_1128_cov_3.631681	613	693	0	72	80	0.9000000
NODE_4648_length_1128_cov_3.631681	613	693	2	8	80	0.1000000
NODE_4648_length_1128_cov_3.631681	666	746	0	80	80	1.0000000
NODE_4650_length_1128_cov_3.091351	519	599	0	54	80	0.6750000
NODE_4650_length_1128_cov_3.091351	519	599	1	6	80	0.0750000
NODE_4650_length_1128_cov_3.091351	519	599	3	9	80	0.1125000
NODE_4650_length_1128_cov_3.091351	519	599	4	11	80	0.1375000
NODE_4650_length_1128_cov_3.091351	572	652	0	80	80	1.0000000
NODE_4660_length_1127_cov_38.932879	405	485	0	80	80	1.0000000
NODE_4660_length_1127_cov_38.932879	458	538	0	36	80	0.4500000
NODE_4660_length_1127_cov_38.932879	458	538	2	44	80	0.5500000
NODE_4660_length_1127_cov_38.932879	534	614	2	29	80	0.3625000
NODE_4660_length_1127_cov_38.932879	534	614	6	18	80	0.2250000
NODE_4660_length_1127_cov_38.932879	534	614	8	33	80	0.4125000
NODE_4660_length_1127_cov_38.932879	587	667	0	25	80	0.3125000
NODE_4660_length_1127_cov_38.932879	587	667	6	46	80	0.5750000
NODE_4660_length_1127_cov_38.932879	587	667	8	9	80	0.1125000
NODE_4661_length_1127_cov_37.721790	236	316	0	80	80	1.0000000
NODE_4661_length_1127_cov_37.721790	289	369	0	80	80	1.0000000
NODE_4661_length_1127_cov_37.721790	365	445	0	80	80	1.0000000
NODE_4661_length_1127_cov_37.721790	418	498	0	80	80	1.0000000
NODE_4662_length_1127_cov_31.866732	444	523	0	79	79	1.0000000
NODE_4662_length_1127_cov_31.866732	496	576	0	80	80	1.0000000
NODE_4662_length_1127_cov_31.866732	572	652	0	80	80	1.0000000
NODE_4662_length_1127_cov_31.866732	625	705	0	80	80	1.0000000
NODE_4663_length_1127_cov_25.616732	430	510	0	80	80	1.0000000
NODE_4663_length_1127_cov_25.616732	483	563	0	80	80	1.0000000
NODE_4664_length_1127_cov_21.838521	338	418	0	57	80	0.7125000
NODE_4664_length_1127_cov_21.838521	338	418	2	23	80	0.2875000
NODE_4664_length_1127_cov_21.838521	391	471	0	80	80	1.0000000
NODE_4664_length_1127_cov_21.838521	467	547	0	41	80	0.5125000
NODE_4664_length_1127_cov_21.838521	467	547	2	17	80	0.2125000
NODE_4664_length_1127_cov_21.838521	467	547	6	8	80	0.1000000
NODE_4664_length_1127_cov_21.838521	467	547	8	8	80	0.1000000
NODE_4664_length_1127_cov_21.838521	467	547	14	6	80	0.0750000
NODE_4664_length_1127_cov_21.838521	520	600	2	5	80	0.0625000
NODE_4664_length_1127_cov_21.838521	520	600	6	8	80	0.1000000
NODE_4664_length_1127_cov_21.838521	520	600	8	8	80	0.1000000
NODE_4664_length_1127_cov_21.838521	520	600	14	59	80	0.7375000
NODE_4665_length_1127_cov_15.024319	711	800	0	89	89	1.0000000
NODE_4665_length_1127_cov_15.024319	773	853	0	31	80	0.3875000
NODE_4665_length_1127_cov_15.024319	773	853	7	2	80	0.0250000
NODE_4665_length_1127_cov_15.024319	773	853	8	47	80	0.5875000
NODE_4667_length_1127_cov_4.786965	386	466	0	38	80	0.4750000
NODE_4667_length_1127_cov_4.786965	386	466	2	42	80	0.5250000
NODE_4667_length_1127_cov_4.786965	439	519	0	64	80	0.8000000
NODE_4667_length_1127_cov_4.786965	439	519	2	16	80	0.2000000
NODE_4672_length_1126_cov_51.699124	448	528	0	71	80	0.8875000
NODE_4672_length_1126_cov_51.699124	448	528	4	9	80	0.1125000
NODE_4672_length_1126_cov_51.699124	501	581	0	18	80	0.2250000
NODE_4672_length_1126_cov_51.699124	501	581	4	12	80	0.1500000
NODE_4672_length_1126_cov_51.699124	501	581	6	6	80	0.0750000
NODE_4672_length_1126_cov_51.699124	501	581	8	44	80	0.5500000
NODE_4673_length_1126_cov_38.135346	427	507	4	41	80	0.5125000
NODE_4673_length_1126_cov_38.135346	427	507	6	12	80	0.1500000
NODE_4673_length_1126_cov_38.135346	427	507	8	27	80	0.3375000
NODE_4673_length_1126_cov_38.135346	480	560	2	51	80	0.6375000
NODE_4673_length_1126_cov_38.135346	480	560	4	29	80	0.3625000
NODE_4673_length_1126_cov_38.135346	556	638	0	75	82	0.9146342
NODE_4673_length_1126_cov_38.135346	556	638	2	7	82	0.0853659
NODE_4673_length_1126_cov_38.135346	611	691	0	80	80	1.0000000
NODE_4674_length_1126_cov_34.637780	23	97	1	1	74	0.0135135
NODE_4674_length_1126_cov_34.637780	23	97	7	19	74	0.2567568
NODE_4674_length_1126_cov_34.637780	23	97	8	54	74	0.7297297
NODE_4674_length_1126_cov_34.637780	146	226	6	23	80	0.2875000
NODE_4674_length_1126_cov_34.637780	146	226	8	15	80	0.1875000
NODE_4674_length_1126_cov_34.637780	146	226	12	36	80	0.4500000
NODE_4674_length_1126_cov_34.637780	146	226	13	6	80	0.0750000
NODE_4674_length_1126_cov_34.637780	146	226	6	23	80	0.2875000
NODE_4674_length_1126_cov_34.637780	146	226	8	15	80	0.1875000
NODE_4674_length_1126_cov_34.637780	146	226	12	36	80	0.4500000
NODE_4674_length_1126_cov_34.637780	146	226	13	6	80	0.0750000
NODE_4674_length_1126_cov_34.637780	146	208	6	8	62	0.1290323
NODE_4674_length_1126_cov_34.637780	146	208	8	15	62	0.2419355
NODE_4674_length_1126_cov_34.637780	146	208	12	33	62	0.5322581
NODE_4674_length_1126_cov_34.637780	146	208	13	6	62	0.0967742
NODE_4674_length_1126_cov_34.637780	146	217	6	14	71	0.1971831
NODE_4674_length_1126_cov_34.637780	146	217	8	15	71	0.2112676
NODE_4674_length_1126_cov_34.637780	146	217	12	36	71	0.5070422
NODE_4674_length_1126_cov_34.637780	146	217	13	6	71	0.0845070
NODE_4675_length_1126_cov_21.360273	595	675	0	80	80	1.0000000
NODE_4675_length_1126_cov_21.360273	648	728	0	80	80	1.0000000
NODE_4676_length_1126_cov_17.420643	422	502	0	80	80	1.0000000
NODE_4676_length_1126_cov_17.420643	475	555	0	80	80	1.0000000
NODE_4677_length_1126_cov_15.896787	383	463	0	11	80	0.1375000
NODE_4677_length_1126_cov_15.896787	383	463	2	31	80	0.3875000
NODE_4677_length_1126_cov_15.896787	383	463	4	13	80	0.1625000
NODE_4677_length_1126_cov_15.896787	383	463	6	25	80	0.3125000
NODE_4677_length_1126_cov_15.896787	436	516	0	64	80	0.8000000
NODE_4677_length_1126_cov_15.896787	436	516	2	16	80	0.2000000
NODE_4678_length_1126_cov_8.525803	174	254	0	80	80	1.0000000
NODE_4678_length_1126_cov_8.525803	227	307	0	50	80	0.6250000
NODE_4678_length_1126_cov_8.525803	227	307	2	30	80	0.3750000
NODE_4679_length_1126_cov_5.805258	463	543	0	55	80	0.6875000
NODE_4679_length_1126_cov_5.805258	463	543	2	25	80	0.3125000
NODE_4679_length_1126_cov_5.805258	516	596	0	80	80	1.0000000
NODE_4685_length_1126_cov_1.502434	6	86	0	12	80	0.1500000
NODE_4685_length_1126_cov_1.502434	6	86	6	23	80	0.2875000
NODE_4685_length_1126_cov_1.502434	6	86	8	6	80	0.0750000
NODE_4685_length_1126_cov_1.502434	6	86	10	39	80	0.4875000
NODE_4685_length_1126_cov_1.502434	59	108	10	49	49	1.0000000
NODE_4689_length_1125_cov_34.314815	405	485	0	4	80	0.0500000
NODE_4689_length_1125_cov_34.314815	405	485	4	76	80	0.9500000
NODE_4689_length_1125_cov_34.314815	458	538	0	47	80	0.5875000
NODE_4689_length_1125_cov_34.314815	458	538	4	33	80	0.4125000
NODE_4689_length_1125_cov_34.314815	534	614	0	42	80	0.5250000
NODE_4689_length_1125_cov_34.314815	534	614	4	38	80	0.4750000
NODE_4689_length_1125_cov_34.314815	587	667	4	80	80	1.0000000
NODE_4690_length_1125_cov_33.553606	458	538	0	19	80	0.2375000
NODE_4690_length_1125_cov_33.553606	458	538	2	61	80	0.7625000
NODE_4690_length_1125_cov_33.553606	511	591	0	41	80	0.5125000
NODE_4690_length_1125_cov_33.553606	511	591	2	39	80	0.4875000
NODE_4690_length_1125_cov_33.553606	587	667	2	19	80	0.2375000
NODE_4690_length_1125_cov_33.553606	587	667	6	3	80	0.0375000
NODE_4690_length_1125_cov_33.553606	587	667	8	58	80	0.7250000
NODE_4690_length_1125_cov_33.553606	640	720	6	56	80	0.7000000
NODE_4690_length_1125_cov_33.553606	640	720	8	24	80	0.3000000
NODE_4691_length_1125_cov_33.371345	408	488	0	31	80	0.3875000
NODE_4691_length_1125_cov_33.371345	408	488	6	49	80	0.6125000
NODE_4691_length_1125_cov_33.371345	461	541	0	6	80	0.0750000
NODE_4691_length_1125_cov_33.371345	461	541	6	74	80	0.9250000
NODE_4691_length_1125_cov_33.371345	537	617	0	80	80	1.0000000
NODE_4691_length_1125_cov_33.371345	590	670	0	80	80	1.0000000
NODE_4692_length_1125_cov_22.580897	279	359	0	27	80	0.3375000
NODE_4692_length_1125_cov_22.580897	279	359	2	53	80	0.6625000
NODE_4692_length_1125_cov_22.580897	332	412	0	80	80	1.0000000
NODE_4692_length_1125_cov_22.580897	408	488	0	74	80	0.9250000
NODE_4692_length_1125_cov_22.580897	408	488	4	6	80	0.0750000
NODE_4692_length_1125_cov_22.580897	461	541	0	21	80	0.2625000
NODE_4692_length_1125_cov_22.580897	461	541	4	59	80	0.7375000
NODE_4705_length_1124_cov_52.278049	616	696	0	20	80	0.2500000
NODE_4705_length_1124_cov_52.278049	616	696	2	60	80	0.7500000
NODE_4705_length_1124_cov_52.278049	669	749	2	80	80	1.0000000
NODE_4706_length_1124_cov_25.280000	444	524	0	72	80	0.9000000
NODE_4706_length_1124_cov_25.280000	444	524	2	8	80	0.1000000
NODE_4706_length_1124_cov_25.280000	497	577	0	80	80	1.0000000
NODE_4706_length_1124_cov_25.280000	573	653	0	80	80	1.0000000
NODE_4706_length_1124_cov_25.280000	626	706	0	80	80	1.0000000
NODE_4707_length_1124_cov_18.700488	114	194	0	80	80	1.0000000
NODE_4707_length_1124_cov_18.700488	167	247	0	80	80	1.0000000
NODE_4717_length_1123_cov_26.445312	388	468	0	17	80	0.2125000
NODE_4717_length_1123_cov_26.445312	388	468	2	10	80	0.1250000
NODE_4717_length_1123_cov_26.445312	388	468	4	4	80	0.0500000
NODE_4717_length_1123_cov_26.445312	388	468	6	49	80	0.6125000
NODE_4717_length_1123_cov_26.445312	441	521	0	17	80	0.2125000
NODE_4717_length_1123_cov_26.445312	441	521	2	63	80	0.7875000
NODE_4717_length_1123_cov_26.445312	517	597	0	10	80	0.1250000
NODE_4717_length_1123_cov_26.445312	517	597	2	70	80	0.8750000
NODE_4717_length_1123_cov_26.445312	570	650	0	63	80	0.7875000
NODE_4717_length_1123_cov_26.445312	570	650	2	17	80	0.2125000
NODE_4718_length_1123_cov_18.677734	522	602	0	80	80	1.0000000
NODE_4718_length_1123_cov_18.677734	575	655	0	80	80	1.0000000
NODE_4718_length_1123_cov_18.677734	651	731	0	80	80	1.0000000
NODE_4718_length_1123_cov_18.677734	704	784	0	80	80	1.0000000
NODE_4728_length_1122_cov_38.688172	295	375	0	80	80	1.0000000
NODE_4728_length_1122_cov_38.688172	348	428	0	80	80	1.0000000
NODE_4728_length_1122_cov_38.688172	424	504	0	47	80	0.5875000
NODE_4728_length_1122_cov_38.688172	424	504	2	33	80	0.4125000
NODE_4728_length_1122_cov_38.688172	477	557	0	17	80	0.2125000
NODE_4728_length_1122_cov_38.688172	477	557	2	63	80	0.7875000
NODE_4729_length_1122_cov_32.827957	232	312	0	80	80	1.0000000
NODE_4729_length_1122_cov_32.827957	285	365	0	80	80	1.0000000
NODE_4729_length_1122_cov_32.827957	361	441	0	80	80	1.0000000
NODE_4729_length_1122_cov_32.827957	414	494	0	52	80	0.6500000
NODE_4729_length_1122_cov_32.827957	414	494	2	28	80	0.3500000
NODE_4730_length_1122_cov_12.574780	396	476	0	25	80	0.3125000
NODE_4730_length_1122_cov_12.574780	396	476	2	24	80	0.3000000
NODE_4730_length_1122_cov_12.574780	396	476	3	1	80	0.0125000
NODE_4730_length_1122_cov_12.574780	396	476	4	30	80	0.3750000
NODE_4730_length_1122_cov_12.574780	449	529	0	78	80	0.9750000
NODE_4730_length_1122_cov_12.574780	449	529	2	2	80	0.0250000
NODE_4730_length_1122_cov_12.574780	525	605	0	80	80	1.0000000
NODE_4730_length_1122_cov_12.574780	578	658	0	80	80	1.0000000
NODE_4731_length_1122_cov_8.582600	586	666	0	7	80	0.0875000
NODE_4731_length_1122_cov_8.582600	586	666	2	73	80	0.9125000
NODE_4731_length_1122_cov_8.582600	639	719	0	36	80	0.4500000
NODE_4731_length_1122_cov_8.582600	639	719	2	44	80	0.5500000
NODE_4733_length_1122_cov_3.714565	284	364	0	80	80	1.0000000
NODE_4733_length_1122_cov_3.714565	337	417	0	80	80	1.0000000
NODE_4738_length_1122_cov_1.757576	25	87	0	62	62	1.0000000
NODE_4742_length_1121_cov_39.595890	507	587	12	2	80	0.0250000
NODE_4742_length_1121_cov_39.595890	507	587	16	78	80	0.9750000
NODE_4742_length_1121_cov_39.595890	560	640	0	20	80	0.2500000
NODE_4742_length_1121_cov_39.595890	560	640	12	2	80	0.0250000
NODE_4742_length_1121_cov_39.595890	560	640	16	58	80	0.7250000
NODE_4742_length_1121_cov_39.595890	636	716	0	44	80	0.5500000
NODE_4742_length_1121_cov_39.595890	636	716	2	36	80	0.4500000
NODE_4742_length_1121_cov_39.595890	689	769	2	80	80	1.0000000
NODE_4743_length_1121_cov_23.832681	525	605	0	43	80	0.5375000
NODE_4743_length_1121_cov_23.832681	525	605	1	22	80	0.2750000
NODE_4743_length_1121_cov_23.832681	525	605	7	8	80	0.1000000
NODE_4743_length_1121_cov_23.832681	525	605	13	7	80	0.0875000
NODE_4743_length_1121_cov_23.832681	578	658	1	12	80	0.1500000
NODE_4743_length_1121_cov_23.832681	578	658	7	8	80	0.1000000
NODE_4743_length_1121_cov_23.832681	578	658	13	60	80	0.7500000
NODE_4744_length_1121_cov_18.033268	1	42	0	41	41	1.0000000
NODE_4744_length_1121_cov_18.033268	671	751	0	80	80	1.0000000
NODE_4744_length_1121_cov_18.033268	724	804	0	80	80	1.0000000
NODE_4745_length_1121_cov_8.633072	610	690	0	80	80	1.0000000
NODE_4745_length_1121_cov_8.633072	663	743	0	80	80	1.0000000
NODE_4751_length_1120_cov_34.281097	377	457	8	2	80	0.0250000
NODE_4751_length_1120_cov_34.281097	377	457	10	78	80	0.9750000
NODE_4751_length_1120_cov_34.281097	430	510	0	22	80	0.2750000
NODE_4751_length_1120_cov_34.281097	430	510	8	26	80	0.3250000
NODE_4751_length_1120_cov_34.281097	430	510	10	32	80	0.4000000
NODE_4751_length_1120_cov_34.281097	506	586	0	80	80	1.0000000
NODE_4751_length_1120_cov_34.281097	559	639	0	63	80	0.7875000
NODE_4751_length_1120_cov_34.281097	559	639	2	17	80	0.2125000
NODE_4752_length_1120_cov_31.468168	401	481	0	80	80	1.0000000
NODE_4752_length_1120_cov_31.468168	454	534	0	80	80	1.0000000
NODE_4752_length_1120_cov_31.468168	530	610	0	59	80	0.7375000
NODE_4752_length_1120_cov_31.468168	530	610	6	21	80	0.2625000
NODE_4752_length_1120_cov_31.468168	583	663	0	6	80	0.0750000
NODE_4752_length_1120_cov_31.468168	583	663	6	74	80	0.9250000
NODE_4753_length_1120_cov_28.182174	418	498	0	3	80	0.0375000
NODE_4753_length_1120_cov_28.182174	418	498	4	29	80	0.3625000
NODE_4753_length_1120_cov_28.182174	418	498	6	5	80	0.0625000
NODE_4753_length_1120_cov_28.182174	418	498	8	43	80	0.5375000
NODE_4753_length_1120_cov_28.182174	471	551	0	56	80	0.7000000
NODE_4753_length_1120_cov_28.182174	471	551	4	24	80	0.3000000
NODE_4754_length_1120_cov_25.423115	405	485	0	80	80	1.0000000
NODE_4754_length_1120_cov_25.423115	458	538	0	80	80	1.0000000
NODE_4754_length_1120_cov_25.423115	534	614	0	80	80	1.0000000
NODE_4754_length_1120_cov_25.423115	587	667	0	38	80	0.4750000
NODE_4754_length_1120_cov_25.423115	587	667	4	42	80	0.5250000
NODE_4755_length_1120_cov_24.441724	589	662	2	73	73	1.0000000
NODE_4755_length_1120_cov_24.441724	636	716	0	38	80	0.4750000
NODE_4755_length_1120_cov_24.441724	636	716	2	42	80	0.5250000
NODE_4756_length_1120_cov_18.966699	406	486	0	80	80	1.0000000
NODE_4756_length_1120_cov_18.966699	459	539	0	80	80	1.0000000
NODE_4757_length_1120_cov_16.136141	508	588	0	80	80	1.0000000
NODE_4757_length_1120_cov_16.136141	561	641	0	80	80	1.0000000
NODE_4758_length_1120_cov_15.492654	460	540	0	80	80	1.0000000
NODE_4758_length_1120_cov_15.492654	460	540	0	80	80	1.0000000
NODE_4758_length_1120_cov_15.492654	513	593	0	80	80	1.0000000
NODE_4759_length_1120_cov_8.696376	646	726	1	10	80	0.1250000
NODE_4759_length_1120_cov_8.696376	646	726	2	70	80	0.8750000
NODE_4759_length_1120_cov_8.696376	699	779	1	27	80	0.3375000
NODE_4759_length_1120_cov_8.696376	699	779	2	53	80	0.6625000
NODE_4760_length_1120_cov_7.916748	304	384	0	80	80	1.0000000
NODE_4760_length_1120_cov_7.916748	357	437	0	62	80	0.7750000
NODE_4760_length_1120_cov_7.916748	357	437	2	18	80	0.2250000
NODE_4772_length_1119_cov_32.617647	425	505	0	57	80	0.7125000
NODE_4772_length_1119_cov_32.617647	425	505	2	23	80	0.2875000
NODE_4772_length_1119_cov_32.617647	478	558	0	80	80	1.0000000
NODE_4773_length_1119_cov_24.944118	455	535	0	80	80	1.0000000
NODE_4773_length_1119_cov_24.944118	508	588	0	80	80	1.0000000
NODE_4774_length_1119_cov_22.214706	614	694	0	42	80	0.5250000
NODE_4774_length_1119_cov_22.214706	614	694	10	38	80	0.4750000
NODE_4774_length_1119_cov_22.214706	667	747	10	80	80	1.0000000
NODE_4775_length_1119_cov_21.115686	431	511	0	20	80	0.2500000
NODE_4775_length_1119_cov_21.115686	431	511	2	60	80	0.7500000
NODE_4775_length_1119_cov_21.115686	484	564	0	61	80	0.7625000
NODE_4775_length_1119_cov_21.115686	484	564	2	19	80	0.2375000
NODE_4777_length_1119_cov_11.895098	565	645	0	80	80	1.0000000
NODE_4777_length_1119_cov_11.895098	618	698	0	80	80	1.0000000
NODE_4782_length_1119_cov_2.783333	37	99	2	62	62	1.0000000
NODE_4789_length_1118_cov_35.214917	555	635	0	80	80	1.0000000
NODE_4789_length_1118_cov_35.214917	608	688	0	80	80	1.0000000
NODE_4789_length_1118_cov_35.214917	684	764	0	80	80	1.0000000
NODE_4789_length_1118_cov_35.214917	737	817	0	80	80	1.0000000
NODE_4790_length_1118_cov_23.114818	602	682	2	30	80	0.3750000
NODE_4790_length_1118_cov_23.114818	602	682	4	34	80	0.4250000
NODE_4790_length_1118_cov_23.114818	602	682	6	16	80	0.2000000
NODE_4790_length_1118_cov_23.114818	655	735	0	18	80	0.2250000
NODE_4790_length_1118_cov_23.114818	655	735	4	62	80	0.7750000
NODE_4790_length_1118_cov_23.114818	731	811	0	80	80	1.0000000
NODE_4790_length_1118_cov_23.114818	784	864	0	80	80	1.0000000
NODE_4791_length_1118_cov_18.293425	388	463	0	75	75	1.0000000
NODE_4791_length_1118_cov_18.293425	436	516	0	80	80	1.0000000
NODE_4791_length_1118_cov_18.293425	512	592	0	80	80	1.0000000
NODE_4791_length_1118_cov_18.293425	565	645	0	68	80	0.8500000
NODE_4791_length_1118_cov_18.293425	565	645	2	12	80	0.1500000
NODE_4792_length_1118_cov_17.228656	480	560	2	37	80	0.4625000
NODE_4792_length_1118_cov_17.228656	480	560	4	43	80	0.5375000
NODE_4792_length_1118_cov_17.228656	533	613	0	41	80	0.5125000
NODE_4792_length_1118_cov_17.228656	533	613	2	9	80	0.1125000
NODE_4792_length_1118_cov_17.228656	533	613	4	30	80	0.3750000
NODE_4794_length_1118_cov_14.299313	468	548	0	15	80	0.1875000
NODE_4794_length_1118_cov_14.299313	468	548	2	65	80	0.8125000
NODE_4794_length_1118_cov_14.299313	521	601	0	29	80	0.3625000
NODE_4794_length_1118_cov_14.299313	521	601	2	51	80	0.6375000
NODE_4795_length_1118_cov_10.203140	306	386	0	37	80	0.4625000
NODE_4795_length_1118_cov_10.203140	306	386	4	43	80	0.5375000
NODE_4795_length_1118_cov_10.203140	359	439	0	16	80	0.2000000
NODE_4795_length_1118_cov_10.203140	359	439	4	64	80	0.8000000
NODE_4795_length_1118_cov_10.203140	435	515	0	80	80	1.0000000
NODE_4795_length_1118_cov_10.203140	488	568	0	80	80	1.0000000
NODE_4796_length_1118_cov_2.885182	471	551	0	80	80	1.0000000
NODE_4796_length_1118_cov_2.885182	524	604	0	80	80	1.0000000
NODE_4805_length_1117_cov_19.425344	541	621	0	30	80	0.3750000
NODE_4805_length_1117_cov_19.425344	541	621	2	50	80	0.6250000
NODE_4805_length_1117_cov_19.425344	594	674	0	22	80	0.2750000
NODE_4805_length_1117_cov_19.425344	594	674	2	58	80	0.7250000
NODE_4806_length_1117_cov_16.386051	385	465	0	43	80	0.5375000
NODE_4806_length_1117_cov_16.386051	385	465	4	37	80	0.4625000
NODE_4806_length_1117_cov_16.386051	438	518	0	10	80	0.1250000
NODE_4806_length_1117_cov_16.386051	438	518	4	70	80	0.8750000
NODE_4807_length_1117_cov_10.353635	294	374	10	49	80	0.6125000
NODE_4807_length_1117_cov_10.353635	294	374	14	12	80	0.1500000
NODE_4807_length_1117_cov_10.353635	294	374	16	13	80	0.1625000
NODE_4807_length_1117_cov_10.353635	294	374	18	6	80	0.0750000
NODE_4807_length_1117_cov_10.353635	347	427	6	12	80	0.1500000
NODE_4807_length_1117_cov_10.353635	347	427	8	9	80	0.1125000
NODE_4807_length_1117_cov_10.353635	347	427	14	8	80	0.1000000
NODE_4807_length_1117_cov_10.353635	347	427	15	1	80	0.0125000
NODE_4807_length_1117_cov_10.353635	347	427	16	32	80	0.4000000
NODE_4807_length_1117_cov_10.353635	347	427	18	18	80	0.2250000
NODE_4808_length_1117_cov_7.492141	417	497	0	80	80	1.0000000
NODE_4808_length_1117_cov_7.492141	470	550	0	80	80	1.0000000
NODE_4812_length_1117_cov_3.225933	666	728	0	62	62	1.0000000
NODE_4819_length_1116_cov_30.106195	457	537	0	80	80	1.0000000
NODE_4819_length_1116_cov_30.106195	510	590	0	80	80	1.0000000
NODE_4820_length_1116_cov_25.518191	831	911	0	80	80	1.0000000
NODE_4820_length_1116_cov_25.518191	884	964	0	80	80	1.0000000
NODE_4821_length_1116_cov_20.629302	500	580	0	12	80	0.1500000
NODE_4821_length_1116_cov_20.629302	500	580	2	68	80	0.8500000
NODE_4821_length_1116_cov_20.629302	553	633	0	65	80	0.8125000
NODE_4821_length_1116_cov_20.629302	553	633	2	15	80	0.1875000
NODE_4822_length_1116_cov_16.723697	345	425	0	80	80	1.0000000
NODE_4822_length_1116_cov_16.723697	398	478	0	80	80	1.0000000
NODE_4823_length_1116_cov_16.046214	735	815	12	12	80	0.1500000
NODE_4823_length_1116_cov_16.046214	735	815	13	6	80	0.0750000
NODE_4823_length_1116_cov_16.046214	735	815	14	45	80	0.5625000
NODE_4823_length_1116_cov_16.046214	735	815	15	17	80	0.2125000
NODE_4823_length_1116_cov_16.046214	788	868	0	14	80	0.1750000
NODE_4823_length_1116_cov_16.046214	788	868	2	2	80	0.0250000
NODE_4823_length_1116_cov_16.046214	788	868	12	24	80	0.3000000
NODE_4823_length_1116_cov_16.046214	788	868	14	30	80	0.3750000
NODE_4823_length_1116_cov_16.046214	788	868	15	10	80	0.1250000
NODE_4828_length_1116_cov_1.379548	800	880	0	80	80	1.0000000
NODE_4828_length_1116_cov_1.379548	853	933	0	80	80	1.0000000
NODE_4832_length_1115_cov_30.584646	549	629	0	8	80	0.1000000
NODE_4832_length_1115_cov_30.584646	549	629	2	72	80	0.9000000
NODE_4832_length_1115_cov_30.584646	602	682	0	61	80	0.7625000
NODE_4832_length_1115_cov_30.584646	602	682	2	19	80	0.2375000
NODE_4833_length_1115_cov_15.871063	454	534	1	11	80	0.1375000
NODE_4833_length_1115_cov_15.871063	454	534	2	40	80	0.5000000
NODE_4833_length_1115_cov_15.871063	454	534	3	16	80	0.2000000
NODE_4833_length_1115_cov_15.871063	454	534	4	7	80	0.0875000
NODE_4833_length_1115_cov_15.871063	454	534	6	6	80	0.0750000
NODE_4833_length_1115_cov_15.871063	507	587	3	14	80	0.1750000
NODE_4833_length_1115_cov_15.871063	507	587	4	7	80	0.0875000
NODE_4833_length_1115_cov_15.871063	507	587	5	2	80	0.0250000
NODE_4833_length_1115_cov_15.871063	507	587	6	57	80	0.7125000
NODE_4833_length_1115_cov_15.871063	583	663	2	2	80	0.0250000
NODE_4833_length_1115_cov_15.871063	583	663	3	8	80	0.1000000
NODE_4833_length_1115_cov_15.871063	583	663	4	38	80	0.4750000
NODE_4833_length_1115_cov_15.871063	583	663	5	30	80	0.3750000
NODE_4833_length_1115_cov_15.871063	583	663	6	2	80	0.0250000
NODE_4833_length_1115_cov_15.871063	636	716	0	32	80	0.4000000
NODE_4833_length_1115_cov_15.871063	636	716	2	13	80	0.1625000
NODE_4833_length_1115_cov_15.871063	636	716	3	16	80	0.2000000
NODE_4833_length_1115_cov_15.871063	636	716	4	19	80	0.2375000
NODE_4840_length_1114_cov_20.633498	1034	1114	0	8	80	0.1000000
NODE_4840_length_1114_cov_20.633498	1034	1114	9	38	80	0.4750000
NODE_4840_length_1114_cov_20.633498	1034	1114	15	34	80	0.4250000
NODE_4840_length_1114_cov_20.633498	1034	1114	0	8	80	0.1000000
NODE_4840_length_1114_cov_20.633498	1034	1114	9	38	80	0.4750000
NODE_4840_length_1114_cov_20.633498	1034	1114	15	34	80	0.4250000
NODE_4840_length_1114_cov_20.633498	1034	1114	0	8	80	0.1000000
NODE_4840_length_1114_cov_20.633498	1034	1114	9	38	80	0.4750000
NODE_4840_length_1114_cov_20.633498	1034	1114	15	34	80	0.4250000
NODE_4840_length_1114_cov_20.633498	1034	1114	0	8	80	0.1000000
NODE_4840_length_1114_cov_20.633498	1034	1114	9	38	80	0.4750000
NODE_4840_length_1114_cov_20.633498	1034	1114	15	34	80	0.4250000
NODE_4840_length_1114_cov_20.633498	1034	1114	0	8	80	0.1000000
NODE_4840_length_1114_cov_20.633498	1034	1114	9	38	80	0.4750000
NODE_4840_length_1114_cov_20.633498	1034	1114	15	34	80	0.4250000
NODE_4840_length_1114_cov_20.633498	1043	1114	0	8	71	0.1126761
NODE_4840_length_1114_cov_20.633498	1043	1114	9	38	71	0.5352113
NODE_4840_length_1114_cov_20.633498	1043	1114	15	25	71	0.3521127
NODE_4841_length_1114_cov_17.383251	516	601	0	85	85	1.0000000
NODE_4841_length_1114_cov_17.383251	574	653	0	65	79	0.8227848
NODE_4841_length_1114_cov_17.383251	574	653	2	14	79	0.1772152
NODE_4841_length_1114_cov_17.383251	649	729	2	80	80	1.0000000
NODE_4841_length_1114_cov_17.383251	702	782	0	7	80	0.0875000
NODE_4841_length_1114_cov_17.383251	702	782	2	73	80	0.9125000
NODE_4842_length_1114_cov_5.562562	563	643	0	30	80	0.3750000
NODE_4842_length_1114_cov_5.562562	563	643	2	50	80	0.6250000
NODE_4842_length_1114_cov_5.562562	616	696	0	80	80	1.0000000
NODE_4847_length_1113_cov_51.988166	343	423	0	80	80	1.0000000
NODE_4847_length_1113_cov_51.988166	396	476	0	80	80	1.0000000
NODE_4847_length_1113_cov_51.988166	472	552	0	80	80	1.0000000
NODE_4847_length_1113_cov_51.988166	525	605	0	80	80	1.0000000
NODE_4848_length_1113_cov_35.005917	359	439	0	80	80	1.0000000
NODE_4848_length_1113_cov_35.005917	412	492	0	80	80	1.0000000
NODE_4849_length_1113_cov_28.106509	570	650	0	77	80	0.9625000
NODE_4849_length_1113_cov_28.106509	570	650	4	3	80	0.0375000
NODE_4849_length_1113_cov_28.106509	623	703	0	80	80	1.0000000
NODE_4849_length_1113_cov_28.106509	699	779	0	26	80	0.3250000
NODE_4849_length_1113_cov_28.106509	699	779	2	10	80	0.1250000
NODE_4849_length_1113_cov_28.106509	699	779	4	44	80	0.5500000
NODE_4849_length_1113_cov_28.106509	752	832	0	22	80	0.2750000
NODE_4849_length_1113_cov_28.106509	752	832	2	2	80	0.0250000
NODE_4849_length_1113_cov_28.106509	752	832	4	56	80	0.7000000
NODE_4850_length_1113_cov_18.636095	512	592	0	80	80	1.0000000
NODE_4850_length_1113_cov_18.636095	565	645	0	80	80	1.0000000
NODE_4851_length_1113_cov_16.664694	352	432	0	80	80	1.0000000
NODE_4851_length_1113_cov_16.664694	405	485	0	80	80	1.0000000
NODE_4851_length_1113_cov_16.664694	481	561	0	80	80	1.0000000
NODE_4851_length_1113_cov_16.664694	534	614	0	80	80	1.0000000
NODE_4852_length_1113_cov_14.155819	454	512	0	58	58	1.0000000
NODE_4852_length_1113_cov_14.155819	511	575	0	64	64	1.0000000
NODE_4853_length_1113_cov_10.185404	494	574	0	80	80	1.0000000
NODE_4853_length_1113_cov_10.185404	547	627	0	80	80	1.0000000
NODE_4855_length_1113_cov_4.005917	700	780	0	31	80	0.3875000
NODE_4855_length_1113_cov_4.005917	700	780	2	49	80	0.6125000
NODE_4855_length_1113_cov_4.005917	753	833	0	80	80	1.0000000
NODE_4866_length_1112_cov_14.961500	427	507	0	9	80	0.1125000
NODE_4866_length_1112_cov_14.961500	427	507	2	71	80	0.8875000
NODE_4866_length_1112_cov_14.961500	480	560	0	14	80	0.1750000
NODE_4866_length_1112_cov_14.961500	480	560	2	66	80	0.8250000
NODE_4866_length_1112_cov_14.961500	556	636	0	61	80	0.7625000
NODE_4866_length_1112_cov_14.961500	556	636	2	19	80	0.2375000
NODE_4866_length_1112_cov_14.961500	609	689	0	80	80	1.0000000
NODE_4875_length_1112_cov_1.655479	45	123	0	78	78	1.0000000
NODE_4875_length_1112_cov_1.655479	98	166	0	68	68	1.0000000
NODE_4880_length_1111_cov_37.999012	473	553	0	80	80	1.0000000
NODE_4880_length_1111_cov_37.999012	526	606	0	80	80	1.0000000
NODE_4880_length_1111_cov_37.999012	602	682	0	80	80	1.0000000
NODE_4880_length_1111_cov_37.999012	655	735	0	80	80	1.0000000
NODE_4881_length_1111_cov_24.394269	644	724	0	10	80	0.1250000
NODE_4881_length_1111_cov_24.394269	644	724	2	34	80	0.4250000
NODE_4881_length_1111_cov_24.394269	644	724	4	1	80	0.0125000
NODE_4881_length_1111_cov_24.394269	644	724	6	22	80	0.2750000
NODE_4881_length_1111_cov_24.394269	644	724	16	4	80	0.0500000
NODE_4881_length_1111_cov_24.394269	644	724	18	9	80	0.1125000
NODE_4881_length_1111_cov_24.394269	697	777	6	14	80	0.1750000
NODE_4881_length_1111_cov_24.394269	697	777	16	45	80	0.5625000
NODE_4881_length_1111_cov_24.394269	697	777	18	21	80	0.2625000
NODE_4882_length_1111_cov_23.676877	374	454	0	37	80	0.4625000
NODE_4882_length_1111_cov_23.676877	374	454	2	43	80	0.5375000
NODE_4882_length_1111_cov_23.676877	427	507	0	6	80	0.0750000
NODE_4882_length_1111_cov_23.676877	427	507	2	74	80	0.9250000
NODE_4883_length_1111_cov_17.522727	383	463	0	80	80	1.0000000
NODE_4883_length_1111_cov_17.522727	436	516	0	80	80	1.0000000
NODE_4884_length_1111_cov_16.495059	388	468	0	4	80	0.0500000
NODE_4884_length_1111_cov_16.495059	388	468	2	76	80	0.9500000
NODE_4884_length_1111_cov_16.495059	441	521	0	57	80	0.7125000
NODE_4884_length_1111_cov_16.495059	441	521	2	23	80	0.2875000
NODE_4885_length_1111_cov_15.366601	555	635	0	80	80	1.0000000
NODE_4885_length_1111_cov_15.366601	608	688	0	80	80	1.0000000
NODE_4886_length_1111_cov_15.314229	809	889	2	80	80	1.0000000
NODE_4886_length_1111_cov_15.314229	862	942	0	47	80	0.5875000
NODE_4886_length_1111_cov_15.314229	862	942	2	33	80	0.4125000
NODE_4887_length_1111_cov_9.732213	443	523	4	63	80	0.7875000
NODE_4887_length_1111_cov_9.732213	443	523	5	14	80	0.1750000
NODE_4887_length_1111_cov_9.732213	443	523	6	3	80	0.0375000
NODE_4887_length_1111_cov_9.732213	496	576	4	59	80	0.7375000
NODE_4887_length_1111_cov_9.732213	496	576	6	21	80	0.2625000
NODE_4888_length_1111_cov_4.907115	606	686	0	80	80	1.0000000
NODE_4888_length_1111_cov_4.907115	659	739	0	80	80	1.0000000
NODE_4892_length_1110_cov_23.012859	453	533	0	11	80	0.1375000
NODE_4892_length_1110_cov_23.012859	453	533	2	10	80	0.1250000
NODE_4892_length_1110_cov_23.012859	453	533	4	59	80	0.7375000
NODE_4892_length_1110_cov_23.012859	506	586	0	19	80	0.2375000
NODE_4892_length_1110_cov_23.012859	506	586	2	22	80	0.2750000
NODE_4892_length_1110_cov_23.012859	506	586	4	39	80	0.4875000
NODE_4892_length_1110_cov_23.012859	582	662	0	80	80	1.0000000
NODE_4892_length_1110_cov_23.012859	635	715	0	80	80	1.0000000
NODE_4895_length_1110_cov_5.305638	754	834	0	80	80	1.0000000
NODE_4895_length_1110_cov_5.305638	807	887	0	80	80	1.0000000
NODE_4896_length_1110_cov_3.698318	642	685	4	43	43	1.0000000
NODE_4899_length_1110_cov_1.871414	15	86	10	59	71	0.8309859
NODE_4899_length_1110_cov_1.871414	15	86	11	3	71	0.0422535
NODE_4899_length_1110_cov_1.871414	15	86	12	2	71	0.0281690
NODE_4899_length_1110_cov_1.871414	15	86	13	2	71	0.0281690
NODE_4899_length_1110_cov_1.871414	15	86	15	3	71	0.0422535
NODE_4899_length_1110_cov_1.871414	15	86	19	2	71	0.0281690
NODE_4903_length_1109_cov_35.307921	413	493	0	4	80	0.0500000
NODE_4903_length_1109_cov_35.307921	413	493	2	5	80	0.0625000
NODE_4903_length_1109_cov_35.307921	413	493	4	28	80	0.3500000
NODE_4903_length_1109_cov_35.307921	413	493	6	43	80	0.5375000
NODE_4903_length_1109_cov_35.307921	466	546	0	35	80	0.4375000
NODE_4903_length_1109_cov_35.307921	466	546	4	45	80	0.5625000
NODE_4903_length_1109_cov_35.307921	542	622	0	80	80	1.0000000
NODE_4903_length_1109_cov_35.307921	595	675	0	80	80	1.0000000
NODE_4904_length_1109_cov_27.880198	501	581	0	80	80	1.0000000
NODE_4904_length_1109_cov_27.880198	554	634	0	80	80	1.0000000
NODE_4904_length_1109_cov_27.880198	630	710	0	80	80	1.0000000
NODE_4904_length_1109_cov_27.880198	683	763	0	80	80	1.0000000
NODE_4905_length_1109_cov_21.858416	571	651	0	80	80	1.0000000
NODE_4905_length_1109_cov_21.858416	624	704	0	80	80	1.0000000
NODE_4912_length_1108_cov_59.921705	386	466	6	1	80	0.0125000
NODE_4912_length_1108_cov_59.921705	386	466	11	1	80	0.0125000
NODE_4912_length_1108_cov_59.921705	386	466	15	14	80	0.1750000
NODE_4912_length_1108_cov_59.921705	386	466	17	8	80	0.1000000
NODE_4912_length_1108_cov_59.921705	386	466	26	1	80	0.0125000
NODE_4912_length_1108_cov_59.921705	386	466	28	33	80	0.4125000
NODE_4912_length_1108_cov_59.921705	386	466	29	5	80	0.0625000
NODE_4912_length_1108_cov_59.921705	386	466	30	6	80	0.0750000
NODE_4912_length_1108_cov_59.921705	386	466	31	11	80	0.1375000
NODE_4912_length_1108_cov_59.921705	439	519	20	1	80	0.0125000
NODE_4912_length_1108_cov_59.921705	439	519	22	4	80	0.0500000
NODE_4912_length_1108_cov_59.921705	439	519	24	36	80	0.4500000
NODE_4912_length_1108_cov_59.921705	439	519	27	1	80	0.0125000
NODE_4912_length_1108_cov_59.921705	439	519	28	9	80	0.1125000
NODE_4912_length_1108_cov_59.921705	439	519	29	5	80	0.0625000
NODE_4912_length_1108_cov_59.921705	439	519	30	13	80	0.1625000
NODE_4912_length_1108_cov_59.921705	439	519	31	11	80	0.1375000
NODE_4912_length_1108_cov_59.921705	515	595	0	35	80	0.4375000
NODE_4912_length_1108_cov_59.921705	515	595	10	2	80	0.0250000
NODE_4912_length_1108_cov_59.921705	515	595	11	22	80	0.2750000
NODE_4912_length_1108_cov_59.921705	515	595	19	1	80	0.0125000
NODE_4912_length_1108_cov_59.921705	515	595	20	17	80	0.2125000
NODE_4912_length_1108_cov_59.921705	515	595	22	3	80	0.0375000
NODE_4912_length_1108_cov_59.921705	568	648	0	80	80	1.0000000
NODE_4914_length_1108_cov_16.069376	513	593	0	80	80	1.0000000
NODE_4914_length_1108_cov_16.069376	566	646	0	80	80	1.0000000
NODE_4916_length_1108_cov_11.656095	333	413	0	80	80	1.0000000
NODE_4916_length_1108_cov_11.656095	386	466	0	80	80	1.0000000
NODE_4917_length_1108_cov_10.266601	431	511	0	1	80	0.0125000
NODE_4917_length_1108_cov_10.266601	431	511	1	79	80	0.9875000
NODE_4917_length_1108_cov_10.266601	484	564	1	57	80	0.7125000
NODE_4917_length_1108_cov_10.266601	484	564	2	23	80	0.2875000
NODE_4918_length_1108_cov_8.895937	635	715	6	80	80	1.0000000
NODE_4918_length_1108_cov_8.895937	688	768	0	6	80	0.0750000
NODE_4918_length_1108_cov_8.895937	688	768	1	1	80	0.0125000
NODE_4918_length_1108_cov_8.895937	688	768	2	20	80	0.2500000
NODE_4918_length_1108_cov_8.895937	688	768	4	5	80	0.0625000
NODE_4918_length_1108_cov_8.895937	688	768	6	48	80	0.6000000
NODE_4920_length_1108_cov_5.682854	577	657	0	80	80	1.0000000
NODE_4920_length_1108_cov_5.682854	630	710	0	80	80	1.0000000
NODE_4927_length_1107_cov_35.050595	423	503	0	80	80	1.0000000
NODE_4927_length_1107_cov_35.050595	476	556	0	80	80	1.0000000
NODE_4927_length_1107_cov_35.050595	552	632	0	5	80	0.0625000
NODE_4927_length_1107_cov_35.050595	552	632	2	75	80	0.9375000
NODE_4927_length_1107_cov_35.050595	605	685	2	35	80	0.4375000
NODE_4927_length_1107_cov_35.050595	605	685	6	45	80	0.5625000
NODE_4928_length_1107_cov_31.386905	422	502	0	77	80	0.9625000
NODE_4928_length_1107_cov_31.386905	422	502	2	3	80	0.0375000
NODE_4928_length_1107_cov_31.386905	475	555	0	24	80	0.3000000
NODE_4928_length_1107_cov_31.386905	475	555	2	56	80	0.7000000
NODE_4929_length_1107_cov_29.178571	577	657	0	80	80	1.0000000
NODE_4929_length_1107_cov_29.178571	630	710	0	80	80	1.0000000
NODE_4929_length_1107_cov_29.178571	934	1000	0	66	66	1.0000000
NODE_4929_length_1107_cov_29.178571	934	1005	0	71	71	1.0000000
NODE_4930_length_1107_cov_16.038690	574	654	0	80	80	1.0000000
NODE_4930_length_1107_cov_16.038690	627	707	0	80	80	1.0000000
NODE_4931_length_1107_cov_15.472222	78	158	96	2	80	0.0250000
NODE_4931_length_1107_cov_15.472222	78	158	98	3	80	0.0375000
NODE_4931_length_1107_cov_15.472222	78	158	100	1	80	0.0125000
NODE_4931_length_1107_cov_15.472222	78	158	102	1	80	0.0125000
NODE_4931_length_1107_cov_15.472222	78	158	104	2	80	0.0250000
NODE_4931_length_1107_cov_15.472222	78	158	106	5	80	0.0625000
NODE_4931_length_1107_cov_15.472222	78	158	113	1	80	0.0125000
NODE_4931_length_1107_cov_15.472222	78	158	114	2	80	0.0250000
NODE_4931_length_1107_cov_15.472222	78	158	118	6	80	0.0750000
NODE_4931_length_1107_cov_15.472222	78	158	126	3	80	0.0375000
NODE_4931_length_1107_cov_15.472222	78	158	130	1	80	0.0125000
NODE_4931_length_1107_cov_15.472222	78	158	132	3	80	0.0375000
NODE_4931_length_1107_cov_15.472222	78	158	136	5	80	0.0625000
NODE_4931_length_1107_cov_15.472222	78	158	138	1	80	0.0125000
NODE_4931_length_1107_cov_15.472222	78	158	140	5	80	0.0625000
NODE_4931_length_1107_cov_15.472222	78	158	142	1	80	0.0125000
NODE_4931_length_1107_cov_15.472222	78	158	144	1	80	0.0125000
NODE_4931_length_1107_cov_15.472222	78	158	146	1	80	0.0125000
NODE_4931_length_1107_cov_15.472222	78	158	152	1	80	0.0125000
NODE_4931_length_1107_cov_15.472222	78	158	160	1	80	0.0125000
NODE_4931_length_1107_cov_15.472222	78	158	163	2	80	0.0250000
NODE_4931_length_1107_cov_15.472222	78	158	164	1	80	0.0125000
NODE_4931_length_1107_cov_15.472222	78	158	165	5	80	0.0625000
NODE_4931_length_1107_cov_15.472222	78	158	166	2	80	0.0250000
NODE_4931_length_1107_cov_15.472222	78	158	170	24	80	0.3000000
NODE_4931_length_1107_cov_15.472222	131	194	21	1	63	0.0158730
NODE_4931_length_1107_cov_15.472222	131	194	22	2	63	0.0317460
NODE_4931_length_1107_cov_15.472222	131	194	24	1	63	0.0158730
NODE_4931_length_1107_cov_15.472222	131	194	27	4	63	0.0634921
NODE_4931_length_1107_cov_15.472222	131	194	31	2	63	0.0317460
NODE_4931_length_1107_cov_15.472222	131	194	35	1	63	0.0158730
NODE_4931_length_1107_cov_15.472222	131	194	38	2	63	0.0317460
NODE_4931_length_1107_cov_15.472222	131	194	40	1	63	0.0158730
NODE_4931_length_1107_cov_15.472222	131	194	42	2	63	0.0317460
NODE_4931_length_1107_cov_15.472222	131	194	44	2	63	0.0317460
NODE_4931_length_1107_cov_15.472222	131	194	45	1	63	0.0158730
NODE_4931_length_1107_cov_15.472222	131	194	46	1	63	0.0158730
NODE_4931_length_1107_cov_15.472222	131	194	51	1	63	0.0158730
NODE_4931_length_1107_cov_15.472222	131	194	52	1	63	0.0158730
NODE_4931_length_1107_cov_15.472222	131	194	72	2	63	0.0317460
NODE_4931_length_1107_cov_15.472222	131	194	73	1	63	0.0158730
NODE_4931_length_1107_cov_15.472222	131	194	80	2	63	0.0317460
NODE_4931_length_1107_cov_15.472222	131	194	82	2	63	0.0317460
NODE_4931_length_1107_cov_15.472222	131	194	87	1	63	0.0158730
NODE_4931_length_1107_cov_15.472222	131	194	88	1	63	0.0158730
NODE_4931_length_1107_cov_15.472222	131	194	94	5	63	0.0793651
NODE_4931_length_1107_cov_15.472222	131	194	96	2	63	0.0317460
NODE_4931_length_1107_cov_15.472222	131	194	98	3	63	0.0476190
NODE_4931_length_1107_cov_15.472222	131	194	100	1	63	0.0158730
NODE_4931_length_1107_cov_15.472222	131	194	102	1	63	0.0158730
NODE_4931_length_1107_cov_15.472222	131	194	104	2	63	0.0317460
NODE_4931_length_1107_cov_15.472222	131	194	106	5	63	0.0793651
NODE_4931_length_1107_cov_15.472222	131	194	113	1	63	0.0158730
NODE_4931_length_1107_cov_15.472222	131	194	114	2	63	0.0317460
NODE_4931_length_1107_cov_15.472222	131	194	118	6	63	0.0952381
NODE_4931_length_1107_cov_15.472222	131	194	126	3	63	0.0476190
NODE_4931_length_1107_cov_15.472222	131	194	130	1	63	0.0158730
NODE_4931_length_1107_cov_15.472222	952	995	0	21	43	0.4883721
NODE_4931_length_1107_cov_15.472222	952	995	4	1	43	0.0232558
NODE_4931_length_1107_cov_15.472222	952	995	6	19	43	0.4418605
NODE_4931_length_1107_cov_15.472222	952	995	8	2	43	0.0465116
NODE_4931_length_1107_cov_15.472222	968	1052	0	8	84	0.0952381
NODE_4931_length_1107_cov_15.472222	968	1052	6	76	84	0.9047619
NODE_4932_length_1107_cov_13.911706	502	582	0	38	80	0.4750000
NODE_4932_length_1107_cov_13.911706	502	582	2	42	80	0.5250000
NODE_4932_length_1107_cov_13.911706	555	635	0	9	80	0.1125000
NODE_4932_length_1107_cov_13.911706	555	635	2	71	80	0.8875000
NODE_4933_length_1107_cov_11.701389	520	600	0	34	80	0.4250000
NODE_4933_length_1107_cov_11.701389	520	600	2	46	80	0.5750000
NODE_4933_length_1107_cov_11.701389	573	653	0	35	80	0.4375000
NODE_4933_length_1107_cov_11.701389	573	653	2	45	80	0.5625000
NODE_4944_length_1106_cov_59.617676	452	532	0	80	80	1.0000000
NODE_4944_length_1106_cov_59.617676	505	585	0	80	80	1.0000000
NODE_4944_length_1106_cov_59.617676	581	661	0	80	80	1.0000000
NODE_4944_length_1106_cov_59.617676	634	714	0	80	80	1.0000000
NODE_4945_length_1106_cov_40.808342	439	504	0	65	65	1.0000000
NODE_4945_length_1106_cov_40.808342	471	511	0	40	40	1.0000000
NODE_4945_length_1106_cov_40.808342	503	569	0	66	66	1.0000000
NODE_4945_length_1106_cov_40.808342	536	601	0	65	65	1.0000000
NODE_4945_length_1106_cov_40.808342	568	648	0	43	80	0.5375000
NODE_4945_length_1106_cov_40.808342	568	648	4	37	80	0.4625000
NODE_4945_length_1106_cov_40.808342	621	682	4	61	61	1.0000000
NODE_4946_length_1106_cov_23.186693	560	640	0	10	80	0.1250000
NODE_4946_length_1106_cov_23.186693	560	640	2	70	80	0.8750000
NODE_4946_length_1106_cov_23.186693	613	693	0	63	80	0.7875000
NODE_4946_length_1106_cov_23.186693	613	693	2	17	80	0.2125000
NODE_4947_length_1106_cov_14.570010	466	546	0	80	80	1.0000000
NODE_4947_length_1106_cov_14.570010	519	599	0	80	80	1.0000000
NODE_4948_length_1106_cov_14.039722	487	567	0	80	80	1.0000000
NODE_4948_length_1106_cov_14.039722	540	620	0	80	80	1.0000000
NODE_4949_length_1106_cov_8.872890	328	408	0	80	80	1.0000000
NODE_4949_length_1106_cov_8.872890	381	461	0	80	80	1.0000000
NODE_4950_length_1106_cov_7.157895	332	412	0	80	80	1.0000000
NODE_4950_length_1106_cov_7.157895	385	465	0	80	80	1.0000000
NODE_4951_length_1106_cov_6.530288	513	593	0	80	80	1.0000000
NODE_4951_length_1106_cov_6.530288	566	646	0	80	80	1.0000000
NODE_4959_length_1105_cov_28.126243	253	333	0	28	80	0.3500000
NODE_4959_length_1105_cov_28.126243	253	333	2	52	80	0.6500000
NODE_4959_length_1105_cov_28.126243	306	386	2	80	80	1.0000000
NODE_4960_length_1105_cov_24.994036	549	629	0	5	80	0.0625000
NODE_4960_length_1105_cov_24.994036	549	629	2	75	80	0.9375000
NODE_4960_length_1105_cov_24.994036	602	682	0	46	80	0.5750000
NODE_4960_length_1105_cov_24.994036	602	682	2	34	80	0.4250000
NODE_4961_length_1105_cov_17.635189	442	522	0	80	80	1.0000000
NODE_4961_length_1105_cov_17.635189	495	575	0	80	80	1.0000000
NODE_4963_length_1105_cov_10.114314	438	518	0	47	80	0.5875000
NODE_4963_length_1105_cov_10.114314	438	518	2	33	80	0.4125000
NODE_4963_length_1105_cov_10.114314	491	571	0	80	80	1.0000000
NODE_4964_length_1105_cov_8.403579	507	587	0	80	80	1.0000000
NODE_4964_length_1105_cov_8.403579	560	640	0	80	80	1.0000000
NODE_4966_length_1105_cov_6.682903	467	547	0	54	80	0.6750000
NODE_4966_length_1105_cov_6.682903	467	547	2	26	80	0.3250000
NODE_4966_length_1105_cov_6.682903	520	600	0	74	80	0.9250000
NODE_4966_length_1105_cov_6.682903	520	600	2	6	80	0.0750000
NODE_4966_length_1105_cov_6.682903	596	676	2	31	80	0.3875000
NODE_4966_length_1105_cov_6.682903	596	676	4	49	80	0.6125000
NODE_4966_length_1105_cov_6.682903	649	729	0	25	80	0.3125000
NODE_4966_length_1105_cov_6.682903	649	729	2	31	80	0.3875000
NODE_4966_length_1105_cov_6.682903	649	729	4	24	80	0.3000000
NODE_4974_length_1104_cov_27.599005	388	468	0	25	80	0.3125000
NODE_4974_length_1104_cov_27.599005	388	468	2	25	80	0.3125000
NODE_4974_length_1104_cov_27.599005	388	468	8	21	80	0.2625000
NODE_4974_length_1104_cov_27.599005	388	468	10	3	80	0.0375000
NODE_4974_length_1104_cov_27.599005	388	468	12	5	80	0.0625000
NODE_4974_length_1104_cov_27.599005	388	468	14	1	80	0.0125000
NODE_4974_length_1104_cov_27.599005	441	521	8	18	80	0.2250000
NODE_4974_length_1104_cov_27.599005	441	521	10	3	80	0.0375000
NODE_4974_length_1104_cov_27.599005	441	521	12	5	80	0.0625000
NODE_4974_length_1104_cov_27.599005	441	521	14	54	80	0.6750000
NODE_4984_length_1103_cov_2.787849	620	682	2	62	62	1.0000000
NODE_4986_length_1102_cov_34.484546	667	747	0	80	80	1.0000000
NODE_4986_length_1102_cov_34.484546	720	800	0	80	80	1.0000000
NODE_4987_length_1102_cov_17.631107	511	587	0	4	76	0.0526316
NODE_4987_length_1102_cov_17.631107	511	587	2	72	76	0.9473684
NODE_4987_length_1102_cov_17.631107	560	640	0	20	80	0.2500000
NODE_4987_length_1102_cov_17.631107	560	640	2	60	80	0.7500000
NODE_4998_length_1101_cov_35.638723	414	491	2	77	77	1.0000000
NODE_4998_length_1101_cov_35.638723	414	491	2	77	77	1.0000000
NODE_4998_length_1101_cov_35.638723	488	544	0	48	56	0.8571429
NODE_4998_length_1101_cov_35.638723	488	544	1	2	56	0.0357143
NODE_4998_length_1101_cov_35.638723	488	544	2	6	56	0.1071429
NODE_4998_length_1101_cov_35.638723	752	832	2	63	80	0.7875000
NODE_4998_length_1101_cov_35.638723	752	832	4	17	80	0.2125000
NODE_4998_length_1101_cov_35.638723	805	885	0	39	80	0.4875000
NODE_4998_length_1101_cov_35.638723	805	885	2	41	80	0.5125000
NODE_4998_length_1101_cov_35.638723	881	961	0	44	80	0.5500000
NODE_4998_length_1101_cov_35.638723	881	961	2	17	80	0.2125000
NODE_4998_length_1101_cov_35.638723	881	961	4	19	80	0.2375000
NODE_4998_length_1101_cov_35.638723	934	1014	2	8	80	0.1000000
NODE_4998_length_1101_cov_35.638723	934	1014	4	50	80	0.6250000
NODE_4998_length_1101_cov_35.638723	934	1014	6	2	80	0.0250000
NODE_4998_length_1101_cov_35.638723	934	1014	8	20	80	0.2500000
NODE_4999_length_1101_cov_28.366267	452	532	0	80	80	1.0000000
NODE_4999_length_1101_cov_28.366267	505	585	0	80	80	1.0000000
NODE_5000_length_1101_cov_24.513972	475	555	0	80	80	1.0000000
NODE_5000_length_1101_cov_24.513972	528	608	0	80	80	1.0000000
NODE_5001_length_1101_cov_22.315369	335	415	0	15	80	0.1875000
NODE_5001_length_1101_cov_22.315369	335	415	2	65	80	0.8125000
NODE_5001_length_1101_cov_22.315369	388	468	0	66	80	0.8250000
NODE_5001_length_1101_cov_22.315369	388	468	2	14	80	0.1750000
NODE_5001_length_1101_cov_22.315369	464	544	0	2	80	0.0250000
NODE_5001_length_1101_cov_22.315369	464	544	2	45	80	0.5625000
NODE_5001_length_1101_cov_22.315369	464	544	6	11	80	0.1375000
NODE_5001_length_1101_cov_22.315369	464	544	8	6	80	0.0750000
NODE_5001_length_1101_cov_22.315369	464	544	10	16	80	0.2000000
NODE_5001_length_1101_cov_22.315369	517	597	4	12	80	0.1500000
NODE_5001_length_1101_cov_22.315369	517	597	6	5	80	0.0625000
NODE_5001_length_1101_cov_22.315369	517	597	8	47	80	0.5875000
NODE_5001_length_1101_cov_22.315369	517	597	10	16	80	0.2000000
NODE_5002_length_1101_cov_22.070858	419	499	0	80	80	1.0000000
NODE_5002_length_1101_cov_22.070858	472	552	0	80	80	1.0000000
NODE_5002_length_1101_cov_22.070858	548	628	0	46	80	0.5750000
NODE_5002_length_1101_cov_22.070858	548	628	14	34	80	0.4250000
NODE_5002_length_1101_cov_22.070858	601	681	13	29	80	0.3625000
NODE_5002_length_1101_cov_22.070858	601	681	14	51	80	0.6375000
NODE_5003_length_1101_cov_18.821357	469	549	0	80	80	1.0000000
NODE_5003_length_1101_cov_18.821357	522	602	0	80	80	1.0000000
NODE_5004_length_1101_cov_17.151697	502	582	0	45	80	0.5625000
NODE_5004_length_1101_cov_17.151697	502	582	2	35	80	0.4375000
NODE_5004_length_1101_cov_17.151697	555	635	0	8	80	0.1000000
NODE_5004_length_1101_cov_17.151697	555	635	1	10	80	0.1250000
NODE_5004_length_1101_cov_17.151697	555	635	2	62	80	0.7750000
NODE_5005_length_1101_cov_8.371257	968	1048	35	1	80	0.0125000
NODE_5005_length_1101_cov_8.371257	968	1048	48	1	80	0.0125000
NODE_5005_length_1101_cov_8.371257	968	1048	50	1	80	0.0125000
NODE_5005_length_1101_cov_8.371257	968	1048	60	4	80	0.0500000
NODE_5005_length_1101_cov_8.371257	968	1048	66	5	80	0.0625000
NODE_5005_length_1101_cov_8.371257	968	1048	68	4	80	0.0500000
NODE_5005_length_1101_cov_8.371257	968	1048	69	1	80	0.0125000
NODE_5005_length_1101_cov_8.371257	968	1048	70	1	80	0.0125000
NODE_5005_length_1101_cov_8.371257	968	1048	72	1	80	0.0125000
NODE_5005_length_1101_cov_8.371257	968	1048	73	1	80	0.0125000
NODE_5005_length_1101_cov_8.371257	968	1048	74	1	80	0.0125000
NODE_5005_length_1101_cov_8.371257	968	1048	76	1	80	0.0125000
NODE_5005_length_1101_cov_8.371257	968	1048	78	2	80	0.0250000
NODE_5005_length_1101_cov_8.371257	968	1048	80	1	80	0.0125000
NODE_5005_length_1101_cov_8.371257	968	1048	82	1	80	0.0125000
NODE_5005_length_1101_cov_8.371257	968	1048	86	54	80	0.6750000
NODE_5010_length_1100_cov_42.528472	582	662	0	27	80	0.3375000
NODE_5010_length_1100_cov_42.528472	582	662	2	53	80	0.6625000
NODE_5010_length_1100_cov_42.528472	635	715	0	35	80	0.4375000
NODE_5010_length_1100_cov_42.528472	635	715	2	45	80	0.5625000
NODE_5010_length_1100_cov_42.528472	711	791	0	80	80	1.0000000
NODE_5010_length_1100_cov_42.528472	764	844	0	66	80	0.8250000
NODE_5010_length_1100_cov_42.528472	764	844	6	14	80	0.1750000
NODE_5011_length_1100_cov_40.883117	324	404	8	80	80	1.0000000
NODE_5011_length_1100_cov_40.883117	377	457	0	43	80	0.5375000
NODE_5011_length_1100_cov_40.883117	377	457	7	3	80	0.0375000
NODE_5011_length_1100_cov_40.883117	377	457	8	34	80	0.4250000
NODE_5011_length_1100_cov_40.883117	453	533	0	26	80	0.3250000
NODE_5011_length_1100_cov_40.883117	453	533	2	54	80	0.6750000
NODE_5011_length_1100_cov_40.883117	506	586	2	56	80	0.7000000
NODE_5011_length_1100_cov_40.883117	506	586	4	24	80	0.3000000
NODE_5012_length_1100_cov_23.160839	524	604	3	11	80	0.1375000
NODE_5012_length_1100_cov_23.160839	524	604	6	69	80	0.8625000
NODE_5012_length_1100_cov_23.160839	577	657	0	26	80	0.3250000
NODE_5012_length_1100_cov_23.160839	577	657	6	54	80	0.6750000
NODE_5012_length_1100_cov_23.160839	653	733	0	6	80	0.0750000
NODE_5012_length_1100_cov_23.160839	653	733	2	29	80	0.3625000
NODE_5012_length_1100_cov_23.160839	653	733	7	1	80	0.0125000
NODE_5012_length_1100_cov_23.160839	653	733	8	44	80	0.5500000
NODE_5012_length_1100_cov_23.160839	706	786	2	11	80	0.1375000
NODE_5012_length_1100_cov_23.160839	706	786	8	64	80	0.8000000
NODE_5012_length_1100_cov_23.160839	706	786	10	5	80	0.0625000
NODE_5013_length_1100_cov_22.200799	485	565	0	80	80	1.0000000
NODE_5013_length_1100_cov_22.200799	538	618	0	80	80	1.0000000
NODE_5013_length_1100_cov_22.200799	614	694	0	80	80	1.0000000
NODE_5013_length_1100_cov_22.200799	667	745	0	78	78	1.0000000
NODE_5014_length_1100_cov_15.353646	472	552	0	80	80	1.0000000
NODE_5014_length_1100_cov_15.353646	525	605	0	80	80	1.0000000
NODE_5015_length_1100_cov_14.584416	673	753	3	22	80	0.2750000
NODE_5015_length_1100_cov_14.584416	673	753	4	2	80	0.0250000
NODE_5015_length_1100_cov_14.584416	673	753	5	56	80	0.7000000
NODE_5015_length_1100_cov_14.584416	726	806	0	26	80	0.3250000
NODE_5015_length_1100_cov_14.584416	726	806	2	20	80	0.2500000
NODE_5015_length_1100_cov_14.584416	726	806	4	9	80	0.1125000
NODE_5015_length_1100_cov_14.584416	726	806	5	25	80	0.3125000
NODE_5029_length_1099_cov_85.893000	464	544	14	34	80	0.4250000
NODE_5029_length_1099_cov_85.893000	464	544	23	20	80	0.2500000
NODE_5029_length_1099_cov_85.893000	464	544	26	1	80	0.0125000
NODE_5029_length_1099_cov_85.893000	464	544	30	25	80	0.3125000
NODE_5029_length_1099_cov_85.893000	517	597	0	24	80	0.3000000
NODE_5029_length_1099_cov_85.893000	517	597	13	1	80	0.0125000
NODE_5029_length_1099_cov_85.893000	517	597	14	55	80	0.6875000
NODE_5029_length_1099_cov_85.893000	593	673	0	80	80	1.0000000
NODE_5029_length_1099_cov_85.893000	646	726	0	80	80	1.0000000
NODE_5030_length_1099_cov_45.874000	521	601	0	80	80	1.0000000
NODE_5030_length_1099_cov_45.874000	574	654	0	80	80	1.0000000
NODE_5030_length_1099_cov_45.874000	650	730	0	80	80	1.0000000
NODE_5030_length_1099_cov_45.874000	703	783	0	80	80	1.0000000
NODE_5031_length_1099_cov_25.192000	526	606	2	51	80	0.6375000
NODE_5031_length_1099_cov_25.192000	526	606	4	29	80	0.3625000
NODE_5031_length_1099_cov_25.192000	579	659	0	21	80	0.2625000
NODE_5031_length_1099_cov_25.192000	579	659	1	2	80	0.0250000
NODE_5031_length_1099_cov_25.192000	579	659	2	13	80	0.1625000
NODE_5031_length_1099_cov_25.192000	579	659	4	44	80	0.5500000
NODE_5032_length_1099_cov_11.846000	565	645	0	32	80	0.4000000
NODE_5032_length_1099_cov_11.846000	565	645	2	48	80	0.6000000
NODE_5032_length_1099_cov_11.846000	618	698	0	26	80	0.3250000
NODE_5032_length_1099_cov_11.846000	618	698	2	54	80	0.6750000
NODE_5033_length_1099_cov_9.527000	495	575	0	18	80	0.2250000
NODE_5033_length_1099_cov_9.527000	495	575	3	1	80	0.0125000
NODE_5033_length_1099_cov_9.527000	495	575	4	16	80	0.2000000
NODE_5033_length_1099_cov_9.527000	495	575	6	45	80	0.5625000
NODE_5033_length_1099_cov_9.527000	548	628	0	27	80	0.3375000
NODE_5033_length_1099_cov_9.527000	548	628	1	2	80	0.0250000
NODE_5033_length_1099_cov_9.527000	548	628	4	7	80	0.0875000
NODE_5033_length_1099_cov_9.527000	548	628	6	44	80	0.5500000
NODE_5034_length_1099_cov_8.993000	464	544	0	80	80	1.0000000
NODE_5034_length_1099_cov_8.993000	517	597	0	75	80	0.9375000
NODE_5034_length_1099_cov_8.993000	517	597	2	5	80	0.0625000
NODE_5039_length_1099_cov_2.286000	273	353	0	80	80	1.0000000
NODE_5045_length_1098_cov_44.988989	360	440	0	80	80	1.0000000
NODE_5045_length_1098_cov_44.988989	413	493	0	80	80	1.0000000
NODE_5046_length_1098_cov_35.192192	452	532	2	11	80	0.1375000
NODE_5046_length_1098_cov_35.192192	452	532	4	4	80	0.0500000
NODE_5046_length_1098_cov_35.192192	452	532	6	65	80	0.8125000
NODE_5046_length_1098_cov_35.192192	505	585	0	45	80	0.5625000
NODE_5046_length_1098_cov_35.192192	505	585	4	12	80	0.1500000
NODE_5046_length_1098_cov_35.192192	505	585	6	23	80	0.2875000
NODE_5046_length_1098_cov_35.192192	581	661	0	80	80	1.0000000
NODE_5046_length_1098_cov_35.192192	634	714	0	80	80	1.0000000
NODE_5047_length_1098_cov_28.743744	449	529	0	80	80	1.0000000
NODE_5047_length_1098_cov_28.743744	502	582	0	80	80	1.0000000
NODE_5047_length_1098_cov_28.743744	578	658	0	80	80	1.0000000
NODE_5047_length_1098_cov_28.743744	631	711	0	80	80	1.0000000
NODE_5048_length_1098_cov_28.230230	477	557	0	80	80	1.0000000
NODE_5048_length_1098_cov_28.230230	530	610	0	80	80	1.0000000
NODE_5048_length_1098_cov_28.230230	606	686	0	11	80	0.1375000
NODE_5048_length_1098_cov_28.230230	606	686	5	3	80	0.0375000
NODE_5048_length_1098_cov_28.230230	606	686	6	66	80	0.8250000
NODE_5048_length_1098_cov_28.230230	659	739	0	24	80	0.3000000
NODE_5048_length_1098_cov_28.230230	659	739	6	56	80	0.7000000
NODE_5049_length_1098_cov_26.131131	494	574	0	78	80	0.9750000
NODE_5049_length_1098_cov_26.131131	494	574	2	2	80	0.0250000
NODE_5049_length_1098_cov_26.131131	547	627	0	80	80	1.0000000
NODE_5050_length_1098_cov_21.355355	599	679	0	80	80	1.0000000
NODE_5050_length_1098_cov_21.355355	652	732	0	80	80	1.0000000
NODE_5051_length_1098_cov_17.087087	541	621	0	80	80	1.0000000
NODE_5051_length_1098_cov_17.087087	594	674	0	80	80	1.0000000
NODE_5051_length_1098_cov_17.087087	670	750	0	76	80	0.9500000
NODE_5051_length_1098_cov_17.087087	670	750	10	4	80	0.0500000
NODE_5051_length_1098_cov_17.087087	723	803	0	23	80	0.2875000
NODE_5051_length_1098_cov_17.087087	723	803	10	57	80	0.7125000
NODE_5052_length_1098_cov_15.455455	545	625	0	10	80	0.1250000
NODE_5052_length_1098_cov_15.455455	545	625	4	12	80	0.1500000
NODE_5052_length_1098_cov_15.455455	545	625	6	44	80	0.5500000
NODE_5052_length_1098_cov_15.455455	545	625	8	14	80	0.1750000
NODE_5052_length_1098_cov_15.455455	598	678	0	63	80	0.7875000
NODE_5052_length_1098_cov_15.455455	598	678	4	12	80	0.1500000
NODE_5052_length_1098_cov_15.455455	598	678	6	5	80	0.0625000
NODE_5052_length_1098_cov_15.455455	674	754	0	80	80	1.0000000
NODE_5052_length_1098_cov_15.455455	727	807	0	80	80	1.0000000
NODE_5054_length_1097_cov_37.103206	438	518	2	11	80	0.1375000
NODE_5054_length_1097_cov_37.103206	438	518	4	41	80	0.5125000
NODE_5054_length_1097_cov_37.103206	438	518	8	11	80	0.1375000
NODE_5054_length_1097_cov_37.103206	438	518	10	17	80	0.2125000
NODE_5054_length_1097_cov_37.103206	491	571	0	2	80	0.0250000
NODE_5054_length_1097_cov_37.103206	491	571	2	62	80	0.7750000
NODE_5054_length_1097_cov_37.103206	491	571	4	16	80	0.2000000
NODE_5054_length_1097_cov_37.103206	567	647	0	21	80	0.2625000
NODE_5054_length_1097_cov_37.103206	567	647	2	59	80	0.7375000
NODE_5054_length_1097_cov_37.103206	620	700	0	38	80	0.4750000
NODE_5054_length_1097_cov_37.103206	620	700	2	42	80	0.5250000
NODE_5055_length_1097_cov_32.624248	501	581	0	65	80	0.8125000
NODE_5055_length_1097_cov_32.624248	501	581	2	15	80	0.1875000
NODE_5055_length_1097_cov_32.624248	554	634	0	12	80	0.1500000
NODE_5055_length_1097_cov_32.624248	554	634	2	68	80	0.8500000
NODE_5056_length_1097_cov_25.240481	401	480	0	79	79	1.0000000
NODE_5056_length_1097_cov_25.240481	453	533	0	80	80	1.0000000
NODE_5056_length_1097_cov_25.240481	529	609	0	80	80	1.0000000
NODE_5056_length_1097_cov_25.240481	582	662	0	80	80	1.0000000
NODE_5057_length_1097_cov_21.221443	484	564	0	80	80	1.0000000
NODE_5057_length_1097_cov_21.221443	537	617	0	80	80	1.0000000
NODE_5057_length_1097_cov_21.221443	613	693	0	80	80	1.0000000
NODE_5057_length_1097_cov_21.221443	666	746	0	80	80	1.0000000
NODE_5058_length_1097_cov_20.968938	515	595	0	80	80	1.0000000
NODE_5058_length_1097_cov_20.968938	568	648	0	80	80	1.0000000
NODE_5059_length_1097_cov_13.136273	697	779	0	82	82	1.0000000
NODE_5059_length_1097_cov_13.136273	752	832	0	80	80	1.0000000
NODE_5060_length_1097_cov_6.376754	442	522	1	16	80	0.2000000
NODE_5060_length_1097_cov_6.376754	442	522	2	64	80	0.8000000
NODE_5060_length_1097_cov_6.376754	495	575	2	80	80	1.0000000
NODE_5061_length_1097_cov_6.068136	299	379	0	80	80	1.0000000
NODE_5061_length_1097_cov_6.068136	352	432	0	80	80	1.0000000
NODE_5072_length_1096_cov_55.816449	430	510	0	80	80	1.0000000
NODE_5072_length_1096_cov_55.816449	483	563	0	80	80	1.0000000
NODE_5072_length_1096_cov_55.816449	559	639	0	35	80	0.4375000
NODE_5072_length_1096_cov_55.816449	559	639	7	38	80	0.4750000
NODE_5072_length_1096_cov_55.816449	559	639	8	7	80	0.0875000
NODE_5072_length_1096_cov_55.816449	612	692	7	20	80	0.2500000
NODE_5072_length_1096_cov_55.816449	612	692	8	60	80	0.7500000
NODE_5073_length_1096_cov_24.672016	431	511	0	80	80	1.0000000
NODE_5073_length_1096_cov_24.672016	484	564	0	80	80	1.0000000
NODE_5073_length_1096_cov_24.672016	560	640	0	52	80	0.6500000
NODE_5073_length_1096_cov_24.672016	560	640	1	28	80	0.3500000
NODE_5073_length_1096_cov_24.672016	613	693	1	39	80	0.4875000
NODE_5073_length_1096_cov_24.672016	613	693	2	41	80	0.5125000
NODE_5074_length_1096_cov_22.980943	372	452	0	80	80	1.0000000
NODE_5074_length_1096_cov_22.980943	425	505	0	80	80	1.0000000
NODE_5075_length_1096_cov_16.649950	486	566	0	80	80	1.0000000
NODE_5075_length_1096_cov_16.649950	539	619	0	28	80	0.3500000
NODE_5075_length_1096_cov_16.649950	539	619	2	52	80	0.6500000
NODE_5076_length_1096_cov_16.433300	443	523	2	49	80	0.6125000
NODE_5076_length_1096_cov_16.433300	443	523	4	31	80	0.3875000
NODE_5076_length_1096_cov_16.433300	496	576	0	29	80	0.3625000
NODE_5076_length_1096_cov_16.433300	496	576	2	30	80	0.3750000
NODE_5076_length_1096_cov_16.433300	496	576	4	21	80	0.2625000
NODE_5076_length_1096_cov_16.433300	886	966	0	36	80	0.4500000
NODE_5076_length_1096_cov_16.433300	886	966	4	44	80	0.5500000
NODE_5076_length_1096_cov_16.433300	939	1018	0	79	79	1.0000000
NODE_5077_length_1096_cov_13.398195	670	750	0	21	80	0.2625000
NODE_5077_length_1096_cov_13.398195	670	750	2	59	80	0.7375000
NODE_5077_length_1096_cov_13.398195	723	803	0	36	80	0.4500000
NODE_5077_length_1096_cov_13.398195	723	803	2	44	80	0.5500000
NODE_5080_length_1095_cov_25.390562	520	600	0	80	80	1.0000000
NODE_5080_length_1095_cov_25.390562	573	653	0	80	80	1.0000000
NODE_5080_length_1095_cov_25.390562	649	729	0	80	80	1.0000000
NODE_5080_length_1095_cov_25.390562	702	782	0	80	80	1.0000000
NODE_5081_length_1095_cov_13.832329	549	629	0	80	80	1.0000000
NODE_5081_length_1095_cov_13.832329	602	682	0	80	80	1.0000000
NODE_5082_length_1095_cov_13.017068	497	577	0	51	80	0.6375000
NODE_5082_length_1095_cov_13.017068	497	577	2	29	80	0.3625000
NODE_5082_length_1095_cov_13.017068	550	630	0	80	80	1.0000000
NODE_5083_length_1095_cov_7.640562	627	707	0	80	80	1.0000000
NODE_5083_length_1095_cov_7.640562	680	760	0	80	80	1.0000000
NODE_5085_length_1095_cov_4.664659	307	387	0	80	80	1.0000000
NODE_5089_length_1094_cov_35.850251	409	489	0	80	80	1.0000000
NODE_5089_length_1094_cov_35.850251	462	542	0	80	80	1.0000000
NODE_5089_length_1094_cov_35.850251	538	618	0	80	80	1.0000000
NODE_5089_length_1094_cov_35.850251	591	671	0	80	80	1.0000000
NODE_5090_length_1094_cov_27.197990	462	542	0	80	80	1.0000000
NODE_5090_length_1094_cov_27.197990	515	595	0	54	80	0.6750000
NODE_5090_length_1094_cov_27.197990	515	595	2	26	80	0.3250000
NODE_5091_length_1094_cov_19.282412	451	531	13	18	80	0.2250000
NODE_5091_length_1094_cov_19.282412	451	531	17	19	80	0.2375000
NODE_5091_length_1094_cov_19.282412	451	531	21	5	80	0.0625000
NODE_5091_length_1094_cov_19.282412	451	531	30	1	80	0.0125000
NODE_5091_length_1094_cov_19.282412	451	531	31	4	80	0.0500000
NODE_5091_length_1094_cov_19.282412	451	531	35	1	80	0.0125000
NODE_5091_length_1094_cov_19.282412	451	531	36	10	80	0.1250000
NODE_5091_length_1094_cov_19.282412	451	531	42	22	80	0.2750000
NODE_5091_length_1094_cov_19.282412	504	584	25	8	80	0.1000000
NODE_5091_length_1094_cov_19.282412	504	584	30	18	80	0.2250000
NODE_5091_length_1094_cov_19.282412	504	584	36	5	80	0.0625000
NODE_5091_length_1094_cov_19.282412	504	584	38	6	80	0.0750000
NODE_5091_length_1094_cov_19.282412	504	584	42	43	80	0.5375000
NODE_5092_length_1094_cov_16.084422	558	614	0	56	56	1.0000000
NODE_5092_length_1094_cov_16.084422	587	667	0	80	80	1.0000000
NODE_5093_length_1094_cov_11.335678	384	464	4	25	80	0.3125000
NODE_5093_length_1094_cov_11.335678	384	464	8	16	80	0.2000000
NODE_5093_length_1094_cov_11.335678	384	464	10	21	80	0.2625000
NODE_5093_length_1094_cov_11.335678	384	464	12	3	80	0.0375000
NODE_5093_length_1094_cov_11.335678	384	464	14	15	80	0.1875000
NODE_5093_length_1094_cov_11.335678	437	517	0	52	80	0.6500000
NODE_5093_length_1094_cov_11.335678	437	517	4	26	80	0.3250000
NODE_5093_length_1094_cov_11.335678	437	517	8	2	80	0.0250000
NODE_5094_length_1094_cov_10.767839	396	476	12	80	80	1.0000000
NODE_5094_length_1094_cov_10.767839	449	529	4	26	80	0.3250000
NODE_5094_length_1094_cov_10.767839	449	529	8	16	80	0.2000000
NODE_5094_length_1094_cov_10.767839	449	529	12	38	80	0.4750000
NODE_5095_length_1094_cov_9.527638	579	659	0	80	80	1.0000000
NODE_5095_length_1094_cov_9.527638	632	712	0	80	80	1.0000000
NODE_5096_length_1094_cov_9.166834	527	607	8	80	80	1.0000000
NODE_5096_length_1094_cov_9.166834	580	660	0	49	80	0.6125000
NODE_5096_length_1094_cov_9.166834	580	660	7	1	80	0.0125000
NODE_5096_length_1094_cov_9.166834	580	660	8	30	80	0.3750000
NODE_5097_length_1094_cov_5.632161	708	768	0	60	60	1.0000000
NODE_5097_length_1094_cov_5.632161	761	821	0	60	60	1.0000000
NODE_5108_length_1093_cov_28.531187	374	454	8	11	80	0.1375000
NODE_5108_length_1093_cov_28.531187	374	454	16	1	80	0.0125000
NODE_5108_length_1093_cov_28.531187	374	454	18	18	80	0.2250000
NODE_5108_length_1093_cov_28.531187	374	454	20	50	80	0.6250000
NODE_5108_length_1093_cov_28.531187	427	507	16	40	80	0.5000000
NODE_5108_length_1093_cov_28.531187	427	507	18	15	80	0.1875000
NODE_5108_length_1093_cov_28.531187	427	507	20	25	80	0.3125000
NODE_5109_length_1093_cov_22.744467	516	596	0	80	80	1.0000000
NODE_5109_length_1093_cov_22.744467	569	649	0	80	80	1.0000000
NODE_5109_length_1093_cov_22.744467	645	725	0	71	80	0.8875000
NODE_5109_length_1093_cov_22.744467	645	725	4	9	80	0.1125000
NODE_5109_length_1093_cov_22.744467	698	778	0	18	80	0.2250000
NODE_5109_length_1093_cov_22.744467	698	778	4	13	80	0.1625000
NODE_5109_length_1093_cov_22.744467	698	778	6	49	80	0.6125000
NODE_5110_length_1093_cov_11.637827	282	362	2	80	80	1.0000000
NODE_5110_length_1093_cov_11.637827	335	415	0	7	80	0.0875000
NODE_5110_length_1093_cov_11.637827	335	415	1	1	80	0.0125000
NODE_5110_length_1093_cov_11.637827	335	415	2	72	80	0.9000000
NODE_5111_length_1093_cov_9.047284	660	740	0	7	80	0.0875000
NODE_5111_length_1093_cov_9.047284	660	740	2	73	80	0.9125000
NODE_5111_length_1093_cov_9.047284	713	793	0	60	80	0.7500000
NODE_5111_length_1093_cov_9.047284	713	793	2	20	80	0.2500000
NODE_5112_length_1093_cov_6.857143	658	738	0	80	80	1.0000000
NODE_5112_length_1093_cov_6.857143	711	791	0	80	80	1.0000000
NODE_5113_length_1093_cov_5.311871	587	667	0	58	80	0.7250000
NODE_5113_length_1093_cov_5.311871	587	667	2	22	80	0.2750000
NODE_5113_length_1093_cov_5.311871	640	720	0	5	80	0.0625000
NODE_5113_length_1093_cov_5.311871	640	720	2	75	80	0.9375000
NODE_5118_length_1092_cov_105.542800	682	768	4	86	86	1.0000000
NODE_5118_length_1092_cov_105.542800	745	807	0	5	62	0.0806452
NODE_5118_length_1092_cov_105.542800	745	807	2	18	62	0.2903226
NODE_5118_length_1092_cov_105.542800	745	807	4	39	62	0.6290323
NODE_5119_length_1092_cov_30.957704	610	690	0	80	80	1.0000000
NODE_5119_length_1092_cov_30.957704	663	743	0	80	80	1.0000000
NODE_5121_length_1092_cov_16.737160	725	805	0	80	80	1.0000000
NODE_5121_length_1092_cov_16.737160	778	858	0	80	80	1.0000000
NODE_5123_length_1092_cov_11.193353	335	415	0	49	80	0.6125000
NODE_5123_length_1092_cov_11.193353	335	415	4	31	80	0.3875000
NODE_5123_length_1092_cov_11.193353	388	468	4	80	80	1.0000000
NODE_5124_length_1092_cov_9.348439	489	569	0	80	80	1.0000000
NODE_5124_length_1092_cov_9.348439	542	622	0	80	80	1.0000000
NODE_5125_length_1092_cov_7.533736	243	323	0	80	80	1.0000000
NODE_5125_length_1092_cov_7.533736	296	376	0	80	80	1.0000000
NODE_5126_length_1092_cov_6.968781	470	550	0	80	80	1.0000000
NODE_5126_length_1092_cov_6.968781	523	603	0	80	80	1.0000000
NODE_5134_length_1091_cov_54.234879	417	497	8	19	80	0.2375000
NODE_5134_length_1091_cov_54.234879	417	497	10	50	80	0.6250000
NODE_5134_length_1091_cov_54.234879	417	497	12	11	80	0.1375000
NODE_5134_length_1091_cov_54.234879	470	550	4	11	80	0.1375000
NODE_5134_length_1091_cov_54.234879	470	550	6	26	80	0.3250000
NODE_5134_length_1091_cov_54.234879	470	550	10	16	80	0.2000000
NODE_5134_length_1091_cov_54.234879	470	550	12	27	80	0.3375000
NODE_5134_length_1091_cov_54.234879	546	626	2	17	80	0.2125000
NODE_5134_length_1091_cov_54.234879	546	626	4	11	80	0.1375000
NODE_5134_length_1091_cov_54.234879	546	626	9	2	80	0.0250000
NODE_5134_length_1091_cov_54.234879	546	626	15	3	80	0.0375000
NODE_5134_length_1091_cov_54.234879	546	626	19	1	80	0.0125000
NODE_5134_length_1091_cov_54.234879	546	626	20	7	80	0.0875000
NODE_5134_length_1091_cov_54.234879	546	626	21	4	80	0.0500000
NODE_5134_length_1091_cov_54.234879	546	626	25	21	80	0.2625000
NODE_5134_length_1091_cov_54.234879	546	626	26	14	80	0.1750000
NODE_5134_length_1091_cov_54.234879	599	679	12	15	80	0.1875000
NODE_5134_length_1091_cov_54.234879	599	679	18	1	80	0.0125000
NODE_5134_length_1091_cov_54.234879	599	679	20	7	80	0.0875000
NODE_5134_length_1091_cov_54.234879	599	679	25	13	80	0.1625000
NODE_5134_length_1091_cov_54.234879	599	679	26	33	80	0.4125000
NODE_5134_length_1091_cov_54.234879	599	679	28	11	80	0.1375000
NODE_5135_length_1091_cov_35.045363	384	464	0	1	80	0.0125000
NODE_5135_length_1091_cov_35.045363	384	464	2	54	80	0.6750000
NODE_5135_length_1091_cov_35.045363	384	464	4	25	80	0.3125000
NODE_5135_length_1091_cov_35.045363	437	517	2	56	80	0.7000000
NODE_5135_length_1091_cov_35.045363	437	517	4	24	80	0.3000000
NODE_5135_length_1091_cov_35.045363	513	593	0	67	80	0.8375000
NODE_5135_length_1091_cov_35.045363	513	593	2	13	80	0.1625000
NODE_5135_length_1091_cov_35.045363	566	646	0	80	80	1.0000000
NODE_5136_length_1091_cov_28.490927	329	409	0	80	80	1.0000000
NODE_5136_length_1091_cov_28.490927	382	462	0	80	80	1.0000000
NODE_5136_length_1091_cov_28.490927	618	698	0	80	80	1.0000000
NODE_5136_length_1091_cov_28.490927	671	751	0	80	80	1.0000000
NODE_5137_length_1091_cov_23.733871	514	594	6	80	80	1.0000000
NODE_5137_length_1091_cov_23.733871	567	647	0	37	80	0.4625000
NODE_5137_length_1091_cov_23.733871	567	647	6	43	80	0.5375000
NODE_5138_length_1091_cov_13.065524	444	524	0	80	80	1.0000000
NODE_5138_length_1091_cov_13.065524	497	577	0	80	80	1.0000000
NODE_5139_length_1091_cov_10.961694	582	646	0	64	64	1.0000000
NODE_5140_length_1091_cov_8.166331	299	379	2	80	80	1.0000000
NODE_5140_length_1091_cov_8.166331	352	432	0	29	80	0.3625000
NODE_5140_length_1091_cov_8.166331	352	432	2	51	80	0.6375000
NODE_5141_length_1091_cov_7.006048	617	697	0	80	80	1.0000000
NODE_5141_length_1091_cov_7.006048	670	750	0	80	80	1.0000000
NODE_5151_length_1090_cov_73.781029	352	432	0	8	80	0.1000000
NODE_5151_length_1090_cov_73.781029	352	432	2	72	80	0.9000000
NODE_5151_length_1090_cov_73.781029	405	485	0	22	80	0.2750000
NODE_5151_length_1090_cov_73.781029	405	485	2	58	80	0.7250000
NODE_5151_length_1090_cov_73.781029	481	567	0	86	86	1.0000000
NODE_5151_length_1090_cov_73.781029	540	620	0	80	80	1.0000000
NODE_5152_length_1090_cov_42.394551	530	610	0	80	80	1.0000000
NODE_5152_length_1090_cov_42.394551	583	663	0	80	80	1.0000000
NODE_5153_length_1090_cov_37.643794	436	516	0	80	80	1.0000000
NODE_5153_length_1090_cov_37.643794	489	569	0	80	80	1.0000000
NODE_5153_length_1090_cov_37.643794	565	645	0	80	80	1.0000000
NODE_5153_length_1090_cov_37.643794	618	698	0	80	80	1.0000000
NODE_5154_length_1090_cov_32.876892	487	567	0	38	80	0.4750000
NODE_5154_length_1090_cov_32.876892	487	567	6	42	80	0.5250000
NODE_5154_length_1090_cov_32.876892	540	620	0	18	80	0.2250000
NODE_5154_length_1090_cov_32.876892	540	620	6	62	80	0.7750000
NODE_5155_length_1090_cov_25.373360	486	566	0	21	80	0.2625000
NODE_5155_length_1090_cov_25.373360	486	566	2	59	80	0.7375000
NODE_5155_length_1090_cov_25.373360	539	619	0	24	80	0.3000000
NODE_5155_length_1090_cov_25.373360	539	619	2	56	80	0.7000000
NODE_5156_length_1090_cov_21.290616	422	502	0	12	80	0.1500000
NODE_5156_length_1090_cov_21.290616	422	502	2	68	80	0.8500000
NODE_5156_length_1090_cov_21.290616	475	555	0	52	80	0.6500000
NODE_5156_length_1090_cov_21.290616	475	555	2	28	80	0.3500000
NODE_5156_length_1090_cov_21.290616	551	631	0	80	80	1.0000000
NODE_5156_length_1090_cov_21.290616	604	684	0	44	80	0.5500000
NODE_5156_length_1090_cov_21.290616	604	684	2	21	80	0.2625000
NODE_5156_length_1090_cov_21.290616	604	684	4	15	80	0.1875000
NODE_5157_length_1090_cov_16.040363	666	746	0	10	80	0.1250000
NODE_5157_length_1090_cov_16.040363	666	746	4	70	80	0.8750000
NODE_5157_length_1090_cov_16.040363	719	799	0	56	80	0.7000000
NODE_5157_length_1090_cov_16.040363	719	799	4	24	80	0.3000000
NODE_5158_length_1090_cov_14.826438	393	473	0	80	80	1.0000000
NODE_5158_length_1090_cov_14.826438	446	526	0	80	80	1.0000000
NODE_5159_length_1090_cov_13.721493	498	578	0	80	80	1.0000000
NODE_5159_length_1090_cov_13.721493	551	631	0	80	80	1.0000000
NODE_5160_length_1090_cov_12.365288	386	467	0	81	81	1.0000000
NODE_5160_length_1090_cov_12.365288	440	520	0	80	80	1.0000000
NODE_5160_length_1090_cov_12.365288	516	596	0	80	80	1.0000000
NODE_5160_length_1090_cov_12.365288	569	649	0	80	80	1.0000000
NODE_5161_length_1090_cov_5.348133	0	80	0	9	80	0.1125000
NODE_5161_length_1090_cov_5.348133	0	80	2	13	80	0.1625000
NODE_5161_length_1090_cov_5.348133	0	80	4	23	80	0.2875000
NODE_5161_length_1090_cov_5.348133	0	80	8	1	80	0.0125000
NODE_5161_length_1090_cov_5.348133	0	80	9	4	80	0.0500000
NODE_5161_length_1090_cov_5.348133	0	80	11	30	80	0.3750000
NODE_5161_length_1090_cov_5.348133	53	99	11	34	46	0.7391304
NODE_5161_length_1090_cov_5.348133	53	99	14	12	46	0.2608696
NODE_5163_length_1090_cov_3.598385	300	340	64	1	40	0.0250000
NODE_5163_length_1090_cov_3.598385	300	340	68	2	40	0.0500000
NODE_5163_length_1090_cov_3.598385	300	340	70	7	40	0.1750000
NODE_5163_length_1090_cov_3.598385	300	340	74	3	40	0.0750000
NODE_5163_length_1090_cov_3.598385	300	340	75	1	40	0.0250000
NODE_5163_length_1090_cov_3.598385	300	340	76	3	40	0.0750000
NODE_5163_length_1090_cov_3.598385	300	340	77	2	40	0.0500000
NODE_5163_length_1090_cov_3.598385	300	340	80	1	40	0.0250000
NODE_5163_length_1090_cov_3.598385	300	340	84	3	40	0.0750000
NODE_5163_length_1090_cov_3.598385	300	340	90	1	40	0.0250000
NODE_5163_length_1090_cov_3.598385	300	340	94	1	40	0.0250000
NODE_5163_length_1090_cov_3.598385	300	340	100	1	40	0.0250000
NODE_5163_length_1090_cov_3.598385	300	340	102	4	40	0.1000000
NODE_5163_length_1090_cov_3.598385	300	340	104	3	40	0.0750000
NODE_5163_length_1090_cov_3.598385	300	340	106	3	40	0.0750000
NODE_5163_length_1090_cov_3.598385	300	340	110	3	40	0.0750000
NODE_5163_length_1090_cov_3.598385	300	340	112	1	40	0.0250000
NODE_5170_length_1089_cov_55.374747	515	594	1	39	79	0.4936709
NODE_5170_length_1089_cov_55.374747	515	594	2	40	79	0.5063291
NODE_5170_length_1089_cov_55.374747	567	647	1	2	80	0.0250000
NODE_5170_length_1089_cov_55.374747	567	647	2	78	80	0.9750000
NODE_5170_length_1089_cov_55.374747	643	723	0	19	80	0.2375000
NODE_5170_length_1089_cov_55.374747	643	723	1	59	80	0.7375000
NODE_5170_length_1089_cov_55.374747	643	723	2	2	80	0.0250000
NODE_5170_length_1089_cov_55.374747	696	776	0	72	80	0.9000000
NODE_5170_length_1089_cov_55.374747	696	776	1	8	80	0.1000000
NODE_5171_length_1089_cov_38.506061	458	538	0	80	80	1.0000000
NODE_5171_length_1089_cov_38.506061	511	591	0	80	80	1.0000000
NODE_5171_length_1089_cov_38.506061	587	667	0	80	80	1.0000000
NODE_5171_length_1089_cov_38.506061	640	720	0	80	80	1.0000000
NODE_5172_length_1089_cov_22.657576	379	459	14	5	80	0.0625000
NODE_5172_length_1089_cov_22.657576	379	459	21	17	80	0.2125000
NODE_5172_length_1089_cov_22.657576	379	459	24	9	80	0.1125000
NODE_5172_length_1089_cov_22.657576	379	459	29	1	80	0.0125000
NODE_5172_length_1089_cov_22.657576	379	459	30	1	80	0.0125000
NODE_5172_length_1089_cov_22.657576	379	459	31	39	80	0.4875000
NODE_5172_length_1089_cov_22.657576	379	459	34	1	80	0.0125000
NODE_5172_length_1089_cov_22.657576	379	459	35	7	80	0.0875000
NODE_5172_length_1089_cov_22.657576	432	512	14	52	80	0.6500000
NODE_5172_length_1089_cov_22.657576	432	512	16	6	80	0.0750000
NODE_5172_length_1089_cov_22.657576	432	512	24	9	80	0.1125000
NODE_5172_length_1089_cov_22.657576	432	512	31	5	80	0.0625000
NODE_5172_length_1089_cov_22.657576	432	512	34	1	80	0.0125000
NODE_5172_length_1089_cov_22.657576	432	512	35	7	80	0.0875000
NODE_5173_length_1089_cov_21.180808	547	627	0	27	80	0.3375000
NODE_5173_length_1089_cov_21.180808	547	627	2	53	80	0.6625000
NODE_5173_length_1089_cov_21.180808	600	680	0	44	80	0.5500000
NODE_5173_length_1089_cov_21.180808	600	680	2	36	80	0.4500000
NODE_5174_length_1089_cov_18.713131	431	511	0	80	80	1.0000000
NODE_5174_length_1089_cov_18.713131	484	564	0	80	80	1.0000000
NODE_5174_length_1089_cov_18.713131	560	640	0	80	80	1.0000000
NODE_5174_length_1089_cov_18.713131	613	693	0	80	80	1.0000000
NODE_5175_length_1089_cov_17.382828	376	456	0	61	80	0.7625000
NODE_5175_length_1089_cov_17.382828	376	456	2	19	80	0.2375000
NODE_5175_length_1089_cov_17.382828	429	509	0	8	80	0.1000000
NODE_5175_length_1089_cov_17.382828	429	509	2	72	80	0.9000000
NODE_5175_length_1089_cov_17.382828	505	585	0	65	80	0.8125000
NODE_5175_length_1089_cov_17.382828	505	585	2	15	80	0.1875000
NODE_5175_length_1089_cov_17.382828	558	638	0	80	80	1.0000000
NODE_5176_length_1089_cov_14.540404	610	690	0	80	80	1.0000000
NODE_5176_length_1089_cov_14.540404	663	743	0	80	80	1.0000000
NODE_5182_length_1088_cov_10.603640	504	584	9	78	80	0.9750000
NODE_5182_length_1088_cov_10.603640	504	584	10	2	80	0.0250000
NODE_5182_length_1088_cov_10.603640	557	632	0	45	75	0.6000000
NODE_5182_length_1088_cov_10.603640	557	632	8	1	75	0.0133333
NODE_5182_length_1088_cov_10.603640	557	632	9	29	75	0.3866667
NODE_5194_length_1088_cov_0.759353	0	59	0	59	59	1.0000000
NODE_5194_length_1088_cov_0.759353	32	97	0	65	65	1.0000000
NODE_5195_length_1087_cov_51.676113	457	537	24	12	80	0.1500000
NODE_5195_length_1087_cov_51.676113	457	537	26	9	80	0.1125000
NODE_5195_length_1087_cov_51.676113	457	537	29	15	80	0.1875000
NODE_5195_length_1087_cov_51.676113	457	537	31	1	80	0.0125000
NODE_5195_length_1087_cov_51.676113	457	537	34	29	80	0.3625000
NODE_5195_length_1087_cov_51.676113	457	537	35	14	80	0.1750000
NODE_5195_length_1087_cov_51.676113	510	590	28	3	80	0.0375000
NODE_5195_length_1087_cov_51.676113	510	590	30	10	80	0.1250000
NODE_5195_length_1087_cov_51.676113	510	590	32	3	80	0.0375000
NODE_5195_length_1087_cov_51.676113	510	590	33	17	80	0.2125000
NODE_5195_length_1087_cov_51.676113	510	590	34	35	80	0.4375000
NODE_5195_length_1087_cov_51.676113	510	590	36	12	80	0.1500000
NODE_5195_length_1087_cov_51.676113	586	666	0	47	80	0.5875000
NODE_5195_length_1087_cov_51.676113	586	666	2	16	80	0.2000000
NODE_5195_length_1087_cov_51.676113	586	666	6	4	80	0.0500000
NODE_5195_length_1087_cov_51.676113	586	666	17	1	80	0.0125000
NODE_5195_length_1087_cov_51.676113	586	666	18	2	80	0.0250000
NODE_5195_length_1087_cov_51.676113	586	666	28	9	80	0.1125000
NODE_5195_length_1087_cov_51.676113	586	666	30	1	80	0.0125000
NODE_5195_length_1087_cov_51.676113	639	719	0	80	80	1.0000000
NODE_5196_length_1087_cov_47.144737	214	276	52	4	62	0.0645161
NODE_5196_length_1087_cov_47.144737	214	276	56	4	62	0.0645161
NODE_5196_length_1087_cov_47.144737	214	276	60	5	62	0.0806452
NODE_5196_length_1087_cov_47.144737	214	276	66	1	62	0.0161290
NODE_5196_length_1087_cov_47.144737	214	276	68	1	62	0.0161290
NODE_5196_length_1087_cov_47.144737	214	276	74	3	62	0.0483871
NODE_5196_length_1087_cov_47.144737	214	276	75	1	62	0.0161290
NODE_5196_length_1087_cov_47.144737	214	276	79	1	62	0.0161290
NODE_5196_length_1087_cov_47.144737	214	276	80	3	62	0.0483871
NODE_5196_length_1087_cov_47.144737	214	276	85	3	62	0.0483871
NODE_5196_length_1087_cov_47.144737	214	276	87	1	62	0.0161290
NODE_5196_length_1087_cov_47.144737	214	276	89	3	62	0.0483871
NODE_5196_length_1087_cov_47.144737	214	276	91	2	62	0.0322581
NODE_5196_length_1087_cov_47.144737	214	276	96	1	62	0.0161290
NODE_5196_length_1087_cov_47.144737	214	276	97	1	62	0.0161290
NODE_5196_length_1087_cov_47.144737	214	276	101	2	62	0.0322581
NODE_5196_length_1087_cov_47.144737	214	276	103	6	62	0.0967742
NODE_5196_length_1087_cov_47.144737	214	276	105	5	62	0.0806452
NODE_5196_length_1087_cov_47.144737	214	276	107	1	62	0.0161290
NODE_5196_length_1087_cov_47.144737	214	276	111	1	62	0.0161290
NODE_5196_length_1087_cov_47.144737	214	276	115	3	62	0.0483871
NODE_5196_length_1087_cov_47.144737	214	276	117	2	62	0.0322581
NODE_5196_length_1087_cov_47.144737	214	276	119	3	62	0.0483871
NODE_5196_length_1087_cov_47.144737	214	276	121	1	62	0.0161290
NODE_5196_length_1087_cov_47.144737	214	276	123	3	62	0.0483871
NODE_5196_length_1087_cov_47.144737	214	276	125	1	62	0.0161290
NODE_5196_length_1087_cov_47.144737	630	710	0	80	80	1.0000000
NODE_5196_length_1087_cov_47.144737	683	763	0	56	80	0.7000000
NODE_5196_length_1087_cov_47.144737	683	763	2	20	80	0.2500000
NODE_5196_length_1087_cov_47.144737	683	763	4	1	80	0.0125000
NODE_5196_length_1087_cov_47.144737	683	763	5	3	80	0.0375000
NODE_5197_length_1087_cov_46.633603	871	951	0	54	80	0.6750000
NODE_5197_length_1087_cov_46.633603	871	951	6	26	80	0.3250000
NODE_5197_length_1087_cov_46.633603	924	999	0	75	75	1.0000000
NODE_5198_length_1087_cov_30.577935	528	608	0	80	80	1.0000000
NODE_5198_length_1087_cov_30.577935	581	661	0	80	80	1.0000000
NODE_5199_length_1087_cov_30.205466	515	591	0	68	76	0.8947368
NODE_5199_length_1087_cov_30.205466	515	591	2	8	76	0.1052632
NODE_5199_length_1087_cov_30.205466	564	644	0	19	80	0.2375000
NODE_5199_length_1087_cov_30.205466	564	644	2	61	80	0.7625000
NODE_5200_length_1087_cov_29.595142	568	648	0	73	80	0.9125000
NODE_5200_length_1087_cov_29.595142	568	648	2	7	80	0.0875000
NODE_5200_length_1087_cov_29.595142	621	701	0	80	80	1.0000000
NODE_5201_length_1087_cov_11.600202	374	454	0	68	80	0.8500000
NODE_5201_length_1087_cov_11.600202	374	454	4	12	80	0.1500000
NODE_5201_length_1087_cov_11.600202	427	507	0	15	80	0.1875000
NODE_5201_length_1087_cov_11.600202	427	507	4	19	80	0.2375000
NODE_5201_length_1087_cov_11.600202	427	507	6	46	80	0.5750000
NODE_5202_length_1087_cov_7.746964	436	516	2	80	80	1.0000000
NODE_5202_length_1087_cov_7.746964	489	569	0	21	80	0.2625000
NODE_5202_length_1087_cov_7.746964	489	569	2	59	80	0.7375000
NODE_5211_length_1086_cov_35.748734	406	486	0	14	80	0.1750000
NODE_5211_length_1086_cov_35.748734	406	486	2	66	80	0.8250000
NODE_5211_length_1086_cov_35.748734	459	539	0	67	80	0.8375000
NODE_5211_length_1086_cov_35.748734	459	539	2	13	80	0.1625000
NODE_5212_length_1086_cov_18.445795	325	405	2	65	80	0.8125000
NODE_5212_length_1086_cov_18.445795	325	405	4	3	80	0.0375000
NODE_5212_length_1086_cov_18.445795	325	405	6	12	80	0.1500000
NODE_5212_length_1086_cov_18.445795	378	458	2	12	80	0.1500000
NODE_5212_length_1086_cov_18.445795	378	458	4	56	80	0.7000000
NODE_5212_length_1086_cov_18.445795	378	458	6	12	80	0.1500000
NODE_5213_length_1086_cov_16.878419	528	608	0	13	80	0.1625000
NODE_5213_length_1086_cov_16.878419	528	608	2	2	80	0.0250000
NODE_5213_length_1086_cov_16.878419	528	608	4	65	80	0.8125000
NODE_5213_length_1086_cov_16.878419	581	661	2	29	80	0.3625000
NODE_5213_length_1086_cov_16.878419	581	661	4	51	80	0.6375000
NODE_5214_length_1086_cov_10.700101	498	578	0	80	80	1.0000000
NODE_5214_length_1086_cov_10.700101	551	631	0	80	80	1.0000000
NODE_5215_length_1086_cov_10.656535	277	357	0	80	80	1.0000000
NODE_5215_length_1086_cov_10.656535	330	410	0	80	80	1.0000000
NODE_5216_length_1086_cov_6.873354	374	454	0	80	80	1.0000000
NODE_5216_length_1086_cov_6.873354	427	507	0	80	80	1.0000000
NODE_5217_length_1086_cov_5.225937	869	949	0	80	80	1.0000000
NODE_5217_length_1086_cov_5.225937	922	1002	0	80	80	1.0000000
NODE_5229_length_1085_cov_30.599391	515	595	0	11	80	0.1375000
NODE_5229_length_1085_cov_30.599391	515	595	2	67	80	0.8375000
NODE_5229_length_1085_cov_30.599391	515	595	4	2	80	0.0250000
NODE_5229_length_1085_cov_30.599391	568	648	2	61	80	0.7625000
NODE_5229_length_1085_cov_30.599391	568	648	4	19	80	0.2375000
NODE_5231_length_1085_cov_13.723124	558	638	0	80	80	1.0000000
NODE_5231_length_1085_cov_13.723124	611	691	0	30	80	0.3750000
NODE_5231_length_1085_cov_13.723124	611	691	2	50	80	0.6250000
NODE_5232_length_1085_cov_12.481744	576	656	0	15	80	0.1875000
NODE_5232_length_1085_cov_12.481744	576	656	2	65	80	0.8125000
NODE_5232_length_1085_cov_12.481744	629	709	0	4	80	0.0500000
NODE_5232_length_1085_cov_12.481744	629	709	2	76	80	0.9500000
NODE_5233_length_1085_cov_11.570994	553	633	0	80	80	1.0000000
NODE_5233_length_1085_cov_11.570994	606	686	0	80	80	1.0000000
NODE_5234_length_1085_cov_10.730223	273	353	2	46	80	0.5750000
NODE_5234_length_1085_cov_10.730223	273	353	7	12	80	0.1500000
NODE_5234_length_1085_cov_10.730223	273	353	9	22	80	0.2750000
NODE_5234_length_1085_cov_10.730223	326	406	7	63	80	0.7875000
NODE_5234_length_1085_cov_10.730223	326	406	8	2	80	0.0250000
NODE_5234_length_1085_cov_10.730223	326	406	9	15	80	0.1875000
NODE_5234_length_1085_cov_10.730223	402	482	0	29	80	0.3625000
NODE_5234_length_1085_cov_10.730223	402	482	7	2	80	0.0250000
NODE_5234_length_1085_cov_10.730223	402	482	8	49	80	0.6125000
NODE_5234_length_1085_cov_10.730223	455	535	0	80	80	1.0000000
NODE_5234_length_1085_cov_10.730223	832	908	10	3	76	0.0394737
NODE_5234_length_1085_cov_10.730223	832	908	11	1	76	0.0131579
NODE_5234_length_1085_cov_10.730223	832	908	12	3	76	0.0394737
NODE_5234_length_1085_cov_10.730223	832	908	14	15	76	0.1973684
NODE_5234_length_1085_cov_10.730223	832	908	16	4	76	0.0526316
NODE_5234_length_1085_cov_10.730223	832	908	18	1	76	0.0131579
NODE_5234_length_1085_cov_10.730223	832	908	20	3	76	0.0394737
NODE_5234_length_1085_cov_10.730223	832	908	22	1	76	0.0131579
NODE_5234_length_1085_cov_10.730223	832	908	24	1	76	0.0131579
NODE_5234_length_1085_cov_10.730223	832	908	26	2	76	0.0263158
NODE_5234_length_1085_cov_10.730223	832	908	28	4	76	0.0526316
NODE_5234_length_1085_cov_10.730223	832	908	32	4	76	0.0526316
NODE_5234_length_1085_cov_10.730223	832	908	34	34	76	0.4473684
NODE_5236_length_1085_cov_8.309331	400	480	0	80	80	1.0000000
NODE_5236_length_1085_cov_8.309331	453	533	0	80	80	1.0000000
NODE_5248_length_1084_cov_60.255838	446	524	0	34	78	0.4358974
NODE_5248_length_1084_cov_60.255838	446	524	2	44	78	0.5641026
NODE_5248_length_1084_cov_60.255838	497	577	0	80	80	1.0000000
NODE_5249_length_1084_cov_33.332995	445	525	0	23	80	0.2875000
NODE_5249_length_1084_cov_33.332995	445	525	2	57	80	0.7125000
NODE_5249_length_1084_cov_33.332995	498	578	0	76	80	0.9500000
NODE_5249_length_1084_cov_33.332995	498	578	2	4	80	0.0500000
NODE_5250_length_1084_cov_11.004061	757	837	0	80	80	1.0000000
NODE_5250_length_1084_cov_11.004061	810	890	0	80	80	1.0000000
NODE_5258_length_1083_cov_42.182927	451	531	0	80	80	1.0000000
NODE_5258_length_1083_cov_42.182927	504	584	0	79	80	0.9875000
NODE_5258_length_1083_cov_42.182927	504	584	1	1	80	0.0125000
NODE_5258_length_1083_cov_42.182927	580	660	0	3	80	0.0375000
NODE_5258_length_1083_cov_42.182927	580	660	1	49	80	0.6125000
NODE_5258_length_1083_cov_42.182927	580	660	2	28	80	0.3500000
NODE_5258_length_1083_cov_42.182927	633	713	2	46	80	0.5750000
NODE_5258_length_1083_cov_42.182927	633	713	4	34	80	0.4250000
NODE_5259_length_1083_cov_41.163618	275	355	2	80	80	1.0000000
NODE_5259_length_1083_cov_41.163618	328	408	0	24	80	0.3000000
NODE_5259_length_1083_cov_41.163618	328	408	2	56	80	0.7000000
NODE_5259_length_1083_cov_41.163618	404	484	0	80	80	1.0000000
NODE_5259_length_1083_cov_41.163618	457	537	0	80	80	1.0000000
NODE_5260_length_1083_cov_39.798780	527	607	0	80	80	1.0000000
NODE_5260_length_1083_cov_39.798780	580	660	0	80	80	1.0000000
NODE_5261_length_1083_cov_34.261179	475	555	2	29	80	0.3625000
NODE_5261_length_1083_cov_34.261179	475	555	4	7	80	0.0875000
NODE_5261_length_1083_cov_34.261179	475	555	6	44	80	0.5500000
NODE_5261_length_1083_cov_34.261179	528	608	0	4	80	0.0500000
NODE_5261_length_1083_cov_34.261179	528	608	4	46	80	0.5750000
NODE_5261_length_1083_cov_34.261179	528	608	6	30	80	0.3750000
NODE_5262_length_1083_cov_33.573171	486	566	0	43	80	0.5375000
NODE_5262_length_1083_cov_33.573171	486	566	1	1	80	0.0125000
NODE_5262_length_1083_cov_33.573171	486	566	2	36	80	0.4500000
NODE_5262_length_1083_cov_33.573171	539	619	2	52	80	0.6500000
NODE_5262_length_1083_cov_33.573171	539	619	4	14	80	0.1750000
NODE_5262_length_1083_cov_33.573171	539	619	8	2	80	0.0250000
NODE_5262_length_1083_cov_33.573171	539	619	10	12	80	0.1500000
NODE_5262_length_1083_cov_33.573171	615	695	4	15	80	0.1875000
NODE_5262_length_1083_cov_33.573171	615	695	5	1	80	0.0125000
NODE_5262_length_1083_cov_33.573171	615	695	6	3	80	0.0375000
NODE_5262_length_1083_cov_33.573171	615	695	10	61	80	0.7625000
NODE_5262_length_1083_cov_33.573171	668	748	0	28	80	0.3500000
NODE_5262_length_1083_cov_33.573171	668	748	2	1	80	0.0125000
NODE_5262_length_1083_cov_33.573171	668	748	4	39	80	0.4875000
NODE_5262_length_1083_cov_33.573171	668	748	5	1	80	0.0125000
NODE_5262_length_1083_cov_33.573171	668	748	6	3	80	0.0375000
NODE_5262_length_1083_cov_33.573171	668	748	10	8	80	0.1000000
NODE_5263_length_1083_cov_33.091463	452	532	0	41	80	0.5125000
NODE_5263_length_1083_cov_33.091463	452	532	5	2	80	0.0250000
NODE_5263_length_1083_cov_33.091463	452	532	11	2	80	0.0250000
NODE_5263_length_1083_cov_33.091463	452	532	16	1	80	0.0125000
NODE_5263_length_1083_cov_33.091463	452	532	18	34	80	0.4250000
NODE_5263_length_1083_cov_33.091463	505	585	12	18	80	0.2250000
NODE_5263_length_1083_cov_33.091463	505	585	18	62	80	0.7750000
NODE_5264_length_1083_cov_30.982724	550	630	2	77	80	0.9625000
NODE_5264_length_1083_cov_30.982724	550	630	4	3	80	0.0375000
NODE_5264_length_1083_cov_30.982724	603	683	0	52	80	0.6500000
NODE_5264_length_1083_cov_30.982724	603	683	2	28	80	0.3500000
NODE_5265_length_1083_cov_18.819106	586	666	2	16	80	0.2000000
NODE_5265_length_1083_cov_18.819106	586	666	4	64	80	0.8000000
NODE_5265_length_1083_cov_18.819106	639	719	0	30	80	0.3750000
NODE_5265_length_1083_cov_18.819106	639	719	2	7	80	0.0875000
NODE_5265_length_1083_cov_18.819106	639	719	4	43	80	0.5375000
NODE_5266_length_1083_cov_17.278455	408	488	2	22	80	0.2750000
NODE_5266_length_1083_cov_17.278455	408	488	4	58	80	0.7250000
NODE_5266_length_1083_cov_17.278455	461	541	0	34	80	0.4250000
NODE_5266_length_1083_cov_17.278455	461	541	2	41	80	0.5125000
NODE_5266_length_1083_cov_17.278455	461	541	4	5	80	0.0625000
NODE_5267_length_1083_cov_13.862805	481	561	0	80	80	1.0000000
NODE_5267_length_1083_cov_13.862805	534	614	0	49	80	0.6125000
NODE_5267_length_1083_cov_13.862805	534	614	4	31	80	0.3875000
NODE_5268_length_1083_cov_13.083333	522	602	8	10	80	0.1250000
NODE_5268_length_1083_cov_13.083333	522	602	10	50	80	0.6250000
NODE_5268_length_1083_cov_13.083333	522	602	13	20	80	0.2500000
NODE_5268_length_1083_cov_13.083333	575	655	0	37	80	0.4625000
NODE_5268_length_1083_cov_13.083333	575	655	4	1	80	0.0125000
NODE_5268_length_1083_cov_13.083333	575	655	8	25	80	0.3125000
NODE_5268_length_1083_cov_13.083333	575	655	10	17	80	0.2125000
NODE_5269_length_1083_cov_11.824187	242	322	0	80	80	1.0000000
NODE_5269_length_1083_cov_11.824187	295	375	0	80	80	1.0000000
NODE_5271_length_1083_cov_3.025407	359	439	0	80	80	1.0000000
NODE_5271_length_1083_cov_3.025407	412	489	0	77	77	1.0000000
NODE_5277_length_1082_cov_34.664293	461	541	9	80	80	1.0000000
NODE_5277_length_1082_cov_34.664293	514	594	3	32	80	0.4000000
NODE_5277_length_1082_cov_34.664293	514	594	9	48	80	0.6000000
NODE_5278_length_1082_cov_17.422177	406	486	0	13	80	0.1625000
NODE_5278_length_1082_cov_17.422177	406	486	2	30	80	0.3750000
NODE_5278_length_1082_cov_17.422177	406	486	4	37	80	0.4625000
NODE_5278_length_1082_cov_17.422177	459	539	0	6	80	0.0750000
NODE_5278_length_1082_cov_17.422177	459	539	2	21	80	0.2625000
NODE_5278_length_1082_cov_17.422177	459	539	4	53	80	0.6625000
NODE_5279_length_1082_cov_15.906409	442	522	0	74	80	0.9250000
NODE_5279_length_1082_cov_15.906409	442	522	4	3	80	0.0375000
NODE_5279_length_1082_cov_15.906409	442	522	6	3	80	0.0375000
NODE_5279_length_1082_cov_15.906409	495	575	0	21	80	0.2625000
NODE_5279_length_1082_cov_15.906409	495	575	4	3	80	0.0375000
NODE_5279_length_1082_cov_15.906409	495	575	6	56	80	0.7000000
NODE_5280_length_1082_cov_13.703967	324	404	0	8	80	0.1000000
NODE_5280_length_1082_cov_13.703967	324	404	2	72	80	0.9000000
NODE_5280_length_1082_cov_13.703967	377	457	0	61	80	0.7625000
NODE_5280_length_1082_cov_13.703967	377	457	2	19	80	0.2375000
NODE_5281_length_1082_cov_6.478128	159	205	0	4	46	0.0869565
NODE_5281_length_1082_cov_6.478128	159	205	2	42	46	0.9130435
NODE_5281_length_1082_cov_6.478128	203	283	0	30	80	0.3750000
NODE_5281_length_1082_cov_6.478128	203	283	6	1	80	0.0125000
NODE_5281_length_1082_cov_6.478128	203	283	8	4	80	0.0500000
NODE_5281_length_1082_cov_6.478128	203	283	14	45	80	0.5625000
NODE_5281_length_1082_cov_6.478128	256	336	0	9	80	0.1125000
NODE_5281_length_1082_cov_6.478128	256	336	8	7	80	0.0875000
NODE_5281_length_1082_cov_6.478128	256	336	14	64	80	0.8000000
NODE_5281_length_1082_cov_6.478128	861	941	0	42	80	0.5250000
NODE_5281_length_1082_cov_6.478128	861	941	2	38	80	0.4750000
NODE_5282_length_1082_cov_4.218718	982	1062	86	1	80	0.0125000
NODE_5282_length_1082_cov_4.218718	982	1062	87	1	80	0.0125000
NODE_5282_length_1082_cov_4.218718	982	1062	106	1	80	0.0125000
NODE_5282_length_1082_cov_4.218718	982	1062	113	1	80	0.0125000
NODE_5282_length_1082_cov_4.218718	982	1062	120	1	80	0.0125000
NODE_5282_length_1082_cov_4.218718	982	1062	127	1	80	0.0125000
NODE_5282_length_1082_cov_4.218718	982	1062	134	1	80	0.0125000
NODE_5282_length_1082_cov_4.218718	982	1062	138	2	80	0.0250000
NODE_5282_length_1082_cov_4.218718	982	1062	144	1	80	0.0125000
NODE_5282_length_1082_cov_4.218718	982	1062	148	1	80	0.0125000
NODE_5282_length_1082_cov_4.218718	982	1062	150	1	80	0.0125000
NODE_5282_length_1082_cov_4.218718	982	1062	156	1	80	0.0125000
NODE_5282_length_1082_cov_4.218718	982	1062	160	2	80	0.0250000
NODE_5282_length_1082_cov_4.218718	982	1062	170	1	80	0.0125000
NODE_5282_length_1082_cov_4.218718	982	1062	174	1	80	0.0125000
NODE_5282_length_1082_cov_4.218718	982	1062	178	1	80	0.0125000
NODE_5282_length_1082_cov_4.218718	982	1062	188	1	80	0.0125000
NODE_5282_length_1082_cov_4.218718	982	1062	190	1	80	0.0125000
NODE_5282_length_1082_cov_4.218718	982	1062	198	1	80	0.0125000
NODE_5282_length_1082_cov_4.218718	982	1062	214	1	80	0.0125000
NODE_5282_length_1082_cov_4.218718	982	1062	216	1	80	0.0125000
NODE_5282_length_1082_cov_4.218718	982	1062	218	1	80	0.0125000
NODE_5282_length_1082_cov_4.218718	982	1062	220	1	80	0.0125000
NODE_5282_length_1082_cov_4.218718	982	1062	242	2	80	0.0250000
NODE_5282_length_1082_cov_4.218718	982	1062	246	7	80	0.0875000
NODE_5282_length_1082_cov_4.218718	982	1062	254	1	80	0.0125000
NODE_5282_length_1082_cov_4.218718	982	1062	260	1	80	0.0125000
NODE_5282_length_1082_cov_4.218718	982	1062	267	2	80	0.0250000
NODE_5282_length_1082_cov_4.218718	982	1062	273	1	80	0.0125000
NODE_5282_length_1082_cov_4.218718	982	1062	284	1	80	0.0125000
NODE_5282_length_1082_cov_4.218718	982	1062	292	2	80	0.0250000
NODE_5282_length_1082_cov_4.218718	982	1062	294	1	80	0.0125000
NODE_5282_length_1082_cov_4.218718	982	1062	296	1	80	0.0125000
NODE_5282_length_1082_cov_4.218718	982	1062	310	1	80	0.0125000
NODE_5282_length_1082_cov_4.218718	982	1062	311	1	80	0.0125000
NODE_5282_length_1082_cov_4.218718	982	1062	313	1	80	0.0125000
NODE_5282_length_1082_cov_4.218718	982	1062	314	1	80	0.0125000
NODE_5282_length_1082_cov_4.218718	982	1062	318	2	80	0.0250000
NODE_5282_length_1082_cov_4.218718	982	1062	322	2	80	0.0250000
NODE_5282_length_1082_cov_4.218718	982	1062	326	2	80	0.0250000
NODE_5282_length_1082_cov_4.218718	982	1062	330	2	80	0.0250000
NODE_5282_length_1082_cov_4.218718	982	1062	336	2	80	0.0250000
NODE_5282_length_1082_cov_4.218718	982	1062	340	1	80	0.0125000
NODE_5282_length_1082_cov_4.218718	982	1062	344	2	80	0.0250000
NODE_5282_length_1082_cov_4.218718	982	1062	346	2	80	0.0250000
NODE_5282_length_1082_cov_4.218718	982	1062	350	2	80	0.0250000
NODE_5282_length_1082_cov_4.218718	982	1062	352	1	80	0.0125000
NODE_5282_length_1082_cov_4.218718	982	1062	354	3	80	0.0375000
NODE_5282_length_1082_cov_4.218718	982	1062	356	1	80	0.0125000
NODE_5282_length_1082_cov_4.218718	982	1062	358	3	80	0.0375000
NODE_5282_length_1082_cov_4.218718	982	1062	362	1	80	0.0125000
NODE_5282_length_1082_cov_4.218718	982	1062	364	1	80	0.0125000
NODE_5282_length_1082_cov_4.218718	982	1062	365	3	80	0.0375000
NODE_5282_length_1082_cov_4.218718	982	1062	367	1	80	0.0125000
NODE_5282_length_1082_cov_4.218718	982	1062	369	1	80	0.0125000
NODE_5291_length_1081_cov_45.308554	510	590	4	14	80	0.1750000
NODE_5291_length_1081_cov_45.308554	510	590	6	39	80	0.4875000
NODE_5291_length_1081_cov_45.308554	510	590	9	3	80	0.0375000
NODE_5291_length_1081_cov_45.308554	510	590	10	24	80	0.3000000
NODE_5291_length_1081_cov_45.308554	563	643	0	3	80	0.0375000
NODE_5291_length_1081_cov_45.308554	563	643	4	43	80	0.5375000
NODE_5291_length_1081_cov_45.308554	563	643	6	10	80	0.1250000
NODE_5291_length_1081_cov_45.308554	563	643	9	2	80	0.0250000
NODE_5291_length_1081_cov_45.308554	563	643	10	22	80	0.2750000
NODE_5292_length_1081_cov_39.581466	476	556	2	2	80	0.0250000
NODE_5292_length_1081_cov_39.581466	476	556	4	33	80	0.4125000
NODE_5292_length_1081_cov_39.581466	476	556	5	1	80	0.0125000
NODE_5292_length_1081_cov_39.581466	476	556	6	1	80	0.0125000
NODE_5292_length_1081_cov_39.581466	476	556	8	29	80	0.3625000
NODE_5292_length_1081_cov_39.581466	476	556	10	14	80	0.1750000
NODE_5292_length_1081_cov_39.581466	529	609	2	55	80	0.6875000
NODE_5292_length_1081_cov_39.581466	529	609	4	25	80	0.3125000
NODE_5292_length_1081_cov_39.581466	605	685	0	30	80	0.3750000
NODE_5292_length_1081_cov_39.581466	605	685	2	50	80	0.6250000
NODE_5292_length_1081_cov_39.581466	658	738	0	80	80	1.0000000
NODE_5293_length_1081_cov_39.457230	373	453	0	80	80	1.0000000
NODE_5293_length_1081_cov_39.457230	426	506	0	80	80	1.0000000
NODE_5294_length_1081_cov_20.415479	376	451	0	75	75	1.0000000
NODE_5294_length_1081_cov_20.415479	436	511	0	75	75	1.0000000
NODE_5294_length_1081_cov_20.415479	496	571	0	62	75	0.8266667
NODE_5294_length_1081_cov_20.415479	496	571	2	13	75	0.1733333
NODE_5294_length_1081_cov_20.415479	544	624	0	14	80	0.1750000
NODE_5294_length_1081_cov_20.415479	544	624	2	50	80	0.6250000
NODE_5294_length_1081_cov_20.415479	544	624	4	6	80	0.0750000
NODE_5294_length_1081_cov_20.415479	544	624	6	10	80	0.1250000
NODE_5295_length_1081_cov_19.985743	378	458	6	12	80	0.1500000
NODE_5295_length_1081_cov_19.985743	378	458	8	27	80	0.3375000
NODE_5295_length_1081_cov_19.985743	378	458	10	41	80	0.5125000
NODE_5295_length_1081_cov_19.985743	431	511	0	20	80	0.2500000
NODE_5295_length_1081_cov_19.985743	431	511	2	32	80	0.4000000
NODE_5295_length_1081_cov_19.985743	431	511	6	13	80	0.1625000
NODE_5295_length_1081_cov_19.985743	431	511	10	15	80	0.1875000
NODE_5295_length_1081_cov_19.985743	507	587	0	80	80	1.0000000
NODE_5295_length_1081_cov_19.985743	560	640	0	80	80	1.0000000
NODE_5296_length_1081_cov_12.658859	468	548	0	37	80	0.4625000
NODE_5296_length_1081_cov_12.658859	468	548	2	19	80	0.2375000
NODE_5296_length_1081_cov_12.658859	468	548	4	24	80	0.3000000
NODE_5296_length_1081_cov_12.658859	521	601	2	3	80	0.0375000
NODE_5296_length_1081_cov_12.658859	521	601	4	53	80	0.6625000
NODE_5296_length_1081_cov_12.658859	521	601	6	24	80	0.3000000
NODE_5299_length_1081_cov_2.586558	7	44	0	37	37	1.0000000
NODE_5304_length_1080_cov_27.857288	261	341	0	80	80	1.0000000
NODE_5304_length_1080_cov_27.857288	314	394	0	80	80	1.0000000
NODE_5305_length_1080_cov_24.258919	321	401	0	80	80	1.0000000
NODE_5305_length_1080_cov_24.258919	374	454	0	80	80	1.0000000
NODE_5305_length_1080_cov_24.258919	450	530	0	80	80	1.0000000
NODE_5305_length_1080_cov_24.258919	503	583	0	77	80	0.9625000
NODE_5305_length_1080_cov_24.258919	503	583	2	3	80	0.0375000
NODE_5306_length_1080_cov_22.589195	446	526	0	65	80	0.8125000
NODE_5306_length_1080_cov_22.589195	446	526	4	15	80	0.1875000
NODE_5306_length_1080_cov_22.589195	499	579	0	12	80	0.1500000
NODE_5306_length_1080_cov_22.589195	499	579	4	27	80	0.3375000
NODE_5306_length_1080_cov_22.589195	499	579	6	41	80	0.5125000
NODE_5306_length_1080_cov_22.589195	575	655	0	35	80	0.4375000
NODE_5306_length_1080_cov_22.589195	575	655	2	37	80	0.4625000
NODE_5306_length_1080_cov_22.589195	575	655	6	8	80	0.1000000
NODE_5306_length_1080_cov_22.589195	628	708	0	80	80	1.0000000
NODE_5307_length_1080_cov_15.544343	599	679	0	28	80	0.3500000
NODE_5307_length_1080_cov_15.544343	599	679	2	11	80	0.1375000
NODE_5307_length_1080_cov_15.544343	599	679	4	41	80	0.5125000
NODE_5307_length_1080_cov_15.544343	652	732	0	23	80	0.2875000
NODE_5307_length_1080_cov_15.544343	652	732	2	15	80	0.1875000
NODE_5307_length_1080_cov_15.544343	652	732	4	42	80	0.5250000
NODE_5308_length_1080_cov_10.416922	321	401	2	25	80	0.3125000
NODE_5308_length_1080_cov_10.416922	321	401	4	20	80	0.2500000
NODE_5308_length_1080_cov_10.416922	321	401	6	2	80	0.0250000
NODE_5308_length_1080_cov_10.416922	321	401	9	1	80	0.0125000
NODE_5308_length_1080_cov_10.416922	321	401	10	4	80	0.0500000
NODE_5308_length_1080_cov_10.416922	321	401	12	4	80	0.0500000
NODE_5308_length_1080_cov_10.416922	321	401	16	20	80	0.2500000
NODE_5308_length_1080_cov_10.416922	321	401	20	4	80	0.0500000
NODE_5308_length_1080_cov_10.416922	374	454	12	3	80	0.0375000
NODE_5308_length_1080_cov_10.416922	374	454	16	20	80	0.2500000
NODE_5308_length_1080_cov_10.416922	374	454	18	2	80	0.0250000
NODE_5308_length_1080_cov_10.416922	374	454	20	10	80	0.1250000
NODE_5308_length_1080_cov_10.416922	374	454	22	45	80	0.5625000
NODE_5315_length_1079_cov_55.352041	367	447	0	80	80	1.0000000
NODE_5315_length_1079_cov_55.352041	420	500	0	80	80	1.0000000
NODE_5315_length_1079_cov_55.352041	496	576	0	80	80	1.0000000
NODE_5315_length_1079_cov_55.352041	549	629	0	80	80	1.0000000
NODE_5316_length_1079_cov_46.879592	444	524	0	80	80	1.0000000
NODE_5316_length_1079_cov_46.879592	497	577	0	78	80	0.9750000
NODE_5316_length_1079_cov_46.879592	497	577	2	2	80	0.0250000
NODE_5316_length_1079_cov_46.879592	573	652	0	2	79	0.0253165
NODE_5316_length_1079_cov_46.879592	573	652	2	77	79	0.9746835
NODE_5316_length_1079_cov_46.879592	625	703	0	36	78	0.4615385
NODE_5316_length_1079_cov_46.879592	625	703	2	42	78	0.5384616
NODE_5317_length_1079_cov_13.708163	611	691	0	80	80	1.0000000
NODE_5317_length_1079_cov_13.708163	664	744	0	80	80	1.0000000
NODE_5318_length_1079_cov_8.632653	416	496	0	80	80	1.0000000
NODE_5318_length_1079_cov_8.632653	469	549	0	80	80	1.0000000
NODE_5325_length_1078_cov_27.804903	357	437	1	11	80	0.1375000
NODE_5325_length_1078_cov_27.804903	357	437	5	69	80	0.8625000
NODE_5325_length_1078_cov_27.804903	410	490	1	2	80	0.0250000
NODE_5325_length_1078_cov_27.804903	410	490	3	35	80	0.4375000
NODE_5325_length_1078_cov_27.804903	410	490	5	43	80	0.5375000
NODE_5326_length_1078_cov_26.071502	459	539	0	80	80	1.0000000
NODE_5326_length_1078_cov_26.071502	512	592	0	80	80	1.0000000
NODE_5326_length_1078_cov_26.071502	588	668	0	80	80	1.0000000
NODE_5326_length_1078_cov_26.071502	641	718	0	77	77	1.0000000
NODE_5327_length_1078_cov_14.985700	495	575	0	80	80	1.0000000
NODE_5327_length_1078_cov_14.985700	548	628	0	80	80	1.0000000
NODE_5333_length_1077_cov_23.876278	546	626	4	80	80	1.0000000
NODE_5333_length_1077_cov_23.876278	599	679	0	42	80	0.5250000
NODE_5333_length_1077_cov_23.876278	599	679	4	38	80	0.4750000
NODE_5334_length_1077_cov_16.067485	532	612	0	80	80	1.0000000
NODE_5334_length_1077_cov_16.067485	585	665	0	80	80	1.0000000
NODE_5335_length_1077_cov_14.568507	556	636	4	80	80	1.0000000
NODE_5335_length_1077_cov_14.568507	609	689	0	24	80	0.3000000
NODE_5335_length_1077_cov_14.568507	609	689	2	6	80	0.0750000
NODE_5335_length_1077_cov_14.568507	609	689	4	50	80	0.6250000
NODE_5336_length_1077_cov_9.507157	496	576	0	80	80	1.0000000
NODE_5336_length_1077_cov_9.507157	549	629	0	80	80	1.0000000
NODE_5342_length_1077_cov_1.781186	252	274	0	22	22	1.0000000
NODE_5345_length_1076_cov_20.592631	534	614	0	76	80	0.9500000
NODE_5345_length_1076_cov_20.592631	534	614	1	4	80	0.0500000
NODE_5345_length_1076_cov_20.592631	587	667	0	80	80	1.0000000
NODE_5346_length_1076_cov_14.788127	427	507	0	80	80	1.0000000
NODE_5346_length_1076_cov_14.788127	480	560	0	80	80	1.0000000
NODE_5348_length_1076_cov_6.306039	883	961	0	78	78	1.0000000
NODE_5348_length_1076_cov_6.306039	936	1014	0	78	78	1.0000000
NODE_5357_length_1075_cov_37.941598	550	630	12	15	80	0.1875000
NODE_5357_length_1075_cov_37.941598	550	630	14	65	80	0.8125000
NODE_5357_length_1075_cov_37.941598	603	685	0	41	82	0.5000000
NODE_5357_length_1075_cov_37.941598	603	685	2	7	82	0.0853659
NODE_5357_length_1075_cov_37.941598	603	685	12	13	82	0.1585366
NODE_5357_length_1075_cov_37.941598	603	685	14	21	82	0.2560976
NODE_5357_length_1075_cov_37.941598	681	761	0	80	80	1.0000000
NODE_5357_length_1075_cov_37.941598	734	814	0	80	80	1.0000000
NODE_5358_length_1075_cov_32.224385	397	477	0	80	80	1.0000000
NODE_5358_length_1075_cov_32.224385	450	530	0	80	80	1.0000000
NODE_5359_length_1075_cov_9.626025	440	520	0	14	80	0.1750000
NODE_5359_length_1075_cov_9.626025	440	520	1	62	80	0.7750000
NODE_5359_length_1075_cov_9.626025	440	520	3	4	80	0.0500000
NODE_5359_length_1075_cov_9.626025	493	573	1	23	80	0.2875000
NODE_5359_length_1075_cov_9.626025	493	573	3	17	80	0.2125000
NODE_5359_length_1075_cov_9.626025	493	573	4	31	80	0.3875000
NODE_5359_length_1075_cov_9.626025	493	573	6	9	80	0.1125000
NODE_5362_length_1075_cov_2.926230	38	99	0	61	61	1.0000000
NODE_5372_length_1074_cov_19.034872	568	648	0	74	80	0.9250000
NODE_5372_length_1074_cov_19.034872	568	648	1	6	80	0.0750000
NODE_5372_length_1074_cov_19.034872	621	701	0	21	80	0.2625000
NODE_5372_length_1074_cov_19.034872	621	701	1	21	80	0.2625000
NODE_5372_length_1074_cov_19.034872	621	701	3	38	80	0.4750000
NODE_5372_length_1074_cov_19.034872	697	777	1	34	80	0.4250000
NODE_5372_length_1074_cov_19.034872	697	777	3	46	80	0.5750000
NODE_5372_length_1074_cov_19.034872	750	830	0	38	80	0.4750000
NODE_5372_length_1074_cov_19.034872	750	830	1	42	80	0.5250000
NODE_5373_length_1074_cov_9.450256	577	657	0	2	80	0.0250000
NODE_5373_length_1074_cov_9.450256	577	657	2	78	80	0.9750000
NODE_5373_length_1074_cov_9.450256	630	710	0	34	80	0.4250000
NODE_5373_length_1074_cov_9.450256	630	710	2	46	80	0.5750000
NODE_5374_length_1074_cov_9.155897	526	606	1	40	80	0.5000000
NODE_5374_length_1074_cov_9.155897	526	606	2	4	80	0.0500000
NODE_5374_length_1074_cov_9.155897	526	606	3	36	80	0.4500000
NODE_5374_length_1074_cov_9.155897	579	659	1	5	80	0.0625000
NODE_5374_length_1074_cov_9.155897	579	659	2	4	80	0.0500000
NODE_5374_length_1074_cov_9.155897	579	659	3	71	80	0.8875000
NODE_5374_length_1074_cov_9.155897	655	735	1	4	80	0.0500000
NODE_5374_length_1074_cov_9.155897	655	735	3	49	80	0.6125000
NODE_5374_length_1074_cov_9.155897	655	735	4	27	80	0.3375000
NODE_5374_length_1074_cov_9.155897	708	788	1	29	80	0.3625000
NODE_5374_length_1074_cov_9.155897	708	788	3	14	80	0.1750000
NODE_5374_length_1074_cov_9.155897	708	788	4	37	80	0.4625000
NODE_5375_length_1074_cov_4.600000	606	686	0	80	80	1.0000000
NODE_5375_length_1074_cov_4.600000	659	739	0	80	80	1.0000000
NODE_5376_length_1074_cov_4.328205	32	112	14	11	80	0.1375000
NODE_5376_length_1074_cov_4.328205	32	112	18	4	80	0.0500000
NODE_5376_length_1074_cov_4.328205	32	112	20	2	80	0.0250000
NODE_5376_length_1074_cov_4.328205	32	112	24	13	80	0.1625000
NODE_5376_length_1074_cov_4.328205	32	112	28	39	80	0.4875000
NODE_5376_length_1074_cov_4.328205	32	112	29	11	80	0.1375000
NODE_5380_length_1073_cov_60.012320	448	528	4	3	80	0.0375000
NODE_5380_length_1073_cov_60.012320	448	528	11	4	80	0.0500000
NODE_5380_length_1073_cov_60.012320	448	528	12	63	80	0.7875000
NODE_5380_length_1073_cov_60.012320	448	528	14	10	80	0.1250000
NODE_5380_length_1073_cov_60.012320	501	581	2	25	80	0.3125000
NODE_5380_length_1073_cov_60.012320	501	581	4	31	80	0.3875000
NODE_5380_length_1073_cov_60.012320	501	581	12	17	80	0.2125000
NODE_5380_length_1073_cov_60.012320	501	581	14	7	80	0.0875000
NODE_5382_length_1073_cov_26.415811	529	609	0	80	80	1.0000000
NODE_5382_length_1073_cov_26.415811	582	662	0	80	80	1.0000000
NODE_5383_length_1073_cov_19.062628	571	651	0	80	80	1.0000000
NODE_5383_length_1073_cov_19.062628	624	704	0	80	80	1.0000000
NODE_5384_length_1073_cov_18.536961	447	527	0	24	80	0.3000000
NODE_5384_length_1073_cov_18.536961	447	527	2	56	80	0.7000000
NODE_5384_length_1073_cov_18.536961	500	580	0	77	80	0.9625000
NODE_5384_length_1073_cov_18.536961	500	580	2	3	80	0.0375000
NODE_5384_length_1073_cov_18.536961	576	656	0	80	80	1.0000000
NODE_5384_length_1073_cov_18.536961	629	709	0	73	80	0.9125000
NODE_5384_length_1073_cov_18.536961	629	709	2	7	80	0.0875000
NODE_5385_length_1073_cov_15.318275	712	792	0	22	80	0.2750000
NODE_5385_length_1073_cov_15.318275	712	792	2	58	80	0.7250000
NODE_5385_length_1073_cov_15.318275	765	845	0	48	80	0.6000000
NODE_5385_length_1073_cov_15.318275	765	845	2	32	80	0.4000000
NODE_5386_length_1073_cov_8.376797	287	367	0	80	80	1.0000000
NODE_5386_length_1073_cov_8.376797	340	420	0	80	80	1.0000000
NODE_5387_length_1073_cov_5.749487	257	337	0	67	80	0.8375000
NODE_5387_length_1073_cov_5.749487	257	337	4	13	80	0.1625000
NODE_5387_length_1073_cov_5.749487	310	390	0	14	80	0.1750000
NODE_5387_length_1073_cov_5.749487	310	390	4	66	80	0.8250000
NODE_5388_length_1073_cov_5.156057	408	444	6	36	36	1.0000000
NODE_5390_length_1073_cov_3.019507	1	69	0	68	68	1.0000000
NODE_5390_length_1073_cov_3.019507	42	122	0	80	80	1.0000000
NODE_5399_length_1072_cov_62.729702	351	431	0	29	80	0.3625000
NODE_5399_length_1072_cov_62.729702	351	431	46	20	80	0.2500000
NODE_5399_length_1072_cov_62.729702	351	431	47	18	80	0.2250000
NODE_5399_length_1072_cov_62.729702	351	431	48	2	80	0.0250000
NODE_5399_length_1072_cov_62.729702	351	431	52	11	80	0.1375000
NODE_5399_length_1072_cov_62.729702	404	484	47	14	80	0.1750000
NODE_5399_length_1072_cov_62.729702	404	484	48	2	80	0.0250000
NODE_5399_length_1072_cov_62.729702	404	484	50	2	80	0.0250000
NODE_5399_length_1072_cov_62.729702	404	484	51	4	80	0.0500000
NODE_5399_length_1072_cov_62.729702	404	484	52	17	80	0.2125000
NODE_5399_length_1072_cov_62.729702	404	484	53	6	80	0.0750000
NODE_5399_length_1072_cov_62.729702	404	484	54	3	80	0.0375000
NODE_5399_length_1072_cov_62.729702	404	484	55	32	80	0.4000000
NODE_5399_length_1072_cov_62.729702	480	560	6	13	80	0.1625000
NODE_5399_length_1072_cov_62.729702	480	560	8	27	80	0.3375000
NODE_5399_length_1072_cov_62.729702	480	560	49	1	80	0.0125000
NODE_5399_length_1072_cov_62.729702	480	560	51	22	80	0.2750000
NODE_5399_length_1072_cov_62.729702	480	560	52	4	80	0.0500000
NODE_5399_length_1072_cov_62.729702	480	560	53	13	80	0.1625000
NODE_5399_length_1072_cov_62.729702	533	613	0	14	80	0.1750000
NODE_5399_length_1072_cov_62.729702	533	613	2	17	80	0.2125000
NODE_5399_length_1072_cov_62.729702	533	613	4	10	80	0.1250000
NODE_5399_length_1072_cov_62.729702	533	613	6	4	80	0.0500000
NODE_5399_length_1072_cov_62.729702	533	613	8	35	80	0.4375000
NODE_5400_length_1072_cov_34.045221	430	510	0	80	80	1.0000000
NODE_5400_length_1072_cov_34.045221	483	563	0	80	80	1.0000000
NODE_5401_length_1072_cov_34.006166	342	423	2	12	81	0.1481481
NODE_5401_length_1072_cov_34.006166	342	423	4	16	81	0.1975309
NODE_5401_length_1072_cov_34.006166	342	423	6	15	81	0.1851852
NODE_5401_length_1072_cov_34.006166	342	423	7	1	81	0.0123457
NODE_5401_length_1072_cov_34.006166	342	423	8	37	81	0.4567901
NODE_5401_length_1072_cov_34.006166	396	476	0	45	80	0.5625000
NODE_5401_length_1072_cov_34.006166	396	476	2	20	80	0.2500000
NODE_5401_length_1072_cov_34.006166	396	476	4	9	80	0.1125000
NODE_5401_length_1072_cov_34.006166	396	476	7	1	80	0.0125000
NODE_5401_length_1072_cov_34.006166	396	476	8	5	80	0.0625000
NODE_5401_length_1072_cov_34.006166	472	552	0	80	80	1.0000000
NODE_5401_length_1072_cov_34.006166	525	605	0	80	80	1.0000000
NODE_5403_length_1072_cov_21.852004	300	380	0	80	80	1.0000000
NODE_5403_length_1072_cov_21.852004	353	433	0	80	80	1.0000000
NODE_5404_length_1072_cov_21.532374	476	556	0	80	80	1.0000000
NODE_5404_length_1072_cov_21.532374	529	609	0	80	80	1.0000000
NODE_5405_length_1072_cov_17.018499	415	495	0	18	80	0.2250000
NODE_5405_length_1072_cov_17.018499	415	495	2	62	80	0.7750000
NODE_5405_length_1072_cov_17.018499	468	548	0	70	80	0.8750000
NODE_5405_length_1072_cov_17.018499	468	548	2	10	80	0.1250000
NODE_5410_length_1072_cov_3.302158	388	449	2	38	61	0.6229508
NODE_5410_length_1072_cov_3.302158	388	449	3	1	61	0.0163934
NODE_5410_length_1072_cov_3.302158	388	449	4	22	61	0.3606557
NODE_5410_length_1072_cov_3.302158	422	502	2	27	80	0.3375000
NODE_5410_length_1072_cov_3.302158	422	502	3	49	80	0.6125000
NODE_5410_length_1072_cov_3.302158	422	502	4	4	80	0.0500000
NODE_5414_length_1072_cov_1.773895	114	176	10	1	62	0.0161290
NODE_5414_length_1072_cov_1.773895	114	176	13	4	62	0.0645161
NODE_5414_length_1072_cov_1.773895	114	176	14	18	62	0.2903226
NODE_5414_length_1072_cov_1.773895	114	176	17	1	62	0.0161290
NODE_5414_length_1072_cov_1.773895	114	176	23	1	62	0.0161290
NODE_5414_length_1072_cov_1.773895	114	176	24	2	62	0.0322581
NODE_5414_length_1072_cov_1.773895	114	176	26	3	62	0.0483871
NODE_5414_length_1072_cov_1.773895	114	176	28	2	62	0.0322581
NODE_5414_length_1072_cov_1.773895	114	176	30	16	62	0.2580645
NODE_5414_length_1072_cov_1.773895	114	176	32	6	62	0.0967742
NODE_5414_length_1072_cov_1.773895	114	176	36	8	62	0.1290323
NODE_5417_length_1071_cov_27.565844	312	392	0	80	80	1.0000000
NODE_5417_length_1071_cov_27.565844	365	445	0	80	80	1.0000000
NODE_5419_length_1071_cov_12.666667	480	560	3	80	80	1.0000000
NODE_5419_length_1071_cov_12.666667	533	613	0	42	80	0.5250000
NODE_5419_length_1071_cov_12.666667	533	613	3	38	80	0.4750000
NODE_5421_length_1071_cov_8.942387	418	498	0	80	80	1.0000000
NODE_5421_length_1071_cov_8.942387	471	551	0	80	80	1.0000000
NODE_5427_length_1070_cov_39.255407	591	671	0	80	80	1.0000000
NODE_5427_length_1070_cov_39.255407	644	724	0	80	80	1.0000000
NODE_5428_length_1070_cov_21.903193	430	510	0	30	80	0.3750000
NODE_5428_length_1070_cov_21.903193	430	510	2	50	80	0.6250000
NODE_5428_length_1070_cov_21.903193	483	563	0	80	80	1.0000000
NODE_5428_length_1070_cov_21.903193	559	639	0	80	80	1.0000000
NODE_5428_length_1070_cov_21.903193	612	692	0	53	80	0.6625000
NODE_5428_length_1070_cov_21.903193	612	692	2	27	80	0.3375000
NODE_5429_length_1070_cov_8.963955	871	900	1	2	29	0.0689655
NODE_5429_length_1070_cov_8.963955	871	900	2	1	29	0.0344828
NODE_5429_length_1070_cov_8.963955	871	900	13	1	29	0.0344828
NODE_5429_length_1070_cov_8.963955	871	900	14	1	29	0.0344828
NODE_5429_length_1070_cov_8.963955	871	900	18	2	29	0.0689655
NODE_5429_length_1070_cov_8.963955	871	900	20	2	29	0.0689655
NODE_5429_length_1070_cov_8.963955	871	900	23	1	29	0.0344828
NODE_5429_length_1070_cov_8.963955	871	900	26	3	29	0.1034483
NODE_5429_length_1070_cov_8.963955	871	900	29	1	29	0.0344828
NODE_5429_length_1070_cov_8.963955	871	900	30	3	29	0.1034483
NODE_5429_length_1070_cov_8.963955	871	900	36	2	29	0.0689655
NODE_5429_length_1070_cov_8.963955	871	900	40	2	29	0.0689655
NODE_5429_length_1070_cov_8.963955	871	900	42	2	29	0.0689655
NODE_5429_length_1070_cov_8.963955	871	900	48	1	29	0.0344828
NODE_5429_length_1070_cov_8.963955	871	900	50	1	29	0.0344828
NODE_5429_length_1070_cov_8.963955	871	900	54	1	29	0.0344828
NODE_5429_length_1070_cov_8.963955	871	900	56	1	29	0.0344828
NODE_5429_length_1070_cov_8.963955	871	900	66	2	29	0.0689655
NODE_5429_length_1070_cov_8.963955	873	953	1	1	80	0.0125000
NODE_5429_length_1070_cov_8.963955	873	953	13	1	80	0.0125000
NODE_5429_length_1070_cov_8.963955	873	953	14	1	80	0.0125000
NODE_5429_length_1070_cov_8.963955	873	953	18	2	80	0.0250000
NODE_5429_length_1070_cov_8.963955	873	953	20	2	80	0.0250000
NODE_5429_length_1070_cov_8.963955	873	953	23	1	80	0.0125000
NODE_5429_length_1070_cov_8.963955	873	953	26	3	80	0.0375000
NODE_5429_length_1070_cov_8.963955	873	953	29	1	80	0.0125000
NODE_5429_length_1070_cov_8.963955	873	953	30	3	80	0.0375000
NODE_5429_length_1070_cov_8.963955	873	953	36	2	80	0.0250000
NODE_5429_length_1070_cov_8.963955	873	953	40	2	80	0.0250000
NODE_5429_length_1070_cov_8.963955	873	953	42	2	80	0.0250000
NODE_5429_length_1070_cov_8.963955	873	953	48	1	80	0.0125000
NODE_5429_length_1070_cov_8.963955	873	953	50	1	80	0.0125000
NODE_5429_length_1070_cov_8.963955	873	953	54	1	80	0.0125000
NODE_5429_length_1070_cov_8.963955	873	953	56	1	80	0.0125000
NODE_5429_length_1070_cov_8.963955	873	953	66	3	80	0.0375000
NODE_5429_length_1070_cov_8.963955	873	953	72	1	80	0.0125000
NODE_5429_length_1070_cov_8.963955	873	953	78	1	80	0.0125000
NODE_5429_length_1070_cov_8.963955	873	953	79	1	80	0.0125000
NODE_5429_length_1070_cov_8.963955	873	953	85	1	80	0.0125000
NODE_5429_length_1070_cov_8.963955	873	953	86	1	80	0.0125000
NODE_5429_length_1070_cov_8.963955	873	953	96	1	80	0.0125000
NODE_5429_length_1070_cov_8.963955	873	953	98	1	80	0.0125000
NODE_5429_length_1070_cov_8.963955	873	953	103	1	80	0.0125000
NODE_5429_length_1070_cov_8.963955	873	953	109	2	80	0.0250000
NODE_5429_length_1070_cov_8.963955	873	953	111	1	80	0.0125000
NODE_5429_length_1070_cov_8.963955	873	953	113	1	80	0.0125000
NODE_5429_length_1070_cov_8.963955	873	953	121	1	80	0.0125000
NODE_5429_length_1070_cov_8.963955	873	953	123	1	80	0.0125000
NODE_5429_length_1070_cov_8.963955	873	953	126	4	80	0.0500000
NODE_5429_length_1070_cov_8.963955	873	953	130	5	80	0.0625000
NODE_5429_length_1070_cov_8.963955	873	953	136	6	80	0.0750000
NODE_5429_length_1070_cov_8.963955	873	953	138	2	80	0.0250000
NODE_5429_length_1070_cov_8.963955	873	953	140	1	80	0.0125000
NODE_5429_length_1070_cov_8.963955	873	953	142	2	80	0.0250000
NODE_5429_length_1070_cov_8.963955	873	953	144	2	80	0.0250000
NODE_5429_length_1070_cov_8.963955	873	953	147	1	80	0.0125000
NODE_5429_length_1070_cov_8.963955	873	953	148	15	80	0.1875000
NODE_5433_length_1070_cov_1.659114	1027	1046	2	19	19	1.0000000
NODE_5439_length_1069_cov_40.277320	451	531	0	30	80	0.3750000
NODE_5439_length_1069_cov_40.277320	451	531	13	50	80	0.6250000
NODE_5439_length_1069_cov_40.277320	504	584	12	32	80	0.4000000
NODE_5439_length_1069_cov_40.277320	504	584	13	41	80	0.5125000
NODE_5439_length_1069_cov_40.277320	504	584	14	7	80	0.0875000
NODE_5440_length_1069_cov_23.571134	274	354	0	80	80	1.0000000
NODE_5440_length_1069_cov_23.571134	327	407	0	80	80	1.0000000
NODE_5441_length_1069_cov_22.436082	185	265	2	14	80	0.1750000
NODE_5441_length_1069_cov_22.436082	185	265	4	36	80	0.4500000
NODE_5441_length_1069_cov_22.436082	185	265	6	30	80	0.3750000
NODE_5441_length_1069_cov_22.436082	238	318	0	35	80	0.4375000
NODE_5441_length_1069_cov_22.436082	238	318	4	45	80	0.5625000
NODE_5442_length_1069_cov_18.207216	436	516	0	44	80	0.5500000
NODE_5442_length_1069_cov_18.207216	436	516	6	36	80	0.4500000
NODE_5442_length_1069_cov_18.207216	489	569	6	80	80	1.0000000
NODE_5443_length_1069_cov_17.601031	596	676	0	1	80	0.0125000
NODE_5443_length_1069_cov_17.601031	596	676	2	79	80	0.9875000
NODE_5443_length_1069_cov_17.601031	649	729	0	36	80	0.4500000
NODE_5443_length_1069_cov_17.601031	649	729	2	44	80	0.5500000
NODE_5444_length_1069_cov_16.318557	353	433	4	80	80	1.0000000
NODE_5444_length_1069_cov_16.318557	406	486	0	29	80	0.3625000
NODE_5444_length_1069_cov_16.318557	406	486	4	51	80	0.6375000
NODE_5444_length_1069_cov_16.318557	482	562	0	80	80	1.0000000
NODE_5444_length_1069_cov_16.318557	535	615	0	80	80	1.0000000
NODE_5445_length_1069_cov_13.349485	471	551	0	19	80	0.2375000
NODE_5445_length_1069_cov_13.349485	471	551	2	26	80	0.3250000
NODE_5445_length_1069_cov_13.349485	471	551	4	35	80	0.4375000
NODE_5445_length_1069_cov_13.349485	524	604	0	4	80	0.0500000
NODE_5445_length_1069_cov_13.349485	524	604	2	22	80	0.2750000
NODE_5445_length_1069_cov_13.349485	524	604	4	54	80	0.6750000
NODE_5446_length_1069_cov_13.050515	314	394	1	33	80	0.4125000
NODE_5446_length_1069_cov_13.050515	314	394	3	32	80	0.4000000
NODE_5446_length_1069_cov_13.050515	314	394	4	15	80	0.1875000
NODE_5446_length_1069_cov_13.050515	367	447	0	27	80	0.3375000
NODE_5446_length_1069_cov_13.050515	367	447	1	53	80	0.6625000
NODE_5447_length_1069_cov_12.818557	240	320	0	80	80	1.0000000
NODE_5447_length_1069_cov_12.818557	293	373	0	80	80	1.0000000
NODE_5448_length_1069_cov_11.985567	554	634	0	15	80	0.1875000
NODE_5448_length_1069_cov_11.985567	554	634	2	65	80	0.8125000
NODE_5448_length_1069_cov_11.985567	607	687	0	42	80	0.5250000
NODE_5448_length_1069_cov_11.985567	607	687	2	38	80	0.4750000
NODE_5449_length_1069_cov_10.812371	366	446	0	46	80	0.5750000
NODE_5449_length_1069_cov_10.812371	366	446	2	34	80	0.4250000
NODE_5449_length_1069_cov_10.812371	419	499	0	80	80	1.0000000
NODE_5450_length_1069_cov_7.729897	482	562	0	80	80	1.0000000
NODE_5450_length_1069_cov_7.729897	535	615	0	80	80	1.0000000
NODE_5456_length_1068_cov_31.692466	314	394	1	80	80	1.0000000
NODE_5456_length_1068_cov_31.692466	367	447	0	9	80	0.1125000
NODE_5456_length_1068_cov_31.692466	367	447	1	71	80	0.8875000
NODE_5456_length_1068_cov_31.692466	443	523	0	80	80	1.0000000
NODE_5456_length_1068_cov_31.692466	496	576	0	80	80	1.0000000
NODE_5457_length_1068_cov_29.579979	347	427	0	80	80	1.0000000
NODE_5457_length_1068_cov_29.579979	400	480	0	80	80	1.0000000
NODE_5459_length_1068_cov_23.020640	476	556	0	3	80	0.0375000
NODE_5459_length_1068_cov_23.020640	476	556	2	64	80	0.8000000
NODE_5459_length_1068_cov_23.020640	476	556	4	6	80	0.0750000
NODE_5459_length_1068_cov_23.020640	476	556	6	7	80	0.0875000
NODE_5459_length_1068_cov_23.020640	529	609	2	14	80	0.1750000
NODE_5459_length_1068_cov_23.020640	529	609	4	9	80	0.1125000
NODE_5459_length_1068_cov_23.020640	529	609	6	57	80	0.7125000
NODE_5460_length_1068_cov_15.272446	546	626	0	72	80	0.9000000
NODE_5460_length_1068_cov_15.272446	546	626	4	8	80	0.1000000
NODE_5460_length_1068_cov_15.272446	599	679	0	19	80	0.2375000
NODE_5460_length_1068_cov_15.272446	599	679	4	61	80	0.7625000
NODE_5461_length_1068_cov_13.557276	674	754	0	57	80	0.7125000
NODE_5461_length_1068_cov_13.557276	674	754	2	23	80	0.2875000
NODE_5461_length_1068_cov_13.557276	727	807	0	4	80	0.0500000
NODE_5461_length_1068_cov_13.557276	727	807	2	76	80	0.9500000
NODE_5479_length_1067_cov_48.282025	429	509	0	27	80	0.3375000
NODE_5479_length_1067_cov_48.282025	429	509	4	53	80	0.6625000
NODE_5479_length_1067_cov_48.282025	482	562	0	76	80	0.9500000
NODE_5479_length_1067_cov_48.282025	482	562	4	4	80	0.0500000
NODE_5480_length_1067_cov_41.111570	460	540	0	36	80	0.4500000
NODE_5480_length_1067_cov_41.111570	460	540	2	44	80	0.5500000
NODE_5480_length_1067_cov_41.111570	513	593	2	38	80	0.4750000
NODE_5480_length_1067_cov_41.111570	513	593	4	4	80	0.0500000
NODE_5480_length_1067_cov_41.111570	513	593	6	38	80	0.4750000
NODE_5481_length_1067_cov_39.109504	295	375	0	71	80	0.8875000
NODE_5481_length_1067_cov_39.109504	295	375	4	9	80	0.1125000
NODE_5481_length_1067_cov_39.109504	348	428	0	18	80	0.2250000
NODE_5481_length_1067_cov_39.109504	348	428	4	62	80	0.7750000
NODE_5481_length_1067_cov_39.109504	424	504	4	25	80	0.3125000
NODE_5481_length_1067_cov_39.109504	424	504	6	40	80	0.5000000
NODE_5481_length_1067_cov_39.109504	424	504	8	7	80	0.0875000
NODE_5481_length_1067_cov_39.109504	424	504	9	8	80	0.1000000
NODE_5481_length_1067_cov_39.109504	477	557	4	4	80	0.0500000
NODE_5481_length_1067_cov_39.109504	477	557	5	8	80	0.1000000
NODE_5481_length_1067_cov_39.109504	477	557	6	19	80	0.2375000
NODE_5481_length_1067_cov_39.109504	477	557	7	24	80	0.3000000
NODE_5481_length_1067_cov_39.109504	477	557	8	7	80	0.0875000
NODE_5481_length_1067_cov_39.109504	477	557	9	12	80	0.1500000
NODE_5481_length_1067_cov_39.109504	477	557	11	6	80	0.0750000
NODE_5482_length_1067_cov_35.426653	252	332	0	3	80	0.0375000
NODE_5482_length_1067_cov_35.426653	252	332	2	77	80	0.9625000
NODE_5482_length_1067_cov_35.426653	305	385	0	32	80	0.4000000
NODE_5482_length_1067_cov_35.426653	305	385	2	48	80	0.6000000
NODE_5483_length_1067_cov_29.467975	412	492	0	26	80	0.3250000
NODE_5483_length_1067_cov_29.467975	412	492	2	3	80	0.0375000
NODE_5483_length_1067_cov_29.467975	412	492	4	5	80	0.0625000
NODE_5483_length_1067_cov_29.467975	412	492	6	46	80	0.5750000
NODE_5483_length_1067_cov_29.467975	465	545	2	3	80	0.0375000
NODE_5483_length_1067_cov_29.467975	465	545	4	29	80	0.3625000
NODE_5483_length_1067_cov_29.467975	465	545	6	48	80	0.6000000
NODE_5484_length_1067_cov_20.738636	579	645	22	5	66	0.0757576
NODE_5484_length_1067_cov_20.738636	579	645	26	7	66	0.1060606
NODE_5484_length_1067_cov_20.738636	579	645	28	12	66	0.1818182
NODE_5484_length_1067_cov_20.738636	579	645	30	4	66	0.0606061
NODE_5484_length_1067_cov_20.738636	579	645	32	4	66	0.0606061
NODE_5484_length_1067_cov_20.738636	579	645	38	1	66	0.0151515
NODE_5484_length_1067_cov_20.738636	579	645	40	2	66	0.0303030
NODE_5484_length_1067_cov_20.738636	579	645	42	20	66	0.3030303
NODE_5484_length_1067_cov_20.738636	579	645	44	6	66	0.0909091
NODE_5484_length_1067_cov_20.738636	579	645	46	4	66	0.0606061
NODE_5484_length_1067_cov_20.738636	579	645	48	1	66	0.0151515
NODE_5484_length_1067_cov_20.738636	618	698	42	16	80	0.2000000
NODE_5484_length_1067_cov_20.738636	618	698	44	6	80	0.0750000
NODE_5484_length_1067_cov_20.738636	618	698	46	4	80	0.0500000
NODE_5484_length_1067_cov_20.738636	618	698	48	2	80	0.0250000
NODE_5484_length_1067_cov_20.738636	618	698	49	5	80	0.0625000
NODE_5484_length_1067_cov_20.738636	618	698	50	19	80	0.2375000
NODE_5484_length_1067_cov_20.738636	618	698	51	10	80	0.1250000
NODE_5484_length_1067_cov_20.738636	618	698	52	8	80	0.1000000
NODE_5484_length_1067_cov_20.738636	618	698	53	5	80	0.0625000
NODE_5484_length_1067_cov_20.738636	618	698	54	2	80	0.0250000
NODE_5484_length_1067_cov_20.738636	618	698	55	3	80	0.0375000
NODE_5485_length_1067_cov_15.280992	538	617	0	79	79	1.0000000
NODE_5485_length_1067_cov_15.280992	590	670	0	80	80	1.0000000
NODE_5486_length_1067_cov_13.708678	478	558	8	80	80	1.0000000
NODE_5486_length_1067_cov_13.708678	531	611	0	53	80	0.6625000
NODE_5486_length_1067_cov_13.708678	531	611	8	27	80	0.3375000
NODE_5488_length_1067_cov_9.070248	625	705	0	80	80	1.0000000
NODE_5488_length_1067_cov_9.070248	678	758	0	80	80	1.0000000
NODE_5494_length_1067_cov_1.946281	765	812	0	47	47	1.0000000
NODE_5501_length_1066_cov_54.227508	395	475	4	7	80	0.0875000
NODE_5501_length_1066_cov_54.227508	395	475	12	6	80	0.0750000
NODE_5501_length_1066_cov_54.227508	395	475	16	2	80	0.0250000
NODE_5501_length_1066_cov_54.227508	395	475	20	1	80	0.0125000
NODE_5501_length_1066_cov_54.227508	395	475	26	26	80	0.3250000
NODE_5501_length_1066_cov_54.227508	395	475	27	26	80	0.3250000
NODE_5501_length_1066_cov_54.227508	395	475	28	12	80	0.1500000
NODE_5501_length_1066_cov_54.227508	448	528	6	7	80	0.0875000
NODE_5501_length_1066_cov_54.227508	448	528	10	13	80	0.1625000
NODE_5501_length_1066_cov_54.227508	448	528	12	2	80	0.0250000
NODE_5501_length_1066_cov_54.227508	448	528	20	16	80	0.2000000
NODE_5501_length_1066_cov_54.227508	448	528	26	32	80	0.4000000
NODE_5501_length_1066_cov_54.227508	448	528	27	10	80	0.1250000
NODE_5502_length_1066_cov_33.501551	357	437	0	20	80	0.2500000
NODE_5502_length_1066_cov_33.501551	357	437	8	3	80	0.0375000
NODE_5502_length_1066_cov_33.501551	357	437	10	7	80	0.0875000
NODE_5502_length_1066_cov_33.501551	357	437	12	7	80	0.0875000
NODE_5502_length_1066_cov_33.501551	357	437	14	5	80	0.0625000
NODE_5502_length_1066_cov_33.501551	357	437	16	1	80	0.0125000
NODE_5502_length_1066_cov_33.501551	357	437	29	1	80	0.0125000
NODE_5502_length_1066_cov_33.501551	357	437	31	1	80	0.0125000
NODE_5502_length_1066_cov_33.501551	357	437	32	4	80	0.0500000
NODE_5502_length_1066_cov_33.501551	357	437	33	7	80	0.0875000
NODE_5502_length_1066_cov_33.501551	357	437	34	24	80	0.3000000
NODE_5502_length_1066_cov_33.501551	410	490	32	5	80	0.0625000
NODE_5502_length_1066_cov_33.501551	410	490	33	4	80	0.0500000
NODE_5502_length_1066_cov_33.501551	410	490	34	34	80	0.4250000
NODE_5502_length_1066_cov_33.501551	410	490	35	37	80	0.4625000
NODE_5503_length_1066_cov_33.115822	397	477	0	5	80	0.0625000
NODE_5503_length_1066_cov_33.115822	397	477	6	75	80	0.9375000
NODE_5503_length_1066_cov_33.115822	450	530	0	58	80	0.7250000
NODE_5503_length_1066_cov_33.115822	450	530	6	22	80	0.2750000
NODE_5504_length_1066_cov_26.517063	215	285	86	5	70	0.0714286
NODE_5504_length_1066_cov_26.517063	215	285	87	1	70	0.0142857
NODE_5504_length_1066_cov_26.517063	215	285	88	1	70	0.0142857
NODE_5504_length_1066_cov_26.517063	215	285	90	5	70	0.0714286
NODE_5504_length_1066_cov_26.517063	215	285	91	1	70	0.0142857
NODE_5504_length_1066_cov_26.517063	215	285	92	1	70	0.0142857
NODE_5504_length_1066_cov_26.517063	215	285	93	1	70	0.0142857
NODE_5504_length_1066_cov_26.517063	215	285	95	1	70	0.0142857
NODE_5504_length_1066_cov_26.517063	215	285	97	1	70	0.0142857
NODE_5504_length_1066_cov_26.517063	215	285	99	2	70	0.0285714
NODE_5504_length_1066_cov_26.517063	215	285	101	2	70	0.0285714
NODE_5504_length_1066_cov_26.517063	215	285	103	6	70	0.0857143
NODE_5504_length_1066_cov_26.517063	215	285	104	1	70	0.0142857
NODE_5504_length_1066_cov_26.517063	215	285	105	5	70	0.0714286
NODE_5504_length_1066_cov_26.517063	215	285	106	1	70	0.0142857
NODE_5504_length_1066_cov_26.517063	215	285	107	1	70	0.0142857
NODE_5504_length_1066_cov_26.517063	215	285	111	1	70	0.0142857
NODE_5504_length_1066_cov_26.517063	215	285	112	1	70	0.0142857
NODE_5504_length_1066_cov_26.517063	215	285	115	1	70	0.0142857
NODE_5504_length_1066_cov_26.517063	215	285	119	1	70	0.0142857
NODE_5504_length_1066_cov_26.517063	215	285	122	1	70	0.0142857
NODE_5504_length_1066_cov_26.517063	215	285	124	1	70	0.0142857
NODE_5504_length_1066_cov_26.517063	215	285	134	1	70	0.0142857
NODE_5504_length_1066_cov_26.517063	215	285	135	2	70	0.0285714
NODE_5504_length_1066_cov_26.517063	215	285	138	1	70	0.0142857
NODE_5504_length_1066_cov_26.517063	215	285	146	1	70	0.0142857
NODE_5504_length_1066_cov_26.517063	215	285	149	3	70	0.0428571
NODE_5504_length_1066_cov_26.517063	215	285	153	1	70	0.0142857
NODE_5504_length_1066_cov_26.517063	215	285	155	2	70	0.0285714
NODE_5504_length_1066_cov_26.517063	215	285	157	4	70	0.0571429
NODE_5504_length_1066_cov_26.517063	215	285	161	1	70	0.0142857
NODE_5504_length_1066_cov_26.517063	215	285	163	1	70	0.0142857
NODE_5504_length_1066_cov_26.517063	215	285	166	1	70	0.0142857
NODE_5504_length_1066_cov_26.517063	215	285	171	1	70	0.0142857
NODE_5504_length_1066_cov_26.517063	215	285	176	2	70	0.0285714
NODE_5504_length_1066_cov_26.517063	215	285	177	1	70	0.0142857
NODE_5504_length_1066_cov_26.517063	215	285	181	1	70	0.0142857
NODE_5504_length_1066_cov_26.517063	215	285	183	2	70	0.0285714
NODE_5504_length_1066_cov_26.517063	215	285	185	1	70	0.0142857
NODE_5504_length_1066_cov_26.517063	215	285	187	2	70	0.0285714
NODE_5504_length_1066_cov_26.517063	215	285	197	1	70	0.0142857
NODE_5505_length_1066_cov_16.906929	526	606	9	24	80	0.3000000
NODE_5505_length_1066_cov_16.906929	526	606	11	56	80	0.7000000
NODE_5505_length_1066_cov_16.906929	579	659	0	11	80	0.1375000
NODE_5505_length_1066_cov_16.906929	579	659	9	45	80	0.5625000
NODE_5505_length_1066_cov_16.906929	579	659	11	24	80	0.3000000
NODE_5506_length_1066_cov_16.190279	298	378	0	80	80	1.0000000
NODE_5506_length_1066_cov_16.190279	351	432	0	81	81	1.0000000
NODE_5507_length_1066_cov_15.444674	582	662	0	34	80	0.4250000
NODE_5507_length_1066_cov_15.444674	582	662	2	14	80	0.1750000
NODE_5507_length_1066_cov_15.444674	582	662	4	1	80	0.0125000
NODE_5507_length_1066_cov_15.444674	582	662	5	4	80	0.0500000
NODE_5507_length_1066_cov_15.444674	582	662	7	23	80	0.2875000
NODE_5507_length_1066_cov_15.444674	582	662	10	4	80	0.0500000
NODE_5507_length_1066_cov_15.444674	635	715	0	80	80	1.0000000
NODE_5516_length_1065_cov_51.693582	480	560	0	80	80	1.0000000
NODE_5516_length_1065_cov_51.693582	533	613	0	80	80	1.0000000
NODE_5517_length_1065_cov_33.428571	422	502	0	57	80	0.7125000
NODE_5517_length_1065_cov_33.428571	422	502	8	1	80	0.0125000
NODE_5517_length_1065_cov_33.428571	422	502	9	22	80	0.2750000
NODE_5517_length_1065_cov_33.428571	422	502	0	57	80	0.7125000
NODE_5517_length_1065_cov_33.428571	422	502	8	1	80	0.0125000
NODE_5517_length_1065_cov_33.428571	422	502	9	22	80	0.2750000
NODE_5517_length_1065_cov_33.428571	422	502	0	57	80	0.7125000
NODE_5517_length_1065_cov_33.428571	422	502	8	1	80	0.0125000
NODE_5517_length_1065_cov_33.428571	422	502	9	22	80	0.2750000
NODE_5517_length_1065_cov_33.428571	475	555	0	4	80	0.0500000
NODE_5517_length_1065_cov_33.428571	475	555	8	1	80	0.0125000
NODE_5517_length_1065_cov_33.428571	475	555	9	75	80	0.9375000
NODE_5517_length_1065_cov_33.428571	475	555	0	4	80	0.0500000
NODE_5517_length_1065_cov_33.428571	475	555	8	1	80	0.0125000
NODE_5517_length_1065_cov_33.428571	475	555	9	75	80	0.9375000
NODE_5517_length_1065_cov_33.428571	551	631	9	8	80	0.1000000
NODE_5517_length_1065_cov_33.428571	551	631	16	2	80	0.0250000
NODE_5517_length_1065_cov_33.428571	551	631	17	10	80	0.1250000
NODE_5517_length_1065_cov_33.428571	551	631	19	58	80	0.7250000
NODE_5517_length_1065_cov_33.428571	551	631	20	2	80	0.0250000
NODE_5517_length_1065_cov_33.428571	551	631	9	8	80	0.1000000
NODE_5517_length_1065_cov_33.428571	551	631	16	2	80	0.0250000
NODE_5517_length_1065_cov_33.428571	551	631	17	10	80	0.1250000
NODE_5517_length_1065_cov_33.428571	551	631	19	58	80	0.7250000
NODE_5517_length_1065_cov_33.428571	551	631	20	2	80	0.0250000
NODE_5517_length_1065_cov_33.428571	551	572	9	6	21	0.2857143
NODE_5517_length_1065_cov_33.428571	551	572	16	1	21	0.0476190
NODE_5517_length_1065_cov_33.428571	551	572	17	7	21	0.3333333
NODE_5517_length_1065_cov_33.428571	551	572	19	7	21	0.3333333
NODE_5517_length_1065_cov_33.428571	604	666	9	33	62	0.5322581
NODE_5517_length_1065_cov_33.428571	604	666	15	4	62	0.0645161
NODE_5517_length_1065_cov_33.428571	604	666	16	1	62	0.0161290
NODE_5517_length_1065_cov_33.428571	604	666	17	3	62	0.0483871
NODE_5517_length_1065_cov_33.428571	604	666	19	19	62	0.3064516
NODE_5517_length_1065_cov_33.428571	604	666	20	2	62	0.0322581
NODE_5517_length_1065_cov_33.428571	604	684	9	33	80	0.4125000
NODE_5517_length_1065_cov_33.428571	604	684	15	6	80	0.0750000
NODE_5517_length_1065_cov_33.428571	604	684	16	1	80	0.0125000
NODE_5517_length_1065_cov_33.428571	604	684	17	19	80	0.2375000
NODE_5517_length_1065_cov_33.428571	604	684	19	19	80	0.2375000
NODE_5517_length_1065_cov_33.428571	604	684	20	2	80	0.0250000
NODE_5518_length_1065_cov_31.874741	255	335	0	39	80	0.4875000
NODE_5518_length_1065_cov_31.874741	255	335	3	1	80	0.0125000
NODE_5518_length_1065_cov_31.874741	255	335	4	32	80	0.4000000
NODE_5518_length_1065_cov_31.874741	255	335	6	8	80	0.1000000
NODE_5518_length_1065_cov_31.874741	308	388	4	19	80	0.2375000
NODE_5518_length_1065_cov_31.874741	308	388	5	1	80	0.0125000
NODE_5518_length_1065_cov_31.874741	308	388	6	60	80	0.7500000
NODE_5519_length_1065_cov_21.762940	234	314	0	71	80	0.8875000
NODE_5519_length_1065_cov_21.762940	234	314	2	9	80	0.1125000
NODE_5519_length_1065_cov_21.762940	287	367	0	80	80	1.0000000
NODE_5520_length_1065_cov_19.947205	447	527	0	80	80	1.0000000
NODE_5520_length_1065_cov_19.947205	500	580	0	80	80	1.0000000
NODE_5521_length_1065_cov_14.590062	343	423	4	55	80	0.6875000
NODE_5521_length_1065_cov_14.590062	343	423	8	25	80	0.3125000
NODE_5521_length_1065_cov_14.590062	396	476	0	31	80	0.3875000
NODE_5521_length_1065_cov_14.590062	396	476	2	7	80	0.0875000
NODE_5521_length_1065_cov_14.590062	396	476	4	42	80	0.5250000
NODE_5522_length_1065_cov_13.232919	243	323	4	80	80	1.0000000
NODE_5522_length_1065_cov_13.232919	296	376	0	17	80	0.2125000
NODE_5522_length_1065_cov_13.232919	296	376	2	5	80	0.0625000
NODE_5522_length_1065_cov_13.232919	296	376	4	58	80	0.7250000
NODE_5523_length_1065_cov_10.670807	481	561	0	80	80	1.0000000
NODE_5523_length_1065_cov_10.670807	534	614	0	80	80	1.0000000
NODE_5524_length_1065_cov_10.473085	496	576	0	80	80	1.0000000
NODE_5524_length_1065_cov_10.473085	549	629	0	80	80	1.0000000
NODE_5525_length_1065_cov_9.711180	286	360	0	74	74	1.0000000
NODE_5525_length_1065_cov_9.711180	339	419	0	80	80	1.0000000
NODE_5534_length_1064_cov_59.929534	457	537	0	23	80	0.2875000
NODE_5534_length_1064_cov_59.929534	457	537	2	57	80	0.7125000
NODE_5534_length_1064_cov_59.929534	510	590	0	33	80	0.4125000
NODE_5534_length_1064_cov_59.929534	510	590	2	47	80	0.5875000
NODE_5534_length_1064_cov_59.929534	586	666	0	73	80	0.9125000
NODE_5534_length_1064_cov_59.929534	586	666	4	7	80	0.0875000
NODE_5534_length_1064_cov_59.929534	639	719	0	20	80	0.2500000
NODE_5534_length_1064_cov_59.929534	639	719	4	60	80	0.7500000
NODE_5535_length_1064_cov_36.480829	367	447	0	80	80	1.0000000
NODE_5535_length_1064_cov_36.480829	420	500	0	80	80	1.0000000
NODE_5535_length_1064_cov_36.480829	496	576	0	80	80	1.0000000
NODE_5535_length_1064_cov_36.480829	549	629	0	80	80	1.0000000
NODE_5536_length_1064_cov_32.307772	547	627	0	36	80	0.4500000
NODE_5536_length_1064_cov_32.307772	547	627	13	1	80	0.0125000
NODE_5536_length_1064_cov_32.307772	547	627	14	1	80	0.0125000
NODE_5536_length_1064_cov_32.307772	547	627	15	1	80	0.0125000
NODE_5536_length_1064_cov_32.307772	547	627	16	41	80	0.5125000
NODE_5536_length_1064_cov_32.307772	600	680	16	36	80	0.4500000
NODE_5536_length_1064_cov_32.307772	600	680	18	44	80	0.5500000
NODE_5537_length_1064_cov_25.255959	462	542	0	80	80	1.0000000
NODE_5537_length_1064_cov_25.255959	515	595	0	80	80	1.0000000
NODE_5537_length_1064_cov_25.255959	591	671	0	80	80	1.0000000
NODE_5537_length_1064_cov_25.255959	644	724	0	80	80	1.0000000
NODE_5538_length_1064_cov_23.053886	343	423	0	19	80	0.2375000
NODE_5538_length_1064_cov_23.053886	343	423	4	61	80	0.7625000
NODE_5538_length_1064_cov_23.053886	396	476	4	80	80	1.0000000
NODE_5538_length_1064_cov_23.053886	472	552	0	71	80	0.8875000
NODE_5538_length_1064_cov_23.053886	472	552	4	9	80	0.1125000
NODE_5538_length_1064_cov_23.053886	525	605	0	80	80	1.0000000
NODE_5539_length_1064_cov_22.018653	479	559	0	7	80	0.0875000
NODE_5539_length_1064_cov_22.018653	479	559	2	45	80	0.5625000
NODE_5539_length_1064_cov_22.018653	479	559	4	28	80	0.3500000
NODE_5539_length_1064_cov_22.018653	532	612	4	37	80	0.4625000
NODE_5539_length_1064_cov_22.018653	532	612	6	13	80	0.1625000
NODE_5539_length_1064_cov_22.018653	532	612	7	17	80	0.2125000
NODE_5539_length_1064_cov_22.018653	532	612	8	13	80	0.1625000
NODE_5540_length_1064_cov_12.868394	424	504	0	80	80	1.0000000
NODE_5540_length_1064_cov_12.868394	477	557	0	80	80	1.0000000
NODE_5541_length_1064_cov_10.098446	467	547	0	61	80	0.7625000
NODE_5541_length_1064_cov_10.098446	467	547	2	19	80	0.2375000
NODE_5541_length_1064_cov_10.098446	520	600	0	8	80	0.1000000
NODE_5541_length_1064_cov_10.098446	520	600	2	72	80	0.9000000
NODE_5543_length_1064_cov_2.925389	173	245	2	25	72	0.3472222
NODE_5543_length_1064_cov_2.925389	173	245	3	10	72	0.1388889
NODE_5543_length_1064_cov_2.925389	173	245	4	6	72	0.0833333
NODE_5543_length_1064_cov_2.925389	173	245	5	6	72	0.0833333
NODE_5543_length_1064_cov_2.925389	173	245	7	3	72	0.0416667
NODE_5543_length_1064_cov_2.925389	173	245	9	2	72	0.0277778
NODE_5543_length_1064_cov_2.925389	173	245	11	3	72	0.0416667
NODE_5543_length_1064_cov_2.925389	173	245	12	7	72	0.0972222
NODE_5543_length_1064_cov_2.925389	173	245	14	7	72	0.0972222
NODE_5543_length_1064_cov_2.925389	173	245	16	3	72	0.0416667
NODE_5551_length_1063_cov_104.615145	504	584	0	75	80	0.9375000
NODE_5551_length_1063_cov_104.615145	504	584	4	5	80	0.0625000
NODE_5551_length_1063_cov_104.615145	557	637	0	22	80	0.2750000
NODE_5551_length_1063_cov_104.615145	557	637	4	16	80	0.2000000
NODE_5551_length_1063_cov_104.615145	557	637	8	25	80	0.3125000
NODE_5551_length_1063_cov_104.615145	557	637	10	8	80	0.1000000
NODE_5551_length_1063_cov_104.615145	557	637	12	9	80	0.1125000
NODE_5552_length_1063_cov_36.515560	482	562	0	25	80	0.3125000
NODE_5552_length_1063_cov_36.515560	482	562	2	55	80	0.6875000
NODE_5552_length_1063_cov_36.515560	535	615	0	78	80	0.9750000
NODE_5552_length_1063_cov_36.515560	535	615	2	2	80	0.0250000
NODE_5552_length_1063_cov_36.515560	611	691	0	77	80	0.9625000
NODE_5552_length_1063_cov_36.515560	611	691	1	1	80	0.0125000
NODE_5552_length_1063_cov_36.515560	611	691	4	2	80	0.0250000
NODE_5552_length_1063_cov_36.515560	664	744	0	24	80	0.3000000
NODE_5552_length_1063_cov_36.515560	664	744	1	1	80	0.0125000
NODE_5552_length_1063_cov_36.515560	664	744	4	55	80	0.6875000
NODE_5553_length_1063_cov_30.700207	470	550	0	80	80	1.0000000
NODE_5553_length_1063_cov_30.700207	523	603	0	80	80	1.0000000
NODE_5553_length_1063_cov_30.700207	599	679	0	38	80	0.4750000
NODE_5553_length_1063_cov_30.700207	599	679	2	10	80	0.1250000
NODE_5553_length_1063_cov_30.700207	599	679	9	1	80	0.0125000
NODE_5553_length_1063_cov_30.700207	599	679	10	31	80	0.3875000
NODE_5553_length_1063_cov_30.700207	652	732	8	29	80	0.3625000
NODE_5553_length_1063_cov_30.700207	652	732	10	51	80	0.6375000
NODE_5554_length_1063_cov_24.552905	362	442	0	12	80	0.1500000
NODE_5554_length_1063_cov_24.552905	362	442	2	68	80	0.8500000
NODE_5554_length_1063_cov_24.552905	415	495	0	16	80	0.2000000
NODE_5554_length_1063_cov_24.552905	415	495	2	15	80	0.1875000
NODE_5554_length_1063_cov_24.552905	415	495	6	49	80	0.6125000
NODE_5555_length_1063_cov_21.985477	407	487	0	80	80	1.0000000
NODE_5555_length_1063_cov_21.985477	460	540	0	61	80	0.7625000
NODE_5555_length_1063_cov_21.985477	460	540	2	19	80	0.2375000
NODE_5555_length_1063_cov_21.985477	536	616	2	80	80	1.0000000
NODE_5555_length_1063_cov_21.985477	589	670	0	29	81	0.3580247
NODE_5555_length_1063_cov_21.985477	589	670	1	4	81	0.0493827
NODE_5555_length_1063_cov_21.985477	589	670	2	48	81	0.5925926
NODE_5557_length_1063_cov_15.400415	685	765	0	80	80	1.0000000
NODE_5557_length_1063_cov_15.400415	738	818	0	80	80	1.0000000
NODE_5558_length_1063_cov_13.282158	510	590	0	80	80	1.0000000
NODE_5558_length_1063_cov_13.282158	563	643	0	80	80	1.0000000
NODE_5559_length_1063_cov_12.970954	417	495	0	78	78	1.0000000
NODE_5559_length_1063_cov_12.970954	468	548	0	80	80	1.0000000
NODE_5560_length_1063_cov_7.917012	639	719	0	53	80	0.6625000
NODE_5560_length_1063_cov_7.917012	639	719	3	12	80	0.1500000
NODE_5560_length_1063_cov_7.917012	639	719	4	15	80	0.1875000
NODE_5560_length_1063_cov_7.917012	692	772	0	80	80	1.0000000
NODE_5569_length_1063_cov_1.695021	893	947	4	1	54	0.0185185
NODE_5569_length_1063_cov_1.695021	893	947	6	9	54	0.1666667
NODE_5569_length_1063_cov_1.695021	893	947	14	5	54	0.0925926
NODE_5569_length_1063_cov_1.695021	893	947	18	16	54	0.2962963
NODE_5569_length_1063_cov_1.695021	893	947	20	23	54	0.4259259
NODE_5574_length_1062_cov_43.399792	272	352	0	19	80	0.2375000
NODE_5574_length_1062_cov_43.399792	272	352	2	61	80	0.7625000
NODE_5574_length_1062_cov_43.399792	325	405	0	49	80	0.6125000
NODE_5574_length_1062_cov_43.399792	325	405	2	31	80	0.3875000
NODE_5576_length_1062_cov_19.778816	401	481	0	37	80	0.4625000
NODE_5576_length_1062_cov_19.778816	401	481	4	43	80	0.5375000
NODE_5576_length_1062_cov_19.778816	454	534	4	80	80	1.0000000
NODE_5577_length_1062_cov_16.034268	628	708	0	80	80	1.0000000
NODE_5577_length_1062_cov_16.034268	681	761	0	80	80	1.0000000
NODE_5578_length_1062_cov_13.346833	623	703	0	80	80	1.0000000
NODE_5578_length_1062_cov_13.346833	676	756	0	80	80	1.0000000
NODE_5579_length_1062_cov_9.886812	670	750	0	80	80	1.0000000
NODE_5579_length_1062_cov_9.886812	723	803	0	80	80	1.0000000
NODE_5580_length_1062_cov_9.078920	525	604	2	54	79	0.6835443
NODE_5580_length_1062_cov_9.078920	525	604	6	25	79	0.3164557
NODE_5580_length_1062_cov_9.078920	577	657	2	2	80	0.0250000
NODE_5580_length_1062_cov_9.078920	577	657	6	70	80	0.8750000
NODE_5580_length_1062_cov_9.078920	577	657	8	8	80	0.1000000
NODE_5581_length_1062_cov_8.934579	203	283	0	80	80	1.0000000
NODE_5581_length_1062_cov_8.934579	256	336	0	80	80	1.0000000
NODE_5588_length_1061_cov_22.637214	418	498	0	80	80	1.0000000
NODE_5588_length_1061_cov_22.637214	471	551	0	80	80	1.0000000
NODE_5589_length_1061_cov_22.338877	479	559	0	58	80	0.7250000
NODE_5589_length_1061_cov_22.338877	479	559	2	22	80	0.2750000
NODE_5589_length_1061_cov_22.338877	532	612	0	5	80	0.0625000
NODE_5589_length_1061_cov_22.338877	532	612	2	75	80	0.9375000
NODE_5597_length_1060_cov_31.595213	394	473	0	79	79	1.0000000
NODE_5597_length_1060_cov_31.595213	446	526	0	80	80	1.0000000
NODE_5597_length_1060_cov_31.595213	522	602	0	80	80	1.0000000
NODE_5597_length_1060_cov_31.595213	575	655	0	80	80	1.0000000
NODE_5598_length_1060_cov_26.136316	486	566	0	3	80	0.0375000
NODE_5598_length_1060_cov_26.136316	486	566	18	77	80	0.9625000
NODE_5598_length_1060_cov_26.136316	539	619	18	80	80	1.0000000
NODE_5598_length_1060_cov_26.136316	615	695	0	63	80	0.7875000
NODE_5598_length_1060_cov_26.136316	615	695	17	1	80	0.0125000
NODE_5598_length_1060_cov_26.136316	615	695	18	16	80	0.2000000
NODE_5598_length_1060_cov_26.136316	668	748	0	80	80	1.0000000
NODE_5599_length_1060_cov_25.329865	370	450	3	1	80	0.0125000
NODE_5599_length_1060_cov_25.329865	370	450	4	55	80	0.6875000
NODE_5599_length_1060_cov_25.329865	370	450	6	6	80	0.0750000
NODE_5599_length_1060_cov_25.329865	370	450	8	18	80	0.2250000
NODE_5599_length_1060_cov_25.329865	423	503	2	18	80	0.2250000
NODE_5599_length_1060_cov_25.329865	423	503	4	36	80	0.4500000
NODE_5599_length_1060_cov_25.329865	423	503	6	6	80	0.0750000
NODE_5599_length_1060_cov_25.329865	423	503	8	20	80	0.2500000
NODE_5600_length_1060_cov_16.881374	539	611	0	41	72	0.5694444
NODE_5600_length_1060_cov_16.881374	539	611	2	31	72	0.4305556
NODE_5601_length_1060_cov_14.789802	406	486	0	80	80	1.0000000
NODE_5601_length_1060_cov_14.789802	459	539	0	80	80	1.0000000
NODE_5603_length_1060_cov_5.900104	517	597	0	80	80	1.0000000
NODE_5603_length_1060_cov_5.900104	570	650	0	80	80	1.0000000
NODE_5611_length_1059_cov_16.630208	412	492	0	80	80	1.0000000
NODE_5611_length_1059_cov_16.630208	465	552	0	87	87	1.0000000
NODE_5611_length_1059_cov_16.630208	548	628	0	80	80	1.0000000
NODE_5611_length_1059_cov_16.630208	601	681	0	80	80	1.0000000
NODE_5621_length_1058_cov_60.155370	395	475	2	80	80	1.0000000
NODE_5621_length_1058_cov_60.155370	448	528	0	38	80	0.4750000
NODE_5621_length_1058_cov_60.155370	448	528	2	42	80	0.5250000
NODE_5621_length_1058_cov_60.155370	524	604	0	74	80	0.9250000
NODE_5621_length_1058_cov_60.155370	524	604	2	6	80	0.0750000
NODE_5621_length_1058_cov_60.155370	577	657	0	21	80	0.2625000
NODE_5621_length_1058_cov_60.155370	577	657	2	59	80	0.7375000
NODE_5622_length_1058_cov_31.253389	475	555	7	13	80	0.1625000
NODE_5622_length_1058_cov_31.253389	475	555	13	31	80	0.3875000
NODE_5622_length_1058_cov_31.253389	475	555	14	13	80	0.1625000
NODE_5622_length_1058_cov_31.253389	475	555	15	23	80	0.2875000
NODE_5622_length_1058_cov_31.253389	475	555	7	13	80	0.1625000
NODE_5622_length_1058_cov_31.253389	475	555	13	31	80	0.3875000
NODE_5622_length_1058_cov_31.253389	475	555	14	13	80	0.1625000
NODE_5622_length_1058_cov_31.253389	475	555	15	23	80	0.2875000
NODE_5622_length_1058_cov_31.253389	528	608	2	15	80	0.1875000
NODE_5622_length_1058_cov_31.253389	528	608	6	7	80	0.0875000
NODE_5622_length_1058_cov_31.253389	528	608	7	7	80	0.0875000
NODE_5622_length_1058_cov_31.253389	528	608	8	9	80	0.1125000
NODE_5622_length_1058_cov_31.253389	528	608	13	24	80	0.3000000
NODE_5622_length_1058_cov_31.253389	528	608	14	13	80	0.1625000
NODE_5622_length_1058_cov_31.253389	528	608	15	5	80	0.0625000
NODE_5622_length_1058_cov_31.253389	533	608	2	15	75	0.2000000
NODE_5622_length_1058_cov_31.253389	533	608	6	7	75	0.0933333
NODE_5622_length_1058_cov_31.253389	533	608	7	7	75	0.0933333
NODE_5622_length_1058_cov_31.253389	533	608	8	9	75	0.1200000
NODE_5622_length_1058_cov_31.253389	533	608	13	24	75	0.3200000
NODE_5622_length_1058_cov_31.253389	533	608	14	13	75	0.1733333
NODE_5623_length_1058_cov_24.520334	264	344	0	80	80	1.0000000
NODE_5623_length_1058_cov_24.520334	317	397	0	80	80	1.0000000
NODE_5624_length_1058_cov_24.211679	297	377	0	26	80	0.3250000
NODE_5624_length_1058_cov_24.211679	297	377	4	54	80	0.6750000
NODE_5624_length_1058_cov_24.211679	350	430	4	80	80	1.0000000
NODE_5625_length_1058_cov_18.100104	454	534	0	46	80	0.5750000
NODE_5625_length_1058_cov_18.100104	454	534	8	7	80	0.0875000
NODE_5625_length_1058_cov_18.100104	454	534	10	27	80	0.3375000
NODE_5625_length_1058_cov_18.100104	507	587	10	32	80	0.4000000
NODE_5625_length_1058_cov_18.100104	507	587	14	48	80	0.6000000
NODE_5626_length_1058_cov_11.645464	476	556	0	6	80	0.0750000
NODE_5626_length_1058_cov_11.645464	476	556	2	74	80	0.9250000
NODE_5626_length_1058_cov_11.645464	529	609	0	49	80	0.6125000
NODE_5626_length_1058_cov_11.645464	529	609	2	31	80	0.3875000
NODE_5627_length_1058_cov_9.953076	621	712	0	69	91	0.7582418
NODE_5627_length_1058_cov_9.953076	621	712	1	22	91	0.2417582
NODE_5627_length_1058_cov_9.953076	685	765	0	80	80	1.0000000
NODE_5628_length_1058_cov_6.294056	819	899	0	67	80	0.8375000
NODE_5628_length_1058_cov_6.294056	819	899	2	13	80	0.1625000
NODE_5628_length_1058_cov_6.294056	875	952	0	11	77	0.1428571
NODE_5628_length_1058_cov_6.294056	875	952	2	66	77	0.8571429
NODE_5637_length_1057_cov_43.191023	413	493	0	66	80	0.8250000
NODE_5637_length_1057_cov_43.191023	413	493	2	14	80	0.1750000
NODE_5637_length_1057_cov_43.191023	466	546	0	80	80	1.0000000
NODE_5637_length_1057_cov_43.191023	542	622	0	80	80	1.0000000
NODE_5637_length_1057_cov_43.191023	595	675	0	64	80	0.8000000
NODE_5637_length_1057_cov_43.191023	595	675	2	16	80	0.2000000
NODE_5638_length_1057_cov_27.387265	486	566	4	13	80	0.1625000
NODE_5638_length_1057_cov_27.387265	486	566	8	67	80	0.8375000
NODE_5638_length_1057_cov_27.387265	539	619	0	21	80	0.2625000
NODE_5638_length_1057_cov_27.387265	539	619	4	3	80	0.0375000
NODE_5638_length_1057_cov_27.387265	539	619	8	56	80	0.7000000
NODE_5639_length_1057_cov_16.489562	416	496	0	63	80	0.7875000
NODE_5639_length_1057_cov_16.489562	416	496	2	17	80	0.2125000
NODE_5639_length_1057_cov_16.489562	469	549	0	10	80	0.1250000
NODE_5639_length_1057_cov_16.489562	469	549	2	70	80	0.8750000
NODE_5640_length_1057_cov_13.605428	631	711	0	80	80	1.0000000
NODE_5640_length_1057_cov_13.605428	684	764	0	80	80	1.0000000
NODE_5641_length_1057_cov_12.768267	518	598	0	80	80	1.0000000
NODE_5641_length_1057_cov_12.768267	571	651	0	80	80	1.0000000
NODE_5644_length_1057_cov_7.692067	706	786	0	29	80	0.3625000
NODE_5644_length_1057_cov_7.692067	706	786	2	51	80	0.6375000
NODE_5644_length_1057_cov_7.692067	759	839	0	13	80	0.1625000
NODE_5644_length_1057_cov_7.692067	759	839	2	67	80	0.8375000
NODE_5645_length_1057_cov_6.697286	561	641	0	80	80	1.0000000
NODE_5645_length_1057_cov_6.697286	614	694	0	80	80	1.0000000
NODE_5654_length_1056_cov_57.539185	462	542	2	53	80	0.6625000
NODE_5654_length_1056_cov_57.539185	462	542	4	27	80	0.3375000
NODE_5654_length_1056_cov_57.539185	515	595	0	2	80	0.0250000
NODE_5654_length_1056_cov_57.539185	515	595	2	78	80	0.9750000
NODE_5655_length_1056_cov_35.751306	421	501	0	2	80	0.0250000
NODE_5655_length_1056_cov_35.751306	421	501	5	42	80	0.5250000
NODE_5655_length_1056_cov_35.751306	421	501	6	36	80	0.4500000
NODE_5655_length_1056_cov_35.751306	474	554	0	48	80	0.6000000
NODE_5655_length_1056_cov_35.751306	474	554	6	32	80	0.4000000
NODE_5656_length_1056_cov_29.749216	415	490	2	20	75	0.2666667
NODE_5656_length_1056_cov_29.749216	415	490	6	45	75	0.6000000
NODE_5656_length_1056_cov_29.749216	415	490	8	10	75	0.1333333
NODE_5656_length_1056_cov_29.749216	416	495	2	19	79	0.2405063
NODE_5656_length_1056_cov_29.749216	416	495	6	50	79	0.6329114
NODE_5656_length_1056_cov_29.749216	416	495	8	10	79	0.1265823
NODE_5656_length_1056_cov_29.749216	448	495	6	47	47	1.0000000
NODE_5656_length_1056_cov_29.749216	468	548	0	41	80	0.5125000
NODE_5656_length_1056_cov_29.749216	468	548	5	1	80	0.0125000
NODE_5656_length_1056_cov_29.749216	468	548	6	38	80	0.4750000
NODE_5656_length_1056_cov_29.749216	468	548	0	41	80	0.5125000
NODE_5656_length_1056_cov_29.749216	468	548	5	1	80	0.0125000
NODE_5656_length_1056_cov_29.749216	468	548	6	38	80	0.4750000
NODE_5656_length_1056_cov_29.749216	468	548	0	41	80	0.5125000
NODE_5656_length_1056_cov_29.749216	468	548	5	1	80	0.0125000
NODE_5656_length_1056_cov_29.749216	468	548	6	38	80	0.4750000
NODE_5657_length_1056_cov_25.342738	297	377	0	80	80	1.0000000
NODE_5657_length_1056_cov_25.342738	350	430	0	80	80	1.0000000
NODE_5657_length_1056_cov_25.342738	426	506	0	80	80	1.0000000
NODE_5657_length_1056_cov_25.342738	479	559	0	80	80	1.0000000
NODE_5658_length_1056_cov_24.094044	535	615	5	1	80	0.0125000
NODE_5658_length_1056_cov_24.094044	535	615	7	79	80	0.9875000
NODE_5658_length_1056_cov_24.094044	588	668	0	12	80	0.1500000
NODE_5658_length_1056_cov_24.094044	588	668	2	24	80	0.3000000
NODE_5658_length_1056_cov_24.094044	588	668	7	44	80	0.5500000
NODE_5659_length_1056_cov_20.700104	570	650	0	80	80	1.0000000
NODE_5659_length_1056_cov_20.700104	623	703	0	80	80	1.0000000
NODE_5660_length_1056_cov_14.215256	349	429	0	80	80	1.0000000
NODE_5660_length_1056_cov_14.215256	402	482	0	80	80	1.0000000
NODE_5660_length_1056_cov_14.215256	478	558	0	80	80	1.0000000
NODE_5660_length_1056_cov_14.215256	531	611	0	80	80	1.0000000
NODE_5661_length_1056_cov_13.782654	563	643	2	80	80	1.0000000
NODE_5661_length_1056_cov_13.782654	616	696	0	31	80	0.3875000
NODE_5661_length_1056_cov_13.782654	616	696	2	49	80	0.6125000
NODE_5663_length_1056_cov_9.298851	373	453	2	33	80	0.4125000
NODE_5663_length_1056_cov_9.298851	373	453	5	22	80	0.2750000
NODE_5663_length_1056_cov_9.298851	373	453	6	11	80	0.1375000
NODE_5663_length_1056_cov_9.298851	373	453	8	14	80	0.1750000
NODE_5663_length_1056_cov_9.298851	426	503	0	33	77	0.4285714
NODE_5663_length_1056_cov_9.298851	426	503	2	44	77	0.5714286
NODE_5665_length_1056_cov_6.157785	396	476	0	80	80	1.0000000
NODE_5665_length_1056_cov_6.157785	449	529	0	80	80	1.0000000
NODE_5666_length_1056_cov_6.034483	287	367	0	80	80	1.0000000
NODE_5666_length_1056_cov_6.034483	340	420	0	80	80	1.0000000
NODE_5667_length_1056_cov_3.259143	371	410	0	38	39	0.9743590
NODE_5667_length_1056_cov_3.259143	371	410	2	1	39	0.0256410
NODE_5667_length_1056_cov_3.259143	424	463	2	7	39	0.1794872
NODE_5667_length_1056_cov_3.259143	424	463	4	32	39	0.8205128
NODE_5668_length_1056_cov_2.362591	234	314	0	74	80	0.9250000
NODE_5668_length_1056_cov_2.362591	234	314	2	6	80	0.0750000
NODE_5672_length_1055_cov_36.460251	468	548	0	59	80	0.7375000
NODE_5672_length_1055_cov_36.460251	468	548	5	1	80	0.0125000
NODE_5672_length_1055_cov_36.460251	468	548	6	20	80	0.2500000
NODE_5672_length_1055_cov_36.460251	521	601	0	6	80	0.0750000
NODE_5672_length_1055_cov_36.460251	521	601	5	1	80	0.0125000
NODE_5672_length_1055_cov_36.460251	521	601	6	73	80	0.9125000
NODE_5673_length_1055_cov_31.235356	502	582	4	20	80	0.2500000
NODE_5673_length_1055_cov_31.235356	502	582	6	60	80	0.7500000
NODE_5673_length_1055_cov_31.235356	555	635	0	47	80	0.5875000
NODE_5673_length_1055_cov_31.235356	555	635	4	26	80	0.3250000
NODE_5673_length_1055_cov_31.235356	555	635	6	7	80	0.0875000
NODE_5674_length_1055_cov_23.330544	403	483	0	80	80	1.0000000
NODE_5674_length_1055_cov_23.330544	456	536	0	80	80	1.0000000
NODE_5674_length_1055_cov_23.330544	532	612	0	80	80	1.0000000
NODE_5674_length_1055_cov_23.330544	585	665	0	80	80	1.0000000
NODE_5675_length_1055_cov_19.541841	321	401	0	29	80	0.3625000
NODE_5675_length_1055_cov_19.541841	321	401	6	51	80	0.6375000
NODE_5675_length_1055_cov_19.541841	374	454	0	17	80	0.2125000
NODE_5675_length_1055_cov_19.541841	374	454	6	63	80	0.7875000
NODE_5676_length_1055_cov_15.744770	525	605	0	77	80	0.9625000
NODE_5676_length_1055_cov_15.744770	525	605	2	3	80	0.0375000
NODE_5676_length_1055_cov_15.744770	578	658	0	24	80	0.3000000
NODE_5676_length_1055_cov_15.744770	578	658	2	56	80	0.7000000
NODE_5677_length_1055_cov_10.729079	335	415	0	80	80	1.0000000
NODE_5677_length_1055_cov_10.729079	388	468	0	80	80	1.0000000
NODE_5678_length_1055_cov_7.525105	575	655	0	7	80	0.0875000
NODE_5678_length_1055_cov_7.525105	575	655	2	65	80	0.8125000
NODE_5678_length_1055_cov_7.525105	575	655	4	8	80	0.1000000
NODE_5678_length_1055_cov_7.525105	628	708	0	7	80	0.0875000
NODE_5678_length_1055_cov_7.525105	628	708	2	12	80	0.1500000
NODE_5678_length_1055_cov_7.525105	628	708	4	61	80	0.7625000
NODE_5688_length_1054_cov_45.920419	371	451	0	80	80	1.0000000
NODE_5688_length_1054_cov_45.920419	424	505	0	81	81	1.0000000
NODE_5689_length_1054_cov_30.545550	499	578	0	79	79	1.0000000
NODE_5689_length_1054_cov_30.545550	552	631	0	79	79	1.0000000
NODE_5689_length_1054_cov_30.545550	627	707	0	80	80	1.0000000
NODE_5689_length_1054_cov_30.545550	680	760	0	80	80	1.0000000
NODE_5690_length_1054_cov_16.606283	347	427	0	35	80	0.4375000
NODE_5690_length_1054_cov_16.606283	347	427	2	45	80	0.5625000
NODE_5690_length_1054_cov_16.606283	400	480	0	80	80	1.0000000
NODE_5691_length_1054_cov_11.637696	244	316	0	2	72	0.0277778
NODE_5691_length_1054_cov_11.637696	244	316	2	70	72	0.9722222
NODE_5691_length_1054_cov_11.637696	312	392	0	78	80	0.9750000
NODE_5691_length_1054_cov_11.637696	312	392	2	2	80	0.0250000
NODE_5691_length_1054_cov_11.637696	365	445	0	32	80	0.4000000
NODE_5691_length_1054_cov_11.637696	365	445	2	48	80	0.6000000
NODE_5692_length_1054_cov_10.381152	493	573	0	1	80	0.0125000
NODE_5692_length_1054_cov_10.381152	493	573	2	79	80	0.9875000
NODE_5692_length_1054_cov_10.381152	546	626	0	19	80	0.2375000
NODE_5692_length_1054_cov_10.381152	546	626	2	61	80	0.7625000
NODE_5703_length_1053_cov_57.660377	445	527	0	14	82	0.1707317
NODE_5703_length_1053_cov_57.660377	445	527	2	18	82	0.2195122
NODE_5703_length_1053_cov_57.660377	445	527	4	50	82	0.6097561
NODE_5703_length_1053_cov_57.660377	500	580	0	9	80	0.1125000
NODE_5703_length_1053_cov_57.660377	500	580	2	71	80	0.8875000
NODE_5704_length_1053_cov_33.518868	329	409	0	41	80	0.5125000
NODE_5704_length_1053_cov_33.518868	329	409	2	39	80	0.4875000
NODE_5704_length_1053_cov_33.518868	382	462	0	80	80	1.0000000
NODE_5704_length_1053_cov_33.518868	458	538	0	80	80	1.0000000
NODE_5704_length_1053_cov_33.518868	511	591	0	51	80	0.6375000
NODE_5704_length_1053_cov_33.518868	511	591	4	29	80	0.3625000
NODE_5705_length_1053_cov_32.412998	375	455	0	80	80	1.0000000
NODE_5705_length_1053_cov_32.412998	428	508	0	80	80	1.0000000
NODE_5705_length_1053_cov_32.412998	504	584	0	80	80	1.0000000
NODE_5705_length_1053_cov_32.412998	557	637	0	68	80	0.8500000
NODE_5705_length_1053_cov_32.412998	557	637	2	12	80	0.1500000
NODE_5706_length_1053_cov_26.545073	456	536	2	15	80	0.1875000
NODE_5706_length_1053_cov_26.545073	456	536	3	65	80	0.8125000
NODE_5706_length_1053_cov_26.545073	509	589	1	12	80	0.1500000
NODE_5706_length_1053_cov_26.545073	509	589	2	7	80	0.0875000
NODE_5706_length_1053_cov_26.545073	509	589	3	61	80	0.7625000
NODE_5706_length_1053_cov_26.545073	585	665	0	46	80	0.5750000
NODE_5706_length_1053_cov_26.545073	585	665	1	34	80	0.4250000
NODE_5706_length_1053_cov_26.545073	638	718	0	80	80	1.0000000
NODE_5707_length_1053_cov_20.346960	543	623	0	45	80	0.5625000
NODE_5707_length_1053_cov_20.346960	543	623	2	35	80	0.4375000
NODE_5707_length_1053_cov_20.346960	596	677	0	14	81	0.1728395
NODE_5707_length_1053_cov_20.346960	596	677	2	67	81	0.8271605
NODE_5708_length_1053_cov_11.655136	393	473	0	80	80	1.0000000
NODE_5708_length_1053_cov_11.655136	446	526	0	80	80	1.0000000
NODE_5710_length_1053_cov_4.771488	84	149	4	5	65	0.0769231
NODE_5710_length_1053_cov_4.771488	84	149	12	60	65	0.9230769
NODE_5718_length_1052_cov_18.469045	448	528	0	80	80	1.0000000
NODE_5718_length_1052_cov_18.469045	501	581	0	80	80	1.0000000
NODE_5719_length_1052_cov_13.136411	425	505	0	80	80	1.0000000
NODE_5719_length_1052_cov_13.136411	478	558	0	80	80	1.0000000
NODE_5722_length_1052_cov_3.082896	607	687	0	78	80	0.9750000
NODE_5722_length_1052_cov_3.082896	607	687	2	2	80	0.0250000
NODE_5722_length_1052_cov_3.082896	660	740	0	80	80	1.0000000
NODE_5729_length_1051_cov_34.868697	472	552	0	67	80	0.8375000
NODE_5729_length_1051_cov_34.868697	472	552	2	13	80	0.1625000
NODE_5729_length_1051_cov_34.868697	525	605	0	15	80	0.1875000
NODE_5729_length_1051_cov_34.868697	525	605	2	65	80	0.8125000
NODE_5730_length_1051_cov_19.446429	549	629	0	6	80	0.0750000
NODE_5730_length_1051_cov_19.446429	549	629	3	7	80	0.0875000
NODE_5730_length_1051_cov_19.446429	549	629	6	67	80	0.8375000
NODE_5730_length_1051_cov_19.446429	602	682	6	80	80	1.0000000
NODE_5731_length_1051_cov_4.022059	600	680	0	80	80	1.0000000
NODE_5736_length_1050_cov_31.556257	429	509	0	80	80	1.0000000
NODE_5736_length_1050_cov_31.556257	482	562	0	80	80	1.0000000
NODE_5736_length_1050_cov_31.556257	558	638	0	80	80	1.0000000
NODE_5736_length_1050_cov_31.556257	611	691	0	39	80	0.4875000
NODE_5736_length_1050_cov_31.556257	611	691	2	41	80	0.5125000
NODE_5737_length_1050_cov_16.337539	398	478	5	18	80	0.2250000
NODE_5737_length_1050_cov_16.337539	398	478	6	62	80	0.7750000
NODE_5737_length_1050_cov_16.337539	451	531	0	52	80	0.6500000
NODE_5737_length_1050_cov_16.337539	451	531	6	28	80	0.3500000
NODE_5738_length_1050_cov_13.290221	507	587	0	2	80	0.0250000
NODE_5738_length_1050_cov_13.290221	507	587	2	78	80	0.9750000
NODE_5738_length_1050_cov_13.290221	560	640	0	25	80	0.3125000
NODE_5738_length_1050_cov_13.290221	560	640	2	55	80	0.6875000
NODE_5739_length_1050_cov_11.389064	532	612	0	80	80	1.0000000
NODE_5739_length_1050_cov_11.389064	585	665	0	80	80	1.0000000
NODE_5740_length_1050_cov_11.091483	259	321	0	62	62	1.0000000
NODE_5740_length_1050_cov_11.091483	294	374	0	80	80	1.0000000
NODE_5740_length_1050_cov_11.091483	370	450	0	80	80	1.0000000
NODE_5740_length_1050_cov_11.091483	423	503	0	80	80	1.0000000
NODE_5742_length_1050_cov_2.201893	928	990	0	62	62	1.0000000
NODE_5742_length_1050_cov_2.201893	981	1043	0	62	62	1.0000000
NODE_5748_length_1050_cov_1.241851	935	990	4	3	55	0.0545455
NODE_5748_length_1050_cov_1.241851	935	990	7	1	55	0.0181818
NODE_5748_length_1050_cov_1.241851	935	990	8	1	55	0.0181818
NODE_5748_length_1050_cov_1.241851	935	990	10	1	55	0.0181818
NODE_5748_length_1050_cov_1.241851	935	990	12	4	55	0.0727273
NODE_5748_length_1050_cov_1.241851	935	990	14	1	55	0.0181818
NODE_5748_length_1050_cov_1.241851	935	990	16	4	55	0.0727273
NODE_5748_length_1050_cov_1.241851	935	990	18	3	55	0.0545455
NODE_5748_length_1050_cov_1.241851	935	990	20	3	55	0.0545455
NODE_5748_length_1050_cov_1.241851	935	990	22	10	55	0.1818182
NODE_5748_length_1050_cov_1.241851	935	990	24	24	55	0.4363636
NODE_5748_length_1050_cov_1.241851	956	1036	16	8	80	0.1000000
NODE_5748_length_1050_cov_1.241851	956	1036	20	3	80	0.0375000
NODE_5748_length_1050_cov_1.241851	956	1036	22	20	80	0.2500000
NODE_5748_length_1050_cov_1.241851	956	1036	24	49	80	0.6125000
NODE_5752_length_1049_cov_28.174737	446	526	0	36	80	0.4500000
NODE_5752_length_1049_cov_28.174737	446	526	2	27	80	0.3375000
NODE_5752_length_1049_cov_28.174737	446	526	7	17	80	0.2125000
NODE_5752_length_1049_cov_28.174737	499	579	2	10	80	0.1250000
NODE_5752_length_1049_cov_28.174737	499	579	5	15	80	0.1875000
NODE_5752_length_1049_cov_28.174737	499	579	6	6	80	0.0750000
NODE_5752_length_1049_cov_28.174737	499	579	7	47	80	0.5875000
NODE_5752_length_1049_cov_28.174737	499	579	8	2	80	0.0250000
NODE_5753_length_1049_cov_23.186316	389	469	0	80	80	1.0000000
NODE_5753_length_1049_cov_23.186316	442	522	0	80	80	1.0000000
NODE_5753_length_1049_cov_23.186316	518	595	0	59	77	0.7662337
NODE_5753_length_1049_cov_23.186316	518	595	4	18	77	0.2337662
NODE_5753_length_1049_cov_23.186316	568	648	0	9	80	0.1125000
NODE_5753_length_1049_cov_23.186316	568	648	4	71	80	0.8875000
NODE_5754_length_1049_cov_21.097895	532	612	2	12	80	0.1500000
NODE_5754_length_1049_cov_21.097895	532	612	4	68	80	0.8500000
NODE_5754_length_1049_cov_21.097895	585	665	0	17	80	0.2125000
NODE_5754_length_1049_cov_21.097895	585	665	2	47	80	0.5875000
NODE_5754_length_1049_cov_21.097895	585	665	4	16	80	0.2000000
NODE_5755_length_1049_cov_18.964211	375	466	0	51	91	0.5604396
NODE_5755_length_1049_cov_18.964211	375	466	1	40	91	0.4395604
NODE_5755_length_1049_cov_18.964211	439	519	1	66	80	0.8250000
NODE_5755_length_1049_cov_18.964211	439	519	2	14	80	0.1750000
NODE_5755_length_1049_cov_18.964211	515	595	1	23	80	0.2875000
NODE_5755_length_1049_cov_18.964211	515	595	2	57	80	0.7125000
NODE_5755_length_1049_cov_18.964211	568	648	1	76	80	0.9500000
NODE_5755_length_1049_cov_18.964211	568	648	2	4	80	0.0500000
NODE_5756_length_1049_cov_18.075789	437	517	0	80	80	1.0000000
NODE_5756_length_1049_cov_18.075789	490	570	0	80	80	1.0000000
NODE_5756_length_1049_cov_18.075789	566	644	0	78	78	1.0000000
NODE_5756_length_1049_cov_18.075789	620	695	0	75	75	1.0000000
NODE_5757_length_1049_cov_16.194737	569	650	0	46	81	0.5679013
NODE_5757_length_1049_cov_16.194737	569	650	2	35	81	0.4320988
NODE_5757_length_1049_cov_16.194737	623	703	0	80	80	1.0000000
NODE_5757_length_1049_cov_16.194737	699	779	0	80	80	1.0000000
NODE_5757_length_1049_cov_16.194737	752	832	0	80	80	1.0000000
NODE_5759_length_1049_cov_6.323158	588	668	0	80	80	1.0000000
NODE_5759_length_1049_cov_6.323158	641	721	0	80	80	1.0000000
NODE_5770_length_1048_cov_73.887250	535	615	0	59	80	0.7375000
NODE_5770_length_1048_cov_73.887250	535	615	2	21	80	0.2625000
NODE_5770_length_1048_cov_73.887250	588	668	0	6	80	0.0750000
NODE_5770_length_1048_cov_73.887250	588	668	2	74	80	0.9250000
NODE_5770_length_1048_cov_73.887250	664	744	0	76	80	0.9500000
NODE_5770_length_1048_cov_73.887250	664	744	2	4	80	0.0500000
NODE_5770_length_1048_cov_73.887250	717	797	0	80	80	1.0000000
NODE_5770_length_1048_cov_73.887250	899	979	0	80	80	1.0000000
NODE_5771_length_1048_cov_48.242360	407	487	2	80	80	1.0000000
NODE_5771_length_1048_cov_48.242360	460	540	0	30	80	0.3750000
NODE_5771_length_1048_cov_48.242360	460	540	2	50	80	0.6250000
NODE_5771_length_1048_cov_48.242360	536	616	0	80	80	1.0000000
NODE_5771_length_1048_cov_48.242360	589	669	0	80	80	1.0000000
NODE_5772_length_1048_cov_38.430980	352	432	0	23	80	0.2875000
NODE_5772_length_1048_cov_38.430980	352	432	4	4	80	0.0500000
NODE_5772_length_1048_cov_38.430980	352	432	16	1	80	0.0125000
NODE_5772_length_1048_cov_38.430980	352	432	17	52	80	0.6500000
NODE_5772_length_1048_cov_38.430980	405	485	16	3	80	0.0375000
NODE_5772_length_1048_cov_38.430980	405	485	17	77	80	0.9625000
NODE_5773_length_1048_cov_28.179136	548	628	2	18	80	0.2250000
NODE_5773_length_1048_cov_28.179136	548	628	4	62	80	0.7750000
NODE_5773_length_1048_cov_28.179136	601	681	0	16	80	0.2000000
NODE_5773_length_1048_cov_28.179136	601	681	2	51	80	0.6375000
NODE_5773_length_1048_cov_28.179136	601	681	4	13	80	0.1625000
NODE_5773_length_1048_cov_28.179136	677	757	0	80	80	1.0000000
NODE_5773_length_1048_cov_28.179136	730	810	0	80	80	1.0000000
NODE_5774_length_1048_cov_22.985248	409	489	2	55	80	0.6875000
NODE_5774_length_1048_cov_22.985248	409	489	4	4	80	0.0500000
NODE_5774_length_1048_cov_22.985248	409	489	6	21	80	0.2625000
NODE_5774_length_1048_cov_22.985248	462	542	2	2	80	0.0250000
NODE_5774_length_1048_cov_22.985248	462	542	4	57	80	0.7125000
NODE_5774_length_1048_cov_22.985248	462	542	6	21	80	0.2625000
NODE_5774_length_1048_cov_22.985248	538	618	0	17	80	0.2125000
NODE_5774_length_1048_cov_22.985248	538	618	4	63	80	0.7875000
NODE_5774_length_1048_cov_22.985248	591	671	0	10	80	0.1250000
NODE_5774_length_1048_cov_22.985248	591	671	4	51	80	0.6375000
NODE_5774_length_1048_cov_22.985248	591	671	6	19	80	0.2375000
NODE_5775_length_1048_cov_17.883035	500	580	6	80	80	1.0000000
NODE_5775_length_1048_cov_17.883035	553	633	0	34	80	0.4250000
NODE_5775_length_1048_cov_17.883035	553	633	6	46	80	0.5750000
NODE_5776_length_1048_cov_17.444679	377	457	0	29	80	0.3625000
NODE_5776_length_1048_cov_17.444679	377	457	2	30	80	0.3750000
NODE_5776_length_1048_cov_17.444679	377	457	4	21	80	0.2625000
NODE_5776_length_1048_cov_17.444679	430	510	2	6	80	0.0750000
NODE_5776_length_1048_cov_17.444679	430	510	4	68	80	0.8500000
NODE_5776_length_1048_cov_17.444679	430	510	6	6	80	0.0750000
NODE_5777_length_1048_cov_13.387777	518	598	2	32	80	0.4000000
NODE_5777_length_1048_cov_13.387777	518	598	4	15	80	0.1875000
NODE_5777_length_1048_cov_13.387777	518	598	6	17	80	0.2125000
NODE_5777_length_1048_cov_13.387777	518	598	8	16	80	0.2000000
NODE_5777_length_1048_cov_13.387777	571	651	4	3	80	0.0375000
NODE_5777_length_1048_cov_13.387777	571	651	6	61	80	0.7625000
NODE_5777_length_1048_cov_13.387777	571	651	8	16	80	0.2000000
NODE_5778_length_1048_cov_12.934668	716	796	0	80	80	1.0000000
NODE_5778_length_1048_cov_12.934668	769	849	0	80	80	1.0000000
NODE_5778_length_1048_cov_12.934668	845	925	0	80	80	1.0000000
NODE_5778_length_1048_cov_12.934668	898	975	0	77	77	1.0000000
NODE_5779_length_1048_cov_12.712329	330	410	0	80	80	1.0000000
NODE_5779_length_1048_cov_12.712329	384	463	0	79	79	1.0000000
NODE_5779_length_1048_cov_12.712329	459	539	0	80	80	1.0000000
NODE_5779_length_1048_cov_12.712329	512	592	0	52	80	0.6500000
NODE_5779_length_1048_cov_12.712329	512	592	2	28	80	0.3500000
NODE_5780_length_1048_cov_9.232877	305	355	0	50	50	1.0000000
NODE_5786_length_1047_cov_79.917722	540	620	0	80	80	1.0000000
NODE_5786_length_1047_cov_79.917722	593	673	0	80	80	1.0000000
NODE_5787_length_1047_cov_28.527426	582	662	0	80	80	1.0000000
NODE_5787_length_1047_cov_28.527426	635	715	0	28	80	0.3500000
NODE_5787_length_1047_cov_28.527426	635	715	2	47	80	0.5875000
NODE_5787_length_1047_cov_28.527426	635	715	4	5	80	0.0625000
NODE_5788_length_1047_cov_26.068565	372	452	0	80	80	1.0000000
NODE_5788_length_1047_cov_26.068565	425	505	0	80	80	1.0000000
NODE_5789_length_1047_cov_25.946203	424	504	0	26	80	0.3250000
NODE_5789_length_1047_cov_25.946203	424	504	4	54	80	0.6750000
NODE_5789_length_1047_cov_25.946203	477	557	0	79	80	0.9875000
NODE_5789_length_1047_cov_25.946203	477	557	4	1	80	0.0125000
NODE_5790_length_1047_cov_19.255274	458	538	0	80	80	1.0000000
NODE_5790_length_1047_cov_19.255274	511	591	0	44	80	0.5500000
NODE_5790_length_1047_cov_19.255274	511	591	2	36	80	0.4500000
NODE_5791_length_1047_cov_16.618143	467	547	2	32	80	0.4000000
NODE_5791_length_1047_cov_16.618143	467	547	4	48	80	0.6000000
NODE_5791_length_1047_cov_16.618143	520	600	0	41	80	0.5125000
NODE_5791_length_1047_cov_16.618143	520	600	2	35	80	0.4375000
NODE_5791_length_1047_cov_16.618143	520	600	4	4	80	0.0500000
NODE_5792_length_1047_cov_14.246835	643	723	0	32	80	0.4000000
NODE_5792_length_1047_cov_14.246835	643	723	6	48	80	0.6000000
NODE_5792_length_1047_cov_14.246835	696	776	0	13	80	0.1625000
NODE_5792_length_1047_cov_14.246835	696	776	4	1	80	0.0125000
NODE_5792_length_1047_cov_14.246835	696	776	5	24	80	0.3000000
NODE_5792_length_1047_cov_14.246835	696	776	6	42	80	0.5250000
NODE_5793_length_1047_cov_9.869198	414	494	0	80	80	1.0000000
NODE_5793_length_1047_cov_9.869198	467	547	0	80	80	1.0000000
NODE_5794_length_1047_cov_8.513713	300	380	0	80	80	1.0000000
NODE_5794_length_1047_cov_8.513713	353	433	0	80	80	1.0000000
NODE_5795_length_1047_cov_7.412447	442	522	0	80	80	1.0000000
NODE_5795_length_1047_cov_7.412447	495	575	0	80	80	1.0000000
NODE_5803_length_1046_cov_41.392819	587	667	2	80	80	1.0000000
NODE_5803_length_1046_cov_41.392819	640	720	0	24	80	0.3000000
NODE_5803_length_1046_cov_41.392819	640	720	2	56	80	0.7000000
NODE_5804_length_1046_cov_30.317846	382	462	0	29	80	0.3625000
NODE_5804_length_1046_cov_30.317846	382	462	2	51	80	0.6375000
NODE_5804_length_1046_cov_30.317846	435	515	2	80	80	1.0000000
NODE_5805_length_1046_cov_28.184794	346	426	0	24	80	0.3000000
NODE_5805_length_1046_cov_28.184794	346	426	2	56	80	0.7000000
NODE_5805_length_1046_cov_28.184794	399	479	0	77	80	0.9625000
NODE_5805_length_1046_cov_28.184794	399	479	2	3	80	0.0375000
NODE_5806_length_1046_cov_24.595565	501	581	0	34	80	0.4250000
NODE_5806_length_1046_cov_24.595565	501	581	10	46	80	0.5750000
NODE_5806_length_1046_cov_24.595565	554	634	9	25	80	0.3125000
NODE_5806_length_1046_cov_24.595565	554	634	10	55	80	0.6875000
NODE_5807_length_1046_cov_17.958817	447	527	0	26	80	0.3250000
NODE_5807_length_1046_cov_17.958817	447	527	1	1	80	0.0125000
NODE_5807_length_1046_cov_17.958817	447	527	2	53	80	0.6625000
NODE_5807_length_1046_cov_17.958817	500	580	0	79	80	0.9875000
NODE_5807_length_1046_cov_17.958817	500	580	1	1	80	0.0125000
NODE_5808_length_1046_cov_15.494192	385	465	0	6	80	0.0750000
NODE_5808_length_1046_cov_15.494192	385	465	2	74	80	0.9250000
NODE_5808_length_1046_cov_15.494192	438	518	0	56	80	0.7000000
NODE_5808_length_1046_cov_15.494192	438	518	2	24	80	0.3000000
NODE_5809_length_1046_cov_12.639916	554	634	0	10	80	0.1250000
NODE_5809_length_1046_cov_12.639916	554	634	8	14	80	0.1750000
NODE_5809_length_1046_cov_12.639916	554	634	10	56	80	0.7000000
NODE_5809_length_1046_cov_12.639916	607	687	0	63	80	0.7875000
NODE_5809_length_1046_cov_12.639916	607	687	8	14	80	0.1750000
NODE_5809_length_1046_cov_12.639916	607	687	10	3	80	0.0375000
NODE_5810_length_1046_cov_11.238648	471	551	0	4	80	0.0500000
NODE_5810_length_1046_cov_11.238648	471	551	4	6	80	0.0750000
NODE_5810_length_1046_cov_11.238648	471	551	8	14	80	0.1750000
NODE_5810_length_1046_cov_11.238648	471	551	10	4	80	0.0500000
NODE_5810_length_1046_cov_11.238648	471	551	12	52	80	0.6500000
NODE_5810_length_1046_cov_11.238648	524	604	8	38	80	0.4750000
NODE_5810_length_1046_cov_11.238648	524	604	10	15	80	0.1875000
NODE_5810_length_1046_cov_11.238648	524	604	12	27	80	0.3375000
NODE_5811_length_1046_cov_10.744456	459	539	2	50	80	0.6250000
NODE_5811_length_1046_cov_10.744456	459	539	4	30	80	0.3750000
NODE_5811_length_1046_cov_10.744456	512	592	0	23	80	0.2875000
NODE_5811_length_1046_cov_10.744456	512	592	2	57	80	0.7125000
NODE_5812_length_1046_cov_8.689546	302	382	2	8	80	0.1000000
NODE_5812_length_1046_cov_8.689546	302	382	4	52	80	0.6500000
NODE_5812_length_1046_cov_8.689546	302	382	6	20	80	0.2500000
NODE_5812_length_1046_cov_8.689546	355	435	0	17	80	0.2125000
NODE_5812_length_1046_cov_8.689546	355	435	2	12	80	0.1500000
NODE_5812_length_1046_cov_8.689546	355	435	4	9	80	0.1125000
NODE_5812_length_1046_cov_8.689546	355	435	6	42	80	0.5250000
NODE_5823_length_1045_cov_75.975687	359	440	22	21	81	0.2592593
NODE_5823_length_1045_cov_75.975687	359	440	23	56	81	0.6913580
NODE_5823_length_1045_cov_75.975687	359	440	28	4	81	0.0493827
NODE_5823_length_1045_cov_75.975687	412	493	6	32	81	0.3950617
NODE_5823_length_1045_cov_75.975687	412	493	22	17	81	0.2098765
NODE_5823_length_1045_cov_75.975687	412	493	23	8	81	0.0987654
NODE_5823_length_1045_cov_75.975687	412	493	24	11	81	0.1358025
NODE_5823_length_1045_cov_75.975687	412	493	26	9	81	0.1111111
NODE_5823_length_1045_cov_75.975687	412	493	28	4	81	0.0493827
NODE_5823_length_1045_cov_75.975687	489	569	2	64	80	0.8000000
NODE_5823_length_1045_cov_75.975687	489	569	6	10	80	0.1250000
NODE_5823_length_1045_cov_75.975687	489	569	8	6	80	0.0750000
NODE_5823_length_1045_cov_75.975687	542	622	2	80	80	1.0000000
NODE_5824_length_1045_cov_54.419662	434	514	0	20	80	0.2500000
NODE_5824_length_1045_cov_54.419662	434	514	2	54	80	0.6750000
NODE_5824_length_1045_cov_54.419662	434	514	6	6	80	0.0750000
NODE_5824_length_1045_cov_54.419662	487	567	0	73	80	0.9125000
NODE_5824_length_1045_cov_54.419662	487	567	2	7	80	0.0875000
NODE_5824_length_1045_cov_54.419662	563	639	0	76	76	1.0000000
NODE_5824_length_1045_cov_54.419662	616	696	0	80	80	1.0000000
NODE_5825_length_1045_cov_23.188161	395	475	0	58	80	0.7250000
NODE_5825_length_1045_cov_23.188161	395	475	2	22	80	0.2750000
NODE_5825_length_1045_cov_23.188161	448	528	0	5	80	0.0625000
NODE_5825_length_1045_cov_23.188161	448	528	2	75	80	0.9375000
NODE_5826_length_1045_cov_19.686047	571	651	3	2	80	0.0250000
NODE_5826_length_1045_cov_19.686047	571	651	4	78	80	0.9750000
NODE_5826_length_1045_cov_19.686047	624	704	0	42	80	0.5250000
NODE_5826_length_1045_cov_19.686047	624	704	2	9	80	0.1125000
NODE_5826_length_1045_cov_19.686047	624	704	3	4	80	0.0500000
NODE_5826_length_1045_cov_19.686047	624	704	4	25	80	0.3125000
NODE_5827_length_1045_cov_19.378436	478	558	0	16	80	0.2000000
NODE_5827_length_1045_cov_19.378436	478	558	2	64	80	0.8000000
NODE_5827_length_1045_cov_19.378436	531	611	0	69	80	0.8625000
NODE_5827_length_1045_cov_19.378436	531	611	2	11	80	0.1375000
NODE_5828_length_1045_cov_17.601480	359	439	0	80	80	1.0000000
NODE_5828_length_1045_cov_17.601480	412	492	0	80	80	1.0000000
NODE_5829_length_1045_cov_17.372093	633	713	0	55	80	0.6875000
NODE_5829_length_1045_cov_17.372093	633	713	2	25	80	0.3125000
NODE_5829_length_1045_cov_17.372093	686	766	0	2	80	0.0250000
NODE_5829_length_1045_cov_17.372093	686	766	2	78	80	0.9750000
NODE_5830_length_1045_cov_14.828753	433	513	0	80	80	1.0000000
NODE_5830_length_1045_cov_14.828753	486	566	0	80	80	1.0000000
NODE_5831_length_1045_cov_11.673362	664	744	0	80	80	1.0000000
NODE_5831_length_1045_cov_11.673362	717	797	0	80	80	1.0000000
NODE_5843_length_1044_cov_42.600000	344	424	2	69	80	0.8625000
NODE_5843_length_1044_cov_42.600000	344	424	4	11	80	0.1375000
NODE_5843_length_1044_cov_42.600000	397	477	2	18	80	0.2250000
NODE_5843_length_1044_cov_42.600000	397	477	4	50	80	0.6250000
NODE_5843_length_1044_cov_42.600000	397	477	6	5	80	0.0625000
NODE_5843_length_1044_cov_42.600000	397	477	8	7	80	0.0875000
NODE_5844_length_1044_cov_27.653968	454	534	0	58	80	0.7250000
NODE_5844_length_1044_cov_27.653968	454	534	2	22	80	0.2750000
NODE_5844_length_1044_cov_27.653968	507	587	0	80	80	1.0000000
NODE_5845_length_1044_cov_24.561905	297	375	0	78	78	1.0000000
NODE_5845_length_1044_cov_24.561905	348	428	0	80	80	1.0000000
NODE_5845_length_1044_cov_24.561905	424	504	0	80	80	1.0000000
NODE_5845_length_1044_cov_24.561905	477	557	0	80	80	1.0000000
NODE_5846_length_1044_cov_23.720635	294	374	0	40	80	0.5000000
NODE_5846_length_1044_cov_23.720635	294	374	4	29	80	0.3625000
NODE_5846_length_1044_cov_23.720635	294	374	10	11	80	0.1375000
NODE_5846_length_1044_cov_23.720635	347	427	0	67	80	0.8375000
NODE_5846_length_1044_cov_23.720635	347	427	4	13	80	0.1625000
NODE_5846_length_1044_cov_23.720635	423	503	4	80	80	1.0000000
NODE_5846_length_1044_cov_23.720635	476	556	0	40	80	0.5000000
NODE_5846_length_1044_cov_23.720635	476	556	4	40	80	0.5000000
NODE_5847_length_1044_cov_20.871958	462	542	0	80	80	1.0000000
NODE_5847_length_1044_cov_20.871958	515	595	0	80	80	1.0000000
NODE_5847_length_1044_cov_20.871958	591	671	0	80	80	1.0000000
NODE_5847_length_1044_cov_20.871958	644	724	0	80	80	1.0000000
NODE_5848_length_1044_cov_18.596825	433	513	0	80	80	1.0000000
NODE_5848_length_1044_cov_18.596825	486	566	0	80	80	1.0000000
NODE_5849_length_1044_cov_16.102646	414	494	4	80	80	1.0000000
NODE_5849_length_1044_cov_16.102646	467	547	0	39	80	0.4875000
NODE_5849_length_1044_cov_16.102646	467	547	4	41	80	0.5125000
NODE_5850_length_1044_cov_12.156614	578	658	0	80	80	1.0000000
NODE_5850_length_1044_cov_12.156614	631	711	0	80	80	1.0000000
NODE_5851_length_1044_cov_10.661376	506	586	0	80	80	1.0000000
NODE_5851_length_1044_cov_10.661376	559	639	0	80	80	1.0000000
NODE_5852_length_1044_cov_9.534392	461	541	0	80	80	1.0000000
NODE_5852_length_1044_cov_9.534392	514	594	0	28	80	0.3500000
NODE_5852_length_1044_cov_9.534392	514	594	2	52	80	0.6500000
NODE_5853_length_1044_cov_5.517460	434	514	0	80	80	1.0000000
NODE_5853_length_1044_cov_5.517460	487	567	0	80	80	1.0000000
NODE_5856_length_1044_cov_1.502646	769	845	0	37	76	0.4868421
NODE_5856_length_1044_cov_1.502646	769	845	2	8	76	0.1052632
NODE_5856_length_1044_cov_1.502646	769	845	6	31	76	0.4078947
NODE_5860_length_1043_cov_42.288136	452	532	0	80	80	1.0000000
NODE_5860_length_1043_cov_42.288136	505	585	0	51	80	0.6375000
NODE_5860_length_1043_cov_42.288136	505	585	2	29	80	0.3625000
NODE_5861_length_1043_cov_25.987288	350	430	2	9	80	0.1125000
NODE_5861_length_1043_cov_25.987288	350	430	4	14	80	0.1750000
NODE_5861_length_1043_cov_25.987288	350	430	8	2	80	0.0250000
NODE_5861_length_1043_cov_25.987288	350	430	10	3	80	0.0375000
NODE_5861_length_1043_cov_25.987288	350	430	12	8	80	0.1000000
NODE_5861_length_1043_cov_25.987288	350	430	17	1	80	0.0125000
NODE_5861_length_1043_cov_25.987288	350	430	18	1	80	0.0125000
NODE_5861_length_1043_cov_25.987288	350	430	20	10	80	0.1250000
NODE_5861_length_1043_cov_25.987288	350	430	22	17	80	0.2125000
NODE_5861_length_1043_cov_25.987288	350	430	24	15	80	0.1875000
NODE_5861_length_1043_cov_25.987288	403	483	20	11	80	0.1375000
NODE_5861_length_1043_cov_25.987288	403	483	22	26	80	0.3250000
NODE_5861_length_1043_cov_25.987288	403	483	24	17	80	0.2125000
NODE_5861_length_1043_cov_25.987288	403	483	25	17	80	0.2125000
NODE_5861_length_1043_cov_25.987288	403	483	27	6	80	0.0750000
NODE_5861_length_1043_cov_25.987288	403	483	29	3	80	0.0375000
NODE_5861_length_1043_cov_25.987288	479	559	25	18	80	0.2250000
NODE_5861_length_1043_cov_25.987288	479	559	28	1	80	0.0125000
NODE_5861_length_1043_cov_25.987288	479	559	29	11	80	0.1375000
NODE_5861_length_1043_cov_25.987288	479	559	32	12	80	0.1500000
NODE_5861_length_1043_cov_25.987288	479	559	33	2	80	0.0250000
NODE_5861_length_1043_cov_25.987288	479	559	34	10	80	0.1250000
NODE_5861_length_1043_cov_25.987288	479	559	35	9	80	0.1125000
NODE_5861_length_1043_cov_25.987288	479	559	36	17	80	0.2125000
NODE_5861_length_1043_cov_25.987288	532	612	20	5	80	0.0625000
NODE_5861_length_1043_cov_25.987288	532	612	22	9	80	0.1125000
NODE_5861_length_1043_cov_25.987288	532	612	25	6	80	0.0750000
NODE_5861_length_1043_cov_25.987288	532	612	26	9	80	0.1125000
NODE_5861_length_1043_cov_25.987288	532	612	28	6	80	0.0750000
NODE_5861_length_1043_cov_25.987288	532	612	32	12	80	0.1500000
NODE_5861_length_1043_cov_25.987288	532	612	34	8	80	0.1000000
NODE_5861_length_1043_cov_25.987288	532	612	36	25	80	0.3125000
NODE_5862_length_1043_cov_20.838983	561	641	0	80	80	1.0000000
NODE_5862_length_1043_cov_20.838983	614	694	0	80	80	1.0000000
NODE_5863_length_1043_cov_20.312500	489	569	0	80	80	1.0000000
NODE_5863_length_1043_cov_20.312500	542	622	0	52	80	0.6500000
NODE_5863_length_1043_cov_20.312500	542	622	2	28	80	0.3500000
NODE_5864_length_1043_cov_16.320975	569	649	6	80	80	1.0000000
NODE_5864_length_1043_cov_16.320975	622	702	0	29	80	0.3625000
NODE_5864_length_1043_cov_16.320975	622	702	6	51	80	0.6375000
NODE_5865_length_1043_cov_11.176907	521	601	12	80	80	1.0000000
NODE_5865_length_1043_cov_11.176907	574	654	0	8	80	0.1000000
NODE_5865_length_1043_cov_11.176907	574	654	12	72	80	0.9000000
NODE_5866_length_1043_cov_8.146186	530	596	0	25	66	0.3787879
NODE_5866_length_1043_cov_8.146186	530	596	2	41	66	0.6212121
NODE_5866_length_1043_cov_8.146186	569	649	0	78	80	0.9750000
NODE_5866_length_1043_cov_8.146186	569	649	2	2	80	0.0250000
NODE_5868_length_1043_cov_5.347458	646	726	0	80	80	1.0000000
NODE_5868_length_1043_cov_5.347458	699	779	0	80	80	1.0000000
NODE_5879_length_1042_cov_242.728526	820	900	427	1	80	0.0125000
NODE_5879_length_1042_cov_242.728526	820	900	428	1	80	0.0125000
NODE_5879_length_1042_cov_242.728526	820	900	429	3	80	0.0375000
NODE_5879_length_1042_cov_242.728526	820	900	433	1	80	0.0125000
NODE_5879_length_1042_cov_242.728526	820	900	440	1	80	0.0125000
NODE_5879_length_1042_cov_242.728526	820	900	461	1	80	0.0125000
NODE_5879_length_1042_cov_242.728526	820	900	500	1	80	0.0125000
NODE_5879_length_1042_cov_242.728526	820	900	532	1	80	0.0125000
NODE_5879_length_1042_cov_242.728526	820	900	549	1	80	0.0125000
NODE_5879_length_1042_cov_242.728526	820	900	562	1	80	0.0125000
NODE_5879_length_1042_cov_242.728526	820	900	589	1	80	0.0125000
NODE_5879_length_1042_cov_242.728526	820	900	602	1	80	0.0125000
NODE_5879_length_1042_cov_242.728526	820	900	613	1	80	0.0125000
NODE_5879_length_1042_cov_242.728526	820	900	620	1	80	0.0125000
NODE_5879_length_1042_cov_242.728526	820	900	622	1	80	0.0125000
NODE_5879_length_1042_cov_242.728526	820	900	638	1	80	0.0125000
NODE_5879_length_1042_cov_242.728526	820	900	643	1	80	0.0125000
NODE_5879_length_1042_cov_242.728526	820	900	668	1	80	0.0125000
NODE_5879_length_1042_cov_242.728526	820	900	674	1	80	0.0125000
NODE_5879_length_1042_cov_242.728526	820	900	682	1	80	0.0125000
NODE_5879_length_1042_cov_242.728526	820	900	695	1	80	0.0125000
NODE_5879_length_1042_cov_242.728526	820	900	707	1	80	0.0125000
NODE_5879_length_1042_cov_242.728526	820	900	710	3	80	0.0375000
NODE_5879_length_1042_cov_242.728526	820	900	711	1	80	0.0125000
NODE_5879_length_1042_cov_242.728526	820	900	712	3	80	0.0375000
NODE_5879_length_1042_cov_242.728526	820	900	715	1	80	0.0125000
NODE_5879_length_1042_cov_242.728526	820	900	723	1	80	0.0125000
NODE_5879_length_1042_cov_242.728526	820	900	730	1	80	0.0125000
NODE_5879_length_1042_cov_242.728526	820	900	745	1	80	0.0125000
NODE_5879_length_1042_cov_242.728526	820	900	746	1	80	0.0125000
NODE_5879_length_1042_cov_242.728526	820	900	747	1	80	0.0125000
NODE_5879_length_1042_cov_242.728526	820	900	762	1	80	0.0125000
NODE_5879_length_1042_cov_242.728526	820	900	765	1	80	0.0125000
NODE_5879_length_1042_cov_242.728526	820	900	775	1	80	0.0125000
NODE_5879_length_1042_cov_242.728526	820	900	785	1	80	0.0125000
NODE_5879_length_1042_cov_242.728526	820	900	791	1	80	0.0125000
NODE_5879_length_1042_cov_242.728526	820	900	796	1	80	0.0125000
NODE_5879_length_1042_cov_242.728526	820	900	807	1	80	0.0125000
NODE_5879_length_1042_cov_242.728526	820	900	822	2	80	0.0250000
NODE_5879_length_1042_cov_242.728526	820	900	824	2	80	0.0250000
NODE_5879_length_1042_cov_242.728526	820	900	827	1	80	0.0125000
NODE_5879_length_1042_cov_242.728526	820	900	836	1	80	0.0125000
NODE_5879_length_1042_cov_242.728526	820	900	838	1	80	0.0125000
NODE_5879_length_1042_cov_242.728526	820	900	844	1	80	0.0125000
NODE_5879_length_1042_cov_242.728526	820	900	847	1	80	0.0125000
NODE_5879_length_1042_cov_242.728526	820	900	852	1	80	0.0125000
NODE_5879_length_1042_cov_242.728526	820	900	853	1	80	0.0125000
NODE_5879_length_1042_cov_242.728526	820	900	873	1	80	0.0125000
NODE_5879_length_1042_cov_242.728526	820	900	875	1	80	0.0125000
NODE_5879_length_1042_cov_242.728526	820	900	884	1	80	0.0125000
NODE_5879_length_1042_cov_242.728526	820	900	892	1	80	0.0125000
NODE_5879_length_1042_cov_242.728526	820	900	901	1	80	0.0125000
NODE_5879_length_1042_cov_242.728526	820	900	912	1	80	0.0125000
NODE_5879_length_1042_cov_242.728526	820	900	915	1	80	0.0125000
NODE_5879_length_1042_cov_242.728526	820	900	919	1	80	0.0125000
NODE_5879_length_1042_cov_242.728526	820	900	925	1	80	0.0125000
NODE_5879_length_1042_cov_242.728526	820	900	935	1	80	0.0125000
NODE_5879_length_1042_cov_242.728526	820	900	946	1	80	0.0125000
NODE_5879_length_1042_cov_242.728526	820	900	962	1	80	0.0125000
NODE_5879_length_1042_cov_242.728526	820	900	970	1	80	0.0125000
NODE_5879_length_1042_cov_242.728526	820	900	976	1	80	0.0125000
NODE_5879_length_1042_cov_242.728526	820	900	984	1	80	0.0125000
NODE_5879_length_1042_cov_242.728526	820	900	990	1	80	0.0125000
NODE_5879_length_1042_cov_242.728526	820	900	994	1	80	0.0125000
NODE_5879_length_1042_cov_242.728526	820	900	995	1	80	0.0125000
NODE_5879_length_1042_cov_242.728526	820	900	996	1	80	0.0125000
NODE_5879_length_1042_cov_242.728526	820	900	999	1	80	0.0125000
NODE_5879_length_1042_cov_242.728526	820	900	1002	1	80	0.0125000
NODE_5879_length_1042_cov_242.728526	820	900	1005	2	80	0.0250000
NODE_5879_length_1042_cov_242.728526	820	900	1007	1	80	0.0125000
NODE_5879_length_1042_cov_242.728526	820	900	1008	1	80	0.0125000
NODE_5879_length_1042_cov_242.728526	873	903	852	1	30	0.0333333
NODE_5879_length_1042_cov_242.728526	873	903	853	1	30	0.0333333
NODE_5879_length_1042_cov_242.728526	873	903	873	1	30	0.0333333
NODE_5879_length_1042_cov_242.728526	873	903	875	1	30	0.0333333
NODE_5879_length_1042_cov_242.728526	873	903	884	1	30	0.0333333
NODE_5879_length_1042_cov_242.728526	873	903	892	1	30	0.0333333
NODE_5879_length_1042_cov_242.728526	873	903	901	1	30	0.0333333
NODE_5879_length_1042_cov_242.728526	873	903	912	1	30	0.0333333
NODE_5879_length_1042_cov_242.728526	873	903	915	1	30	0.0333333
NODE_5879_length_1042_cov_242.728526	873	903	919	1	30	0.0333333
NODE_5879_length_1042_cov_242.728526	873	903	925	1	30	0.0333333
NODE_5879_length_1042_cov_242.728526	873	903	935	1	30	0.0333333
NODE_5879_length_1042_cov_242.728526	873	903	946	1	30	0.0333333
NODE_5879_length_1042_cov_242.728526	873	903	962	1	30	0.0333333
NODE_5879_length_1042_cov_242.728526	873	903	970	1	30	0.0333333
NODE_5879_length_1042_cov_242.728526	873	903	976	1	30	0.0333333
NODE_5879_length_1042_cov_242.728526	873	903	984	1	30	0.0333333
NODE_5879_length_1042_cov_242.728526	873	903	990	1	30	0.0333333
NODE_5879_length_1042_cov_242.728526	873	903	994	1	30	0.0333333
NODE_5879_length_1042_cov_242.728526	873	903	995	1	30	0.0333333
NODE_5879_length_1042_cov_242.728526	873	903	996	1	30	0.0333333
NODE_5879_length_1042_cov_242.728526	873	903	999	1	30	0.0333333
NODE_5879_length_1042_cov_242.728526	873	903	1002	1	30	0.0333333
NODE_5879_length_1042_cov_242.728526	873	903	1005	2	30	0.0666667
NODE_5879_length_1042_cov_242.728526	873	903	1007	1	30	0.0333333
NODE_5879_length_1042_cov_242.728526	873	903	1008	1	30	0.0333333
NODE_5879_length_1042_cov_242.728526	873	903	1009	1	30	0.0333333
NODE_5879_length_1042_cov_242.728526	873	903	1010	2	30	0.0666667
NODE_5880_length_1042_cov_63.214210	355	435	8	22	80	0.2750000
NODE_5880_length_1042_cov_63.214210	355	435	12	58	80	0.7250000
NODE_5880_length_1042_cov_63.214210	408	488	6	1	80	0.0125000
NODE_5880_length_1042_cov_63.214210	408	488	8	31	80	0.3875000
NODE_5880_length_1042_cov_63.214210	408	488	10	43	80	0.5375000
NODE_5880_length_1042_cov_63.214210	408	488	12	5	80	0.0625000
NODE_5881_length_1042_cov_29.581124	497	577	0	80	80	1.0000000
NODE_5881_length_1042_cov_29.581124	550	630	0	80	80	1.0000000
NODE_5882_length_1042_cov_23.861082	519	599	0	1	80	0.0125000
NODE_5882_length_1042_cov_23.861082	519	599	4	23	80	0.2875000
NODE_5882_length_1042_cov_23.861082	519	599	8	56	80	0.7000000
NODE_5882_length_1042_cov_23.861082	572	652	0	12	80	0.1500000
NODE_5882_length_1042_cov_23.861082	572	652	3	1	80	0.0125000
NODE_5882_length_1042_cov_23.861082	572	652	4	38	80	0.4750000
NODE_5882_length_1042_cov_23.861082	572	652	8	29	80	0.3625000
NODE_5882_length_1042_cov_23.861082	648	728	0	16	80	0.2000000
NODE_5882_length_1042_cov_23.861082	648	728	2	64	80	0.8000000
NODE_5882_length_1042_cov_23.861082	701	781	0	63	80	0.7875000
NODE_5882_length_1042_cov_23.861082	701	781	2	17	80	0.2125000
NODE_5883_length_1042_cov_22.247084	555	635	0	80	80	1.0000000
NODE_5883_length_1042_cov_22.247084	608	688	0	80	80	1.0000000
NODE_5884_length_1042_cov_22.117709	335	415	0	80	80	1.0000000
NODE_5884_length_1042_cov_22.117709	388	468	0	80	80	1.0000000
NODE_5884_length_1042_cov_22.117709	464	544	0	80	80	1.0000000
NODE_5884_length_1042_cov_22.117709	517	597	0	80	80	1.0000000
NODE_5885_length_1042_cov_16.831389	27	97	10	32	70	0.4571429
NODE_5885_length_1042_cov_16.831389	27	97	12	5	70	0.0714286
NODE_5885_length_1042_cov_16.831389	27	97	14	7	70	0.1000000
NODE_5885_length_1042_cov_16.831389	27	97	16	26	70	0.3714286
NODE_5885_length_1042_cov_16.831389	372	452	0	80	80	1.0000000
NODE_5885_length_1042_cov_16.831389	425	505	0	43	80	0.5375000
NODE_5885_length_1042_cov_16.831389	425	505	2	37	80	0.4625000
NODE_5886_length_1042_cov_16.662778	416	496	20	80	80	1.0000000
NODE_5886_length_1042_cov_16.662778	469	549	0	3	80	0.0375000
NODE_5886_length_1042_cov_16.662778	469	549	20	77	80	0.9625000
NODE_5887_length_1042_cov_9.474019	361	441	0	80	80	1.0000000
NODE_5887_length_1042_cov_9.474019	414	494	0	80	80	1.0000000
NODE_5888_length_1042_cov_6.725345	356	419	0	20	63	0.3174603
NODE_5888_length_1042_cov_6.725345	356	419	2	5	63	0.0793651
NODE_5888_length_1042_cov_6.725345	356	419	5	38	63	0.6031746
NODE_5888_length_1042_cov_6.725345	392	472	3	4	80	0.0500000
NODE_5888_length_1042_cov_6.725345	392	472	5	76	80	0.9500000
NODE_5896_length_1041_cov_42.960722	335	415	0	80	80	1.0000000
NODE_5896_length_1041_cov_42.960722	388	468	0	80	80	1.0000000
NODE_5896_length_1041_cov_42.960722	464	544	0	21	80	0.2625000
NODE_5896_length_1041_cov_42.960722	464	544	1	1	80	0.0125000
NODE_5896_length_1041_cov_42.960722	464	544	2	58	80	0.7250000
NODE_5896_length_1041_cov_42.960722	517	597	0	3	80	0.0375000
NODE_5896_length_1041_cov_42.960722	517	597	2	77	80	0.9625000
NODE_5897_length_1041_cov_37.331210	513	593	2	20	80	0.2500000
NODE_5897_length_1041_cov_37.331210	513	593	4	13	80	0.1625000
NODE_5897_length_1041_cov_37.331210	513	593	6	3	80	0.0375000
NODE_5897_length_1041_cov_37.331210	513	593	8	44	80	0.5500000
NODE_5897_length_1041_cov_37.331210	566	646	4	15	80	0.1875000
NODE_5897_length_1041_cov_37.331210	566	646	8	65	80	0.8125000
NODE_5897_length_1041_cov_37.331210	642	722	0	72	80	0.9000000
NODE_5897_length_1041_cov_37.331210	642	722	4	8	80	0.1000000
NODE_5897_length_1041_cov_37.331210	695	775	0	80	80	1.0000000
NODE_5898_length_1041_cov_36.477707	455	535	0	29	80	0.3625000
NODE_5898_length_1041_cov_36.477707	455	535	2	51	80	0.6375000
NODE_5898_length_1041_cov_36.477707	508	588	0	3	80	0.0375000
NODE_5898_length_1041_cov_36.477707	508	588	2	77	80	0.9625000
NODE_5898_length_1041_cov_36.477707	584	664	0	79	80	0.9875000
NODE_5898_length_1041_cov_36.477707	584	664	2	1	80	0.0125000
NODE_5898_length_1041_cov_36.477707	637	717	0	80	80	1.0000000
NODE_5898_length_1041_cov_36.477707	753	799	0	46	46	1.0000000
NODE_5899_length_1041_cov_19.286624	468	548	0	6	80	0.0750000
NODE_5899_length_1041_cov_19.286624	468	548	6	9	80	0.1125000
NODE_5899_length_1041_cov_19.286624	468	548	8	3	80	0.0375000
NODE_5899_length_1041_cov_19.286624	468	548	10	13	80	0.1625000
NODE_5899_length_1041_cov_19.286624	468	548	13	2	80	0.0250000
NODE_5899_length_1041_cov_19.286624	468	548	14	47	80	0.5875000
NODE_5899_length_1041_cov_19.286624	521	601	4	12	80	0.1500000
NODE_5899_length_1041_cov_19.286624	521	601	9	1	80	0.0125000
NODE_5899_length_1041_cov_19.286624	521	601	10	11	80	0.1375000
NODE_5899_length_1041_cov_19.286624	521	601	13	31	80	0.3875000
NODE_5899_length_1041_cov_19.286624	521	601	14	25	80	0.3125000
NODE_5900_length_1041_cov_17.072187	578	658	2	80	80	1.0000000
NODE_5900_length_1041_cov_17.072187	631	711	0	2	80	0.0250000
NODE_5900_length_1041_cov_17.072187	631	711	2	78	80	0.9750000
NODE_5901_length_1041_cov_11.887473	437	517	0	25	80	0.3125000
NODE_5901_length_1041_cov_11.887473	437	517	4	55	80	0.6875000
NODE_5901_length_1041_cov_11.887473	490	570	0	78	80	0.9750000
NODE_5901_length_1041_cov_11.887473	490	570	4	2	80	0.0250000
NODE_5902_length_1041_cov_6.957537	354	434	0	80	80	1.0000000
NODE_5902_length_1041_cov_6.957537	407	487	0	80	80	1.0000000
NODE_5913_length_1040_cov_34.618491	478	558	0	80	80	1.0000000
NODE_5913_length_1040_cov_34.618491	531	611	0	80	80	1.0000000
NODE_5914_length_1040_cov_33.061637	485	565	2	80	80	1.0000000
NODE_5914_length_1040_cov_33.061637	538	618	0	29	80	0.3625000
NODE_5914_length_1040_cov_33.061637	538	618	2	51	80	0.6375000
NODE_5915_length_1040_cov_27.818278	402	482	0	64	80	0.8000000
NODE_5915_length_1040_cov_27.818278	402	482	2	16	80	0.2000000
NODE_5915_length_1040_cov_27.818278	455	535	0	80	80	1.0000000
NODE_5916_length_1040_cov_17.933050	487	567	0	80	80	1.0000000
NODE_5916_length_1040_cov_17.933050	540	620	0	80	80	1.0000000
NODE_5917_length_1040_cov_14.327311	237	317	0	80	80	1.0000000
NODE_5917_length_1040_cov_14.327311	290	370	0	58	80	0.7250000
NODE_5917_length_1040_cov_14.327311	290	370	2	18	80	0.2250000
NODE_5917_length_1040_cov_14.327311	290	370	4	4	80	0.0500000
NODE_5917_length_1040_cov_14.327311	366	446	4	80	80	1.0000000
NODE_5917_length_1040_cov_14.327311	419	499	0	38	80	0.4750000
NODE_5917_length_1040_cov_14.327311	419	499	2	4	80	0.0500000
NODE_5917_length_1040_cov_14.327311	419	499	4	38	80	0.4750000
NODE_5918_length_1040_cov_11.910733	369	449	0	16	80	0.2000000
NODE_5918_length_1040_cov_11.910733	369	449	2	64	80	0.8000000
NODE_5918_length_1040_cov_11.910733	422	502	0	41	80	0.5125000
NODE_5918_length_1040_cov_11.910733	422	502	2	39	80	0.4875000
NODE_5919_length_1040_cov_11.521785	355	435	1	80	80	1.0000000
NODE_5919_length_1040_cov_11.521785	408	488	0	7	80	0.0875000
NODE_5919_length_1040_cov_11.521785	408	488	1	38	80	0.4750000
NODE_5919_length_1040_cov_11.521785	408	488	2	35	80	0.4375000
NODE_5920_length_1040_cov_9.573858	632	712	0	35	80	0.4375000
NODE_5920_length_1040_cov_9.573858	632	712	9	1	80	0.0125000
NODE_5920_length_1040_cov_9.573858	632	712	10	44	80	0.5500000
NODE_5920_length_1040_cov_9.573858	685	765	10	80	80	1.0000000
NODE_5921_length_1040_cov_8.148778	349	429	0	68	80	0.8500000
NODE_5921_length_1040_cov_8.148778	349	429	2	12	80	0.1500000
NODE_5921_length_1040_cov_8.148778	402	482	0	15	80	0.1875000
NODE_5921_length_1040_cov_8.148778	402	482	2	65	80	0.8125000
NODE_5922_length_1040_cov_7.927736	282	362	0	12	80	0.1500000
NODE_5922_length_1040_cov_7.927736	282	362	2	68	80	0.8500000
NODE_5922_length_1040_cov_7.927736	335	415	0	47	80	0.5875000
NODE_5922_length_1040_cov_7.927736	335	415	2	33	80	0.4125000
NODE_5927_length_1040_cov_2.317747	2	78	0	76	76	1.0000000
NODE_5934_length_1039_cov_40.150000	487	567	2	15	80	0.1875000
NODE_5934_length_1039_cov_40.150000	487	567	4	16	80	0.2000000
NODE_5934_length_1039_cov_40.150000	487	567	6	49	80	0.6125000
NODE_5934_length_1039_cov_40.150000	540	620	2	15	80	0.1875000
NODE_5934_length_1039_cov_40.150000	540	620	3	53	80	0.6625000
NODE_5934_length_1039_cov_40.150000	540	620	4	12	80	0.1500000
NODE_5934_length_1039_cov_40.150000	616	696	2	2	80	0.0250000
NODE_5934_length_1039_cov_40.150000	616	696	3	16	80	0.2000000
NODE_5934_length_1039_cov_40.150000	616	696	10	55	80	0.6875000
NODE_5934_length_1039_cov_40.150000	616	696	11	1	80	0.0125000
NODE_5934_length_1039_cov_40.150000	616	696	12	6	80	0.0750000
NODE_5934_length_1039_cov_40.150000	669	739	8	6	70	0.0857143
NODE_5934_length_1039_cov_40.150000	669	739	9	1	70	0.0142857
NODE_5934_length_1039_cov_40.150000	669	739	10	58	70	0.8285714
NODE_5934_length_1039_cov_40.150000	669	739	11	5	70	0.0714286
NODE_5935_length_1039_cov_37.940426	175	255	10	19	80	0.2375000
NODE_5935_length_1039_cov_37.940426	175	255	18	7	80	0.0875000
NODE_5935_length_1039_cov_37.940426	175	255	20	54	80	0.6750000
NODE_5935_length_1039_cov_37.940426	228	308	0	18	80	0.2250000
NODE_5935_length_1039_cov_37.940426	228	308	6	2	80	0.0250000
NODE_5935_length_1039_cov_37.940426	228	308	14	11	80	0.1375000
NODE_5935_length_1039_cov_37.940426	228	308	16	1	80	0.0125000
NODE_5935_length_1039_cov_37.940426	228	308	18	10	80	0.1250000
NODE_5935_length_1039_cov_37.940426	228	308	20	38	80	0.4750000
NODE_5935_length_1039_cov_37.940426	304	384	0	80	80	1.0000000
NODE_5935_length_1039_cov_37.940426	357	437	0	39	80	0.4875000
NODE_5935_length_1039_cov_37.940426	357	437	4	41	80	0.5125000
NODE_5936_length_1039_cov_24.567021	371	451	0	64	80	0.8000000
NODE_5936_length_1039_cov_24.567021	371	451	1	16	80	0.2000000
NODE_5936_length_1039_cov_24.567021	424	504	0	80	80	1.0000000
NODE_5937_length_1039_cov_15.790426	293	373	0	51	80	0.6375000
NODE_5937_length_1039_cov_15.790426	293	373	2	29	80	0.3625000
NODE_5937_length_1039_cov_15.790426	346	426	2	80	80	1.0000000
NODE_5938_length_1039_cov_14.670213	591	671	0	38	80	0.4750000
NODE_5938_length_1039_cov_14.670213	591	671	4	1	80	0.0125000
NODE_5938_length_1039_cov_14.670213	591	671	5	41	80	0.5125000
NODE_5938_length_1039_cov_14.670213	644	724	4	26	80	0.3250000
NODE_5938_length_1039_cov_14.670213	644	724	5	54	80	0.6750000
NODE_5939_length_1039_cov_11.568085	439	519	0	80	80	1.0000000
NODE_5939_length_1039_cov_11.568085	492	571	0	79	79	1.0000000
NODE_5947_length_1038_cov_17.191693	549	629	0	1	80	0.0125000
NODE_5947_length_1038_cov_17.191693	549	629	8	79	80	0.9875000
NODE_5947_length_1038_cov_17.191693	602	682	0	54	80	0.6750000
NODE_5947_length_1038_cov_17.191693	602	682	8	26	80	0.3250000
NODE_5948_length_1038_cov_13.520767	516	596	0	80	80	1.0000000
NODE_5948_length_1038_cov_13.520767	569	649	0	80	80	1.0000000
NODE_5949_length_1038_cov_10.541001	487	567	0	46	80	0.5750000
NODE_5949_length_1038_cov_10.541001	487	567	2	34	80	0.4250000
NODE_5949_length_1038_cov_10.541001	540	620	0	80	80	1.0000000
NODE_5950_length_1038_cov_8.826411	432	512	0	22	80	0.2750000
NODE_5950_length_1038_cov_8.826411	432	512	1	58	80	0.7250000
NODE_5950_length_1038_cov_8.826411	485	565	0	69	80	0.8625000
NODE_5950_length_1038_cov_8.826411	485	565	1	5	80	0.0625000
NODE_5950_length_1038_cov_8.826411	485	565	2	6	80	0.0750000
NODE_5952_length_1038_cov_2.587859	673	753	0	80	80	1.0000000
NODE_5952_length_1038_cov_2.587859	726	806	0	80	80	1.0000000
NODE_5963_length_1037_cov_66.968017	402	482	2	57	80	0.7125000
NODE_5963_length_1037_cov_66.968017	402	482	10	3	80	0.0375000
NODE_5963_length_1037_cov_66.968017	402	482	12	20	80	0.2500000
NODE_5963_length_1037_cov_66.968017	455	535	2	4	80	0.0500000
NODE_5963_length_1037_cov_66.968017	455	535	10	56	80	0.7000000
NODE_5963_length_1037_cov_66.968017	455	535	12	20	80	0.2500000
NODE_5964_length_1037_cov_53.639659	527	607	0	63	80	0.7875000
NODE_5964_length_1037_cov_53.639659	527	607	5	1	80	0.0125000
NODE_5964_length_1037_cov_53.639659	527	607	6	16	80	0.2000000
NODE_5964_length_1037_cov_53.639659	580	660	0	10	80	0.1250000
NODE_5964_length_1037_cov_53.639659	580	660	5	1	80	0.0125000
NODE_5964_length_1037_cov_53.639659	580	660	6	69	80	0.8625000
NODE_5965_length_1037_cov_45.353945	542	622	0	72	80	0.9000000
NODE_5965_length_1037_cov_45.353945	542	622	2	8	80	0.1000000
NODE_5965_length_1037_cov_45.353945	595	675	0	19	80	0.2375000
NODE_5965_length_1037_cov_45.353945	595	675	2	61	80	0.7625000
NODE_5966_length_1037_cov_31.078891	356	436	3	9	80	0.1125000
NODE_5966_length_1037_cov_31.078891	356	436	4	2	80	0.0250000
NODE_5966_length_1037_cov_31.078891	356	436	7	16	80	0.2000000
NODE_5966_length_1037_cov_31.078891	356	436	8	12	80	0.1500000
NODE_5966_length_1037_cov_31.078891	356	436	10	41	80	0.5125000
NODE_5966_length_1037_cov_31.078891	409	489	1	27	80	0.3375000
NODE_5966_length_1037_cov_31.078891	409	489	3	35	80	0.4375000
NODE_5966_length_1037_cov_31.078891	409	489	4	2	80	0.0250000
NODE_5966_length_1037_cov_31.078891	409	489	8	2	80	0.0250000
NODE_5966_length_1037_cov_31.078891	409	489	10	14	80	0.1750000
NODE_5967_length_1037_cov_25.453092	421	501	2	62	80	0.7750000
NODE_5967_length_1037_cov_25.453092	421	501	4	18	80	0.2250000
NODE_5967_length_1037_cov_25.453092	474	554	0	21	80	0.2625000
NODE_5967_length_1037_cov_25.453092	474	554	2	50	80	0.6250000
NODE_5967_length_1037_cov_25.453092	474	554	4	9	80	0.1125000
NODE_5967_length_1037_cov_25.453092	550	573	0	23	23	1.0000000
NODE_5968_length_1037_cov_13.740938	348	428	2	80	80	1.0000000
NODE_5968_length_1037_cov_13.740938	401	481	0	37	80	0.4625000
NODE_5968_length_1037_cov_13.740938	401	481	2	43	80	0.5375000
NODE_5969_length_1037_cov_12.632196	564	644	5	1	80	0.0125000
NODE_5969_length_1037_cov_12.632196	564	644	6	19	80	0.2375000
NODE_5969_length_1037_cov_12.632196	564	644	8	60	80	0.7500000
NODE_5969_length_1037_cov_12.632196	617	697	0	53	80	0.6625000
NODE_5969_length_1037_cov_12.632196	617	697	5	1	80	0.0125000
NODE_5969_length_1037_cov_12.632196	617	697	6	19	80	0.2375000
NODE_5969_length_1037_cov_12.632196	617	697	8	7	80	0.0875000
NODE_5970_length_1037_cov_8.904051	640	720	0	80	80	1.0000000
NODE_5970_length_1037_cov_8.904051	693	773	0	80	80	1.0000000
NODE_5978_length_1037_cov_1.859275	31	91	0	60	60	1.0000000
NODE_5986_length_1036_cov_52.270011	493	573	0	80	80	1.0000000
NODE_5986_length_1036_cov_52.270011	546	626	0	80	80	1.0000000
NODE_5987_length_1036_cov_24.080043	369	449	0	43	80	0.5375000
NODE_5987_length_1036_cov_24.080043	369	449	2	37	80	0.4625000
NODE_5987_length_1036_cov_24.080043	422	502	0	17	80	0.2125000
NODE_5987_length_1036_cov_24.080043	422	502	2	63	80	0.7875000
NODE_5988_length_1036_cov_20.533618	513	593	0	80	80	1.0000000
NODE_5988_length_1036_cov_20.533618	566	645	0	79	79	1.0000000
NODE_5988_length_1036_cov_20.533618	648	728	0	80	80	1.0000000
NODE_5988_length_1036_cov_20.533618	701	781	0	80	80	1.0000000
NODE_5989_length_1036_cov_19.715048	467	547	2	25	80	0.3125000
NODE_5989_length_1036_cov_19.715048	467	547	4	55	80	0.6875000
NODE_5989_length_1036_cov_19.715048	520	600	2	76	80	0.9500000
NODE_5989_length_1036_cov_19.715048	520	600	4	4	80	0.0500000
NODE_5990_length_1036_cov_19.452508	399	479	0	80	80	1.0000000
NODE_5990_length_1036_cov_19.452508	452	532	0	80	80	1.0000000
NODE_5990_length_1036_cov_19.452508	528	608	0	22	80	0.2750000
NODE_5990_length_1036_cov_19.452508	528	608	1	20	80	0.2500000
NODE_5990_length_1036_cov_19.452508	528	608	2	38	80	0.4750000
NODE_5990_length_1036_cov_19.452508	581	661	2	80	80	1.0000000
NODE_5991_length_1036_cov_13.840982	635	715	1	4	80	0.0500000
NODE_5991_length_1036_cov_13.840982	635	715	2	13	80	0.1625000
NODE_5991_length_1036_cov_13.840982	635	715	3	2	80	0.0250000
NODE_5991_length_1036_cov_13.840982	635	715	4	61	80	0.7625000
NODE_5991_length_1036_cov_13.840982	688	768	3	20	80	0.2500000
NODE_5991_length_1036_cov_13.840982	688	768	4	60	80	0.7500000
NODE_5992_length_1036_cov_6.913554	424	504	0	61	80	0.7625000
NODE_5992_length_1036_cov_6.913554	424	504	1	19	80	0.2375000
NODE_5992_length_1036_cov_6.913554	477	557	0	80	80	1.0000000
NODE_5993_length_1036_cov_5.880470	436	516	0	80	80	1.0000000
NODE_5993_length_1036_cov_5.880470	489	569	0	80	80	1.0000000
NODE_5994_length_1036_cov_4.638207	531	611	0	6	80	0.0750000
NODE_5994_length_1036_cov_4.638207	531	611	2	74	80	0.9250000
NODE_5994_length_1036_cov_4.638207	584	664	0	45	80	0.5625000
NODE_5994_length_1036_cov_4.638207	584	664	2	35	80	0.4375000
NODE_5998_length_1036_cov_1.293490	19	69	0	50	50	1.0000000
NODE_6001_length_1035_cov_31.941239	590	670	0	80	80	1.0000000
NODE_6001_length_1035_cov_31.941239	643	723	0	80	80	1.0000000
NODE_6002_length_1035_cov_14.917735	396	476	0	80	80	1.0000000
NODE_6002_length_1035_cov_14.917735	449	529	0	80	80	1.0000000
NODE_6003_length_1035_cov_12.552350	467	547	2	80	80	1.0000000
NODE_6003_length_1035_cov_12.552350	520	600	0	44	80	0.5500000
NODE_6003_length_1035_cov_12.552350	520	600	1	1	80	0.0125000
NODE_6003_length_1035_cov_12.552350	520	600	2	35	80	0.4375000
NODE_6004_length_1035_cov_12.050214	40	103	0	63	63	1.0000000
NODE_6004_length_1035_cov_12.050214	138	219	0	3	81	0.0370370
NODE_6004_length_1035_cov_12.050214	138	219	2	11	81	0.1358025
NODE_6004_length_1035_cov_12.050214	138	219	4	20	81	0.2469136
NODE_6004_length_1035_cov_12.050214	138	219	6	47	81	0.5802469
NODE_6005_length_1035_cov_7.020299	350	430	0	18	80	0.2250000
NODE_6005_length_1035_cov_7.020299	350	430	2	62	80	0.7750000
NODE_6005_length_1035_cov_7.020299	403	483	0	6	80	0.0750000
NODE_6005_length_1035_cov_7.020299	403	483	2	74	80	0.9250000
NODE_6006_length_1035_cov_4.726496	531	611	0	80	80	1.0000000
NODE_6006_length_1035_cov_4.726496	584	664	0	80	80	1.0000000
NODE_6018_length_1034_cov_26.810695	322	402	1	46	80	0.5750000
NODE_6018_length_1034_cov_26.810695	322	402	2	17	80	0.2125000
NODE_6018_length_1034_cov_26.810695	322	402	3	14	80	0.1750000
NODE_6018_length_1034_cov_26.810695	322	402	4	3	80	0.0375000
NODE_6018_length_1034_cov_26.810695	375	455	1	6	80	0.0750000
NODE_6018_length_1034_cov_26.810695	375	455	2	60	80	0.7500000
NODE_6018_length_1034_cov_26.810695	375	455	3	14	80	0.1750000
NODE_6018_length_1034_cov_26.810695	451	531	0	43	80	0.5375000
NODE_6018_length_1034_cov_26.810695	451	531	2	37	80	0.4625000
NODE_6018_length_1034_cov_26.810695	504	584	0	80	80	1.0000000
NODE_6032_length_1033_cov_42.574946	462	542	0	80	80	1.0000000
NODE_6032_length_1033_cov_42.574946	515	595	0	80	80	1.0000000
NODE_6033_length_1033_cov_17.073876	464	544	0	80	80	1.0000000
NODE_6033_length_1033_cov_17.073876	517	597	0	80	80	1.0000000
NODE_6034_length_1033_cov_15.791221	309	386	0	77	77	1.0000000
NODE_6034_length_1033_cov_15.791221	359	439	0	80	80	1.0000000
NODE_6035_length_1033_cov_11.340471	437	517	0	80	80	1.0000000
NODE_6035_length_1033_cov_11.340471	490	570	0	80	80	1.0000000
NODE_6045_length_1032_cov_56.511254	466	546	11	21	80	0.2625000
NODE_6045_length_1032_cov_56.511254	466	546	12	41	80	0.5125000
NODE_6045_length_1032_cov_56.511254	466	546	14	18	80	0.2250000
NODE_6045_length_1032_cov_56.511254	519	599	1	10	80	0.1250000
NODE_6045_length_1032_cov_56.511254	519	599	3	37	80	0.4625000
NODE_6045_length_1032_cov_56.511254	519	599	4	3	80	0.0375000
NODE_6045_length_1032_cov_56.511254	519	599	12	9	80	0.1125000
NODE_6045_length_1032_cov_56.511254	519	599	13	1	80	0.0125000
NODE_6045_length_1032_cov_56.511254	519	599	14	20	80	0.2500000
NODE_6046_length_1032_cov_20.752412	479	559	0	30	80	0.3750000
NODE_6046_length_1032_cov_20.752412	479	559	1	8	80	0.1000000
NODE_6046_length_1032_cov_20.752412	479	559	2	6	80	0.0750000
NODE_6046_length_1032_cov_20.752412	479	559	3	8	80	0.1000000
NODE_6046_length_1032_cov_20.752412	479	559	4	5	80	0.0625000
NODE_6046_length_1032_cov_20.752412	479	559	6	23	80	0.2875000
NODE_6046_length_1032_cov_20.752412	532	612	2	11	80	0.1375000
NODE_6046_length_1032_cov_20.752412	532	612	4	17	80	0.2125000
NODE_6046_length_1032_cov_20.752412	532	612	6	52	80	0.6500000
NODE_6047_length_1032_cov_8.166131	257	337	0	80	80	1.0000000
NODE_6047_length_1032_cov_8.166131	310	390	0	80	80	1.0000000
NODE_6048_length_1032_cov_7.991426	277	357	0	6	80	0.0750000
NODE_6048_length_1032_cov_7.991426	277	357	2	74	80	0.9250000
NODE_6048_length_1032_cov_7.991426	330	410	0	59	80	0.7375000
NODE_6048_length_1032_cov_7.991426	330	410	2	21	80	0.2625000
NODE_6049_length_1032_cov_5.276527	371	451	0	80	80	1.0000000
NODE_6049_length_1032_cov_5.276527	424	504	0	75	80	0.9375000
NODE_6049_length_1032_cov_5.276527	424	504	2	5	80	0.0625000
NODE_6055_length_1031_cov_71.154506	586	654	42	35	68	0.5147059
NODE_6055_length_1031_cov_71.154506	586	654	46	33	68	0.4852941
NODE_6055_length_1031_cov_71.154506	616	696	41	17	80	0.2125000
NODE_6055_length_1031_cov_71.154506	616	696	42	5	80	0.0625000
NODE_6055_length_1031_cov_71.154506	616	696	43	21	80	0.2625000
NODE_6055_length_1031_cov_71.154506	616	696	45	1	80	0.0125000
NODE_6055_length_1031_cov_71.154506	616	696	46	36	80	0.4500000
NODE_6055_length_1031_cov_71.154506	669	749	2	18	80	0.2250000
NODE_6055_length_1031_cov_71.154506	669	749	5	1	80	0.0125000
NODE_6055_length_1031_cov_71.154506	669	749	6	1	80	0.0125000
NODE_6055_length_1031_cov_71.154506	669	749	21	1	80	0.0125000
NODE_6055_length_1031_cov_71.154506	669	749	23	12	80	0.1500000
NODE_6055_length_1031_cov_71.154506	669	749	24	2	80	0.0250000
NODE_6055_length_1031_cov_71.154506	669	749	25	3	80	0.0375000
NODE_6055_length_1031_cov_71.154506	669	749	40	1	80	0.0125000
NODE_6055_length_1031_cov_71.154506	669	749	41	31	80	0.3875000
NODE_6055_length_1031_cov_71.154506	669	749	43	10	80	0.1250000
NODE_6056_length_1031_cov_70.221030	409	489	18	29	80	0.3625000
NODE_6056_length_1031_cov_70.221030	409	489	20	38	80	0.4750000
NODE_6056_length_1031_cov_70.221030	409	489	21	6	80	0.0750000
NODE_6056_length_1031_cov_70.221030	409	489	23	2	80	0.0250000
NODE_6056_length_1031_cov_70.221030	409	489	24	3	80	0.0375000
NODE_6056_length_1031_cov_70.221030	409	489	25	2	80	0.0250000
NODE_6056_length_1031_cov_70.221030	462	542	1	9	80	0.1125000
NODE_6056_length_1031_cov_70.221030	462	542	2	8	80	0.1000000
NODE_6056_length_1031_cov_70.221030	462	542	17	4	80	0.0500000
NODE_6056_length_1031_cov_70.221030	462	542	18	16	80	0.2000000
NODE_6056_length_1031_cov_70.221030	462	542	19	30	80	0.3750000
NODE_6056_length_1031_cov_70.221030	462	542	20	13	80	0.1625000
NODE_6056_length_1031_cov_70.221030	538	618	2	80	80	1.0000000
NODE_6056_length_1031_cov_70.221030	591	671	2	49	80	0.6125000
NODE_6056_length_1031_cov_70.221030	591	671	3	6	80	0.0750000
NODE_6056_length_1031_cov_70.221030	591	671	4	1	80	0.0125000
NODE_6056_length_1031_cov_70.221030	591	671	5	24	80	0.3000000
NODE_6057_length_1031_cov_43.618026	462	542	16	80	80	1.0000000
NODE_6057_length_1031_cov_43.618026	515	595	0	15	80	0.1875000
NODE_6057_length_1031_cov_43.618026	515	595	15	15	80	0.1875000
NODE_6057_length_1031_cov_43.618026	515	595	16	50	80	0.6250000
NODE_6058_length_1031_cov_43.581545	303	383	0	24	80	0.3000000
NODE_6058_length_1031_cov_43.581545	303	383	2	56	80	0.7000000
NODE_6058_length_1031_cov_43.581545	356	436	0	39	80	0.4875000
NODE_6058_length_1031_cov_43.581545	356	436	2	41	80	0.5125000
NODE_6058_length_1031_cov_43.581545	432	512	0	80	80	1.0000000
NODE_6058_length_1031_cov_43.581545	485	565	0	80	80	1.0000000
NODE_6059_length_1031_cov_22.310086	382	462	0	2	80	0.0250000
NODE_6059_length_1031_cov_22.310086	382	462	2	78	80	0.9750000
NODE_6059_length_1031_cov_22.310086	435	515	0	6	80	0.0750000
NODE_6059_length_1031_cov_22.310086	435	515	2	74	80	0.9250000
NODE_6060_length_1031_cov_11.547210	481	561	0	80	80	1.0000000
NODE_6060_length_1031_cov_11.547210	534	614	0	80	80	1.0000000
NODE_6066_length_1030_cov_54.380236	363	443	0	80	80	1.0000000
NODE_6066_length_1030_cov_54.380236	416	496	0	80	80	1.0000000
NODE_6066_length_1030_cov_54.380236	492	572	0	80	80	1.0000000
NODE_6066_length_1030_cov_54.380236	545	625	0	80	80	1.0000000
NODE_6067_length_1030_cov_45.040816	334	414	0	12	80	0.1500000
NODE_6067_length_1030_cov_45.040816	334	414	8	33	80	0.4125000
NODE_6067_length_1030_cov_45.040816	334	414	10	35	80	0.4375000
NODE_6067_length_1030_cov_45.040816	387	467	0	65	80	0.8125000
NODE_6067_length_1030_cov_45.040816	387	467	8	15	80	0.1875000
NODE_6067_length_1030_cov_45.040816	463	543	0	54	80	0.6750000
NODE_6067_length_1030_cov_45.040816	463	543	1	18	80	0.2250000
NODE_6067_length_1030_cov_45.040816	463	543	5	8	80	0.1000000
NODE_6067_length_1030_cov_45.040816	516	596	0	1	80	0.0125000
NODE_6067_length_1030_cov_45.040816	516	596	1	18	80	0.2250000
NODE_6067_length_1030_cov_45.040816	516	596	5	33	80	0.4125000
NODE_6067_length_1030_cov_45.040816	516	596	6	9	80	0.1125000
NODE_6067_length_1030_cov_45.040816	516	596	10	19	80	0.2375000
NODE_6068_length_1030_cov_20.491944	511	591	0	56	80	0.7000000
NODE_6068_length_1030_cov_20.491944	511	591	2	24	80	0.3000000
NODE_6068_length_1030_cov_20.491944	564	644	0	3	80	0.0375000
NODE_6068_length_1030_cov_20.491944	564	644	2	77	80	0.9625000
NODE_6069_length_1030_cov_17.253491	524	604	0	80	80	1.0000000
NODE_6069_length_1030_cov_17.253491	577	657	0	57	80	0.7125000
NODE_6069_length_1030_cov_17.253491	577	657	2	23	80	0.2875000
NODE_6070_length_1030_cov_14.337272	564	644	1	26	80	0.3250000
NODE_6070_length_1030_cov_14.337272	564	644	2	54	80	0.6750000
NODE_6070_length_1030_cov_14.337272	617	697	1	16	80	0.2000000
NODE_6070_length_1030_cov_14.337272	617	697	2	64	80	0.8000000
NODE_6071_length_1030_cov_5.742213	474	554	0	80	80	1.0000000
NODE_6071_length_1030_cov_5.742213	527	607	0	80	80	1.0000000
NODE_6073_length_1030_cov_5.208378	978	1030	2	17	52	0.3269231
NODE_6073_length_1030_cov_5.208378	978	1030	4	10	52	0.1923077
NODE_6073_length_1030_cov_5.208378	978	1030	6	3	52	0.0576923
NODE_6073_length_1030_cov_5.208378	978	1030	8	22	52	0.4230769
NODE_6077_length_1030_cov_2.146079	979	1010	0	31	31	1.0000000
NODE_6083_length_1029_cov_236.527957	584	666	2	16	82	0.1951219
NODE_6083_length_1029_cov_236.527957	584	666	6	4	82	0.0487805
NODE_6083_length_1029_cov_236.527957	584	666	7	2	82	0.0243902
NODE_6083_length_1029_cov_236.527957	584	666	9	7	82	0.0853659
NODE_6083_length_1029_cov_236.527957	584	666	10	2	82	0.0243902
NODE_6083_length_1029_cov_236.527957	584	666	12	7	82	0.0853659
NODE_6083_length_1029_cov_236.527957	584	666	19	2	82	0.0243902
NODE_6083_length_1029_cov_236.527957	584	666	20	42	82	0.5121951
NODE_6083_length_1029_cov_236.527957	639	702	13	17	63	0.2698413
NODE_6083_length_1029_cov_236.527957	639	702	14	7	63	0.1111111
NODE_6083_length_1029_cov_236.527957	639	702	18	1	63	0.0158730
NODE_6083_length_1029_cov_236.527957	639	702	19	13	63	0.2063492
NODE_6083_length_1029_cov_236.527957	639	702	20	25	63	0.3968254
NODE_6084_length_1029_cov_41.650538	364	444	0	80	80	1.0000000
NODE_6084_length_1029_cov_41.650538	417	497	0	80	80	1.0000000
NODE_6084_length_1029_cov_41.650538	493	573	0	20	80	0.2500000
NODE_6084_length_1029_cov_41.650538	493	573	2	60	80	0.7500000
NODE_6084_length_1029_cov_41.650538	546	626	0	40	80	0.5000000
NODE_6084_length_1029_cov_41.650538	546	626	2	40	80	0.5000000
NODE_6085_length_1029_cov_34.940860	314	360	0	46	46	1.0000000
NODE_6085_length_1029_cov_34.940860	371	451	0	80	80	1.0000000
NODE_6085_length_1029_cov_34.940860	424	502	0	78	78	1.0000000
NODE_6086_length_1029_cov_28.752688	255	335	0	10	80	0.1250000
NODE_6086_length_1029_cov_28.752688	255	335	12	70	80	0.8750000
NODE_6086_length_1029_cov_28.752688	308	388	0	63	80	0.7875000
NODE_6086_length_1029_cov_28.752688	308	388	12	17	80	0.2125000
NODE_6086_length_1029_cov_28.752688	384	464	0	20	80	0.2500000
NODE_6086_length_1029_cov_28.752688	384	464	2	60	80	0.7500000
NODE_6086_length_1029_cov_28.752688	437	517	2	69	80	0.8625000
NODE_6086_length_1029_cov_28.752688	437	517	4	11	80	0.1375000
NODE_6087_length_1029_cov_28.523656	409	489	0	5	80	0.0625000
NODE_6087_length_1029_cov_28.523656	409	489	5	1	80	0.0125000
NODE_6087_length_1029_cov_28.523656	409	489	6	74	80	0.9250000
NODE_6087_length_1029_cov_28.523656	462	542	0	38	80	0.4750000
NODE_6087_length_1029_cov_28.523656	462	542	6	42	80	0.5250000
NODE_6088_length_1029_cov_28.283871	281	361	0	80	80	1.0000000
NODE_6088_length_1029_cov_28.283871	334	414	0	80	80	1.0000000
NODE_6088_length_1029_cov_28.283871	410	490	0	80	80	1.0000000
NODE_6088_length_1029_cov_28.283871	463	546	0	32	83	0.3855422
NODE_6088_length_1029_cov_28.283871	463	546	4	51	83	0.6144578
NODE_6089_length_1029_cov_26.883871	434	514	0	19	80	0.2375000
NODE_6089_length_1029_cov_26.883871	434	514	2	61	80	0.7625000
NODE_6089_length_1029_cov_26.883871	487	567	0	72	80	0.9000000
NODE_6089_length_1029_cov_26.883871	487	567	2	8	80	0.1000000
NODE_6090_length_1029_cov_23.552688	305	385	0	52	80	0.6500000
NODE_6090_length_1029_cov_23.552688	305	385	2	28	80	0.3500000
NODE_6090_length_1029_cov_23.552688	358	438	2	80	80	1.0000000
NODE_6090_length_1029_cov_23.552688	434	514	0	48	80	0.6000000
NODE_6090_length_1029_cov_23.552688	434	514	2	32	80	0.4000000
NODE_6090_length_1029_cov_23.552688	487	567	0	80	80	1.0000000
NODE_6091_length_1029_cov_22.520430	434	514	0	15	80	0.1875000
NODE_6091_length_1029_cov_22.520430	434	514	2	65	80	0.8125000
NODE_6091_length_1029_cov_22.520430	487	567	0	68	80	0.8500000
NODE_6091_length_1029_cov_22.520430	487	567	2	12	80	0.1500000
NODE_6092_length_1029_cov_21.924731	335	415	0	80	80	1.0000000
NODE_6092_length_1029_cov_21.924731	388	468	0	80	80	1.0000000
NODE_6093_length_1029_cov_17.101075	501	581	0	18	80	0.2250000
NODE_6093_length_1029_cov_17.101075	501	581	2	62	80	0.7750000
NODE_6093_length_1029_cov_17.101075	554	634	0	14	80	0.1750000
NODE_6093_length_1029_cov_17.101075	554	634	2	66	80	0.8250000
NODE_6093_length_1029_cov_17.101075	630	710	0	33	80	0.4125000
NODE_6093_length_1029_cov_17.101075	630	710	2	9	80	0.1125000
NODE_6093_length_1029_cov_17.101075	630	710	4	1	80	0.0125000
NODE_6093_length_1029_cov_17.101075	630	710	5	7	80	0.0875000
NODE_6093_length_1029_cov_17.101075	630	710	8	30	80	0.3750000
NODE_6093_length_1029_cov_17.101075	683	755	6	7	72	0.0972222
NODE_6093_length_1029_cov_17.101075	683	755	8	65	72	0.9027778
NODE_6094_length_1029_cov_14.052688	405	485	0	80	80	1.0000000
NODE_6094_length_1029_cov_14.052688	458	538	0	80	80	1.0000000
NODE_6095_length_1029_cov_11.119355	291	369	0	78	78	1.0000000
NODE_6095_length_1029_cov_11.119355	342	422	0	80	80	1.0000000
NODE_6097_length_1029_cov_3.850538	231	311	0	20	80	0.2500000
NODE_6097_length_1029_cov_3.850538	231	311	2	60	80	0.7500000
NODE_6097_length_1029_cov_3.850538	284	364	0	73	80	0.9125000
NODE_6097_length_1029_cov_3.850538	284	364	2	7	80	0.0875000
NODE_6104_length_1028_cov_19.625404	495	575	0	80	80	1.0000000
NODE_6104_length_1028_cov_19.625404	548	628	0	80	80	1.0000000
NODE_6105_length_1028_cov_17.497309	533	613	0	80	80	1.0000000
NODE_6105_length_1028_cov_17.497309	586	666	0	80	80	1.0000000
NODE_6106_length_1028_cov_16.528525	497	577	0	57	80	0.7125000
NODE_6106_length_1028_cov_16.528525	497	577	2	23	80	0.2875000
NODE_6106_length_1028_cov_16.528525	550	630	0	4	80	0.0500000
NODE_6106_length_1028_cov_16.528525	550	630	2	76	80	0.9500000
NODE_6107_length_1028_cov_10.212056	463	543	0	80	80	1.0000000
NODE_6107_length_1028_cov_10.212056	516	596	0	80	80	1.0000000
NODE_6108_length_1028_cov_10.131324	399	479	0	50	80	0.6250000
NODE_6108_length_1028_cov_10.131324	399	479	1	12	80	0.1500000
NODE_6108_length_1028_cov_10.131324	399	479	2	18	80	0.2250000
NODE_6108_length_1028_cov_10.131324	452	532	0	80	80	1.0000000
NODE_6109_length_1028_cov_9.773950	482	562	0	80	80	1.0000000
NODE_6109_length_1028_cov_9.773950	535	615	0	80	80	1.0000000
NODE_6110_length_1028_cov_8.079656	399	479	0	65	80	0.8125000
NODE_6110_length_1028_cov_8.079656	399	479	2	15	80	0.1875000
NODE_6110_length_1028_cov_8.079656	452	532	0	12	80	0.1500000
NODE_6110_length_1028_cov_8.079656	452	532	2	68	80	0.8500000
NODE_6111_length_1028_cov_7.092573	439	519	0	34	80	0.4250000
NODE_6111_length_1028_cov_7.092573	439	519	2	3	80	0.0375000
NODE_6111_length_1028_cov_7.092573	439	519	4	43	80	0.5375000
NODE_6111_length_1028_cov_7.092573	492	572	0	10	80	0.1250000
NODE_6111_length_1028_cov_7.092573	492	572	2	7	80	0.0875000
NODE_6111_length_1028_cov_7.092573	492	572	4	63	80	0.7875000
NODE_6112_length_1028_cov_4.727664	416	488	0	72	72	1.0000000
NODE_6112_length_1028_cov_4.727664	461	541	0	80	80	1.0000000
NODE_6125_length_1027_cov_51.341595	399	479	0	80	80	1.0000000
NODE_6125_length_1027_cov_51.341595	452	532	0	80	80	1.0000000
NODE_6125_length_1027_cov_51.341595	528	608	0	80	80	1.0000000
NODE_6125_length_1027_cov_51.341595	581	661	0	80	80	1.0000000
NODE_6126_length_1027_cov_45.613147	347	427	2	80	80	1.0000000
NODE_6126_length_1027_cov_45.613147	400	480	0	53	80	0.6625000
NODE_6126_length_1027_cov_45.613147	400	480	2	27	80	0.3375000
NODE_6126_length_1027_cov_45.613147	476	556	0	77	80	0.9625000
NODE_6126_length_1027_cov_45.613147	476	556	2	3	80	0.0375000
NODE_6126_length_1027_cov_45.613147	529	609	0	24	80	0.3000000
NODE_6126_length_1027_cov_45.613147	529	609	2	56	80	0.7000000
NODE_6127_length_1027_cov_35.435345	431	511	4	6	80	0.0750000
NODE_6127_length_1027_cov_35.435345	431	511	6	51	80	0.6375000
NODE_6127_length_1027_cov_35.435345	431	511	8	23	80	0.2875000
NODE_6127_length_1027_cov_35.435345	484	564	0	20	80	0.2500000
NODE_6127_length_1027_cov_35.435345	484	564	4	11	80	0.1375000
NODE_6127_length_1027_cov_35.435345	484	564	6	49	80	0.6125000
NODE_6135_length_1026_cov_39.737864	374	454	1	64	80	0.8000000
NODE_6135_length_1026_cov_39.737864	374	454	5	16	80	0.2000000
NODE_6135_length_1026_cov_39.737864	427	509	1	11	82	0.1341463
NODE_6135_length_1026_cov_39.737864	427	509	5	71	82	0.8658537
NODE_6135_length_1026_cov_39.737864	505	585	0	17	80	0.2125000
NODE_6135_length_1026_cov_39.737864	505	585	1	25	80	0.3125000
NODE_6135_length_1026_cov_39.737864	505	585	4	21	80	0.2625000
NODE_6135_length_1026_cov_39.737864	505	585	5	17	80	0.2125000
NODE_6135_length_1026_cov_39.737864	558	638	0	2	80	0.0250000
NODE_6135_length_1026_cov_39.737864	558	638	1	51	80	0.6375000
NODE_6135_length_1026_cov_39.737864	558	638	3	27	80	0.3375000
NODE_6136_length_1026_cov_26.400216	423	503	0	80	80	1.0000000
NODE_6136_length_1026_cov_26.400216	476	556	0	80	80	1.0000000
NODE_6137_length_1026_cov_25.325782	477	557	0	13	80	0.1625000
NODE_6137_length_1026_cov_25.325782	477	557	4	67	80	0.8375000
NODE_6137_length_1026_cov_25.325782	530	610	0	28	80	0.3500000
NODE_6137_length_1026_cov_25.325782	530	610	4	52	80	0.6500000
NODE_6137_length_1026_cov_25.325782	606	686	0	80	80	1.0000000
NODE_6137_length_1026_cov_25.325782	659	739	0	80	80	1.0000000
NODE_6138_length_1026_cov_22.218986	408	488	0	32	80	0.4000000
NODE_6138_length_1026_cov_22.218986	408	488	2	48	80	0.6000000
NODE_6138_length_1026_cov_22.218986	461	541	0	76	80	0.9500000
NODE_6138_length_1026_cov_22.218986	461	541	2	4	80	0.0500000
NODE_6138_length_1026_cov_22.218986	537	617	0	80	80	1.0000000
NODE_6138_length_1026_cov_22.218986	590	670	0	80	80	1.0000000
NODE_6139_length_1026_cov_15.640777	450	530	0	16	80	0.2000000
NODE_6139_length_1026_cov_15.640777	450	530	4	64	80	0.8000000
NODE_6139_length_1026_cov_15.640777	503	583	0	9	80	0.1125000
NODE_6139_length_1026_cov_15.640777	503	583	2	40	80	0.5000000
NODE_6139_length_1026_cov_15.640777	503	583	4	31	80	0.3875000
NODE_6140_length_1026_cov_12.062567	165	245	0	23	80	0.2875000
NODE_6140_length_1026_cov_12.062567	165	245	1	14	80	0.1750000
NODE_6140_length_1026_cov_12.062567	165	245	2	43	80	0.5375000
NODE_6140_length_1026_cov_12.062567	218	298	2	80	80	1.0000000
NODE_6142_length_1026_cov_5.002157	335	415	0	80	80	1.0000000
NODE_6142_length_1026_cov_5.002157	388	468	0	80	80	1.0000000
NODE_6155_length_1025_cov_52.053996	366	446	0	56	80	0.7000000
NODE_6155_length_1025_cov_52.053996	366	446	2	24	80	0.3000000
NODE_6155_length_1025_cov_52.053996	419	499	0	3	80	0.0375000
NODE_6155_length_1025_cov_52.053996	419	499	2	42	80	0.5250000
NODE_6155_length_1025_cov_52.053996	419	499	3	25	80	0.3125000
NODE_6155_length_1025_cov_52.053996	419	499	4	10	80	0.1250000
NODE_6155_length_1025_cov_52.053996	495	575	2	35	80	0.4375000
NODE_6155_length_1025_cov_52.053996	495	575	4	20	80	0.2500000
NODE_6155_length_1025_cov_52.053996	495	575	7	1	80	0.0125000
NODE_6155_length_1025_cov_52.053996	495	575	8	24	80	0.3000000
NODE_6155_length_1025_cov_52.053996	548	628	2	2	80	0.0250000
NODE_6155_length_1025_cov_52.053996	548	628	7	15	80	0.1875000
NODE_6155_length_1025_cov_52.053996	548	628	8	63	80	0.7875000
NODE_6156_length_1025_cov_35.980562	318	375	6	42	57	0.7368421
NODE_6156_length_1025_cov_35.980562	318	375	8	3	57	0.0526316
NODE_6156_length_1025_cov_35.980562	318	375	15	1	57	0.0175439
NODE_6156_length_1025_cov_35.980562	318	375	16	11	57	0.1929825
NODE_6156_length_1025_cov_35.980562	348	428	6	12	80	0.1500000
NODE_6156_length_1025_cov_35.980562	348	428	8	3	80	0.0375000
NODE_6156_length_1025_cov_35.980562	348	428	10	41	80	0.5125000
NODE_6156_length_1025_cov_35.980562	348	428	15	1	80	0.0125000
NODE_6156_length_1025_cov_35.980562	348	428	16	23	80	0.2875000
NODE_6156_length_1025_cov_35.980562	425	482	0	11	57	0.1929825
NODE_6156_length_1025_cov_35.980562	425	482	7	13	57	0.2280702
NODE_6156_length_1025_cov_35.980562	425	482	9	7	57	0.1228070
NODE_6156_length_1025_cov_35.980562	425	482	10	26	57	0.4561403
NODE_6156_length_1025_cov_35.980562	455	521	0	50	66	0.7575758
NODE_6156_length_1025_cov_35.980562	455	521	7	13	66	0.1969697
NODE_6156_length_1025_cov_35.980562	455	521	9	3	66	0.0454545
NODE_6157_length_1025_cov_26.954644	607	687	0	80	80	1.0000000
NODE_6157_length_1025_cov_26.954644	660	740	0	64	80	0.8000000
NODE_6157_length_1025_cov_26.954644	660	740	2	16	80	0.2000000
NODE_6158_length_1025_cov_20.576674	428	508	0	80	80	1.0000000
NODE_6158_length_1025_cov_20.576674	481	561	0	80	80	1.0000000
NODE_6159_length_1025_cov_15.525918	415	495	3	47	80	0.5875000
NODE_6159_length_1025_cov_15.525918	415	495	4	33	80	0.4125000
NODE_6159_length_1025_cov_15.525918	468	548	0	17	80	0.2125000
NODE_6159_length_1025_cov_15.525918	468	548	1	1	80	0.0125000
NODE_6159_length_1025_cov_15.525918	468	548	2	1	80	0.0125000
NODE_6159_length_1025_cov_15.525918	468	548	3	61	80	0.7625000
NODE_6160_length_1025_cov_7.044276	240	320	0	80	80	1.0000000
NODE_6161_length_1025_cov_6.688985	334	414	0	9	80	0.1125000
NODE_6161_length_1025_cov_6.688985	334	414	4	48	80	0.6000000
NODE_6161_length_1025_cov_6.688985	334	414	6	2	80	0.0250000
NODE_6161_length_1025_cov_6.688985	334	414	10	21	80	0.2625000
NODE_6161_length_1025_cov_6.688985	387	467	4	4	80	0.0500000
NODE_6161_length_1025_cov_6.688985	387	467	6	12	80	0.1500000
NODE_6161_length_1025_cov_6.688985	387	467	8	35	80	0.4375000
NODE_6161_length_1025_cov_6.688985	387	467	10	29	80	0.3625000
NODE_6170_length_1024_cov_28.681081	264	344	0	80	80	1.0000000
NODE_6170_length_1024_cov_28.681081	317	397	0	71	80	0.8875000
NODE_6170_length_1024_cov_28.681081	317	397	4	9	80	0.1125000
NODE_6170_length_1024_cov_28.681081	393	477	4	84	84	1.0000000
NODE_6171_length_1024_cov_17.922162	324	404	0	80	80	1.0000000
NODE_6171_length_1024_cov_17.922162	377	457	0	80	80	1.0000000
NODE_6173_length_1024_cov_12.018378	368	448	0	80	80	1.0000000
NODE_6173_length_1024_cov_12.018378	421	501	0	80	80	1.0000000
NODE_6174_length_1024_cov_8.800000	517	597	0	80	80	1.0000000
NODE_6174_length_1024_cov_8.800000	570	650	0	80	80	1.0000000
NODE_6175_length_1024_cov_6.207568	318	398	0	80	80	1.0000000
NODE_6175_length_1024_cov_6.207568	371	451	0	80	80	1.0000000
NODE_6178_length_1024_cov_2.468108	274	324	0	50	50	1.0000000
NODE_6178_length_1024_cov_2.468108	274	322	0	48	48	1.0000000
NODE_6178_length_1024_cov_2.468108	274	324	0	50	50	1.0000000
NODE_6178_length_1024_cov_2.468108	274	323	0	49	49	1.0000000
NODE_6178_length_1024_cov_2.468108	274	322	0	48	48	1.0000000
NODE_6185_length_1023_cov_100.366883	441	521	4	80	80	1.0000000
NODE_6185_length_1023_cov_100.366883	494	574	0	4	80	0.0500000
NODE_6185_length_1023_cov_100.366883	494	574	2	1	80	0.0125000
NODE_6185_length_1023_cov_100.366883	494	574	4	75	80	0.9375000
NODE_6186_length_1023_cov_64.271645	349	429	0	80	80	1.0000000
NODE_6186_length_1023_cov_64.271645	402	482	0	80	80	1.0000000
NODE_6186_length_1023_cov_64.271645	478	558	0	80	80	1.0000000
NODE_6186_length_1023_cov_64.271645	531	611	0	80	80	1.0000000
NODE_6187_length_1023_cov_32.695887	318	398	0	80	80	1.0000000
NODE_6187_length_1023_cov_32.695887	371	451	0	80	80	1.0000000
NODE_6187_length_1023_cov_32.695887	447	527	0	80	80	1.0000000
NODE_6187_length_1023_cov_32.695887	500	580	0	80	80	1.0000000
NODE_6188_length_1023_cov_16.244589	601	681	0	6	80	0.0750000
NODE_6188_length_1023_cov_16.244589	601	681	2	74	80	0.9250000
NODE_6188_length_1023_cov_16.244589	654	734	0	59	80	0.7375000
NODE_6188_length_1023_cov_16.244589	654	734	2	21	80	0.2625000
NODE_6189_length_1023_cov_15.876623	371	451	0	80	80	1.0000000
NODE_6189_length_1023_cov_15.876623	424	504	0	80	80	1.0000000
NODE_6189_length_1023_cov_15.876623	500	580	0	80	80	1.0000000
NODE_6189_length_1023_cov_15.876623	553	633	0	80	80	1.0000000
NODE_6190_length_1023_cov_14.678571	555	635	7	80	80	1.0000000
NODE_6190_length_1023_cov_14.678571	608	688	7	60	80	0.7500000
NODE_6190_length_1023_cov_14.678571	608	688	8	20	80	0.2500000
NODE_6191_length_1023_cov_14.443723	406	486	0	80	80	1.0000000
NODE_6191_length_1023_cov_14.443723	459	539	0	80	80	1.0000000
NODE_6192_length_1023_cov_10.984848	590	670	0	14	80	0.1750000
NODE_6192_length_1023_cov_10.984848	590	670	2	66	80	0.8250000
NODE_6192_length_1023_cov_10.984848	643	723	0	67	80	0.8375000
NODE_6192_length_1023_cov_10.984848	643	723	2	13	80	0.1625000
NODE_6202_length_1022_cov_42.952329	555	636	0	81	81	1.0000000
NODE_6202_length_1022_cov_42.952329	609	689	0	80	80	1.0000000
NODE_6202_length_1022_cov_42.952329	685	765	0	40	80	0.5000000
NODE_6202_length_1022_cov_42.952329	685	765	5	28	80	0.3500000
NODE_6202_length_1022_cov_42.952329	685	765	8	1	80	0.0125000
NODE_6202_length_1022_cov_42.952329	685	765	9	7	80	0.0875000
NODE_6202_length_1022_cov_42.952329	685	765	11	4	80	0.0500000
NODE_6202_length_1022_cov_42.952329	738	818	5	15	80	0.1875000
NODE_6202_length_1022_cov_42.952329	738	818	8	1	80	0.0125000
NODE_6202_length_1022_cov_42.952329	738	818	9	7	80	0.0875000
NODE_6202_length_1022_cov_42.952329	738	818	11	57	80	0.7125000
NODE_6203_length_1022_cov_29.949079	510	590	2	52	80	0.6500000
NODE_6203_length_1022_cov_29.949079	510	590	4	28	80	0.3500000
NODE_6203_length_1022_cov_29.949079	563	643	2	80	80	1.0000000
NODE_6204_length_1022_cov_7.672806	461	541	0	80	80	1.0000000
NODE_6204_length_1022_cov_7.672806	514	594	0	80	80	1.0000000
NODE_6213_length_1021_cov_47.379610	341	421	2	80	80	1.0000000
NODE_6213_length_1021_cov_47.379610	394	474	0	45	80	0.5625000
NODE_6213_length_1021_cov_47.379610	394	474	2	35	80	0.4375000
NODE_6213_length_1021_cov_47.379610	470	550	0	80	80	1.0000000
NODE_6213_length_1021_cov_47.379610	523	603	0	80	80	1.0000000
NODE_6214_length_1021_cov_33.255965	588	668	0	80	80	1.0000000
NODE_6214_length_1021_cov_33.255965	641	721	0	80	80	1.0000000
NODE_6227_length_1020_cov_24.565689	485	565	0	42	80	0.5250000
NODE_6227_length_1020_cov_24.565689	485	565	2	38	80	0.4750000
NODE_6227_length_1020_cov_24.565689	538	618	0	17	80	0.2125000
NODE_6227_length_1020_cov_24.565689	538	618	2	63	80	0.7875000
NODE_6228_length_1020_cov_20.825190	395	475	0	17	80	0.2125000
NODE_6228_length_1020_cov_20.825190	395	475	2	63	80	0.7875000
NODE_6228_length_1020_cov_20.825190	448	528	0	67	80	0.8375000
NODE_6228_length_1020_cov_20.825190	448	528	2	13	80	0.1625000
NODE_6229_length_1020_cov_20.305103	285	365	0	80	80	1.0000000
NODE_6229_length_1020_cov_20.305103	338	418	0	67	80	0.8375000
NODE_6229_length_1020_cov_20.305103	338	418	2	13	80	0.1625000
NODE_6229_length_1020_cov_20.305103	414	494	2	24	80	0.3000000
NODE_6229_length_1020_cov_20.305103	414	494	4	56	80	0.7000000
NODE_6229_length_1020_cov_20.305103	467	548	0	26	81	0.3209876
NODE_6229_length_1020_cov_20.305103	467	548	2	48	81	0.5925926
NODE_6229_length_1020_cov_20.305103	467	548	4	7	81	0.0864198
NODE_6230_length_1020_cov_17.919653	408	488	0	80	80	1.0000000
NODE_6230_length_1020_cov_17.919653	461	541	0	80	80	1.0000000
NODE_6231_length_1020_cov_13.972856	436	516	2	27	80	0.3375000
NODE_6231_length_1020_cov_13.972856	436	516	6	19	80	0.2375000
NODE_6231_length_1020_cov_13.972856	436	516	8	34	80	0.4250000
NODE_6231_length_1020_cov_13.972856	489	569	0	42	80	0.5250000
NODE_6231_length_1020_cov_13.972856	489	569	2	38	80	0.4750000
NODE_6232_length_1020_cov_10.472313	407	487	2	32	80	0.4000000
NODE_6232_length_1020_cov_10.472313	407	487	4	32	80	0.4000000
NODE_6232_length_1020_cov_10.472313	407	487	6	16	80	0.2000000
NODE_6232_length_1020_cov_10.472313	460	540	4	80	80	1.0000000
NODE_6235_length_1020_cov_3.707926	821	901	2	80	80	1.0000000
NODE_6235_length_1020_cov_3.707926	874	954	0	8	80	0.1000000
NODE_6235_length_1020_cov_3.707926	874	954	1	21	80	0.2625000
NODE_6235_length_1020_cov_3.707926	874	954	2	51	80	0.6375000
NODE_6238_length_1020_cov_2.648208	0	70	0	70	70	1.0000000
NODE_6238_length_1020_cov_2.648208	43	88	0	45	45	1.0000000
NODE_6248_length_1019_cov_30.164130	476	556	0	72	80	0.9000000
NODE_6248_length_1019_cov_30.164130	476	556	2	8	80	0.1000000
NODE_6248_length_1019_cov_30.164130	529	609	0	19	80	0.2375000
NODE_6248_length_1019_cov_30.164130	529	609	2	61	80	0.7625000
NODE_6248_length_1019_cov_30.164130	605	685	0	61	80	0.7625000
NODE_6248_length_1019_cov_30.164130	605	685	2	19	80	0.2375000
NODE_6248_length_1019_cov_30.164130	658	738	0	30	80	0.3750000
NODE_6248_length_1019_cov_30.164130	658	738	2	50	80	0.6250000
NODE_6249_length_1019_cov_22.845652	343	423	0	17	80	0.2125000
NODE_6249_length_1019_cov_22.845652	343	423	2	63	80	0.7875000
NODE_6249_length_1019_cov_22.845652	396	476	0	64	80	0.8000000
NODE_6249_length_1019_cov_22.845652	396	476	2	16	80	0.2000000
NODE_6249_length_1019_cov_22.845652	472	552	0	80	80	1.0000000
NODE_6249_length_1019_cov_22.845652	525	605	0	80	80	1.0000000
NODE_6250_length_1019_cov_8.098913	523	601	0	16	78	0.2051282
NODE_6250_length_1019_cov_8.098913	523	601	4	62	78	0.7948718
NODE_6250_length_1019_cov_8.098913	574	654	4	74	80	0.9250000
NODE_6250_length_1019_cov_8.098913	574	654	5	6	80	0.0750000
NODE_6251_length_1019_cov_7.896739	423	503	0	80	80	1.0000000
NODE_6251_length_1019_cov_7.896739	476	556	0	80	80	1.0000000
NODE_6252_length_1019_cov_4.597826	625	696	29	6	71	0.0845070
NODE_6252_length_1019_cov_4.597826	625	696	34	1	71	0.0140845
NODE_6252_length_1019_cov_4.597826	625	696	36	6	71	0.0845070
NODE_6252_length_1019_cov_4.597826	625	696	38	10	71	0.1408451
NODE_6252_length_1019_cov_4.597826	625	696	41	7	71	0.0985916
NODE_6252_length_1019_cov_4.597826	625	696	44	1	71	0.0140845
NODE_6252_length_1019_cov_4.597826	625	696	49	1	71	0.0140845
NODE_6252_length_1019_cov_4.597826	625	696	59	34	71	0.4788733
NODE_6252_length_1019_cov_4.597826	625	696	61	5	71	0.0704225
NODE_6263_length_1019_cov_1.139130	89	165	2	3	76	0.0394737
NODE_6263_length_1019_cov_1.139130	89	165	4	63	76	0.8289474
NODE_6263_length_1019_cov_1.139130	89	165	6	10	76	0.1315790
NODE_6265_length_1018_cov_33.494015	212	292	0	7	80	0.0875000
NODE_6265_length_1018_cov_33.494015	212	292	4	1	80	0.0125000
NODE_6265_length_1018_cov_33.494015	212	292	12	1	80	0.0125000
NODE_6265_length_1018_cov_33.494015	212	292	23	1	80	0.0125000
NODE_6265_length_1018_cov_33.494015	212	292	31	2	80	0.0250000
NODE_6265_length_1018_cov_33.494015	212	292	35	1	80	0.0125000
NODE_6265_length_1018_cov_33.494015	212	292	41	1	80	0.0125000
NODE_6265_length_1018_cov_33.494015	212	292	43	1	80	0.0125000
NODE_6265_length_1018_cov_33.494015	212	292	45	1	80	0.0125000
NODE_6265_length_1018_cov_33.494015	212	292	55	1	80	0.0125000
NODE_6265_length_1018_cov_33.494015	212	292	57	3	80	0.0375000
NODE_6265_length_1018_cov_33.494015	212	292	61	4	80	0.0500000
NODE_6265_length_1018_cov_33.494015	212	292	63	4	80	0.0500000
NODE_6265_length_1018_cov_33.494015	212	292	66	1	80	0.0125000
NODE_6265_length_1018_cov_33.494015	212	292	67	4	80	0.0500000
NODE_6265_length_1018_cov_33.494015	212	292	68	2	80	0.0250000
NODE_6265_length_1018_cov_33.494015	212	292	72	8	80	0.1000000
NODE_6265_length_1018_cov_33.494015	212	292	73	22	80	0.2750000
NODE_6265_length_1018_cov_33.494015	212	292	75	4	80	0.0500000
NODE_6265_length_1018_cov_33.494015	212	292	76	1	80	0.0125000
NODE_6265_length_1018_cov_33.494015	212	292	77	8	80	0.1000000
NODE_6265_length_1018_cov_33.494015	212	292	78	2	80	0.0250000
NODE_6265_length_1018_cov_33.494015	265	345	0	60	80	0.7500000
NODE_6265_length_1018_cov_33.494015	265	345	4	1	80	0.0125000
NODE_6265_length_1018_cov_33.494015	265	345	12	1	80	0.0125000
NODE_6265_length_1018_cov_33.494015	265	345	23	1	80	0.0125000
NODE_6265_length_1018_cov_33.494015	265	345	31	2	80	0.0250000
NODE_6265_length_1018_cov_33.494015	265	345	35	1	80	0.0125000
NODE_6265_length_1018_cov_33.494015	265	345	41	1	80	0.0125000
NODE_6265_length_1018_cov_33.494015	265	345	43	1	80	0.0125000
NODE_6265_length_1018_cov_33.494015	265	345	45	1	80	0.0125000
NODE_6265_length_1018_cov_33.494015	265	345	55	1	80	0.0125000
NODE_6265_length_1018_cov_33.494015	265	345	57	3	80	0.0375000
NODE_6265_length_1018_cov_33.494015	265	345	61	4	80	0.0500000
NODE_6265_length_1018_cov_33.494015	265	345	63	3	80	0.0375000
NODE_6266_length_1018_cov_22.776931	372	452	6	80	80	1.0000000
NODE_6266_length_1018_cov_22.776931	425	505	0	20	80	0.2500000
NODE_6266_length_1018_cov_22.776931	425	505	6	60	80	0.7500000
NODE_6268_length_1018_cov_8.486398	404	484	0	80	80	1.0000000
NODE_6268_length_1018_cov_8.486398	457	537	0	80	80	1.0000000
NODE_6270_length_1018_cov_7.737758	357	437	0	80	80	1.0000000
NODE_6270_length_1018_cov_7.737758	410	490	0	79	80	0.9875000
NODE_6270_length_1018_cov_7.737758	410	490	2	1	80	0.0125000
NODE_6286_length_1017_cov_207.523965	0	41	152	1	41	0.0243902
NODE_6286_length_1017_cov_207.523965	0	41	159	1	41	0.0243902
NODE_6286_length_1017_cov_207.523965	0	41	167	1	41	0.0243902
NODE_6286_length_1017_cov_207.523965	0	41	176	2	41	0.0487805
NODE_6286_length_1017_cov_207.523965	0	41	178	2	41	0.0487805
NODE_6286_length_1017_cov_207.523965	0	41	180	1	41	0.0243902
NODE_6286_length_1017_cov_207.523965	0	41	181	1	41	0.0243902
NODE_6286_length_1017_cov_207.523965	0	41	193	2	41	0.0487805
NODE_6286_length_1017_cov_207.523965	0	41	195	1	41	0.0243902
NODE_6286_length_1017_cov_207.523965	0	41	201	1	41	0.0243902
NODE_6286_length_1017_cov_207.523965	0	41	204	1	41	0.0243902
NODE_6286_length_1017_cov_207.523965	0	41	210	1	41	0.0243902
NODE_6286_length_1017_cov_207.523965	0	41	216	1	41	0.0243902
NODE_6286_length_1017_cov_207.523965	0	41	219	1	41	0.0243902
NODE_6286_length_1017_cov_207.523965	0	41	223	1	41	0.0243902
NODE_6286_length_1017_cov_207.523965	0	41	224	2	41	0.0487805
NODE_6286_length_1017_cov_207.523965	0	41	236	4	41	0.0975610
NODE_6286_length_1017_cov_207.523965	0	41	238	1	41	0.0243902
NODE_6286_length_1017_cov_207.523965	0	41	240	3	41	0.0731707
NODE_6286_length_1017_cov_207.523965	0	41	249	1	41	0.0243902
NODE_6286_length_1017_cov_207.523965	0	41	253	1	41	0.0243902
NODE_6286_length_1017_cov_207.523965	0	41	255	2	41	0.0487805
NODE_6286_length_1017_cov_207.523965	0	41	256	1	41	0.0243902
NODE_6286_length_1017_cov_207.523965	0	41	260	1	41	0.0243902
NODE_6286_length_1017_cov_207.523965	0	41	270	1	41	0.0243902
NODE_6286_length_1017_cov_207.523965	0	41	276	1	41	0.0243902
NODE_6286_length_1017_cov_207.523965	0	41	279	2	41	0.0487805
NODE_6286_length_1017_cov_207.523965	0	41	285	1	41	0.0243902
NODE_6286_length_1017_cov_207.523965	0	41	287	1	41	0.0243902
NODE_6286_length_1017_cov_207.523965	0	41	289	1	41	0.0243902
NODE_6286_length_1017_cov_207.523965	14	94	210	1	80	0.0125000
NODE_6286_length_1017_cov_207.523965	14	94	216	1	80	0.0125000
NODE_6286_length_1017_cov_207.523965	14	94	219	1	80	0.0125000
NODE_6286_length_1017_cov_207.523965	14	94	223	1	80	0.0125000
NODE_6286_length_1017_cov_207.523965	14	94	224	2	80	0.0250000
NODE_6286_length_1017_cov_207.523965	14	94	236	4	80	0.0500000
NODE_6286_length_1017_cov_207.523965	14	94	238	1	80	0.0125000
NODE_6286_length_1017_cov_207.523965	14	94	240	3	80	0.0375000
NODE_6286_length_1017_cov_207.523965	14	94	249	1	80	0.0125000
NODE_6286_length_1017_cov_207.523965	14	94	253	1	80	0.0125000
NODE_6286_length_1017_cov_207.523965	14	94	255	2	80	0.0250000
NODE_6286_length_1017_cov_207.523965	14	94	256	1	80	0.0125000
NODE_6286_length_1017_cov_207.523965	14	94	260	1	80	0.0125000
NODE_6286_length_1017_cov_207.523965	14	94	270	1	80	0.0125000
NODE_6286_length_1017_cov_207.523965	14	94	276	1	80	0.0125000
NODE_6286_length_1017_cov_207.523965	14	94	279	2	80	0.0250000
NODE_6286_length_1017_cov_207.523965	14	94	285	1	80	0.0125000
NODE_6286_length_1017_cov_207.523965	14	94	287	1	80	0.0125000
NODE_6286_length_1017_cov_207.523965	14	94	289	1	80	0.0125000
NODE_6286_length_1017_cov_207.523965	14	94	297	1	80	0.0125000
NODE_6286_length_1017_cov_207.523965	14	94	299	2	80	0.0250000
NODE_6286_length_1017_cov_207.523965	14	94	302	1	80	0.0125000
NODE_6286_length_1017_cov_207.523965	14	94	308	1	80	0.0125000
NODE_6286_length_1017_cov_207.523965	14	94	313	1	80	0.0125000
NODE_6286_length_1017_cov_207.523965	14	94	315	1	80	0.0125000
NODE_6286_length_1017_cov_207.523965	14	94	317	1	80	0.0125000
NODE_6286_length_1017_cov_207.523965	14	94	330	2	80	0.0250000
NODE_6286_length_1017_cov_207.523965	14	94	335	1	80	0.0125000
NODE_6286_length_1017_cov_207.523965	14	94	345	3	80	0.0375000
NODE_6286_length_1017_cov_207.523965	14	94	349	1	80	0.0125000
NODE_6286_length_1017_cov_207.523965	14	94	350	3	80	0.0375000
NODE_6286_length_1017_cov_207.523965	14	94	354	1	80	0.0125000
NODE_6286_length_1017_cov_207.523965	14	94	360	2	80	0.0250000
NODE_6286_length_1017_cov_207.523965	14	94	369	1	80	0.0125000
NODE_6286_length_1017_cov_207.523965	14	94	371	1	80	0.0125000
NODE_6286_length_1017_cov_207.523965	14	94	374	3	80	0.0375000
NODE_6286_length_1017_cov_207.523965	14	94	376	1	80	0.0125000
NODE_6286_length_1017_cov_207.523965	14	94	378	7	80	0.0875000
NODE_6286_length_1017_cov_207.523965	14	94	379	1	80	0.0125000
NODE_6286_length_1017_cov_207.523965	14	94	381	2	80	0.0250000
NODE_6286_length_1017_cov_207.523965	14	94	386	3	80	0.0375000
NODE_6286_length_1017_cov_207.523965	14	94	390	2	80	0.0250000
NODE_6286_length_1017_cov_207.523965	14	94	392	1	80	0.0125000
NODE_6286_length_1017_cov_207.523965	14	94	398	1	80	0.0125000
NODE_6286_length_1017_cov_207.523965	14	94	400	1	80	0.0125000
NODE_6286_length_1017_cov_207.523965	14	94	406	2	80	0.0250000
NODE_6286_length_1017_cov_207.523965	14	94	414	1	80	0.0125000
NODE_6286_length_1017_cov_207.523965	14	94	418	1	80	0.0125000
NODE_6286_length_1017_cov_207.523965	14	94	419	2	80	0.0250000
NODE_6286_length_1017_cov_207.523965	14	94	420	2	80	0.0250000
NODE_6287_length_1017_cov_18.824619	490	570	0	80	80	1.0000000
NODE_6287_length_1017_cov_18.824619	543	623	0	80	80	1.0000000
NODE_6288_length_1017_cov_14.794118	428	508	0	80	80	1.0000000
NODE_6288_length_1017_cov_14.794118	481	561	0	80	80	1.0000000
NODE_6288_length_1017_cov_14.794118	557	637	0	80	80	1.0000000
NODE_6288_length_1017_cov_14.794118	610	690	0	80	80	1.0000000
NODE_6297_length_1016_cov_22.267176	577	657	2	7	80	0.0875000
NODE_6297_length_1016_cov_22.267176	577	657	4	50	80	0.6250000
NODE_6297_length_1016_cov_22.267176	577	657	6	23	80	0.2875000
NODE_6297_length_1016_cov_22.267176	630	710	0	28	80	0.3500000
NODE_6297_length_1016_cov_22.267176	630	710	2	32	80	0.4000000
NODE_6297_length_1016_cov_22.267176	630	710	4	12	80	0.1500000
NODE_6297_length_1016_cov_22.267176	630	710	6	8	80	0.1000000
NODE_6298_length_1016_cov_21.134133	625	705	12	37	80	0.4625000
NODE_6298_length_1016_cov_21.134133	625	705	14	4	80	0.0500000
NODE_6298_length_1016_cov_21.134133	625	705	16	39	80	0.4875000
NODE_6298_length_1016_cov_21.134133	678	758	0	41	80	0.5125000
NODE_6298_length_1016_cov_21.134133	678	758	2	7	80	0.0875000
NODE_6298_length_1016_cov_21.134133	678	758	6	4	80	0.0500000
NODE_6298_length_1016_cov_21.134133	678	758	12	28	80	0.3500000
NODE_6299_length_1016_cov_20.392585	504	584	0	67	80	0.8375000
NODE_6299_length_1016_cov_20.392585	504	584	2	13	80	0.1625000
NODE_6299_length_1016_cov_20.392585	557	637	0	14	80	0.1750000
NODE_6299_length_1016_cov_20.392585	557	637	2	66	80	0.8250000
NODE_6299_length_1016_cov_20.392585	633	713	0	12	80	0.1500000
NODE_6299_length_1016_cov_20.392585	633	713	2	68	80	0.8500000
NODE_6299_length_1016_cov_20.392585	686	766	0	65	80	0.8125000
NODE_6299_length_1016_cov_20.392585	686	766	2	15	80	0.1875000
NODE_6300_length_1016_cov_16.917121	524	604	0	80	80	1.0000000
NODE_6300_length_1016_cov_16.917121	577	657	0	80	80	1.0000000
NODE_6301_length_1016_cov_8.243184	438	518	0	80	80	1.0000000
NODE_6301_length_1016_cov_8.243184	491	571	0	80	80	1.0000000
NODE_6301_length_1016_cov_8.243184	567	647	0	80	80	1.0000000
NODE_6301_length_1016_cov_8.243184	620	700	0	80	80	1.0000000
NODE_6302_length_1016_cov_8.141767	166	256	2	1	90	0.0111111
NODE_6302_length_1016_cov_8.141767	166	256	6	1	90	0.0111111
NODE_6302_length_1016_cov_8.141767	166	256	8	4	90	0.0444444
NODE_6302_length_1016_cov_8.141767	166	256	10	18	90	0.2000000
NODE_6302_length_1016_cov_8.141767	166	256	11	4	90	0.0444444
NODE_6302_length_1016_cov_8.141767	166	256	12	23	90	0.2555556
NODE_6302_length_1016_cov_8.141767	166	256	14	2	90	0.0222222
NODE_6302_length_1016_cov_8.141767	166	256	16	10	90	0.1111111
NODE_6302_length_1016_cov_8.141767	166	256	20	1	90	0.0111111
NODE_6302_length_1016_cov_8.141767	166	256	22	3	90	0.0333333
NODE_6302_length_1016_cov_8.141767	166	256	24	4	90	0.0444444
NODE_6302_length_1016_cov_8.141767	166	256	26	1	90	0.0111111
NODE_6302_length_1016_cov_8.141767	166	256	28	2	90	0.0222222
NODE_6302_length_1016_cov_8.141767	166	256	30	2	90	0.0222222
NODE_6302_length_1016_cov_8.141767	166	256	32	6	90	0.0666667
NODE_6302_length_1016_cov_8.141767	166	256	34	8	90	0.0888889
NODE_6303_length_1016_cov_7.466739	576	656	0	80	80	1.0000000
NODE_6303_length_1016_cov_7.466739	629	709	0	80	80	1.0000000
NODE_6318_length_1015_cov_24.680131	459	539	0	80	80	1.0000000
NODE_6318_length_1015_cov_24.680131	512	592	0	80	80	1.0000000
NODE_6318_length_1015_cov_24.680131	588	668	0	26	80	0.3250000
NODE_6318_length_1015_cov_24.680131	588	668	2	54	80	0.6750000
NODE_6318_length_1015_cov_24.680131	641	721	0	60	80	0.7500000
NODE_6318_length_1015_cov_24.680131	641	721	2	20	80	0.2500000
NODE_6319_length_1015_cov_23.198690	407	487	0	80	80	1.0000000
NODE_6319_length_1015_cov_23.198690	460	540	0	80	80	1.0000000
NODE_6319_length_1015_cov_23.198690	536	616	0	80	80	1.0000000
NODE_6319_length_1015_cov_23.198690	589	669	0	80	80	1.0000000
NODE_6320_length_1015_cov_22.544760	490	570	0	2	80	0.0250000
NODE_6320_length_1015_cov_22.544760	490	570	2	78	80	0.9750000
NODE_6320_length_1015_cov_22.544760	543	623	0	44	80	0.5500000
NODE_6320_length_1015_cov_22.544760	543	623	2	36	80	0.4500000
NODE_6321_length_1015_cov_17.994541	510	590	0	80	80	1.0000000
NODE_6321_length_1015_cov_17.994541	563	643	0	62	80	0.7750000
NODE_6321_length_1015_cov_17.994541	563	643	2	18	80	0.2250000
NODE_6322_length_1015_cov_16.594978	437	517	0	27	80	0.3375000
NODE_6322_length_1015_cov_16.594978	437	517	4	37	80	0.4625000
NODE_6322_length_1015_cov_16.594978	437	517	6	16	80	0.2000000
NODE_6322_length_1015_cov_16.594978	490	570	4	11	80	0.1375000
NODE_6322_length_1015_cov_16.594978	490	570	5	43	80	0.5375000
NODE_6322_length_1015_cov_16.594978	490	570	6	26	80	0.3250000
NODE_6323_length_1015_cov_14.000000	505	585	0	80	80	1.0000000
NODE_6323_length_1015_cov_14.000000	558	638	0	80	80	1.0000000
NODE_6324_length_1015_cov_9.978166	345	425	0	80	80	1.0000000
NODE_6324_length_1015_cov_9.978166	398	478	0	80	80	1.0000000
NODE_6325_length_1015_cov_6.844978	393	473	2	19	80	0.2375000
NODE_6325_length_1015_cov_6.844978	393	473	4	30	80	0.3750000
NODE_6325_length_1015_cov_6.844978	393	473	6	31	80	0.3875000
NODE_6325_length_1015_cov_6.844978	446	526	4	70	80	0.8750000
NODE_6325_length_1015_cov_6.844978	446	526	6	10	80	0.1250000
NODE_6337_length_1014_cov_95.709290	259	335	0	76	76	1.0000000
NODE_6337_length_1014_cov_95.709290	310	390	0	80	80	1.0000000
NODE_6337_length_1014_cov_95.709290	386	466	0	49	80	0.6125000
NODE_6337_length_1014_cov_95.709290	386	466	4	31	80	0.3875000
NODE_6337_length_1014_cov_95.709290	439	519	4	80	80	1.0000000
NODE_6338_length_1014_cov_67.918033	182	262	0	27	80	0.3375000
NODE_6338_length_1014_cov_67.918033	182	262	7	1	80	0.0125000
NODE_6338_length_1014_cov_67.918033	182	262	8	52	80	0.6500000
NODE_6338_length_1014_cov_67.918033	235	315	0	25	80	0.3125000
NODE_6338_length_1014_cov_67.918033	235	315	8	55	80	0.6875000
NODE_6338_length_1014_cov_67.918033	311	391	0	80	80	1.0000000
NODE_6338_length_1014_cov_67.918033	364	444	0	80	80	1.0000000
NODE_6339_length_1014_cov_44.802186	418	498	0	80	80	1.0000000
NODE_6339_length_1014_cov_44.802186	471	551	0	80	80	1.0000000
NODE_6340_length_1014_cov_36.349727	369	449	0	80	80	1.0000000
NODE_6340_length_1014_cov_36.349727	422	502	0	58	80	0.7250000
NODE_6340_length_1014_cov_36.349727	422	502	2	22	80	0.2750000
NODE_6340_length_1014_cov_36.349727	498	578	2	25	80	0.3125000
NODE_6340_length_1014_cov_36.349727	498	578	4	8	80	0.1000000
NODE_6340_length_1014_cov_36.349727	498	578	17	20	80	0.2500000
NODE_6340_length_1014_cov_36.349727	498	578	18	12	80	0.1500000
NODE_6340_length_1014_cov_36.349727	498	578	19	15	80	0.1875000
NODE_6340_length_1014_cov_36.349727	551	631	14	10	80	0.1250000
NODE_6340_length_1014_cov_36.349727	551	631	15	16	80	0.2000000
NODE_6340_length_1014_cov_36.349727	551	631	16	18	80	0.2250000
NODE_6340_length_1014_cov_36.349727	551	631	17	29	80	0.3625000
NODE_6340_length_1014_cov_36.349727	551	631	19	7	80	0.0875000
NODE_6341_length_1014_cov_35.547541	363	441	0	78	78	1.0000000
NODE_6341_length_1014_cov_35.547541	416	494	0	78	78	1.0000000
NODE_6342_length_1014_cov_32.266667	428	508	0	80	80	1.0000000
NODE_6342_length_1014_cov_32.266667	481	561	0	80	80	1.0000000
NODE_6343_length_1014_cov_28.493989	480	560	0	80	80	1.0000000
NODE_6343_length_1014_cov_28.493989	533	613	0	80	80	1.0000000
NODE_6343_length_1014_cov_28.493989	609	689	0	32	80	0.4000000
NODE_6343_length_1014_cov_28.493989	609	689	6	48	80	0.6000000
NODE_6343_length_1014_cov_28.493989	662	742	6	80	80	1.0000000
NODE_6344_length_1014_cov_25.171585	500	580	0	17	80	0.2125000
NODE_6344_length_1014_cov_25.171585	500	580	6	24	80	0.3000000
NODE_6344_length_1014_cov_25.171585	500	580	8	39	80	0.4875000
NODE_6344_length_1014_cov_25.171585	553	633	0	6	80	0.0750000
NODE_6344_length_1014_cov_25.171585	553	633	2	17	80	0.2125000
NODE_6344_length_1014_cov_25.171585	553	633	8	57	80	0.7125000
NODE_6345_length_1014_cov_22.437158	534	614	0	80	80	1.0000000
NODE_6345_length_1014_cov_22.437158	587	667	0	34	80	0.4250000
NODE_6345_length_1014_cov_22.437158	587	667	2	46	80	0.5750000
NODE_6346_length_1014_cov_19.238251	379	459	0	76	80	0.9500000
NODE_6346_length_1014_cov_19.238251	379	459	2	4	80	0.0500000
NODE_6346_length_1014_cov_19.238251	432	512	0	23	80	0.2875000
NODE_6346_length_1014_cov_19.238251	432	512	2	29	80	0.3625000
NODE_6346_length_1014_cov_19.238251	432	512	4	28	80	0.3500000
NODE_6346_length_1014_cov_19.238251	508	585	4	77	77	1.0000000
NODE_6346_length_1014_cov_19.238251	558	638	0	50	80	0.6250000
NODE_6346_length_1014_cov_19.238251	558	638	4	30	80	0.3750000
NODE_6347_length_1014_cov_15.926776	594	674	0	80	80	1.0000000
NODE_6347_length_1014_cov_15.926776	647	727	0	80	80	1.0000000
NODE_6348_length_1014_cov_8.691803	285	365	0	80	80	1.0000000
NODE_6348_length_1014_cov_8.691803	338	418	0	80	80	1.0000000
NODE_6349_length_1014_cov_7.959563	531	611	0	80	80	1.0000000
NODE_6349_length_1014_cov_7.959563	584	664	0	80	80	1.0000000
NODE_6351_length_1014_cov_7.608743	298	378	0	15	80	0.1875000
NODE_6351_length_1014_cov_7.608743	298	378	2	65	80	0.8125000
NODE_6351_length_1014_cov_7.608743	351	431	0	63	80	0.7875000
NODE_6351_length_1014_cov_7.608743	351	431	2	17	80	0.2125000
NODE_6352_length_1014_cov_6.209836	321	401	0	80	80	1.0000000
NODE_6352_length_1014_cov_6.209836	374	454	0	55	80	0.6875000
NODE_6352_length_1014_cov_6.209836	374	454	2	25	80	0.3125000
NODE_6364_length_1013_cov_32.695842	423	503	0	80	80	1.0000000
NODE_6364_length_1013_cov_32.695842	476	556	0	80	80	1.0000000
NODE_6364_length_1013_cov_32.695842	552	632	0	71	80	0.8875000
NODE_6364_length_1013_cov_32.695842	552	632	8	9	80	0.1125000
NODE_6364_length_1013_cov_32.695842	605	685	0	18	80	0.2250000
NODE_6364_length_1013_cov_32.695842	605	685	8	62	80	0.7750000
NODE_6365_length_1013_cov_21.935449	424	503	0	28	79	0.3544304
NODE_6365_length_1013_cov_21.935449	424	503	2	51	79	0.6455696
NODE_6365_length_1013_cov_21.935449	476	556	2	80	80	1.0000000
NODE_6366_length_1013_cov_17.532823	440	520	1	6	80	0.0750000
NODE_6366_length_1013_cov_17.532823	440	520	2	74	80	0.9250000
NODE_6366_length_1013_cov_17.532823	493	573	1	50	80	0.6250000
NODE_6366_length_1013_cov_17.532823	493	573	2	30	80	0.3750000
NODE_6367_length_1013_cov_14.555799	478	558	2	80	80	1.0000000
NODE_6367_length_1013_cov_14.555799	531	611	0	13	80	0.1625000
NODE_6367_length_1013_cov_14.555799	531	611	1	23	80	0.2875000
NODE_6367_length_1013_cov_14.555799	531	611	2	44	80	0.5500000
NODE_6368_length_1013_cov_13.142232	476	556	2	80	80	1.0000000
NODE_6368_length_1013_cov_13.142232	529	609	0	19	80	0.2375000
NODE_6368_length_1013_cov_13.142232	529	609	1	10	80	0.1250000
NODE_6368_length_1013_cov_13.142232	529	609	2	51	80	0.6375000
NODE_6369_length_1013_cov_7.756018	538	618	0	80	80	1.0000000
NODE_6369_length_1013_cov_7.756018	591	671	0	80	80	1.0000000
NODE_6371_length_1013_cov_4.368709	550	630	0	80	80	1.0000000
NODE_6371_length_1013_cov_4.368709	603	683	0	80	80	1.0000000
NODE_6380_length_1012_cov_91.547645	378	458	0	80	80	1.0000000
NODE_6380_length_1012_cov_91.547645	431	511	0	80	80	1.0000000
NODE_6380_length_1012_cov_91.547645	507	587	0	80	80	1.0000000
NODE_6380_length_1012_cov_91.547645	560	640	0	69	80	0.8625000
NODE_6380_length_1012_cov_91.547645	560	640	2	11	80	0.1375000
NODE_6381_length_1012_cov_64.409639	345	425	0	80	80	1.0000000
NODE_6381_length_1012_cov_64.409639	398	478	0	80	80	1.0000000
NODE_6382_length_1012_cov_63.035049	438	518	0	80	80	1.0000000
NODE_6382_length_1012_cov_63.035049	491	571	0	80	80	1.0000000
NODE_6383_length_1012_cov_53.686747	276	356	0	10	80	0.1250000
NODE_6383_length_1012_cov_53.686747	276	356	2	70	80	0.8750000
NODE_6383_length_1012_cov_53.686747	329	409	0	63	80	0.7875000
NODE_6383_length_1012_cov_53.686747	329	409	2	17	80	0.2125000
NODE_6383_length_1012_cov_53.686747	405	485	0	75	80	0.9375000
NODE_6383_length_1012_cov_53.686747	405	485	4	5	80	0.0625000
NODE_6383_length_1012_cov_53.686747	458	538	0	22	80	0.2750000
NODE_6383_length_1012_cov_53.686747	458	538	4	58	80	0.7250000
NODE_6384_length_1012_cov_35.861993	453	533	0	80	80	1.0000000
NODE_6384_length_1012_cov_35.861993	506	581	0	75	75	1.0000000
NODE_6385_length_1012_cov_16.125958	510	590	0	80	80	1.0000000
NODE_6385_length_1012_cov_16.125958	563	643	0	80	80	1.0000000
NODE_6386_length_1012_cov_15.395400	501	581	0	76	80	0.9500000
NODE_6386_length_1012_cov_15.395400	501	581	2	4	80	0.0500000
NODE_6386_length_1012_cov_15.395400	554	634	0	23	80	0.2875000
NODE_6386_length_1012_cov_15.395400	554	634	2	57	80	0.7125000
NODE_6388_length_1012_cov_6.409639	528	608	0	2	80	0.0250000
NODE_6388_length_1012_cov_6.409639	528	608	2	78	80	0.9750000
NODE_6388_length_1012_cov_6.409639	581	661	0	14	80	0.1750000
NODE_6388_length_1012_cov_6.409639	581	661	2	66	80	0.8250000
NODE_6398_length_1011_cov_53.032895	515	595	0	9	80	0.1125000
NODE_6398_length_1011_cov_53.032895	515	595	2	71	80	0.8875000
NODE_6398_length_1011_cov_53.032895	568	648	0	62	80	0.7750000
NODE_6398_length_1011_cov_53.032895	568	648	2	18	80	0.2250000
NODE_6399_length_1011_cov_25.838816	366	446	0	39	80	0.4875000
NODE_6399_length_1011_cov_25.838816	366	446	2	41	80	0.5125000
NODE_6399_length_1011_cov_25.838816	419	499	0	2	80	0.0250000
NODE_6399_length_1011_cov_25.838816	419	499	2	78	80	0.9750000
NODE_6400_length_1011_cov_22.734649	426	506	0	80	80	1.0000000
NODE_6400_length_1011_cov_22.734649	479	559	0	60	80	0.7500000
NODE_6400_length_1011_cov_22.734649	479	559	2	20	80	0.2500000
NODE_6400_length_1011_cov_22.734649	555	636	2	54	81	0.6666667
NODE_6400_length_1011_cov_22.734649	555	636	4	27	81	0.3333333
NODE_6400_length_1011_cov_22.734649	609	689	2	80	80	1.0000000
NODE_6401_length_1011_cov_18.127193	389	469	1	50	80	0.6250000
NODE_6401_length_1011_cov_18.127193	389	469	2	30	80	0.3750000
NODE_6401_length_1011_cov_18.127193	442	520	1	12	78	0.1538462
NODE_6401_length_1011_cov_18.127193	442	520	2	66	78	0.8461539
NODE_6401_length_1011_cov_18.127193	516	596	1	65	80	0.8125000
NODE_6401_length_1011_cov_18.127193	516	596	2	7	80	0.0875000
NODE_6401_length_1011_cov_18.127193	516	596	3	8	80	0.1000000
NODE_6401_length_1011_cov_18.127193	569	649	1	12	80	0.1500000
NODE_6401_length_1011_cov_18.127193	569	649	2	23	80	0.2875000
NODE_6401_length_1011_cov_18.127193	569	649	3	8	80	0.1000000
NODE_6401_length_1011_cov_18.127193	569	649	4	37	80	0.4625000
NODE_6402_length_1011_cov_12.709430	309	389	3	13	80	0.1625000
NODE_6402_length_1011_cov_12.709430	309	389	6	67	80	0.8375000
NODE_6402_length_1011_cov_12.709430	362	442	3	33	80	0.4125000
NODE_6402_length_1011_cov_12.709430	362	442	6	47	80	0.5875000
NODE_6403_length_1011_cov_8.731360	441	521	0	80	80	1.0000000
NODE_6403_length_1011_cov_8.731360	494	574	0	80	80	1.0000000
NODE_6405_length_1011_cov_7.212719	219	299	5	28	80	0.3500000
NODE_6405_length_1011_cov_7.212719	219	299	7	52	80	0.6500000
NODE_6408_length_1011_cov_3.569079	173	253	0	6	80	0.0750000
NODE_6408_length_1011_cov_3.569079	173	253	2	74	80	0.9250000
NODE_6408_length_1011_cov_3.569079	226	306	0	28	80	0.3500000
NODE_6408_length_1011_cov_3.569079	226	306	2	52	80	0.6500000
NODE_6409_length_1011_cov_1.703947	779	851	5	2	72	0.0277778
NODE_6409_length_1011_cov_1.703947	779	851	9	3	72	0.0416667
NODE_6409_length_1011_cov_1.703947	779	851	12	1	72	0.0138889
NODE_6409_length_1011_cov_1.703947	779	851	14	1	72	0.0138889
NODE_6409_length_1011_cov_1.703947	779	851	16	1	72	0.0138889
NODE_6409_length_1011_cov_1.703947	779	851	18	3	72	0.0416667
NODE_6409_length_1011_cov_1.703947	779	851	20	1	72	0.0138889
NODE_6409_length_1011_cov_1.703947	779	851	22	7	72	0.0972222
NODE_6409_length_1011_cov_1.703947	779	851	24	1	72	0.0138889
NODE_6409_length_1011_cov_1.703947	779	851	26	4	72	0.0555556
NODE_6409_length_1011_cov_1.703947	779	851	27	1	72	0.0138889
NODE_6409_length_1011_cov_1.703947	779	851	28	3	72	0.0416667
NODE_6409_length_1011_cov_1.703947	779	851	32	2	72	0.0277778
NODE_6409_length_1011_cov_1.703947	779	851	40	11	72	0.1527778
NODE_6409_length_1011_cov_1.703947	779	851	42	8	72	0.1111111
NODE_6409_length_1011_cov_1.703947	779	851	46	8	72	0.1111111
NODE_6409_length_1011_cov_1.703947	779	851	48	2	72	0.0277778
NODE_6409_length_1011_cov_1.703947	779	851	50	4	72	0.0555556
NODE_6409_length_1011_cov_1.703947	779	851	52	9	72	0.1250000
NODE_6416_length_1010_cov_51.841932	335	415	2	80	80	1.0000000
NODE_6416_length_1010_cov_51.841932	388	468	1	6	80	0.0750000
NODE_6416_length_1010_cov_51.841932	388	468	2	74	80	0.9250000
NODE_6417_length_1010_cov_35.860593	576	656	0	80	80	1.0000000
NODE_6417_length_1010_cov_35.860593	629	709	0	80	80	1.0000000
NODE_6418_length_1010_cov_30.043908	509	589	0	32	80	0.4000000
NODE_6418_length_1010_cov_30.043908	509	589	2	48	80	0.6000000
NODE_6418_length_1010_cov_30.043908	562	642	0	1	80	0.0125000
NODE_6418_length_1010_cov_30.043908	562	642	2	43	80	0.5375000
NODE_6418_length_1010_cov_30.043908	562	642	4	36	80	0.4500000
NODE_6418_length_1010_cov_30.043908	638	718	0	14	80	0.1750000
NODE_6418_length_1010_cov_30.043908	638	718	4	66	80	0.8250000
NODE_6418_length_1010_cov_30.043908	691	771	0	67	80	0.8375000
NODE_6418_length_1010_cov_30.043908	691	771	4	13	80	0.1625000
NODE_6420_length_1010_cov_15.156970	364	444	0	80	80	1.0000000
NODE_6420_length_1010_cov_15.156970	417	497	0	30	80	0.3750000
NODE_6420_length_1010_cov_15.156970	417	497	2	50	80	0.6250000
NODE_6421_length_1010_cov_13.546652	385	465	0	80	80	1.0000000
NODE_6421_length_1010_cov_13.546652	438	518	0	80	80	1.0000000
NODE_6422_length_1010_cov_13.317234	480	560	0	32	80	0.4000000
NODE_6422_length_1010_cov_13.317234	480	560	4	7	80	0.0875000
NODE_6422_length_1010_cov_13.317234	480	560	6	41	80	0.5125000
NODE_6422_length_1010_cov_13.317234	533	613	4	6	80	0.0750000
NODE_6422_length_1010_cov_13.317234	533	613	6	74	80	0.9250000
NODE_6423_length_1010_cov_12.900110	427	507	2	12	80	0.1500000
NODE_6423_length_1010_cov_12.900110	427	507	7	7	80	0.0875000
NODE_6423_length_1010_cov_12.900110	427	507	8	61	80	0.7625000
NODE_6423_length_1010_cov_12.900110	480	560	6	15	80	0.1875000
NODE_6423_length_1010_cov_12.900110	480	560	7	45	80	0.5625000
NODE_6423_length_1010_cov_12.900110	480	560	8	20	80	0.2500000
NODE_6424_length_1010_cov_11.423710	631	711	2	16	80	0.2000000
NODE_6424_length_1010_cov_11.423710	631	711	6	64	80	0.8000000
NODE_6424_length_1010_cov_11.423710	684	764	0	40	80	0.5000000
NODE_6424_length_1010_cov_11.423710	684	764	6	40	80	0.5000000
NODE_6425_length_1010_cov_11.256861	492	572	0	80	80	1.0000000
NODE_6425_length_1010_cov_11.256861	545	625	0	80	80	1.0000000
NODE_6426_length_1010_cov_11.000000	455	535	0	50	80	0.6250000
NODE_6426_length_1010_cov_11.000000	455	535	4	30	80	0.3750000
NODE_6426_length_1010_cov_11.000000	508	588	0	4	80	0.0500000
NODE_6426_length_1010_cov_11.000000	508	588	4	76	80	0.9500000
NODE_6428_length_1010_cov_4.990121	476	556	1	7	80	0.0875000
NODE_6428_length_1010_cov_4.990121	476	556	2	73	80	0.9125000
NODE_6428_length_1010_cov_4.990121	529	609	1	26	80	0.3250000
NODE_6428_length_1010_cov_4.990121	529	609	2	54	80	0.6750000
NODE_6430_length_1010_cov_4.892426	476	556	0	13	80	0.1625000
NODE_6430_length_1010_cov_4.892426	476	556	4	67	80	0.8375000
NODE_6430_length_1010_cov_4.892426	529	609	0	66	80	0.8250000
NODE_6430_length_1010_cov_4.892426	529	609	4	14	80	0.1750000
NODE_6431_length_1010_cov_3.624588	157	196	0	39	39	1.0000000
NODE_6435_length_1010_cov_1.440176	1	58	0	57	57	1.0000000
NODE_6436_length_1009_cov_44.626374	288	362	2	2	74	0.0270270
NODE_6436_length_1009_cov_44.626374	288	362	4	69	74	0.9324324
NODE_6436_length_1009_cov_44.626374	288	362	6	3	74	0.0405405
NODE_6436_length_1009_cov_44.626374	335	415	2	55	80	0.6875000
NODE_6436_length_1009_cov_44.626374	335	415	4	22	80	0.2750000
NODE_6436_length_1009_cov_44.626374	335	415	6	3	80	0.0375000
NODE_6436_length_1009_cov_44.626374	411	491	0	57	80	0.7125000
NODE_6436_length_1009_cov_44.626374	411	491	2	23	80	0.2875000
NODE_6436_length_1009_cov_44.626374	464	544	0	80	80	1.0000000
NODE_6437_length_1009_cov_31.828571	412	492	0	22	80	0.2750000
NODE_6437_length_1009_cov_31.828571	412	492	6	58	80	0.7250000
NODE_6437_length_1009_cov_31.828571	465	545	0	25	80	0.3125000
NODE_6437_length_1009_cov_31.828571	465	545	5	1	80	0.0125000
NODE_6437_length_1009_cov_31.828571	465	545	6	54	80	0.6750000
NODE_6438_length_1009_cov_28.539560	571	651	0	80	80	1.0000000
NODE_6438_length_1009_cov_28.539560	624	704	0	80	80	1.0000000
NODE_6439_length_1009_cov_20.281319	577	657	4	4	80	0.0500000
NODE_6439_length_1009_cov_20.281319	577	657	6	5	80	0.0625000
NODE_6439_length_1009_cov_20.281319	577	657	8	6	80	0.0750000
NODE_6439_length_1009_cov_20.281319	577	657	14	46	80	0.5750000
NODE_6439_length_1009_cov_20.281319	577	657	16	8	80	0.1000000
NODE_6439_length_1009_cov_20.281319	577	657	18	11	80	0.1375000
NODE_6439_length_1009_cov_20.281319	630	710	0	7	80	0.0875000
NODE_6439_length_1009_cov_20.281319	630	710	8	5	80	0.0625000
NODE_6439_length_1009_cov_20.281319	630	710	10	21	80	0.2625000
NODE_6439_length_1009_cov_20.281319	630	710	12	15	80	0.1875000
NODE_6439_length_1009_cov_20.281319	630	710	14	32	80	0.4000000
NODE_6440_length_1009_cov_18.649451	430	510	0	34	80	0.4250000
NODE_6440_length_1009_cov_18.649451	430	510	2	46	80	0.5750000
NODE_6440_length_1009_cov_18.649451	483	563	0	80	80	1.0000000
NODE_6442_length_1009_cov_3.767033	647	727	0	80	80	1.0000000
NODE_6442_length_1009_cov_3.767033	700	780	0	80	80	1.0000000
NODE_6443_length_1009_cov_2.903297	36	63	0	27	27	1.0000000
NODE_6451_length_1008_cov_44.825083	399	479	0	45	80	0.5625000
NODE_6451_length_1008_cov_44.825083	399	479	2	35	80	0.4375000
NODE_6451_length_1008_cov_44.825083	452	532	0	80	80	1.0000000
NODE_6452_length_1008_cov_41.030803	280	360	0	72	80	0.9000000
NODE_6452_length_1008_cov_41.030803	280	360	2	8	80	0.1000000
NODE_6452_length_1008_cov_41.030803	333	413	0	80	80	1.0000000
NODE_6452_length_1008_cov_41.030803	409	489	0	80	80	1.0000000
NODE_6452_length_1008_cov_41.030803	462	542	0	80	80	1.0000000
NODE_6453_length_1008_cov_39.377338	311	391	0	80	80	1.0000000
NODE_6453_length_1008_cov_39.377338	364	444	0	80	80	1.0000000
NODE_6453_length_1008_cov_39.377338	440	520	0	6	80	0.0750000
NODE_6453_length_1008_cov_39.377338	440	520	2	74	80	0.9250000
NODE_6453_length_1008_cov_39.377338	493	573	2	80	80	1.0000000
NODE_6454_length_1008_cov_27.836084	405	485	4	80	80	1.0000000
NODE_6454_length_1008_cov_27.836084	458	538	0	44	80	0.5500000
NODE_6454_length_1008_cov_27.836084	458	538	4	36	80	0.4500000
NODE_6454_length_1008_cov_27.836084	534	614	0	80	80	1.0000000
NODE_6454_length_1008_cov_27.836084	587	667	0	80	80	1.0000000
NODE_6455_length_1008_cov_24.741474	485	565	0	47	80	0.5875000
NODE_6455_length_1008_cov_24.741474	485	565	2	33	80	0.4125000
NODE_6455_length_1008_cov_24.741474	538	618	0	3	80	0.0375000
NODE_6455_length_1008_cov_24.741474	538	618	2	77	80	0.9625000
NODE_6456_length_1008_cov_20.278328	401	481	0	80	80	1.0000000
NODE_6456_length_1008_cov_20.278328	454	534	0	80	80	1.0000000
NODE_6457_length_1008_cov_6.071507	460	540	0	80	80	1.0000000
NODE_6457_length_1008_cov_6.071507	513	593	0	80	80	1.0000000
NODE_6466_length_1008_cov_1.798680	0	64	0	10	64	0.1562500
NODE_6466_length_1008_cov_1.798680	0	64	4	54	64	0.8437500
NODE_6466_length_1008_cov_1.798680	37	104	4	65	67	0.9701493
NODE_6466_length_1008_cov_1.798680	37	104	6	2	67	0.0298507
NODE_6473_length_1007_cov_27.011013	294	371	0	27	77	0.3506494
NODE_6473_length_1007_cov_27.011013	294	371	2	50	77	0.6493506
NODE_6473_length_1007_cov_27.011013	347	424	0	11	77	0.1428571
NODE_6473_length_1007_cov_27.011013	347	424	2	66	77	0.8571429
NODE_6474_length_1007_cov_24.668502	369	449	0	80	80	1.0000000
NODE_6474_length_1007_cov_24.668502	422	502	0	80	80	1.0000000
NODE_6474_length_1007_cov_24.668502	498	578	0	80	80	1.0000000
NODE_6474_length_1007_cov_24.668502	551	631	0	80	80	1.0000000
NODE_6475_length_1007_cov_21.729075	454	534	0	80	80	1.0000000
NODE_6475_length_1007_cov_21.729075	507	587	0	80	80	1.0000000
NODE_6475_length_1007_cov_21.729075	583	663	0	80	80	1.0000000
NODE_6475_length_1007_cov_21.729075	636	716	0	80	80	1.0000000
NODE_6476_length_1007_cov_14.515419	400	480	2	46	80	0.5750000
NODE_6476_length_1007_cov_14.515419	400	480	4	34	80	0.4250000
NODE_6476_length_1007_cov_14.515419	453	533	0	14	80	0.1750000
NODE_6476_length_1007_cov_14.515419	453	533	2	15	80	0.1875000
NODE_6476_length_1007_cov_14.515419	453	533	4	51	80	0.6375000
NODE_6477_length_1007_cov_13.685022	376	456	1	5	80	0.0625000
NODE_6477_length_1007_cov_13.685022	376	456	7	1	80	0.0125000
NODE_6477_length_1007_cov_13.685022	376	456	8	19	80	0.2375000
NODE_6477_length_1007_cov_13.685022	376	456	9	5	80	0.0625000
NODE_6477_length_1007_cov_13.685022	376	456	10	50	80	0.6250000
NODE_6477_length_1007_cov_13.685022	429	509	9	22	80	0.2750000
NODE_6477_length_1007_cov_13.685022	429	509	10	58	80	0.7250000
NODE_6478_length_1007_cov_9.189427	438	518	0	59	80	0.7375000
NODE_6478_length_1007_cov_9.189427	438	518	2	21	80	0.2625000
NODE_6478_length_1007_cov_9.189427	491	571	0	80	80	1.0000000
NODE_6491_length_1006_cov_59.773980	379	459	0	14	80	0.1750000
NODE_6491_length_1006_cov_59.773980	379	459	4	1	80	0.0125000
NODE_6491_length_1006_cov_59.773980	379	459	7	33	80	0.4125000
NODE_6491_length_1006_cov_59.773980	379	459	13	32	80	0.4000000
NODE_6491_length_1006_cov_59.773980	432	512	13	63	80	0.7875000
NODE_6491_length_1006_cov_59.773980	432	512	14	17	80	0.2125000
NODE_6491_length_1006_cov_59.773980	508	588	8	2	80	0.0250000
NODE_6491_length_1006_cov_59.773980	508	588	9	18	80	0.2250000
NODE_6491_length_1006_cov_59.773980	508	588	13	23	80	0.2875000
NODE_6491_length_1006_cov_59.773980	508	588	15	27	80	0.3375000
NODE_6491_length_1006_cov_59.773980	508	588	20	1	80	0.0125000
NODE_6491_length_1006_cov_59.773980	508	588	21	9	80	0.1125000
NODE_6491_length_1006_cov_59.773980	561	641	2	6	80	0.0750000
NODE_6491_length_1006_cov_59.773980	561	641	8	2	80	0.0250000
NODE_6491_length_1006_cov_59.773980	561	641	9	56	80	0.7000000
NODE_6491_length_1006_cov_59.773980	561	641	10	9	80	0.1125000
NODE_6491_length_1006_cov_59.773980	561	641	15	7	80	0.0875000
NODE_6492_length_1006_cov_34.762955	482	562	0	16	80	0.2000000
NODE_6492_length_1006_cov_34.762955	482	562	7	1	80	0.0125000
NODE_6492_length_1006_cov_34.762955	482	562	8	46	80	0.5750000
NODE_6492_length_1006_cov_34.762955	482	562	14	17	80	0.2125000
NODE_6492_length_1006_cov_34.762955	535	615	0	69	80	0.8625000
NODE_6492_length_1006_cov_34.762955	535	615	7	1	80	0.0125000
NODE_6492_length_1006_cov_34.762955	535	615	8	10	80	0.1250000
NODE_6493_length_1006_cov_21.776185	516	596	2	52	80	0.6500000
NODE_6493_length_1006_cov_21.776185	516	596	4	28	80	0.3500000
NODE_6493_length_1006_cov_21.776185	569	649	2	55	80	0.6875000
NODE_6493_length_1006_cov_21.776185	569	649	4	25	80	0.3125000
NODE_6494_length_1006_cov_19.690187	371	451	0	80	80	1.0000000
NODE_6494_length_1006_cov_19.690187	424	504	0	80	80	1.0000000
NODE_6495_length_1006_cov_19.299890	495	575	0	80	80	1.0000000
NODE_6495_length_1006_cov_19.299890	548	628	0	80	80	1.0000000
NODE_6496_length_1006_cov_13.187431	245	325	0	80	80	1.0000000
NODE_6496_length_1006_cov_13.187431	298	378	0	80	80	1.0000000
NODE_6497_length_1006_cov_12.862183	383	463	0	25	80	0.3125000
NODE_6497_length_1006_cov_12.862183	383	463	4	55	80	0.6875000
NODE_6497_length_1006_cov_12.862183	436	516	4	80	80	1.0000000
NODE_6498_length_1006_cov_10.986770	762	842	0	80	80	1.0000000
NODE_6498_length_1006_cov_10.986770	815	895	0	80	80	1.0000000
NODE_6499_length_1006_cov_8.633958	314	394	0	3	80	0.0375000
NODE_6499_length_1006_cov_8.633958	314	394	4	44	80	0.5500000
NODE_6499_length_1006_cov_8.633958	314	394	6	33	80	0.4125000
NODE_6499_length_1006_cov_8.633958	367	447	0	9	80	0.1125000
NODE_6499_length_1006_cov_8.633958	367	447	2	6	80	0.0750000
NODE_6499_length_1006_cov_8.633958	367	447	6	65	80	0.8125000
NODE_6515_length_1005_cov_80.271523	509	589	4	20	80	0.2500000
NODE_6515_length_1005_cov_80.271523	509	589	10	44	80	0.5500000
NODE_6515_length_1005_cov_80.271523	509	589	12	16	80	0.2000000
NODE_6515_length_1005_cov_80.271523	562	642	0	34	80	0.4250000
NODE_6515_length_1005_cov_80.271523	562	642	2	13	80	0.1625000
NODE_6515_length_1005_cov_80.271523	562	642	4	26	80	0.3250000
NODE_6515_length_1005_cov_80.271523	562	642	10	7	80	0.0875000
NODE_6516_length_1005_cov_45.008830	357	437	0	80	80	1.0000000
NODE_6516_length_1005_cov_45.008830	410	490	0	80	80	1.0000000
NODE_6517_length_1005_cov_36.636865	567	647	0	25	80	0.3125000
NODE_6517_length_1005_cov_36.636865	567	647	4	55	80	0.6875000
NODE_6517_length_1005_cov_36.636865	620	700	0	21	80	0.2625000
NODE_6517_length_1005_cov_36.636865	620	700	4	59	80	0.7375000
NODE_6518_length_1005_cov_21.222958	389	409	0	20	20	1.0000000
NODE_6518_length_1005_cov_21.222958	451	519	0	68	68	1.0000000
NODE_6518_length_1005_cov_21.222958	515	595	0	80	80	1.0000000
NODE_6518_length_1005_cov_21.222958	568	648	0	80	80	1.0000000
NODE_6520_length_1005_cov_14.278146	480	560	0	80	80	1.0000000
NODE_6520_length_1005_cov_14.278146	533	613	0	59	80	0.7375000
NODE_6520_length_1005_cov_14.278146	533	613	2	21	80	0.2625000
NODE_6521_length_1005_cov_13.215232	511	591	0	80	80	1.0000000
NODE_6521_length_1005_cov_13.215232	564	644	0	80	80	1.0000000
NODE_6523_length_1005_cov_5.579470	534	614	0	80	80	1.0000000
NODE_6523_length_1005_cov_5.579470	587	667	0	80	80	1.0000000
NODE_6536_length_1004_cov_45.470718	343	423	0	80	80	1.0000000
NODE_6536_length_1004_cov_45.470718	396	476	0	80	80	1.0000000
NODE_6536_length_1004_cov_45.470718	472	552	0	80	80	1.0000000
NODE_6536_length_1004_cov_45.470718	525	605	0	80	80	1.0000000
NODE_6537_length_1004_cov_34.565746	419	499	3	2	80	0.0250000
NODE_6537_length_1004_cov_34.565746	419	499	5	57	80	0.7125000
NODE_6537_length_1004_cov_34.565746	419	499	7	21	80	0.2625000
NODE_6537_length_1004_cov_34.565746	472	552	1	36	80	0.4500000
NODE_6537_length_1004_cov_34.565746	472	552	2	14	80	0.1750000
NODE_6537_length_1004_cov_34.565746	472	552	3	5	80	0.0625000
NODE_6537_length_1004_cov_34.565746	472	552	5	25	80	0.3125000
NODE_6538_length_1004_cov_28.710497	385	465	0	80	80	1.0000000
NODE_6538_length_1004_cov_28.710497	438	518	0	80	80	1.0000000
NODE_6538_length_1004_cov_28.710497	514	594	0	80	80	1.0000000
NODE_6538_length_1004_cov_28.710497	567	647	0	80	80	1.0000000
NODE_6539_length_1004_cov_12.745856	432	512	8	80	80	1.0000000
NODE_6539_length_1004_cov_12.745856	485	565	0	12	80	0.1500000
NODE_6539_length_1004_cov_12.745856	485	565	8	68	80	0.8500000
NODE_6550_length_1003_cov_47.014381	383	463	0	80	80	1.0000000
NODE_6550_length_1003_cov_47.014381	436	516	0	80	80	1.0000000
NODE_6550_length_1003_cov_47.014381	512	592	0	80	80	1.0000000
NODE_6550_length_1003_cov_47.014381	565	645	0	80	80	1.0000000
NODE_6551_length_1003_cov_35.329646	372	452	11	56	80	0.7000000
NODE_6551_length_1003_cov_35.329646	372	452	12	24	80	0.3000000
NODE_6551_length_1003_cov_35.329646	425	505	5	7	80	0.0875000
NODE_6551_length_1003_cov_35.329646	425	505	6	26	80	0.3250000
NODE_6551_length_1003_cov_35.329646	425	505	7	15	80	0.1875000
NODE_6551_length_1003_cov_35.329646	425	505	11	3	80	0.0375000
NODE_6551_length_1003_cov_35.329646	425	505	12	29	80	0.3625000
NODE_6552_length_1003_cov_32.721239	357	437	0	80	80	1.0000000
NODE_6552_length_1003_cov_32.721239	410	490	0	80	80	1.0000000
NODE_6553_length_1003_cov_23.758850	467	547	0	80	80	1.0000000
NODE_6553_length_1003_cov_23.758850	520	600	0	80	80	1.0000000
NODE_6554_length_1003_cov_19.939159	240	320	2	52	80	0.6500000
NODE_6554_length_1003_cov_19.939159	240	320	4	12	80	0.1500000
NODE_6554_length_1003_cov_19.939159	240	320	6	16	80	0.2000000
NODE_6554_length_1003_cov_19.939159	293	373	4	49	80	0.6125000
NODE_6554_length_1003_cov_19.939159	293	373	6	31	80	0.3875000
NODE_6555_length_1003_cov_16.618363	524	604	0	33	80	0.4125000
NODE_6555_length_1003_cov_16.618363	524	604	1	6	80	0.0750000
NODE_6555_length_1003_cov_16.618363	524	604	2	41	80	0.5125000
NODE_6555_length_1003_cov_16.618363	577	657	2	80	80	1.0000000
NODE_6555_length_1003_cov_16.618363	653	733	0	20	80	0.2500000
NODE_6555_length_1003_cov_16.618363	653	733	1	6	80	0.0750000
NODE_6555_length_1003_cov_16.618363	653	733	2	54	80	0.6750000
NODE_6555_length_1003_cov_16.618363	706	786	0	73	80	0.9125000
NODE_6555_length_1003_cov_16.618363	706	786	1	6	80	0.0750000
NODE_6555_length_1003_cov_16.618363	706	786	2	1	80	0.0125000
NODE_6556_length_1003_cov_13.863938	537	617	0	17	80	0.2125000
NODE_6556_length_1003_cov_13.863938	537	617	2	44	80	0.5500000
NODE_6556_length_1003_cov_13.863938	537	617	4	19	80	0.2375000
NODE_6556_length_1003_cov_13.863938	590	670	2	40	80	0.5000000
NODE_6556_length_1003_cov_13.863938	590	670	4	40	80	0.5000000
NODE_6557_length_1003_cov_12.363938	529	609	0	69	80	0.8625000
NODE_6557_length_1003_cov_12.363938	529	609	1	11	80	0.1375000
NODE_6557_length_1003_cov_12.363938	582	662	0	16	80	0.2000000
NODE_6557_length_1003_cov_12.363938	582	662	1	15	80	0.1875000
NODE_6557_length_1003_cov_12.363938	582	662	2	49	80	0.6125000
NODE_6567_length_1002_cov_65.513843	387	467	0	80	80	1.0000000
NODE_6567_length_1002_cov_65.513843	440	520	0	80	80	1.0000000
NODE_6567_length_1002_cov_65.513843	516	596	0	80	80	1.0000000
NODE_6567_length_1002_cov_65.513843	569	649	0	80	80	1.0000000
NODE_6568_length_1002_cov_41.995570	408	488	0	66	80	0.8250000
NODE_6568_length_1002_cov_41.995570	408	488	2	14	80	0.1750000
NODE_6568_length_1002_cov_41.995570	461	541	0	80	80	1.0000000
NODE_6569_length_1002_cov_19.966777	401	481	2	57	80	0.7125000
NODE_6569_length_1002_cov_19.966777	401	481	4	23	80	0.2875000
NODE_6569_length_1002_cov_19.966777	454	534	2	57	80	0.7125000
NODE_6569_length_1002_cov_19.966777	454	534	4	23	80	0.2875000
NODE_6570_length_1002_cov_19.539313	334	414	0	50	80	0.6250000
NODE_6570_length_1002_cov_19.539313	334	414	2	1	80	0.0125000
NODE_6570_length_1002_cov_19.539313	334	414	3	29	80	0.3625000
NODE_6570_length_1002_cov_19.539313	335	414	0	49	79	0.6202531
NODE_6570_length_1002_cov_19.539313	335	414	2	1	79	0.0126582
NODE_6570_length_1002_cov_19.539313	335	414	3	29	79	0.3670886
NODE_6570_length_1002_cov_19.539313	387	467	3	28	80	0.3500000
NODE_6570_length_1002_cov_19.539313	387	467	6	52	80	0.6500000
NODE_6570_length_1002_cov_19.539313	387	467	3	28	80	0.3500000
NODE_6570_length_1002_cov_19.539313	387	467	6	52	80	0.6500000
NODE_6570_length_1002_cov_19.539313	396	467	3	19	71	0.2676056
NODE_6570_length_1002_cov_19.539313	396	467	6	52	71	0.7323943
NODE_6570_length_1002_cov_19.539313	463	543	5	9	80	0.1125000
NODE_6570_length_1002_cov_19.539313	463	543	6	50	80	0.6250000
NODE_6570_length_1002_cov_19.539313	463	543	7	1	80	0.0125000
NODE_6570_length_1002_cov_19.539313	463	543	8	20	80	0.2500000
NODE_6570_length_1002_cov_19.539313	516	596	0	2	80	0.0250000
NODE_6570_length_1002_cov_19.539313	516	596	2	29	80	0.3625000
NODE_6570_length_1002_cov_19.539313	516	596	5	31	80	0.3875000
NODE_6570_length_1002_cov_19.539313	516	596	7	1	80	0.0125000
NODE_6570_length_1002_cov_19.539313	516	596	8	17	80	0.2125000
NODE_6571_length_1002_cov_17.780731	631	711	4	20	80	0.2500000
NODE_6571_length_1002_cov_17.780731	631	711	6	60	80	0.7500000
NODE_6571_length_1002_cov_17.780731	684	764	0	50	80	0.6250000
NODE_6571_length_1002_cov_17.780731	684	764	6	30	80	0.3750000
NODE_6572_length_1002_cov_17.590255	0	58	0	58	58	1.0000000
NODE_6572_length_1002_cov_17.590255	31	77	0	46	46	1.0000000
NODE_6573_length_1002_cov_17.105205	522	602	0	80	80	1.0000000
NODE_6573_length_1002_cov_17.105205	575	655	0	80	80	1.0000000
NODE_6574_length_1002_cov_11.954596	480	560	0	14	80	0.1750000
NODE_6574_length_1002_cov_11.954596	480	560	4	66	80	0.8250000
NODE_6574_length_1002_cov_11.954596	533	613	0	9	80	0.1125000
NODE_6574_length_1002_cov_11.954596	533	613	4	71	80	0.8875000
NODE_6575_length_1002_cov_11.823920	471	551	0	80	80	1.0000000
NODE_6575_length_1002_cov_11.823920	524	614	0	90	90	1.0000000
NODE_6577_length_1002_cov_6.596899	422	502	0	39	80	0.4875000
NODE_6577_length_1002_cov_6.596899	422	502	2	41	80	0.5125000
NODE_6577_length_1002_cov_6.596899	475	555	2	48	80	0.6000000
NODE_6577_length_1002_cov_6.596899	475	555	6	32	80	0.4000000
NODE_6588_length_1002_cov_2.102990	29	110	4	3	81	0.0370370
NODE_6588_length_1002_cov_2.102990	29	110	8	7	81	0.0864198
NODE_6588_length_1002_cov_2.102990	29	110	10	4	81	0.0493827
NODE_6588_length_1002_cov_2.102990	29	110	12	9	81	0.1111111
NODE_6588_length_1002_cov_2.102990	29	110	14	1	81	0.0123457
NODE_6588_length_1002_cov_2.102990	29	110	16	12	81	0.1481481
NODE_6588_length_1002_cov_2.102990	29	110	20	45	81	0.5555556
NODE_6596_length_1001_cov_41.914634	549	629	0	80	80	1.0000000
NODE_6596_length_1001_cov_41.914634	602	682	0	51	80	0.6375000
NODE_6596_length_1001_cov_41.914634	602	682	2	29	80	0.3625000
NODE_6597_length_1001_cov_30.378049	306	386	1	80	80	1.0000000
NODE_6597_length_1001_cov_30.378049	359	439	0	5	80	0.0625000
NODE_6597_length_1001_cov_30.378049	359	439	1	75	80	0.9375000
NODE_6597_length_1001_cov_30.378049	369	439	0	5	70	0.0714286
NODE_6597_length_1001_cov_30.378049	369	439	1	65	70	0.9285714
NODE_6597_length_1001_cov_30.378049	435	515	0	80	80	1.0000000
NODE_6597_length_1001_cov_30.378049	488	568	0	80	80	1.0000000
NODE_6598_length_1001_cov_22.517738	536	616	0	47	80	0.5875000
NODE_6598_length_1001_cov_22.517738	536	616	2	33	80	0.4125000
NODE_6598_length_1001_cov_22.517738	589	670	2	81	81	1.0000000
NODE_6599_length_1001_cov_17.996674	414	456	0	42	42	1.0000000
NODE_6599_length_1001_cov_17.996674	429	509	0	80	80	1.0000000
NODE_6599_length_1001_cov_17.996674	505	585	0	80	80	1.0000000
NODE_6599_length_1001_cov_17.996674	558	638	0	80	80	1.0000000
NODE_6600_length_1001_cov_16.798226	422	502	0	80	80	1.0000000
NODE_6600_length_1001_cov_16.798226	475	555	0	80	80	1.0000000
NODE_6600_length_1001_cov_16.798226	551	631	0	80	80	1.0000000
NODE_6600_length_1001_cov_16.798226	604	684	0	80	80	1.0000000
NODE_6601_length_1001_cov_12.778271	348	428	0	80	80	1.0000000
NODE_6601_length_1001_cov_12.778271	401	481	0	80	80	1.0000000
NODE_6602_length_1001_cov_12.305987	255	335	0	80	80	1.0000000
NODE_6602_length_1001_cov_12.305987	308	388	0	44	80	0.5500000
NODE_6602_length_1001_cov_12.305987	308	388	2	36	80	0.4500000
NODE_6603_length_1001_cov_11.955654	485	569	0	84	84	1.0000000
NODE_6603_length_1001_cov_11.955654	542	622	0	80	80	1.0000000
NODE_6604_length_1001_cov_10.156319	587	667	0	73	80	0.9125000
NODE_6604_length_1001_cov_10.156319	587	667	2	7	80	0.0875000
NODE_6604_length_1001_cov_10.156319	640	720	0	80	80	1.0000000
NODE_6605_length_1001_cov_9.754989	377	457	0	27	80	0.3375000
NODE_6605_length_1001_cov_9.754989	377	457	2	53	80	0.6625000
NODE_6605_length_1001_cov_9.754989	430	510	0	80	80	1.0000000
NODE_6607_length_1001_cov_4.616408	408	488	0	80	80	1.0000000
NODE_6607_length_1001_cov_4.616408	461	541	0	80	80	1.0000000
NODE_6616_length_1000_cov_55.578246	393	473	0	80	80	1.0000000
NODE_6616_length_1000_cov_55.578246	446	526	0	80	80	1.0000000
NODE_6616_length_1000_cov_55.578246	522	598	0	76	76	1.0000000
NODE_6616_length_1000_cov_55.578246	575	649	0	74	74	1.0000000
NODE_6617_length_1000_cov_51.534961	432	512	0	19	80	0.2375000
NODE_6617_length_1000_cov_51.534961	432	512	2	61	80	0.7625000
NODE_6617_length_1000_cov_51.534961	485	565	0	53	80	0.6625000
NODE_6617_length_1000_cov_51.534961	485	565	2	8	80	0.1000000
NODE_6617_length_1000_cov_51.534961	485	565	14	19	80	0.2375000
NODE_6617_length_1000_cov_51.534961	561	641	14	14	80	0.1750000
NODE_6617_length_1000_cov_51.534961	561	641	15	23	80	0.2875000
NODE_6617_length_1000_cov_51.534961	561	641	16	43	80	0.5375000
NODE_6617_length_1000_cov_51.534961	614	694	0	6	80	0.0750000
NODE_6617_length_1000_cov_51.534961	614	694	2	17	80	0.2125000
NODE_6617_length_1000_cov_51.534961	614	694	15	53	80	0.6625000
NODE_6617_length_1000_cov_51.534961	614	694	16	4	80	0.0500000
NODE_6618_length_1000_cov_39.011099	186	266	0	80	80	1.0000000
NODE_6618_length_1000_cov_39.011099	239	319	0	80	80	1.0000000
NODE_6619_length_1000_cov_19.897891	451	531	0	80	80	1.0000000
NODE_6619_length_1000_cov_19.897891	504	584	0	80	80	1.0000000
NODE_6619_length_1000_cov_19.897891	580	660	0	10	80	0.1250000
NODE_6619_length_1000_cov_19.897891	580	660	4	70	80	0.8750000
NODE_6619_length_1000_cov_19.897891	633	713	0	8	80	0.1000000
NODE_6619_length_1000_cov_19.897891	633	713	1	5	80	0.0625000
NODE_6619_length_1000_cov_19.897891	633	713	4	67	80	0.8375000
NODE_6620_length_1000_cov_13.349612	324	404	0	80	80	1.0000000
NODE_6620_length_1000_cov_13.349612	377	457	0	80	80	1.0000000
NODE_6621_length_1000_cov_11.463929	382	462	0	80	80	1.0000000
NODE_6621_length_1000_cov_11.463929	435	515	0	80	80	1.0000000
NODE_6622_length_1000_cov_9.675916	625	705	0	78	80	0.9750000
NODE_6622_length_1000_cov_9.675916	625	705	1	2	80	0.0250000
NODE_6622_length_1000_cov_9.675916	678	758	0	25	80	0.3125000
NODE_6622_length_1000_cov_9.675916	678	758	1	39	80	0.4875000
NODE_6622_length_1000_cov_9.675916	678	758	2	16	80	0.2000000
NODE_6623_length_1000_cov_7.051054	358	438	0	9	80	0.1125000
NODE_6623_length_1000_cov_7.051054	358	438	2	71	80	0.8875000
NODE_6623_length_1000_cov_7.051054	411	491	0	62	80	0.7750000
NODE_6623_length_1000_cov_7.051054	411	491	2	18	80	0.2250000
NODE_6626_length_1000_cov_3.652608	203	265	0	62	62	1.0000000
NODE_6639_length_999_cov_47.442222	604	684	0	80	80	1.0000000
NODE_6639_length_999_cov_47.442222	657	723	0	66	66	1.0000000
NODE_6640_length_999_cov_33.055556	458	540	0	17	82	0.2073171
NODE_6640_length_999_cov_33.055556	458	540	2	4	82	0.0487805
NODE_6640_length_999_cov_33.055556	458	540	4	61	82	0.7439024
NODE_6640_length_999_cov_33.055556	513	593	0	11	80	0.1375000
NODE_6640_length_999_cov_33.055556	513	593	2	2	80	0.0250000
NODE_6640_length_999_cov_33.055556	513	593	4	67	80	0.8375000
NODE_6641_length_999_cov_22.755556	493	573	0	27	80	0.3375000
NODE_6641_length_999_cov_22.755556	493	573	6	16	80	0.2000000
NODE_6641_length_999_cov_22.755556	493	573	14	37	80	0.4625000
NODE_6641_length_999_cov_22.755556	546	626	6	11	80	0.1375000
NODE_6641_length_999_cov_22.755556	546	626	13	1	80	0.0125000
NODE_6641_length_999_cov_22.755556	546	626	14	68	80	0.8500000
NODE_6642_length_999_cov_21.842222	359	439	0	80	80	1.0000000
NODE_6642_length_999_cov_21.842222	412	492	0	80	80	1.0000000
NODE_6643_length_999_cov_20.006667	361	441	4	1	80	0.0125000
NODE_6643_length_999_cov_20.006667	361	441	6	28	80	0.3500000
NODE_6643_length_999_cov_20.006667	361	441	7	4	80	0.0500000
NODE_6643_length_999_cov_20.006667	361	441	8	47	80	0.5875000
NODE_6643_length_999_cov_20.006667	414	494	2	15	80	0.1875000
NODE_6643_length_999_cov_20.006667	414	494	3	14	80	0.1750000
NODE_6643_length_999_cov_20.006667	414	494	4	1	80	0.0125000
NODE_6643_length_999_cov_20.006667	414	494	5	18	80	0.2250000
NODE_6643_length_999_cov_20.006667	414	494	6	13	80	0.1625000
NODE_6643_length_999_cov_20.006667	414	494	7	9	80	0.1125000
NODE_6643_length_999_cov_20.006667	414	494	8	10	80	0.1250000
NODE_6643_length_999_cov_20.006667	490	570	2	80	80	1.0000000
NODE_6643_length_999_cov_20.006667	543	623	1	36	80	0.4500000
NODE_6643_length_999_cov_20.006667	543	623	2	44	80	0.5500000
NODE_6645_length_999_cov_16.794444	438	518	0	50	80	0.6250000
NODE_6645_length_999_cov_16.794444	438	518	1	20	80	0.2500000
NODE_6645_length_999_cov_16.794444	438	518	2	1	80	0.0125000
NODE_6645_length_999_cov_16.794444	438	518	4	9	80	0.1125000
NODE_6645_length_999_cov_16.794444	491	571	0	80	80	1.0000000
NODE_6646_length_999_cov_15.146667	464	544	0	80	80	1.0000000
NODE_6646_length_999_cov_15.146667	517	597	0	80	80	1.0000000
NODE_6648_length_999_cov_8.771111	361	441	0	80	80	1.0000000
NODE_6648_length_999_cov_8.771111	414	492	0	78	78	1.0000000
NODE_6649_length_999_cov_5.171111	417	497	0	13	80	0.1625000
NODE_6649_length_999_cov_5.171111	417	497	2	67	80	0.8375000
NODE_6649_length_999_cov_5.171111	470	550	2	80	80	1.0000000
NODE_6650_length_999_cov_2.854444	35	101	8	61	66	0.9242424
NODE_6650_length_999_cov_2.854444	35	101	10	1	66	0.0151515
NODE_6650_length_999_cov_2.854444	35	101	12	4	66	0.0606061
NODE_6657_length_998_cov_30.697442	404	484	4	43	80	0.5375000
NODE_6657_length_998_cov_30.697442	404	484	6	37	80	0.4625000
NODE_6657_length_998_cov_30.697442	457	537	0	6	80	0.0750000
NODE_6657_length_998_cov_30.697442	457	537	4	74	80	0.9250000
NODE_6657_length_998_cov_30.697442	533	613	0	66	80	0.8250000
NODE_6657_length_998_cov_30.697442	533	613	2	14	80	0.1750000
NODE_6657_length_998_cov_30.697442	586	666	0	13	80	0.1625000
NODE_6657_length_998_cov_30.697442	586	666	2	67	80	0.8375000
NODE_6658_length_998_cov_23.703003	235	315	0	16	80	0.2000000
NODE_6658_length_998_cov_23.703003	235	315	2	64	80	0.8000000
NODE_6658_length_998_cov_23.703003	288	368	0	69	80	0.8625000
NODE_6658_length_998_cov_23.703003	288	368	2	11	80	0.1375000
NODE_6659_length_998_cov_22.692992	531	611	0	80	80	1.0000000
NODE_6659_length_998_cov_22.692992	584	664	0	80	80	1.0000000
NODE_6660_length_998_cov_11.152392	514	594	0	80	80	1.0000000
NODE_6660_length_998_cov_11.152392	567	640	0	73	73	1.0000000
NODE_6660_length_998_cov_11.152392	636	716	0	80	80	1.0000000
NODE_6660_length_998_cov_11.152392	689	769	0	80	80	1.0000000
NODE_6661_length_998_cov_10.061179	422	502	4	18	80	0.2250000
NODE_6661_length_998_cov_10.061179	422	502	6	62	80	0.7750000
NODE_6661_length_998_cov_10.061179	475	555	2	42	80	0.5250000
NODE_6661_length_998_cov_10.061179	475	555	4	20	80	0.2500000
NODE_6661_length_998_cov_10.061179	475	555	6	18	80	0.2250000
NODE_6662_length_998_cov_7.126808	353	430	0	59	77	0.7662337
NODE_6662_length_998_cov_7.126808	353	430	7	1	77	0.0129870
NODE_6662_length_998_cov_7.126808	353	430	8	4	77	0.0519481
NODE_6662_length_998_cov_7.126808	353	430	11	13	77	0.1688312
NODE_6662_length_998_cov_7.126808	403	483	0	9	80	0.1125000
NODE_6662_length_998_cov_7.126808	403	483	7	1	80	0.0125000
NODE_6662_length_998_cov_7.126808	403	483	8	4	80	0.0500000
NODE_6662_length_998_cov_7.126808	403	483	11	28	80	0.3500000
NODE_6662_length_998_cov_7.126808	403	483	12	38	80	0.4750000
NODE_6669_length_997_cov_48.518931	445	525	0	32	80	0.4000000
NODE_6669_length_997_cov_48.518931	445	525	4	48	80	0.6000000
NODE_6669_length_997_cov_48.518931	498	578	0	31	80	0.3875000
NODE_6669_length_997_cov_48.518931	498	578	4	49	80	0.6125000
NODE_6670_length_997_cov_36.721604	400	480	0	80	80	1.0000000
NODE_6670_length_997_cov_36.721604	453	533	0	80	80	1.0000000
NODE_6671_length_997_cov_22.646993	328	408	0	9	80	0.1125000
NODE_6671_length_997_cov_22.646993	328	408	2	8	80	0.1000000
NODE_6671_length_997_cov_22.646993	328	408	4	63	80	0.7875000
NODE_6671_length_997_cov_22.646993	381	461	4	80	80	1.0000000
NODE_6672_length_997_cov_19.709354	420	500	0	80	80	1.0000000
NODE_6672_length_997_cov_19.709354	473	553	0	80	80	1.0000000
NODE_6672_length_997_cov_19.709354	549	629	0	31	80	0.3875000
NODE_6672_length_997_cov_19.709354	549	629	2	49	80	0.6125000
NODE_6672_length_997_cov_19.709354	602	682	0	4	80	0.0500000
NODE_6672_length_997_cov_19.709354	602	682	2	76	80	0.9500000
NODE_6673_length_997_cov_17.947661	465	545	0	80	80	1.0000000
NODE_6673_length_997_cov_17.947661	518	598	0	80	80	1.0000000
NODE_6673_length_997_cov_17.947661	594	674	0	80	80	1.0000000
NODE_6673_length_997_cov_17.947661	647	727	0	80	80	1.0000000
NODE_6674_length_997_cov_14.718263	388	468	0	80	80	1.0000000
NODE_6674_length_997_cov_14.718263	441	521	0	80	80	1.0000000
NODE_6675_length_997_cov_7.114699	307	387	0	53	80	0.6625000
NODE_6675_length_997_cov_7.114699	307	387	2	27	80	0.3375000
NODE_6675_length_997_cov_7.114699	360	440	2	80	80	1.0000000
NODE_6694_length_996_cov_59.568562	387	467	0	80	80	1.0000000
NODE_6694_length_996_cov_59.568562	440	520	0	80	80	1.0000000
NODE_6695_length_996_cov_32.462653	503	583	0	21	80	0.2625000
NODE_6695_length_996_cov_32.462653	503	583	5	1	80	0.0125000
NODE_6695_length_996_cov_32.462653	503	583	6	58	80	0.7250000
NODE_6695_length_996_cov_32.462653	556	636	4	30	80	0.3750000
NODE_6695_length_996_cov_32.462653	556	636	6	33	80	0.4125000
NODE_6695_length_996_cov_32.462653	556	636	8	2	80	0.0250000
NODE_6695_length_996_cov_32.462653	556	636	10	15	80	0.1875000
NODE_6696_length_996_cov_23.312152	571	651	0	32	80	0.4000000
NODE_6696_length_996_cov_23.312152	571	651	2	48	80	0.6000000
NODE_6696_length_996_cov_23.312152	624	704	0	80	80	1.0000000
NODE_6697_length_996_cov_20.979933	533	613	0	55	80	0.6875000
NODE_6697_length_996_cov_20.979933	533	613	4	25	80	0.3125000
NODE_6697_length_996_cov_20.979933	586	666	0	2	80	0.0250000
NODE_6697_length_996_cov_20.979933	586	666	4	78	80	0.9750000
NODE_6698_length_996_cov_17.865106	535	615	0	80	80	1.0000000
NODE_6698_length_996_cov_17.865106	588	668	0	80	80	1.0000000
NODE_6699_length_996_cov_10.297659	499	579	2	42	80	0.5250000
NODE_6699_length_996_cov_10.297659	499	579	4	38	80	0.4750000
NODE_6699_length_996_cov_10.297659	552	630	0	39	78	0.5000000
NODE_6699_length_996_cov_10.297659	552	630	2	39	78	0.5000000
NODE_6702_length_996_cov_3.205128	499	555	0	32	56	0.5714286
NODE_6702_length_996_cov_3.205128	499	555	2	24	56	0.4285714
NODE_6707_length_995_cov_26.131696	543	623	0	29	80	0.3625000
NODE_6707_length_995_cov_26.131696	543	623	2	6	80	0.0750000
NODE_6707_length_995_cov_26.131696	543	623	4	45	80	0.5625000
NODE_6707_length_995_cov_26.131696	596	676	0	80	80	1.0000000
NODE_6708_length_995_cov_20.262277	457	537	0	80	80	1.0000000
NODE_6708_length_995_cov_20.262277	510	590	0	80	80	1.0000000
NODE_6709_length_995_cov_19.382812	457	537	0	80	80	1.0000000
NODE_6709_length_995_cov_19.382812	510	590	0	80	80	1.0000000
NODE_6710_length_995_cov_19.034598	453	533	8	9	80	0.1125000
NODE_6710_length_995_cov_19.034598	453	533	9	71	80	0.8875000
NODE_6710_length_995_cov_19.034598	506	586	0	32	80	0.4000000
NODE_6710_length_995_cov_19.034598	506	586	9	48	80	0.6000000
NODE_6711_length_995_cov_9.734375	222	323	0	21	101	0.2079208
NODE_6711_length_995_cov_9.734375	222	323	2	44	101	0.4356436
NODE_6711_length_995_cov_9.734375	222	323	4	36	101	0.3564357
NODE_6711_length_995_cov_9.734375	296	376	2	7	80	0.0875000
NODE_6711_length_995_cov_9.734375	296	376	4	55	80	0.6875000
NODE_6711_length_995_cov_9.734375	296	376	6	18	80	0.2250000
NODE_6723_length_994_cov_74.678212	362	442	2	15	80	0.1875000
NODE_6723_length_994_cov_74.678212	362	442	4	8	80	0.1000000
NODE_6723_length_994_cov_74.678212	362	442	6	36	80	0.4500000
NODE_6723_length_994_cov_74.678212	362	442	8	21	80	0.2625000
NODE_6723_length_994_cov_74.678212	415	495	2	15	80	0.1875000
NODE_6723_length_994_cov_74.678212	415	495	4	61	80	0.7625000
NODE_6723_length_994_cov_74.678212	415	495	8	4	80	0.0500000
NODE_6723_length_994_cov_74.678212	491	571	2	24	80	0.3000000
NODE_6723_length_994_cov_74.678212	491	571	3	26	80	0.3250000
NODE_6723_length_994_cov_74.678212	491	571	4	30	80	0.3750000
NODE_6723_length_994_cov_74.678212	544	624	0	41	80	0.5125000
NODE_6723_length_994_cov_74.678212	544	624	2	36	80	0.4500000
NODE_6723_length_994_cov_74.678212	544	624	3	3	80	0.0375000
NODE_6724_length_994_cov_26.045810	442	522	0	80	80	1.0000000
NODE_6724_length_994_cov_26.045810	495	575	0	80	80	1.0000000
NODE_6725_length_994_cov_25.240223	504	584	0	80	80	1.0000000
NODE_6725_length_994_cov_25.240223	557	637	0	80	80	1.0000000
NODE_6726_length_994_cov_24.615642	422	502	0	80	80	1.0000000
NODE_6726_length_994_cov_24.615642	475	555	0	80	80	1.0000000
NODE_6726_length_994_cov_24.615642	551	631	0	80	80	1.0000000
NODE_6726_length_994_cov_24.615642	604	684	0	30	80	0.3750000
NODE_6726_length_994_cov_24.615642	604	684	2	50	80	0.6250000
NODE_6727_length_994_cov_22.593296	323	403	0	10	80	0.1250000
NODE_6727_length_994_cov_22.593296	323	403	1	66	80	0.8250000
NODE_6727_length_994_cov_22.593296	323	403	2	4	80	0.0500000
NODE_6727_length_994_cov_22.593296	376	456	1	23	80	0.2875000
NODE_6727_length_994_cov_22.593296	376	456	2	57	80	0.7125000
NODE_6727_length_994_cov_22.593296	452	532	1	49	80	0.6125000
NODE_6727_length_994_cov_22.593296	452	532	2	31	80	0.3875000
NODE_6727_length_994_cov_22.593296	505	585	0	24	80	0.3000000
NODE_6727_length_994_cov_22.593296	505	585	1	44	80	0.5500000
NODE_6727_length_994_cov_22.593296	505	585	2	12	80	0.1500000
NODE_6728_length_994_cov_6.985475	0	58	0	58	58	1.0000000
NODE_6728_length_994_cov_6.985475	15	95	0	80	80	1.0000000
NODE_6728_length_994_cov_6.985475	68	148	0	37	80	0.4625000
NODE_6728_length_994_cov_6.985475	68	148	2	43	80	0.5375000
NODE_6740_length_993_cov_56.321029	266	346	0	80	80	1.0000000
NODE_6740_length_993_cov_56.321029	319	399	0	80	80	1.0000000
NODE_6740_length_993_cov_56.321029	400	470	0	70	70	1.0000000
NODE_6740_length_993_cov_56.321029	443	523	0	80	80	1.0000000
NODE_6741_length_993_cov_44.695749	385	465	0	18	80	0.2250000
NODE_6741_length_993_cov_44.695749	385	465	2	19	80	0.2375000
NODE_6741_length_993_cov_44.695749	385	465	4	10	80	0.1250000
NODE_6741_length_993_cov_44.695749	385	465	6	33	80	0.4125000
NODE_6741_length_993_cov_44.695749	438	518	0	7	80	0.0875000
NODE_6741_length_993_cov_44.695749	438	518	4	56	80	0.7000000
NODE_6741_length_993_cov_44.695749	438	518	6	17	80	0.2125000
NODE_6742_length_993_cov_40.574944	417	497	0	80	80	1.0000000
NODE_6742_length_993_cov_40.574944	470	550	0	80	80	1.0000000
NODE_6742_length_993_cov_40.574944	546	628	0	82	82	1.0000000
NODE_6742_length_993_cov_40.574944	601	681	0	39	80	0.4875000
NODE_6742_length_993_cov_40.574944	601	681	2	41	80	0.5125000
NODE_6743_length_993_cov_39.817673	3	83	0	22	80	0.2750000
NODE_6743_length_993_cov_39.817673	3	83	2	29	80	0.3625000
NODE_6743_length_993_cov_39.817673	3	83	4	29	80	0.3625000
NODE_6744_length_993_cov_30.128635	477	557	10	13	80	0.1625000
NODE_6744_length_993_cov_30.128635	477	557	13	18	80	0.2250000
NODE_6744_length_993_cov_30.128635	477	557	14	49	80	0.6125000
NODE_6744_length_993_cov_30.128635	530	610	0	35	80	0.4375000
NODE_6744_length_993_cov_30.128635	530	610	4	3	80	0.0375000
NODE_6744_length_993_cov_30.128635	530	610	13	33	80	0.4125000
NODE_6744_length_993_cov_30.128635	530	610	14	9	80	0.1125000
NODE_6745_length_993_cov_17.435123	573	653	0	20	80	0.2500000
NODE_6745_length_993_cov_17.435123	573	653	4	60	80	0.7500000
NODE_6745_length_993_cov_17.435123	626	706	4	80	80	1.0000000
NODE_6746_length_993_cov_13.074944	483	563	0	31	80	0.3875000
NODE_6746_length_993_cov_13.074944	483	563	2	20	80	0.2500000
NODE_6746_length_993_cov_13.074944	483	563	4	29	80	0.3625000
NODE_6746_length_993_cov_13.074944	536	616	4	80	80	1.0000000
NODE_6747_length_993_cov_10.190157	500	580	0	74	80	0.9250000
NODE_6747_length_993_cov_10.190157	500	580	2	6	80	0.0750000
NODE_6747_length_993_cov_10.190157	553	633	0	21	80	0.2625000
NODE_6747_length_993_cov_10.190157	553	633	2	11	80	0.1375000
NODE_6747_length_993_cov_10.190157	553	633	4	4	80	0.0500000
NODE_6747_length_993_cov_10.190157	553	633	5	1	80	0.0125000
NODE_6747_length_993_cov_10.190157	553	633	6	43	80	0.5375000
NODE_6756_length_993_cov_0.909396	16	73	0	57	57	1.0000000
NODE_6757_length_992_cov_36.119821	354	434	0	80	80	1.0000000
NODE_6757_length_992_cov_36.119821	407	487	0	59	80	0.7375000
NODE_6757_length_992_cov_36.119821	407	487	2	21	80	0.2625000
NODE_6757_length_992_cov_36.119821	483	563	2	30	80	0.3750000
NODE_6757_length_992_cov_36.119821	483	563	3	1	80	0.0125000
NODE_6757_length_992_cov_36.119821	483	563	4	49	80	0.6125000
NODE_6757_length_992_cov_36.119821	536	616	2	40	80	0.5000000
NODE_6757_length_992_cov_36.119821	536	616	4	40	80	0.5000000
NODE_6758_length_992_cov_34.802912	443	523	0	80	80	1.0000000
NODE_6758_length_992_cov_34.802912	496	576	0	80	80	1.0000000
NODE_6759_length_992_cov_33.047032	381	461	14	1	80	0.0125000
NODE_6759_length_992_cov_33.047032	381	461	49	1	80	0.0125000
NODE_6759_length_992_cov_33.047032	381	461	50	3	80	0.0375000
NODE_6759_length_992_cov_33.047032	381	461	51	35	80	0.4375000
NODE_6759_length_992_cov_33.047032	381	461	52	2	80	0.0250000
NODE_6759_length_992_cov_33.047032	381	461	54	18	80	0.2250000
NODE_6759_length_992_cov_33.047032	381	461	55	20	80	0.2500000
NODE_6759_length_992_cov_33.047032	434	514	44	6	80	0.0750000
NODE_6759_length_992_cov_33.047032	434	514	46	7	80	0.0875000
NODE_6759_length_992_cov_33.047032	434	514	47	22	80	0.2750000
NODE_6759_length_992_cov_33.047032	434	514	54	14	80	0.1750000
NODE_6759_length_992_cov_33.047032	434	514	55	13	80	0.1625000
NODE_6759_length_992_cov_33.047032	434	514	56	4	80	0.0500000
NODE_6759_length_992_cov_33.047032	434	514	59	2	80	0.0250000
NODE_6759_length_992_cov_33.047032	434	514	61	12	80	0.1500000
NODE_6759_length_992_cov_33.047032	510	590	0	61	80	0.7625000
NODE_6759_length_992_cov_33.047032	510	590	43	1	80	0.0125000
NODE_6759_length_992_cov_33.047032	510	590	44	18	80	0.2250000
NODE_6759_length_992_cov_33.047032	563	643	0	80	80	1.0000000
NODE_6760_length_992_cov_23.543113	435	515	7	67	80	0.8375000
NODE_6760_length_992_cov_23.543113	435	515	9	13	80	0.1625000
NODE_6760_length_992_cov_23.543113	488	568	2	11	80	0.1375000
NODE_6760_length_992_cov_23.543113	488	568	6	6	80	0.0750000
NODE_6760_length_992_cov_23.543113	488	568	7	14	80	0.1750000
NODE_6760_length_992_cov_23.543113	488	568	8	2	80	0.0250000
NODE_6760_length_992_cov_23.543113	488	568	9	47	80	0.5875000
NODE_6761_length_992_cov_22.608063	440	520	0	14	80	0.1750000
NODE_6761_length_992_cov_22.608063	440	520	2	1	80	0.0125000
NODE_6761_length_992_cov_22.608063	440	520	8	65	80	0.8125000
NODE_6761_length_992_cov_22.608063	493	573	0	67	80	0.8375000
NODE_6761_length_992_cov_22.608063	493	573	2	1	80	0.0125000
NODE_6761_length_992_cov_22.608063	493	573	8	12	80	0.1500000
NODE_6762_length_992_cov_21.427772	216	296	0	42	80	0.5250000
NODE_6762_length_992_cov_21.427772	216	296	6	38	80	0.4750000
NODE_6762_length_992_cov_21.427772	269	349	6	80	80	1.0000000
NODE_6763_length_992_cov_20.010078	312	392	0	80	80	1.0000000
NODE_6763_length_992_cov_20.010078	365	445	0	80	80	1.0000000
NODE_6764_length_992_cov_16.524076	465	545	1	28	80	0.3500000
NODE_6764_length_992_cov_16.524076	465	545	3	52	80	0.6500000
NODE_6764_length_992_cov_16.524076	518	598	1	68	80	0.8500000
NODE_6764_length_992_cov_16.524076	518	598	2	12	80	0.1500000
NODE_6765_length_992_cov_16.266517	396	476	0	28	80	0.3500000
NODE_6765_length_992_cov_16.266517	396	476	4	52	80	0.6500000
NODE_6765_length_992_cov_16.266517	449	529	4	80	80	1.0000000
NODE_6766_length_992_cov_16.146697	272	352	0	80	80	1.0000000
NODE_6766_length_992_cov_16.146697	325	405	0	46	80	0.5750000
NODE_6766_length_992_cov_16.146697	325	405	2	34	80	0.4250000
NODE_6767_length_992_cov_15.212766	354	434	0	80	80	1.0000000
NODE_6767_length_992_cov_15.212766	407	487	0	80	80	1.0000000
NODE_6767_length_992_cov_15.212766	483	563	0	80	80	1.0000000
NODE_6767_length_992_cov_15.212766	536	616	0	80	80	1.0000000
NODE_6781_length_991_cov_48.582960	451	531	0	80	80	1.0000000
NODE_6781_length_991_cov_48.582960	504	584	0	80	80	1.0000000
NODE_6782_length_991_cov_25.891256	340	420	0	80	80	1.0000000
NODE_6782_length_991_cov_25.891256	393	473	0	80	80	1.0000000
NODE_6782_length_991_cov_25.891256	469	549	0	80	80	1.0000000
NODE_6782_length_991_cov_25.891256	522	602	0	80	80	1.0000000
NODE_6783_length_991_cov_25.392377	377	457	4	40	80	0.5000000
NODE_6783_length_991_cov_25.392377	377	457	8	40	80	0.5000000
NODE_6783_length_991_cov_25.392377	430	510	0	26	80	0.3250000
NODE_6783_length_991_cov_25.392377	430	510	4	37	80	0.4625000
NODE_6783_length_991_cov_25.392377	430	510	8	17	80	0.2125000
NODE_6783_length_991_cov_25.392377	506	586	0	71	80	0.8875000
NODE_6783_length_991_cov_25.392377	506	586	2	9	80	0.1125000
NODE_6783_length_991_cov_25.392377	559	639	0	18	80	0.2250000
NODE_6783_length_991_cov_25.392377	559	639	2	62	80	0.7750000
NODE_6784_length_991_cov_22.210762	421	501	2	12	80	0.1500000
NODE_6784_length_991_cov_22.210762	421	501	3	68	80	0.8500000
NODE_6784_length_991_cov_22.210762	474	554	0	15	80	0.1875000
NODE_6784_length_991_cov_22.210762	474	554	1	1	80	0.0125000
NODE_6784_length_991_cov_22.210762	474	554	2	18	80	0.2250000
NODE_6784_length_991_cov_22.210762	474	554	3	46	80	0.5750000
NODE_6785_length_991_cov_18.008969	366	446	0	80	80	1.0000000
NODE_6785_length_991_cov_18.008969	419	499	0	80	80	1.0000000
NODE_6785_length_991_cov_18.008969	495	575	0	80	80	1.0000000
NODE_6785_length_991_cov_18.008969	548	629	0	81	81	1.0000000
NODE_6786_length_991_cov_14.727578	426	506	0	44	80	0.5500000
NODE_6786_length_991_cov_14.727578	426	506	2	28	80	0.3500000
NODE_6786_length_991_cov_14.727578	426	506	4	8	80	0.1000000
NODE_6786_length_991_cov_14.727578	479	559	2	19	80	0.2375000
NODE_6786_length_991_cov_14.727578	479	559	4	13	80	0.1625000
NODE_6786_length_991_cov_14.727578	479	559	6	15	80	0.1875000
NODE_6786_length_991_cov_14.727578	479	559	7	1	80	0.0125000
NODE_6786_length_991_cov_14.727578	479	559	8	32	80	0.4000000
NODE_6787_length_991_cov_13.081839	240	320	0	80	80	1.0000000
NODE_6787_length_991_cov_13.081839	293	373	0	80	80	1.0000000
NODE_6788_length_991_cov_12.693946	425	505	0	13	80	0.1625000
NODE_6788_length_991_cov_12.693946	425	505	2	67	80	0.8375000
NODE_6788_length_991_cov_12.693946	478	558	0	37	80	0.4625000
NODE_6788_length_991_cov_12.693946	478	558	2	43	80	0.5375000
NODE_6789_length_991_cov_9.647982	436	516	0	16	80	0.2000000
NODE_6789_length_991_cov_9.647982	436	516	2	64	80	0.8000000
NODE_6789_length_991_cov_9.647982	489	569	0	69	80	0.8625000
NODE_6789_length_991_cov_9.647982	489	569	2	11	80	0.1375000
NODE_6790_length_991_cov_5.176009	538	618	0	56	80	0.7000000
NODE_6790_length_991_cov_5.176009	538	618	2	24	80	0.3000000
NODE_6790_length_991_cov_5.176009	591	671	0	3	80	0.0375000
NODE_6790_length_991_cov_5.176009	591	671	2	77	80	0.9625000
NODE_6801_length_990_cov_39.386083	402	482	0	26	80	0.3250000
NODE_6801_length_990_cov_39.386083	402	482	15	1	80	0.0125000
NODE_6801_length_990_cov_39.386083	402	482	16	53	80	0.6625000
NODE_6801_length_990_cov_39.386083	455	535	4	20	80	0.2500000
NODE_6801_length_990_cov_39.386083	455	535	16	55	80	0.6875000
NODE_6801_length_990_cov_39.386083	455	535	19	1	80	0.0125000
NODE_6801_length_990_cov_39.386083	455	535	20	4	80	0.0500000
NODE_6802_length_990_cov_35.993266	321	401	0	73	80	0.9125000
NODE_6802_length_990_cov_35.993266	321	401	2	7	80	0.0875000
NODE_6802_length_990_cov_35.993266	374	454	0	20	80	0.2500000
NODE_6802_length_990_cov_35.993266	374	454	2	60	80	0.7500000
NODE_6802_length_990_cov_35.993266	450	530	2	77	80	0.9625000
NODE_6802_length_990_cov_35.993266	450	530	4	3	80	0.0375000
NODE_6802_length_990_cov_35.993266	503	583	0	16	80	0.2000000
NODE_6802_length_990_cov_35.993266	503	583	2	64	80	0.8000000
NODE_6803_length_990_cov_24.445567	588	668	0	8	80	0.1000000
NODE_6803_length_990_cov_24.445567	588	668	2	72	80	0.9000000
NODE_6803_length_990_cov_24.445567	641	721	2	80	80	1.0000000
NODE_6805_length_990_cov_22.378227	430	510	0	80	80	1.0000000
NODE_6805_length_990_cov_22.378227	483	563	0	80	80	1.0000000
NODE_6806_length_990_cov_20.150393	408	488	0	7	80	0.0875000
NODE_6806_length_990_cov_20.150393	408	488	3	1	80	0.0125000
NODE_6806_length_990_cov_20.150393	408	488	4	72	80	0.9000000
NODE_6806_length_990_cov_20.150393	461	541	0	31	80	0.3875000
NODE_6806_length_990_cov_20.150393	461	541	4	49	80	0.6125000
NODE_6807_length_990_cov_18.154882	434	514	0	71	80	0.8875000
NODE_6807_length_990_cov_18.154882	434	514	2	9	80	0.1125000
NODE_6807_length_990_cov_18.154882	487	567	0	18	80	0.2250000
NODE_6807_length_990_cov_18.154882	487	567	2	62	80	0.7750000
NODE_6808_length_990_cov_17.250281	329	409	0	80	80	1.0000000
NODE_6808_length_990_cov_17.250281	382	462	0	80	80	1.0000000
NODE_6808_length_990_cov_17.250281	458	538	0	44	80	0.5500000
NODE_6808_length_990_cov_17.250281	458	538	4	10	80	0.1250000
NODE_6808_length_990_cov_17.250281	458	538	6	26	80	0.3250000
NODE_6808_length_990_cov_17.250281	511	591	4	12	80	0.1500000
NODE_6808_length_990_cov_17.250281	511	591	6	50	80	0.6250000
NODE_6808_length_990_cov_17.250281	511	591	8	18	80	0.2250000
NODE_6809_length_990_cov_14.977553	448	528	0	4	80	0.0500000
NODE_6809_length_990_cov_14.977553	448	528	2	76	80	0.9500000
NODE_6809_length_990_cov_14.977553	501	581	0	57	80	0.7125000
NODE_6809_length_990_cov_14.977553	501	581	2	23	80	0.2875000
NODE_6810_length_990_cov_13.846240	482	562	0	6	80	0.0750000
NODE_6810_length_990_cov_13.846240	482	562	4	9	80	0.1125000
NODE_6810_length_990_cov_13.846240	482	562	6	65	80	0.8125000
NODE_6810_length_990_cov_13.846240	535	615	0	23	80	0.2875000
NODE_6810_length_990_cov_13.846240	535	615	4	1	80	0.0125000
NODE_6810_length_990_cov_13.846240	535	615	5	11	80	0.1375000
NODE_6810_length_990_cov_13.846240	535	615	6	45	80	0.5625000
NODE_6821_length_990_cov_0.978676	79	151	0	11	72	0.1527778
NODE_6821_length_990_cov_0.978676	79	151	2	61	72	0.8472222
NODE_6821_length_990_cov_0.978676	82	152	0	12	70	0.1714286
NODE_6821_length_990_cov_0.978676	82	152	2	58	70	0.8285714
NODE_6823_length_989_cov_45.902247	47	127	2	1	80	0.0125000
NODE_6823_length_989_cov_45.902247	47	127	8	2	80	0.0250000
NODE_6823_length_989_cov_45.902247	47	127	10	1	80	0.0125000
NODE_6823_length_989_cov_45.902247	47	127	14	2	80	0.0250000
NODE_6823_length_989_cov_45.902247	47	127	26	1	80	0.0125000
NODE_6823_length_989_cov_45.902247	47	127	28	1	80	0.0125000
NODE_6823_length_989_cov_45.902247	47	127	32	3	80	0.0375000
NODE_6823_length_989_cov_45.902247	47	127	38	6	80	0.0750000
NODE_6823_length_989_cov_45.902247	47	127	40	2	80	0.0250000
NODE_6823_length_989_cov_45.902247	47	127	42	2	80	0.0250000
NODE_6823_length_989_cov_45.902247	47	127	44	1	80	0.0125000
NODE_6823_length_989_cov_45.902247	47	127	46	2	80	0.0250000
NODE_6823_length_989_cov_45.902247	47	127	48	56	80	0.7000000
NODE_6823_length_989_cov_45.902247	330	410	4	43	80	0.5375000
NODE_6823_length_989_cov_45.902247	330	410	6	29	80	0.3625000
NODE_6823_length_989_cov_45.902247	330	410	8	1	80	0.0125000
NODE_6823_length_989_cov_45.902247	330	410	9	1	80	0.0125000
NODE_6823_length_989_cov_45.902247	330	410	10	6	80	0.0750000
NODE_6823_length_989_cov_45.902247	383	463	0	8	80	0.1000000
NODE_6823_length_989_cov_45.902247	383	463	3	1	80	0.0125000
NODE_6823_length_989_cov_45.902247	383	463	4	30	80	0.3750000
NODE_6823_length_989_cov_45.902247	383	463	6	41	80	0.5125000
NODE_6824_length_989_cov_35.430337	412	492	0	24	80	0.3000000
NODE_6824_length_989_cov_35.430337	412	492	2	56	80	0.7000000
NODE_6824_length_989_cov_35.430337	465	545	0	44	80	0.5500000
NODE_6824_length_989_cov_35.430337	465	545	2	36	80	0.4500000
NODE_6825_length_989_cov_30.124719	477	557	2	11	80	0.1375000
NODE_6825_length_989_cov_30.124719	477	557	4	12	80	0.1500000
NODE_6825_length_989_cov_30.124719	477	557	6	57	80	0.7125000
NODE_6825_length_989_cov_30.124719	530	610	0	26	80	0.3250000
NODE_6825_length_989_cov_30.124719	530	610	4	39	80	0.4875000
NODE_6825_length_989_cov_30.124719	530	610	6	15	80	0.1875000
NODE_6826_length_989_cov_29.347191	447	527	2	25	80	0.3125000
NODE_6826_length_989_cov_29.347191	447	527	6	14	80	0.1750000
NODE_6826_length_989_cov_29.347191	447	527	8	41	80	0.5125000
NODE_6826_length_989_cov_29.347191	500	580	0	31	80	0.3875000
NODE_6826_length_989_cov_29.347191	500	580	2	47	80	0.5875000
NODE_6826_length_989_cov_29.347191	500	580	6	1	80	0.0125000
NODE_6826_length_989_cov_29.347191	500	580	8	1	80	0.0125000
NODE_6826_length_989_cov_29.347191	576	656	0	8	80	0.1000000
NODE_6826_length_989_cov_29.347191	576	656	4	29	80	0.3625000
NODE_6826_length_989_cov_29.347191	576	656	12	43	80	0.5375000
NODE_6826_length_989_cov_29.347191	629	709	4	22	80	0.2750000
NODE_6826_length_989_cov_29.347191	629	709	12	58	80	0.7250000
NODE_6827_length_989_cov_27.886517	245	325	0	80	80	1.0000000
NODE_6827_length_989_cov_27.886517	298	378	0	80	80	1.0000000
NODE_6827_length_989_cov_27.886517	374	454	0	9	80	0.1125000
NODE_6827_length_989_cov_27.886517	374	454	2	35	80	0.4375000
NODE_6827_length_989_cov_27.886517	374	454	4	36	80	0.4500000
NODE_6827_length_989_cov_27.886517	427	507	2	19	80	0.2375000
NODE_6827_length_989_cov_27.886517	427	507	4	61	80	0.7625000
NODE_6828_length_989_cov_27.515730	393	473	0	15	80	0.1875000
NODE_6828_length_989_cov_27.515730	393	473	2	41	80	0.5125000
NODE_6828_length_989_cov_27.515730	393	473	4	16	80	0.2000000
NODE_6828_length_989_cov_27.515730	393	473	6	8	80	0.1000000
NODE_6828_length_989_cov_27.515730	446	526	0	15	80	0.1875000
NODE_6828_length_989_cov_27.515730	446	526	2	4	80	0.0500000
NODE_6828_length_989_cov_27.515730	446	526	6	61	80	0.7625000
NODE_6828_length_989_cov_27.515730	522	602	6	80	80	1.0000000
NODE_6828_length_989_cov_27.515730	575	655	0	46	80	0.5750000
NODE_6828_length_989_cov_27.515730	575	655	5	1	80	0.0125000
NODE_6828_length_989_cov_27.515730	575	655	6	33	80	0.4125000
NODE_6829_length_989_cov_23.844944	312	392	0	5	80	0.0625000
NODE_6829_length_989_cov_23.844944	312	392	4	75	80	0.9375000
NODE_6829_length_989_cov_23.844944	365	445	0	10	80	0.1250000
NODE_6829_length_989_cov_23.844944	365	445	4	70	80	0.8750000
NODE_6830_length_989_cov_23.131461	475	555	0	80	80	1.0000000
NODE_6830_length_989_cov_23.131461	528	608	0	80	80	1.0000000
NODE_6831_length_989_cov_20.189888	500	580	0	80	80	1.0000000
NODE_6831_length_989_cov_20.189888	553	633	0	80	80	1.0000000
NODE_6832_length_989_cov_18.429213	190	270	0	28	80	0.3500000
NODE_6832_length_989_cov_18.429213	190	270	4	52	80	0.6500000
NODE_6832_length_989_cov_18.429213	258	323	4	24	65	0.3692308
NODE_6832_length_989_cov_18.429213	258	323	8	30	65	0.4615385
NODE_6832_length_989_cov_18.429213	258	323	10	11	65	0.1692308
NODE_6832_length_989_cov_18.429213	319	399	6	5	80	0.0625000
NODE_6832_length_989_cov_18.429213	319	399	8	3	80	0.0375000
NODE_6832_length_989_cov_18.429213	319	399	10	43	80	0.5375000
NODE_6832_length_989_cov_18.429213	319	399	14	2	80	0.0250000
NODE_6832_length_989_cov_18.429213	319	399	20	9	80	0.1125000
NODE_6832_length_989_cov_18.429213	319	399	21	12	80	0.1500000
NODE_6832_length_989_cov_18.429213	319	399	22	1	80	0.0125000
NODE_6832_length_989_cov_18.429213	319	399	24	1	80	0.0125000
NODE_6832_length_989_cov_18.429213	319	399	25	4	80	0.0500000
NODE_6832_length_989_cov_18.429213	372	412	20	22	40	0.5500000
NODE_6832_length_989_cov_18.429213	372	412	21	12	40	0.3000000
NODE_6832_length_989_cov_18.429213	372	412	22	1	40	0.0250000
NODE_6832_length_989_cov_18.429213	372	412	24	1	40	0.0250000
NODE_6832_length_989_cov_18.429213	372	412	25	4	40	0.1000000
NODE_6833_length_989_cov_10.307865	433	513	0	80	80	1.0000000
NODE_6833_length_989_cov_10.307865	486	570	0	34	84	0.4047619
NODE_6833_length_989_cov_10.307865	486	570	2	50	84	0.5952381
NODE_6833_length_989_cov_10.307865	566	642	0	28	76	0.3684210
NODE_6833_length_989_cov_10.307865	566	642	2	48	76	0.6315789
NODE_6833_length_989_cov_10.307865	615	695	0	11	80	0.1375000
NODE_6833_length_989_cov_10.307865	615	695	2	69	80	0.8625000
NODE_6834_length_989_cov_8.941573	528	608	0	74	80	0.9250000
NODE_6834_length_989_cov_8.941573	528	608	2	6	80	0.0750000
NODE_6834_length_989_cov_8.941573	581	661	0	21	80	0.2625000
NODE_6834_length_989_cov_8.941573	581	661	2	59	80	0.7375000
NODE_6835_length_989_cov_5.132584	459	524	0	65	65	1.0000000
NODE_6838_length_989_cov_2.540449	703	783	0	80	80	1.0000000
NODE_6845_length_988_cov_52.168729	361	441	0	29	80	0.3625000
NODE_6845_length_988_cov_52.168729	361	441	2	51	80	0.6375000
NODE_6845_length_988_cov_52.168729	414	494	2	80	80	1.0000000
NODE_6845_length_988_cov_52.168729	490	570	2	66	80	0.8250000
NODE_6845_length_988_cov_52.168729	490	570	4	14	80	0.1750000
NODE_6845_length_988_cov_52.168729	543	623	0	29	80	0.3625000
NODE_6845_length_988_cov_52.168729	543	623	2	51	80	0.6375000
NODE_6846_length_988_cov_36.733408	390	470	0	20	80	0.2500000
NODE_6846_length_988_cov_36.733408	390	470	2	60	80	0.7500000
NODE_6846_length_988_cov_36.733408	443	523	2	78	80	0.9750000
NODE_6846_length_988_cov_36.733408	443	523	4	2	80	0.0250000
NODE_6847_length_988_cov_36.221597	478	558	0	80	80	1.0000000
NODE_6847_length_988_cov_36.221597	531	611	0	80	80	1.0000000
NODE_6848_length_988_cov_25.895388	389	469	0	65	80	0.8125000
NODE_6848_length_988_cov_25.895388	389	469	2	15	80	0.1875000
NODE_6848_length_988_cov_25.895388	442	522	0	12	80	0.1500000
NODE_6848_length_988_cov_25.895388	442	522	2	68	80	0.8500000
NODE_6848_length_988_cov_25.895388	518	598	0	57	80	0.7125000
NODE_6848_length_988_cov_25.895388	518	598	2	23	80	0.2875000
NODE_6848_length_988_cov_25.895388	571	651	0	80	80	1.0000000
NODE_6849_length_988_cov_20.250844	423	503	2	51	80	0.6375000
NODE_6849_length_988_cov_20.250844	423	503	4	29	80	0.3625000
NODE_6849_length_988_cov_20.250844	476	556	2	80	80	1.0000000
NODE_6850_length_988_cov_15.812148	474	554	2	11	80	0.1375000
NODE_6850_length_988_cov_15.812148	474	554	4	16	80	0.2000000
NODE_6850_length_988_cov_15.812148	474	554	10	3	80	0.0375000
NODE_6850_length_988_cov_15.812148	474	554	12	3	80	0.0375000
NODE_6850_length_988_cov_15.812148	474	554	17	1	80	0.0125000
NODE_6850_length_988_cov_15.812148	474	554	18	46	80	0.5750000
NODE_6850_length_988_cov_15.812148	527	607	13	12	80	0.1500000
NODE_6850_length_988_cov_15.812148	527	607	15	27	80	0.3375000
NODE_6850_length_988_cov_15.812148	527	607	17	2	80	0.0250000
NODE_6850_length_988_cov_15.812148	527	607	18	39	80	0.4875000
NODE_6851_length_988_cov_15.082115	435	517	0	82	82	1.0000000
NODE_6851_length_988_cov_15.082115	490	570	0	80	80	1.0000000
NODE_6852_length_988_cov_14.697413	467	547	0	80	80	1.0000000
NODE_6852_length_988_cov_14.697413	520	600	0	80	80	1.0000000
NODE_6853_length_988_cov_7.730034	562	642	0	80	80	1.0000000
NODE_6853_length_988_cov_7.730034	615	695	0	80	80	1.0000000
NODE_6862_length_987_cov_42.784910	383	476	0	81	93	0.8709677
NODE_6862_length_987_cov_42.784910	383	476	2	12	93	0.1290323
NODE_6862_length_987_cov_42.784910	449	529	0	15	80	0.1875000
NODE_6862_length_987_cov_42.784910	449	529	2	65	80	0.8125000
NODE_6863_length_987_cov_39.716216	290	370	0	54	80	0.6750000
NODE_6863_length_987_cov_39.716216	290	370	2	26	80	0.3250000
NODE_6863_length_987_cov_39.716216	343	423	0	18	80	0.2250000
NODE_6863_length_987_cov_39.716216	343	423	2	62	80	0.7750000
NODE_6863_length_987_cov_39.716216	419	499	0	20	80	0.2500000
NODE_6863_length_987_cov_39.716216	419	499	2	60	80	0.7500000
NODE_6863_length_987_cov_39.716216	472	552	0	65	80	0.8125000
NODE_6863_length_987_cov_39.716216	472	552	2	13	80	0.1625000
NODE_6863_length_987_cov_39.716216	472	552	4	2	80	0.0250000
NODE_6864_length_987_cov_28.171171	406	486	0	58	80	0.7250000
NODE_6864_length_987_cov_28.171171	406	486	6	22	80	0.2750000
NODE_6864_length_987_cov_28.171171	459	539	0	5	80	0.0625000
NODE_6864_length_987_cov_28.171171	459	539	6	75	80	0.9375000
NODE_6864_length_987_cov_28.171171	535	615	0	36	80	0.4500000
NODE_6864_length_987_cov_28.171171	535	615	6	44	80	0.5500000
NODE_6864_length_987_cov_28.171171	588	668	0	80	80	1.0000000
NODE_6865_length_987_cov_23.627252	331	411	0	59	80	0.7375000
NODE_6865_length_987_cov_23.627252	331	411	2	21	80	0.2625000
NODE_6865_length_987_cov_23.627252	384	464	0	6	80	0.0750000
NODE_6865_length_987_cov_23.627252	384	464	2	74	80	0.9250000
NODE_6866_length_987_cov_18.797297	437	517	0	30	80	0.3750000
NODE_6866_length_987_cov_18.797297	437	517	2	50	80	0.6250000
NODE_6866_length_987_cov_18.797297	490	570	0	80	80	1.0000000
NODE_6867_length_987_cov_15.628378	369	449	0	80	80	1.0000000
NODE_6867_length_987_cov_15.628378	422	502	0	80	80	1.0000000
NODE_6868_length_987_cov_15.439189	438	518	0	80	80	1.0000000
NODE_6868_length_987_cov_15.439189	491	571	0	80	80	1.0000000
NODE_6869_length_987_cov_14.343468	506	586	0	37	80	0.4625000
NODE_6869_length_987_cov_14.343468	506	586	2	43	80	0.5375000
NODE_6869_length_987_cov_14.343468	559	639	0	4	80	0.0500000
NODE_6869_length_987_cov_14.343468	559	639	2	76	80	0.9500000
NODE_6870_length_987_cov_13.515766	475	555	0	11	80	0.1375000
NODE_6870_length_987_cov_13.515766	475	555	2	69	80	0.8625000
NODE_6870_length_987_cov_13.515766	528	608	0	64	80	0.8000000
NODE_6870_length_987_cov_13.515766	528	608	2	16	80	0.2000000
NODE_6871_length_987_cov_9.521396	408	482	0	64	74	0.8648649
NODE_6871_length_987_cov_9.521396	408	482	2	10	74	0.1351351
NODE_6871_length_987_cov_9.521396	455	535	0	51	80	0.6375000
NODE_6871_length_987_cov_9.521396	455	535	4	29	80	0.3625000
NODE_6872_length_987_cov_9.054054	440	520	0	80	80	1.0000000
NODE_6872_length_987_cov_9.054054	493	573	0	31	80	0.3875000
NODE_6872_length_987_cov_9.054054	493	573	2	49	80	0.6125000
NODE_6875_length_987_cov_5.378378	509	589	0	80	80	1.0000000
NODE_6875_length_987_cov_5.378378	562	642	0	80	80	1.0000000
NODE_6889_length_986_cov_36.937993	327	407	0	24	80	0.3000000
NODE_6889_length_986_cov_36.937993	327	407	2	56	80	0.7000000
NODE_6889_length_986_cov_36.937993	380	460	0	29	80	0.3625000
NODE_6889_length_986_cov_36.937993	380	460	2	51	80	0.6375000
NODE_6889_length_986_cov_36.937993	456	536	0	80	80	1.0000000
NODE_6889_length_986_cov_36.937993	509	589	0	80	80	1.0000000
NODE_6890_length_986_cov_35.130778	325	405	0	42	80	0.5250000
NODE_6890_length_986_cov_35.130778	325	405	1	38	80	0.4750000
NODE_6890_length_986_cov_35.130778	378	458	0	80	80	1.0000000
NODE_6890_length_986_cov_35.130778	454	534	0	80	80	1.0000000
NODE_6890_length_986_cov_35.130778	507	587	0	80	80	1.0000000
NODE_6891_length_986_cov_24.037204	602	682	0	10	80	0.1250000
NODE_6891_length_986_cov_24.037204	602	682	2	70	80	0.8750000
NODE_6891_length_986_cov_24.037204	655	735	2	80	80	1.0000000
NODE_6891_length_986_cov_24.037204	731	811	0	1	80	0.0125000
NODE_6891_length_986_cov_24.037204	731	811	2	11	80	0.1375000
NODE_6891_length_986_cov_24.037204	731	811	6	1	80	0.0125000
NODE_6891_length_986_cov_24.037204	731	811	8	67	80	0.8375000
NODE_6891_length_986_cov_24.037204	784	864	0	34	80	0.4250000
NODE_6891_length_986_cov_24.037204	784	864	2	2	80	0.0250000
NODE_6891_length_986_cov_24.037204	784	864	6	4	80	0.0500000
NODE_6891_length_986_cov_24.037204	784	864	8	40	80	0.5000000
NODE_6892_length_986_cov_20.591883	395	475	0	2	80	0.0250000
NODE_6892_length_986_cov_20.591883	395	475	8	36	80	0.4500000
NODE_6892_length_986_cov_20.591883	395	475	10	42	80	0.5250000
NODE_6892_length_986_cov_20.591883	448	528	0	18	80	0.2250000
NODE_6892_length_986_cov_20.591883	448	528	8	20	80	0.2500000
NODE_6892_length_986_cov_20.591883	448	528	10	42	80	0.5250000
NODE_6893_length_986_cov_16.815107	389	469	0	66	80	0.8250000
NODE_6893_length_986_cov_16.815107	389	469	2	14	80	0.1750000
NODE_6893_length_986_cov_16.815107	442	522	0	80	80	1.0000000
NODE_6894_length_986_cov_11.021421	474	554	4	20	80	0.2500000
NODE_6894_length_986_cov_11.021421	474	554	7	26	80	0.3250000
NODE_6894_length_986_cov_11.021421	474	554	8	34	80	0.4250000
NODE_6894_length_986_cov_11.021421	527	607	0	41	80	0.5125000
NODE_6894_length_986_cov_11.021421	527	607	4	32	80	0.4000000
NODE_6894_length_986_cov_11.021421	527	607	7	2	80	0.0250000
NODE_6894_length_986_cov_11.021421	527	607	8	5	80	0.0625000
NODE_6905_length_985_cov_41.707675	443	523	13	12	80	0.1500000
NODE_6905_length_985_cov_41.707675	443	523	14	36	80	0.4500000
NODE_6905_length_985_cov_41.707675	443	523	19	32	80	0.4000000
NODE_6905_length_985_cov_41.707675	496	576	6	30	80	0.3750000
NODE_6905_length_985_cov_41.707675	496	576	19	50	80	0.6250000
NODE_6911_length_984_cov_64.531073	412	481	0	69	69	1.0000000
NODE_6911_length_984_cov_64.531073	454	534	0	80	80	1.0000000
NODE_6911_length_984_cov_64.531073	475	555	0	80	80	1.0000000
NODE_6911_length_984_cov_64.531073	528	608	0	80	80	1.0000000
NODE_6911_length_984_cov_64.531073	549	629	0	80	80	1.0000000
NODE_6912_length_984_cov_28.832768	430	510	1	27	80	0.3375000
NODE_6912_length_984_cov_28.832768	430	510	2	53	80	0.6625000
NODE_6912_length_984_cov_28.832768	483	563	1	51	80	0.6375000
NODE_6912_length_984_cov_28.832768	483	563	2	29	80	0.3625000
NODE_6913_length_984_cov_27.247458	203	283	0	80	80	1.0000000
NODE_6913_length_984_cov_27.247458	256	336	0	80	80	1.0000000
NODE_6913_length_984_cov_27.247458	332	412	0	80	80	1.0000000
NODE_6913_length_984_cov_27.247458	385	465	0	80	80	1.0000000
NODE_6914_length_984_cov_25.944633	483	563	0	29	80	0.3625000
NODE_6914_length_984_cov_25.944633	483	563	2	51	80	0.6375000
NODE_6914_length_984_cov_25.944633	536	616	0	17	80	0.2125000
NODE_6914_length_984_cov_25.944633	536	616	2	63	80	0.7875000
NODE_6915_length_984_cov_16.611299	351	431	2	27	80	0.3375000
NODE_6915_length_984_cov_16.611299	351	431	3	1	80	0.0125000
NODE_6915_length_984_cov_16.611299	351	431	4	52	80	0.6500000
NODE_6915_length_984_cov_16.611299	404	484	0	24	80	0.3000000
NODE_6915_length_984_cov_16.611299	404	484	2	37	80	0.4625000
NODE_6915_length_984_cov_16.611299	404	484	3	1	80	0.0125000
NODE_6915_length_984_cov_16.611299	404	484	4	18	80	0.2250000
NODE_6917_length_984_cov_6.414689	415	495	0	80	80	1.0000000
NODE_6917_length_984_cov_6.414689	468	548	0	66	80	0.8250000
NODE_6917_length_984_cov_6.414689	468	548	2	14	80	0.1750000
NODE_6918_length_984_cov_4.720904	494	574	4	28	80	0.3500000
NODE_6918_length_984_cov_4.720904	494	574	6	52	80	0.6500000
NODE_6918_length_984_cov_4.720904	547	627	1	10	80	0.1250000
NODE_6918_length_984_cov_4.720904	547	627	3	22	80	0.2750000
NODE_6918_length_984_cov_4.720904	547	627	6	39	80	0.4875000
NODE_6918_length_984_cov_4.720904	547	627	7	9	80	0.1125000
NODE_6927_length_984_cov_1.333333	922	971	0	10	49	0.2040816
NODE_6927_length_984_cov_1.333333	922	971	4	39	49	0.7959183
NODE_6931_length_983_cov_34.566742	466	546	0	46	80	0.5750000
NODE_6931_length_983_cov_34.566742	466	546	8	34	80	0.4250000
NODE_6931_length_983_cov_34.566742	519	599	8	80	80	1.0000000
NODE_6932_length_983_cov_26.011312	449	529	2	80	80	1.0000000
NODE_6932_length_983_cov_26.011312	502	582	0	32	80	0.4000000
NODE_6932_length_983_cov_26.011312	502	582	2	48	80	0.6000000
NODE_6932_length_983_cov_26.011312	578	658	0	80	80	1.0000000
NODE_6932_length_983_cov_26.011312	631	711	0	80	80	1.0000000
NODE_6933_length_983_cov_24.694570	539	619	0	80	80	1.0000000
NODE_6933_length_983_cov_24.694570	592	672	0	80	80	1.0000000
NODE_6934_length_983_cov_22.214932	395	475	0	75	80	0.9375000
NODE_6934_length_983_cov_22.214932	395	475	2	5	80	0.0625000
NODE_6934_length_983_cov_22.214932	448	528	0	22	80	0.2750000
NODE_6934_length_983_cov_22.214932	448	528	2	58	80	0.7250000
NODE_6935_length_983_cov_19.132353	377	457	0	29	80	0.3625000
NODE_6935_length_983_cov_19.132353	377	457	2	51	80	0.6375000
NODE_6935_length_983_cov_19.132353	430	510	0	24	80	0.3000000
NODE_6935_length_983_cov_19.132353	430	510	2	56	80	0.7000000
NODE_6936_length_983_cov_16.875566	419	499	2	24	80	0.3000000
NODE_6936_length_983_cov_16.875566	419	499	6	10	80	0.1250000
NODE_6936_length_983_cov_16.875566	419	499	8	46	80	0.5750000
NODE_6936_length_983_cov_16.875566	472	552	0	33	80	0.4125000
NODE_6936_length_983_cov_16.875566	472	552	6	30	80	0.3750000
NODE_6936_length_983_cov_16.875566	472	552	8	17	80	0.2125000
NODE_6936_length_983_cov_16.875566	548	628	0	80	80	1.0000000
NODE_6936_length_983_cov_16.875566	601	681	0	80	80	1.0000000
NODE_6937_length_983_cov_7.240950	487	567	0	80	80	1.0000000
NODE_6937_length_983_cov_7.240950	540	620	0	80	80	1.0000000
NODE_6949_length_982_cov_30.750849	357	437	0	34	80	0.4250000
NODE_6949_length_982_cov_30.750849	357	437	2	24	80	0.3000000
NODE_6949_length_982_cov_30.750849	357	437	4	22	80	0.2750000
NODE_6949_length_982_cov_30.750849	410	490	2	11	80	0.1375000
NODE_6949_length_982_cov_30.750849	410	490	4	69	80	0.8625000
NODE_6950_length_982_cov_29.901472	516	596	0	80	80	1.0000000
NODE_6950_length_982_cov_29.901472	569	649	0	80	80	1.0000000
NODE_6951_length_982_cov_18.251416	356	436	2	2	80	0.0250000
NODE_6951_length_982_cov_18.251416	356	436	4	18	80	0.2250000
NODE_6951_length_982_cov_18.251416	356	436	6	60	80	0.7500000
NODE_6951_length_982_cov_18.251416	409	489	0	4	80	0.0500000
NODE_6951_length_982_cov_18.251416	409	489	2	13	80	0.1625000
NODE_6951_length_982_cov_18.251416	409	489	4	55	80	0.6875000
NODE_6951_length_982_cov_18.251416	409	489	6	8	80	0.1000000
NODE_6951_length_982_cov_18.251416	485	565	4	39	80	0.4875000
NODE_6951_length_982_cov_18.251416	485	565	5	16	80	0.2000000
NODE_6951_length_982_cov_18.251416	485	565	6	25	80	0.3125000
NODE_6951_length_982_cov_18.251416	538	618	2	42	80	0.5250000
NODE_6951_length_982_cov_18.251416	538	618	4	31	80	0.3875000
NODE_6951_length_982_cov_18.251416	538	618	5	6	80	0.0750000
NODE_6951_length_982_cov_18.251416	538	618	6	1	80	0.0125000
NODE_6952_length_982_cov_13.840317	608	688	0	38	80	0.4750000
NODE_6952_length_982_cov_13.840317	608	688	2	4	80	0.0500000
NODE_6952_length_982_cov_13.840317	608	688	6	38	80	0.4750000
NODE_6952_length_982_cov_13.840317	661	741	4	23	80	0.2875000
NODE_6952_length_982_cov_13.840317	661	741	6	57	80	0.7125000
NODE_6953_length_982_cov_13.227633	317	397	0	34	80	0.4250000
NODE_6953_length_982_cov_13.227633	317	397	2	46	80	0.5750000
NODE_6953_length_982_cov_13.227633	370	450	0	80	80	1.0000000
NODE_6954_length_982_cov_10.918460	209	289	0	80	80	1.0000000
NODE_6954_length_982_cov_10.918460	262	342	0	80	80	1.0000000
NODE_6956_length_982_cov_7.210646	216	296	0	22	80	0.2750000
NODE_6956_length_982_cov_7.210646	216	296	2	58	80	0.7250000
NODE_6956_length_982_cov_7.210646	269	349	0	75	80	0.9375000
NODE_6956_length_982_cov_7.210646	269	349	2	5	80	0.0625000
NODE_6973_length_981_cov_55.260771	410	490	0	80	80	1.0000000
NODE_6973_length_981_cov_55.260771	463	543	0	80	80	1.0000000
NODE_6973_length_981_cov_55.260771	539	619	0	8	80	0.1000000
NODE_6973_length_981_cov_55.260771	539	619	6	72	80	0.9000000
NODE_6973_length_981_cov_55.260771	592	672	0	47	80	0.5875000
NODE_6973_length_981_cov_55.260771	592	672	6	33	80	0.4125000
NODE_6974_length_981_cov_33.287982	362	441	0	79	79	1.0000000
NODE_6974_length_981_cov_33.287982	414	495	0	81	81	1.0000000
NODE_6974_length_981_cov_33.287982	491	571	0	55	80	0.6875000
NODE_6974_length_981_cov_33.287982	491	571	4	25	80	0.3125000
NODE_6974_length_981_cov_33.287982	544	624	0	2	80	0.0250000
NODE_6974_length_981_cov_33.287982	544	624	4	78	80	0.9750000
NODE_6975_length_981_cov_33.121315	269	349	0	80	80	1.0000000
NODE_6975_length_981_cov_33.121315	322	402	0	61	80	0.7625000
NODE_6975_length_981_cov_33.121315	322	402	2	19	80	0.2375000
NODE_6975_length_981_cov_33.121315	398	478	0	5	80	0.0625000
NODE_6975_length_981_cov_33.121315	398	478	2	75	80	0.9375000
NODE_6975_length_981_cov_33.121315	451	531	0	58	80	0.7250000
NODE_6975_length_981_cov_33.121315	451	531	2	22	80	0.2750000
NODE_6976_length_981_cov_26.732426	397	477	0	80	80	1.0000000
NODE_6976_length_981_cov_26.732426	450	530	0	80	80	1.0000000
NODE_6977_length_981_cov_24.304989	390	470	0	10	80	0.1250000
NODE_6977_length_981_cov_24.304989	390	470	2	63	80	0.7875000
NODE_6977_length_981_cov_24.304989	390	470	8	7	80	0.0875000
NODE_6977_length_981_cov_24.304989	443	523	2	20	80	0.2500000
NODE_6977_length_981_cov_24.304989	443	523	6	3	80	0.0375000
NODE_6977_length_981_cov_24.304989	443	523	8	42	80	0.5250000
NODE_6977_length_981_cov_24.304989	443	523	10	15	80	0.1875000
NODE_6978_length_981_cov_10.485261	363	443	0	80	80	1.0000000
NODE_6978_length_981_cov_10.485261	416	496	0	80	80	1.0000000
NODE_6980_length_981_cov_5.328798	821	885	0	64	64	1.0000000
NODE_6980_length_981_cov_5.328798	847	884	0	37	37	1.0000000
NODE_6998_length_980_cov_40.710556	329	409	1	57	80	0.7125000
NODE_6998_length_980_cov_40.710556	329	409	2	23	80	0.2875000
NODE_6998_length_980_cov_40.710556	382	462	1	29	80	0.3625000
NODE_6998_length_980_cov_40.710556	382	462	8	15	80	0.1875000
NODE_6998_length_980_cov_40.710556	382	462	15	36	80	0.4500000
NODE_6998_length_980_cov_40.710556	458	538	14	36	80	0.4500000
NODE_6998_length_980_cov_40.710556	458	538	15	44	80	0.5500000
NODE_6998_length_980_cov_40.710556	511	591	0	15	80	0.1875000
NODE_6998_length_980_cov_40.710556	511	591	7	15	80	0.1875000
NODE_6998_length_980_cov_40.710556	511	591	14	50	80	0.6250000
NODE_6999_length_980_cov_37.634506	666	746	0	13	80	0.1625000
NODE_6999_length_980_cov_37.634506	666	746	6	67	80	0.8375000
NODE_6999_length_980_cov_37.634506	719	799	0	45	80	0.5625000
NODE_6999_length_980_cov_37.634506	719	799	6	35	80	0.4375000
NODE_7000_length_980_cov_36.261067	331	411	0	80	80	1.0000000
NODE_7000_length_980_cov_36.261067	384	453	0	69	69	1.0000000
NODE_7000_length_980_cov_36.261067	465	545	0	7	80	0.0875000
NODE_7000_length_980_cov_36.261067	465	545	2	21	80	0.2625000
NODE_7000_length_980_cov_36.261067	465	545	4	52	80	0.6500000
NODE_7000_length_980_cov_36.261067	518	598	0	20	80	0.2500000
NODE_7000_length_980_cov_36.261067	518	598	2	28	80	0.3500000
NODE_7000_length_980_cov_36.261067	518	598	4	32	80	0.4000000
NODE_7001_length_980_cov_28.514188	430	510	0	80	80	1.0000000
NODE_7001_length_980_cov_28.514188	483	563	0	54	80	0.6750000
NODE_7001_length_980_cov_28.514188	483	563	2	26	80	0.3250000
NODE_7002_length_980_cov_25.205448	497	577	0	80	80	1.0000000
NODE_7002_length_980_cov_25.205448	550	630	0	80	80	1.0000000
NODE_7003_length_980_cov_24.321226	417	497	0	80	80	1.0000000
NODE_7003_length_980_cov_24.321226	470	550	0	80	80	1.0000000
NODE_7004_length_980_cov_20.460840	388	468	0	80	80	1.0000000
NODE_7004_length_980_cov_20.460840	441	521	0	80	80	1.0000000
NODE_7005_length_980_cov_19.969353	486	566	0	80	80	1.0000000
NODE_7005_length_980_cov_19.969353	539	619	0	80	80	1.0000000
NODE_7006_length_980_cov_13.736663	350	430	0	80	80	1.0000000
NODE_7006_length_980_cov_13.736663	403	483	0	80	80	1.0000000
NODE_7006_length_980_cov_13.736663	479	559	0	80	80	1.0000000
NODE_7006_length_980_cov_13.736663	532	612	0	80	80	1.0000000
NODE_7008_length_980_cov_10.842225	517	597	0	47	80	0.5875000
NODE_7008_length_980_cov_10.842225	517	597	2	33	80	0.4125000
NODE_7008_length_980_cov_10.842225	570	650	0	15	80	0.1875000
NODE_7008_length_980_cov_10.842225	570	650	2	65	80	0.8125000
NODE_7009_length_980_cov_10.087401	341	424	0	83	83	1.0000000
NODE_7009_length_980_cov_10.087401	397	477	0	80	80	1.0000000
NODE_7010_length_980_cov_9.643587	267	347	0	80	80	1.0000000
NODE_7010_length_980_cov_9.643587	320	400	0	80	80	1.0000000
NODE_7010_length_980_cov_9.643587	396	476	0	17	80	0.2125000
NODE_7010_length_980_cov_9.643587	396	476	2	63	80	0.7875000
NODE_7010_length_980_cov_9.643587	449	529	0	43	80	0.5375000
NODE_7010_length_980_cov_9.643587	449	529	2	37	80	0.4625000
NODE_7026_length_979_cov_22.576136	442	522	0	80	80	1.0000000
NODE_7026_length_979_cov_22.576136	495	575	0	80	80	1.0000000
NODE_7027_length_979_cov_19.739773	445	524	0	79	79	1.0000000
NODE_7027_length_979_cov_19.739773	497	577	0	80	80	1.0000000
NODE_7028_length_979_cov_19.480682	436	516	0	80	80	1.0000000
NODE_7028_length_979_cov_19.480682	489	569	0	80	80	1.0000000
NODE_7028_length_979_cov_19.480682	565	645	0	80	80	1.0000000
NODE_7028_length_979_cov_19.480682	618	698	0	80	80	1.0000000
NODE_7029_length_979_cov_18.901136	470	550	0	80	80	1.0000000
NODE_7029_length_979_cov_18.901136	523	603	0	80	80	1.0000000
NODE_7031_length_979_cov_3.519318	101	168	2	53	67	0.7910448
NODE_7031_length_979_cov_3.519318	101	168	4	14	67	0.2089552
NODE_7040_length_978_cov_23.195677	424	504	0	19	80	0.2375000
NODE_7040_length_978_cov_23.195677	424	504	10	19	80	0.2375000
NODE_7040_length_978_cov_23.195677	424	504	12	42	80	0.5250000
NODE_7040_length_978_cov_23.195677	477	557	0	72	80	0.9000000
NODE_7040_length_978_cov_23.195677	477	557	10	8	80	0.1000000
NODE_7041_length_978_cov_18.866894	440	520	4	21	80	0.2625000
NODE_7041_length_978_cov_18.866894	440	520	6	46	80	0.5750000
NODE_7041_length_978_cov_18.866894	440	520	10	13	80	0.1625000
NODE_7041_length_978_cov_18.866894	493	573	0	17	80	0.2125000
NODE_7041_length_978_cov_18.866894	493	573	3	2	80	0.0250000
NODE_7041_length_978_cov_18.866894	493	573	4	20	80	0.2500000
NODE_7041_length_978_cov_18.866894	493	573	6	41	80	0.5125000
NODE_7042_length_978_cov_15.614334	341	421	0	64	80	0.8000000
NODE_7042_length_978_cov_15.614334	341	421	2	16	80	0.2000000
NODE_7042_length_978_cov_15.614334	394	474	0	80	80	1.0000000
NODE_7042_length_978_cov_15.614334	470	550	0	80	80	1.0000000
NODE_7042_length_978_cov_15.614334	523	603	0	80	80	1.0000000
NODE_7043_length_978_cov_15.253697	327	407	0	10	80	0.1250000
NODE_7043_length_978_cov_15.253697	327	407	2	70	80	0.8750000
NODE_7043_length_978_cov_15.253697	380	460	0	17	80	0.2125000
NODE_7043_length_978_cov_15.253697	380	460	2	63	80	0.7875000
NODE_7043_length_978_cov_15.253697	456	536	0	80	80	1.0000000
NODE_7043_length_978_cov_15.253697	509	589	0	80	80	1.0000000
NODE_7044_length_978_cov_14.730375	407	487	0	80	80	1.0000000
NODE_7044_length_978_cov_14.730375	460	540	0	48	80	0.6000000
NODE_7044_length_978_cov_14.730375	460	540	6	32	80	0.4000000
NODE_7045_length_978_cov_7.257110	571	651	0	80	80	1.0000000
NODE_7045_length_978_cov_7.257110	624	704	0	80	80	1.0000000
NODE_7062_length_977_cov_47.484055	427	507	0	40	80	0.5000000
NODE_7062_length_977_cov_47.484055	427	507	2	40	80	0.5000000
NODE_7062_length_977_cov_47.484055	480	560	0	80	80	1.0000000
NODE_7063_length_977_cov_47.116173	428	508	0	5	80	0.0625000
NODE_7063_length_977_cov_47.116173	428	508	4	75	80	0.9375000
NODE_7063_length_977_cov_47.116173	481	561	0	58	80	0.7250000
NODE_7063_length_977_cov_47.116173	481	561	4	22	80	0.2750000
NODE_7063_length_977_cov_47.116173	557	637	0	80	80	1.0000000
NODE_7063_length_977_cov_47.116173	610	690	0	80	80	1.0000000
NODE_7064_length_977_cov_32.542141	486	566	4	53	80	0.6625000
NODE_7064_length_977_cov_32.542141	486	566	6	27	80	0.3375000
NODE_7064_length_977_cov_32.542141	539	619	2	42	80	0.5250000
NODE_7064_length_977_cov_32.542141	539	619	3	1	80	0.0125000
NODE_7064_length_977_cov_32.542141	539	619	6	37	80	0.4625000
NODE_7065_length_977_cov_30.676538	361	441	0	54	80	0.6750000
NODE_7065_length_977_cov_30.676538	361	441	2	26	80	0.3250000
NODE_7065_length_977_cov_30.676538	414	494	0	1	80	0.0125000
NODE_7065_length_977_cov_30.676538	414	494	2	79	80	0.9875000
NODE_7066_length_977_cov_28.348519	455	535	0	15	80	0.1875000
NODE_7066_length_977_cov_28.348519	455	535	2	65	80	0.8125000
NODE_7066_length_977_cov_28.348519	508	588	0	68	80	0.8500000
NODE_7066_length_977_cov_28.348519	508	588	2	12	80	0.1500000
NODE_7067_length_977_cov_26.571754	343	423	0	15	80	0.1875000
NODE_7067_length_977_cov_26.571754	343	423	4	65	80	0.8125000
NODE_7067_length_977_cov_26.571754	396	476	0	10	80	0.1250000
NODE_7067_length_977_cov_26.571754	396	476	3	1	80	0.0125000
NODE_7067_length_977_cov_26.571754	396	476	4	69	80	0.8625000
NODE_7067_length_977_cov_26.571754	472	552	0	80	80	1.0000000
NODE_7067_length_977_cov_26.571754	525	600	0	75	75	1.0000000
NODE_7068_length_977_cov_24.898633	470	550	2	21	80	0.2625000
NODE_7068_length_977_cov_24.898633	470	550	4	47	80	0.5875000
NODE_7068_length_977_cov_24.898633	470	550	6	12	80	0.1500000
NODE_7068_length_977_cov_24.898633	523	603	2	15	80	0.1875000
NODE_7068_length_977_cov_24.898633	523	603	4	7	80	0.0875000
NODE_7068_length_977_cov_24.898633	523	603	6	58	80	0.7250000
NODE_7069_length_977_cov_22.986333	313	393	0	80	80	1.0000000
NODE_7069_length_977_cov_22.986333	366	446	0	80	80	1.0000000
NODE_7069_length_977_cov_22.986333	442	522	0	80	80	1.0000000
NODE_7069_length_977_cov_22.986333	495	575	0	80	80	1.0000000
NODE_7070_length_977_cov_10.753986	290	370	0	80	80	1.0000000
NODE_7070_length_977_cov_10.753986	343	423	0	80	80	1.0000000
NODE_7071_length_977_cov_9.924829	401	456	4	9	55	0.1636364
NODE_7071_length_977_cov_9.924829	401	456	6	46	55	0.8363636
NODE_7073_length_977_cov_6.391800	483	563	0	29	80	0.3625000
NODE_7073_length_977_cov_6.391800	483	563	2	51	80	0.6375000
NODE_7073_length_977_cov_6.391800	536	616	0	80	80	1.0000000
NODE_7075_length_977_cov_2.907745	191	241	0	17	50	0.3400000
NODE_7075_length_977_cov_2.907745	191	241	3	24	50	0.4800000
NODE_7075_length_977_cov_2.907745	191	241	5	2	50	0.0400000
NODE_7075_length_977_cov_2.907745	191	241	8	7	50	0.1400000
NODE_7085_length_976_cov_38.192702	326	406	0	80	80	1.0000000
NODE_7085_length_976_cov_38.192702	379	459	0	80	80	1.0000000
NODE_7085_length_976_cov_38.192702	455	535	0	80	80	1.0000000
NODE_7085_length_976_cov_38.192702	455	536	0	81	81	1.0000000
NODE_7085_length_976_cov_38.192702	455	519	0	64	64	1.0000000
NODE_7085_length_976_cov_38.192702	508	588	0	80	80	1.0000000
NODE_7086_length_976_cov_26.275941	499	579	4	62	80	0.7750000
NODE_7086_length_976_cov_26.275941	499	579	6	18	80	0.2250000
NODE_7086_length_976_cov_26.275941	552	632	2	38	80	0.4750000
NODE_7086_length_976_cov_26.275941	552	632	4	24	80	0.3000000
NODE_7086_length_976_cov_26.275941	552	632	6	18	80	0.2250000
NODE_7087_length_976_cov_25.559863	376	456	0	80	80	1.0000000
NODE_7087_length_976_cov_25.559863	429	509	0	80	80	1.0000000
NODE_7088_length_976_cov_17.961231	572	652	0	25	80	0.3125000
NODE_7088_length_976_cov_17.961231	572	652	2	55	80	0.6875000
NODE_7088_length_976_cov_17.961231	625	705	0	78	80	0.9750000
NODE_7088_length_976_cov_17.961231	625	705	2	2	80	0.0250000
NODE_7089_length_976_cov_5.567845	789	851	0	3	62	0.0483871
NODE_7089_length_976_cov_5.567845	789	851	4	59	62	0.9516129
NODE_7089_length_976_cov_5.567845	842	904	4	62	62	1.0000000
NODE_7101_length_975_cov_192.211187	722	802	3	5	80	0.0625000
NODE_7101_length_975_cov_192.211187	722	802	5	8	80	0.1000000
NODE_7101_length_975_cov_192.211187	722	802	6	14	80	0.1750000
NODE_7101_length_975_cov_192.211187	722	802	7	40	80	0.5000000
NODE_7101_length_975_cov_192.211187	722	802	8	5	80	0.0625000
NODE_7101_length_975_cov_192.211187	722	802	9	4	80	0.0500000
NODE_7101_length_975_cov_192.211187	722	802	10	4	80	0.0500000
NODE_7102_length_975_cov_41.446347	414	494	0	22	80	0.2750000
NODE_7102_length_975_cov_41.446347	414	494	2	58	80	0.7250000
NODE_7102_length_975_cov_41.446347	467	547	0	75	80	0.9375000
NODE_7102_length_975_cov_41.446347	467	547	2	5	80	0.0625000
NODE_7103_length_975_cov_37.618721	375	455	1	5	80	0.0625000
NODE_7103_length_975_cov_37.618721	375	455	2	75	80	0.9375000
NODE_7103_length_975_cov_37.618721	428	508	1	9	80	0.1125000
NODE_7103_length_975_cov_37.618721	428	508	2	71	80	0.8875000
NODE_7104_length_975_cov_34.265982	424	504	2	47	80	0.5875000
NODE_7104_length_975_cov_34.265982	424	504	5	25	80	0.3125000
NODE_7104_length_975_cov_34.265982	424	504	6	8	80	0.1000000
NODE_7104_length_975_cov_34.265982	477	557	4	17	80	0.2125000
NODE_7104_length_975_cov_34.265982	477	557	5	61	80	0.7625000
NODE_7104_length_975_cov_34.265982	477	557	6	2	80	0.0250000
NODE_7105_length_975_cov_31.888128	461	541	0	80	80	1.0000000
NODE_7105_length_975_cov_31.888128	514	594	0	80	80	1.0000000
NODE_7106_length_975_cov_22.093607	392	472	4	53	80	0.6625000
NODE_7106_length_975_cov_22.093607	392	472	6	27	80	0.3375000
NODE_7106_length_975_cov_22.093607	445	525	0	18	80	0.2250000
NODE_7106_length_975_cov_22.093607	445	525	2	10	80	0.1250000
NODE_7106_length_975_cov_22.093607	445	525	4	52	80	0.6500000
NODE_7107_length_975_cov_15.091324	403	483	0	80	80	1.0000000
NODE_7107_length_975_cov_15.091324	456	536	0	80	80	1.0000000
NODE_7108_length_975_cov_15.046804	63	143	0	33	80	0.4125000
NODE_7108_length_975_cov_15.046804	63	143	4	47	80	0.5875000
NODE_7108_length_975_cov_15.046804	116	196	0	29	80	0.3625000
NODE_7108_length_975_cov_15.046804	116	196	4	51	80	0.6375000
NODE_7109_length_975_cov_12.043379	535	615	2	74	80	0.9250000
NODE_7109_length_975_cov_12.043379	535	615	4	6	80	0.0750000
NODE_7109_length_975_cov_12.043379	588	668	0	9	80	0.1125000
NODE_7109_length_975_cov_12.043379	588	668	2	51	80	0.6375000
NODE_7109_length_975_cov_12.043379	588	668	4	20	80	0.2500000
NODE_7110_length_975_cov_11.772831	276	354	0	78	78	1.0000000
NODE_7110_length_975_cov_11.772831	327	407	0	80	80	1.0000000
NODE_7111_length_975_cov_10.599315	405	485	8	80	80	1.0000000
NODE_7111_length_975_cov_10.599315	458	538	0	6	80	0.0750000
NODE_7111_length_975_cov_10.599315	458	538	4	4	80	0.0500000
NODE_7111_length_975_cov_10.599315	458	538	8	70	80	0.8750000
NODE_7112_length_975_cov_8.089041	430	510	0	80	80	1.0000000
NODE_7112_length_975_cov_8.089041	483	563	0	80	80	1.0000000
NODE_7114_length_975_cov_3.728311	254	334	1	22	80	0.2750000
NODE_7114_length_975_cov_3.728311	254	334	3	58	80	0.7250000
NODE_7114_length_975_cov_3.728311	307	387	1	58	80	0.7250000
NODE_7114_length_975_cov_3.728311	307	387	2	17	80	0.2125000
NODE_7114_length_975_cov_3.728311	307	387	3	5	80	0.0625000
NODE_7125_length_974_cov_293.334857	564	642	98	2	78	0.0256410
NODE_7125_length_974_cov_293.334857	564	642	103	2	78	0.0256410
NODE_7125_length_974_cov_293.334857	564	642	112	1	78	0.0128205
NODE_7125_length_974_cov_293.334857	564	642	113	1	78	0.0128205
NODE_7125_length_974_cov_293.334857	564	642	118	3	78	0.0384615
NODE_7125_length_974_cov_293.334857	564	642	121	4	78	0.0512821
NODE_7125_length_974_cov_293.334857	564	642	122	1	78	0.0128205
NODE_7125_length_974_cov_293.334857	564	642	123	1	78	0.0128205
NODE_7125_length_974_cov_293.334857	564	642	124	5	78	0.0641026
NODE_7125_length_974_cov_293.334857	564	642	126	3	78	0.0384615
NODE_7125_length_974_cov_293.334857	564	642	128	3	78	0.0384615
NODE_7125_length_974_cov_293.334857	564	642	129	3	78	0.0384615
NODE_7125_length_974_cov_293.334857	564	642	130	3	78	0.0384615
NODE_7125_length_974_cov_293.334857	564	642	131	10	78	0.1282051
NODE_7125_length_974_cov_293.334857	564	642	132	4	78	0.0512821
NODE_7125_length_974_cov_293.334857	564	642	133	2	78	0.0256410
NODE_7125_length_974_cov_293.334857	564	642	134	4	78	0.0512821
NODE_7125_length_974_cov_293.334857	564	642	135	8	78	0.1025641
NODE_7125_length_974_cov_293.334857	564	642	136	7	78	0.0897436
NODE_7125_length_974_cov_293.334857	564	642	138	1	78	0.0128205
NODE_7125_length_974_cov_293.334857	564	642	139	3	78	0.0384615
NODE_7125_length_974_cov_293.334857	564	642	140	3	78	0.0384615
NODE_7125_length_974_cov_293.334857	564	642	141	1	78	0.0128205
NODE_7125_length_974_cov_293.334857	564	642	142	1	78	0.0128205
NODE_7125_length_974_cov_293.334857	564	642	143	2	78	0.0256410
NODE_7125_length_974_cov_293.334857	564	642	98	2	78	0.0256410
NODE_7125_length_974_cov_293.334857	564	642	103	2	78	0.0256410
NODE_7125_length_974_cov_293.334857	564	642	112	1	78	0.0128205
NODE_7125_length_974_cov_293.334857	564	642	113	1	78	0.0128205
NODE_7125_length_974_cov_293.334857	564	642	118	3	78	0.0384615
NODE_7125_length_974_cov_293.334857	564	642	121	4	78	0.0512821
NODE_7125_length_974_cov_293.334857	564	642	122	1	78	0.0128205
NODE_7125_length_974_cov_293.334857	564	642	123	1	78	0.0128205
NODE_7125_length_974_cov_293.334857	564	642	124	5	78	0.0641026
NODE_7125_length_974_cov_293.334857	564	642	126	3	78	0.0384615
NODE_7125_length_974_cov_293.334857	564	642	128	3	78	0.0384615
NODE_7125_length_974_cov_293.334857	564	642	129	3	78	0.0384615
NODE_7125_length_974_cov_293.334857	564	642	130	3	78	0.0384615
NODE_7125_length_974_cov_293.334857	564	642	131	10	78	0.1282051
NODE_7125_length_974_cov_293.334857	564	642	132	4	78	0.0512821
NODE_7125_length_974_cov_293.334857	564	642	133	2	78	0.0256410
NODE_7125_length_974_cov_293.334857	564	642	134	4	78	0.0512821
NODE_7125_length_974_cov_293.334857	564	642	135	8	78	0.1025641
NODE_7125_length_974_cov_293.334857	564	642	136	7	78	0.0897436
NODE_7125_length_974_cov_293.334857	564	642	138	1	78	0.0128205
NODE_7125_length_974_cov_293.334857	564	642	139	3	78	0.0384615
NODE_7125_length_974_cov_293.334857	564	642	140	3	78	0.0384615
NODE_7125_length_974_cov_293.334857	564	642	141	1	78	0.0128205
NODE_7125_length_974_cov_293.334857	564	642	142	1	78	0.0128205
NODE_7125_length_974_cov_293.334857	564	642	143	2	78	0.0256410
NODE_7125_length_974_cov_293.334857	564	633	98	2	69	0.0289855
NODE_7125_length_974_cov_293.334857	564	633	103	2	69	0.0289855
NODE_7125_length_974_cov_293.334857	564	633	112	1	69	0.0144928
NODE_7125_length_974_cov_293.334857	564	633	113	1	69	0.0144928
NODE_7125_length_974_cov_293.334857	564	633	118	3	69	0.0434783
NODE_7125_length_974_cov_293.334857	564	633	121	4	69	0.0579710
NODE_7125_length_974_cov_293.334857	564	633	122	1	69	0.0144928
NODE_7125_length_974_cov_293.334857	564	633	123	1	69	0.0144928
NODE_7125_length_974_cov_293.334857	564	633	124	5	69	0.0724638
NODE_7125_length_974_cov_293.334857	564	633	126	3	69	0.0434783
NODE_7125_length_974_cov_293.334857	564	633	128	1	69	0.0144928
NODE_7125_length_974_cov_293.334857	564	633	129	3	69	0.0434783
NODE_7125_length_974_cov_293.334857	564	633	130	3	69	0.0434783
NODE_7125_length_974_cov_293.334857	564	633	131	7	69	0.1014493
NODE_7125_length_974_cov_293.334857	564	633	132	4	69	0.0579710
NODE_7125_length_974_cov_293.334857	564	633	133	2	69	0.0289855
NODE_7125_length_974_cov_293.334857	564	633	134	4	69	0.0579710
NODE_7125_length_974_cov_293.334857	564	633	135	8	69	0.1159420
NODE_7125_length_974_cov_293.334857	564	633	136	7	69	0.1014493
NODE_7125_length_974_cov_293.334857	564	633	138	1	69	0.0144928
NODE_7125_length_974_cov_293.334857	564	633	139	3	69	0.0434783
NODE_7125_length_974_cov_293.334857	564	633	140	3	69	0.0434783
NODE_7126_length_974_cov_49.884571	459	539	0	80	80	1.0000000
NODE_7126_length_974_cov_49.884571	512	592	0	80	80	1.0000000
NODE_7127_length_974_cov_38.384000	430	508	0	78	78	1.0000000
NODE_7127_length_974_cov_38.384000	483	561	0	78	78	1.0000000
NODE_7128_length_974_cov_26.008000	391	471	0	44	80	0.5500000
NODE_7128_length_974_cov_26.008000	391	471	1	36	80	0.4500000
NODE_7128_length_974_cov_26.008000	444	524	1	80	80	1.0000000
NODE_7128_length_974_cov_26.008000	520	600	1	18	80	0.2250000
NODE_7128_length_974_cov_26.008000	520	600	3	26	80	0.3250000
NODE_7128_length_974_cov_26.008000	520	600	6	15	80	0.1875000
NODE_7128_length_974_cov_26.008000	520	600	7	21	80	0.2625000
NODE_7128_length_974_cov_26.008000	573	653	6	21	80	0.2625000
NODE_7128_length_974_cov_26.008000	573	653	7	15	80	0.1875000
NODE_7128_length_974_cov_26.008000	573	653	8	8	80	0.1000000
NODE_7128_length_974_cov_26.008000	573	653	9	36	80	0.4500000
NODE_7129_length_974_cov_21.160000	460	540	0	35	80	0.4375000
NODE_7129_length_974_cov_21.160000	460	540	2	27	80	0.3375000
NODE_7129_length_974_cov_21.160000	460	540	4	11	80	0.1375000
NODE_7129_length_974_cov_21.160000	460	540	6	7	80	0.0875000
NODE_7129_length_974_cov_21.160000	513	593	2	9	80	0.1125000
NODE_7129_length_974_cov_21.160000	513	593	4	25	80	0.3125000
NODE_7129_length_974_cov_21.160000	513	593	6	46	80	0.5750000
NODE_7131_length_974_cov_11.384000	290	370	0	80	80	1.0000000
NODE_7131_length_974_cov_11.384000	343	423	0	80	80	1.0000000
NODE_7132_length_974_cov_11.216000	543	623	4	80	80	1.0000000
NODE_7132_length_974_cov_11.216000	596	668	0	42	72	0.5833333
NODE_7132_length_974_cov_11.216000	596	668	4	30	72	0.4166667
NODE_7133_length_974_cov_9.601143	436	516	0	80	80	1.0000000
NODE_7133_length_974_cov_9.601143	489	569	0	80	80	1.0000000
NODE_7134_length_974_cov_7.436571	382	462	0	80	80	1.0000000
NODE_7134_length_974_cov_7.436571	436	515	0	79	79	1.0000000
NODE_7147_length_973_cov_46.012586	349	429	2	33	80	0.4125000
NODE_7147_length_973_cov_46.012586	349	429	3	12	80	0.1500000
NODE_7147_length_973_cov_46.012586	349	429	4	10	80	0.1250000
NODE_7147_length_973_cov_46.012586	349	429	6	8	80	0.1000000
NODE_7147_length_973_cov_46.012586	349	429	8	17	80	0.2125000
NODE_7147_length_973_cov_46.012586	402	482	2	2	80	0.0250000
NODE_7147_length_973_cov_46.012586	402	482	6	61	80	0.7625000
NODE_7147_length_973_cov_46.012586	402	482	8	17	80	0.2125000
NODE_7147_length_973_cov_46.012586	478	558	0	43	80	0.5375000
NODE_7147_length_973_cov_46.012586	478	558	6	37	80	0.4625000
NODE_7147_length_973_cov_46.012586	531	611	0	80	80	1.0000000
NODE_7148_length_973_cov_40.305492	364	444	0	80	80	1.0000000
NODE_7148_length_973_cov_40.305492	417	497	0	80	80	1.0000000
NODE_7149_length_973_cov_24.105263	460	540	0	80	80	1.0000000
NODE_7149_length_973_cov_24.105263	513	593	0	80	80	1.0000000
NODE_7150_length_973_cov_22.106407	342	422	0	5	80	0.0625000
NODE_7150_length_973_cov_22.106407	342	422	2	75	80	0.9375000
NODE_7150_length_973_cov_22.106407	395	475	0	58	80	0.7250000
NODE_7150_length_973_cov_22.106407	395	475	2	22	80	0.2750000
NODE_7150_length_973_cov_22.106407	471	550	0	46	79	0.5822785
NODE_7150_length_973_cov_22.106407	471	550	2	33	79	0.4177215
NODE_7150_length_973_cov_22.106407	526	604	0	24	78	0.3076923
NODE_7150_length_973_cov_22.106407	526	604	2	54	78	0.6923077
NODE_7151_length_973_cov_10.994279	430	510	0	80	80	1.0000000
NODE_7151_length_973_cov_10.994279	483	563	0	80	80	1.0000000
NODE_7151_length_973_cov_10.994279	559	635	0	76	76	1.0000000
NODE_7151_length_973_cov_10.994279	608	688	0	80	80	1.0000000
NODE_7153_length_973_cov_2.973684	734	814	0	5	80	0.0625000
NODE_7153_length_973_cov_2.973684	734	814	2	63	80	0.7875000
NODE_7153_length_973_cov_2.973684	734	814	4	3	80	0.0375000
NODE_7153_length_973_cov_2.973684	734	814	6	2	80	0.0250000
NODE_7153_length_973_cov_2.973684	734	814	8	3	80	0.0375000
NODE_7153_length_973_cov_2.973684	734	814	9	4	80	0.0500000
NODE_7153_length_973_cov_2.973684	820	890	9	2	70	0.0285714
NODE_7153_length_973_cov_2.973684	820	890	10	21	70	0.3000000
NODE_7153_length_973_cov_2.973684	820	890	12	15	70	0.2142857
NODE_7153_length_973_cov_2.973684	820	890	14	32	70	0.4571429
NODE_7153_length_973_cov_2.973684	863	944	8	8	81	0.0987654
NODE_7153_length_973_cov_2.973684	863	944	10	19	81	0.2345679
NODE_7153_length_973_cov_2.973684	863	944	12	9	81	0.1111111
NODE_7153_length_973_cov_2.973684	863	944	14	45	81	0.5555556
NODE_7166_length_972_cov_32.547537	299	379	0	21	80	0.2625000
NODE_7166_length_972_cov_32.547537	299	379	2	59	80	0.7375000
NODE_7166_length_972_cov_32.547537	352	432	0	74	80	0.9250000
NODE_7166_length_972_cov_32.547537	352	432	2	6	80	0.0750000
NODE_7166_length_972_cov_32.547537	428	508	0	30	80	0.3750000
NODE_7166_length_972_cov_32.547537	428	508	2	50	80	0.6250000
NODE_7166_length_972_cov_32.547537	481	561	2	80	80	1.0000000
NODE_7167_length_972_cov_31.010309	474	554	2	55	80	0.6875000
NODE_7167_length_972_cov_31.010309	474	554	4	25	80	0.3125000
NODE_7167_length_972_cov_31.010309	527	607	0	7	80	0.0875000
NODE_7167_length_972_cov_31.010309	527	607	2	33	80	0.4125000
NODE_7167_length_972_cov_31.010309	527	607	4	40	80	0.5000000
NODE_7168_length_972_cov_29.810997	481	561	0	51	80	0.6375000
NODE_7168_length_972_cov_29.810997	481	561	7	29	80	0.3625000
NODE_7168_length_972_cov_29.810997	534	614	7	69	80	0.8625000
NODE_7168_length_972_cov_29.810997	534	614	8	11	80	0.1375000
NODE_7169_length_972_cov_23.438717	442	522	0	4	80	0.0500000
NODE_7169_length_972_cov_23.438717	442	522	2	15	80	0.1875000
NODE_7169_length_972_cov_23.438717	442	522	4	61	80	0.7625000
NODE_7169_length_972_cov_23.438717	495	575	0	4	80	0.0500000
NODE_7169_length_972_cov_23.438717	495	575	2	68	80	0.8500000
NODE_7169_length_972_cov_23.438717	495	575	4	8	80	0.1000000
NODE_7170_length_972_cov_18.886598	453	533	0	1	80	0.0125000
NODE_7170_length_972_cov_18.886598	453	533	2	79	80	0.9875000
NODE_7170_length_972_cov_18.886598	506	585	0	53	79	0.6708861
NODE_7170_length_972_cov_18.886598	506	585	2	26	79	0.3291139
NODE_7171_length_972_cov_15.100802	329	409	4	80	80	1.0000000
NODE_7171_length_972_cov_15.100802	382	462	0	27	80	0.3375000
NODE_7171_length_972_cov_15.100802	382	462	4	53	80	0.6625000
NODE_7172_length_972_cov_12.674685	444	524	0	80	80	1.0000000
NODE_7172_length_972_cov_12.674685	497	577	0	80	80	1.0000000
NODE_7173_length_972_cov_11.235968	504	584	1	80	80	1.0000000
NODE_7173_length_972_cov_11.235968	557	637	1	80	80	1.0000000
NODE_7174_length_972_cov_10.983963	402	482	0	80	80	1.0000000
NODE_7174_length_972_cov_10.983963	455	535	0	46	80	0.5750000
NODE_7174_length_972_cov_10.983963	455	535	2	34	80	0.4250000
NODE_7175_length_972_cov_8.887743	302	382	0	51	80	0.6375000
NODE_7175_length_972_cov_8.887743	302	382	2	29	80	0.3625000
NODE_7175_length_972_cov_8.887743	355	430	2	75	75	1.0000000
NODE_7176_length_972_cov_8.265750	488	568	0	80	80	1.0000000
NODE_7176_length_972_cov_8.265750	541	621	0	80	80	1.0000000
NODE_7182_length_972_cov_2.714777	165	241	0	10	76	0.1315790
NODE_7182_length_972_cov_2.714777	165	241	2	34	76	0.4473684
NODE_7182_length_972_cov_2.714777	165	241	4	1	76	0.0131579
NODE_7182_length_972_cov_2.714777	165	241	8	31	76	0.4078947
NODE_7195_length_971_cov_52.575688	398	478	0	80	80	1.0000000
NODE_7195_length_971_cov_52.575688	451	531	0	80	80	1.0000000
NODE_7195_length_971_cov_52.575688	527	607	0	80	80	1.0000000
NODE_7195_length_971_cov_52.575688	580	660	0	80	80	1.0000000
NODE_7196_length_971_cov_44.464450	280	360	0	80	80	1.0000000
NODE_7196_length_971_cov_44.464450	333	413	0	80	80	1.0000000
NODE_7196_length_971_cov_44.464450	409	489	0	13	80	0.1625000
NODE_7196_length_971_cov_44.464450	409	489	6	67	80	0.8375000
NODE_7196_length_971_cov_44.464450	462	542	0	25	80	0.3125000
NODE_7196_length_971_cov_44.464450	462	542	6	55	80	0.6875000
NODE_7197_length_971_cov_32.721330	509	589	0	80	80	1.0000000
NODE_7197_length_971_cov_32.721330	562	642	0	80	80	1.0000000
NODE_7198_length_971_cov_30.264908	474	554	0	16	80	0.2000000
NODE_7198_length_971_cov_30.264908	474	554	4	64	80	0.8000000
NODE_7198_length_971_cov_30.264908	527	607	0	22	80	0.2750000
NODE_7198_length_971_cov_30.264908	527	607	3	1	80	0.0125000
NODE_7198_length_971_cov_30.264908	527	607	4	57	80	0.7125000
NODE_7199_length_971_cov_26.631881	434	514	0	80	80	1.0000000
NODE_7199_length_971_cov_26.631881	487	567	0	80	80	1.0000000
NODE_7200_length_971_cov_25.635321	404	484	0	80	80	1.0000000
NODE_7200_length_971_cov_25.635321	457	537	0	80	80	1.0000000
NODE_7201_length_971_cov_23.334862	363	443	0	80	80	1.0000000
NODE_7201_length_971_cov_23.334862	416	497	0	81	81	1.0000000
NODE_7202_length_971_cov_18.254587	468	548	0	64	80	0.8000000
NODE_7202_length_971_cov_18.254587	468	548	2	16	80	0.2000000
NODE_7202_length_971_cov_18.254587	521	601	0	11	80	0.1375000
NODE_7202_length_971_cov_18.254587	521	601	2	69	80	0.8625000
NODE_7203_length_971_cov_18.229358	392	472	0	70	80	0.8750000
NODE_7203_length_971_cov_18.229358	392	472	2	10	80	0.1250000
NODE_7203_length_971_cov_18.229358	445	525	0	17	80	0.2125000
NODE_7203_length_971_cov_18.229358	445	525	2	62	80	0.7750000
NODE_7203_length_971_cov_18.229358	445	525	4	1	80	0.0125000
NODE_7204_length_971_cov_16.591743	481	561	0	26	80	0.3250000
NODE_7204_length_971_cov_16.591743	481	561	2	54	80	0.6750000
NODE_7204_length_971_cov_16.591743	534	614	0	67	80	0.8375000
NODE_7204_length_971_cov_16.591743	534	614	2	13	80	0.1625000
NODE_7205_length_971_cov_15.563073	463	543	0	80	80	1.0000000
NODE_7205_length_971_cov_15.563073	516	596	0	80	80	1.0000000
NODE_7206_length_971_cov_12.141055	415	495	0	80	80	1.0000000
NODE_7206_length_971_cov_12.141055	468	548	0	80	80	1.0000000
NODE_7222_length_970_cov_34.928817	438	518	0	80	80	1.0000000
NODE_7222_length_970_cov_34.928817	491	571	0	80	80	1.0000000
NODE_7223_length_970_cov_34.445465	540	620	6	49	80	0.6125000
NODE_7223_length_970_cov_34.445465	540	620	8	9	80	0.1125000
NODE_7223_length_970_cov_34.445465	540	620	10	22	80	0.2750000
NODE_7223_length_970_cov_34.445465	593	673	6	6	80	0.0750000
NODE_7223_length_970_cov_34.445465	593	673	8	52	80	0.6500000
NODE_7223_length_970_cov_34.445465	593	673	10	22	80	0.2750000
NODE_7224_length_970_cov_34.257176	352	432	0	80	80	1.0000000
NODE_7224_length_970_cov_34.257176	405	485	0	80	80	1.0000000
NODE_7225_length_970_cov_26.904707	297	372	15	12	75	0.1600000
NODE_7225_length_970_cov_26.904707	297	372	24	2	75	0.0266667
NODE_7225_length_970_cov_26.904707	297	372	26	10	75	0.1333333
NODE_7225_length_970_cov_26.904707	297	372	27	51	75	0.6800000
NODE_7225_length_970_cov_26.904707	303	376	7	3	73	0.0410959
NODE_7225_length_970_cov_26.904707	303	376	15	13	73	0.1780822
NODE_7225_length_970_cov_26.904707	303	376	24	2	73	0.0273973
NODE_7225_length_970_cov_26.904707	303	376	26	10	73	0.1369863
NODE_7225_length_970_cov_26.904707	303	376	27	45	73	0.6164383
NODE_7225_length_970_cov_26.904707	311	377	7	4	66	0.0606061
NODE_7225_length_970_cov_26.904707	311	377	15	13	66	0.1969697
NODE_7225_length_970_cov_26.904707	311	377	24	2	66	0.0303030
NODE_7225_length_970_cov_26.904707	311	377	26	10	66	0.1515152
NODE_7225_length_970_cov_26.904707	311	377	27	37	66	0.5606061
NODE_7225_length_970_cov_26.904707	350	429	0	32	79	0.4050633
NODE_7225_length_970_cov_26.904707	350	429	5	11	79	0.1392405
NODE_7225_length_970_cov_26.904707	350	429	7	13	79	0.1645570
NODE_7225_length_970_cov_26.904707	350	429	15	13	79	0.1645570
NODE_7225_length_970_cov_26.904707	350	429	24	2	79	0.0253165
NODE_7225_length_970_cov_26.904707	350	429	26	8	79	0.1012658
NODE_7225_length_970_cov_26.904707	350	429	0	32	79	0.4050633
NODE_7225_length_970_cov_26.904707	350	429	5	11	79	0.1392405
NODE_7225_length_970_cov_26.904707	350	429	7	13	79	0.1645570
NODE_7225_length_970_cov_26.904707	350	429	15	13	79	0.1645570
NODE_7225_length_970_cov_26.904707	350	429	24	2	79	0.0253165
NODE_7225_length_970_cov_26.904707	350	429	26	8	79	0.1012658
NODE_7225_length_970_cov_26.904707	350	429	0	32	79	0.4050633
NODE_7225_length_970_cov_26.904707	350	429	5	11	79	0.1392405
NODE_7225_length_970_cov_26.904707	350	429	7	13	79	0.1645570
NODE_7225_length_970_cov_26.904707	350	429	15	13	79	0.1645570
NODE_7225_length_970_cov_26.904707	350	429	24	2	79	0.0253165
NODE_7225_length_970_cov_26.904707	350	429	26	8	79	0.1012658
NODE_7226_length_970_cov_26.040184	266	346	0	12	80	0.1500000
NODE_7226_length_970_cov_26.040184	266	346	2	68	80	0.8500000
NODE_7226_length_970_cov_26.040184	319	399	0	65	80	0.8125000
NODE_7226_length_970_cov_26.040184	319	399	2	15	80	0.1875000
NODE_7226_length_970_cov_26.040184	395	475	0	45	80	0.5625000
NODE_7226_length_970_cov_26.040184	395	475	1	35	80	0.4375000
NODE_7226_length_970_cov_26.040184	448	528	1	40	80	0.5000000
NODE_7226_length_970_cov_26.040184	448	528	2	28	80	0.3500000
NODE_7226_length_970_cov_26.040184	448	528	3	12	80	0.1500000
NODE_7227_length_970_cov_19.291619	415	495	0	80	80	1.0000000
NODE_7227_length_970_cov_19.291619	468	548	0	80	80	1.0000000
NODE_7228_length_970_cov_17.731343	557	637	0	80	80	1.0000000
NODE_7228_length_970_cov_17.731343	610	690	0	80	80	1.0000000
NODE_7229_length_970_cov_15.135476	407	487	0	80	80	1.0000000
NODE_7229_length_970_cov_15.135476	460	540	0	80	80	1.0000000
NODE_7230_length_970_cov_12.675086	534	614	0	80	80	1.0000000
NODE_7230_length_970_cov_12.675086	587	667	0	80	80	1.0000000
NODE_7231_length_970_cov_8.095293	487	567	0	80	80	1.0000000
NODE_7231_length_970_cov_8.095293	540	620	0	80	80	1.0000000
NODE_7233_length_970_cov_7.127440	336	416	0	80	80	1.0000000
NODE_7233_length_970_cov_7.127440	389	469	0	80	80	1.0000000
NODE_7234_length_970_cov_5.824340	0	56	0	56	56	1.0000000
NODE_7246_length_969_cov_47.172414	419	499	12	37	80	0.4625000
NODE_7246_length_969_cov_47.172414	419	499	13	43	80	0.5375000
NODE_7246_length_969_cov_47.172414	472	552	2	5	80	0.0625000
NODE_7246_length_969_cov_47.172414	472	552	7	18	80	0.2250000
NODE_7246_length_969_cov_47.172414	472	552	9	21	80	0.2625000
NODE_7246_length_969_cov_47.172414	472	552	13	28	80	0.3500000
NODE_7246_length_969_cov_47.172414	472	552	14	8	80	0.1000000
NODE_7247_length_969_cov_28.234483	327	407	0	80	80	1.0000000
NODE_7247_length_969_cov_28.234483	380	460	0	80	80	1.0000000
NODE_7248_length_969_cov_27.131034	392	472	2	9	80	0.1125000
NODE_7248_length_969_cov_27.131034	392	472	6	37	80	0.4625000
NODE_7248_length_969_cov_27.131034	392	472	8	34	80	0.4250000
NODE_7248_length_969_cov_27.131034	445	525	0	29	80	0.3625000
NODE_7248_length_969_cov_27.131034	445	525	2	33	80	0.4125000
NODE_7248_length_969_cov_27.131034	445	525	8	18	80	0.2250000
NODE_7249_length_969_cov_26.345977	466	542	0	76	76	1.0000000
NODE_7249_length_969_cov_26.345977	515	595	0	39	80	0.4875000
NODE_7249_length_969_cov_26.345977	515	595	2	41	80	0.5125000
NODE_7250_length_969_cov_18.954023	274	354	0	52	80	0.6500000
NODE_7250_length_969_cov_18.954023	274	354	2	28	80	0.3500000
NODE_7250_length_969_cov_18.954023	327	407	2	80	80	1.0000000
NODE_7251_length_969_cov_17.952874	410	490	0	3	80	0.0375000
NODE_7251_length_969_cov_17.952874	410	490	2	77	80	0.9625000
NODE_7251_length_969_cov_17.952874	463	543	0	56	80	0.7000000
NODE_7251_length_969_cov_17.952874	463	543	2	24	80	0.3000000
NODE_7251_length_969_cov_17.952874	693	773	0	56	80	0.7000000
NODE_7251_length_969_cov_17.952874	693	773	5	5	80	0.0625000
NODE_7251_length_969_cov_17.952874	693	773	7	19	80	0.2375000
NODE_7251_length_969_cov_17.952874	746	826	0	3	80	0.0375000
NODE_7251_length_969_cov_17.952874	746	826	5	5	80	0.0625000
NODE_7251_length_969_cov_17.952874	746	826	7	26	80	0.3250000
NODE_7251_length_969_cov_17.952874	746	826	9	11	80	0.1375000
NODE_7251_length_969_cov_17.952874	746	826	14	35	80	0.4375000
NODE_7252_length_969_cov_15.942529	446	526	0	80	80	1.0000000
NODE_7252_length_969_cov_15.942529	499	579	0	80	80	1.0000000
NODE_7253_length_969_cov_9.926437	573	653	0	80	80	1.0000000
NODE_7253_length_969_cov_9.926437	626	706	0	80	80	1.0000000
NODE_7265_length_968_cov_59.162255	376	456	14	1	80	0.0125000
NODE_7265_length_968_cov_59.162255	376	456	23	1	80	0.0125000
NODE_7265_length_968_cov_59.162255	376	456	24	39	80	0.4875000
NODE_7265_length_968_cov_59.162255	376	456	25	13	80	0.1625000
NODE_7265_length_968_cov_59.162255	376	456	26	6	80	0.0750000
NODE_7265_length_968_cov_59.162255	376	456	28	5	80	0.0625000
NODE_7265_length_968_cov_59.162255	376	456	29	5	80	0.0625000
NODE_7265_length_968_cov_59.162255	376	456	30	1	80	0.0125000
NODE_7265_length_968_cov_59.162255	376	456	31	2	80	0.0250000
NODE_7265_length_968_cov_59.162255	376	456	33	7	80	0.0875000
NODE_7265_length_968_cov_59.162255	429	509	17	13	80	0.1625000
NODE_7265_length_968_cov_59.162255	429	509	18	1	80	0.0125000
NODE_7265_length_968_cov_59.162255	429	509	25	1	80	0.0125000
NODE_7265_length_968_cov_59.162255	429	509	26	19	80	0.2375000
NODE_7265_length_968_cov_59.162255	429	509	27	23	80	0.2875000
NODE_7265_length_968_cov_59.162255	429	509	28	8	80	0.1000000
NODE_7265_length_968_cov_59.162255	429	509	29	5	80	0.0625000
NODE_7265_length_968_cov_59.162255	429	509	30	1	80	0.0125000
NODE_7265_length_968_cov_59.162255	429	509	31	2	80	0.0250000
NODE_7265_length_968_cov_59.162255	429	509	33	7	80	0.0875000
NODE_7265_length_968_cov_59.162255	505	585	0	47	80	0.5875000
NODE_7265_length_968_cov_59.162255	505	585	4	2	80	0.0250000
NODE_7265_length_968_cov_59.162255	505	585	5	3	80	0.0375000
NODE_7265_length_968_cov_59.162255	505	585	7	13	80	0.1625000
NODE_7265_length_968_cov_59.162255	505	585	16	1	80	0.0125000
NODE_7265_length_968_cov_59.162255	505	585	17	14	80	0.1750000
NODE_7265_length_968_cov_59.162255	558	638	0	80	80	1.0000000
NODE_7266_length_968_cov_40.005754	514	594	0	15	80	0.1875000
NODE_7266_length_968_cov_40.005754	514	594	2	65	80	0.8125000
NODE_7266_length_968_cov_40.005754	567	647	0	7	80	0.0875000
NODE_7266_length_968_cov_40.005754	567	647	2	73	80	0.9125000
NODE_7267_length_968_cov_36.521289	450	530	0	13	80	0.1625000
NODE_7267_length_968_cov_36.521289	450	530	1	26	80	0.3250000
NODE_7267_length_968_cov_36.521289	450	530	2	41	80	0.5125000
NODE_7267_length_968_cov_36.521289	503	583	0	66	80	0.8250000
NODE_7267_length_968_cov_36.521289	503	583	1	14	80	0.1750000
NODE_7268_length_968_cov_34.799770	474	554	0	80	80	1.0000000
NODE_7268_length_968_cov_34.799770	527	607	0	80	80	1.0000000
NODE_7269_length_968_cov_26.929804	293	372	0	1	79	0.0126582
NODE_7269_length_968_cov_26.929804	293	372	2	78	79	0.9873418
NODE_7269_length_968_cov_26.929804	345	425	0	3	80	0.0375000
NODE_7269_length_968_cov_26.929804	345	425	2	77	80	0.9625000
NODE_7269_length_968_cov_26.929804	421	501	0	12	80	0.1500000
NODE_7269_length_968_cov_26.929804	421	501	2	17	80	0.2125000
NODE_7269_length_968_cov_26.929804	421	501	9	1	80	0.0125000
NODE_7269_length_968_cov_26.929804	421	501	14	18	80	0.2250000
NODE_7269_length_968_cov_26.929804	421	501	16	17	80	0.2125000
NODE_7269_length_968_cov_26.929804	421	501	19	7	80	0.0875000
NODE_7269_length_968_cov_26.929804	421	501	20	8	80	0.1000000
NODE_7269_length_968_cov_26.929804	474	554	4	17	80	0.2125000
NODE_7269_length_968_cov_26.929804	474	554	8	1	80	0.0125000
NODE_7269_length_968_cov_26.929804	474	554	10	2	80	0.0250000
NODE_7269_length_968_cov_26.929804	474	554	16	12	80	0.1500000
NODE_7269_length_968_cov_26.929804	474	554	19	40	80	0.5000000
NODE_7269_length_968_cov_26.929804	474	554	20	8	80	0.1000000
NODE_7270_length_968_cov_24.468354	434	514	0	80	80	1.0000000
NODE_7270_length_968_cov_24.468354	487	567	0	80	80	1.0000000
NODE_7271_length_968_cov_23.204833	344	424	0	80	80	1.0000000
NODE_7271_length_968_cov_23.204833	397	477	0	80	80	1.0000000
NODE_7271_length_968_cov_23.204833	473	553	0	80	80	1.0000000
NODE_7271_length_968_cov_23.204833	526	606	0	80	80	1.0000000
NODE_7272_length_968_cov_22.321059	417	497	0	40	80	0.5000000
NODE_7272_length_968_cov_22.321059	417	497	2	40	80	0.5000000
NODE_7272_length_968_cov_22.321059	470	550	2	48	80	0.6000000
NODE_7272_length_968_cov_22.321059	470	550	4	32	80	0.4000000
NODE_7273_length_968_cov_20.897583	313	393	2	27	80	0.3375000
NODE_7273_length_968_cov_20.897583	313	393	4	18	80	0.2250000
NODE_7273_length_968_cov_20.897583	313	393	8	10	80	0.1250000
NODE_7273_length_968_cov_20.897583	313	393	11	18	80	0.2250000
NODE_7273_length_968_cov_20.897583	313	393	15	6	80	0.0750000
NODE_7273_length_968_cov_20.897583	313	393	16	1	80	0.0125000
NODE_7273_length_968_cov_20.897583	366	446	8	2	80	0.0250000
NODE_7273_length_968_cov_20.897583	366	446	10	9	80	0.1125000
NODE_7273_length_968_cov_20.897583	366	446	11	25	80	0.3125000
NODE_7273_length_968_cov_20.897583	366	446	13	17	80	0.2125000
NODE_7273_length_968_cov_20.897583	366	446	14	12	80	0.1500000
NODE_7273_length_968_cov_20.897583	366	446	15	14	80	0.1750000
NODE_7273_length_968_cov_20.897583	366	446	16	1	80	0.0125000
NODE_7274_length_968_cov_19.296893	401	481	8	28	80	0.3500000
NODE_7274_length_968_cov_19.296893	401	481	10	52	80	0.6500000
NODE_7274_length_968_cov_19.296893	454	534	3	25	80	0.3125000
NODE_7274_length_968_cov_19.296893	454	534	4	5	80	0.0625000
NODE_7274_length_968_cov_19.296893	454	534	6	10	80	0.1250000
NODE_7274_length_968_cov_19.296893	454	534	10	40	80	0.5000000
NODE_7275_length_968_cov_18.100115	573	653	0	80	80	1.0000000
NODE_7275_length_968_cov_18.100115	626	706	0	38	80	0.4750000
NODE_7275_length_968_cov_18.100115	626	706	2	42	80	0.5250000
NODE_7276_length_968_cov_15.576525	472	552	0	80	80	1.0000000
NODE_7276_length_968_cov_15.576525	525	605	0	80	80	1.0000000
NODE_7277_length_968_cov_15.024166	329	409	0	80	80	1.0000000
NODE_7277_length_968_cov_15.024166	382	462	0	80	80	1.0000000
NODE_7277_length_968_cov_15.024166	458	538	0	80	80	1.0000000
NODE_7277_length_968_cov_15.024166	511	591	0	80	80	1.0000000
NODE_7278_length_968_cov_13.911392	674	754	0	80	80	1.0000000
NODE_7278_length_968_cov_13.911392	727	807	0	47	80	0.5875000
NODE_7278_length_968_cov_13.911392	727	807	2	33	80	0.4125000
NODE_7279_length_968_cov_11.698504	598	678	0	22	80	0.2750000
NODE_7279_length_968_cov_11.698504	598	678	4	58	80	0.7250000
NODE_7279_length_968_cov_11.698504	651	731	0	6	80	0.0750000
NODE_7279_length_968_cov_11.698504	651	731	4	74	80	0.9250000
NODE_7280_length_968_cov_6.490219	538	618	0	80	80	1.0000000
NODE_7280_length_968_cov_6.490219	591	671	0	80	80	1.0000000
NODE_7294_length_967_cov_25.572581	332	412	0	63	80	0.7875000
NODE_7294_length_967_cov_25.572581	332	412	2	17	80	0.2125000
NODE_7294_length_967_cov_25.572581	385	465	0	80	80	1.0000000
NODE_7295_length_967_cov_24.919355	396	476	0	7	80	0.0875000
NODE_7295_length_967_cov_24.919355	396	476	2	73	80	0.9125000
NODE_7295_length_967_cov_24.919355	449	529	0	35	80	0.4375000
NODE_7295_length_967_cov_24.919355	449	529	2	45	80	0.5625000
NODE_7296_length_967_cov_19.137097	374	454	0	80	80	1.0000000
NODE_7296_length_967_cov_19.137097	427	507	0	80	80	1.0000000
NODE_7296_length_967_cov_19.137097	503	583	0	80	80	1.0000000
NODE_7296_length_967_cov_19.137097	556	636	0	80	80	1.0000000
NODE_7297_length_967_cov_14.654378	453	533	0	80	80	1.0000000
NODE_7297_length_967_cov_14.654378	506	586	0	80	80	1.0000000
NODE_7298_length_967_cov_8.027650	280	360	0	80	80	1.0000000
NODE_7298_length_967_cov_8.027650	333	413	0	80	80	1.0000000
NODE_7310_length_966_cov_43.154556	401	474	4	19	73	0.2602740
NODE_7310_length_966_cov_43.154556	401	474	6	54	73	0.7397260
NODE_7310_length_966_cov_43.154556	447	527	0	48	80	0.6000000
NODE_7310_length_966_cov_43.154556	447	527	4	24	80	0.3000000
NODE_7310_length_966_cov_43.154556	447	527	6	8	80	0.1000000
NODE_7311_length_966_cov_42.877739	477	557	1	6	80	0.0750000
NODE_7311_length_966_cov_42.877739	477	557	2	11	80	0.1375000
NODE_7311_length_966_cov_42.877739	477	557	9	3	80	0.0375000
NODE_7311_length_966_cov_42.877739	477	557	15	60	80	0.7500000
NODE_7311_length_966_cov_42.877739	530	610	1	17	80	0.2125000
NODE_7311_length_966_cov_42.877739	530	610	2	53	80	0.6625000
NODE_7311_length_966_cov_42.877739	530	610	9	3	80	0.0375000
NODE_7311_length_966_cov_42.877739	530	610	15	7	80	0.0875000
NODE_7312_length_966_cov_39.956171	283	363	1	12	80	0.1500000
NODE_7312_length_966_cov_39.956171	283	363	2	68	80	0.8500000
NODE_7312_length_966_cov_39.956171	336	416	1	40	80	0.5000000
NODE_7312_length_966_cov_39.956171	336	416	2	40	80	0.5000000
NODE_7312_length_966_cov_39.956171	412	494	1	82	82	1.0000000
NODE_7312_length_966_cov_39.956171	467	547	1	36	80	0.4500000
NODE_7312_length_966_cov_39.956171	467	547	2	10	80	0.1250000
NODE_7312_length_966_cov_39.956171	467	547	3	34	80	0.4250000
NODE_7313_length_966_cov_36.160323	461	541	0	5	80	0.0625000
NODE_7313_length_966_cov_36.160323	461	541	6	12	80	0.1500000
NODE_7313_length_966_cov_36.160323	461	541	8	63	80	0.7875000
NODE_7313_length_966_cov_36.160323	461	541	0	5	80	0.0625000
NODE_7313_length_966_cov_36.160323	461	541	6	12	80	0.1500000
NODE_7313_length_966_cov_36.160323	461	541	8	63	80	0.7875000
NODE_7313_length_966_cov_36.160323	514	594	2	36	80	0.4500000
NODE_7313_length_966_cov_36.160323	514	594	8	44	80	0.5500000
NODE_7314_length_966_cov_18.658593	408	488	0	80	80	1.0000000
NODE_7314_length_966_cov_18.658593	461	541	0	80	80	1.0000000
NODE_7315_length_966_cov_17.606690	341	421	0	80	80	1.0000000
NODE_7315_length_966_cov_17.606690	394	474	0	80	80	1.0000000
NODE_7316_length_966_cov_16.064591	296	376	1	19	80	0.2375000
NODE_7316_length_966_cov_16.064591	296	376	3	54	80	0.6750000
NODE_7316_length_966_cov_16.064591	296	376	8	2	80	0.0250000
NODE_7316_length_966_cov_16.064591	296	376	9	5	80	0.0625000
NODE_7316_length_966_cov_16.064591	349	429	3	20	80	0.2500000
NODE_7316_length_966_cov_16.064591	349	429	7	6	80	0.0750000
NODE_7316_length_966_cov_16.064591	349	429	8	2	80	0.0250000
NODE_7316_length_966_cov_16.064591	349	429	9	9	80	0.1125000
NODE_7316_length_966_cov_16.064591	349	429	10	43	80	0.5375000
NODE_7317_length_966_cov_15.155709	562	642	0	80	80	1.0000000
NODE_7317_length_966_cov_15.155709	615	695	0	80	80	1.0000000
NODE_7318_length_966_cov_7.726644	280	360	2	23	80	0.2875000
NODE_7318_length_966_cov_7.726644	280	360	4	26	80	0.3250000
NODE_7318_length_966_cov_7.726644	280	360	6	31	80	0.3875000
NODE_7318_length_966_cov_7.726644	334	414	0	21	80	0.2625000
NODE_7318_length_966_cov_7.726644	334	414	2	6	80	0.0750000
NODE_7318_length_966_cov_7.726644	334	414	4	36	80	0.4500000
NODE_7318_length_966_cov_7.726644	334	414	6	17	80	0.2125000
NODE_7335_length_965_cov_51.524249	197	277	0	80	80	1.0000000
NODE_7335_length_965_cov_51.524249	250	327	0	77	77	1.0000000
NODE_7335_length_965_cov_51.524249	329	406	0	9	77	0.1168831
NODE_7335_length_965_cov_51.524249	329	406	4	6	77	0.0779221
NODE_7335_length_965_cov_51.524249	329	406	6	41	77	0.5324675
NODE_7335_length_965_cov_51.524249	329	406	9	5	77	0.0649351
NODE_7335_length_965_cov_51.524249	329	406	11	16	77	0.2077922
NODE_7335_length_965_cov_51.524249	379	459	6	6	80	0.0750000
NODE_7335_length_965_cov_51.524249	379	459	8	35	80	0.4375000
NODE_7335_length_965_cov_51.524249	379	459	9	5	80	0.0625000
NODE_7335_length_965_cov_51.524249	379	459	11	20	80	0.2500000
NODE_7335_length_965_cov_51.524249	379	459	12	7	80	0.0875000
NODE_7335_length_965_cov_51.524249	379	459	14	7	80	0.0875000
NODE_7336_length_965_cov_18.072748	515	595	0	24	80	0.3000000
NODE_7336_length_965_cov_18.072748	515	595	8	12	80	0.1500000
NODE_7336_length_965_cov_18.072748	515	595	12	38	80	0.4750000
NODE_7336_length_965_cov_18.072748	515	595	16	6	80	0.0750000
NODE_7336_length_965_cov_18.072748	568	648	11	19	80	0.2375000
NODE_7336_length_965_cov_18.072748	568	648	12	27	80	0.3375000
NODE_7336_length_965_cov_18.072748	568	648	16	34	80	0.4250000
NODE_7337_length_965_cov_14.277136	342	422	2	80	80	1.0000000
NODE_7337_length_965_cov_14.277136	395	470	0	35	75	0.4666667
NODE_7337_length_965_cov_14.277136	395	470	2	40	75	0.5333334
NODE_7338_length_965_cov_7.808314	567	647	0	80	80	1.0000000
NODE_7338_length_965_cov_7.808314	620	700	0	80	80	1.0000000
NODE_7344_length_964_cov_60.153757	197	277	16	6	80	0.0750000
NODE_7344_length_964_cov_60.153757	197	277	17	3	80	0.0375000
NODE_7344_length_964_cov_60.153757	197	277	20	9	80	0.1125000
NODE_7344_length_964_cov_60.153757	197	277	22	9	80	0.1125000
NODE_7344_length_964_cov_60.153757	197	277	24	1	80	0.0125000
NODE_7344_length_964_cov_60.153757	197	277	30	1	80	0.0125000
NODE_7344_length_964_cov_60.153757	197	277	34	1	80	0.0125000
NODE_7344_length_964_cov_60.153757	197	277	36	6	80	0.0750000
NODE_7344_length_964_cov_60.153757	197	277	39	2	80	0.0250000
NODE_7344_length_964_cov_60.153757	197	277	46	3	80	0.0375000
NODE_7344_length_964_cov_60.153757	197	277	52	6	80	0.0750000
NODE_7344_length_964_cov_60.153757	197	277	53	1	80	0.0125000
NODE_7344_length_964_cov_60.153757	197	277	58	1	80	0.0125000
NODE_7344_length_964_cov_60.153757	197	277	69	5	80	0.0625000
NODE_7344_length_964_cov_60.153757	197	277	71	5	80	0.0625000
NODE_7344_length_964_cov_60.153757	197	277	73	4	80	0.0500000
NODE_7344_length_964_cov_60.153757	197	277	74	2	80	0.0250000
NODE_7344_length_964_cov_60.153757	197	277	76	3	80	0.0375000
NODE_7344_length_964_cov_60.153757	197	277	79	1	80	0.0125000
NODE_7344_length_964_cov_60.153757	197	277	81	1	80	0.0125000
NODE_7344_length_964_cov_60.153757	197	277	84	1	80	0.0125000
NODE_7344_length_964_cov_60.153757	197	277	86	1	80	0.0125000
NODE_7344_length_964_cov_60.153757	197	277	89	1	80	0.0125000
NODE_7344_length_964_cov_60.153757	197	277	91	1	80	0.0125000
NODE_7344_length_964_cov_60.153757	197	277	93	2	80	0.0250000
NODE_7344_length_964_cov_60.153757	197	277	95	4	80	0.0500000
NODE_7344_length_964_cov_60.153757	250	314	2	4	64	0.0625000
NODE_7344_length_964_cov_60.153757	250	314	3	1	64	0.0156250
NODE_7344_length_964_cov_60.153757	250	314	4	12	64	0.1875000
NODE_7344_length_964_cov_60.153757	250	314	9	2	64	0.0312500
NODE_7344_length_964_cov_60.153757	250	314	11	9	64	0.1406250
NODE_7344_length_964_cov_60.153757	250	314	13	4	64	0.0625000
NODE_7344_length_964_cov_60.153757	250	314	14	1	64	0.0156250
NODE_7344_length_964_cov_60.153757	250	314	16	10	64	0.1562500
NODE_7344_length_964_cov_60.153757	250	314	17	3	64	0.0468750
NODE_7344_length_964_cov_60.153757	250	314	20	9	64	0.1406250
NODE_7344_length_964_cov_60.153757	250	314	22	9	64	0.1406250
NODE_7344_length_964_cov_60.153757	672	752	0	80	80	1.0000000
NODE_7344_length_964_cov_60.153757	725	805	0	53	80	0.6625000
NODE_7344_length_964_cov_60.153757	725	805	2	27	80	0.3375000
NODE_7345_length_964_cov_45.564162	314	394	0	80	80	1.0000000
NODE_7345_length_964_cov_45.564162	367	447	0	80	80	1.0000000
NODE_7345_length_964_cov_45.564162	443	523	0	43	80	0.5375000
NODE_7345_length_964_cov_45.564162	443	523	2	30	80	0.3750000
NODE_7345_length_964_cov_45.564162	443	523	4	7	80	0.0875000
NODE_7345_length_964_cov_45.564162	496	566	0	8	70	0.1142857
NODE_7345_length_964_cov_45.564162	496	566	2	30	70	0.4285714
NODE_7345_length_964_cov_45.564162	496	566	4	32	70	0.4571429
NODE_7346_length_964_cov_33.487861	363	443	0	62	80	0.7750000
NODE_7346_length_964_cov_33.487861	363	443	2	18	80	0.2250000
NODE_7346_length_964_cov_33.487861	416	496	0	13	80	0.1625000
NODE_7346_length_964_cov_33.487861	416	496	2	67	80	0.8375000
NODE_7347_length_964_cov_33.077457	408	488	0	80	80	1.0000000
NODE_7347_length_964_cov_33.077457	461	541	0	80	80	1.0000000
NODE_7347_length_964_cov_33.077457	537	617	0	80	80	1.0000000
NODE_7347_length_964_cov_33.077457	590	670	0	80	80	1.0000000
NODE_7348_length_964_cov_29.250867	419	499	2	80	80	1.0000000
NODE_7348_length_964_cov_29.250867	472	552	0	12	80	0.1500000
NODE_7348_length_964_cov_29.250867	472	552	1	10	80	0.1250000
NODE_7348_length_964_cov_29.250867	472	552	2	34	80	0.4250000
NODE_7348_length_964_cov_29.250867	472	552	3	1	80	0.0125000
NODE_7348_length_964_cov_29.250867	472	552	4	23	80	0.2875000
NODE_7349_length_964_cov_20.191908	228	301	0	11	73	0.1506849
NODE_7349_length_964_cov_20.191908	228	301	2	62	73	0.8493150
NODE_7349_length_964_cov_20.191908	349	429	0	80	80	1.0000000
NODE_7349_length_964_cov_20.191908	402	482	0	45	80	0.5625000
NODE_7349_length_964_cov_20.191908	402	482	2	35	80	0.4375000
NODE_7350_length_964_cov_18.510983	486	566	0	24	80	0.3000000
NODE_7350_length_964_cov_18.510983	486	566	2	56	80	0.7000000
NODE_7350_length_964_cov_18.510983	539	619	0	77	80	0.9625000
NODE_7350_length_964_cov_18.510983	539	619	2	3	80	0.0375000
NODE_7351_length_964_cov_16.613873	464	544	0	80	80	1.0000000
NODE_7351_length_964_cov_16.613873	517	597	0	80	80	1.0000000
NODE_7352_length_964_cov_15.717919	411	491	0	50	80	0.6250000
NODE_7352_length_964_cov_15.717919	411	491	4	30	80	0.3750000
NODE_7352_length_964_cov_15.717919	464	544	4	80	80	1.0000000
NODE_7352_length_964_cov_15.717919	540	620	0	49	80	0.6125000
NODE_7352_length_964_cov_15.717919	540	620	4	31	80	0.3875000
NODE_7352_length_964_cov_15.717919	593	668	0	75	75	1.0000000
NODE_7353_length_964_cov_14.591908	521	601	0	80	80	1.0000000
NODE_7353_length_964_cov_14.591908	574	654	0	80	80	1.0000000
NODE_7354_length_964_cov_11.589595	475	555	0	80	80	1.0000000
NODE_7354_length_964_cov_11.589595	528	608	0	80	80	1.0000000
NODE_7355_length_964_cov_7.639306	420	500	4	10	80	0.1250000
NODE_7355_length_964_cov_7.639306	420	500	5	40	80	0.5000000
NODE_7355_length_964_cov_7.639306	420	500	6	30	80	0.3750000
NODE_7355_length_964_cov_7.639306	473	553	0	53	80	0.6625000
NODE_7355_length_964_cov_7.639306	473	553	4	10	80	0.1250000
NODE_7355_length_964_cov_7.639306	473	553	5	17	80	0.2125000
NODE_7356_length_964_cov_7.596532	534	614	0	80	80	1.0000000
NODE_7356_length_964_cov_7.596532	587	667	0	80	80	1.0000000
NODE_7357_length_964_cov_6.568786	368	448	0	72	80	0.9000000
NODE_7357_length_964_cov_6.568786	368	448	2	8	80	0.1000000
NODE_7357_length_964_cov_6.568786	421	501	0	19	80	0.2375000
NODE_7357_length_964_cov_6.568786	421	501	2	61	80	0.7625000
NODE_7359_length_964_cov_6.027746	890	940	16	7	50	0.1400000
NODE_7359_length_964_cov_6.027746	890	940	18	9	50	0.1800000
NODE_7359_length_964_cov_6.027746	890	940	20	6	50	0.1200000
NODE_7359_length_964_cov_6.027746	890	940	24	2	50	0.0400000
NODE_7359_length_964_cov_6.027746	890	940	26	3	50	0.0600000
NODE_7359_length_964_cov_6.027746	890	940	28	9	50	0.1800000
NODE_7359_length_964_cov_6.027746	890	940	30	1	50	0.0200000
NODE_7359_length_964_cov_6.027746	890	940	36	11	50	0.2200000
NODE_7359_length_964_cov_6.027746	890	940	38	2	50	0.0400000
NODE_7361_length_964_cov_4.665896	706	772	0	66	66	1.0000000
NODE_7376_length_963_cov_66.251157	456	536	0	7	80	0.0875000
NODE_7376_length_963_cov_66.251157	456	536	6	73	80	0.9125000
NODE_7376_length_963_cov_66.251157	509	589	0	60	80	0.7500000
NODE_7376_length_963_cov_66.251157	509	589	6	20	80	0.2500000
NODE_7376_length_963_cov_66.251157	585	665	0	80	80	1.0000000
NODE_7376_length_963_cov_66.251157	638	718	0	80	80	1.0000000
NODE_7377_length_963_cov_35.638889	381	461	0	80	80	1.0000000
NODE_7377_length_963_cov_35.638889	434	514	0	80	80	1.0000000
NODE_7377_length_963_cov_35.638889	510	590	0	12	80	0.1500000
NODE_7377_length_963_cov_35.638889	510	590	4	57	80	0.7125000
NODE_7377_length_963_cov_35.638889	510	590	6	11	80	0.1375000
NODE_7377_length_963_cov_35.638889	563	643	2	34	80	0.4250000
NODE_7377_length_963_cov_35.638889	563	643	4	16	80	0.2000000
NODE_7377_length_963_cov_35.638889	563	643	6	30	80	0.3750000
NODE_7378_length_963_cov_33.642361	347	427	0	30	80	0.3750000
NODE_7378_length_963_cov_33.642361	347	427	1	50	80	0.6250000
NODE_7378_length_963_cov_33.642361	400	480	1	80	80	1.0000000
NODE_7379_length_963_cov_18.626157	392	472	1	9	80	0.1125000
NODE_7379_length_963_cov_18.626157	392	472	2	71	80	0.8875000
NODE_7379_length_963_cov_18.626157	445	525	1	22	80	0.2750000
NODE_7379_length_963_cov_18.626157	445	525	2	58	80	0.7250000
NODE_7380_length_963_cov_17.750000	402	482	4	25	80	0.3125000
NODE_7380_length_963_cov_17.750000	402	482	14	48	80	0.6000000
NODE_7380_length_963_cov_17.750000	402	482	15	1	80	0.0125000
NODE_7380_length_963_cov_17.750000	402	482	16	6	80	0.0750000
NODE_7380_length_963_cov_17.750000	455	535	12	37	80	0.4625000
NODE_7380_length_963_cov_17.750000	455	535	14	43	80	0.5375000
NODE_7381_length_963_cov_17.023148	542	622	0	80	80	1.0000000
NODE_7381_length_963_cov_17.023148	595	675	0	80	80	1.0000000
NODE_7382_length_963_cov_16.642361	481	561	0	80	80	1.0000000
NODE_7382_length_963_cov_16.642361	534	614	0	80	80	1.0000000
NODE_7382_length_963_cov_16.642361	572	629	0	57	57	1.0000000
NODE_7383_length_963_cov_14.961806	283	363	0	80	80	1.0000000
NODE_7383_length_963_cov_14.961806	336	416	0	80	80	1.0000000
NODE_7384_length_963_cov_13.341435	558	638	0	2	80	0.0250000
NODE_7384_length_963_cov_13.341435	558	638	2	78	80	0.9750000
NODE_7384_length_963_cov_13.341435	611	691	0	55	80	0.6875000
NODE_7384_length_963_cov_13.341435	611	691	2	25	80	0.3125000
NODE_7386_length_963_cov_9.520833	459	539	0	80	80	1.0000000
NODE_7386_length_963_cov_9.520833	512	592	0	80	80	1.0000000
NODE_7386_length_963_cov_9.520833	588	662	0	74	74	1.0000000
NODE_7386_length_963_cov_9.520833	641	724	0	83	83	1.0000000
NODE_7388_length_963_cov_7.510417	781	842	4	2	61	0.0327869
NODE_7388_length_963_cov_7.510417	781	842	6	8	61	0.1311475
NODE_7388_length_963_cov_7.510417	781	842	14	1	61	0.0163934
NODE_7388_length_963_cov_7.510417	781	842	15	2	61	0.0327869
NODE_7388_length_963_cov_7.510417	781	842	21	1	61	0.0163934
NODE_7388_length_963_cov_7.510417	781	842	23	4	61	0.0655738
NODE_7388_length_963_cov_7.510417	781	842	25	8	61	0.1311475
NODE_7388_length_963_cov_7.510417	781	842	26	1	61	0.0163934
NODE_7388_length_963_cov_7.510417	781	842	33	1	61	0.0163934
NODE_7388_length_963_cov_7.510417	781	842	35	1	61	0.0163934
NODE_7388_length_963_cov_7.510417	781	842	37	9	61	0.1475410
NODE_7388_length_963_cov_7.510417	781	842	40	3	61	0.0491803
NODE_7388_length_963_cov_7.510417	781	842	42	2	61	0.0327869
NODE_7388_length_963_cov_7.510417	781	842	43	6	61	0.0983607
NODE_7388_length_963_cov_7.510417	781	842	45	5	61	0.0819672
NODE_7388_length_963_cov_7.510417	781	842	47	7	61	0.1147541
NODE_7388_length_963_cov_7.510417	815	894	37	4	79	0.0506329
NODE_7388_length_963_cov_7.510417	815	894	40	3	79	0.0379747
NODE_7388_length_963_cov_7.510417	815	894	42	2	79	0.0253165
NODE_7388_length_963_cov_7.510417	815	894	43	6	79	0.0759494
NODE_7388_length_963_cov_7.510417	815	894	45	5	79	0.0632911
NODE_7388_length_963_cov_7.510417	815	894	47	7	79	0.0886076
NODE_7388_length_963_cov_7.510417	815	894	49	15	79	0.1898734
NODE_7388_length_963_cov_7.510417	815	894	50	8	79	0.1012658
NODE_7388_length_963_cov_7.510417	815	894	52	3	79	0.0379747
NODE_7388_length_963_cov_7.510417	815	894	53	5	79	0.0632911
NODE_7388_length_963_cov_7.510417	815	894	54	21	79	0.2658228
NODE_7392_length_963_cov_3.755787	378	458	0	80	80	1.0000000
NODE_7392_length_963_cov_3.755787	431	511	0	80	80	1.0000000
NODE_7397_length_963_cov_1.931713	426	485	0	59	59	1.0000000
NODE_7404_length_962_cov_37.169177	356	436	0	80	80	1.0000000
NODE_7404_length_962_cov_37.169177	409	489	0	80	80	1.0000000
NODE_7405_length_962_cov_28.852839	474	554	0	80	80	1.0000000
NODE_7405_length_962_cov_28.852839	527	607	0	80	80	1.0000000
NODE_7405_length_962_cov_28.852839	603	683	0	80	80	1.0000000
NODE_7405_length_962_cov_28.852839	656	736	0	80	80	1.0000000
NODE_7406_length_962_cov_27.859791	441	521	0	35	80	0.4375000
NODE_7406_length_962_cov_27.859791	441	521	2	45	80	0.5625000
NODE_7406_length_962_cov_27.859791	494	574	0	6	80	0.0750000
NODE_7406_length_962_cov_27.859791	494	574	2	74	80	0.9250000
NODE_7407_length_962_cov_21.019699	318	398	0	16	80	0.2000000
NODE_7407_length_962_cov_21.019699	318	398	2	64	80	0.8000000
NODE_7407_length_962_cov_21.019699	371	451	0	52	80	0.6500000
NODE_7407_length_962_cov_21.019699	371	451	2	28	80	0.3500000
NODE_7408_length_962_cov_16.792584	350	430	0	80	80	1.0000000
NODE_7408_length_962_cov_16.792584	403	483	0	80	80	1.0000000
NODE_7409_length_962_cov_14.650058	477	557	4	80	80	1.0000000
NODE_7409_length_962_cov_14.650058	530	610	0	52	80	0.6500000
NODE_7409_length_962_cov_14.650058	530	610	4	28	80	0.3500000
NODE_7410_length_962_cov_7.993048	308	345	0	37	37	1.0000000
NODE_7411_length_962_cov_7.835458	447	527	2	80	80	1.0000000
NODE_7411_length_962_cov_7.835458	500	580	1	39	80	0.4875000
NODE_7411_length_962_cov_7.835458	500	580	2	41	80	0.5125000
NODE_7412_length_962_cov_6.855156	490	570	0	80	80	1.0000000
NODE_7412_length_962_cov_6.855156	543	623	0	80	80	1.0000000
NODE_7417_length_962_cov_1.840093	88	151	0	1	63	0.0158730
NODE_7417_length_962_cov_1.840093	88	151	6	1	63	0.0158730
NODE_7417_length_962_cov_1.840093	88	151	12	1	63	0.0158730
NODE_7417_length_962_cov_1.840093	88	151	32	1	63	0.0158730
NODE_7417_length_962_cov_1.840093	88	151	36	1	63	0.0158730
NODE_7417_length_962_cov_1.840093	88	151	38	2	63	0.0317460
NODE_7417_length_962_cov_1.840093	88	151	46	1	63	0.0158730
NODE_7417_length_962_cov_1.840093	88	151	47	3	63	0.0476190
NODE_7417_length_962_cov_1.840093	88	151	51	1	63	0.0158730
NODE_7417_length_962_cov_1.840093	88	151	53	2	63	0.0317460
NODE_7417_length_962_cov_1.840093	88	151	59	1	63	0.0158730
NODE_7417_length_962_cov_1.840093	88	151	67	1	63	0.0158730
NODE_7417_length_962_cov_1.840093	88	151	71	1	63	0.0158730
NODE_7417_length_962_cov_1.840093	88	151	79	1	63	0.0158730
NODE_7417_length_962_cov_1.840093	88	151	83	3	63	0.0476190
NODE_7417_length_962_cov_1.840093	88	151	89	1	63	0.0158730
NODE_7417_length_962_cov_1.840093	88	151	91	1	63	0.0158730
NODE_7417_length_962_cov_1.840093	88	151	93	1	63	0.0158730
NODE_7417_length_962_cov_1.840093	88	151	95	1	63	0.0158730
NODE_7417_length_962_cov_1.840093	88	151	99	6	63	0.0952381
NODE_7417_length_962_cov_1.840093	88	151	103	1	63	0.0158730
NODE_7417_length_962_cov_1.840093	88	151	107	1	63	0.0158730
NODE_7417_length_962_cov_1.840093	88	151	117	1	63	0.0158730
NODE_7417_length_962_cov_1.840093	88	151	121	4	63	0.0634921
NODE_7417_length_962_cov_1.840093	88	151	127	2	63	0.0317460
NODE_7417_length_962_cov_1.840093	88	151	129	3	63	0.0476190
NODE_7417_length_962_cov_1.840093	88	151	131	1	63	0.0158730
NODE_7417_length_962_cov_1.840093	88	151	137	2	63	0.0317460
NODE_7417_length_962_cov_1.840093	88	151	141	1	63	0.0158730
NODE_7417_length_962_cov_1.840093	88	151	145	2	63	0.0317460
NODE_7417_length_962_cov_1.840093	88	151	148	1	63	0.0158730
NODE_7417_length_962_cov_1.840093	88	151	149	1	63	0.0158730
NODE_7417_length_962_cov_1.840093	88	151	151	2	63	0.0317460
NODE_7417_length_962_cov_1.840093	88	151	155	1	63	0.0158730
NODE_7417_length_962_cov_1.840093	88	151	159	4	63	0.0634921
NODE_7417_length_962_cov_1.840093	88	151	165	1	63	0.0158730
NODE_7417_length_962_cov_1.840093	88	151	167	1	63	0.0158730
NODE_7417_length_962_cov_1.840093	88	151	169	3	63	0.0476190
NODE_7422_length_961_cov_61.019722	453	533	0	2	80	0.0250000
NODE_7422_length_961_cov_61.019722	453	533	3	43	80	0.5375000
NODE_7422_length_961_cov_61.019722	453	533	4	21	80	0.2625000
NODE_7422_length_961_cov_61.019722	453	533	6	14	80	0.1750000
NODE_7422_length_961_cov_61.019722	506	586	0	2	80	0.0250000
NODE_7422_length_961_cov_61.019722	506	586	3	4	80	0.0500000
NODE_7422_length_961_cov_61.019722	506	586	4	74	80	0.9250000
NODE_7422_length_961_cov_61.019722	614	672	0	52	58	0.8965517
NODE_7422_length_961_cov_61.019722	614	672	4	6	58	0.1034483
NODE_7423_length_961_cov_51.005800	334	414	2	23	80	0.2875000
NODE_7423_length_961_cov_51.005800	334	414	6	57	80	0.7125000
NODE_7423_length_961_cov_51.005800	387	467	0	19	80	0.2375000
NODE_7423_length_961_cov_51.005800	387	467	2	57	80	0.7125000
NODE_7423_length_961_cov_51.005800	387	467	6	4	80	0.0500000
NODE_7424_length_961_cov_45.923434	391	471	0	29	80	0.3625000
NODE_7424_length_961_cov_45.923434	391	471	23	48	80	0.6000000
NODE_7424_length_961_cov_45.923434	391	471	24	3	80	0.0375000
NODE_7424_length_961_cov_45.923434	444	524	23	24	80	0.3000000
NODE_7424_length_961_cov_45.923434	444	524	24	8	80	0.1000000
NODE_7424_length_961_cov_45.923434	444	524	25	4	80	0.0500000
NODE_7424_length_961_cov_45.923434	444	524	26	10	80	0.1250000
NODE_7424_length_961_cov_45.923434	444	524	29	12	80	0.1500000
NODE_7424_length_961_cov_45.923434	444	524	30	22	80	0.2750000
NODE_7426_length_961_cov_21.410673	313	393	0	80	80	1.0000000
NODE_7426_length_961_cov_21.410673	366	446	0	60	80	0.7500000
NODE_7426_length_961_cov_21.410673	366	446	2	20	80	0.2500000
NODE_7427_length_961_cov_18.592807	403	483	2	32	80	0.4000000
NODE_7427_length_961_cov_18.592807	403	483	4	48	80	0.6000000
NODE_7427_length_961_cov_18.592807	456	536	0	23	80	0.2875000
NODE_7427_length_961_cov_18.592807	456	536	2	57	80	0.7125000
NODE_7428_length_961_cov_17.701856	433	513	0	1	80	0.0125000
NODE_7428_length_961_cov_17.701856	433	513	2	9	80	0.1125000
NODE_7428_length_961_cov_17.701856	433	513	3	61	80	0.7625000
NODE_7428_length_961_cov_17.701856	433	513	4	9	80	0.1125000
NODE_7428_length_961_cov_17.701856	486	566	0	6	80	0.0750000
NODE_7428_length_961_cov_17.701856	486	566	3	18	80	0.2250000
NODE_7428_length_961_cov_17.701856	486	566	4	56	80	0.7000000
NODE_7429_length_961_cov_17.020882	505	585	0	80	80	1.0000000
NODE_7429_length_961_cov_17.020882	558	638	0	80	80	1.0000000
NODE_7430_length_961_cov_16.235499	328	408	0	80	80	1.0000000
NODE_7430_length_961_cov_16.235499	381	461	0	80	80	1.0000000
NODE_7432_length_961_cov_12.968677	347	427	0	80	80	1.0000000
NODE_7432_length_961_cov_12.968677	400	480	0	80	80	1.0000000
NODE_7433_length_961_cov_9.875870	439	519	0	80	80	1.0000000
NODE_7433_length_961_cov_9.875870	492	572	0	80	80	1.0000000
NODE_7434_length_961_cov_6.172854	624	704	0	80	80	1.0000000
NODE_7434_length_961_cov_6.172854	677	757	0	80	80	1.0000000
NODE_7435_length_961_cov_4.553364	451	531	0	17	80	0.2125000
NODE_7435_length_961_cov_4.553364	451	531	2	63	80	0.7875000
NODE_7435_length_961_cov_4.553364	504	584	0	32	80	0.4000000
NODE_7435_length_961_cov_4.553364	504	584	2	48	80	0.6000000
NODE_7440_length_960_cov_35.649245	65	145	0	80	80	1.0000000
NODE_7440_length_960_cov_35.649245	118	198	0	62	80	0.7750000
NODE_7440_length_960_cov_35.649245	118	198	2	18	80	0.2250000
NODE_7440_length_960_cov_35.649245	446	526	0	71	80	0.8875000
NODE_7440_length_960_cov_35.649245	446	526	2	9	80	0.1125000
NODE_7440_length_960_cov_35.649245	499	579	0	80	80	1.0000000
NODE_7441_length_960_cov_34.886179	386	466	6	80	80	1.0000000
NODE_7441_length_960_cov_34.886179	439	519	0	31	80	0.3875000
NODE_7441_length_960_cov_34.886179	439	519	5	1	80	0.0125000
NODE_7441_length_960_cov_34.886179	439	519	6	48	80	0.6000000
NODE_7443_length_960_cov_25.133566	413	493	0	80	80	1.0000000
NODE_7443_length_960_cov_25.133566	466	546	0	52	80	0.6500000
NODE_7443_length_960_cov_25.133566	466	546	2	28	80	0.3500000
NODE_7444_length_960_cov_19.336818	385	465	0	7	80	0.0875000
NODE_7444_length_960_cov_19.336818	385	465	2	27	80	0.3375000
NODE_7444_length_960_cov_19.336818	385	465	6	33	80	0.4125000
NODE_7444_length_960_cov_19.336818	385	465	10	5	80	0.0625000
NODE_7444_length_960_cov_19.336818	385	465	12	8	80	0.1000000
NODE_7444_length_960_cov_19.336818	438	518	6	14	80	0.1750000
NODE_7444_length_960_cov_19.336818	438	518	10	52	80	0.6500000
NODE_7444_length_960_cov_19.336818	438	518	12	14	80	0.1750000
NODE_7445_length_960_cov_13.221835	460	539	0	79	79	1.0000000
NODE_7445_length_960_cov_13.221835	512	592	0	80	80	1.0000000
NODE_7446_length_960_cov_12.804878	347	427	0	28	80	0.3500000
NODE_7446_length_960_cov_12.804878	347	427	2	52	80	0.6500000
NODE_7446_length_960_cov_12.804878	400	480	2	80	80	1.0000000
NODE_7462_length_959_cov_39.394186	326	406	0	19	80	0.2375000
NODE_7462_length_959_cov_39.394186	326	406	4	23	80	0.2875000
NODE_7462_length_959_cov_39.394186	326	406	6	38	80	0.4750000
NODE_7462_length_959_cov_39.394186	379	459	0	72	80	0.9000000
NODE_7462_length_959_cov_39.394186	379	459	4	8	80	0.1000000
NODE_7463_length_959_cov_28.895349	327	407	0	65	80	0.8125000
NODE_7463_length_959_cov_28.895349	327	407	2	1	80	0.0125000
NODE_7463_length_959_cov_28.895349	327	407	6	14	80	0.1750000
NODE_7463_length_959_cov_28.895349	380	460	0	12	80	0.1500000
NODE_7463_length_959_cov_28.895349	380	460	2	1	80	0.0125000
NODE_7463_length_959_cov_28.895349	380	460	6	67	80	0.8375000
NODE_7464_length_959_cov_26.634884	563	643	0	80	80	1.0000000
NODE_7464_length_959_cov_26.634884	616	696	0	80	80	1.0000000
NODE_7464_length_959_cov_26.634884	692	772	0	38	80	0.4750000
NODE_7464_length_959_cov_26.634884	692	772	4	6	80	0.0750000
NODE_7464_length_959_cov_26.634884	692	772	6	1	80	0.0125000
NODE_7464_length_959_cov_26.634884	692	772	8	35	80	0.4375000
NODE_7464_length_959_cov_26.634884	745	825	4	20	80	0.2500000
NODE_7464_length_959_cov_26.634884	745	825	6	34	80	0.4250000
NODE_7464_length_959_cov_26.634884	745	825	8	26	80	0.3250000
NODE_7465_length_959_cov_18.862791	320	400	0	67	80	0.8375000
NODE_7465_length_959_cov_18.862791	320	400	2	13	80	0.1625000
NODE_7465_length_959_cov_18.862791	373	453	0	14	80	0.1750000
NODE_7465_length_959_cov_18.862791	373	453	2	17	80	0.2125000
NODE_7465_length_959_cov_18.862791	373	453	4	49	80	0.6125000
NODE_7466_length_959_cov_17.910465	358	438	0	80	80	1.0000000
NODE_7466_length_959_cov_17.910465	411	491	0	80	80	1.0000000
NODE_7467_length_959_cov_15.337209	267	347	0	23	80	0.2875000
NODE_7467_length_959_cov_15.337209	267	347	2	45	80	0.5625000
NODE_7467_length_959_cov_15.337209	267	347	6	12	80	0.1500000
NODE_7467_length_959_cov_15.337209	320	400	2	15	80	0.1875000
NODE_7467_length_959_cov_15.337209	320	400	6	64	80	0.8000000
NODE_7467_length_959_cov_15.337209	320	400	8	1	80	0.0125000
NODE_7468_length_959_cov_9.005814	529	609	0	80	80	1.0000000
NODE_7468_length_959_cov_9.005814	582	662	0	80	80	1.0000000
NODE_7469_length_959_cov_8.163953	392	472	0	80	80	1.0000000
NODE_7469_length_959_cov_8.163953	445	525	0	80	80	1.0000000
NODE_7470_length_959_cov_7.097674	401	481	0	31	80	0.3875000
NODE_7470_length_959_cov_7.097674	401	481	2	49	80	0.6125000
NODE_7470_length_959_cov_7.097674	454	534	0	17	80	0.2125000
NODE_7470_length_959_cov_7.097674	454	534	2	63	80	0.7875000
NODE_7472_length_959_cov_4.603488	596	676	0	58	80	0.7250000
NODE_7472_length_959_cov_4.603488	596	676	2	22	80	0.2750000
NODE_7472_length_959_cov_4.603488	649	729	0	80	80	1.0000000
NODE_7486_length_958_cov_57.015134	328	408	0	80	80	1.0000000
NODE_7486_length_958_cov_57.015134	381	461	0	80	80	1.0000000
NODE_7486_length_958_cov_57.015134	457	537	0	80	80	1.0000000
NODE_7486_length_958_cov_57.015134	510	590	0	80	80	1.0000000
NODE_7487_length_958_cov_42.265425	418	498	0	80	80	1.0000000
NODE_7487_length_958_cov_42.265425	471	551	0	80	80	1.0000000
NODE_7488_length_958_cov_28.618161	336	416	0	8	80	0.1000000
NODE_7488_length_958_cov_28.618161	336	416	2	9	80	0.1125000
NODE_7488_length_958_cov_28.618161	336	416	4	63	80	0.7875000
NODE_7488_length_958_cov_28.618161	389	469	0	61	80	0.7625000
NODE_7488_length_958_cov_28.618161	389	469	2	9	80	0.1125000
NODE_7488_length_958_cov_28.618161	389	469	4	10	80	0.1250000
NODE_7488_length_958_cov_28.618161	465	545	0	80	80	1.0000000
NODE_7488_length_958_cov_28.618161	518	598	0	80	80	1.0000000
NODE_7489_length_958_cov_16.452852	446	526	0	26	80	0.3250000
NODE_7489_length_958_cov_16.452852	446	526	6	54	80	0.6750000
NODE_7489_length_958_cov_16.452852	499	579	0	13	80	0.1625000
NODE_7489_length_958_cov_16.452852	499	579	6	67	80	0.8375000
NODE_7490_length_958_cov_16.008149	446	526	0	80	80	1.0000000
NODE_7490_length_958_cov_16.008149	499	579	0	80	80	1.0000000
NODE_7491_length_958_cov_14.154831	516	596	0	2	80	0.0250000
NODE_7491_length_958_cov_14.154831	516	596	2	78	80	0.9750000
NODE_7491_length_958_cov_14.154831	569	649	0	55	80	0.6875000
NODE_7491_length_958_cov_14.154831	569	649	2	25	80	0.3125000
NODE_7492_length_958_cov_12.381839	454	534	0	80	80	1.0000000
NODE_7492_length_958_cov_12.381839	507	587	0	80	80	1.0000000
NODE_7493_length_958_cov_11.782305	479	559	0	80	80	1.0000000
NODE_7493_length_958_cov_11.782305	532	612	0	80	80	1.0000000
NODE_7501_length_957_cov_40.837995	746	826	0	80	80	1.0000000
NODE_7501_length_957_cov_40.837995	799	879	0	80	80	1.0000000
NODE_7502_length_957_cov_25.976690	631	711	0	80	80	1.0000000
NODE_7502_length_957_cov_25.976690	684	764	0	80	80	1.0000000
NODE_7503_length_957_cov_25.855478	57	131	4	12	74	0.1621622
NODE_7503_length_957_cov_25.855478	57	131	6	1	74	0.0135135
NODE_7503_length_957_cov_25.855478	57	131	8	4	74	0.0540541
NODE_7503_length_957_cov_25.855478	57	131	10	3	74	0.0405405
NODE_7503_length_957_cov_25.855478	57	131	12	3	74	0.0405405
NODE_7503_length_957_cov_25.855478	57	131	14	4	74	0.0540541
NODE_7503_length_957_cov_25.855478	57	131	16	47	74	0.6351351
NODE_7503_length_957_cov_25.855478	414	494	0	80	80	1.0000000
NODE_7503_length_957_cov_25.855478	467	547	0	80	80	1.0000000
NODE_7504_length_957_cov_24.625874	445	525	0	22	80	0.2750000
NODE_7504_length_957_cov_24.625874	445	525	9	1	80	0.0125000
NODE_7504_length_957_cov_24.625874	445	525	10	18	80	0.2250000
NODE_7504_length_957_cov_24.625874	445	525	12	39	80	0.4875000
NODE_7504_length_957_cov_24.625874	498	578	0	75	80	0.9375000
NODE_7504_length_957_cov_24.625874	498	578	9	1	80	0.0125000
NODE_7504_length_957_cov_24.625874	498	578	10	4	80	0.0500000
NODE_7505_length_957_cov_19.955711	286	366	0	13	80	0.1625000
NODE_7505_length_957_cov_19.955711	286	366	8	67	80	0.8375000
NODE_7505_length_957_cov_19.955711	339	419	0	10	80	0.1250000
NODE_7505_length_957_cov_19.955711	339	419	8	70	80	0.8750000
NODE_7506_length_957_cov_18.861305	414	494	0	80	80	1.0000000
NODE_7506_length_957_cov_18.861305	467	547	0	80	80	1.0000000
NODE_7507_length_957_cov_17.356643	361	441	0	80	80	1.0000000
NODE_7507_length_957_cov_17.356643	414	494	0	69	80	0.8625000
NODE_7507_length_957_cov_17.356643	414	494	2	11	80	0.1375000
NODE_7508_length_957_cov_13.569930	162	242	0	80	80	1.0000000
NODE_7508_length_957_cov_13.569930	215	299	0	84	84	1.0000000
NODE_7509_length_957_cov_12.334499	314	394	2	32	80	0.4000000
NODE_7509_length_957_cov_12.334499	314	394	7	30	80	0.3750000
NODE_7509_length_957_cov_12.334499	314	394	8	17	80	0.2125000
NODE_7509_length_957_cov_12.334499	314	394	9	1	80	0.0125000
NODE_7509_length_957_cov_12.334499	367	447	7	10	80	0.1250000
NODE_7509_length_957_cov_12.334499	367	447	8	70	80	0.8750000
NODE_7510_length_957_cov_12.017483	173	253	0	80	80	1.0000000
NODE_7510_length_957_cov_12.017483	226	306	0	53	80	0.6625000
NODE_7510_length_957_cov_12.017483	226	306	4	27	80	0.3375000
NODE_7511_length_957_cov_10.026807	446	526	0	80	80	1.0000000
NODE_7511_length_957_cov_10.026807	499	579	0	80	80	1.0000000
NODE_7529_length_956_cov_48.047841	479	559	0	25	80	0.3125000
NODE_7529_length_956_cov_48.047841	479	559	2	55	80	0.6875000
NODE_7529_length_956_cov_48.047841	532	612	2	28	80	0.3500000
NODE_7529_length_956_cov_48.047841	532	612	4	31	80	0.3875000
NODE_7529_length_956_cov_48.047841	532	612	6	21	80	0.2625000
NODE_7529_length_956_cov_48.047841	608	688	4	1	80	0.0125000
NODE_7529_length_956_cov_48.047841	608	688	6	13	80	0.1625000
NODE_7529_length_956_cov_48.047841	608	688	8	4	80	0.0500000
NODE_7529_length_956_cov_48.047841	608	688	10	9	80	0.1125000
NODE_7529_length_956_cov_48.047841	608	688	13	1	80	0.0125000
NODE_7529_length_956_cov_48.047841	608	688	14	52	80	0.6500000
NODE_7529_length_956_cov_48.047841	661	741	0	25	80	0.3125000
NODE_7529_length_956_cov_48.047841	661	741	2	4	80	0.0500000
NODE_7529_length_956_cov_48.047841	661	741	4	3	80	0.0375000
NODE_7529_length_956_cov_48.047841	661	741	8	25	80	0.3125000
NODE_7529_length_956_cov_48.047841	661	741	10	9	80	0.1125000
NODE_7529_length_956_cov_48.047841	661	741	14	14	80	0.1750000
NODE_7530_length_956_cov_34.539090	298	378	0	80	80	1.0000000
NODE_7530_length_956_cov_34.539090	351	431	0	80	80	1.0000000
NODE_7530_length_956_cov_34.539090	427	507	0	80	80	1.0000000
NODE_7530_length_956_cov_34.539090	480	560	0	40	80	0.5000000
NODE_7530_length_956_cov_34.539090	480	560	2	1	80	0.0125000
NODE_7530_length_956_cov_34.539090	480	560	3	2	80	0.0250000
NODE_7530_length_956_cov_34.539090	480	560	4	37	80	0.4625000
NODE_7531_length_956_cov_24.355893	398	478	0	80	80	1.0000000
NODE_7531_length_956_cov_24.355893	451	531	0	80	80	1.0000000
NODE_7532_length_956_cov_21.940490	373	453	0	23	80	0.2875000
NODE_7532_length_956_cov_21.940490	373	453	4	46	80	0.5750000
NODE_7532_length_956_cov_21.940490	373	453	8	11	80	0.1375000
NODE_7532_length_956_cov_21.940490	426	506	4	36	80	0.4500000
NODE_7532_length_956_cov_21.940490	426	506	7	1	80	0.0125000
NODE_7532_length_956_cov_21.940490	426	506	8	43	80	0.5375000
NODE_7532_length_956_cov_21.940490	502	582	4	72	80	0.9000000
NODE_7532_length_956_cov_21.940490	502	582	6	8	80	0.1000000
NODE_7532_length_956_cov_21.940490	555	635	4	63	80	0.7875000
NODE_7532_length_956_cov_21.940490	555	635	6	13	80	0.1625000
NODE_7532_length_956_cov_21.940490	555	635	8	4	80	0.0500000
NODE_7533_length_956_cov_19.435239	274	354	0	80	80	1.0000000
NODE_7533_length_956_cov_19.435239	274	301	0	27	27	1.0000000
NODE_7534_length_956_cov_17.819137	378	458	0	21	80	0.2625000
NODE_7534_length_956_cov_17.819137	378	458	2	57	80	0.7125000
NODE_7534_length_956_cov_17.819137	378	458	4	2	80	0.0250000
NODE_7534_length_956_cov_17.819137	431	511	0	74	80	0.9250000
NODE_7534_length_956_cov_17.819137	431	511	2	6	80	0.0750000
NODE_7535_length_956_cov_16.098016	551	631	2	16	80	0.2000000
NODE_7535_length_956_cov_16.098016	551	631	4	50	80	0.6250000
NODE_7535_length_956_cov_16.098016	551	631	6	14	80	0.1750000
NODE_7535_length_956_cov_16.098016	604	684	0	46	80	0.5750000
NODE_7535_length_956_cov_16.098016	604	684	2	23	80	0.2875000
NODE_7535_length_956_cov_16.098016	604	684	4	11	80	0.1375000
NODE_7536_length_956_cov_15.229872	490	570	0	80	80	1.0000000
NODE_7536_length_956_cov_15.229872	543	623	0	80	80	1.0000000
NODE_7537_length_956_cov_7.533256	439	519	0	16	80	0.2000000
NODE_7537_length_956_cov_7.533256	439	519	4	64	80	0.8000000
NODE_7537_length_956_cov_7.533256	497	572	0	20	75	0.2666667
NODE_7537_length_956_cov_7.533256	497	572	4	55	75	0.7333333
NODE_7545_length_955_cov_30.821262	438	518	0	16	80	0.2000000
NODE_7545_length_955_cov_30.821262	438	518	1	15	80	0.1875000
NODE_7545_length_955_cov_30.821262	438	518	2	49	80	0.6125000
NODE_7545_length_955_cov_30.821262	491	571	2	80	80	1.0000000
NODE_7546_length_955_cov_30.574766	380	460	2	55	80	0.6875000
NODE_7546_length_955_cov_30.574766	380	460	4	25	80	0.3125000
NODE_7546_length_955_cov_30.574766	433	513	2	80	80	1.0000000
NODE_7546_length_955_cov_30.574766	509	589	0	3	80	0.0375000
NODE_7546_length_955_cov_30.574766	509	589	2	6	80	0.0750000
NODE_7546_length_955_cov_30.574766	509	589	4	71	80	0.8875000
NODE_7546_length_955_cov_30.574766	562	642	0	12	80	0.1500000
NODE_7546_length_955_cov_30.574766	562	642	3	1	80	0.0125000
NODE_7546_length_955_cov_30.574766	562	642	4	67	80	0.8375000
NODE_7547_length_955_cov_27.734813	373	453	7	29	80	0.3625000
NODE_7547_length_955_cov_27.734813	373	453	9	41	80	0.5125000
NODE_7547_length_955_cov_27.734813	373	453	11	10	80	0.1250000
NODE_7547_length_955_cov_27.734813	426	506	2	35	80	0.4375000
NODE_7547_length_955_cov_27.734813	426	506	4	1	80	0.0125000
NODE_7547_length_955_cov_27.734813	426	506	9	17	80	0.2125000
NODE_7547_length_955_cov_27.734813	426	506	11	27	80	0.3375000
NODE_7548_length_955_cov_24.475467	439	519	0	4	80	0.0500000
NODE_7548_length_955_cov_24.475467	439	519	1	76	80	0.9500000
NODE_7548_length_955_cov_24.475467	492	572	0	35	80	0.4375000
NODE_7548_length_955_cov_24.475467	492	572	1	45	80	0.5625000
NODE_7549_length_955_cov_22.146028	351	431	0	80	80	1.0000000
NODE_7549_length_955_cov_22.146028	404	484	0	80	80	1.0000000
NODE_7550_length_955_cov_16.212617	441	521	0	80	80	1.0000000
NODE_7550_length_955_cov_16.212617	494	574	0	80	80	1.0000000
NODE_7551_length_955_cov_13.334112	269	349	0	74	80	0.9250000
NODE_7551_length_955_cov_13.334112	269	349	2	6	80	0.0750000
NODE_7551_length_955_cov_13.334112	322	402	0	21	80	0.2625000
NODE_7551_length_955_cov_13.334112	322	402	2	59	80	0.7375000
NODE_7552_length_955_cov_12.544393	363	443	0	9	80	0.1125000
NODE_7552_length_955_cov_12.544393	363	443	5	2	80	0.0250000
NODE_7552_length_955_cov_12.544393	363	443	6	69	80	0.8625000
NODE_7552_length_955_cov_12.544393	416	496	0	62	80	0.7750000
NODE_7552_length_955_cov_12.544393	416	496	5	1	80	0.0125000
NODE_7552_length_955_cov_12.544393	416	496	6	17	80	0.2125000
NODE_7553_length_955_cov_8.204439	358	438	0	80	80	1.0000000
NODE_7553_length_955_cov_8.204439	411	491	0	80	80	1.0000000
NODE_7563_length_954_cov_35.691228	381	461	0	35	80	0.4375000
NODE_7563_length_954_cov_35.691228	381	461	4	45	80	0.5625000
NODE_7563_length_954_cov_35.691228	434	514	0	80	80	1.0000000
NODE_7564_length_954_cov_30.769591	408	488	0	52	80	0.6500000
NODE_7564_length_954_cov_30.769591	408	488	2	28	80	0.3500000
NODE_7564_length_954_cov_30.769591	461	541	2	80	80	1.0000000
NODE_7565_length_954_cov_27.247953	418	498	22	80	80	1.0000000
NODE_7565_length_954_cov_27.247953	471	551	0	17	80	0.2125000
NODE_7565_length_954_cov_27.247953	471	551	19	1	80	0.0125000
NODE_7565_length_954_cov_27.247953	471	551	21	1	80	0.0125000
NODE_7565_length_954_cov_27.247953	471	551	22	61	80	0.7625000
NODE_7566_length_954_cov_22.796491	270	350	0	80	80	1.0000000
NODE_7566_length_954_cov_22.796491	323	403	0	80	80	1.0000000
NODE_7567_length_954_cov_15.645614	337	417	0	80	80	1.0000000
NODE_7567_length_954_cov_15.645614	390	470	0	80	80	1.0000000
NODE_7568_length_954_cov_13.538012	346	426	0	15	80	0.1875000
NODE_7568_length_954_cov_13.538012	346	426	1	2	80	0.0250000
NODE_7568_length_954_cov_13.538012	346	426	2	63	80	0.7875000
NODE_7568_length_954_cov_13.538012	399	479	2	80	80	1.0000000
NODE_7569_length_954_cov_12.162573	155	217	0	62	62	1.0000000
NODE_7570_length_954_cov_10.714620	239	319	0	13	80	0.1625000
NODE_7570_length_954_cov_10.714620	239	319	2	20	80	0.2500000
NODE_7570_length_954_cov_10.714620	239	319	4	47	80	0.5875000
NODE_7570_length_954_cov_10.714620	292	372	2	37	80	0.4625000
NODE_7570_length_954_cov_10.714620	292	372	4	43	80	0.5375000
NODE_7571_length_954_cov_5.670175	431	511	0	80	80	1.0000000
NODE_7571_length_954_cov_5.670175	484	564	0	80	80	1.0000000
NODE_7582_length_953_cov_35.789227	425	505	0	80	80	1.0000000
NODE_7582_length_953_cov_35.789227	478	558	0	80	80	1.0000000
NODE_7583_length_953_cov_33.940281	430	510	0	32	80	0.4000000
NODE_7583_length_953_cov_33.940281	430	510	2	48	80	0.6000000
NODE_7583_length_953_cov_33.940281	483	563	0	80	80	1.0000000
NODE_7584_length_953_cov_26.844262	333	413	2	54	80	0.6750000
NODE_7584_length_953_cov_26.844262	333	413	4	26	80	0.3250000
NODE_7584_length_953_cov_26.844262	386	466	0	21	80	0.2625000
NODE_7584_length_953_cov_26.844262	386	466	2	42	80	0.5250000
NODE_7584_length_953_cov_26.844262	386	466	4	17	80	0.2125000
NODE_7584_length_953_cov_26.844262	462	542	0	80	80	1.0000000
NODE_7584_length_953_cov_26.844262	515	595	0	68	80	0.8500000
NODE_7584_length_953_cov_26.844262	515	595	2	12	80	0.1500000
NODE_7585_length_953_cov_20.770492	301	381	0	80	80	1.0000000
NODE_7585_length_953_cov_20.770492	354	434	0	80	80	1.0000000
NODE_7586_length_953_cov_17.514052	421	501	0	55	80	0.6875000
NODE_7586_length_953_cov_17.514052	421	501	2	25	80	0.3125000
NODE_7586_length_953_cov_17.514052	474	554	0	2	80	0.0250000
NODE_7586_length_953_cov_17.514052	474	554	2	78	80	0.9750000
NODE_7586_length_953_cov_17.514052	550	630	0	57	80	0.7125000
NODE_7586_length_953_cov_17.514052	550	630	2	23	80	0.2875000
NODE_7586_length_953_cov_17.514052	603	683	0	80	80	1.0000000
NODE_7587_length_953_cov_11.579625	332	412	0	41	80	0.5125000
NODE_7587_length_953_cov_11.579625	332	412	4	39	80	0.4875000
NODE_7587_length_953_cov_11.579625	385	465	0	3	80	0.0375000
NODE_7587_length_953_cov_11.579625	385	465	2	10	80	0.1250000
NODE_7587_length_953_cov_11.579625	385	465	3	19	80	0.2375000
NODE_7587_length_953_cov_11.579625	385	465	4	48	80	0.6000000
NODE_7588_length_953_cov_7.281030	276	356	0	43	80	0.5375000
NODE_7588_length_953_cov_7.281030	276	356	2	37	80	0.4625000
NODE_7588_length_953_cov_7.281030	329	409	2	69	80	0.8625000
NODE_7588_length_953_cov_7.281030	329	409	4	11	80	0.1375000
NODE_7599_length_952_cov_44.880422	447	527	0	8	80	0.1000000
NODE_7599_length_952_cov_44.880422	447	527	6	72	80	0.9000000
NODE_7599_length_952_cov_44.880422	500	580	0	10	80	0.1250000
NODE_7599_length_952_cov_44.880422	500	580	6	70	80	0.8750000
NODE_7599_length_952_cov_44.880422	871	951	0	80	80	1.0000000
NODE_7600_length_952_cov_42.485346	402	482	0	80	80	1.0000000
NODE_7600_length_952_cov_42.485346	455	535	0	80	80	1.0000000
NODE_7601_length_952_cov_40.065651	422	502	0	80	80	1.0000000
NODE_7601_length_952_cov_40.065651	475	555	0	80	80	1.0000000
NODE_7602_length_952_cov_34.813599	308	388	0	14	80	0.1750000
NODE_7602_length_952_cov_34.813599	308	388	2	66	80	0.8250000
NODE_7602_length_952_cov_34.813599	361	441	0	67	80	0.8375000
NODE_7602_length_952_cov_34.813599	361	441	2	13	80	0.1625000
NODE_7603_length_952_cov_28.055100	661	741	0	80	80	1.0000000
NODE_7603_length_952_cov_28.055100	714	794	0	80	80	1.0000000
NODE_7604_length_952_cov_23.739742	435	515	0	80	80	1.0000000
NODE_7604_length_952_cov_23.739742	488	568	0	80	80	1.0000000
NODE_7606_length_952_cov_11.478312	245	324	0	15	79	0.1898734
NODE_7606_length_952_cov_11.478312	245	324	2	64	79	0.8101266
NODE_7606_length_952_cov_11.478312	297	377	2	80	80	1.0000000
NODE_7607_length_952_cov_11.284877	272	352	0	80	80	1.0000000
NODE_7607_length_952_cov_11.284877	325	405	0	80	80	1.0000000
NODE_7608_length_952_cov_10.807737	458	538	0	80	80	1.0000000
NODE_7608_length_952_cov_10.807737	511	591	0	80	80	1.0000000
NODE_7609_length_952_cov_8.770223	375	455	0	36	80	0.4500000
NODE_7609_length_952_cov_8.770223	375	455	2	44	80	0.5500000
NODE_7609_length_952_cov_8.770223	428	508	0	21	80	0.2625000
NODE_7609_length_952_cov_8.770223	428	508	2	59	80	0.7375000
NODE_7623_length_951_cov_54.397887	354	434	0	80	80	1.0000000
NODE_7623_length_951_cov_54.397887	407	487	0	80	80	1.0000000
NODE_7623_length_951_cov_54.397887	483	563	0	80	80	1.0000000
NODE_7623_length_951_cov_54.397887	544	616	0	72	72	1.0000000
NODE_7624_length_951_cov_47.881455	355	435	0	53	80	0.6625000
NODE_7624_length_951_cov_47.881455	355	435	2	27	80	0.3375000
NODE_7624_length_951_cov_47.881455	408	488	0	80	80	1.0000000
NODE_7624_length_951_cov_47.881455	484	564	0	32	80	0.4000000
NODE_7624_length_951_cov_47.881455	484	564	2	2	80	0.0250000
NODE_7624_length_951_cov_47.881455	484	564	3	11	80	0.1375000
NODE_7624_length_951_cov_47.881455	484	564	5	13	80	0.1625000
NODE_7624_length_951_cov_47.881455	484	564	7	7	80	0.0875000
NODE_7624_length_951_cov_47.881455	484	564	8	15	80	0.1875000
NODE_7624_length_951_cov_47.881455	537	617	2	14	80	0.1750000
NODE_7624_length_951_cov_47.881455	537	617	4	4	80	0.0500000
NODE_7624_length_951_cov_47.881455	537	617	5	5	80	0.0625000
NODE_7624_length_951_cov_47.881455	537	617	7	40	80	0.5000000
NODE_7624_length_951_cov_47.881455	537	617	8	17	80	0.2125000
NODE_7625_length_951_cov_24.322770	479	559	4	66	80	0.8250000
NODE_7625_length_951_cov_24.322770	479	559	6	14	80	0.1750000
NODE_7625_length_951_cov_24.322770	532	612	0	51	80	0.6375000
NODE_7625_length_951_cov_24.322770	532	612	4	29	80	0.3625000
NODE_7626_length_951_cov_23.001174	470	550	0	13	80	0.1625000
NODE_7626_length_951_cov_23.001174	470	550	2	67	80	0.8375000
NODE_7626_length_951_cov_23.001174	523	603	0	66	80	0.8250000
NODE_7626_length_951_cov_23.001174	523	603	2	14	80	0.1750000
NODE_7627_length_951_cov_22.059859	562	642	0	57	80	0.7125000
NODE_7627_length_951_cov_22.059859	562	642	2	23	80	0.2875000
NODE_7627_length_951_cov_22.059859	615	695	0	14	80	0.1750000
NODE_7627_length_951_cov_22.059859	615	695	2	66	80	0.8250000
NODE_7628_length_951_cov_19.413146	456	536	0	47	80	0.5875000
NODE_7628_length_951_cov_19.413146	456	536	4	33	80	0.4125000
NODE_7628_length_951_cov_19.413146	509	589	0	19	80	0.2375000
NODE_7628_length_951_cov_19.413146	509	589	4	61	80	0.7625000
NODE_7628_length_951_cov_19.413146	830	877	0	47	47	1.0000000
NODE_7629_length_951_cov_18.970657	384	464	0	39	80	0.4875000
NODE_7629_length_951_cov_18.970657	384	464	2	41	80	0.5125000
NODE_7629_length_951_cov_18.970657	437	517	2	80	80	1.0000000
NODE_7629_length_951_cov_18.970657	513	593	0	72	80	0.9000000
NODE_7629_length_951_cov_18.970657	513	593	2	8	80	0.1000000
NODE_7629_length_951_cov_18.970657	566	646	0	80	80	1.0000000
NODE_7630_length_951_cov_17.164319	409	490	0	81	81	1.0000000
NODE_7630_length_951_cov_17.164319	463	543	0	80	80	1.0000000
NODE_7631_length_951_cov_17.009390	393	473	0	66	80	0.8250000
NODE_7631_length_951_cov_17.009390	393	473	4	14	80	0.1750000
NODE_7631_length_951_cov_17.009390	446	526	0	13	80	0.1625000
NODE_7631_length_951_cov_17.009390	446	526	4	67	80	0.8375000
NODE_7632_length_951_cov_15.551643	520	600	0	80	80	1.0000000
NODE_7632_length_951_cov_15.551643	573	653	0	80	80	1.0000000
NODE_7633_length_951_cov_13.562207	364	444	0	80	80	1.0000000
NODE_7633_length_951_cov_13.562207	417	497	0	80	80	1.0000000
NODE_7634_length_951_cov_13.086854	450	530	0	17	80	0.2125000
NODE_7634_length_951_cov_13.086854	450	530	2	63	80	0.7875000
NODE_7634_length_951_cov_13.086854	503	583	0	70	80	0.8750000
NODE_7634_length_951_cov_13.086854	503	583	2	10	80	0.1250000
NODE_7635_length_951_cov_6.812207	350	430	0	7	80	0.0875000
NODE_7635_length_951_cov_6.812207	350	430	2	24	80	0.3000000
NODE_7635_length_951_cov_6.812207	350	430	6	49	80	0.6125000
NODE_7635_length_951_cov_6.812207	403	483	0	11	80	0.1375000
NODE_7635_length_951_cov_6.812207	403	483	2	2	80	0.0250000
NODE_7635_length_951_cov_6.812207	403	483	6	67	80	0.8375000
NODE_7636_length_951_cov_5.076291	80	160	0	80	80	1.0000000
NODE_7636_length_951_cov_5.076291	133	213	0	80	80	1.0000000
NODE_7649_length_950_cov_62.151586	731	794	2	22	63	0.3492064
NODE_7649_length_950_cov_62.151586	731	794	6	18	63	0.2857143
NODE_7649_length_950_cov_62.151586	731	794	7	1	63	0.0158730
NODE_7649_length_950_cov_62.151586	731	794	8	2	63	0.0317460
NODE_7649_length_950_cov_62.151586	731	794	10	7	63	0.1111111
NODE_7649_length_950_cov_62.151586	731	794	12	4	63	0.0634921
NODE_7649_length_950_cov_62.151586	731	794	16	9	63	0.1428571
NODE_7650_length_950_cov_56.088132	354	434	0	80	80	1.0000000
NODE_7650_length_950_cov_56.088132	407	487	0	80	80	1.0000000
NODE_7650_length_950_cov_56.088132	483	563	0	80	80	1.0000000
NODE_7650_length_950_cov_56.088132	536	616	0	80	80	1.0000000
NODE_7651_length_950_cov_29.780259	501	581	2	19	80	0.2375000
NODE_7651_length_950_cov_29.780259	501	581	4	13	80	0.1625000
NODE_7651_length_950_cov_29.780259	501	581	6	48	80	0.6000000
NODE_7651_length_950_cov_29.780259	554	634	0	34	80	0.4250000
NODE_7651_length_950_cov_29.780259	554	634	4	32	80	0.4000000
NODE_7651_length_950_cov_29.780259	554	634	6	14	80	0.1750000
NODE_7652_length_950_cov_27.278496	388	468	0	80	80	1.0000000
NODE_7652_length_950_cov_27.278496	441	519	0	78	78	1.0000000
NODE_7653_length_950_cov_26.766157	322	402	1	80	80	1.0000000
NODE_7653_length_950_cov_26.766157	375	455	0	32	80	0.4000000
NODE_7653_length_950_cov_26.766157	375	455	1	48	80	0.6000000
NODE_7653_length_950_cov_26.766157	451	531	1	30	80	0.3750000
NODE_7653_length_950_cov_26.766157	451	531	2	50	80	0.6250000
NODE_7653_length_950_cov_26.766157	504	584	0	48	80	0.6000000
NODE_7653_length_950_cov_26.766157	504	584	2	32	80	0.4000000
NODE_7654_length_950_cov_19.638073	421	501	0	80	80	1.0000000
NODE_7654_length_950_cov_19.638073	474	554	0	80	80	1.0000000
NODE_7654_length_950_cov_19.638073	550	630	0	6	80	0.0750000
NODE_7654_length_950_cov_19.638073	550	630	12	1	80	0.0125000
NODE_7654_length_950_cov_19.638073	550	630	13	32	80	0.4000000
NODE_7654_length_950_cov_19.638073	550	630	14	41	80	0.5125000
NODE_7654_length_950_cov_19.638073	603	683	14	38	80	0.4750000
NODE_7654_length_950_cov_19.638073	603	683	15	18	80	0.2250000
NODE_7654_length_950_cov_19.638073	603	683	16	24	80	0.3000000
NODE_7655_length_950_cov_14.686251	376	456	0	80	80	1.0000000
NODE_7655_length_950_cov_14.686251	429	509	0	80	80	1.0000000
NODE_7656_length_950_cov_14.215041	339	419	0	80	80	1.0000000
NODE_7656_length_950_cov_14.215041	392	472	0	80	80	1.0000000
NODE_7657_length_950_cov_6.397180	370	450	0	80	80	1.0000000
NODE_7657_length_950_cov_6.397180	423	504	0	81	81	1.0000000
NODE_7659_length_950_cov_4.430082	594	674	0	80	80	1.0000000
NODE_7659_length_950_cov_4.430082	647	727	0	80	80	1.0000000
NODE_7672_length_949_cov_25.550588	371	451	4	80	80	1.0000000
NODE_7672_length_949_cov_25.550588	500	580	0	55	80	0.6875000
NODE_7672_length_949_cov_25.550588	500	580	2	25	80	0.3125000
NODE_7672_length_949_cov_25.550588	553	633	0	2	80	0.0250000
NODE_7672_length_949_cov_25.550588	553	633	2	78	80	0.9750000
NODE_7673_length_949_cov_20.949412	252	332	0	58	80	0.7250000
NODE_7673_length_949_cov_20.949412	252	332	2	22	80	0.2750000
NODE_7673_length_949_cov_20.949412	305	385	0	21	80	0.2625000
NODE_7673_length_949_cov_20.949412	305	385	2	59	80	0.7375000
NODE_7674_length_949_cov_20.601176	364	444	0	80	80	1.0000000
NODE_7674_length_949_cov_20.601176	417	497	0	80	80	1.0000000
NODE_7674_length_949_cov_20.601176	493	573	0	80	80	1.0000000
NODE_7674_length_949_cov_20.601176	546	626	0	80	80	1.0000000
NODE_7675_length_949_cov_20.575294	481	561	2	31	80	0.3875000
NODE_7675_length_949_cov_20.575294	481	561	4	26	80	0.3250000
NODE_7675_length_949_cov_20.575294	481	561	6	23	80	0.2875000
NODE_7675_length_949_cov_20.575294	534	614	2	80	80	1.0000000
NODE_7676_length_949_cov_19.483529	340	420	0	80	80	1.0000000
NODE_7676_length_949_cov_19.483529	393	473	0	80	80	1.0000000
NODE_7676_length_949_cov_19.483529	469	549	0	80	80	1.0000000
NODE_7676_length_949_cov_19.483529	522	602	0	80	80	1.0000000
NODE_7677_length_949_cov_19.407059	433	513	0	80	80	1.0000000
NODE_7677_length_949_cov_19.407059	486	566	0	80	80	1.0000000
NODE_7677_length_949_cov_19.407059	562	642	0	61	80	0.7625000
NODE_7677_length_949_cov_19.407059	562	642	2	19	80	0.2375000
NODE_7677_length_949_cov_19.407059	615	695	0	8	80	0.1000000
NODE_7677_length_949_cov_19.407059	615	695	2	72	80	0.9000000
NODE_7678_length_949_cov_10.903529	561	641	8	80	80	1.0000000
NODE_7678_length_949_cov_10.903529	614	694	0	30	80	0.3750000
NODE_7678_length_949_cov_10.903529	614	694	8	50	80	0.6250000
NODE_7679_length_949_cov_7.245882	0	71	0	51	71	0.7183099
NODE_7679_length_949_cov_7.245882	0	71	3	10	71	0.1408451
NODE_7679_length_949_cov_7.245882	0	71	5	10	71	0.1408451
NODE_7679_length_949_cov_7.245882	0	71	0	51	71	0.7183099
NODE_7679_length_949_cov_7.245882	0	71	3	10	71	0.1408451
NODE_7679_length_949_cov_7.245882	0	71	5	10	71	0.1408451
NODE_7679_length_949_cov_7.245882	44	124	0	7	80	0.0875000
NODE_7679_length_949_cov_7.245882	44	124	3	10	80	0.1250000
NODE_7679_length_949_cov_7.245882	44	124	5	12	80	0.1500000
NODE_7679_length_949_cov_7.245882	44	124	6	16	80	0.2000000
NODE_7679_length_949_cov_7.245882	44	124	8	35	80	0.4375000
NODE_7680_length_949_cov_6.998824	494	574	0	80	80	1.0000000
NODE_7680_length_949_cov_6.998824	547	627	0	80	80	1.0000000
NODE_7702_length_948_cov_37.201413	510	590	1	18	80	0.2250000
NODE_7702_length_948_cov_37.201413	510	590	3	28	80	0.3500000
NODE_7702_length_948_cov_37.201413	510	590	4	34	80	0.4250000
NODE_7702_length_948_cov_37.201413	563	643	1	13	80	0.1625000
NODE_7702_length_948_cov_37.201413	563	643	2	2	80	0.0250000
NODE_7702_length_948_cov_37.201413	563	643	4	65	80	0.8125000
NODE_7703_length_948_cov_20.082450	58	99	2	41	41	1.0000000
NODE_7703_length_948_cov_20.082450	113	193	6	5	80	0.0625000
NODE_7703_length_948_cov_20.082450	113	193	12	6	80	0.0750000
NODE_7703_length_948_cov_20.082450	113	193	14	3	80	0.0375000
NODE_7703_length_948_cov_20.082450	113	193	16	11	80	0.1375000
NODE_7703_length_948_cov_20.082450	113	193	18	26	80	0.3250000
NODE_7703_length_948_cov_20.082450	113	193	21	1	80	0.0125000
NODE_7703_length_948_cov_20.082450	113	193	23	1	80	0.0125000
NODE_7703_length_948_cov_20.082450	113	193	25	1	80	0.0125000
NODE_7703_length_948_cov_20.082450	113	193	31	14	80	0.1750000
NODE_7703_length_948_cov_20.082450	113	193	37	1	80	0.0125000
NODE_7703_length_948_cov_20.082450	113	193	40	1	80	0.0125000
NODE_7703_length_948_cov_20.082450	113	193	42	6	80	0.0750000
NODE_7703_length_948_cov_20.082450	113	193	44	4	80	0.0500000
NODE_7703_length_948_cov_20.082450	166	246	25	1	80	0.0125000
NODE_7703_length_948_cov_20.082450	166	246	30	12	80	0.1500000
NODE_7703_length_948_cov_20.082450	166	246	31	14	80	0.1750000
NODE_7703_length_948_cov_20.082450	166	246	32	16	80	0.2000000
NODE_7703_length_948_cov_20.082450	166	246	37	1	80	0.0125000
NODE_7703_length_948_cov_20.082450	166	246	38	3	80	0.0375000
NODE_7703_length_948_cov_20.082450	166	246	40	7	80	0.0875000
NODE_7703_length_948_cov_20.082450	166	246	42	11	80	0.1375000
NODE_7703_length_948_cov_20.082450	166	246	44	12	80	0.1500000
NODE_7703_length_948_cov_20.082450	166	246	45	1	80	0.0125000
NODE_7703_length_948_cov_20.082450	166	246	46	2	80	0.0250000
NODE_7704_length_948_cov_16.785630	308	388	2	38	80	0.4750000
NODE_7704_length_948_cov_16.785630	308	388	3	26	80	0.3250000
NODE_7704_length_948_cov_16.785630	308	388	4	16	80	0.2000000
NODE_7704_length_948_cov_16.785630	361	441	2	71	80	0.8875000
NODE_7704_length_948_cov_16.785630	361	441	6	9	80	0.1125000
NODE_7704_length_948_cov_16.785630	437	517	6	7	80	0.0875000
NODE_7704_length_948_cov_16.785630	437	517	10	25	80	0.3125000
NODE_7704_length_948_cov_16.785630	437	517	11	26	80	0.3250000
NODE_7704_length_948_cov_16.785630	437	517	12	22	80	0.2750000
NODE_7704_length_948_cov_16.785630	490	570	6	19	80	0.2375000
NODE_7704_length_948_cov_16.785630	490	570	10	59	80	0.7375000
NODE_7704_length_948_cov_16.785630	490	570	11	2	80	0.0250000
NODE_7705_length_948_cov_12.740872	400	480	0	80	80	1.0000000
NODE_7705_length_948_cov_12.740872	453	533	0	80	80	1.0000000
NODE_7706_length_948_cov_10.220259	465	545	0	14	80	0.1750000
NODE_7706_length_948_cov_10.220259	465	545	6	5	80	0.0625000
NODE_7706_length_948_cov_10.220259	465	545	8	61	80	0.7625000
NODE_7706_length_948_cov_10.220259	518	598	0	34	80	0.4250000
NODE_7706_length_948_cov_10.220259	518	598	2	9	80	0.1125000
NODE_7706_length_948_cov_10.220259	518	598	8	37	80	0.4625000
NODE_7707_length_948_cov_8.504122	456	536	0	80	80	1.0000000
NODE_7707_length_948_cov_8.504122	509	589	0	80	80	1.0000000
NODE_7709_length_948_cov_5.425206	641	721	0	80	80	1.0000000
NODE_7709_length_948_cov_5.425206	694	774	0	80	80	1.0000000
NODE_7711_length_948_cov_3.586572	696	776	0	80	80	1.0000000
NODE_7715_length_948_cov_2.786808	259	324	0	65	65	1.0000000
NODE_7715_length_948_cov_2.786808	297	377	0	68	80	0.8500000
NODE_7715_length_948_cov_2.786808	297	377	2	12	80	0.1500000
NODE_7721_length_947_cov_91.466981	393	473	0	80	80	1.0000000
NODE_7721_length_947_cov_91.466981	446	526	0	80	80	1.0000000
NODE_7722_length_947_cov_61.139151	402	482	0	12	80	0.1500000
NODE_7722_length_947_cov_61.139151	402	482	2	2	80	0.0250000
NODE_7722_length_947_cov_61.139151	402	482	6	66	80	0.8250000
NODE_7722_length_947_cov_61.139151	455	535	0	12	80	0.1500000
NODE_7722_length_947_cov_61.139151	455	535	2	55	80	0.6875000
NODE_7722_length_947_cov_61.139151	455	535	6	13	80	0.1625000
NODE_7723_length_947_cov_50.009434	488	568	0	6	80	0.0750000
NODE_7723_length_947_cov_50.009434	488	568	1	66	80	0.8250000
NODE_7723_length_947_cov_50.009434	488	568	2	8	80	0.1000000
NODE_7723_length_947_cov_50.009434	541	621	1	19	80	0.2375000
NODE_7723_length_947_cov_50.009434	541	621	2	61	80	0.7625000
NODE_7724_length_947_cov_36.271226	511	591	2	17	80	0.2125000
NODE_7724_length_947_cov_36.271226	511	591	7	6	80	0.0750000
NODE_7724_length_947_cov_36.271226	511	591	8	7	80	0.0875000
NODE_7724_length_947_cov_36.271226	511	591	9	7	80	0.0875000
NODE_7724_length_947_cov_36.271226	511	591	10	43	80	0.5375000
NODE_7724_length_947_cov_36.271226	564	644	0	52	80	0.6500000
NODE_7724_length_947_cov_36.271226	564	644	2	18	80	0.2250000
NODE_7724_length_947_cov_36.271226	564	644	7	6	80	0.0750000
NODE_7724_length_947_cov_36.271226	564	644	9	4	80	0.0500000
NODE_7725_length_947_cov_23.384434	425	505	0	80	80	1.0000000
NODE_7725_length_947_cov_23.384434	478	558	0	80	80	1.0000000
NODE_7726_length_947_cov_19.103774	316	396	0	5	80	0.0625000
NODE_7726_length_947_cov_19.103774	316	396	2	35	80	0.4375000
NODE_7726_length_947_cov_19.103774	316	396	4	16	80	0.2000000
NODE_7726_length_947_cov_19.103774	316	396	6	24	80	0.3000000
NODE_7726_length_947_cov_19.103774	369	449	0	58	80	0.7250000
NODE_7726_length_947_cov_19.103774	369	449	2	22	80	0.2750000
NODE_7727_length_947_cov_18.853774	516	596	0	29	80	0.3625000
NODE_7727_length_947_cov_18.853774	516	596	2	51	80	0.6375000
NODE_7727_length_947_cov_18.853774	569	649	0	80	80	1.0000000
NODE_7728_length_947_cov_18.077830	315	395	0	21	80	0.2625000
NODE_7728_length_947_cov_18.077830	315	395	2	59	80	0.7375000
NODE_7728_length_947_cov_18.077830	368	448	0	23	80	0.2875000
NODE_7728_length_947_cov_18.077830	368	448	2	57	80	0.7125000
NODE_7729_length_947_cov_17.713443	403	483	0	80	80	1.0000000
NODE_7729_length_947_cov_17.713443	456	536	0	80	80	1.0000000
NODE_7730_length_947_cov_14.492925	358	438	0	33	80	0.4125000
NODE_7730_length_947_cov_14.492925	358	438	2	47	80	0.5875000
NODE_7730_length_947_cov_14.492925	411	491	0	17	80	0.2125000
NODE_7730_length_947_cov_14.492925	411	491	2	63	80	0.7875000
NODE_7730_length_947_cov_14.492925	487	567	0	80	80	1.0000000
NODE_7730_length_947_cov_14.492925	540	620	0	80	80	1.0000000
NODE_7731_length_947_cov_10.573113	550	630	0	73	80	0.9125000
NODE_7731_length_947_cov_10.573113	550	630	2	7	80	0.0875000
NODE_7731_length_947_cov_10.573113	603	683	0	20	80	0.2500000
NODE_7731_length_947_cov_10.573113	603	683	2	60	80	0.7500000
NODE_7732_length_947_cov_7.762972	550	630	4	59	80	0.7375000
NODE_7732_length_947_cov_7.762972	550	630	6	9	80	0.1125000
NODE_7732_length_947_cov_7.762972	550	630	8	12	80	0.1500000
NODE_7732_length_947_cov_7.762972	607	683	4	12	76	0.1578947
NODE_7732_length_947_cov_7.762972	607	683	6	52	76	0.6842105
NODE_7732_length_947_cov_7.762972	607	683	8	12	76	0.1578947
NODE_7747_length_946_cov_39.726092	378	458	0	80	80	1.0000000
NODE_7747_length_946_cov_39.726092	431	511	0	80	80	1.0000000
NODE_7747_length_946_cov_39.726092	507	587	0	80	80	1.0000000
NODE_7747_length_946_cov_39.726092	560	640	0	80	80	1.0000000
NODE_7748_length_946_cov_32.728453	404	484	0	80	80	1.0000000
NODE_7748_length_946_cov_32.728453	457	537	0	80	80	1.0000000
NODE_7749_length_946_cov_27.548996	280	360	0	45	80	0.5625000
NODE_7749_length_946_cov_27.548996	280	360	4	35	80	0.4375000
NODE_7749_length_946_cov_27.548996	333	413	0	80	80	1.0000000
NODE_7750_length_946_cov_24.622196	352	432	0	39	80	0.4875000
NODE_7750_length_946_cov_24.622196	352	432	2	17	80	0.2125000
NODE_7750_length_946_cov_24.622196	352	432	6	24	80	0.3000000
NODE_7750_length_946_cov_24.622196	405	486	2	3	81	0.0370370
NODE_7750_length_946_cov_24.622196	405	486	4	33	81	0.4074074
NODE_7750_length_946_cov_24.622196	405	486	6	45	81	0.5555556
NODE_7751_length_946_cov_18.082645	492	572	0	80	80	1.0000000
NODE_7751_length_946_cov_18.082645	545	625	0	80	80	1.0000000
NODE_7752_length_946_cov_18.031877	433	513	0	80	80	1.0000000
NODE_7752_length_946_cov_18.031877	486	566	0	80	80	1.0000000
NODE_7753_length_946_cov_15.188902	472	552	0	80	80	1.0000000
NODE_7753_length_946_cov_15.188902	525	605	0	80	80	1.0000000
NODE_7754_length_946_cov_11.201889	408	488	0	80	80	1.0000000
NODE_7754_length_946_cov_11.201889	461	541	0	80	80	1.0000000
NODE_7768_length_945_cov_42.997636	361	441	0	80	80	1.0000000
NODE_7768_length_945_cov_42.997636	414	494	0	80	80	1.0000000
NODE_7769_length_945_cov_31.223404	357	437	22	11	80	0.1375000
NODE_7769_length_945_cov_31.223404	357	437	38	1	80	0.0125000
NODE_7769_length_945_cov_31.223404	357	437	39	68	80	0.8500000
NODE_7769_length_945_cov_31.223404	410	490	24	22	80	0.2750000
NODE_7769_length_945_cov_31.223404	410	490	30	1	80	0.0125000
NODE_7769_length_945_cov_31.223404	410	490	31	5	80	0.0625000
NODE_7769_length_945_cov_31.223404	410	490	39	52	80	0.6500000
NODE_7770_length_945_cov_26.348700	331	411	0	54	80	0.6750000
NODE_7770_length_945_cov_26.348700	331	411	1	26	80	0.3250000
NODE_7770_length_945_cov_26.348700	384	464	0	1	80	0.0125000
NODE_7770_length_945_cov_26.348700	384	464	1	38	80	0.4750000
NODE_7770_length_945_cov_26.348700	384	464	3	34	80	0.4250000
NODE_7770_length_945_cov_26.348700	384	464	4	7	80	0.0875000
NODE_7771_length_945_cov_20.349882	435	515	0	63	80	0.7875000
NODE_7771_length_945_cov_20.349882	435	515	4	17	80	0.2125000
NODE_7771_length_945_cov_20.349882	488	568	0	10	80	0.1250000
NODE_7771_length_945_cov_20.349882	488	568	4	70	80	0.8750000
NODE_7772_length_945_cov_14.771868	386	466	0	80	80	1.0000000
NODE_7772_length_945_cov_14.771868	439	519	0	80	80	1.0000000
NODE_7773_length_945_cov_10.158392	599	679	0	80	80	1.0000000
NODE_7773_length_945_cov_10.158392	652	732	0	80	80	1.0000000
NODE_7775_length_945_cov_5.403073	357	437	0	80	80	1.0000000
NODE_7775_length_945_cov_5.403073	410	490	0	80	80	1.0000000
NODE_7785_length_944_cov_42.401183	358	438	2	37	80	0.4625000
NODE_7785_length_944_cov_42.401183	358	438	4	29	80	0.3625000
NODE_7785_length_944_cov_42.401183	358	438	6	2	80	0.0250000
NODE_7785_length_944_cov_42.401183	358	438	18	12	80	0.1500000
NODE_7785_length_944_cov_42.401183	411	498	2	15	87	0.1724138
NODE_7785_length_944_cov_42.401183	411	498	18	72	87	0.8275862
NODE_7786_length_944_cov_32.712426	377	457	0	80	80	1.0000000
NODE_7786_length_944_cov_32.712426	430	510	0	80	80	1.0000000
NODE_7787_length_944_cov_27.839053	417	497	0	18	80	0.2250000
NODE_7787_length_944_cov_27.839053	417	497	2	62	80	0.7750000
NODE_7787_length_944_cov_27.839053	470	550	0	71	80	0.8875000
NODE_7787_length_944_cov_27.839053	470	550	2	9	80	0.1125000
NODE_7788_length_944_cov_24.702959	413	493	0	73	80	0.9125000
NODE_7788_length_944_cov_24.702959	413	493	2	7	80	0.0875000
NODE_7788_length_944_cov_24.702959	466	546	0	40	80	0.5000000
NODE_7788_length_944_cov_24.702959	466	546	2	40	80	0.5000000
NODE_7789_length_944_cov_11.951479	347	427	0	80	80	1.0000000
NODE_7789_length_944_cov_11.951479	400	480	0	80	80	1.0000000
NODE_7789_length_944_cov_11.951479	476	556	0	80	80	1.0000000
NODE_7789_length_944_cov_11.951479	529	609	0	80	80	1.0000000
NODE_7790_length_944_cov_6.745562	366	446	0	80	80	1.0000000
NODE_7790_length_944_cov_6.745562	419	499	0	80	80	1.0000000
NODE_7792_length_944_cov_4.420118	236	316	0	80	80	1.0000000
NODE_7792_length_944_cov_4.420118	289	369	0	80	80	1.0000000
NODE_7800_length_943_cov_40.111374	536	614	0	78	78	1.0000000
NODE_7800_length_943_cov_40.111374	587	667	0	80	80	1.0000000
NODE_7801_length_943_cov_29.446682	338	418	4	25	80	0.3125000
NODE_7801_length_943_cov_29.446682	338	418	8	55	80	0.6875000
NODE_7801_length_943_cov_29.446682	391	471	0	19	80	0.2375000
NODE_7801_length_943_cov_29.446682	391	471	4	30	80	0.3750000
NODE_7801_length_943_cov_29.446682	391	471	6	4	80	0.0500000
NODE_7801_length_943_cov_29.446682	391	471	8	27	80	0.3375000
NODE_7802_length_943_cov_28.289100	393	473	4	11	80	0.1375000
NODE_7802_length_943_cov_28.289100	393	473	6	6	80	0.0750000
NODE_7802_length_943_cov_28.289100	393	473	8	63	80	0.7875000
NODE_7802_length_943_cov_28.289100	446	526	0	33	80	0.4125000
NODE_7802_length_943_cov_28.289100	446	526	4	2	80	0.0250000
NODE_7802_length_943_cov_28.289100	446	526	6	8	80	0.1000000
NODE_7802_length_943_cov_28.289100	446	526	8	37	80	0.4625000
NODE_7803_length_943_cov_27.225118	343	423	2	18	80	0.2250000
NODE_7803_length_943_cov_27.225118	343	423	4	35	80	0.4375000
NODE_7803_length_943_cov_27.225118	343	423	6	27	80	0.3375000
NODE_7803_length_943_cov_27.225118	396	476	2	61	80	0.7625000
NODE_7803_length_943_cov_27.225118	396	476	5	10	80	0.1250000
NODE_7803_length_943_cov_27.225118	396	476	6	9	80	0.1125000
NODE_7804_length_943_cov_26.536730	275	303	0	28	28	1.0000000
NODE_7804_length_943_cov_26.536730	299	379	0	58	80	0.7250000
NODE_7804_length_943_cov_26.536730	299	379	4	22	80	0.2750000
NODE_7804_length_943_cov_26.536730	352	432	0	5	80	0.0625000
NODE_7804_length_943_cov_26.536730	352	432	4	25	80	0.3125000
NODE_7804_length_943_cov_26.536730	352	432	6	50	80	0.6250000
NODE_7805_length_943_cov_24.992891	374	454	0	80	80	1.0000000
NODE_7805_length_943_cov_24.992891	427	507	0	80	80	1.0000000
NODE_7805_length_943_cov_24.992891	503	583	0	15	80	0.1875000
NODE_7805_length_943_cov_24.992891	503	583	8	65	80	0.8125000
NODE_7805_length_943_cov_24.992891	556	636	0	15	80	0.1875000
NODE_7805_length_943_cov_24.992891	556	636	6	1	80	0.0125000
NODE_7805_length_943_cov_24.992891	556	636	8	64	80	0.8000000
NODE_7806_length_943_cov_24.758294	403	483	0	27	80	0.3375000
NODE_7806_length_943_cov_24.758294	403	483	2	53	80	0.6625000
NODE_7806_length_943_cov_24.758294	456	536	0	5	80	0.0625000
NODE_7806_length_943_cov_24.758294	456	536	2	75	80	0.9375000
NODE_7807_length_943_cov_22.316351	432	512	0	80	80	1.0000000
NODE_7807_length_943_cov_22.316351	485	565	0	80	80	1.0000000
NODE_7808_length_943_cov_22.149289	393	473	0	55	80	0.6875000
NODE_7808_length_943_cov_22.149289	393	473	2	25	80	0.3125000
NODE_7808_length_943_cov_22.149289	446	526	0	2	80	0.0250000
NODE_7808_length_943_cov_22.149289	446	526	2	78	80	0.9750000
NODE_7809_length_943_cov_20.055687	412	492	0	80	80	1.0000000
NODE_7809_length_943_cov_20.055687	465	545	0	80	80	1.0000000
NODE_7810_length_943_cov_16.022512	338	418	0	80	80	1.0000000
NODE_7810_length_943_cov_16.022512	391	471	0	80	80	1.0000000
NODE_7811_length_943_cov_10.939573	474	554	0	80	80	1.0000000
NODE_7811_length_943_cov_10.939573	527	607	0	80	80	1.0000000
NODE_7812_length_943_cov_9.483412	422	502	0	80	80	1.0000000
NODE_7812_length_943_cov_9.483412	475	555	0	80	80	1.0000000
NODE_7830_length_942_cov_58.088968	384	464	0	6	80	0.0750000
NODE_7830_length_942_cov_58.088968	384	464	4	74	80	0.9250000
NODE_7830_length_942_cov_58.088968	437	517	4	28	80	0.3500000
NODE_7830_length_942_cov_58.088968	437	517	6	52	80	0.6500000
NODE_7832_length_942_cov_27.466192	360	440	0	80	80	1.0000000
NODE_7832_length_942_cov_27.466192	413	493	0	76	80	0.9500000
NODE_7832_length_942_cov_27.466192	413	493	4	4	80	0.0500000
NODE_7833_length_942_cov_26.914591	346	426	0	80	80	1.0000000
NODE_7833_length_942_cov_26.914591	399	479	0	80	80	1.0000000
NODE_7834_length_942_cov_17.911032	390	470	2	21	80	0.2625000
NODE_7834_length_942_cov_17.911032	390	470	4	4	80	0.0500000
NODE_7834_length_942_cov_17.911032	390	470	14	3	80	0.0375000
NODE_7834_length_942_cov_17.911032	390	470	16	38	80	0.4750000
NODE_7834_length_942_cov_17.911032	390	470	18	14	80	0.1750000
NODE_7834_length_942_cov_17.911032	443	523	14	56	80	0.7000000
NODE_7834_length_942_cov_17.911032	443	523	16	24	80	0.3000000
NODE_7835_length_942_cov_14.695136	442	522	0	80	80	1.0000000
NODE_7835_length_942_cov_14.695136	495	575	0	80	80	1.0000000
NODE_7836_length_942_cov_14.097272	547	627	0	80	80	1.0000000
NODE_7836_length_942_cov_14.097272	600	680	0	80	80	1.0000000
NODE_7837_length_942_cov_13.174377	322	402	2	15	80	0.1875000
NODE_7837_length_942_cov_13.174377	322	402	4	51	80	0.6375000
NODE_7837_length_942_cov_13.174377	322	402	6	14	80	0.1750000
NODE_7837_length_942_cov_13.174377	375	455	2	43	80	0.5375000
NODE_7837_length_942_cov_13.174377	375	455	4	37	80	0.4625000
NODE_7858_length_941_cov_36.592637	259	339	2	25	80	0.3125000
NODE_7858_length_941_cov_36.592637	259	339	4	33	80	0.4125000
NODE_7858_length_941_cov_36.592637	259	339	6	22	80	0.2750000
NODE_7858_length_941_cov_36.592637	312	392	0	28	80	0.3500000
NODE_7858_length_941_cov_36.592637	312	392	2	50	80	0.6250000
NODE_7858_length_941_cov_36.592637	312	392	6	2	80	0.0250000
NODE_7858_length_941_cov_36.592637	388	468	0	80	80	1.0000000
NODE_7858_length_941_cov_36.592637	441	521	0	80	80	1.0000000
NODE_7859_length_941_cov_35.375297	352	432	0	80	80	1.0000000
NODE_7859_length_941_cov_35.375297	405	485	0	80	80	1.0000000
NODE_7859_length_941_cov_35.375297	481	561	0	80	80	1.0000000
NODE_7859_length_941_cov_35.375297	534	614	0	80	80	1.0000000
NODE_7860_length_941_cov_32.222090	407	487	0	18	80	0.2250000
NODE_7860_length_941_cov_32.222090	407	487	12	1	80	0.0125000
NODE_7860_length_941_cov_32.222090	407	487	14	34	80	0.4250000
NODE_7860_length_941_cov_32.222090	407	487	23	27	80	0.3375000
NODE_7860_length_941_cov_32.222090	460	540	0	71	80	0.8875000
NODE_7860_length_941_cov_32.222090	460	540	12	1	80	0.0125000
NODE_7860_length_941_cov_32.222090	460	540	14	8	80	0.1000000
NODE_7861_length_941_cov_28.442993	391	471	0	33	80	0.4125000
NODE_7861_length_941_cov_28.442993	391	471	4	23	80	0.2875000
NODE_7861_length_941_cov_28.442993	391	471	6	24	80	0.3000000
NODE_7861_length_941_cov_28.442993	444	524	0	80	80	1.0000000
NODE_7862_length_941_cov_20.788599	341	421	0	17	80	0.2125000
NODE_7862_length_941_cov_20.788599	341	421	2	41	80	0.5125000
NODE_7862_length_941_cov_20.788599	341	421	3	22	80	0.2750000
NODE_7862_length_941_cov_20.788599	394	474	0	23	80	0.2875000
NODE_7862_length_941_cov_20.788599	394	474	2	10	80	0.1250000
NODE_7862_length_941_cov_20.788599	394	474	4	47	80	0.5875000
NODE_7863_length_941_cov_18.000000	364	444	2	62	80	0.7750000
NODE_7863_length_941_cov_18.000000	364	444	4	18	80	0.2250000
NODE_7863_length_941_cov_18.000000	417	497	0	2	80	0.0250000
NODE_7863_length_941_cov_18.000000	417	497	2	20	80	0.2500000
NODE_7863_length_941_cov_18.000000	417	497	4	58	80	0.7250000
NODE_7864_length_941_cov_11.020190	325	405	0	80	80	1.0000000
NODE_7864_length_941_cov_11.020190	378	458	0	80	80	1.0000000
NODE_7865_length_941_cov_6.020190	260	287	12	27	27	1.0000000
NODE_7865_length_941_cov_6.020190	260	340	0	3	80	0.0375000
NODE_7865_length_941_cov_6.020190	260	340	4	18	80	0.2250000
NODE_7865_length_941_cov_6.020190	260	340	11	1	80	0.0125000
NODE_7865_length_941_cov_6.020190	260	340	12	58	80	0.7250000
NODE_7867_length_941_cov_3.745843	867	941	0	11	74	0.1486486
NODE_7867_length_941_cov_3.745843	867	941	2	9	74	0.1216216
NODE_7867_length_941_cov_3.745843	867	941	5	5	74	0.0675676
NODE_7867_length_941_cov_3.745843	867	941	7	15	74	0.2027027
NODE_7867_length_941_cov_3.745843	867	941	8	34	74	0.4594595
NODE_7877_length_940_cov_43.954816	243	323	0	80	80	1.0000000
NODE_7877_length_940_cov_43.954816	296	376	0	80	80	1.0000000
NODE_7877_length_940_cov_43.954816	372	452	0	80	80	1.0000000
NODE_7877_length_940_cov_43.954816	425	505	0	80	80	1.0000000
NODE_7878_length_940_cov_27.763377	423	503	0	17	80	0.2125000
NODE_7878_length_940_cov_27.763377	423	503	2	17	80	0.2125000
NODE_7878_length_940_cov_27.763377	423	503	6	3	80	0.0375000
NODE_7878_length_940_cov_27.763377	423	503	7	43	80	0.5375000
NODE_7878_length_940_cov_27.763377	476	556	1	24	80	0.3000000
NODE_7878_length_940_cov_27.763377	476	556	5	15	80	0.1875000
NODE_7878_length_940_cov_27.763377	476	556	7	41	80	0.5125000
NODE_7897_length_939_cov_58.982143	363	443	2	4	80	0.0500000
NODE_7897_length_939_cov_58.982143	363	443	4	20	80	0.2500000
NODE_7897_length_939_cov_58.982143	363	443	10	1	80	0.0125000
NODE_7897_length_939_cov_58.982143	363	443	14	38	80	0.4750000
NODE_7897_length_939_cov_58.982143	363	443	16	17	80	0.2125000
NODE_7897_length_939_cov_58.982143	416	496	0	14	80	0.1750000
NODE_7897_length_939_cov_58.982143	416	496	6	13	80	0.1625000
NODE_7897_length_939_cov_58.982143	416	496	12	13	80	0.1625000
NODE_7897_length_939_cov_58.982143	416	496	14	40	80	0.5000000
NODE_7898_length_939_cov_32.469048	327	407	0	80	80	1.0000000
NODE_7898_length_939_cov_32.469048	380	460	0	80	80	1.0000000
NODE_7899_length_939_cov_31.895238	265	345	0	80	80	1.0000000
NODE_7899_length_939_cov_31.895238	318	398	0	80	80	1.0000000
NODE_7900_length_939_cov_25.354762	439	519	0	12	80	0.1500000
NODE_7900_length_939_cov_25.354762	439	519	2	68	80	0.8500000
NODE_7900_length_939_cov_25.354762	492	572	2	64	80	0.8000000
NODE_7900_length_939_cov_25.354762	492	572	4	16	80	0.2000000
NODE_7901_length_939_cov_24.892857	370	450	0	80	80	1.0000000
NODE_7901_length_939_cov_24.892857	423	503	0	80	80	1.0000000
NODE_7902_length_939_cov_24.246429	422	502	4	19	80	0.2375000
NODE_7902_length_939_cov_24.246429	422	502	6	10	80	0.1250000
NODE_7902_length_939_cov_24.246429	422	502	10	22	80	0.2750000
NODE_7902_length_939_cov_24.246429	422	502	12	29	80	0.3625000
NODE_7902_length_939_cov_24.246429	475	555	0	11	80	0.1375000
NODE_7902_length_939_cov_24.246429	475	555	6	6	80	0.0750000
NODE_7902_length_939_cov_24.246429	475	555	8	3	80	0.0375000
NODE_7902_length_939_cov_24.246429	475	555	10	55	80	0.6875000
NODE_7902_length_939_cov_24.246429	475	555	12	5	80	0.0625000
NODE_7902_length_939_cov_24.246429	551	631	0	80	80	1.0000000
NODE_7902_length_939_cov_24.246429	604	684	0	80	80	1.0000000
NODE_7903_length_939_cov_21.141667	368	448	0	8	80	0.1000000
NODE_7903_length_939_cov_21.141667	368	448	2	72	80	0.9000000
NODE_7903_length_939_cov_21.141667	421	501	0	61	80	0.7625000
NODE_7903_length_939_cov_21.141667	421	501	2	19	80	0.2375000
NODE_7904_length_939_cov_16.425000	327	407	0	80	80	1.0000000
NODE_7904_length_939_cov_16.425000	380	460	0	80	80	1.0000000
NODE_7905_length_939_cov_13.828571	469	548	0	79	79	1.0000000
NODE_7905_length_939_cov_13.828571	522	603	0	81	81	1.0000000
NODE_7906_length_939_cov_13.521429	402	482	0	54	80	0.6750000
NODE_7906_length_939_cov_13.521429	402	482	2	10	80	0.1250000
NODE_7906_length_939_cov_13.521429	402	482	4	16	80	0.2000000
NODE_7906_length_939_cov_13.521429	455	535	0	1	80	0.0125000
NODE_7906_length_939_cov_13.521429	455	535	2	10	80	0.1250000
NODE_7906_length_939_cov_13.521429	455	535	4	67	80	0.8375000
NODE_7906_length_939_cov_13.521429	455	535	6	2	80	0.0250000
NODE_7907_length_939_cov_12.955952	398	478	0	78	80	0.9750000
NODE_7907_length_939_cov_12.955952	398	478	2	2	80	0.0250000
NODE_7907_length_939_cov_12.955952	451	531	0	80	80	1.0000000
NODE_7908_length_939_cov_6.564286	523	545	0	22	22	1.0000000
NODE_7922_length_938_cov_44.458880	362	442	0	80	80	1.0000000
NODE_7922_length_938_cov_44.458880	415	495	0	80	80	1.0000000
NODE_7923_length_938_cov_44.435042	748	815	0	30	67	0.4477612
NODE_7923_length_938_cov_44.435042	748	815	2	37	67	0.5522388
NODE_7924_length_938_cov_32.177592	466	546	4	80	80	1.0000000
NODE_7924_length_938_cov_32.177592	519	599	0	18	80	0.2250000
NODE_7924_length_938_cov_32.177592	519	599	2	29	80	0.3625000
NODE_7924_length_938_cov_32.177592	519	599	4	33	80	0.4125000
NODE_7925_length_938_cov_21.139452	474	554	0	80	80	1.0000000
NODE_7925_length_938_cov_21.139452	527	607	0	80	80	1.0000000
NODE_7927_length_938_cov_8.791418	300	380	0	80	80	1.0000000
NODE_7927_length_938_cov_8.791418	353	433	0	80	80	1.0000000
NODE_7932_length_938_cov_2.693683	59	139	0	1	80	0.0125000
NODE_7932_length_938_cov_2.693683	59	139	2	6	80	0.0750000
NODE_7932_length_938_cov_2.693683	59	139	4	13	80	0.1625000
NODE_7932_length_938_cov_2.693683	59	139	6	16	80	0.2000000
NODE_7932_length_938_cov_2.693683	59	139	8	44	80	0.5500000
NODE_7932_length_938_cov_2.693683	112	192	0	54	80	0.6750000
NODE_7932_length_938_cov_2.693683	112	192	2	6	80	0.0750000
NODE_7932_length_938_cov_2.693683	112	192	4	13	80	0.1625000
NODE_7932_length_938_cov_2.693683	112	192	6	7	80	0.0875000
NODE_7946_length_937_cov_31.890215	407	487	2	23	80	0.2875000
NODE_7946_length_937_cov_31.890215	407	487	4	34	80	0.4250000
NODE_7946_length_937_cov_31.890215	407	487	6	23	80	0.2875000
NODE_7946_length_937_cov_31.890215	460	536	0	19	76	0.2500000
NODE_7946_length_937_cov_31.890215	460	536	2	53	76	0.6973684
NODE_7946_length_937_cov_31.890215	460	536	6	4	76	0.0526316
NODE_7947_length_937_cov_31.198091	425	505	0	80	80	1.0000000
NODE_7947_length_937_cov_31.198091	478	558	0	75	80	0.9375000
NODE_7947_length_937_cov_31.198091	478	558	2	5	80	0.0625000
NODE_7948_length_937_cov_29.742243	296	376	8	80	80	1.0000000
NODE_7948_length_937_cov_29.742243	349	429	4	50	80	0.6250000
NODE_7948_length_937_cov_29.742243	349	429	8	30	80	0.3750000
NODE_7948_length_937_cov_29.742243	425	505	0	62	80	0.7750000
NODE_7948_length_937_cov_29.742243	425	505	2	3	80	0.0375000
NODE_7948_length_937_cov_29.742243	425	505	4	15	80	0.1875000
NODE_7948_length_937_cov_29.742243	478	558	0	80	80	1.0000000
NODE_7950_length_937_cov_26.153938	487	567	0	80	80	1.0000000
NODE_7950_length_937_cov_26.153938	540	620	0	80	80	1.0000000
NODE_7951_length_937_cov_20.898568	515	595	0	80	80	1.0000000
NODE_7951_length_937_cov_20.898568	568	648	0	80	80	1.0000000
NODE_7952_length_937_cov_20.502387	181	261	0	80	80	1.0000000
NODE_7952_length_937_cov_20.502387	234	314	0	80	80	1.0000000
NODE_7952_length_937_cov_20.502387	310	390	0	35	80	0.4375000
NODE_7952_length_937_cov_20.502387	310	390	4	38	80	0.4750000
NODE_7952_length_937_cov_20.502387	310	390	8	7	80	0.0875000
NODE_7952_length_937_cov_20.502387	363	443	4	38	80	0.4750000
NODE_7952_length_937_cov_20.502387	363	443	8	42	80	0.5250000
NODE_7953_length_937_cov_15.219570	526	606	0	80	80	1.0000000
NODE_7953_length_937_cov_15.219570	579	659	0	80	80	1.0000000
NODE_7954_length_937_cov_9.633652	521	601	0	80	80	1.0000000
NODE_7954_length_937_cov_9.633652	574	654	0	80	80	1.0000000
NODE_7956_length_937_cov_6.630072	305	385	0	53	80	0.6625000
NODE_7956_length_937_cov_6.630072	305	385	2	27	80	0.3375000
NODE_7956_length_937_cov_6.630072	358	438	0	21	80	0.2625000
NODE_7956_length_937_cov_6.630072	358	438	2	59	80	0.7375000
NODE_7957_length_937_cov_4.649165	470	550	0	80	80	1.0000000
NODE_7957_length_937_cov_4.649165	523	603	0	80	80	1.0000000
NODE_7969_length_936_cov_57.105137	267	347	0	80	80	1.0000000
NODE_7969_length_936_cov_57.105137	320	400	0	30	80	0.3750000
NODE_7969_length_936_cov_57.105137	320	400	2	50	80	0.6250000
NODE_7969_length_936_cov_57.105137	396	476	0	38	80	0.4750000
NODE_7969_length_936_cov_57.105137	396	476	2	42	80	0.5250000
NODE_7969_length_936_cov_57.105137	449	529	0	80	80	1.0000000
NODE_7970_length_936_cov_39.983274	433	513	0	80	80	1.0000000
NODE_7970_length_936_cov_39.983274	486	566	0	80	80	1.0000000
NODE_7971_length_936_cov_22.486260	534	614	0	80	80	1.0000000
NODE_7971_length_936_cov_22.486260	587	667	0	80	80	1.0000000
NODE_7972_length_936_cov_19.639188	409	489	0	80	80	1.0000000
NODE_7972_length_936_cov_19.639188	462	542	0	80	80	1.0000000
NODE_7973_length_936_cov_15.083632	322	402	0	13	80	0.1625000
NODE_7973_length_936_cov_15.083632	322	402	7	1	80	0.0125000
NODE_7973_length_936_cov_15.083632	322	402	8	66	80	0.8250000
NODE_7973_length_936_cov_15.083632	375	455	8	80	80	1.0000000
NODE_7974_length_936_cov_13.962963	356	424	0	22	68	0.3235294
NODE_7974_length_936_cov_13.962963	356	424	4	14	68	0.2058824
NODE_7974_length_936_cov_13.962963	356	424	6	32	68	0.4705882
NODE_7975_length_936_cov_12.502987	447	527	0	80	80	1.0000000
NODE_7975_length_936_cov_12.502987	500	580	0	80	80	1.0000000
NODE_7976_length_936_cov_12.279570	340	420	0	80	80	1.0000000
NODE_7976_length_936_cov_12.279570	393	473	0	80	80	1.0000000
NODE_7977_length_936_cov_7.906810	587	667	0	31	80	0.3875000
NODE_7977_length_936_cov_7.906810	587	667	2	49	80	0.6125000
NODE_7977_length_936_cov_7.906810	640	720	0	32	80	0.4000000
NODE_7977_length_936_cov_7.906810	640	720	2	48	80	0.6000000
NODE_7978_length_936_cov_6.845878	322	402	0	8	80	0.1000000
NODE_7978_length_936_cov_6.845878	322	402	4	72	80	0.9000000
NODE_7978_length_936_cov_6.845878	375	455	4	80	80	1.0000000
NODE_7979_length_936_cov_6.434886	556	635	0	43	79	0.5443038
NODE_7979_length_936_cov_6.434886	556	635	4	36	79	0.4556962
NODE_7979_length_936_cov_6.434886	608	688	2	3	80	0.0375000
NODE_7979_length_936_cov_6.434886	608	688	4	77	80	0.9625000
NODE_7993_length_935_cov_38.209330	57	137	87	3	80	0.0375000
NODE_7993_length_935_cov_38.209330	57	137	91	5	80	0.0625000
NODE_7993_length_935_cov_38.209330	57	137	93	3	80	0.0375000
NODE_7993_length_935_cov_38.209330	57	137	101	2	80	0.0250000
NODE_7993_length_935_cov_38.209330	57	137	103	3	80	0.0375000
NODE_7993_length_935_cov_38.209330	57	137	105	7	80	0.0875000
NODE_7993_length_935_cov_38.209330	57	137	107	4	80	0.0500000
NODE_7993_length_935_cov_38.209330	57	137	110	7	80	0.0875000
NODE_7993_length_935_cov_38.209330	57	137	111	9	80	0.1125000
NODE_7993_length_935_cov_38.209330	57	137	112	37	80	0.4625000
NODE_7994_length_935_cov_27.306220	439	519	0	69	80	0.8625000
NODE_7994_length_935_cov_27.306220	439	519	4	11	80	0.1375000
NODE_7994_length_935_cov_27.306220	492	572	0	21	80	0.2625000
NODE_7994_length_935_cov_27.306220	492	572	4	59	80	0.7375000
NODE_7995_length_935_cov_26.562201	321	401	0	80	80	1.0000000
NODE_7995_length_935_cov_26.562201	374	454	0	80	80	1.0000000
NODE_7995_length_935_cov_26.562201	450	530	0	80	80	1.0000000
NODE_7995_length_935_cov_26.562201	503	583	0	80	80	1.0000000
NODE_7996_length_935_cov_25.098086	356	436	0	80	80	1.0000000
NODE_7996_length_935_cov_25.098086	409	489	0	80	80	1.0000000
NODE_7997_length_935_cov_24.316986	467	547	0	68	80	0.8500000
NODE_7997_length_935_cov_24.316986	467	547	2	12	80	0.1500000
NODE_7997_length_935_cov_24.316986	520	600	0	15	80	0.1875000
NODE_7997_length_935_cov_24.316986	520	600	2	65	80	0.8125000
NODE_7998_length_935_cov_19.221292	397	477	2	13	80	0.1625000
NODE_7998_length_935_cov_19.221292	397	477	4	12	80	0.1500000
NODE_7998_length_935_cov_19.221292	397	477	6	26	80	0.3250000
NODE_7998_length_935_cov_19.221292	397	477	10	29	80	0.3625000
NODE_7998_length_935_cov_19.221292	450	530	4	12	80	0.1500000
NODE_7998_length_935_cov_19.221292	450	530	6	8	80	0.1000000
NODE_7998_length_935_cov_19.221292	450	530	8	22	80	0.2750000
NODE_7998_length_935_cov_19.221292	450	530	10	38	80	0.4750000
NODE_7999_length_935_cov_15.016746	404	484	0	66	80	0.8250000
NODE_7999_length_935_cov_15.016746	404	484	2	14	80	0.1750000
NODE_7999_length_935_cov_15.016746	457	537	0	80	80	1.0000000
NODE_8000_length_935_cov_13.138756	341	421	0	15	80	0.1875000
NODE_8000_length_935_cov_13.138756	341	421	5	15	80	0.1875000
NODE_8000_length_935_cov_13.138756	341	421	6	50	80	0.6250000
NODE_8000_length_935_cov_13.138756	394	474	0	19	80	0.2375000
NODE_8000_length_935_cov_13.138756	394	474	5	49	80	0.6125000
NODE_8000_length_935_cov_13.138756	394	474	6	12	80	0.1500000
NODE_8002_length_935_cov_6.485646	512	592	0	80	80	1.0000000
NODE_8002_length_935_cov_6.485646	565	645	0	80	80	1.0000000
NODE_8003_length_935_cov_6.467703	250	330	0	80	80	1.0000000
NODE_8003_length_935_cov_6.467703	303	383	0	80	80	1.0000000
NODE_8004_length_935_cov_6.144737	478	558	0	80	80	1.0000000
NODE_8004_length_935_cov_6.144737	531	611	0	80	80	1.0000000
NODE_8005_length_935_cov_3.905502	39	119	4	1	80	0.0125000
NODE_8005_length_935_cov_3.905502	39	119	6	57	80	0.7125000
NODE_8005_length_935_cov_3.905502	39	119	8	22	80	0.2750000
NODE_8005_length_935_cov_3.905502	92	166	0	16	74	0.2162162
NODE_8005_length_935_cov_3.905502	92	166	2	27	74	0.3648649
NODE_8005_length_935_cov_3.905502	92	166	4	5	74	0.0675676
NODE_8005_length_935_cov_3.905502	92	166	6	22	74	0.2972973
NODE_8005_length_935_cov_3.905502	92	166	8	4	74	0.0540541
NODE_8028_length_934_cov_22.898204	403	483	0	51	80	0.6375000
NODE_8028_length_934_cov_22.898204	403	483	2	29	80	0.3625000
NODE_8028_length_934_cov_22.898204	456	536	0	80	80	1.0000000
NODE_8029_length_934_cov_17.746108	246	326	0	80	80	1.0000000
NODE_8029_length_934_cov_17.746108	299	379	0	75	80	0.9375000
NODE_8029_length_934_cov_17.746108	299	379	2	5	80	0.0625000
NODE_8030_length_934_cov_16.049102	367	447	0	80	80	1.0000000
NODE_8030_length_934_cov_16.049102	420	500	0	80	80	1.0000000
NODE_8031_length_934_cov_13.738922	379	459	0	80	80	1.0000000
NODE_8031_length_934_cov_13.738922	432	459	0	27	27	1.0000000
NODE_8031_length_934_cov_13.738922	470	512	0	42	42	1.0000000
NODE_8032_length_934_cov_9.091018	407	487	0	80	80	1.0000000
NODE_8032_length_934_cov_9.091018	460	540	0	80	80	1.0000000
NODE_8034_length_934_cov_5.349701	583	663	0	80	80	1.0000000
NODE_8050_length_933_cov_36.557554	462	542	0	74	80	0.9250000
NODE_8050_length_933_cov_36.557554	462	542	2	6	80	0.0750000
NODE_8050_length_933_cov_36.557554	515	595	0	80	80	1.0000000
NODE_8051_length_933_cov_27.645084	476	556	0	14	80	0.1750000
NODE_8051_length_933_cov_27.645084	476	556	2	66	80	0.8250000
NODE_8051_length_933_cov_27.645084	529	609	0	36	80	0.4500000
NODE_8051_length_933_cov_27.645084	529	609	2	44	80	0.5500000
NODE_8052_length_933_cov_26.749400	611	691	0	80	80	1.0000000
NODE_8052_length_933_cov_26.749400	664	744	0	80	80	1.0000000
NODE_8053_length_933_cov_26.308153	430	510	0	80	80	1.0000000
NODE_8053_length_933_cov_26.308153	483	563	0	80	80	1.0000000
NODE_8054_length_933_cov_19.966427	444	530	0	2	86	0.0232558
NODE_8054_length_933_cov_19.966427	444	530	2	7	86	0.0813954
NODE_8054_length_933_cov_19.966427	444	530	4	30	86	0.3488372
NODE_8054_length_933_cov_19.966427	444	530	6	47	86	0.5465117
NODE_8054_length_933_cov_19.966427	497	583	0	55	86	0.6395349
NODE_8054_length_933_cov_19.966427	497	583	2	7	86	0.0813954
NODE_8054_length_933_cov_19.966427	497	583	4	24	86	0.2790698
NODE_8055_length_933_cov_16.870504	284	364	0	80	80	1.0000000
NODE_8055_length_933_cov_16.870504	337	415	0	78	78	1.0000000
NODE_8056_length_933_cov_16.699041	366	446	0	80	80	1.0000000
NODE_8056_length_933_cov_16.699041	419	499	0	80	80	1.0000000
NODE_8057_length_933_cov_11.171463	197	277	0	80	80	1.0000000
NODE_8057_length_933_cov_11.171463	250	330	0	80	80	1.0000000
NODE_8073_length_932_cov_26.656663	397	477	2	80	80	1.0000000
NODE_8073_length_932_cov_26.656663	450	530	0	35	80	0.4375000
NODE_8073_length_932_cov_26.656663	450	530	2	45	80	0.5625000
NODE_8074_length_932_cov_16.581032	407	485	0	5	78	0.0641026
NODE_8074_length_932_cov_16.581032	407	485	4	73	78	0.9358974
NODE_8074_length_932_cov_16.581032	460	538	0	58	78	0.7435898
NODE_8074_length_932_cov_16.581032	460	538	4	20	78	0.2564103
NODE_8075_length_932_cov_13.462185	413	493	2	68	80	0.8500000
NODE_8075_length_932_cov_13.462185	413	493	4	12	80	0.1500000
NODE_8075_length_932_cov_13.462185	466	546	2	15	80	0.1875000
NODE_8075_length_932_cov_13.462185	466	546	3	4	80	0.0500000
NODE_8075_length_932_cov_13.462185	466	546	4	40	80	0.5000000
NODE_8075_length_932_cov_13.462185	466	546	5	21	80	0.2625000
NODE_8076_length_932_cov_13.442977	386	466	0	80	80	1.0000000
NODE_8076_length_932_cov_13.442977	439	519	0	80	80	1.0000000
NODE_8077_length_932_cov_11.947179	344	424	0	64	80	0.8000000
NODE_8077_length_932_cov_11.947179	344	424	2	16	80	0.2000000
NODE_8077_length_932_cov_11.947179	397	477	0	11	80	0.1375000
NODE_8077_length_932_cov_11.947179	397	477	2	69	80	0.8625000
NODE_8079_length_932_cov_10.849940	409	489	0	80	80	1.0000000
NODE_8079_length_932_cov_10.849940	462	542	0	80	80	1.0000000
NODE_8080_length_932_cov_10.174070	342	422	0	80	80	1.0000000
NODE_8080_length_932_cov_10.174070	395	475	0	80	80	1.0000000
NODE_8082_length_932_cov_9.200480	184	264	1	8	80	0.1000000
NODE_8082_length_932_cov_9.200480	184	264	2	72	80	0.9000000
NODE_8082_length_932_cov_9.200480	237	317	1	16	80	0.2000000
NODE_8082_length_932_cov_9.200480	237	317	2	64	80	0.8000000
NODE_8090_length_932_cov_2.689076	598	676	0	78	78	1.0000000
NODE_8090_length_932_cov_2.689076	798	845	8	47	47	1.0000000
NODE_8103_length_931_cov_51.451923	320	400	0	80	80	1.0000000
NODE_8103_length_931_cov_51.451923	373	453	0	80	80	1.0000000
NODE_8104_length_931_cov_46.621394	527	607	0	80	80	1.0000000
NODE_8104_length_931_cov_46.621394	580	660	0	80	80	1.0000000
NODE_8105_length_931_cov_36.334135	347	427	0	80	80	1.0000000
NODE_8105_length_931_cov_36.334135	400	480	0	80	80	1.0000000
NODE_8106_length_931_cov_32.495192	482	562	2	17	80	0.2125000
NODE_8106_length_931_cov_32.495192	482	562	4	17	80	0.2125000
NODE_8106_length_931_cov_32.495192	482	562	6	46	80	0.5750000
NODE_8106_length_931_cov_32.495192	535	617	0	27	82	0.3292683
NODE_8106_length_931_cov_32.495192	535	617	2	45	82	0.5487805
NODE_8106_length_931_cov_32.495192	535	617	4	10	82	0.1219512
NODE_8107_length_931_cov_22.100962	375	455	0	9	80	0.1125000
NODE_8107_length_931_cov_22.100962	375	455	2	7	80	0.0875000
NODE_8107_length_931_cov_22.100962	375	455	4	64	80	0.8000000
NODE_8107_length_931_cov_22.100962	428	508	0	42	80	0.5250000
NODE_8107_length_931_cov_22.100962	428	508	2	8	80	0.1000000
NODE_8107_length_931_cov_22.100962	428	508	4	30	80	0.3750000
NODE_8108_length_931_cov_21.781250	347	427	0	80	80	1.0000000
NODE_8108_length_931_cov_21.781250	400	480	0	47	80	0.5875000
NODE_8108_length_931_cov_21.781250	400	480	2	33	80	0.4125000
NODE_8109_length_931_cov_19.084135	411	491	0	3	80	0.0375000
NODE_8109_length_931_cov_19.084135	411	491	2	77	80	0.9625000
NODE_8109_length_931_cov_19.084135	464	544	0	56	80	0.7000000
NODE_8109_length_931_cov_19.084135	464	544	2	24	80	0.3000000
NODE_8110_length_931_cov_14.879808	444	524	0	80	80	1.0000000
NODE_8110_length_931_cov_14.879808	497	577	0	33	80	0.4125000
NODE_8110_length_931_cov_14.879808	497	577	2	47	80	0.5875000
NODE_8111_length_931_cov_13.087740	759	800	8	2	41	0.0487805
NODE_8111_length_931_cov_13.087740	759	800	9	1	41	0.0243902
NODE_8111_length_931_cov_13.087740	759	800	11	1	41	0.0243902
NODE_8111_length_931_cov_13.087740	759	800	13	15	41	0.3658537
NODE_8111_length_931_cov_13.087740	759	800	15	5	41	0.1219512
NODE_8111_length_931_cov_13.087740	759	800	17	7	41	0.1707317
NODE_8111_length_931_cov_13.087740	759	800	19	10	41	0.2439024
NODE_8112_length_931_cov_10.534856	399	479	0	80	80	1.0000000
NODE_8112_length_931_cov_10.534856	452	532	0	80	80	1.0000000
NODE_8113_length_931_cov_9.865385	236	316	0	80	80	1.0000000
NODE_8113_length_931_cov_9.865385	289	369	0	80	80	1.0000000
NODE_8115_length_931_cov_6.201923	479	559	4	43	80	0.5375000
NODE_8115_length_931_cov_6.201923	479	559	6	37	80	0.4625000
NODE_8115_length_931_cov_6.201923	532	612	0	25	80	0.3125000
NODE_8115_length_931_cov_6.201923	532	612	2	22	80	0.2750000
NODE_8115_length_931_cov_6.201923	532	612	4	33	80	0.4125000
NODE_8124_length_931_cov_1.780048	832	902	0	70	70	1.0000000
NODE_8126_length_931_cov_1.433894	220	284	13	12	64	0.1875000
NODE_8126_length_931_cov_1.433894	220	284	15	7	64	0.1093750
NODE_8126_length_931_cov_1.433894	220	284	17	5	64	0.0781250
NODE_8126_length_931_cov_1.433894	220	284	19	5	64	0.0781250
NODE_8126_length_931_cov_1.433894	220	284	20	5	64	0.0781250
NODE_8126_length_931_cov_1.433894	220	284	21	13	64	0.2031250
NODE_8126_length_931_cov_1.433894	220	284	22	8	64	0.1250000
NODE_8126_length_931_cov_1.433894	220	284	23	1	64	0.0156250
NODE_8126_length_931_cov_1.433894	220	284	24	1	64	0.0156250
NODE_8126_length_931_cov_1.433894	220	284	25	7	64	0.1093750
NODE_8131_length_930_cov_49.052948	252	332	0	27	80	0.3375000
NODE_8131_length_930_cov_49.052948	252	332	2	53	80	0.6625000
NODE_8131_length_930_cov_49.052948	305	385	0	80	80	1.0000000
NODE_8131_length_930_cov_49.052948	381	462	0	81	81	1.0000000
NODE_8131_length_930_cov_49.052948	435	515	0	80	80	1.0000000
NODE_8132_length_930_cov_31.510229	400	482	0	82	82	1.0000000
NODE_8132_length_930_cov_31.510229	453	535	0	82	82	1.0000000
NODE_8133_length_930_cov_29.139591	329	409	0	80	80	1.0000000
NODE_8133_length_930_cov_29.139591	382	462	0	52	80	0.6500000
NODE_8133_length_930_cov_29.139591	382	462	2	28	80	0.3500000
NODE_8134_length_930_cov_24.787004	518	598	0	80	80	1.0000000
NODE_8134_length_930_cov_24.787004	571	651	0	80	80	1.0000000
NODE_8135_length_930_cov_24.608905	300	380	4	3	80	0.0375000
NODE_8135_length_930_cov_24.608905	300	380	6	12	80	0.1500000
NODE_8135_length_930_cov_24.608905	300	380	8	5	80	0.0625000
NODE_8135_length_930_cov_24.608905	300	380	10	10	80	0.1250000
NODE_8135_length_930_cov_24.608905	300	380	12	50	80	0.6250000
NODE_8135_length_930_cov_24.608905	353	433	4	56	80	0.7000000
NODE_8135_length_930_cov_24.608905	353	433	6	12	80	0.1500000
NODE_8135_length_930_cov_24.608905	353	433	8	5	80	0.0625000
NODE_8135_length_930_cov_24.608905	353	433	10	7	80	0.0875000
NODE_8136_length_930_cov_16.494585	482	562	4	32	80	0.4000000
NODE_8136_length_930_cov_16.494585	482	562	6	22	80	0.2750000
NODE_8136_length_930_cov_16.494585	482	562	8	26	80	0.3250000
NODE_8136_length_930_cov_16.494585	535	615	4	6	80	0.0750000
NODE_8136_length_930_cov_16.494585	535	615	6	48	80	0.6000000
NODE_8136_length_930_cov_16.494585	535	615	8	26	80	0.3250000
NODE_8137_length_930_cov_13.296029	249	329	0	10	80	0.1250000
NODE_8137_length_930_cov_13.296029	249	329	2	70	80	0.8750000
NODE_8137_length_930_cov_13.296029	302	382	0	44	80	0.5500000
NODE_8137_length_930_cov_13.296029	302	382	2	36	80	0.4500000
NODE_8137_length_930_cov_13.296029	378	458	0	80	80	1.0000000
NODE_8137_length_930_cov_13.296029	431	511	0	80	80	1.0000000
NODE_8138_length_930_cov_11.758123	463	543	6	4	80	0.0500000
NODE_8138_length_930_cov_11.758123	463	543	8	6	80	0.0750000
NODE_8138_length_930_cov_11.758123	463	543	9	7	80	0.0875000
NODE_8138_length_930_cov_11.758123	463	543	11	2	80	0.0250000
NODE_8138_length_930_cov_11.758123	463	543	12	2	80	0.0250000
NODE_8138_length_930_cov_11.758123	463	543	13	54	80	0.6750000
NODE_8138_length_930_cov_11.758123	463	543	15	5	80	0.0625000
NODE_8138_length_930_cov_11.758123	516	596	13	25	80	0.3125000
NODE_8138_length_930_cov_11.758123	516	596	15	55	80	0.6875000
NODE_8139_length_930_cov_7.576414	531	611	0	80	80	1.0000000
NODE_8139_length_930_cov_7.576414	584	664	0	80	80	1.0000000
NODE_8156_length_930_cov_0.821901	676	736	0	60	60	1.0000000
NODE_8157_length_929_cov_54.485542	313	393	4	60	80	0.7500000
NODE_8157_length_929_cov_54.485542	313	393	6	20	80	0.2500000
NODE_8157_length_929_cov_54.485542	366	446	0	15	80	0.1875000
NODE_8157_length_929_cov_54.485542	366	446	2	9	80	0.1125000
NODE_8157_length_929_cov_54.485542	366	446	4	36	80	0.4500000
NODE_8157_length_929_cov_54.485542	366	446	6	20	80	0.2500000
NODE_8157_length_929_cov_54.485542	442	522	0	30	80	0.3750000
NODE_8157_length_929_cov_54.485542	442	522	4	23	80	0.2875000
NODE_8157_length_929_cov_54.485542	442	522	6	27	80	0.3375000
NODE_8157_length_929_cov_54.485542	495	575	6	80	80	1.0000000
NODE_8158_length_929_cov_49.865060	429	509	4	59	80	0.7375000
NODE_8158_length_929_cov_49.865060	429	509	6	16	80	0.2000000
NODE_8158_length_929_cov_49.865060	429	509	10	5	80	0.0625000
NODE_8158_length_929_cov_49.865060	482	562	4	6	80	0.0750000
NODE_8158_length_929_cov_49.865060	482	562	6	22	80	0.2750000
NODE_8158_length_929_cov_49.865060	482	562	8	7	80	0.0875000
NODE_8158_length_929_cov_49.865060	482	562	10	5	80	0.0625000
NODE_8158_length_929_cov_49.865060	482	562	12	40	80	0.5000000
NODE_8159_length_929_cov_34.634940	358	438	0	6	80	0.0750000
NODE_8159_length_929_cov_34.634940	358	438	2	74	80	0.9250000
NODE_8159_length_929_cov_34.634940	411	491	0	53	80	0.6625000
NODE_8159_length_929_cov_34.634940	411	491	2	27	80	0.3375000
NODE_8161_length_929_cov_20.815663	365	445	0	80	80	1.0000000
NODE_8161_length_929_cov_20.815663	418	498	0	80	80	1.0000000
NODE_8162_length_929_cov_17.798795	376	456	0	69	80	0.8625000
NODE_8162_length_929_cov_17.798795	376	456	4	11	80	0.1375000
NODE_8162_length_929_cov_17.798795	429	509	0	80	80	1.0000000
NODE_8163_length_929_cov_16.622892	331	408	0	77	77	1.0000000
NODE_8163_length_929_cov_16.622892	381	461	0	80	80	1.0000000
NODE_8163_length_929_cov_16.622892	457	537	0	80	80	1.0000000
NODE_8163_length_929_cov_16.622892	510	590	0	80	80	1.0000000
NODE_8164_length_929_cov_15.242169	302	382	0	80	80	1.0000000
NODE_8164_length_929_cov_15.242169	355	435	0	80	80	1.0000000
NODE_8164_length_929_cov_15.242169	431	511	0	80	80	1.0000000
NODE_8164_length_929_cov_15.242169	484	564	0	80	80	1.0000000
NODE_8165_length_929_cov_13.197590	259	339	0	80	80	1.0000000
NODE_8165_length_929_cov_13.197590	312	392	0	80	80	1.0000000
NODE_8167_length_929_cov_7.766265	385	465	0	3	80	0.0375000
NODE_8167_length_929_cov_7.766265	385	465	2	16	80	0.2000000
NODE_8167_length_929_cov_7.766265	385	465	4	6	80	0.0750000
NODE_8167_length_929_cov_7.766265	385	465	6	55	80	0.6875000
NODE_8167_length_929_cov_7.766265	438	518	0	16	80	0.2000000
NODE_8167_length_929_cov_7.766265	438	518	4	43	80	0.5375000
NODE_8167_length_929_cov_7.766265	438	518	6	21	80	0.2625000
NODE_8168_length_929_cov_5.750602	382	462	0	80	80	1.0000000
NODE_8168_length_929_cov_5.750602	435	515	0	80	80	1.0000000
NODE_8181_length_928_cov_35.226779	273	353	0	50	80	0.6250000
NODE_8181_length_928_cov_35.226779	273	353	2	30	80	0.3750000
NODE_8181_length_928_cov_35.226779	326	406	0	18	80	0.2250000
NODE_8181_length_928_cov_35.226779	326	406	2	62	80	0.7750000
NODE_8181_length_928_cov_35.226779	402	482	0	75	80	0.9375000
NODE_8181_length_928_cov_35.226779	402	482	2	5	80	0.0625000
NODE_8181_length_928_cov_35.226779	455	535	0	22	80	0.2750000
NODE_8181_length_928_cov_35.226779	455	535	2	58	80	0.7250000
NODE_8182_length_928_cov_25.218335	299	379	0	36	80	0.4500000
NODE_8182_length_928_cov_25.218335	299	379	4	44	80	0.5500000
NODE_8182_length_928_cov_25.218335	352	432	4	80	80	1.0000000
NODE_8183_length_928_cov_22.815440	342	422	0	80	80	1.0000000
NODE_8183_length_928_cov_22.815440	395	475	0	80	80	1.0000000
NODE_8183_length_928_cov_22.815440	471	551	0	17	80	0.2125000
NODE_8183_length_928_cov_22.815440	471	551	2	63	80	0.7875000
NODE_8183_length_928_cov_22.815440	524	604	2	80	80	1.0000000
NODE_8184_length_928_cov_20.718938	365	445	1	14	80	0.1750000
NODE_8184_length_928_cov_20.718938	365	445	3	23	80	0.2875000
NODE_8184_length_928_cov_20.718938	365	445	7	7	80	0.0875000
NODE_8184_length_928_cov_20.718938	365	445	8	26	80	0.3250000
NODE_8184_length_928_cov_20.718938	365	445	9	8	80	0.1000000
NODE_8184_length_928_cov_20.718938	365	445	10	2	80	0.0250000
NODE_8184_length_928_cov_20.718938	418	498	3	5	80	0.0625000
NODE_8184_length_928_cov_20.718938	418	498	4	5	80	0.0625000
NODE_8184_length_928_cov_20.718938	418	498	8	60	80	0.7500000
NODE_8184_length_928_cov_20.718938	418	498	9	8	80	0.1000000
NODE_8184_length_928_cov_20.718938	418	498	10	2	80	0.0250000
NODE_8185_length_928_cov_19.418577	420	500	4	28	80	0.3500000
NODE_8185_length_928_cov_19.418577	420	500	5	1	80	0.0125000
NODE_8185_length_928_cov_19.418577	420	500	6	51	80	0.6375000
NODE_8185_length_928_cov_19.418577	473	553	0	15	80	0.1875000
NODE_8185_length_928_cov_19.418577	473	553	2	35	80	0.4375000
NODE_8185_length_928_cov_19.418577	473	553	4	3	80	0.0375000
NODE_8185_length_928_cov_19.418577	473	553	6	27	80	0.3375000
NODE_8185_length_928_cov_19.418577	549	591	0	42	42	1.0000000
NODE_8186_length_928_cov_13.354644	323	403	0	33	80	0.4125000
NODE_8186_length_928_cov_13.354644	323	403	2	40	80	0.5000000
NODE_8186_length_928_cov_13.354644	323	403	6	7	80	0.0875000
NODE_8186_length_928_cov_13.354644	376	456	2	20	80	0.2500000
NODE_8186_length_928_cov_13.354644	376	456	4	20	80	0.2500000
NODE_8186_length_928_cov_13.354644	376	456	6	40	80	0.5000000
NODE_8187_length_928_cov_13.096502	361	441	1	69	80	0.8625000
NODE_8187_length_928_cov_13.096502	361	441	3	11	80	0.1375000
NODE_8187_length_928_cov_13.096502	414	494	1	16	80	0.2000000
NODE_8187_length_928_cov_13.096502	414	494	2	42	80	0.5250000
NODE_8187_length_928_cov_13.096502	414	494	3	22	80	0.2750000
NODE_8189_length_928_cov_10.399276	447	527	0	80	80	1.0000000
NODE_8189_length_928_cov_10.399276	500	580	0	80	80	1.0000000
NODE_8207_length_927_cov_19.516908	398	478	0	65	80	0.8125000
NODE_8207_length_927_cov_19.516908	398	478	2	15	80	0.1875000
NODE_8207_length_927_cov_19.516908	451	531	0	80	80	1.0000000
NODE_8208_length_927_cov_11.190821	358	438	1	25	80	0.3125000
NODE_8208_length_927_cov_11.190821	358	438	3	55	80	0.6875000
NODE_8208_length_927_cov_11.190821	411	491	0	43	80	0.5375000
NODE_8208_length_927_cov_11.190821	411	491	1	35	80	0.4375000
NODE_8208_length_927_cov_11.190821	411	491	3	2	80	0.0250000
NODE_8209_length_927_cov_8.123188	239	319	0	53	80	0.6625000
NODE_8209_length_927_cov_8.123188	239	319	2	27	80	0.3375000
NODE_8209_length_927_cov_8.123188	292	372	0	80	80	1.0000000
NODE_8210_length_927_cov_4.585749	515	595	0	63	80	0.7875000
NODE_8210_length_927_cov_4.585749	515	595	2	17	80	0.2125000
NODE_8210_length_927_cov_4.585749	568	648	0	80	80	1.0000000
NODE_8222_length_927_cov_1.250000	626	706	0	80	80	1.0000000
NODE_8222_length_927_cov_1.250000	679	759	0	80	80	1.0000000
NODE_8227_length_926_cov_78.382104	433	513	0	80	80	1.0000000
NODE_8227_length_926_cov_78.382104	486	566	0	80	80	1.0000000
NODE_8228_length_926_cov_44.385732	383	463	0	1	80	0.0125000
NODE_8228_length_926_cov_44.385732	383	463	1	79	80	0.9875000
NODE_8228_length_926_cov_44.385732	436	516	0	54	80	0.6750000
NODE_8228_length_926_cov_44.385732	436	516	1	26	80	0.3250000
NODE_8229_length_926_cov_43.446191	362	442	0	80	80	1.0000000
NODE_8229_length_926_cov_43.446191	415	495	0	38	80	0.4750000
NODE_8229_length_926_cov_43.446191	415	495	2	10	80	0.1250000
NODE_8229_length_926_cov_43.446191	415	495	4	32	80	0.4000000
NODE_8229_length_926_cov_43.446191	491	571	2	36	80	0.4500000
NODE_8229_length_926_cov_43.446191	491	571	4	44	80	0.5500000
NODE_8229_length_926_cov_43.446191	544	624	0	50	80	0.6250000
NODE_8229_length_926_cov_43.446191	544	624	2	30	80	0.3750000
NODE_8230_length_926_cov_40.163241	42	61	0	12	19	0.6315789
NODE_8230_length_926_cov_40.163241	42	61	2	7	19	0.3684210
NODE_8230_length_926_cov_40.163241	279	359	0	60	80	0.7500000
NODE_8230_length_926_cov_40.163241	279	359	6	20	80	0.2500000
NODE_8230_length_926_cov_40.163241	332	412	0	7	80	0.0875000
NODE_8230_length_926_cov_40.163241	332	412	6	73	80	0.9125000
NODE_8230_length_926_cov_40.163241	408	488	0	67	80	0.8375000
NODE_8230_length_926_cov_40.163241	408	488	6	13	80	0.1625000
NODE_8230_length_926_cov_40.163241	461	541	0	80	80	1.0000000
NODE_8231_length_926_cov_29.923821	372	452	0	21	80	0.2625000
NODE_8231_length_926_cov_29.923821	372	452	2	59	80	0.7375000
NODE_8231_length_926_cov_29.923821	425	505	0	62	80	0.7750000
NODE_8231_length_926_cov_29.923821	425	505	2	18	80	0.2250000
NODE_8232_length_926_cov_24.657799	350	430	2	51	80	0.6375000
NODE_8232_length_926_cov_24.657799	350	430	4	29	80	0.3625000
NODE_8232_length_926_cov_24.657799	403	483	0	21	80	0.2625000
NODE_8232_length_926_cov_24.657799	403	483	2	20	80	0.2500000
NODE_8232_length_926_cov_24.657799	403	483	4	39	80	0.4875000
NODE_8233_length_926_cov_17.438936	360	440	1	23	80	0.2875000
NODE_8233_length_926_cov_17.438936	360	440	2	14	80	0.1750000
NODE_8233_length_926_cov_17.438936	360	440	4	43	80	0.5375000
NODE_8233_length_926_cov_17.438936	413	493	0	17	80	0.2125000
NODE_8233_length_926_cov_17.438936	413	493	1	59	80	0.7375000
NODE_8233_length_926_cov_17.438936	413	493	2	4	80	0.0500000
NODE_8234_length_926_cov_12.413543	418	491	0	73	73	1.0000000
NODE_8234_length_926_cov_12.413543	464	544	0	80	80	1.0000000
NODE_8235_length_926_cov_5.771463	453	533	0	80	80	1.0000000
NODE_8235_length_926_cov_5.771463	505	586	0	81	81	1.0000000
NODE_8236_length_926_cov_5.209190	435	515	4	80	80	1.0000000
NODE_8236_length_926_cov_5.209190	488	568	0	53	80	0.6625000
NODE_8236_length_926_cov_5.209190	488	568	4	27	80	0.3375000
NODE_8247_length_925_cov_40.767554	514	594	0	80	80	1.0000000
NODE_8247_length_925_cov_40.767554	567	647	0	80	80	1.0000000
NODE_8248_length_925_cov_30.226392	262	342	0	80	80	1.0000000
NODE_8248_length_925_cov_30.226392	315	395	0	80	80	1.0000000
NODE_8248_length_925_cov_30.226392	391	471	0	80	80	1.0000000
NODE_8248_length_925_cov_30.226392	444	524	0	80	80	1.0000000
NODE_8249_length_925_cov_22.075061	334	414	9	26	80	0.3250000
NODE_8249_length_925_cov_22.075061	334	414	10	6	80	0.0750000
NODE_8249_length_925_cov_22.075061	334	414	14	36	80	0.4500000
NODE_8249_length_925_cov_22.075061	334	414	18	12	80	0.1500000
NODE_8249_length_925_cov_22.075061	387	467	9	33	80	0.4125000
NODE_8249_length_925_cov_22.075061	387	467	12	1	80	0.0125000
NODE_8249_length_925_cov_22.075061	387	467	13	16	80	0.2000000
NODE_8249_length_925_cov_22.075061	387	467	14	18	80	0.2250000
NODE_8249_length_925_cov_22.075061	387	467	18	12	80	0.1500000
NODE_8250_length_925_cov_18.164649	410	490	0	80	80	1.0000000
NODE_8250_length_925_cov_18.164649	464	543	0	79	79	1.0000000
NODE_8251_length_925_cov_14.067797	472	548	0	76	76	1.0000000
NODE_8251_length_925_cov_14.067797	525	601	0	76	76	1.0000000
NODE_8252_length_925_cov_7.098063	418	498	0	23	80	0.2875000
NODE_8252_length_925_cov_7.098063	418	498	2	57	80	0.7125000
NODE_8252_length_925_cov_7.098063	471	551	0	17	80	0.2125000
NODE_8252_length_925_cov_7.098063	471	551	2	52	80	0.6500000
NODE_8252_length_925_cov_7.098063	471	551	24	11	80	0.1375000
NODE_8266_length_924_cov_61.292121	397	477	0	80	80	1.0000000
NODE_8266_length_924_cov_61.292121	450	530	0	80	80	1.0000000
NODE_8267_length_924_cov_31.522424	375	455	0	80	80	1.0000000
NODE_8267_length_924_cov_31.522424	428	508	0	80	80	1.0000000
NODE_8268_length_924_cov_30.446061	299	379	0	80	80	1.0000000
NODE_8268_length_924_cov_30.446061	352	432	0	80	80	1.0000000
NODE_8268_length_924_cov_30.446061	428	508	0	80	80	1.0000000
NODE_8268_length_924_cov_30.446061	481	561	0	80	80	1.0000000
NODE_8269_length_924_cov_28.877576	542	622	0	80	80	1.0000000
NODE_8269_length_924_cov_28.877576	595	675	0	80	80	1.0000000
NODE_8270_length_924_cov_27.261818	506	586	0	80	80	1.0000000
NODE_8270_length_924_cov_27.261818	559	639	0	80	80	1.0000000
NODE_8271_length_924_cov_25.946667	371	451	0	80	80	1.0000000
NODE_8271_length_924_cov_25.946667	424	504	0	71	80	0.8875000
NODE_8271_length_924_cov_25.946667	424	504	7	9	80	0.1125000
NODE_8271_length_924_cov_25.946667	500	580	7	48	80	0.6000000
NODE_8271_length_924_cov_25.946667	500	580	11	32	80	0.4000000
NODE_8271_length_924_cov_25.946667	553	633	3	48	80	0.6000000
NODE_8271_length_924_cov_25.946667	553	633	10	3	80	0.0375000
NODE_8271_length_924_cov_25.946667	553	633	11	29	80	0.3625000
NODE_8272_length_924_cov_25.113939	305	385	10	78	80	0.9750000
NODE_8272_length_924_cov_25.113939	305	385	12	2	80	0.0250000
NODE_8272_length_924_cov_25.113939	358	438	0	1	80	0.0125000
NODE_8272_length_924_cov_25.113939	358	438	5	5	80	0.0625000
NODE_8272_length_924_cov_25.113939	358	438	6	18	80	0.2250000
NODE_8272_length_924_cov_25.113939	358	438	10	56	80	0.7000000
NODE_8272_length_924_cov_25.113939	434	514	0	7	80	0.0875000
NODE_8272_length_924_cov_25.113939	434	514	6	73	80	0.9125000
NODE_8272_length_924_cov_25.113939	487	567	0	60	80	0.7500000
NODE_8272_length_924_cov_25.113939	487	567	6	20	80	0.2500000
NODE_8273_length_924_cov_16.343030	481	561	0	80	80	1.0000000
NODE_8273_length_924_cov_16.343030	534	614	0	80	80	1.0000000
NODE_8274_length_924_cov_14.793939	299	379	0	80	80	1.0000000
NODE_8274_length_924_cov_14.793939	352	432	0	46	80	0.5750000
NODE_8274_length_924_cov_14.793939	352	432	4	34	80	0.4250000
NODE_8275_length_924_cov_14.209697	485	562	0	5	77	0.0649351
NODE_8275_length_924_cov_14.209697	485	562	6	6	77	0.0779221
NODE_8275_length_924_cov_14.209697	485	562	8	66	77	0.8571429
NODE_8275_length_924_cov_14.209697	535	615	0	58	80	0.7250000
NODE_8275_length_924_cov_14.209697	535	615	6	6	80	0.0750000
NODE_8275_length_924_cov_14.209697	535	615	8	16	80	0.2000000
NODE_8276_length_924_cov_13.423030	287	367	0	80	80	1.0000000
NODE_8276_length_924_cov_13.423030	340	420	0	80	80	1.0000000
NODE_8277_length_924_cov_12.008485	237	307	0	70	70	1.0000000
NODE_8279_length_924_cov_8.619394	560	640	0	80	80	1.0000000
NODE_8279_length_924_cov_8.619394	613	693	0	80	80	1.0000000
NODE_8280_length_924_cov_4.640000	426	506	0	80	80	1.0000000
NODE_8280_length_924_cov_4.640000	479	559	0	80	80	1.0000000
NODE_8290_length_924_cov_1.467879	352	381	0	29	29	1.0000000
NODE_8296_length_924_cov_0.648485	830	890	0	60	60	1.0000000
NODE_8296_length_924_cov_0.648485	863	924	0	61	61	1.0000000
NODE_8297_length_923_cov_43.213592	371	451	0	80	80	1.0000000
NODE_8297_length_923_cov_43.213592	424	504	0	80	80	1.0000000
NODE_8297_length_923_cov_43.213592	500	580	0	80	80	1.0000000
NODE_8297_length_923_cov_43.213592	553	633	0	80	80	1.0000000
NODE_8298_length_923_cov_34.108010	370	450	0	51	80	0.6375000
NODE_8298_length_923_cov_34.108010	370	450	6	20	80	0.2500000
NODE_8298_length_923_cov_34.108010	370	450	8	9	80	0.1125000
NODE_8298_length_923_cov_34.108010	423	503	6	18	80	0.2250000
NODE_8298_length_923_cov_34.108010	423	503	8	62	80	0.7750000
NODE_8299_length_923_cov_29.163835	392	472	0	43	80	0.5375000
NODE_8299_length_923_cov_29.163835	392	472	3	1	80	0.0125000
NODE_8299_length_923_cov_29.163835	392	472	4	36	80	0.4500000
NODE_8299_length_923_cov_29.163835	445	525	4	80	80	1.0000000
NODE_8300_length_923_cov_19.139563	375	455	0	55	80	0.6875000
NODE_8300_length_923_cov_19.139563	375	455	2	25	80	0.3125000
NODE_8300_length_923_cov_19.139563	428	508	0	2	80	0.0250000
NODE_8300_length_923_cov_19.139563	428	508	2	78	80	0.9750000
NODE_8301_length_923_cov_17.433252	512	592	0	80	80	1.0000000
NODE_8301_length_923_cov_17.433252	565	645	0	80	80	1.0000000
NODE_8302_length_923_cov_16.597087	279	359	0	42	80	0.5250000
NODE_8302_length_923_cov_16.597087	279	359	1	38	80	0.4750000
NODE_8302_length_923_cov_16.597087	332	412	1	55	80	0.6875000
NODE_8302_length_923_cov_16.597087	332	412	2	25	80	0.3125000
NODE_8303_length_923_cov_15.229369	446	526	0	80	80	1.0000000
NODE_8303_length_923_cov_15.229369	499	579	0	79	80	0.9875000
NODE_8303_length_923_cov_15.229369	499	579	2	1	80	0.0125000
NODE_8304_length_923_cov_14.007282	304	349	5	43	45	0.9555556
NODE_8304_length_923_cov_14.007282	304	349	6	2	45	0.0444444
NODE_8304_length_923_cov_14.007282	345	427	0	50	82	0.6097561
NODE_8304_length_923_cov_14.007282	345	427	5	32	82	0.3902439
NODE_8304_length_923_cov_14.007282	397	480	0	83	83	1.0000000
NODE_8305_length_923_cov_6.500000	308	388	10	40	80	0.5000000
NODE_8305_length_923_cov_6.500000	308	388	11	40	80	0.5000000
NODE_8305_length_923_cov_6.500000	361	441	0	6	80	0.0750000
NODE_8305_length_923_cov_6.500000	361	441	9	1	80	0.0125000
NODE_8305_length_923_cov_6.500000	361	441	10	32	80	0.4000000
NODE_8305_length_923_cov_6.500000	361	441	11	41	80	0.5125000
NODE_8307_length_923_cov_6.115291	447	527	0	80	80	1.0000000
NODE_8307_length_923_cov_6.115291	500	580	0	80	80	1.0000000
NODE_8308_length_923_cov_5.351942	363	445	0	82	82	1.0000000
NODE_8308_length_923_cov_5.351942	365	445	0	80	80	1.0000000
NODE_8317_length_923_cov_1.059466	63	143	0	36	80	0.4500000
NODE_8317_length_923_cov_1.059466	63	143	2	44	80	0.5500000
NODE_8320_length_922_cov_40.331713	243	289	103	2	46	0.0434783
NODE_8320_length_922_cov_40.331713	243	289	104	1	46	0.0217391
NODE_8320_length_922_cov_40.331713	243	289	106	1	46	0.0217391
NODE_8320_length_922_cov_40.331713	243	289	108	3	46	0.0652174
NODE_8320_length_922_cov_40.331713	243	289	110	5	46	0.1086956
NODE_8320_length_922_cov_40.331713	243	289	111	2	46	0.0434783
NODE_8320_length_922_cov_40.331713	243	289	112	1	46	0.0217391
NODE_8320_length_922_cov_40.331713	243	289	113	2	46	0.0434783
NODE_8320_length_922_cov_40.331713	243	289	114	2	46	0.0434783
NODE_8320_length_922_cov_40.331713	243	289	115	1	46	0.0217391
NODE_8320_length_922_cov_40.331713	243	289	117	3	46	0.0652174
NODE_8320_length_922_cov_40.331713	243	289	119	1	46	0.0217391
NODE_8320_length_922_cov_40.331713	243	289	120	1	46	0.0217391
NODE_8320_length_922_cov_40.331713	243	289	121	1	46	0.0217391
NODE_8320_length_922_cov_40.331713	243	289	122	1	46	0.0217391
NODE_8320_length_922_cov_40.331713	243	289	123	1	46	0.0217391
NODE_8320_length_922_cov_40.331713	243	289	124	1	46	0.0217391
NODE_8320_length_922_cov_40.331713	243	289	128	1	46	0.0217391
NODE_8320_length_922_cov_40.331713	243	289	131	1	46	0.0217391
NODE_8320_length_922_cov_40.331713	243	289	133	1	46	0.0217391
NODE_8320_length_922_cov_40.331713	243	289	135	2	46	0.0434783
NODE_8320_length_922_cov_40.331713	243	289	137	1	46	0.0217391
NODE_8320_length_922_cov_40.331713	243	289	140	1	46	0.0217391
NODE_8320_length_922_cov_40.331713	243	289	141	1	46	0.0217391
NODE_8320_length_922_cov_40.331713	243	289	145	1	46	0.0217391
NODE_8320_length_922_cov_40.331713	243	289	146	4	46	0.0869565
NODE_8320_length_922_cov_40.331713	243	289	148	4	46	0.0869565
NODE_8320_length_922_cov_40.331713	262	342	103	2	80	0.0250000
NODE_8320_length_922_cov_40.331713	262	342	104	1	80	0.0125000
NODE_8320_length_922_cov_40.331713	262	342	106	1	80	0.0125000
NODE_8320_length_922_cov_40.331713	262	342	108	3	80	0.0375000
NODE_8320_length_922_cov_40.331713	262	342	110	5	80	0.0625000
NODE_8320_length_922_cov_40.331713	262	342	111	2	80	0.0250000
NODE_8320_length_922_cov_40.331713	262	342	112	1	80	0.0125000
NODE_8320_length_922_cov_40.331713	262	342	113	2	80	0.0250000
NODE_8320_length_922_cov_40.331713	262	342	114	2	80	0.0250000
NODE_8320_length_922_cov_40.331713	262	342	115	1	80	0.0125000
NODE_8320_length_922_cov_40.331713	262	342	117	1	80	0.0125000
NODE_8320_length_922_cov_40.331713	262	342	123	1	80	0.0125000
NODE_8320_length_922_cov_40.331713	262	342	124	1	80	0.0125000
NODE_8320_length_922_cov_40.331713	262	342	137	1	80	0.0125000
NODE_8320_length_922_cov_40.331713	262	342	145	2	80	0.0250000
NODE_8320_length_922_cov_40.331713	262	342	146	2	80	0.0250000
NODE_8320_length_922_cov_40.331713	262	342	148	1	80	0.0125000
NODE_8320_length_922_cov_40.331713	262	342	162	1	80	0.0125000
NODE_8320_length_922_cov_40.331713	262	342	164	1	80	0.0125000
NODE_8320_length_922_cov_40.331713	262	342	165	1	80	0.0125000
NODE_8320_length_922_cov_40.331713	262	342	166	2	80	0.0250000
NODE_8320_length_922_cov_40.331713	262	342	167	1	80	0.0125000
NODE_8320_length_922_cov_40.331713	262	342	176	4	80	0.0500000
NODE_8320_length_922_cov_40.331713	262	342	188	1	80	0.0125000
NODE_8320_length_922_cov_40.331713	262	342	189	4	80	0.0500000
NODE_8320_length_922_cov_40.331713	262	342	191	2	80	0.0250000
NODE_8320_length_922_cov_40.331713	262	342	203	1	80	0.0125000
NODE_8320_length_922_cov_40.331713	262	342	213	2	80	0.0250000
NODE_8320_length_922_cov_40.331713	262	342	226	2	80	0.0250000
NODE_8320_length_922_cov_40.331713	262	342	227	1	80	0.0125000
NODE_8320_length_922_cov_40.331713	262	342	230	2	80	0.0250000
NODE_8320_length_922_cov_40.331713	262	342	231	2	80	0.0250000
NODE_8320_length_922_cov_40.331713	262	342	232	1	80	0.0125000
NODE_8320_length_922_cov_40.331713	262	342	236	1	80	0.0125000
NODE_8320_length_922_cov_40.331713	262	342	240	1	80	0.0125000
NODE_8320_length_922_cov_40.331713	262	342	244	1	80	0.0125000
NODE_8320_length_922_cov_40.331713	262	342	246	1	80	0.0125000
NODE_8320_length_922_cov_40.331713	262	342	248	2	80	0.0250000
NODE_8320_length_922_cov_40.331713	262	342	250	1	80	0.0125000
NODE_8320_length_922_cov_40.331713	262	342	253	1	80	0.0125000
NODE_8320_length_922_cov_40.331713	262	342	259	2	80	0.0250000
NODE_8320_length_922_cov_40.331713	262	342	266	1	80	0.0125000
NODE_8320_length_922_cov_40.331713	262	342	269	1	80	0.0125000
NODE_8320_length_922_cov_40.331713	262	342	272	1	80	0.0125000
NODE_8320_length_922_cov_40.331713	262	342	278	1	80	0.0125000
NODE_8320_length_922_cov_40.331713	262	342	280	1	80	0.0125000
NODE_8320_length_922_cov_40.331713	262	342	284	1	80	0.0125000
NODE_8320_length_922_cov_40.331713	262	342	286	1	80	0.0125000
NODE_8320_length_922_cov_40.331713	262	342	290	1	80	0.0125000
NODE_8320_length_922_cov_40.331713	262	342	299	1	80	0.0125000
NODE_8320_length_922_cov_40.331713	262	342	301	1	80	0.0125000
NODE_8320_length_922_cov_40.331713	262	342	303	1	80	0.0125000
NODE_8320_length_922_cov_40.331713	262	342	311	1	80	0.0125000
NODE_8320_length_922_cov_40.331713	262	342	315	1	80	0.0125000
NODE_8320_length_922_cov_40.331713	780	860	14	7	80	0.0875000
NODE_8320_length_922_cov_40.331713	780	860	26	69	80	0.8625000
NODE_8320_length_922_cov_40.331713	780	860	27	2	80	0.0250000
NODE_8320_length_922_cov_40.331713	780	860	28	2	80	0.0250000
NODE_8320_length_922_cov_40.331713	833	913	0	49	80	0.6125000
NODE_8320_length_922_cov_40.331713	833	913	14	11	80	0.1375000
NODE_8320_length_922_cov_40.331713	833	913	26	20	80	0.2500000
NODE_8321_length_922_cov_38.549210	126	177	194	1	51	0.0196078
NODE_8321_length_922_cov_38.549210	126	177	202	1	51	0.0196078
NODE_8321_length_922_cov_38.549210	126	177	212	1	51	0.0196078
NODE_8321_length_922_cov_38.549210	126	177	216	1	51	0.0196078
NODE_8321_length_922_cov_38.549210	126	177	238	1	51	0.0196078
NODE_8321_length_922_cov_38.549210	126	177	240	1	51	0.0196078
NODE_8321_length_922_cov_38.549210	126	177	242	2	51	0.0392157
NODE_8321_length_922_cov_38.549210	126	177	248	1	51	0.0196078
NODE_8321_length_922_cov_38.549210	126	177	262	1	51	0.0196078
NODE_8321_length_922_cov_38.549210	126	177	267	1	51	0.0196078
NODE_8321_length_922_cov_38.549210	126	177	269	1	51	0.0196078
NODE_8321_length_922_cov_38.549210	126	177	280	1	51	0.0196078
NODE_8321_length_922_cov_38.549210	126	177	284	1	51	0.0196078
NODE_8321_length_922_cov_38.549210	126	177	302	1	51	0.0196078
NODE_8321_length_922_cov_38.549210	126	177	310	1	51	0.0196078
NODE_8321_length_922_cov_38.549210	126	177	317	1	51	0.0196078
NODE_8321_length_922_cov_38.549210	126	177	324	1	51	0.0196078
NODE_8321_length_922_cov_38.549210	126	177	327	1	51	0.0196078
NODE_8321_length_922_cov_38.549210	126	177	328	1	51	0.0196078
NODE_8321_length_922_cov_38.549210	126	177	331	1	51	0.0196078
NODE_8321_length_922_cov_38.549210	126	177	333	1	51	0.0196078
NODE_8321_length_922_cov_38.549210	126	177	338	2	51	0.0392157
NODE_8321_length_922_cov_38.549210	126	177	345	1	51	0.0196078
NODE_8321_length_922_cov_38.549210	126	177	347	1	51	0.0196078
NODE_8321_length_922_cov_38.549210	126	177	350	1	51	0.0196078
NODE_8321_length_922_cov_38.549210	126	177	358	1	51	0.0196078
NODE_8321_length_922_cov_38.549210	126	177	360	1	51	0.0196078
NODE_8321_length_922_cov_38.549210	126	177	364	1	51	0.0196078
NODE_8321_length_922_cov_38.549210	126	177	367	1	51	0.0196078
NODE_8321_length_922_cov_38.549210	126	177	377	2	51	0.0392157
NODE_8321_length_922_cov_38.549210	126	177	384	1	51	0.0196078
NODE_8321_length_922_cov_38.549210	126	177	401	4	51	0.0784314
NODE_8321_length_922_cov_38.549210	126	177	403	3	51	0.0588235
NODE_8321_length_922_cov_38.549210	126	177	404	1	51	0.0196078
NODE_8321_length_922_cov_38.549210	126	177	407	1	51	0.0196078
NODE_8321_length_922_cov_38.549210	126	177	409	1	51	0.0196078
NODE_8321_length_922_cov_38.549210	126	177	413	1	51	0.0196078
NODE_8321_length_922_cov_38.549210	126	177	415	1	51	0.0196078
NODE_8321_length_922_cov_38.549210	126	177	417	1	51	0.0196078
NODE_8321_length_922_cov_38.549210	126	177	419	1	51	0.0196078
NODE_8321_length_922_cov_38.549210	126	177	421	1	51	0.0196078
NODE_8321_length_922_cov_38.549210	126	177	444	1	51	0.0196078
NODE_8321_length_922_cov_38.549210	126	177	450	1	51	0.0196078
NODE_8321_length_922_cov_38.549210	308	383	0	75	75	1.0000000
NODE_8321_length_922_cov_38.549210	356	393	0	37	37	1.0000000
NODE_8321_length_922_cov_38.549210	818	898	0	80	80	1.0000000
NODE_8321_length_922_cov_38.549210	871	908	0	37	37	1.0000000
NODE_8322_length_922_cov_35.041312	385	465	0	80	80	1.0000000
NODE_8322_length_922_cov_35.041312	438	518	0	80	80	1.0000000
NODE_8323_length_922_cov_30.749696	426	506	0	21	80	0.2625000
NODE_8323_length_922_cov_30.749696	426	506	2	59	80	0.7375000
NODE_8323_length_922_cov_30.749696	479	559	0	74	80	0.9250000
NODE_8323_length_922_cov_30.749696	479	559	2	6	80	0.0750000
NODE_8324_length_922_cov_25.558931	291	370	0	40	79	0.5063291
NODE_8324_length_922_cov_25.558931	291	370	2	31	79	0.3924051
NODE_8324_length_922_cov_25.558931	291	370	4	8	79	0.1012658
NODE_8324_length_922_cov_25.558931	344	423	0	79	79	1.0000000
NODE_8325_length_922_cov_25.527339	391	471	0	80	80	1.0000000
NODE_8325_length_922_cov_25.527339	444	524	0	80	80	1.0000000
NODE_8326_length_922_cov_23.630620	224	304	0	9	80	0.1125000
NODE_8326_length_922_cov_23.630620	224	304	2	71	80	0.8875000
NODE_8326_length_922_cov_23.630620	277	357	0	62	80	0.7750000
NODE_8326_length_922_cov_23.630620	277	357	2	18	80	0.2250000
NODE_8326_length_922_cov_23.630620	353	433	0	80	80	1.0000000
NODE_8326_length_922_cov_23.630620	406	486	0	80	80	1.0000000
NODE_8327_length_922_cov_22.388821	465	545	0	80	80	1.0000000
NODE_8327_length_922_cov_22.388821	518	598	0	80	80	1.0000000
NODE_8328_length_922_cov_20.320778	421	501	0	60	80	0.7500000
NODE_8328_length_922_cov_20.320778	421	501	2	20	80	0.2500000
NODE_8328_length_922_cov_20.320778	474	554	0	7	80	0.0875000
NODE_8328_length_922_cov_20.320778	474	554	2	26	80	0.3250000
NODE_8328_length_922_cov_20.320778	474	554	4	47	80	0.5875000
NODE_8329_length_922_cov_17.645200	413	479	2	41	66	0.6212121
NODE_8329_length_922_cov_17.645200	413	479	4	25	66	0.3787879
NODE_8330_length_922_cov_12.574727	454	534	0	49	80	0.6125000
NODE_8330_length_922_cov_12.574727	454	534	10	9	80	0.1125000
NODE_8330_length_922_cov_12.574727	454	534	20	22	80	0.2750000
NODE_8330_length_922_cov_12.574727	507	587	10	5	80	0.0625000
NODE_8330_length_922_cov_12.574727	507	587	20	75	80	0.9375000
NODE_8331_length_922_cov_11.934386	255	335	0	38	80	0.4750000
NODE_8331_length_922_cov_11.934386	255	335	4	42	80	0.5250000
NODE_8331_length_922_cov_11.934386	308	388	0	80	80	1.0000000
NODE_8332_length_922_cov_11.068044	423	503	0	80	80	1.0000000
NODE_8332_length_922_cov_11.068044	476	557	0	81	81	1.0000000
NODE_8333_length_922_cov_7.907655	441	521	0	69	80	0.8625000
NODE_8333_length_922_cov_7.907655	441	521	1	11	80	0.1375000
NODE_8333_length_922_cov_7.907655	494	574	0	16	80	0.2000000
NODE_8333_length_922_cov_7.907655	494	574	1	56	80	0.7000000
NODE_8333_length_922_cov_7.907655	494	574	2	8	80	0.1000000
NODE_8334_length_922_cov_7.737546	463	543	0	80	80	1.0000000
NODE_8334_length_922_cov_7.737546	516	596	0	38	80	0.4750000
NODE_8334_length_922_cov_7.737546	516	596	2	42	80	0.5250000
NODE_8335_length_922_cov_7.241798	298	378	0	80	80	1.0000000
NODE_8335_length_922_cov_7.241798	351	431	0	80	80	1.0000000
NODE_8347_length_921_cov_21.317518	457	537	0	22	80	0.2750000
NODE_8347_length_921_cov_21.317518	457	537	6	58	80	0.7250000
NODE_8347_length_921_cov_21.317518	510	590	6	80	80	1.0000000
NODE_8348_length_921_cov_18.462287	519	599	0	69	80	0.8625000
NODE_8348_length_921_cov_18.462287	519	599	2	11	80	0.1375000
NODE_8348_length_921_cov_18.462287	572	652	0	80	80	1.0000000
NODE_8349_length_921_cov_15.440389	373	453	2	80	80	1.0000000
NODE_8349_length_921_cov_15.440389	426	506	0	37	80	0.4625000
NODE_8349_length_921_cov_15.440389	426	506	2	43	80	0.5375000
NODE_8350_length_921_cov_13.216545	465	545	0	31	80	0.3875000
NODE_8350_length_921_cov_13.216545	465	545	4	49	80	0.6125000
NODE_8350_length_921_cov_13.216545	518	598	0	80	80	1.0000000
NODE_8351_length_921_cov_9.283455	399	439	0	40	40	1.0000000
NODE_8351_length_921_cov_9.283455	532	612	0	31	80	0.3875000
NODE_8351_length_921_cov_9.283455	532	612	6	49	80	0.6125000
NODE_8351_length_921_cov_9.283455	585	665	0	80	80	1.0000000
NODE_8352_length_921_cov_8.253041	289	369	0	3	80	0.0375000
NODE_8352_length_921_cov_8.253041	289	369	2	20	80	0.2500000
NODE_8352_length_921_cov_8.253041	289	369	4	57	80	0.7125000
NODE_8352_length_921_cov_8.253041	342	422	0	56	80	0.7000000
NODE_8352_length_921_cov_8.253041	342	422	2	20	80	0.2500000
NODE_8352_length_921_cov_8.253041	342	422	4	4	80	0.0500000
NODE_8364_length_920_cov_47.493301	543	623	2	10	80	0.1250000
NODE_8364_length_920_cov_47.493301	543	623	4	37	80	0.4625000
NODE_8364_length_920_cov_47.493301	543	623	6	33	80	0.4125000
NODE_8364_length_920_cov_47.493301	596	676	0	24	80	0.3000000
NODE_8364_length_920_cov_47.493301	596	676	2	16	80	0.2000000
NODE_8364_length_920_cov_47.493301	596	676	4	29	80	0.3625000
NODE_8364_length_920_cov_47.493301	596	676	6	11	80	0.1375000
NODE_8365_length_920_cov_30.404385	543	623	4	25	80	0.3125000
NODE_8365_length_920_cov_30.404385	543	623	7	21	80	0.2625000
NODE_8365_length_920_cov_30.404385	543	623	8	22	80	0.2750000
NODE_8365_length_920_cov_30.404385	543	623	9	9	80	0.1125000
NODE_8365_length_920_cov_30.404385	543	623	11	3	80	0.0375000
NODE_8365_length_920_cov_30.404385	596	676	4	16	80	0.2000000
NODE_8365_length_920_cov_30.404385	596	676	7	1	80	0.0125000
NODE_8365_length_920_cov_30.404385	596	676	8	63	80	0.7875000
NODE_8366_length_920_cov_25.360536	413	493	4	43	80	0.5375000
NODE_8366_length_920_cov_25.360536	413	493	6	37	80	0.4625000
NODE_8366_length_920_cov_25.360536	466	546	0	36	80	0.4500000
NODE_8366_length_920_cov_25.360536	466	546	2	7	80	0.0875000
NODE_8366_length_920_cov_25.360536	466	546	4	22	80	0.2750000
NODE_8366_length_920_cov_25.360536	466	546	6	15	80	0.1875000
NODE_8366_length_920_cov_25.360536	542	615	0	34	73	0.4657534
NODE_8366_length_920_cov_25.360536	542	615	2	39	73	0.5342466
NODE_8366_length_920_cov_25.360536	588	668	0	1	80	0.0125000
NODE_8366_length_920_cov_25.360536	588	668	1	1	80	0.0125000
NODE_8366_length_920_cov_25.360536	588	668	2	78	80	0.9750000
NODE_8367_length_920_cov_24.918392	403	483	2	35	80	0.4375000
NODE_8367_length_920_cov_24.918392	403	483	4	45	80	0.5625000
NODE_8367_length_920_cov_24.918392	456	536	0	52	80	0.6500000
NODE_8367_length_920_cov_24.918392	456	536	2	28	80	0.3500000
NODE_8368_length_920_cov_18.517661	353	433	0	80	80	1.0000000
NODE_8368_length_920_cov_18.517661	406	486	0	80	80	1.0000000
NODE_8369_length_920_cov_17.710110	310	390	2	22	80	0.2750000
NODE_8369_length_920_cov_17.710110	310	390	4	10	80	0.1250000
NODE_8369_length_920_cov_17.710110	310	390	6	48	80	0.6000000
NODE_8369_length_920_cov_17.710110	363	443	0	27	80	0.3375000
NODE_8369_length_920_cov_17.710110	363	443	2	48	80	0.6000000
NODE_8369_length_920_cov_17.710110	363	443	6	5	80	0.0625000
NODE_8370_length_920_cov_15.650426	403	458	0	55	55	1.0000000
NODE_8371_length_920_cov_12.588307	454	534	0	80	80	1.0000000
NODE_8371_length_920_cov_12.588307	507	586	0	31	79	0.3924051
NODE_8371_length_920_cov_12.588307	507	586	1	48	79	0.6075949
NODE_8372_length_920_cov_10.822168	354	434	0	80	80	1.0000000
NODE_8372_length_920_cov_10.822168	407	487	0	80	80	1.0000000
NODE_8374_length_920_cov_8.297199	453	533	0	80	80	1.0000000
NODE_8374_length_920_cov_8.297199	506	583	0	77	77	1.0000000
NODE_8378_length_920_cov_2.992692	501	581	0	80	80	1.0000000
NODE_8378_length_920_cov_2.992692	554	634	0	33	80	0.4125000
NODE_8378_length_920_cov_2.992692	554	634	2	47	80	0.5875000
NODE_8389_length_919_cov_44.813415	338	418	0	80	80	1.0000000
NODE_8389_length_919_cov_44.813415	391	471	0	80	80	1.0000000
NODE_8389_length_919_cov_44.813415	467	547	0	80	80	1.0000000
NODE_8389_length_919_cov_44.813415	520	600	0	80	80	1.0000000
NODE_8390_length_919_cov_37.459756	389	469	0	80	80	1.0000000
NODE_8390_length_919_cov_37.459756	442	522	0	80	80	1.0000000
NODE_8390_length_919_cov_37.459756	518	598	0	80	80	1.0000000
NODE_8390_length_919_cov_37.459756	571	651	0	80	80	1.0000000
NODE_8391_length_919_cov_35.002439	474	554	0	80	80	1.0000000
NODE_8391_length_919_cov_35.002439	527	607	0	80	80	1.0000000
NODE_8392_length_919_cov_29.935366	246	326	0	80	80	1.0000000
NODE_8392_length_919_cov_29.935366	299	379	0	80	80	1.0000000
NODE_8393_length_919_cov_28.190244	470	550	8	4	80	0.0500000
NODE_8393_length_919_cov_28.190244	470	550	10	8	80	0.1000000
NODE_8393_length_919_cov_28.190244	470	550	12	68	80	0.8500000
NODE_8393_length_919_cov_28.190244	523	603	0	18	80	0.2250000
NODE_8393_length_919_cov_28.190244	523	603	4	19	80	0.2375000
NODE_8393_length_919_cov_28.190244	523	603	12	43	80	0.5375000
NODE_8394_length_919_cov_27.119512	454	534	0	80	80	1.0000000
NODE_8394_length_919_cov_27.119512	507	587	0	74	80	0.9250000
NODE_8394_length_919_cov_27.119512	507	587	2	6	80	0.0750000
NODE_8395_length_919_cov_21.836585	545	625	2	10	80	0.1250000
NODE_8395_length_919_cov_21.836585	545	625	4	70	80	0.8750000
NODE_8395_length_919_cov_21.836585	598	677	0	41	79	0.5189874
NODE_8395_length_919_cov_21.836585	598	677	2	21	79	0.2658228
NODE_8395_length_919_cov_21.836585	598	677	4	17	79	0.2151899
NODE_8396_length_919_cov_17.442683	385	465	0	80	80	1.0000000
NODE_8396_length_919_cov_17.442683	438	518	0	80	80	1.0000000
NODE_8397_length_919_cov_16.685366	309	389	0	37	80	0.4625000
NODE_8397_length_919_cov_16.685366	309	389	6	43	80	0.5375000
NODE_8397_length_919_cov_16.685366	362	442	0	80	80	1.0000000
NODE_8398_length_919_cov_14.013415	435	515	0	26	80	0.3250000
NODE_8398_length_919_cov_14.013415	435	515	2	54	80	0.6750000
NODE_8398_length_919_cov_14.013415	488	568	0	28	80	0.3500000
NODE_8398_length_919_cov_14.013415	488	568	2	52	80	0.6500000
NODE_8399_length_919_cov_12.013415	340	420	0	37	80	0.4625000
NODE_8399_length_919_cov_12.013415	340	420	4	43	80	0.5375000
NODE_8399_length_919_cov_12.013415	393	473	0	80	80	1.0000000
NODE_8403_length_919_cov_3.529268	424	504	0	80	80	1.0000000
NODE_8403_length_919_cov_3.529268	477	557	0	80	80	1.0000000
NODE_8404_length_919_cov_3.200000	444	524	0	14	80	0.1750000
NODE_8404_length_919_cov_3.200000	444	524	2	66	80	0.8250000
NODE_8404_length_919_cov_3.200000	497	577	0	7	80	0.0875000
NODE_8404_length_919_cov_3.200000	497	577	1	1	80	0.0125000
NODE_8404_length_919_cov_3.200000	497	577	2	72	80	0.9000000
NODE_8415_length_918_cov_41.115995	387	467	0	6	80	0.0750000
NODE_8415_length_918_cov_41.115995	387	467	2	74	80	0.9250000
NODE_8415_length_918_cov_41.115995	440	520	0	58	80	0.7250000
NODE_8415_length_918_cov_41.115995	440	520	2	22	80	0.2750000
NODE_8416_length_918_cov_37.405372	427	507	0	80	80	1.0000000
NODE_8416_length_918_cov_37.405372	480	560	0	80	80	1.0000000
NODE_8417_length_918_cov_31.559219	289	369	11	2	80	0.0250000
NODE_8417_length_918_cov_31.559219	289	369	12	12	80	0.1500000
NODE_8417_length_918_cov_31.559219	289	369	14	26	80	0.3250000
NODE_8417_length_918_cov_31.559219	289	369	16	40	80	0.5000000
NODE_8417_length_918_cov_31.559219	342	422	6	20	80	0.2500000
NODE_8417_length_918_cov_31.559219	342	422	16	29	80	0.3625000
NODE_8417_length_918_cov_31.559219	342	422	18	31	80	0.3875000
NODE_8417_length_918_cov_31.559219	418	498	0	19	80	0.2375000
NODE_8417_length_918_cov_31.559219	418	498	2	10	80	0.1250000
NODE_8417_length_918_cov_31.559219	418	498	4	15	80	0.1875000
NODE_8417_length_918_cov_31.559219	418	498	6	36	80	0.4500000
NODE_8417_length_918_cov_31.559219	471	551	0	72	80	0.9000000
NODE_8417_length_918_cov_31.559219	471	551	2	8	80	0.1000000
NODE_8418_length_918_cov_25.195360	429	509	2	80	80	1.0000000
NODE_8418_length_918_cov_25.195360	482	562	0	27	80	0.3375000
NODE_8418_length_918_cov_25.195360	482	562	2	53	80	0.6625000
NODE_8420_length_918_cov_10.537241	361	441	0	80	80	1.0000000
NODE_8420_length_918_cov_10.537241	414	492	0	31	78	0.3974359
NODE_8420_length_918_cov_10.537241	414	492	2	47	78	0.6025641
NODE_8421_length_918_cov_9.821734	283	363	1	8	80	0.1000000
NODE_8421_length_918_cov_9.821734	283	363	2	72	80	0.9000000
NODE_8421_length_918_cov_9.821734	336	416	0	48	80	0.6000000
NODE_8421_length_918_cov_9.821734	336	416	1	13	80	0.1625000
NODE_8421_length_918_cov_9.821734	336	416	2	19	80	0.2375000
NODE_8422_length_918_cov_9.714286	365	445	0	27	80	0.3375000
NODE_8422_length_918_cov_9.714286	365	445	2	53	80	0.6625000
NODE_8422_length_918_cov_9.714286	418	498	0	80	80	1.0000000
NODE_8441_length_917_cov_38.845966	405	476	0	71	71	1.0000000
NODE_8441_length_917_cov_38.845966	458	538	0	80	80	1.0000000
NODE_8442_length_917_cov_37.775061	505	585	0	80	80	1.0000000
NODE_8442_length_917_cov_37.775061	558	638	0	80	80	1.0000000
NODE_8443_length_917_cov_33.195599	335	415	0	80	80	1.0000000
NODE_8443_length_917_cov_33.195599	388	468	0	80	80	1.0000000
NODE_8443_length_917_cov_33.195599	464	544	0	80	80	1.0000000
NODE_8443_length_917_cov_33.195599	517	597	0	80	80	1.0000000
NODE_8444_length_917_cov_22.871638	463	543	0	20	80	0.2500000
NODE_8444_length_917_cov_22.871638	463	543	2	18	80	0.2250000
NODE_8444_length_917_cov_22.871638	463	543	4	14	80	0.1750000
NODE_8444_length_917_cov_22.871638	463	543	6	28	80	0.3500000
NODE_8444_length_917_cov_22.871638	516	593	0	12	77	0.1558442
NODE_8444_length_917_cov_22.871638	516	593	2	11	77	0.1428571
NODE_8444_length_917_cov_22.871638	516	593	4	4	77	0.0519481
NODE_8444_length_917_cov_22.871638	516	593	6	50	77	0.6493506
NODE_8445_length_917_cov_16.899756	321	401	2	12	80	0.1500000
NODE_8445_length_917_cov_16.899756	321	401	10	7	80	0.0875000
NODE_8445_length_917_cov_16.899756	321	401	12	61	80	0.7625000
NODE_8445_length_917_cov_16.899756	374	454	0	32	80	0.4000000
NODE_8445_length_917_cov_16.899756	374	454	10	28	80	0.3500000
NODE_8445_length_917_cov_16.899756	374	454	12	20	80	0.2500000
NODE_8446_length_917_cov_12.283619	397	477	0	34	80	0.4250000
NODE_8446_length_917_cov_12.283619	397	477	4	46	80	0.5750000
NODE_8446_length_917_cov_12.283619	450	530	4	80	80	1.0000000
NODE_8447_length_917_cov_12.172372	380	460	0	73	80	0.9125000
NODE_8447_length_917_cov_12.172372	380	460	2	7	80	0.0875000
NODE_8447_length_917_cov_12.172372	433	513	0	20	80	0.2500000
NODE_8447_length_917_cov_12.172372	433	513	2	60	80	0.7500000
NODE_8447_length_917_cov_12.172372	545	597	2	52	52	1.0000000
NODE_8448_length_917_cov_8.277506	564	644	0	31	80	0.3875000
NODE_8448_length_917_cov_8.277506	564	644	4	30	80	0.3750000
NODE_8448_length_917_cov_8.277506	564	644	8	19	80	0.2375000
NODE_8448_length_917_cov_8.277506	617	697	0	80	80	1.0000000
NODE_8449_length_917_cov_8.145477	155	235	0	80	80	1.0000000
NODE_8449_length_917_cov_8.145477	208	288	0	80	80	1.0000000
NODE_8451_length_917_cov_6.073350	366	446	0	65	80	0.8125000
NODE_8451_length_917_cov_6.073350	366	446	2	15	80	0.1875000
NODE_8451_length_917_cov_6.073350	419	499	0	15	80	0.1875000
NODE_8451_length_917_cov_6.073350	419	499	2	65	80	0.8125000
NODE_8463_length_916_cov_32.867809	347	427	0	16	80	0.2000000
NODE_8463_length_916_cov_32.867809	347	427	2	1	80	0.0125000
NODE_8463_length_916_cov_32.867809	347	427	3	18	80	0.2250000
NODE_8463_length_916_cov_32.867809	347	427	4	45	80	0.5625000
NODE_8463_length_916_cov_32.867809	400	480	0	42	80	0.5250000
NODE_8463_length_916_cov_32.867809	400	480	4	38	80	0.4750000
NODE_8464_length_916_cov_27.673195	450	530	0	35	80	0.4375000
NODE_8464_length_916_cov_27.673195	450	530	1	9	80	0.1125000
NODE_8464_length_916_cov_27.673195	450	530	2	18	80	0.2250000
NODE_8464_length_916_cov_27.673195	450	530	4	8	80	0.1000000
NODE_8464_length_916_cov_27.673195	450	530	8	4	80	0.0500000
NODE_8464_length_916_cov_27.673195	450	530	9	6	80	0.0750000
NODE_8464_length_916_cov_27.673195	503	583	2	9	80	0.1125000
NODE_8464_length_916_cov_27.673195	503	583	4	8	80	0.1000000
NODE_8464_length_916_cov_27.673195	503	583	7	7	80	0.0875000
NODE_8464_length_916_cov_27.673195	503	583	8	4	80	0.0500000
NODE_8464_length_916_cov_27.673195	503	583	9	52	80	0.6500000
NODE_8465_length_916_cov_27.146879	223	303	0	80	80	1.0000000
NODE_8465_length_916_cov_27.146879	276	356	0	80	80	1.0000000
NODE_8466_length_916_cov_25.604651	398	478	1	14	80	0.1750000
NODE_8466_length_916_cov_25.604651	398	478	5	13	80	0.1625000
NODE_8466_length_916_cov_25.604651	398	478	6	32	80	0.4000000
NODE_8466_length_916_cov_25.604651	398	478	10	21	80	0.2625000
NODE_8466_length_916_cov_25.604651	451	531	0	39	80	0.4875000
NODE_8466_length_916_cov_25.604651	451	531	1	28	80	0.3500000
NODE_8466_length_916_cov_25.604651	451	531	5	13	80	0.1625000
NODE_8467_length_916_cov_18.035496	456	536	0	41	80	0.5125000
NODE_8467_length_916_cov_18.035496	456	536	2	39	80	0.4875000
NODE_8467_length_916_cov_18.035496	509	589	0	20	80	0.2500000
NODE_8467_length_916_cov_18.035496	509	589	2	60	80	0.7500000
NODE_8468_length_916_cov_12.651163	500	580	0	27	80	0.3375000
NODE_8468_length_916_cov_12.651163	500	580	4	53	80	0.6625000
NODE_8468_length_916_cov_12.651163	553	633	0	24	80	0.3000000
NODE_8468_length_916_cov_12.651163	553	633	4	56	80	0.7000000
NODE_8469_length_916_cov_11.337821	530	610	0	39	80	0.4875000
NODE_8469_length_916_cov_11.337821	530	610	2	41	80	0.5125000
NODE_8469_length_916_cov_11.337821	583	663	0	80	80	1.0000000
NODE_8470_length_916_cov_9.640147	293	373	0	80	80	1.0000000
NODE_8470_length_916_cov_9.640147	346	426	0	80	80	1.0000000
NODE_8472_length_916_cov_8.042840	426	506	0	80	80	1.0000000
NODE_8472_length_916_cov_8.042840	479	559	0	80	80	1.0000000
NODE_8473_length_916_cov_7.123623	785	847	17	4	62	0.0645161
NODE_8473_length_916_cov_7.123623	785	847	19	2	62	0.0322581
NODE_8473_length_916_cov_7.123623	785	847	23	2	62	0.0322581
NODE_8473_length_916_cov_7.123623	785	847	34	1	62	0.0161290
NODE_8473_length_916_cov_7.123623	785	847	36	3	62	0.0483871
NODE_8473_length_916_cov_7.123623	785	847	40	2	62	0.0322581
NODE_8473_length_916_cov_7.123623	785	847	46	6	62	0.0967742
NODE_8473_length_916_cov_7.123623	785	847	50	2	62	0.0322581
NODE_8473_length_916_cov_7.123623	785	847	54	40	62	0.6451613
NODE_8473_length_916_cov_7.123623	820	900	44	4	80	0.0500000
NODE_8473_length_916_cov_7.123623	820	900	46	1	80	0.0125000
NODE_8473_length_916_cov_7.123623	820	900	50	6	80	0.0750000
NODE_8473_length_916_cov_7.123623	820	900	54	69	80	0.8625000
NODE_8481_length_915_cov_59.289216	398	478	0	11	80	0.1375000
NODE_8481_length_915_cov_59.289216	398	478	1	14	80	0.1750000
NODE_8481_length_915_cov_59.289216	398	478	2	55	80	0.6875000
NODE_8481_length_915_cov_59.289216	451	531	0	64	80	0.8000000
NODE_8481_length_915_cov_59.289216	451	531	1	14	80	0.1750000
NODE_8481_length_915_cov_59.289216	451	531	2	2	80	0.0250000
NODE_8481_length_915_cov_59.289216	527	607	0	11	80	0.1375000
NODE_8481_length_915_cov_59.289216	527	607	2	1	80	0.0125000
NODE_8481_length_915_cov_59.289216	527	607	4	61	80	0.7625000
NODE_8481_length_915_cov_59.289216	527	607	8	7	80	0.0875000
NODE_8481_length_915_cov_59.289216	580	660	4	53	80	0.6625000
NODE_8481_length_915_cov_59.289216	580	660	6	16	80	0.2000000
NODE_8481_length_915_cov_59.289216	580	660	8	11	80	0.1375000
NODE_8482_length_915_cov_45.104167	153	228	0	43	75	0.5733333
NODE_8482_length_915_cov_45.104167	153	228	4	32	75	0.4266667
NODE_8482_length_915_cov_45.104167	206	286	4	80	80	1.0000000
NODE_8482_length_915_cov_45.104167	282	362	0	51	80	0.6375000
NODE_8482_length_915_cov_45.104167	282	362	4	29	80	0.3625000
NODE_8482_length_915_cov_45.104167	335	415	0	80	80	1.0000000
NODE_8483_length_915_cov_37.599265	397	477	0	80	80	1.0000000
NODE_8483_length_915_cov_37.599265	450	530	0	80	80	1.0000000
NODE_8485_length_915_cov_20.458333	297	377	2	51	80	0.6375000
NODE_8485_length_915_cov_20.458333	297	377	4	29	80	0.3625000
NODE_8485_length_915_cov_20.458333	350	430	0	6	80	0.0750000
NODE_8485_length_915_cov_20.458333	350	430	2	55	80	0.6875000
NODE_8485_length_915_cov_20.458333	350	430	4	19	80	0.2375000
NODE_8485_length_915_cov_20.458333	426	506	0	80	80	1.0000000
NODE_8485_length_915_cov_20.458333	479	559	0	80	80	1.0000000
NODE_8486_length_915_cov_14.397059	175	255	0	80	80	1.0000000
NODE_8486_length_915_cov_14.397059	228	308	0	80	80	1.0000000
NODE_8487_length_915_cov_8.741422	295	375	0	50	80	0.6250000
NODE_8487_length_915_cov_8.741422	295	375	2	6	80	0.0750000
NODE_8487_length_915_cov_8.741422	295	375	10	2	80	0.0250000
NODE_8487_length_915_cov_8.741422	295	375	12	22	80	0.2750000
NODE_8487_length_915_cov_8.741422	348	428	2	3	80	0.0375000
NODE_8487_length_915_cov_8.741422	348	428	8	15	80	0.1875000
NODE_8487_length_915_cov_8.741422	348	428	10	2	80	0.0250000
NODE_8487_length_915_cov_8.741422	348	428	12	60	80	0.7500000
NODE_8488_length_915_cov_7.719363	823	894	0	71	71	1.0000000
NODE_8488_length_915_cov_7.719363	828	894	0	66	66	1.0000000
NODE_8488_length_915_cov_7.719363	867	915	0	48	48	1.0000000
NODE_8488_length_915_cov_7.719363	867	915	0	48	48	1.0000000
NODE_8488_length_915_cov_7.719363	867	915	0	48	48	1.0000000
NODE_8489_length_915_cov_7.648284	370	450	0	80	80	1.0000000
NODE_8489_length_915_cov_7.648284	423	503	0	79	80	0.9875000
NODE_8489_length_915_cov_7.648284	423	503	2	1	80	0.0125000
NODE_8490_length_915_cov_6.848039	434	514	2	65	80	0.8125000
NODE_8490_length_915_cov_6.848039	434	514	4	15	80	0.1875000
NODE_8490_length_915_cov_6.848039	487	567	0	47	80	0.5875000
NODE_8490_length_915_cov_6.848039	487	567	2	33	80	0.4125000
NODE_8497_length_915_cov_2.011029	24	99	0	75	75	1.0000000
NODE_8505_length_914_cov_89.814724	0	41	9	2	41	0.0487805
NODE_8505_length_914_cov_89.814724	0	41	11	1	41	0.0243902
NODE_8505_length_914_cov_89.814724	0	41	12	3	41	0.0731707
NODE_8505_length_914_cov_89.814724	0	41	14	2	41	0.0487805
NODE_8505_length_914_cov_89.814724	0	41	18	3	41	0.0731707
NODE_8505_length_914_cov_89.814724	0	41	35	2	41	0.0487805
NODE_8505_length_914_cov_89.814724	0	41	42	2	41	0.0487805
NODE_8505_length_914_cov_89.814724	0	41	44	2	41	0.0487805
NODE_8505_length_914_cov_89.814724	0	41	62	1	41	0.0243902
NODE_8505_length_914_cov_89.814724	0	41	66	1	41	0.0243902
NODE_8505_length_914_cov_89.814724	0	41	70	2	41	0.0487805
NODE_8505_length_914_cov_89.814724	0	41	75	1	41	0.0243902
NODE_8505_length_914_cov_89.814724	0	41	76	1	41	0.0243902
NODE_8505_length_914_cov_89.814724	0	41	89	1	41	0.0243902
NODE_8505_length_914_cov_89.814724	0	41	90	1	41	0.0243902
NODE_8505_length_914_cov_89.814724	0	41	94	4	41	0.0975610
NODE_8505_length_914_cov_89.814724	0	41	96	1	41	0.0243902
NODE_8505_length_914_cov_89.814724	0	41	115	2	41	0.0487805
NODE_8505_length_914_cov_89.814724	0	41	119	3	41	0.0731707
NODE_8505_length_914_cov_89.814724	0	41	131	1	41	0.0243902
NODE_8505_length_914_cov_89.814724	0	41	132	1	41	0.0243902
NODE_8505_length_914_cov_89.814724	0	41	139	1	41	0.0243902
NODE_8505_length_914_cov_89.814724	0	41	141	1	41	0.0243902
NODE_8505_length_914_cov_89.814724	0	41	149	2	41	0.0487805
NODE_8505_length_914_cov_89.814724	19	94	70	2	75	0.0266667
NODE_8505_length_914_cov_89.814724	19	94	75	1	75	0.0133333
NODE_8505_length_914_cov_89.814724	19	94	76	1	75	0.0133333
NODE_8505_length_914_cov_89.814724	19	94	89	1	75	0.0133333
NODE_8505_length_914_cov_89.814724	19	94	90	1	75	0.0133333
NODE_8505_length_914_cov_89.814724	19	94	94	4	75	0.0533333
NODE_8505_length_914_cov_89.814724	19	94	96	1	75	0.0133333
NODE_8505_length_914_cov_89.814724	19	94	115	2	75	0.0266667
NODE_8505_length_914_cov_89.814724	19	94	119	3	75	0.0400000
NODE_8505_length_914_cov_89.814724	19	94	131	1	75	0.0133333
NODE_8505_length_914_cov_89.814724	19	94	132	1	75	0.0133333
NODE_8505_length_914_cov_89.814724	19	94	139	1	75	0.0133333
NODE_8505_length_914_cov_89.814724	19	94	141	1	75	0.0133333
NODE_8505_length_914_cov_89.814724	19	94	149	2	75	0.0266667
NODE_8505_length_914_cov_89.814724	19	94	151	1	75	0.0133333
NODE_8505_length_914_cov_89.814724	19	94	152	1	75	0.0133333
NODE_8505_length_914_cov_89.814724	19	94	154	5	75	0.0666667
NODE_8505_length_914_cov_89.814724	19	94	158	11	75	0.1466667
NODE_8505_length_914_cov_89.814724	19	94	160	2	75	0.0266667
NODE_8505_length_914_cov_89.814724	19	94	161	7	75	0.0933333
NODE_8505_length_914_cov_89.814724	19	94	162	12	75	0.1600000
NODE_8505_length_914_cov_89.814724	19	94	165	5	75	0.0666667
NODE_8505_length_914_cov_89.814724	19	94	166	5	75	0.0666667
NODE_8505_length_914_cov_89.814724	19	94	167	4	75	0.0533333
NODE_8506_length_914_cov_33.755828	400	480	0	80	80	1.0000000
NODE_8506_length_914_cov_33.755828	453	533	0	80	80	1.0000000
NODE_8507_length_914_cov_31.557055	368	448	0	80	80	1.0000000
NODE_8507_length_914_cov_31.557055	421	501	0	80	80	1.0000000
NODE_8508_length_914_cov_29.087117	331	411	0	5	80	0.0625000
NODE_8508_length_914_cov_29.087117	331	411	6	26	80	0.3250000
NODE_8508_length_914_cov_29.087117	331	411	8	19	80	0.2375000
NODE_8508_length_914_cov_29.087117	331	411	10	30	80	0.3750000
NODE_8508_length_914_cov_29.087117	384	464	0	58	80	0.7250000
NODE_8508_length_914_cov_29.087117	384	464	6	22	80	0.2750000
NODE_8509_length_914_cov_28.490798	273	353	0	7	80	0.0875000
NODE_8509_length_914_cov_28.490798	273	353	2	10	80	0.1250000
NODE_8509_length_914_cov_28.490798	273	353	4	18	80	0.2250000
NODE_8509_length_914_cov_28.490798	273	353	6	45	80	0.5625000
NODE_8509_length_914_cov_28.490798	326	406	2	37	80	0.4625000
NODE_8509_length_914_cov_28.490798	326	406	4	1	80	0.0125000
NODE_8509_length_914_cov_28.490798	326	406	6	41	80	0.5125000
NODE_8509_length_914_cov_28.490798	326	406	8	1	80	0.0125000
NODE_8509_length_914_cov_28.490798	402	482	2	80	80	1.0000000
NODE_8509_length_914_cov_28.490798	455	535	0	53	80	0.6625000
NODE_8509_length_914_cov_28.490798	455	535	2	27	80	0.3375000
NODE_8510_length_914_cov_25.429448	393	473	4	54	80	0.6750000
NODE_8510_length_914_cov_25.429448	393	473	8	26	80	0.3250000
NODE_8510_length_914_cov_25.429448	446	526	4	48	80	0.6000000
NODE_8510_length_914_cov_25.429448	446	526	5	7	80	0.0875000
NODE_8510_length_914_cov_25.429448	446	526	6	7	80	0.0875000
NODE_8510_length_914_cov_25.429448	446	526	8	18	80	0.2250000
NODE_8510_length_914_cov_25.429448	522	602	4	44	80	0.5500000
NODE_8510_length_914_cov_25.429448	522	602	8	36	80	0.4500000
NODE_8510_length_914_cov_25.429448	575	655	0	33	80	0.4125000
NODE_8510_length_914_cov_25.429448	575	655	2	17	80	0.2125000
NODE_8510_length_914_cov_25.429448	575	655	4	30	80	0.3750000
NODE_8511_length_914_cov_19.111656	354	434	5	26	80	0.3250000
NODE_8511_length_914_cov_19.111656	354	434	9	10	80	0.1250000
NODE_8511_length_914_cov_19.111656	354	434	10	3	80	0.0375000
NODE_8511_length_914_cov_19.111656	354	434	16	41	80	0.5125000
NODE_8511_length_914_cov_19.111656	407	487	9	1	80	0.0125000
NODE_8511_length_914_cov_19.111656	407	487	10	16	80	0.2000000
NODE_8511_length_914_cov_19.111656	407	487	14	4	80	0.0500000
NODE_8511_length_914_cov_19.111656	407	487	15	27	80	0.3375000
NODE_8511_length_914_cov_19.111656	407	487	16	32	80	0.4000000
NODE_8512_length_914_cov_13.423313	603	683	0	80	80	1.0000000
NODE_8512_length_914_cov_13.423313	656	736	0	80	80	1.0000000
NODE_8513_length_914_cov_10.947239	341	411	0	70	70	1.0000000
NODE_8513_length_914_cov_10.947239	384	464	0	80	80	1.0000000
NODE_8518_length_914_cov_1.931288	833	873	0	10	40	0.2500000
NODE_8518_length_914_cov_1.931288	833	873	4	14	40	0.3500000
NODE_8518_length_914_cov_1.931288	833	873	6	16	40	0.4000000
NODE_8526_length_913_cov_49.665848	31	111	16	3	80	0.0375000
NODE_8526_length_913_cov_49.665848	31	111	18	1	80	0.0125000
NODE_8526_length_913_cov_49.665848	31	111	20	22	80	0.2750000
NODE_8526_length_913_cov_49.665848	31	111	24	4	80	0.0500000
NODE_8526_length_913_cov_49.665848	31	111	26	4	80	0.0500000
NODE_8526_length_913_cov_49.665848	31	111	28	22	80	0.2750000
NODE_8526_length_913_cov_49.665848	31	111	29	20	80	0.2500000
NODE_8526_length_913_cov_49.665848	31	111	31	3	80	0.0375000
NODE_8526_length_913_cov_49.665848	31	111	32	1	80	0.0125000
NODE_8526_length_913_cov_49.665848	136	155	17	4	19	0.2105263
NODE_8526_length_913_cov_49.665848	136	155	18	8	19	0.4210526
NODE_8526_length_913_cov_49.665848	136	155	20	7	19	0.3684210
NODE_8527_length_913_cov_47.115479	367	447	0	80	80	1.0000000
NODE_8527_length_913_cov_47.115479	420	500	0	80	80	1.0000000
NODE_8528_length_913_cov_36.541769	502	582	0	80	80	1.0000000
NODE_8528_length_913_cov_36.541769	555	635	0	80	80	1.0000000
NODE_8529_length_913_cov_33.679361	433	513	0	80	80	1.0000000
NODE_8529_length_913_cov_33.679361	486	566	0	80	80	1.0000000
NODE_8530_length_913_cov_29.675676	408	488	0	37	80	0.4625000
NODE_8530_length_913_cov_29.675676	408	488	2	19	80	0.2375000
NODE_8530_length_913_cov_29.675676	408	488	4	24	80	0.3000000
NODE_8530_length_913_cov_29.675676	461	541	2	3	80	0.0375000
NODE_8530_length_913_cov_29.675676	461	541	4	77	80	0.9625000
NODE_8531_length_913_cov_24.901720	342	422	9	23	80	0.2875000
NODE_8531_length_913_cov_24.901720	342	422	10	14	80	0.1750000
NODE_8531_length_913_cov_24.901720	342	422	12	2	80	0.0250000
NODE_8531_length_913_cov_24.901720	342	422	13	20	80	0.2500000
NODE_8531_length_913_cov_24.901720	342	422	14	21	80	0.2625000
NODE_8531_length_913_cov_24.901720	395	475	5	51	80	0.6375000
NODE_8531_length_913_cov_24.901720	395	475	13	22	80	0.2750000
NODE_8531_length_913_cov_24.901720	395	475	14	7	80	0.0875000
NODE_8532_length_913_cov_24.625307	396	476	0	66	80	0.8250000
NODE_8532_length_913_cov_24.625307	396	476	2	14	80	0.1750000
NODE_8532_length_913_cov_24.625307	449	529	0	80	80	1.0000000
NODE_8533_length_913_cov_15.094595	525	589	0	64	64	1.0000000
NODE_8533_length_913_cov_15.094595	562	642	0	80	80	1.0000000
NODE_8534_length_913_cov_8.633907	305	385	0	80	80	1.0000000
NODE_8534_length_913_cov_8.633907	358	429	0	71	71	1.0000000
NODE_8546_length_912_cov_25.110701	419	499	0	80	80	1.0000000
NODE_8546_length_912_cov_25.110701	472	552	0	80	80	1.0000000
NODE_8547_length_912_cov_20.045510	306	386	0	23	80	0.2875000
NODE_8547_length_912_cov_20.045510	306	386	2	3	80	0.0375000
NODE_8547_length_912_cov_20.045510	306	386	7	1	80	0.0125000
NODE_8547_length_912_cov_20.045510	306	386	8	53	80	0.6625000
NODE_8547_length_912_cov_20.045510	359	439	0	8	80	0.1000000
NODE_8547_length_912_cov_20.045510	359	439	2	19	80	0.2375000
NODE_8547_length_912_cov_20.045510	359	439	8	53	80	0.6625000
NODE_8548_length_912_cov_19.635916	326	406	0	13	80	0.1625000
NODE_8548_length_912_cov_19.635916	326	406	2	67	80	0.8375000
NODE_8548_length_912_cov_19.635916	379	459	0	21	80	0.2625000
NODE_8548_length_912_cov_19.635916	379	459	2	59	80	0.7375000
NODE_8549_length_912_cov_17.714637	395	475	0	80	80	1.0000000
NODE_8549_length_912_cov_17.714637	448	528	0	80	80	1.0000000
NODE_8550_length_912_cov_15.546125	355	435	0	17	80	0.2125000
NODE_8550_length_912_cov_15.546125	355	435	2	63	80	0.7875000
NODE_8550_length_912_cov_15.546125	408	488	0	29	80	0.3625000
NODE_8550_length_912_cov_15.546125	408	488	2	51	80	0.6375000
NODE_8551_length_912_cov_15.077491	255	291	2	31	36	0.8611111
NODE_8551_length_912_cov_15.077491	255	291	4	5	36	0.1388889
NODE_8551_length_912_cov_15.077491	264	328	2	22	64	0.3437500
NODE_8551_length_912_cov_15.077491	264	328	4	17	64	0.2656250
NODE_8551_length_912_cov_15.077491	264	328	8	4	64	0.0625000
NODE_8551_length_912_cov_15.077491	264	328	10	21	64	0.3281250
NODE_8551_length_912_cov_15.077491	415	495	0	80	80	1.0000000
NODE_8551_length_912_cov_15.077491	468	548	0	80	80	1.0000000
NODE_8552_length_912_cov_15.023370	361	441	0	80	80	1.0000000
NODE_8552_length_912_cov_15.023370	414	494	0	80	80	1.0000000
NODE_8553_length_912_cov_13.600246	61	141	4	80	80	1.0000000
NODE_8553_length_912_cov_13.600246	460	540	8	7	80	0.0875000
NODE_8553_length_912_cov_13.600246	460	540	12	1	80	0.0125000
NODE_8553_length_912_cov_13.600246	460	540	16	72	80	0.9000000
NODE_8553_length_912_cov_13.600246	513	593	16	80	80	1.0000000
NODE_8554_length_912_cov_13.113161	385	465	0	80	80	1.0000000
NODE_8554_length_912_cov_13.113161	438	518	0	80	80	1.0000000
NODE_8555_length_912_cov_11.110701	353	433	0	10	80	0.1250000
NODE_8555_length_912_cov_11.110701	353	433	2	70	80	0.8750000
NODE_8555_length_912_cov_11.110701	406	486	0	45	80	0.5625000
NODE_8555_length_912_cov_11.110701	406	486	2	35	80	0.4375000
NODE_8555_length_912_cov_11.110701	827	907	0	80	80	1.0000000
NODE_8555_length_912_cov_11.110701	831	854	0	23	23	1.0000000
NODE_8584_length_911_cov_173.171182	580	660	329	1	80	0.0125000
NODE_8584_length_911_cov_173.171182	580	660	330	1	80	0.0125000
NODE_8584_length_911_cov_173.171182	580	660	332	1	80	0.0125000
NODE_8584_length_911_cov_173.171182	580	660	335	1	80	0.0125000
NODE_8584_length_911_cov_173.171182	580	660	341	1	80	0.0125000
NODE_8584_length_911_cov_173.171182	580	660	352	1	80	0.0125000
NODE_8584_length_911_cov_173.171182	580	660	362	1	80	0.0125000
NODE_8584_length_911_cov_173.171182	580	660	366	1	80	0.0125000
NODE_8584_length_911_cov_173.171182	580	660	387	1	80	0.0125000
NODE_8584_length_911_cov_173.171182	580	660	400	1	80	0.0125000
NODE_8584_length_911_cov_173.171182	580	660	406	1	80	0.0125000
NODE_8584_length_911_cov_173.171182	580	660	415	1	80	0.0125000
NODE_8584_length_911_cov_173.171182	580	660	419	1	80	0.0125000
NODE_8584_length_911_cov_173.171182	580	660	424	1	80	0.0125000
NODE_8584_length_911_cov_173.171182	580	660	428	1	80	0.0125000
NODE_8584_length_911_cov_173.171182	580	660	439	1	80	0.0125000
NODE_8584_length_911_cov_173.171182	580	660	441	1	80	0.0125000
NODE_8584_length_911_cov_173.171182	580	660	443	1	80	0.0125000
NODE_8584_length_911_cov_173.171182	580	660	444	1	80	0.0125000
NODE_8584_length_911_cov_173.171182	580	660	445	1	80	0.0125000
NODE_8584_length_911_cov_173.171182	580	660	447	1	80	0.0125000
NODE_8584_length_911_cov_173.171182	580	660	454	3	80	0.0375000
NODE_8584_length_911_cov_173.171182	580	660	458	1	80	0.0125000
NODE_8584_length_911_cov_173.171182	580	660	468	1	80	0.0125000
NODE_8584_length_911_cov_173.171182	580	660	470	1	80	0.0125000
NODE_8584_length_911_cov_173.171182	580	660	472	1	80	0.0125000
NODE_8584_length_911_cov_173.171182	580	660	477	1	80	0.0125000
NODE_8584_length_911_cov_173.171182	580	660	478	1	80	0.0125000
NODE_8584_length_911_cov_173.171182	580	660	492	1	80	0.0125000
NODE_8584_length_911_cov_173.171182	580	660	499	1	80	0.0125000
NODE_8584_length_911_cov_173.171182	580	660	502	1	80	0.0125000
NODE_8584_length_911_cov_173.171182	580	660	503	1	80	0.0125000
NODE_8584_length_911_cov_173.171182	580	660	504	1	80	0.0125000
NODE_8584_length_911_cov_173.171182	580	660	505	1	80	0.0125000
NODE_8584_length_911_cov_173.171182	580	660	520	1	80	0.0125000
NODE_8584_length_911_cov_173.171182	580	660	521	1	80	0.0125000
NODE_8584_length_911_cov_173.171182	580	660	522	2	80	0.0250000
NODE_8584_length_911_cov_173.171182	580	660	531	1	80	0.0125000
NODE_8584_length_911_cov_173.171182	580	660	554	2	80	0.0250000
NODE_8584_length_911_cov_173.171182	580	660	555	3	80	0.0375000
NODE_8584_length_911_cov_173.171182	580	660	576	1	80	0.0125000
NODE_8584_length_911_cov_173.171182	580	660	577	1	80	0.0125000
NODE_8584_length_911_cov_173.171182	580	660	582	1	80	0.0125000
NODE_8584_length_911_cov_173.171182	580	660	586	1	80	0.0125000
NODE_8584_length_911_cov_173.171182	580	660	592	1	80	0.0125000
NODE_8584_length_911_cov_173.171182	580	660	594	1	80	0.0125000
NODE_8584_length_911_cov_173.171182	580	660	601	1	80	0.0125000
NODE_8584_length_911_cov_173.171182	580	660	608	3	80	0.0375000
NODE_8584_length_911_cov_173.171182	580	660	618	1	80	0.0125000
NODE_8584_length_911_cov_173.171182	580	660	625	1	80	0.0125000
NODE_8584_length_911_cov_173.171182	580	660	631	1	80	0.0125000
NODE_8584_length_911_cov_173.171182	580	660	635	1	80	0.0125000
NODE_8584_length_911_cov_173.171182	580	660	647	1	80	0.0125000
NODE_8584_length_911_cov_173.171182	580	660	648	1	80	0.0125000
NODE_8584_length_911_cov_173.171182	580	660	661	1	80	0.0125000
NODE_8584_length_911_cov_173.171182	580	660	666	1	80	0.0125000
NODE_8584_length_911_cov_173.171182	580	660	673	1	80	0.0125000
NODE_8584_length_911_cov_173.171182	580	660	679	1	80	0.0125000
NODE_8584_length_911_cov_173.171182	580	660	681	2	80	0.0250000
NODE_8584_length_911_cov_173.171182	580	660	682	1	80	0.0125000
NODE_8584_length_911_cov_173.171182	580	660	687	1	80	0.0125000
NODE_8584_length_911_cov_173.171182	580	660	695	1	80	0.0125000
NODE_8584_length_911_cov_173.171182	580	660	699	1	80	0.0125000
NODE_8584_length_911_cov_173.171182	580	660	701	1	80	0.0125000
NODE_8584_length_911_cov_173.171182	580	660	702	1	80	0.0125000
NODE_8584_length_911_cov_173.171182	580	660	703	2	80	0.0250000
NODE_8584_length_911_cov_173.171182	580	660	704	2	80	0.0250000
NODE_8584_length_911_cov_173.171182	580	660	708	2	80	0.0250000
NODE_8584_length_911_cov_173.171182	633	713	608	3	80	0.0375000
NODE_8584_length_911_cov_173.171182	633	713	618	1	80	0.0125000
NODE_8584_length_911_cov_173.171182	633	713	625	1	80	0.0125000
NODE_8584_length_911_cov_173.171182	633	713	631	1	80	0.0125000
NODE_8584_length_911_cov_173.171182	633	713	635	1	80	0.0125000
NODE_8584_length_911_cov_173.171182	633	713	647	1	80	0.0125000
NODE_8584_length_911_cov_173.171182	633	713	648	1	80	0.0125000
NODE_8584_length_911_cov_173.171182	633	713	661	1	80	0.0125000
NODE_8584_length_911_cov_173.171182	633	713	666	1	80	0.0125000
NODE_8584_length_911_cov_173.171182	633	713	673	1	80	0.0125000
NODE_8584_length_911_cov_173.171182	633	713	679	1	80	0.0125000
NODE_8584_length_911_cov_173.171182	633	713	681	2	80	0.0250000
NODE_8584_length_911_cov_173.171182	633	713	682	1	80	0.0125000
NODE_8584_length_911_cov_173.171182	633	713	687	1	80	0.0125000
NODE_8584_length_911_cov_173.171182	633	713	695	1	80	0.0125000
NODE_8584_length_911_cov_173.171182	633	713	699	1	80	0.0125000
NODE_8584_length_911_cov_173.171182	633	713	701	1	80	0.0125000
NODE_8584_length_911_cov_173.171182	633	713	702	1	80	0.0125000
NODE_8584_length_911_cov_173.171182	633	713	703	2	80	0.0250000
NODE_8584_length_911_cov_173.171182	633	713	704	2	80	0.0250000
NODE_8584_length_911_cov_173.171182	633	713	708	2	80	0.0250000
NODE_8584_length_911_cov_173.171182	633	713	717	1	80	0.0125000
NODE_8584_length_911_cov_173.171182	633	713	720	2	80	0.0250000
NODE_8584_length_911_cov_173.171182	633	713	721	2	80	0.0250000
NODE_8584_length_911_cov_173.171182	633	713	724	3	80	0.0375000
NODE_8584_length_911_cov_173.171182	633	713	726	1	80	0.0125000
NODE_8584_length_911_cov_173.171182	633	713	727	1	80	0.0125000
NODE_8584_length_911_cov_173.171182	633	713	730	3	80	0.0375000
NODE_8584_length_911_cov_173.171182	633	713	731	2	80	0.0250000
NODE_8584_length_911_cov_173.171182	633	713	735	3	80	0.0375000
NODE_8584_length_911_cov_173.171182	633	713	737	3	80	0.0375000
NODE_8584_length_911_cov_173.171182	633	713	738	1	80	0.0125000
NODE_8584_length_911_cov_173.171182	633	713	739	3	80	0.0375000
NODE_8584_length_911_cov_173.171182	633	713	740	2	80	0.0250000
NODE_8584_length_911_cov_173.171182	633	713	741	4	80	0.0500000
NODE_8584_length_911_cov_173.171182	633	713	743	4	80	0.0500000
NODE_8584_length_911_cov_173.171182	633	713	744	2	80	0.0250000
NODE_8584_length_911_cov_173.171182	633	713	746	2	80	0.0250000
NODE_8584_length_911_cov_173.171182	633	713	747	2	80	0.0250000
NODE_8584_length_911_cov_173.171182	633	713	748	4	80	0.0500000
NODE_8584_length_911_cov_173.171182	633	713	749	1	80	0.0125000
NODE_8584_length_911_cov_173.171182	633	713	751	1	80	0.0125000
NODE_8584_length_911_cov_173.171182	633	713	753	3	80	0.0375000
NODE_8584_length_911_cov_173.171182	633	713	755	1	80	0.0125000
NODE_8584_length_911_cov_173.171182	633	713	758	1	80	0.0125000
NODE_8584_length_911_cov_173.171182	633	713	763	1	80	0.0125000
NODE_8585_length_911_cov_88.250000	525	605	0	80	80	1.0000000
NODE_8585_length_911_cov_88.250000	578	658	0	80	80	1.0000000
NODE_8586_length_911_cov_46.854680	255	335	11	21	80	0.2625000
NODE_8586_length_911_cov_46.854680	255	335	12	3	80	0.0375000
NODE_8586_length_911_cov_46.854680	255	335	16	1	80	0.0125000
NODE_8586_length_911_cov_46.854680	255	335	17	7	80	0.0875000
NODE_8586_length_911_cov_46.854680	255	335	18	25	80	0.3125000
NODE_8586_length_911_cov_46.854680	255	335	20	23	80	0.2875000
NODE_8586_length_911_cov_46.854680	308	388	0	5	80	0.0625000
NODE_8586_length_911_cov_46.854680	308	388	2	3	80	0.0375000
NODE_8586_length_911_cov_46.854680	308	388	12	27	80	0.3375000
NODE_8586_length_911_cov_46.854680	308	388	17	2	80	0.0250000
NODE_8586_length_911_cov_46.854680	308	388	18	15	80	0.1875000
NODE_8586_length_911_cov_46.854680	308	388	20	28	80	0.3500000
NODE_8586_length_911_cov_46.854680	384	464	0	29	80	0.3625000
NODE_8586_length_911_cov_46.854680	384	464	2	20	80	0.2500000
NODE_8586_length_911_cov_46.854680	384	464	4	8	80	0.1000000
NODE_8586_length_911_cov_46.854680	384	464	6	23	80	0.2875000
NODE_8586_length_911_cov_46.854680	437	517	2	9	80	0.1125000
NODE_8586_length_911_cov_46.854680	437	517	4	12	80	0.1500000
NODE_8586_length_911_cov_46.854680	437	517	6	59	80	0.7375000
NODE_8587_length_911_cov_31.362069	301	381	0	72	80	0.9000000
NODE_8587_length_911_cov_31.362069	301	381	6	8	80	0.1000000
NODE_8587_length_911_cov_31.362069	354	434	0	19	80	0.2375000
NODE_8587_length_911_cov_31.362069	354	434	6	61	80	0.7625000
NODE_8588_length_911_cov_19.235222	445	525	0	4	80	0.0500000
NODE_8588_length_911_cov_19.235222	445	525	4	12	80	0.1500000
NODE_8588_length_911_cov_19.235222	445	525	6	64	80	0.8000000
NODE_8588_length_911_cov_19.235222	498	578	0	3	80	0.0375000
NODE_8588_length_911_cov_19.235222	498	578	2	47	80	0.5875000
NODE_8588_length_911_cov_19.235222	498	578	6	30	80	0.3750000
NODE_8589_length_911_cov_16.230296	233	313	0	80	80	1.0000000
NODE_8589_length_911_cov_16.230296	286	366	0	80	80	1.0000000
NODE_8590_length_911_cov_14.979064	472	552	0	80	80	1.0000000
NODE_8590_length_911_cov_14.979064	525	605	0	80	80	1.0000000
NODE_8591_length_911_cov_12.089901	357	409	4	15	52	0.2884615
NODE_8591_length_911_cov_12.089901	357	409	6	24	52	0.4615385
NODE_8591_length_911_cov_12.089901	357	409	8	13	52	0.2500000
NODE_8591_length_911_cov_12.089901	401	462	0	4	61	0.0655738
NODE_8591_length_911_cov_12.089901	401	462	2	11	61	0.1803279
NODE_8591_length_911_cov_12.089901	401	462	4	46	61	0.7540984
NODE_8606_length_910_cov_27.838471	347	427	0	3	80	0.0375000
NODE_8606_length_910_cov_27.838471	347	427	2	77	80	0.9625000
NODE_8606_length_910_cov_27.838471	400	480	0	26	80	0.3250000
NODE_8606_length_910_cov_27.838471	400	480	2	54	80	0.6750000
NODE_8607_length_910_cov_25.895191	361	441	2	44	80	0.5500000
NODE_8607_length_910_cov_25.895191	361	441	4	36	80	0.4500000
NODE_8607_length_910_cov_25.895191	414	494	0	43	80	0.5375000
NODE_8607_length_910_cov_25.895191	414	494	2	37	80	0.4625000
NODE_8608_length_910_cov_25.604192	294	374	0	12	80	0.1500000
NODE_8608_length_910_cov_25.604192	294	374	4	68	80	0.8500000
NODE_8608_length_910_cov_25.604192	347	427	0	16	80	0.2000000
NODE_8608_length_910_cov_25.604192	347	427	4	64	80	0.8000000
NODE_8608_length_910_cov_25.604192	423	503	0	66	80	0.8250000
NODE_8608_length_910_cov_25.604192	423	503	2	14	80	0.1750000
NODE_8608_length_910_cov_25.604192	476	556	0	13	80	0.1625000
NODE_8608_length_910_cov_25.604192	476	556	2	67	80	0.8375000
NODE_8609_length_910_cov_16.066584	656	736	0	80	80	1.0000000
NODE_8609_length_910_cov_16.066584	709	789	0	80	80	1.0000000
NODE_8610_length_910_cov_14.696671	417	497	4	71	80	0.8875000
NODE_8610_length_910_cov_14.696671	417	497	6	9	80	0.1125000
NODE_8610_length_910_cov_14.696671	470	550	0	14	80	0.1750000
NODE_8610_length_910_cov_14.696671	470	550	3	8	80	0.1000000
NODE_8610_length_910_cov_14.696671	470	550	4	58	80	0.7250000
NODE_8612_length_910_cov_7.114673	442	522	6	14	80	0.1750000
NODE_8612_length_910_cov_7.114673	442	522	8	16	80	0.2000000
NODE_8612_length_910_cov_7.114673	442	522	10	50	80	0.6250000
NODE_8612_length_910_cov_7.114673	495	575	0	40	80	0.5000000
NODE_8612_length_910_cov_7.114673	495	575	4	6	80	0.0750000
NODE_8612_length_910_cov_7.114673	495	575	6	21	80	0.2625000
NODE_8612_length_910_cov_7.114673	495	575	10	13	80	0.1625000
NODE_8614_length_910_cov_2.992602	196	269	18	6	73	0.0821918
NODE_8614_length_910_cov_2.992602	196	269	19	3	73	0.0410959
NODE_8614_length_910_cov_2.992602	196	269	20	13	73	0.1780822
NODE_8614_length_910_cov_2.992602	196	269	21	16	73	0.2191781
NODE_8614_length_910_cov_2.992602	196	269	22	13	73	0.1780822
NODE_8614_length_910_cov_2.992602	196	269	23	8	73	0.1095890
NODE_8614_length_910_cov_2.992602	196	269	24	9	73	0.1232877
NODE_8614_length_910_cov_2.992602	196	269	26	3	73	0.0410959
NODE_8614_length_910_cov_2.992602	196	269	28	2	73	0.0273973
NODE_8614_length_910_cov_2.992602	249	329	18	5	80	0.0625000
NODE_8614_length_910_cov_2.992602	249	329	21	7	80	0.0875000
NODE_8614_length_910_cov_2.992602	249	329	22	14	80	0.1750000
NODE_8614_length_910_cov_2.992602	249	329	23	9	80	0.1125000
NODE_8614_length_910_cov_2.992602	249	329	24	1	80	0.0125000
NODE_8614_length_910_cov_2.992602	249	329	25	2	80	0.0250000
NODE_8614_length_910_cov_2.992602	249	329	26	15	80	0.1875000
NODE_8614_length_910_cov_2.992602	249	329	27	4	80	0.0500000
NODE_8614_length_910_cov_2.992602	249	329	28	7	80	0.0875000
NODE_8614_length_910_cov_2.992602	249	329	29	1	80	0.0125000
NODE_8614_length_910_cov_2.992602	249	329	30	15	80	0.1875000
NODE_8614_length_910_cov_2.992602	386	439	12	19	53	0.3584906
NODE_8614_length_910_cov_2.992602	386	439	14	20	53	0.3773585
NODE_8614_length_910_cov_2.992602	386	439	16	8	53	0.1509434
NODE_8614_length_910_cov_2.992602	386	439	18	6	53	0.1132075
NODE_8623_length_909_cov_35.291358	426	506	0	80	80	1.0000000
NODE_8623_length_909_cov_35.291358	479	559	0	80	80	1.0000000
NODE_8624_length_909_cov_27.449383	311	391	0	80	80	1.0000000
NODE_8624_length_909_cov_27.449383	364	444	0	55	80	0.6875000
NODE_8624_length_909_cov_27.449383	364	444	2	25	80	0.3125000
NODE_8625_length_909_cov_25.212346	295	375	0	29	80	0.3625000
NODE_8625_length_909_cov_25.212346	295	375	7	31	80	0.3875000
NODE_8625_length_909_cov_25.212346	295	375	9	8	80	0.1000000
NODE_8625_length_909_cov_25.212346	295	375	10	12	80	0.1500000
NODE_8625_length_909_cov_25.212346	348	428	2	26	80	0.3250000
NODE_8625_length_909_cov_25.212346	348	428	7	7	80	0.0875000
NODE_8625_length_909_cov_25.212346	348	428	9	8	80	0.1000000
NODE_8625_length_909_cov_25.212346	348	428	10	39	80	0.4875000
NODE_8626_length_909_cov_23.604938	403	483	0	15	80	0.1875000
NODE_8626_length_909_cov_23.604938	403	483	2	65	80	0.8125000
NODE_8626_length_909_cov_23.604938	456	536	0	24	80	0.3000000
NODE_8626_length_909_cov_23.604938	456	536	2	56	80	0.7000000
NODE_8627_length_909_cov_19.070370	441	521	2	35	80	0.4375000
NODE_8627_length_909_cov_19.070370	441	521	6	45	80	0.5625000
NODE_8627_length_909_cov_19.070370	494	574	0	20	80	0.2500000
NODE_8627_length_909_cov_19.070370	494	574	4	26	80	0.3250000
NODE_8627_length_909_cov_19.070370	494	574	6	34	80	0.4250000
NODE_8628_length_909_cov_11.533333	332	412	0	36	80	0.4500000
NODE_8628_length_909_cov_11.533333	332	412	2	44	80	0.5500000
NODE_8628_length_909_cov_11.533333	385	465	0	80	80	1.0000000
NODE_8629_length_909_cov_10.229630	497	577	0	80	80	1.0000000
NODE_8629_length_909_cov_10.229630	550	622	0	72	72	1.0000000
NODE_8631_length_909_cov_7.122222	328	408	2	80	80	1.0000000
NODE_8631_length_909_cov_7.122222	381	461	0	45	80	0.5625000
NODE_8631_length_909_cov_7.122222	381	461	2	35	80	0.4375000
NODE_8632_length_909_cov_4.664198	775	855	2	23	80	0.2875000
NODE_8632_length_909_cov_4.664198	775	855	4	12	80	0.1500000
NODE_8632_length_909_cov_4.664198	775	855	6	8	80	0.1000000
NODE_8632_length_909_cov_4.664198	775	855	8	25	80	0.3125000
NODE_8632_length_909_cov_4.664198	775	855	10	1	80	0.0125000
NODE_8632_length_909_cov_4.664198	775	855	12	4	80	0.0500000
NODE_8632_length_909_cov_4.664198	775	855	14	7	80	0.0875000
NODE_8632_length_909_cov_4.664198	828	885	0	12	57	0.2105263
NODE_8632_length_909_cov_4.664198	828	885	2	41	57	0.7192982
NODE_8632_length_909_cov_4.664198	828	885	4	4	57	0.0701754
NODE_8644_length_908_cov_55.546354	409	489	0	80	80	1.0000000
NODE_8644_length_908_cov_55.546354	462	542	0	80	80	1.0000000
NODE_8645_length_908_cov_18.720643	329	409	0	80	80	1.0000000
NODE_8645_length_908_cov_18.720643	382	462	0	80	80	1.0000000
NODE_8646_length_908_cov_14.640297	430	510	0	80	80	1.0000000
NODE_8646_length_908_cov_14.640297	483	562	0	79	79	1.0000000
NODE_8648_length_908_cov_10.789864	370	450	0	80	80	1.0000000
NODE_8648_length_908_cov_10.789864	423	503	0	80	80	1.0000000
NODE_8651_length_908_cov_3.737948	251	331	0	80	80	1.0000000
NODE_8651_length_908_cov_3.737948	304	384	0	80	80	1.0000000
NODE_8664_length_907_cov_22.110149	459	539	0	78	80	0.9750000
NODE_8664_length_907_cov_22.110149	459	539	2	2	80	0.0250000
NODE_8664_length_907_cov_22.110149	512	592	0	25	80	0.3125000
NODE_8664_length_907_cov_22.110149	512	592	2	55	80	0.6875000
NODE_8665_length_907_cov_20.943069	410	490	0	73	80	0.9125000
NODE_8665_length_907_cov_20.943069	410	490	2	7	80	0.0875000
NODE_8665_length_907_cov_20.943069	463	543	0	80	80	1.0000000
NODE_8666_length_907_cov_19.519802	411	488	0	30	77	0.3896104
NODE_8666_length_907_cov_19.519802	411	488	4	47	77	0.6103896
NODE_8666_length_907_cov_19.519802	461	541	0	25	80	0.3125000
NODE_8666_length_907_cov_19.519802	461	541	4	55	80	0.6875000
NODE_8667_length_907_cov_17.928218	329	405	0	76	76	1.0000000
NODE_8667_length_907_cov_17.928218	382	462	0	80	80	1.0000000
NODE_8668_length_907_cov_13.060644	293	373	0	80	80	1.0000000
NODE_8668_length_907_cov_13.060644	346	426	0	80	80	1.0000000
NODE_8669_length_907_cov_11.155941	401	462	0	61	61	1.0000000
NODE_8669_length_907_cov_11.155941	607	687	0	80	80	1.0000000
NODE_8670_length_907_cov_9.237624	247	327	0	80	80	1.0000000
NODE_8670_length_907_cov_9.237624	300	380	0	80	80	1.0000000
NODE_8671_length_907_cov_8.686881	275	365	0	90	90	1.0000000
NODE_8671_length_907_cov_8.686881	338	418	0	80	80	1.0000000
NODE_8680_length_907_cov_2.949257	503	526	0	23	23	1.0000000
NODE_8686_length_906_cov_32.369269	447	527	4	32	80	0.4000000
NODE_8686_length_906_cov_32.369269	447	527	6	48	80	0.6000000
NODE_8686_length_906_cov_32.369269	500	580	0	40	80	0.5000000
NODE_8686_length_906_cov_32.369269	500	580	2	10	80	0.1250000
NODE_8686_length_906_cov_32.369269	500	580	4	11	80	0.1375000
NODE_8686_length_906_cov_32.369269	500	580	6	19	80	0.2375000
NODE_8687_length_906_cov_23.594796	196	276	0	80	80	1.0000000
NODE_8687_length_906_cov_23.594796	249	329	0	80	80	1.0000000
NODE_8688_length_906_cov_21.443618	404	484	0	11	80	0.1375000
NODE_8688_length_906_cov_21.443618	404	484	2	69	80	0.8625000
NODE_8688_length_906_cov_21.443618	457	537	0	11	80	0.1375000
NODE_8688_length_906_cov_21.443618	457	537	2	69	80	0.8625000
NODE_8689_length_906_cov_20.596035	593	634	0	41	41	1.0000000
NODE_8690_length_906_cov_20.429988	410	490	0	80	80	1.0000000
NODE_8690_length_906_cov_20.429988	463	543	0	80	80	1.0000000
NODE_8691_length_906_cov_20.395291	523	603	0	80	80	1.0000000
NODE_8691_length_906_cov_20.395291	576	656	0	80	80	1.0000000
NODE_8692_length_906_cov_19.297398	255	335	0	80	80	1.0000000
NODE_8692_length_906_cov_19.297398	308	388	0	80	80	1.0000000
NODE_8693_length_906_cov_18.505576	357	437	0	2	80	0.0250000
NODE_8693_length_906_cov_18.505576	357	437	2	78	80	0.9750000
NODE_8693_length_906_cov_18.505576	410	490	0	55	80	0.6875000
NODE_8693_length_906_cov_18.505576	410	490	2	25	80	0.3125000
NODE_8694_length_906_cov_10.068154	191	271	0	56	80	0.7000000
NODE_8694_length_906_cov_10.068154	191	271	2	14	80	0.1750000
NODE_8694_length_906_cov_10.068154	191	271	6	10	80	0.1250000
NODE_8694_length_906_cov_10.068154	244	324	0	3	80	0.0375000
NODE_8694_length_906_cov_10.068154	244	324	2	14	80	0.1750000
NODE_8694_length_906_cov_10.068154	244	324	5	8	80	0.1000000
NODE_8694_length_906_cov_10.068154	244	324	6	55	80	0.6875000
NODE_8695_length_906_cov_10.006196	304	384	0	80	80	1.0000000
NODE_8695_length_906_cov_10.006196	357	437	0	80	80	1.0000000
NODE_8696_length_906_cov_8.562577	370	454	0	84	84	1.0000000
NODE_8696_length_906_cov_8.562577	423	507	0	33	84	0.3928571
NODE_8696_length_906_cov_8.562577	423	507	2	22	84	0.2619048
NODE_8696_length_906_cov_8.562577	423	507	4	5	84	0.0595238
NODE_8696_length_906_cov_8.562577	423	507	5	1	84	0.0119048
NODE_8696_length_906_cov_8.562577	423	507	6	23	84	0.2738095
NODE_8716_length_905_cov_39.203474	406	486	0	80	80	1.0000000
NODE_8716_length_905_cov_39.203474	459	539	0	80	80	1.0000000
NODE_8717_length_905_cov_37.053350	411	491	0	22	80	0.2750000
NODE_8717_length_905_cov_37.053350	411	491	2	43	80	0.5375000
NODE_8717_length_905_cov_37.053350	411	491	4	15	80	0.1875000
NODE_8717_length_905_cov_37.053350	464	544	0	75	80	0.9375000
NODE_8717_length_905_cov_37.053350	464	544	2	5	80	0.0625000
NODE_8718_length_905_cov_27.426799	288	368	0	80	80	1.0000000
NODE_8718_length_905_cov_27.426799	341	421	0	27	80	0.3375000
NODE_8718_length_905_cov_27.426799	341	421	2	53	80	0.6625000
NODE_8719_length_905_cov_26.332506	375	455	1	32	80	0.4000000
NODE_8719_length_905_cov_26.332506	375	455	8	16	80	0.2000000
NODE_8719_length_905_cov_26.332506	375	455	9	32	80	0.4000000
NODE_8719_length_905_cov_26.332506	428	508	6	18	80	0.2250000
NODE_8719_length_905_cov_26.332506	428	508	9	36	80	0.4500000
NODE_8719_length_905_cov_26.332506	428	508	10	26	80	0.3250000
NODE_8720_length_905_cov_20.651365	377	457	2	80	80	1.0000000
NODE_8720_length_905_cov_20.651365	430	510	0	8	80	0.1000000
NODE_8720_length_905_cov_20.651365	430	510	2	72	80	0.9000000
NODE_8721_length_905_cov_19.718362	365	445	2	78	80	0.9750000
NODE_8721_length_905_cov_19.718362	365	445	4	2	80	0.0250000
NODE_8721_length_905_cov_19.718362	418	498	0	47	80	0.5875000
NODE_8721_length_905_cov_19.718362	418	498	2	33	80	0.4125000
NODE_8722_length_905_cov_13.696030	366	420	7	4	54	0.0740741
NODE_8722_length_905_cov_13.696030	366	420	11	50	54	0.9259259
NODE_8723_length_905_cov_9.978908	222	302	0	80	80	1.0000000
NODE_8723_length_905_cov_9.978908	275	355	0	80	80	1.0000000
NODE_8725_length_905_cov_7.980149	321	401	0	70	80	0.8750000
NODE_8725_length_905_cov_7.980149	321	401	2	10	80	0.1250000
NODE_8725_length_905_cov_7.980149	374	454	0	80	80	1.0000000
NODE_8727_length_905_cov_6.064516	459	539	0	80	80	1.0000000
NODE_8727_length_905_cov_6.064516	512	592	0	80	80	1.0000000
NODE_8742_length_905_cov_1.040943	73	119	28	6	46	0.1304348
NODE_8742_length_905_cov_1.040943	73	119	30	40	46	0.8695652
NODE_8742_length_905_cov_1.040943	126	172	0	1	46	0.0217391
NODE_8742_length_905_cov_1.040943	126	172	4	1	46	0.0217391
NODE_8742_length_905_cov_1.040943	126	172	6	12	46	0.2608696
NODE_8742_length_905_cov_1.040943	126	172	10	2	46	0.0434783
NODE_8742_length_905_cov_1.040943	126	172	13	1	46	0.0217391
NODE_8742_length_905_cov_1.040943	126	172	16	1	46	0.0217391
NODE_8742_length_905_cov_1.040943	126	172	22	3	46	0.0652174
NODE_8742_length_905_cov_1.040943	126	172	24	1	46	0.0217391
NODE_8742_length_905_cov_1.040943	126	172	26	1	46	0.0217391
NODE_8742_length_905_cov_1.040943	126	172	28	23	46	0.5000000
NODE_8743_length_904_cov_29.532919	338	418	0	80	80	1.0000000
NODE_8743_length_904_cov_29.532919	391	471	0	80	80	1.0000000
NODE_8743_length_904_cov_29.532919	467	547	0	80	80	1.0000000
NODE_8743_length_904_cov_29.532919	520	600	0	80	80	1.0000000
NODE_8744_length_904_cov_28.844720	371	451	2	80	80	1.0000000
NODE_8744_length_904_cov_28.844720	424	504	0	27	80	0.3375000
NODE_8744_length_904_cov_28.844720	424	504	2	53	80	0.6625000
NODE_8745_length_904_cov_26.977640	488	568	0	80	80	1.0000000
NODE_8745_length_904_cov_26.977640	541	621	0	80	80	1.0000000
NODE_8746_length_904_cov_24.529193	464	544	0	4	80	0.0500000
NODE_8746_length_904_cov_24.529193	464	544	2	3	80	0.0375000
NODE_8746_length_904_cov_24.529193	464	544	4	42	80	0.5250000
NODE_8746_length_904_cov_24.529193	464	544	8	31	80	0.3875000
NODE_8746_length_904_cov_24.529193	517	597	2	1	80	0.0125000
NODE_8746_length_904_cov_24.529193	517	597	4	23	80	0.2875000
NODE_8746_length_904_cov_24.529193	517	597	6	21	80	0.2625000
NODE_8746_length_904_cov_24.529193	517	597	8	35	80	0.4375000
NODE_8747_length_904_cov_24.452174	507	587	0	1	80	0.0125000
NODE_8747_length_904_cov_24.452174	507	587	2	16	80	0.2000000
NODE_8747_length_904_cov_24.452174	507	587	4	63	80	0.7875000
NODE_8747_length_904_cov_24.452174	560	640	0	54	80	0.6750000
NODE_8747_length_904_cov_24.452174	560	640	2	16	80	0.2000000
NODE_8747_length_904_cov_24.452174	560	640	4	10	80	0.1250000
NODE_8748_length_904_cov_19.649689	307	387	3	2	80	0.0250000
NODE_8748_length_904_cov_19.649689	307	387	8	17	80	0.2125000
NODE_8748_length_904_cov_19.649689	307	387	9	5	80	0.0625000
NODE_8748_length_904_cov_19.649689	307	387	10	29	80	0.3625000
NODE_8748_length_904_cov_19.649689	307	387	11	16	80	0.2000000
NODE_8748_length_904_cov_19.649689	307	387	12	11	80	0.1375000
NODE_8748_length_904_cov_19.649689	360	440	1	6	80	0.0750000
NODE_8748_length_904_cov_19.649689	360	440	2	11	80	0.1375000
NODE_8748_length_904_cov_19.649689	360	440	3	38	80	0.4750000
NODE_8748_length_904_cov_19.649689	360	440	11	16	80	0.2000000
NODE_8748_length_904_cov_19.649689	360	440	12	9	80	0.1125000
NODE_8748_length_904_cov_19.649689	595	675	2	5	80	0.0625000
NODE_8748_length_904_cov_19.649689	595	675	4	74	80	0.9250000
NODE_8748_length_904_cov_19.649689	595	675	6	1	80	0.0125000
NODE_8748_length_904_cov_19.649689	648	728	0	50	80	0.6250000
NODE_8748_length_904_cov_19.649689	648	728	2	8	80	0.1000000
NODE_8748_length_904_cov_19.649689	648	728	4	22	80	0.2750000
NODE_8750_length_904_cov_16.608696	252	332	0	80	80	1.0000000
NODE_8750_length_904_cov_16.608696	305	385	0	68	80	0.8500000
NODE_8750_length_904_cov_16.608696	305	385	2	12	80	0.1500000
NODE_8750_length_904_cov_16.608696	381	461	2	53	80	0.6625000
NODE_8750_length_904_cov_16.608696	381	461	4	27	80	0.3375000
NODE_8750_length_904_cov_16.608696	434	514	0	19	80	0.2375000
NODE_8750_length_904_cov_16.608696	434	514	2	7	80	0.0875000
NODE_8750_length_904_cov_16.608696	434	514	4	54	80	0.6750000
NODE_8751_length_904_cov_15.811180	431	511	0	26	80	0.3250000
NODE_8751_length_904_cov_15.811180	431	511	1	1	80	0.0125000
NODE_8751_length_904_cov_15.811180	431	511	2	53	80	0.6625000
NODE_8751_length_904_cov_15.811180	484	564	0	18	80	0.2250000
NODE_8751_length_904_cov_15.811180	484	564	2	20	80	0.2500000
NODE_8751_length_904_cov_15.811180	484	564	4	2	80	0.0250000
NODE_8751_length_904_cov_15.811180	484	564	6	40	80	0.5000000
NODE_8752_length_904_cov_9.249689	581	661	0	80	80	1.0000000
NODE_8752_length_904_cov_9.249689	634	714	0	80	80	1.0000000
NODE_8756_length_904_cov_4.772671	318	398	0	2	80	0.0250000
NODE_8756_length_904_cov_4.772671	318	398	2	78	80	0.9750000
NODE_8756_length_904_cov_4.772671	371	451	0	16	80	0.2000000
NODE_8756_length_904_cov_4.772671	371	451	2	64	80	0.8000000
NODE_8773_length_903_cov_58.723881	386	466	16	14	80	0.1750000
NODE_8773_length_903_cov_58.723881	386	466	17	2	80	0.0250000
NODE_8773_length_903_cov_58.723881	386	466	18	7	80	0.0875000
NODE_8773_length_903_cov_58.723881	386	466	29	13	80	0.1625000
NODE_8773_length_903_cov_58.723881	386	466	33	3	80	0.0375000
NODE_8773_length_903_cov_58.723881	386	466	35	4	80	0.0500000
NODE_8773_length_903_cov_58.723881	386	466	37	6	80	0.0750000
NODE_8773_length_903_cov_58.723881	386	466	38	11	80	0.1375000
NODE_8773_length_903_cov_58.723881	386	466	39	7	80	0.0875000
NODE_8773_length_903_cov_58.723881	386	466	40	8	80	0.1000000
NODE_8773_length_903_cov_58.723881	386	466	42	5	80	0.0625000
NODE_8773_length_903_cov_58.723881	439	519	30	1	80	0.0125000
NODE_8773_length_903_cov_58.723881	439	519	32	7	80	0.0875000
NODE_8773_length_903_cov_58.723881	439	519	33	1	80	0.0125000
NODE_8773_length_903_cov_58.723881	439	519	34	7	80	0.0875000
NODE_8773_length_903_cov_58.723881	439	519	37	2	80	0.0250000
NODE_8773_length_903_cov_58.723881	439	519	38	16	80	0.2000000
NODE_8773_length_903_cov_58.723881	439	519	39	16	80	0.2000000
NODE_8773_length_903_cov_58.723881	439	519	40	8	80	0.1000000
NODE_8773_length_903_cov_58.723881	439	519	42	11	80	0.1375000
NODE_8773_length_903_cov_58.723881	439	519	45	1	80	0.0125000
NODE_8773_length_903_cov_58.723881	439	519	46	1	80	0.0125000
NODE_8773_length_903_cov_58.723881	439	519	47	9	80	0.1125000
NODE_8773_length_903_cov_58.723881	515	595	12	24	80	0.3000000
NODE_8773_length_903_cov_58.723881	515	595	14	14	80	0.1750000
NODE_8773_length_903_cov_58.723881	515	595	16	13	80	0.1625000
NODE_8773_length_903_cov_58.723881	515	595	26	3	80	0.0375000
NODE_8773_length_903_cov_58.723881	515	595	30	17	80	0.2125000
NODE_8773_length_903_cov_58.723881	515	595	32	8	80	0.1000000
NODE_8773_length_903_cov_58.723881	515	595	34	1	80	0.0125000
NODE_8773_length_903_cov_58.723881	568	648	6	5	80	0.0625000
NODE_8773_length_903_cov_58.723881	568	648	8	19	80	0.2375000
NODE_8773_length_903_cov_58.723881	568	648	14	16	80	0.2000000
NODE_8773_length_903_cov_58.723881	568	648	15	14	80	0.1750000
NODE_8773_length_903_cov_58.723881	568	648	16	26	80	0.3250000
NODE_8774_length_903_cov_41.298507	397	477	0	34	80	0.4250000
NODE_8774_length_903_cov_41.298507	397	477	8	6	80	0.0750000
NODE_8774_length_903_cov_41.298507	397	477	9	40	80	0.5000000
NODE_8774_length_903_cov_41.298507	450	530	0	54	80	0.6750000
NODE_8774_length_903_cov_41.298507	450	530	2	26	80	0.3250000
NODE_8775_length_903_cov_28.691542	394	474	0	80	80	1.0000000
NODE_8775_length_903_cov_28.691542	447	527	0	80	80	1.0000000
NODE_8776_length_903_cov_26.276119	441	521	0	80	80	1.0000000
NODE_8776_length_903_cov_26.276119	494	574	0	80	80	1.0000000
NODE_8778_length_903_cov_18.166667	351	431	0	80	80	1.0000000
NODE_8778_length_903_cov_18.166667	404	484	0	80	80	1.0000000
NODE_8779_length_903_cov_15.460199	440	520	0	80	80	1.0000000
NODE_8779_length_903_cov_15.460199	493	573	0	80	80	1.0000000
NODE_8780_length_903_cov_15.084577	352	432	0	73	80	0.9125000
NODE_8780_length_903_cov_15.084577	352	432	2	7	80	0.0875000
NODE_8780_length_903_cov_15.084577	405	485	0	20	80	0.2500000
NODE_8780_length_903_cov_15.084577	405	485	2	60	80	0.7500000
NODE_8781_length_903_cov_15.070896	367	447	2	13	80	0.1625000
NODE_8781_length_903_cov_15.070896	367	447	5	47	80	0.5875000
NODE_8781_length_903_cov_15.070896	367	447	6	20	80	0.2500000
NODE_8781_length_903_cov_15.070896	420	500	1	49	80	0.6125000
NODE_8781_length_903_cov_15.070896	420	500	5	31	80	0.3875000
NODE_8782_length_903_cov_14.004975	318	399	0	81	81	1.0000000
NODE_8782_length_903_cov_14.004975	372	452	0	80	80	1.0000000
NODE_8783_length_903_cov_10.546020	150	230	0	80	80	1.0000000
NODE_8783_length_903_cov_10.546020	203	283	0	80	80	1.0000000
NODE_8784_length_903_cov_9.288557	373	453	0	73	80	0.9125000
NODE_8784_length_903_cov_9.288557	373	453	2	7	80	0.0875000
NODE_8784_length_903_cov_9.288557	426	506	0	20	80	0.2500000
NODE_8784_length_903_cov_9.288557	426	506	2	60	80	0.7500000
NODE_8785_length_903_cov_8.052239	439	519	0	47	80	0.5875000
NODE_8785_length_903_cov_8.052239	439	519	2	33	80	0.4125000
NODE_8785_length_903_cov_8.052239	492	572	0	3	80	0.0375000
NODE_8785_length_903_cov_8.052239	492	572	2	77	80	0.9625000
NODE_8798_length_902_cov_64.459527	355	435	10	69	80	0.8625000
NODE_8798_length_902_cov_64.459527	355	435	12	11	80	0.1375000
NODE_8798_length_902_cov_64.459527	408	488	0	10	80	0.1250000
NODE_8798_length_902_cov_64.459527	408	488	2	42	80	0.5250000
NODE_8798_length_902_cov_64.459527	408	488	10	16	80	0.2000000
NODE_8798_length_902_cov_64.459527	408	488	12	12	80	0.1500000
NODE_8798_length_902_cov_64.459527	484	564	0	23	80	0.2875000
NODE_8798_length_902_cov_64.459527	484	564	6	57	80	0.7125000
NODE_8798_length_902_cov_64.459527	537	617	0	40	80	0.5000000
NODE_8798_length_902_cov_64.459527	537	617	6	40	80	0.5000000
NODE_8799_length_902_cov_60.823163	395	475	0	70	80	0.8750000
NODE_8799_length_902_cov_60.823163	395	475	2	10	80	0.1250000
NODE_8799_length_902_cov_60.823163	448	528	0	21	80	0.2625000
NODE_8799_length_902_cov_60.823163	448	528	2	59	80	0.7375000
NODE_8800_length_902_cov_44.002491	383	463	0	80	80	1.0000000
NODE_8800_length_902_cov_44.002491	436	516	0	80	80	1.0000000
NODE_8801_length_902_cov_41.059776	378	458	6	14	80	0.1750000
NODE_8801_length_902_cov_41.059776	378	458	8	66	80	0.8250000
NODE_8801_length_902_cov_41.059776	431	511	0	42	80	0.5250000
NODE_8801_length_902_cov_41.059776	431	511	6	25	80	0.3125000
NODE_8801_length_902_cov_41.059776	431	511	8	13	80	0.1625000
NODE_8802_length_902_cov_38.952677	372	452	0	80	80	1.0000000
NODE_8802_length_902_cov_38.952677	425	505	0	31	80	0.3875000
NODE_8802_length_902_cov_38.952677	425	505	2	49	80	0.6125000
NODE_8803_length_902_cov_34.156912	373	453	0	80	80	1.0000000
NODE_8803_length_902_cov_34.156912	426	506	0	80	80	1.0000000
NODE_8804_length_902_cov_23.007472	295	375	0	50	80	0.6250000
NODE_8804_length_902_cov_23.007472	295	375	2	30	80	0.3750000
NODE_8804_length_902_cov_23.007472	348	428	0	80	80	1.0000000
NODE_8805_length_902_cov_19.491905	238	291	0	45	53	0.8490566
NODE_8805_length_902_cov_19.491905	238	291	4	8	53	0.1509434
NODE_8805_length_902_cov_19.491905	264	344	0	19	80	0.2375000
NODE_8805_length_902_cov_19.491905	264	344	4	61	80	0.7625000
NODE_8806_length_902_cov_10.794521	214	294	0	80	80	1.0000000
NODE_8806_length_902_cov_10.794521	267	347	0	80	80	1.0000000
NODE_8807_length_902_cov_9.520548	518	598	0	24	80	0.3000000
NODE_8807_length_902_cov_9.520548	518	598	2	56	80	0.7000000
NODE_8807_length_902_cov_9.520548	571	651	0	77	80	0.9625000
NODE_8807_length_902_cov_9.520548	571	651	2	3	80	0.0375000
NODE_8808_length_902_cov_8.323786	337	417	0	80	80	1.0000000
NODE_8808_length_902_cov_8.323786	390	470	0	80	80	1.0000000
NODE_8811_length_902_cov_7.300125	434	514	2	80	80	1.0000000
NODE_8811_length_902_cov_7.300125	487	567	2	80	80	1.0000000
NODE_8812_length_902_cov_4.185554	505	585	0	80	80	1.0000000
NODE_8812_length_902_cov_4.185554	558	588	0	30	30	1.0000000
NODE_8812_length_902_cov_4.185554	610	662	0	52	52	1.0000000
NODE_8830_length_902_cov_0.963885	82	106	2	24	24	1.0000000
NODE_8832_length_901_cov_36.066085	412	490	0	39	78	0.5000000
NODE_8832_length_901_cov_36.066085	412	490	2	39	78	0.5000000
NODE_8832_length_901_cov_36.066085	463	543	0	34	80	0.4250000
NODE_8832_length_901_cov_36.066085	463	543	2	46	80	0.5750000
NODE_8833_length_901_cov_28.129676	377	457	1	29	80	0.3625000
NODE_8833_length_901_cov_28.129676	377	457	2	15	80	0.1875000
NODE_8833_length_901_cov_28.129676	377	457	3	36	80	0.4500000
NODE_8833_length_901_cov_28.129676	430	510	1	76	80	0.9500000
NODE_8833_length_901_cov_28.129676	430	510	2	4	80	0.0500000
NODE_8834_length_901_cov_26.763092	272	352	0	80	80	1.0000000
NODE_8834_length_901_cov_26.763092	325	405	0	80	80	1.0000000
NODE_8834_length_901_cov_26.763092	401	481	0	80	80	1.0000000
NODE_8834_length_901_cov_26.763092	454	534	0	80	80	1.0000000
NODE_8835_length_901_cov_25.628429	369	449	0	80	80	1.0000000
NODE_8835_length_901_cov_25.628429	422	502	0	62	80	0.7750000
NODE_8835_length_901_cov_25.628429	422	502	2	18	80	0.2250000
NODE_8836_length_901_cov_17.857855	408	488	0	46	80	0.5750000
NODE_8836_length_901_cov_17.857855	408	488	2	34	80	0.4250000
NODE_8836_length_901_cov_17.857855	461	541	0	27	80	0.3375000
NODE_8836_length_901_cov_17.857855	461	541	2	53	80	0.6625000
NODE_8837_length_901_cov_16.254364	362	442	4	80	80	1.0000000
NODE_8837_length_901_cov_16.254364	415	495	0	38	80	0.4750000
NODE_8837_length_901_cov_16.254364	415	495	4	42	80	0.5250000
NODE_8838_length_901_cov_8.346633	321	401	0	80	80	1.0000000
NODE_8838_length_901_cov_8.346633	374	454	0	50	80	0.6250000
NODE_8838_length_901_cov_8.346633	374	454	2	30	80	0.3750000
NODE_8840_length_901_cov_6.044888	363	443	2	80	80	1.0000000
NODE_8840_length_901_cov_6.044888	416	496	0	50	80	0.6250000
NODE_8840_length_901_cov_6.044888	416	496	2	30	80	0.3750000
NODE_8845_length_901_cov_3.814214	194	274	0	51	80	0.6375000
NODE_8845_length_901_cov_3.814214	194	274	2	29	80	0.3625000
NODE_8845_length_901_cov_3.814214	247	326	0	79	79	1.0000000
NODE_8857_length_900_cov_30.284644	407	487	0	27	80	0.3375000
NODE_8857_length_900_cov_30.284644	407	487	2	53	80	0.6625000
NODE_8857_length_900_cov_30.284644	460	540	0	80	80	1.0000000
NODE_8858_length_900_cov_29.679151	425	505	0	80	80	1.0000000
NODE_8858_length_900_cov_29.679151	478	558	0	80	80	1.0000000
NODE_8859_length_900_cov_25.963795	321	401	0	80	80	1.0000000
NODE_8859_length_900_cov_25.963795	374	454	0	80	80	1.0000000
NODE_8860_length_900_cov_17.681648	530	606	0	14	76	0.1842105
NODE_8860_length_900_cov_17.681648	530	606	2	62	76	0.8157895
NODE_8860_length_900_cov_17.681648	583	659	0	65	76	0.8552632
NODE_8860_length_900_cov_17.681648	583	659	2	11	76	0.1447368
NODE_8861_length_900_cov_16.294632	316	396	0	21	80	0.2625000
NODE_8861_length_900_cov_16.294632	316	396	6	59	80	0.7375000
NODE_8861_length_900_cov_16.294632	369	449	0	34	80	0.4250000
NODE_8861_length_900_cov_16.294632	369	449	6	46	80	0.5750000
NODE_8863_length_900_cov_5.962547	0	70	10	1	70	0.0142857
NODE_8863_length_900_cov_5.962547	0	70	12	1	70	0.0142857
NODE_8863_length_900_cov_5.962547	0	70	16	2	70	0.0285714
NODE_8863_length_900_cov_5.962547	0	70	18	1	70	0.0142857
NODE_8863_length_900_cov_5.962547	0	70	20	2	70	0.0285714
NODE_8863_length_900_cov_5.962547	0	70	22	4	70	0.0571429
NODE_8863_length_900_cov_5.962547	0	70	26	5	70	0.0714286
NODE_8863_length_900_cov_5.962547	0	70	28	2	70	0.0285714
NODE_8863_length_900_cov_5.962547	0	70	30	5	70	0.0714286
NODE_8863_length_900_cov_5.962547	0	70	34	1	70	0.0142857
NODE_8863_length_900_cov_5.962547	0	70	36	5	70	0.0714286
NODE_8863_length_900_cov_5.962547	0	70	38	6	70	0.0857143
NODE_8863_length_900_cov_5.962547	0	70	40	1	70	0.0142857
NODE_8863_length_900_cov_5.962547	0	70	42	3	70	0.0428571
NODE_8863_length_900_cov_5.962547	0	70	44	31	70	0.4428571
NODE_8863_length_900_cov_5.962547	43	108	30	3	65	0.0461538
NODE_8863_length_900_cov_5.962547	43	108	36	2	65	0.0307692
NODE_8863_length_900_cov_5.962547	43	108	42	1	65	0.0153846
NODE_8863_length_900_cov_5.962547	43	108	44	59	65	0.9076923
NODE_8870_length_900_cov_2.521848	85	165	0	80	80	1.0000000
NODE_8870_length_900_cov_2.521848	138	218	0	80	80	1.0000000
NODE_8879_length_899_cov_45.853750	380	460	0	80	80	1.0000000
NODE_8879_length_899_cov_45.853750	433	516	0	83	83	1.0000000
NODE_8880_length_899_cov_37.758750	381	461	0	80	80	1.0000000
NODE_8880_length_899_cov_37.758750	434	514	0	80	80	1.0000000
NODE_8881_length_899_cov_27.362500	413	493	4	18	80	0.2250000
NODE_8881_length_899_cov_27.362500	413	493	10	62	80	0.7750000
NODE_8881_length_899_cov_27.362500	466	546	0	15	80	0.1875000
NODE_8881_length_899_cov_27.362500	466	546	6	38	80	0.4750000
NODE_8881_length_899_cov_27.362500	466	546	10	27	80	0.3375000
NODE_8882_length_899_cov_20.563750	379	459	0	80	80	1.0000000
NODE_8882_length_899_cov_20.563750	432	507	0	75	75	1.0000000
NODE_8884_length_899_cov_17.130000	319	399	0	80	80	1.0000000
NODE_8884_length_899_cov_17.130000	372	452	0	80	80	1.0000000
NODE_8885_length_899_cov_16.317500	270	350	0	54	80	0.6750000
NODE_8885_length_899_cov_16.317500	270	350	2	10	80	0.1250000
NODE_8885_length_899_cov_16.317500	270	350	4	16	80	0.2000000
NODE_8885_length_899_cov_16.317500	323	403	0	1	80	0.0125000
NODE_8885_length_899_cov_16.317500	323	403	2	10	80	0.1250000
NODE_8885_length_899_cov_16.317500	323	403	4	69	80	0.8625000
NODE_8886_length_899_cov_16.190000	284	364	2	80	80	1.0000000
NODE_8886_length_899_cov_16.190000	337	417	0	27	80	0.3375000
NODE_8886_length_899_cov_16.190000	337	417	2	53	80	0.6625000
NODE_8887_length_899_cov_13.873750	317	397	0	80	80	1.0000000
NODE_8887_length_899_cov_13.873750	370	450	0	80	80	1.0000000
NODE_8888_length_899_cov_12.957500	240	320	0	80	80	1.0000000
NODE_8888_length_899_cov_12.957500	293	373	0	80	80	1.0000000
NODE_8889_length_899_cov_12.516250	387	467	0	75	80	0.9375000
NODE_8889_length_899_cov_12.516250	387	467	2	5	80	0.0625000
NODE_8889_length_899_cov_12.516250	440	520	0	22	80	0.2750000
NODE_8889_length_899_cov_12.516250	440	520	2	58	80	0.7250000
NODE_8890_length_899_cov_10.846250	348	428	0	80	80	1.0000000
NODE_8890_length_899_cov_10.846250	401	485	0	84	84	1.0000000
NODE_8891_length_899_cov_9.185000	347	427	0	80	80	1.0000000
NODE_8891_length_899_cov_9.185000	400	480	0	80	80	1.0000000
NODE_8892_length_899_cov_8.655000	498	578	0	80	80	1.0000000
NODE_8892_length_899_cov_8.655000	551	631	0	80	80	1.0000000
NODE_8893_length_899_cov_3.551250	0	54	1	3	54	0.0555556
NODE_8893_length_899_cov_3.551250	0	54	3	8	54	0.1481481
NODE_8893_length_899_cov_3.551250	0	54	4	3	54	0.0555556
NODE_8893_length_899_cov_3.551250	0	54	8	11	54	0.2037037
NODE_8893_length_899_cov_3.551250	0	54	11	1	54	0.0185185
NODE_8893_length_899_cov_3.551250	0	54	13	12	54	0.2222222
NODE_8893_length_899_cov_3.551250	0	54	16	3	54	0.0555556
NODE_8893_length_899_cov_3.551250	0	54	17	10	54	0.1851852
NODE_8893_length_899_cov_3.551250	0	54	18	3	54	0.0555556
NODE_8893_length_899_cov_3.551250	27	107	13	11	80	0.1375000
NODE_8893_length_899_cov_3.551250	27	107	16	3	80	0.0375000
NODE_8893_length_899_cov_3.551250	27	107	17	10	80	0.1250000
NODE_8893_length_899_cov_3.551250	27	107	18	19	80	0.2375000
NODE_8893_length_899_cov_3.551250	27	107	20	4	80	0.0500000
NODE_8893_length_899_cov_3.551250	27	107	22	6	80	0.0750000
NODE_8893_length_899_cov_3.551250	27	107	24	6	80	0.0750000
NODE_8893_length_899_cov_3.551250	27	107	26	21	80	0.2625000
NODE_8893_length_899_cov_3.551250	103	183	11	4	80	0.0500000
NODE_8893_length_899_cov_3.551250	103	183	13	3	80	0.0375000
NODE_8893_length_899_cov_3.551250	103	183	15	1	80	0.0125000
NODE_8893_length_899_cov_3.551250	103	183	18	14	80	0.1750000
NODE_8893_length_899_cov_3.551250	103	183	19	17	80	0.2125000
NODE_8893_length_899_cov_3.551250	103	183	20	4	80	0.0500000
NODE_8893_length_899_cov_3.551250	103	183	24	22	80	0.2750000
NODE_8893_length_899_cov_3.551250	103	183	26	11	80	0.1375000
NODE_8893_length_899_cov_3.551250	103	183	28	4	80	0.0500000
NODE_8893_length_899_cov_3.551250	156	179	13	3	23	0.1304348
NODE_8893_length_899_cov_3.551250	156	179	15	1	23	0.0434783
NODE_8893_length_899_cov_3.551250	156	179	18	14	23	0.6086956
NODE_8893_length_899_cov_3.551250	156	179	19	5	23	0.2173913
NODE_8914_length_898_cov_52.405507	299	379	0	5	80	0.0625000
NODE_8914_length_898_cov_52.405507	299	379	2	28	80	0.3500000
NODE_8914_length_898_cov_52.405507	299	379	4	47	80	0.5875000
NODE_8914_length_898_cov_52.405507	352	432	0	58	80	0.7250000
NODE_8914_length_898_cov_52.405507	352	432	2	22	80	0.2750000
NODE_8914_length_898_cov_52.405507	428	508	0	50	80	0.6250000
NODE_8914_length_898_cov_52.405507	428	508	4	30	80	0.3750000
NODE_8914_length_898_cov_52.405507	481	561	4	64	80	0.8000000
NODE_8914_length_898_cov_52.405507	481	561	6	16	80	0.2000000
NODE_8915_length_898_cov_44.973717	363	443	0	8	80	0.1000000
NODE_8915_length_898_cov_44.973717	363	443	2	72	80	0.9000000
NODE_8915_length_898_cov_44.973717	416	496	0	27	80	0.3375000
NODE_8915_length_898_cov_44.973717	416	496	2	53	80	0.6625000
NODE_8916_length_898_cov_38.269086	425	505	0	10	80	0.1250000
NODE_8916_length_898_cov_38.269086	425	505	2	16	80	0.2000000
NODE_8916_length_898_cov_38.269086	425	505	4	54	80	0.6750000
NODE_8916_length_898_cov_38.269086	478	558	0	57	80	0.7125000
NODE_8916_length_898_cov_38.269086	478	558	2	5	80	0.0625000
NODE_8916_length_898_cov_38.269086	478	558	4	18	80	0.2250000
NODE_8917_length_898_cov_27.006258	465	545	0	17	80	0.2125000
NODE_8917_length_898_cov_27.006258	465	545	2	63	80	0.7875000
NODE_8917_length_898_cov_27.006258	518	598	0	46	80	0.5750000
NODE_8917_length_898_cov_27.006258	518	598	2	34	80	0.4250000
NODE_8918_length_898_cov_25.902378	185	265	0	10	80	0.1250000
NODE_8918_length_898_cov_25.902378	185	265	2	38	80	0.4750000
NODE_8918_length_898_cov_25.902378	185	265	4	32	80	0.4000000
NODE_8918_length_898_cov_25.902378	238	318	0	63	80	0.7875000
NODE_8918_length_898_cov_25.902378	238	318	2	17	80	0.2125000
NODE_8918_length_898_cov_25.902378	314	394	0	6	80	0.0750000
NODE_8918_length_898_cov_25.902378	314	394	4	74	80	0.9250000
NODE_8918_length_898_cov_25.902378	367	447	0	53	80	0.6625000
NODE_8918_length_898_cov_25.902378	367	447	4	27	80	0.3375000
NODE_8919_length_898_cov_25.209011	368	448	2	80	80	1.0000000
NODE_8919_length_898_cov_25.209011	421	501	0	34	80	0.4250000
NODE_8919_length_898_cov_25.209011	421	501	2	46	80	0.5750000
NODE_8920_length_898_cov_21.923655	325	405	0	80	80	1.0000000
NODE_8920_length_898_cov_21.923655	378	458	0	80	80	1.0000000
NODE_8921_length_898_cov_21.065081	306	386	0	1	80	0.0125000
NODE_8921_length_898_cov_21.065081	306	386	2	79	80	0.9875000
NODE_8921_length_898_cov_21.065081	359	439	0	42	80	0.5250000
NODE_8921_length_898_cov_21.065081	359	439	2	38	80	0.4750000
NODE_8922_length_898_cov_20.954944	374	454	0	17	80	0.2125000
NODE_8922_length_898_cov_20.954944	374	454	1	16	80	0.2000000
NODE_8922_length_898_cov_20.954944	374	454	2	47	80	0.5875000
NODE_8922_length_898_cov_20.954944	427	507	0	70	80	0.8750000
NODE_8922_length_898_cov_20.954944	427	507	1	10	80	0.1250000
NODE_8923_length_898_cov_17.387985	398	478	0	80	80	1.0000000
NODE_8923_length_898_cov_17.387985	451	531	0	80	80	1.0000000
NODE_8924_length_898_cov_17.252816	265	345	2	8	80	0.1000000
NODE_8924_length_898_cov_17.252816	265	345	4	1	80	0.0125000
NODE_8924_length_898_cov_17.252816	265	345	5	9	80	0.1125000
NODE_8924_length_898_cov_17.252816	265	345	6	5	80	0.0625000
NODE_8924_length_898_cov_17.252816	265	345	7	40	80	0.5000000
NODE_8924_length_898_cov_17.252816	265	345	8	17	80	0.2125000
NODE_8924_length_898_cov_17.252816	318	398	0	33	80	0.4125000
NODE_8924_length_898_cov_17.252816	318	398	2	6	80	0.0750000
NODE_8924_length_898_cov_17.252816	318	398	6	19	80	0.2375000
NODE_8924_length_898_cov_17.252816	318	398	7	5	80	0.0625000
NODE_8924_length_898_cov_17.252816	318	398	8	17	80	0.2125000
NODE_8926_length_898_cov_13.152691	455	535	0	26	80	0.3250000
NODE_8926_length_898_cov_13.152691	455	535	2	54	80	0.6750000
NODE_8926_length_898_cov_13.152691	508	588	0	43	80	0.5375000
NODE_8926_length_898_cov_13.152691	508	588	2	37	80	0.4625000
NODE_8927_length_898_cov_12.612015	375	455	4	80	80	1.0000000
NODE_8927_length_898_cov_12.612015	428	508	0	18	80	0.2250000
NODE_8927_length_898_cov_12.612015	428	508	4	62	80	0.7750000
NODE_8928_length_898_cov_12.498123	428	508	0	6	80	0.0750000
NODE_8928_length_898_cov_12.498123	428	508	2	74	80	0.9250000
NODE_8928_length_898_cov_12.498123	481	561	0	59	80	0.7375000
NODE_8928_length_898_cov_12.498123	481	561	2	21	80	0.2625000
NODE_8932_length_898_cov_1.790989	0	56	0	56	56	1.0000000
NODE_8932_length_898_cov_1.790989	29	93	0	62	64	0.9687500
NODE_8932_length_898_cov_1.790989	29	93	2	2	64	0.0312500
NODE_8944_length_897_cov_63.921053	350	430	0	75	80	0.9375000
NODE_8944_length_897_cov_63.921053	350	430	2	5	80	0.0625000
NODE_8944_length_897_cov_63.921053	403	483	0	22	80	0.2750000
NODE_8944_length_897_cov_63.921053	403	483	2	58	80	0.7250000
NODE_8945_length_897_cov_58.921053	316	396	0	27	80	0.3375000
NODE_8945_length_897_cov_58.921053	316	396	14	53	80	0.6625000
NODE_8945_length_897_cov_58.921053	369	449	0	10	80	0.1250000
NODE_8945_length_897_cov_58.921053	369	449	14	70	80	0.8750000
NODE_8946_length_897_cov_35.946115	324	404	0	39	80	0.4875000
NODE_8946_length_897_cov_35.946115	324	404	2	41	80	0.5125000
NODE_8946_length_897_cov_35.946115	377	457	0	80	80	1.0000000
NODE_8947_length_897_cov_25.548872	238	318	0	21	80	0.2625000
NODE_8947_length_897_cov_25.548872	238	318	4	16	80	0.2000000
NODE_8947_length_897_cov_25.548872	238	318	8	5	80	0.0625000
NODE_8947_length_897_cov_25.548872	238	318	9	38	80	0.4750000
NODE_8947_length_897_cov_25.548872	291	371	4	37	80	0.4625000
NODE_8947_length_897_cov_25.548872	291	371	8	21	80	0.2625000
NODE_8947_length_897_cov_25.548872	291	371	9	22	80	0.2750000
NODE_8948_length_897_cov_24.913534	399	479	0	80	80	1.0000000
NODE_8948_length_897_cov_24.913534	452	532	0	80	80	1.0000000
NODE_8949_length_897_cov_21.839599	308	388	0	80	80	1.0000000
NODE_8949_length_897_cov_21.839599	361	441	0	80	80	1.0000000
NODE_8950_length_897_cov_19.355890	489	569	1	39	80	0.4875000
NODE_8950_length_897_cov_19.355890	489	569	2	41	80	0.5125000
NODE_8950_length_897_cov_19.355890	542	622	1	80	80	1.0000000
NODE_8951_length_897_cov_16.295739	209	289	1	9	80	0.1125000
NODE_8951_length_897_cov_16.295739	209	289	3	71	80	0.8875000
NODE_8951_length_897_cov_16.295739	262	342	0	7	80	0.0875000
NODE_8951_length_897_cov_16.295739	262	342	1	50	80	0.6250000
NODE_8951_length_897_cov_16.295739	262	342	3	23	80	0.2875000
NODE_8952_length_897_cov_14.766917	395	475	2	80	80	1.0000000
NODE_8952_length_897_cov_14.766917	448	528	0	45	80	0.5625000
NODE_8952_length_897_cov_14.766917	448	528	2	35	80	0.4375000
NODE_8953_length_897_cov_14.219298	253	333	0	80	80	1.0000000
NODE_8953_length_897_cov_14.219298	306	386	0	80	80	1.0000000
NODE_8954_length_897_cov_11.116541	182	262	0	38	80	0.4750000
NODE_8954_length_897_cov_11.116541	182	262	3	2	80	0.0250000
NODE_8954_length_897_cov_11.116541	182	262	4	3	80	0.0375000
NODE_8954_length_897_cov_11.116541	182	262	5	1	80	0.0125000
NODE_8954_length_897_cov_11.116541	182	262	8	36	80	0.4500000
NODE_8954_length_897_cov_11.116541	235	315	8	80	80	1.0000000
NODE_8955_length_897_cov_8.211779	303	383	0	80	80	1.0000000
NODE_8955_length_897_cov_8.211779	356	436	0	80	80	1.0000000
NODE_8973_length_896_cov_48.249686	397	477	0	80	80	1.0000000
NODE_8973_length_896_cov_48.249686	450	530	0	80	80	1.0000000
NODE_8974_length_896_cov_24.824341	213	293	0	80	80	1.0000000
NODE_8974_length_896_cov_24.824341	266	346	0	80	80	1.0000000
NODE_8975_length_896_cov_23.130489	333	413	0	80	80	1.0000000
NODE_8975_length_896_cov_23.130489	386	466	0	80	80	1.0000000
NODE_8975_length_896_cov_23.130489	462	542	0	80	80	1.0000000
NODE_8975_length_896_cov_23.130489	515	595	0	80	80	1.0000000
NODE_8976_length_896_cov_20.673777	361	441	0	2	80	0.0250000
NODE_8976_length_896_cov_20.673777	361	441	19	1	80	0.0125000
NODE_8976_length_896_cov_20.673777	361	441	20	7	80	0.0875000
NODE_8976_length_896_cov_20.673777	361	441	28	3	80	0.0375000
NODE_8976_length_896_cov_20.673777	361	441	29	34	80	0.4250000
NODE_8976_length_896_cov_20.673777	361	441	30	33	80	0.4125000
NODE_8976_length_896_cov_20.673777	414	497	0	31	83	0.3734940
NODE_8976_length_896_cov_20.673777	414	497	18	16	83	0.1927711
NODE_8976_length_896_cov_20.673777	414	497	27	1	83	0.0120482
NODE_8976_length_896_cov_20.673777	414	497	28	10	83	0.1204819
NODE_8976_length_896_cov_20.673777	414	497	30	25	83	0.3012048
NODE_8977_length_896_cov_18.979925	418	498	0	39	80	0.4875000
NODE_8977_length_896_cov_18.979925	418	498	2	41	80	0.5125000
NODE_8977_length_896_cov_18.979925	471	551	0	42	80	0.5250000
NODE_8977_length_896_cov_18.979925	471	551	2	38	80	0.4750000
NODE_8978_length_896_cov_15.875784	340	420	0	80	80	1.0000000
NODE_8978_length_896_cov_15.875784	393	473	0	80	80	1.0000000
NODE_8980_length_896_cov_10.646173	337	417	0	80	80	1.0000000
NODE_8980_length_896_cov_10.646173	390	470	0	80	80	1.0000000
NODE_8981_length_896_cov_10.351317	327	407	2	36	80	0.4500000
NODE_8981_length_896_cov_10.351317	327	407	3	25	80	0.3125000
NODE_8981_length_896_cov_10.351317	327	407	4	19	80	0.2375000
NODE_8981_length_896_cov_10.351317	380	460	0	34	80	0.4250000
NODE_8981_length_896_cov_10.351317	380	460	2	46	80	0.5750000
NODE_8982_length_896_cov_9.754078	411	491	2	55	80	0.6875000
NODE_8982_length_896_cov_9.754078	411	491	4	25	80	0.3125000
NODE_8982_length_896_cov_9.754078	464	544	0	4	80	0.0500000
NODE_8982_length_896_cov_9.754078	464	544	2	50	80	0.6250000
NODE_8982_length_896_cov_9.754078	464	544	4	26	80	0.3250000
NODE_8983_length_896_cov_8.069009	340	422	0	41	82	0.5000000
NODE_8983_length_896_cov_8.069009	340	422	2	41	82	0.5000000
NODE_8983_length_896_cov_8.069009	395	475	0	80	80	1.0000000
NODE_8986_length_896_cov_4.939774	384	464	0	80	80	1.0000000
NODE_8986_length_896_cov_4.939774	437	517	0	80	80	1.0000000
NODE_9005_length_895_cov_54.949749	378	458	2	36	80	0.4500000
NODE_9005_length_895_cov_54.949749	378	458	8	44	80	0.5500000
NODE_9005_length_895_cov_54.949749	431	511	4	11	80	0.1375000
NODE_9005_length_895_cov_54.949749	431	511	6	10	80	0.1250000
NODE_9005_length_895_cov_54.949749	431	511	8	34	80	0.4250000
NODE_9005_length_895_cov_54.949749	431	511	10	25	80	0.3125000
NODE_9006_length_895_cov_53.945980	306	386	2	13	80	0.1625000
NODE_9006_length_895_cov_53.945980	306	386	3	29	80	0.3625000
NODE_9006_length_895_cov_53.945980	306	386	4	18	80	0.2250000
NODE_9006_length_895_cov_53.945980	306	386	5	20	80	0.2500000
NODE_9006_length_895_cov_53.945980	359	439	2	25	80	0.3125000
NODE_9006_length_895_cov_53.945980	359	439	3	3	80	0.0375000
NODE_9006_length_895_cov_53.945980	359	439	4	32	80	0.4000000
NODE_9006_length_895_cov_53.945980	359	439	5	20	80	0.2500000
NODE_9007_length_895_cov_48.915829	369	449	0	25	80	0.3125000
NODE_9007_length_895_cov_48.915829	369	449	4	55	80	0.6875000
NODE_9007_length_895_cov_48.915829	422	502	0	40	80	0.5000000
NODE_9007_length_895_cov_48.915829	422	502	2	2	80	0.0250000
NODE_9007_length_895_cov_48.915829	422	502	4	38	80	0.4750000
NODE_9007_length_895_cov_48.915829	498	578	0	2	80	0.0250000
NODE_9007_length_895_cov_48.915829	498	578	2	78	80	0.9750000
NODE_9007_length_895_cov_48.915829	551	631	0	24	80	0.3000000
NODE_9007_length_895_cov_48.915829	551	631	2	56	80	0.7000000
NODE_9008_length_895_cov_38.347990	452	532	0	48	80	0.6000000
NODE_9008_length_895_cov_38.347990	452	532	2	32	80	0.4000000
NODE_9008_length_895_cov_38.347990	505	585	2	80	80	1.0000000
NODE_9009_length_895_cov_33.716080	418	499	0	81	81	1.0000000
NODE_9009_length_895_cov_33.716080	472	552	0	80	80	1.0000000
NODE_9010_length_895_cov_21.630653	392	468	0	6	76	0.0789474
NODE_9010_length_895_cov_21.630653	392	468	1	2	76	0.0263158
NODE_9010_length_895_cov_21.630653	392	468	2	68	76	0.8947368
NODE_9010_length_895_cov_21.630653	441	521	0	3	80	0.0375000
NODE_9010_length_895_cov_21.630653	441	521	2	77	80	0.9625000
NODE_9011_length_895_cov_19.932161	331	411	6	12	80	0.1500000
NODE_9011_length_895_cov_19.932161	331	411	10	16	80	0.2000000
NODE_9011_length_895_cov_19.932161	331	411	12	52	80	0.6500000
NODE_9011_length_895_cov_19.932161	384	464	0	11	80	0.1375000
NODE_9011_length_895_cov_19.932161	384	464	5	1	80	0.0125000
NODE_9011_length_895_cov_19.932161	384	464	6	20	80	0.2500000
NODE_9011_length_895_cov_19.932161	384	464	10	37	80	0.4625000
NODE_9011_length_895_cov_19.932161	384	464	12	11	80	0.1375000
NODE_9011_length_895_cov_19.932161	460	540	0	70	80	0.8750000
NODE_9011_length_895_cov_19.932161	460	540	4	10	80	0.1250000
NODE_9011_length_895_cov_19.932161	513	593	0	17	80	0.2125000
NODE_9011_length_895_cov_19.932161	513	593	4	63	80	0.7875000
NODE_9012_length_895_cov_16.037688	403	479	6	41	76	0.5394737
NODE_9012_length_895_cov_16.037688	403	479	8	35	76	0.4605263
NODE_9012_length_895_cov_16.037688	452	532	2	48	80	0.6000000
NODE_9012_length_895_cov_16.037688	452	532	7	1	80	0.0125000
NODE_9012_length_895_cov_16.037688	452	532	8	31	80	0.3875000
NODE_9013_length_895_cov_13.003769	372	452	0	19	80	0.2375000
NODE_9013_length_895_cov_13.003769	372	452	2	61	80	0.7625000
NODE_9013_length_895_cov_13.003769	425	491	0	58	66	0.8787879
NODE_9013_length_895_cov_13.003769	425	491	2	8	66	0.1212121
NODE_9014_length_895_cov_12.736181	280	360	0	35	80	0.4375000
NODE_9014_length_895_cov_12.736181	280	360	2	45	80	0.5625000
NODE_9014_length_895_cov_12.736181	333	413	0	6	80	0.0750000
NODE_9014_length_895_cov_12.736181	333	413	2	74	80	0.9250000
NODE_9015_length_895_cov_11.090452	505	585	0	23	80	0.2875000
NODE_9015_length_895_cov_11.090452	505	585	4	56	80	0.7000000
NODE_9015_length_895_cov_11.090452	505	585	6	1	80	0.0125000
NODE_9015_length_895_cov_11.090452	558	638	2	31	80	0.3875000
NODE_9015_length_895_cov_11.090452	558	638	4	26	80	0.3250000
NODE_9015_length_895_cov_11.090452	558	638	6	23	80	0.2875000
NODE_9016_length_895_cov_9.266332	468	548	4	80	80	1.0000000
NODE_9016_length_895_cov_9.266332	521	601	0	46	80	0.5750000
NODE_9016_length_895_cov_9.266332	521	601	4	34	80	0.4250000
NODE_9018_length_895_cov_5.659548	472	552	0	80	80	1.0000000
NODE_9018_length_895_cov_5.659548	525	605	0	80	80	1.0000000
NODE_9019_length_895_cov_5.383166	42	123	2	57	81	0.7037037
NODE_9019_length_895_cov_5.383166	42	123	4	24	81	0.2962963
NODE_9030_length_894_cov_60.153459	446	526	0	80	80	1.0000000
NODE_9030_length_894_cov_60.153459	499	579	0	80	80	1.0000000
NODE_9031_length_894_cov_49.618868	373	453	0	42	80	0.5250000
NODE_9031_length_894_cov_49.618868	373	453	2	38	80	0.4750000
NODE_9031_length_894_cov_49.618868	426	506	0	80	80	1.0000000
NODE_9032_length_894_cov_33.228931	459	539	1	1	80	0.0125000
NODE_9032_length_894_cov_33.228931	459	539	3	6	80	0.0750000
NODE_9032_length_894_cov_33.228931	459	539	4	51	80	0.6375000
NODE_9032_length_894_cov_33.228931	459	539	5	1	80	0.0125000
NODE_9032_length_894_cov_33.228931	459	539	6	21	80	0.2625000
NODE_9032_length_894_cov_33.228931	512	592	4	61	80	0.7625000
NODE_9032_length_894_cov_33.228931	512	592	6	19	80	0.2375000
NODE_9033_length_894_cov_31.933333	411	491	0	80	80	1.0000000
NODE_9033_length_894_cov_31.933333	464	544	0	80	80	1.0000000
NODE_9034_length_894_cov_30.499371	270	350	0	80	80	1.0000000
NODE_9034_length_894_cov_30.499371	323	403	0	80	80	1.0000000
NODE_9034_length_894_cov_30.499371	399	479	0	80	80	1.0000000
NODE_9034_length_894_cov_30.499371	452	532	0	29	80	0.3625000
NODE_9034_length_894_cov_30.499371	452	532	2	51	80	0.6375000
NODE_9035_length_894_cov_23.046541	79	159	0	80	80	1.0000000
NODE_9035_length_894_cov_23.046541	132	212	0	80	80	1.0000000
NODE_9036_length_894_cov_22.266667	381	461	0	29	80	0.3625000
NODE_9036_length_894_cov_22.266667	381	461	5	1	80	0.0125000
NODE_9036_length_894_cov_22.266667	381	461	7	12	80	0.1500000
NODE_9036_length_894_cov_22.266667	381	461	9	35	80	0.4375000
NODE_9036_length_894_cov_22.266667	381	461	10	3	80	0.0375000
NODE_9036_length_894_cov_22.266667	434	514	8	10	80	0.1250000
NODE_9036_length_894_cov_22.266667	434	514	9	24	80	0.3000000
NODE_9036_length_894_cov_22.266667	434	514	10	46	80	0.5750000
NODE_9037_length_894_cov_21.997484	332	412	0	80	80	1.0000000
NODE_9037_length_894_cov_21.997484	385	465	0	80	80	1.0000000
NODE_9038_length_894_cov_21.205031	319	399	0	80	80	1.0000000
NODE_9038_length_894_cov_21.205031	372	452	0	80	80	1.0000000
NODE_9038_length_894_cov_21.205031	448	528	0	80	80	1.0000000
NODE_9038_length_894_cov_21.205031	501	581	0	80	80	1.0000000
NODE_9039_length_894_cov_21.132075	422	502	1	61	80	0.7625000
NODE_9039_length_894_cov_21.132075	422	502	2	19	80	0.2375000
NODE_9039_length_894_cov_21.132075	475	555	0	29	80	0.3625000
NODE_9039_length_894_cov_21.132075	475	555	1	51	80	0.6375000
NODE_9040_length_894_cov_15.598742	338	418	0	77	80	0.9625000
NODE_9040_length_894_cov_15.598742	338	418	1	3	80	0.0375000
NODE_9040_length_894_cov_15.598742	391	471	0	24	80	0.3000000
NODE_9040_length_894_cov_15.598742	391	471	1	32	80	0.4000000
NODE_9040_length_894_cov_15.598742	391	471	2	24	80	0.3000000
NODE_9041_length_894_cov_14.079245	344	424	2	16	80	0.2000000
NODE_9041_length_894_cov_14.079245	344	424	4	64	80	0.8000000
NODE_9041_length_894_cov_14.079245	397	477	2	54	80	0.6750000
NODE_9041_length_894_cov_14.079245	397	477	4	26	80	0.3250000
NODE_9042_length_894_cov_13.031447	336	416	0	80	80	1.0000000
NODE_9042_length_894_cov_13.031447	389	469	0	80	80	1.0000000
NODE_9043_length_894_cov_13.031447	353	433	0	25	80	0.3125000
NODE_9043_length_894_cov_13.031447	353	433	2	55	80	0.6875000
NODE_9043_length_894_cov_13.031447	406	486	0	55	80	0.6875000
NODE_9043_length_894_cov_13.031447	406	486	2	25	80	0.3125000
NODE_9044_length_894_cov_9.706918	330	410	0	80	80	1.0000000
NODE_9045_length_894_cov_6.963522	378	458	0	80	80	1.0000000
NODE_9045_length_894_cov_6.963522	431	511	0	80	80	1.0000000
NODE_9046_length_894_cov_4.993711	365	445	0	80	80	1.0000000
NODE_9046_length_894_cov_4.993711	418	498	0	80	80	1.0000000
NODE_9066_length_893_cov_59.134761	261	341	4	31	80	0.3875000
NODE_9066_length_893_cov_59.134761	261	341	16	6	80	0.0750000
NODE_9066_length_893_cov_59.134761	261	341	20	43	80	0.5375000
NODE_9066_length_893_cov_59.134761	314	394	16	59	80	0.7375000
NODE_9066_length_893_cov_59.134761	314	394	20	21	80	0.2625000
NODE_9067_length_893_cov_58.991184	388	468	0	10	80	0.1250000
NODE_9067_length_893_cov_58.991184	388	468	3	7	80	0.0875000
NODE_9067_length_893_cov_58.991184	388	468	6	26	80	0.3250000
NODE_9067_length_893_cov_58.991184	388	468	7	1	80	0.0125000
NODE_9067_length_893_cov_58.991184	388	468	8	36	80	0.4500000
NODE_9067_length_893_cov_58.991184	441	521	0	24	80	0.3000000
NODE_9067_length_893_cov_58.991184	441	521	2	1	80	0.0125000
NODE_9067_length_893_cov_58.991184	441	521	8	55	80	0.6875000
NODE_9067_length_893_cov_58.991184	517	597	0	10	80	0.1250000
NODE_9067_length_893_cov_58.991184	517	597	2	17	80	0.2125000
NODE_9067_length_893_cov_58.991184	517	597	4	53	80	0.6625000
NODE_9067_length_893_cov_58.991184	570	650	0	19	80	0.2375000
NODE_9067_length_893_cov_58.991184	570	650	2	33	80	0.4125000
NODE_9067_length_893_cov_58.991184	570	650	4	28	80	0.3500000
NODE_9068_length_893_cov_55.644836	434	514	0	31	80	0.3875000
NODE_9068_length_893_cov_55.644836	434	514	2	49	80	0.6125000
NODE_9068_length_893_cov_55.644836	487	567	0	80	80	1.0000000
NODE_9068_length_893_cov_55.644836	563	643	0	80	80	1.0000000
NODE_9068_length_893_cov_55.644836	616	696	0	80	80	1.0000000
NODE_9069_length_893_cov_54.803526	479	559	12	80	80	1.0000000
NODE_9069_length_893_cov_54.803526	532	612	0	39	80	0.4875000
NODE_9069_length_893_cov_54.803526	532	612	12	41	80	0.5125000
NODE_9070_length_893_cov_38.147355	391	471	0	80	80	1.0000000
NODE_9070_length_893_cov_38.147355	444	524	0	80	80	1.0000000
NODE_9071_length_893_cov_33.690176	387	467	0	2	80	0.0250000
NODE_9071_length_893_cov_33.690176	387	467	2	38	80	0.4750000
NODE_9071_length_893_cov_33.690176	387	467	4	40	80	0.5000000
NODE_9071_length_893_cov_33.690176	440	520	0	28	80	0.3500000
NODE_9071_length_893_cov_33.690176	440	520	2	27	80	0.3375000
NODE_9071_length_893_cov_33.690176	440	520	4	25	80	0.3125000
NODE_9072_length_893_cov_32.162469	524	604	0	36	80	0.4500000
NODE_9072_length_893_cov_32.162469	524	604	2	44	80	0.5500000
NODE_9072_length_893_cov_32.162469	577	657	0	6	80	0.0750000
NODE_9072_length_893_cov_32.162469	577	657	2	74	80	0.9250000
NODE_9073_length_893_cov_31.916877	344	424	0	80	80	1.0000000
NODE_9073_length_893_cov_31.916877	397	477	0	80	80	1.0000000
NODE_9074_length_893_cov_28.693955	437	517	0	80	80	1.0000000
NODE_9074_length_893_cov_28.693955	490	570	0	80	80	1.0000000
NODE_9075_length_893_cov_23.564232	363	443	0	80	80	1.0000000
NODE_9075_length_893_cov_23.564232	416	496	0	80	80	1.0000000
NODE_9076_length_893_cov_22.633501	272	352	2	38	80	0.4750000
NODE_9076_length_893_cov_22.633501	272	352	4	42	80	0.5250000
NODE_9076_length_893_cov_22.633501	272	352	2	38	80	0.4750000
NODE_9076_length_893_cov_22.633501	272	352	4	42	80	0.5250000
NODE_9076_length_893_cov_22.633501	272	352	2	38	80	0.4750000
NODE_9076_length_893_cov_22.633501	272	352	4	42	80	0.5250000
NODE_9076_length_893_cov_22.633501	325	405	0	50	80	0.6250000
NODE_9076_length_893_cov_22.633501	325	405	2	9	80	0.1125000
NODE_9076_length_893_cov_22.633501	325	405	4	21	80	0.2625000
NODE_9076_length_893_cov_22.633501	325	405	0	50	80	0.6250000
NODE_9076_length_893_cov_22.633501	325	405	2	9	80	0.1125000
NODE_9076_length_893_cov_22.633501	325	405	4	21	80	0.2625000
NODE_9076_length_893_cov_22.633501	325	405	0	50	80	0.6250000
NODE_9076_length_893_cov_22.633501	325	405	2	9	80	0.1125000
NODE_9076_length_893_cov_22.633501	325	405	4	21	80	0.2625000
NODE_9076_length_893_cov_22.633501	401	481	0	38	80	0.4750000
NODE_9076_length_893_cov_22.633501	401	481	4	26	80	0.3250000
NODE_9076_length_893_cov_22.633501	401	481	6	16	80	0.2000000
NODE_9076_length_893_cov_22.633501	454	534	4	11	80	0.1375000
NODE_9076_length_893_cov_22.633501	454	534	6	69	80	0.8625000
NODE_9077_length_893_cov_22.403023	453	533	0	19	80	0.2375000
NODE_9077_length_893_cov_22.403023	453	533	4	7	80	0.0875000
NODE_9077_length_893_cov_22.403023	453	533	6	54	80	0.6750000
NODE_9077_length_893_cov_22.403023	506	586	0	32	80	0.4000000
NODE_9077_length_893_cov_22.403023	506	586	4	7	80	0.0875000
NODE_9077_length_893_cov_22.403023	506	586	6	41	80	0.5125000
NODE_9078_length_893_cov_19.423174	298	378	0	5	80	0.0625000
NODE_9078_length_893_cov_19.423174	298	378	4	33	80	0.4125000
NODE_9078_length_893_cov_19.423174	298	378	5	7	80	0.0875000
NODE_9078_length_893_cov_19.423174	298	378	6	35	80	0.4375000
NODE_9078_length_893_cov_19.423174	351	431	0	6	80	0.0750000
NODE_9078_length_893_cov_19.423174	351	431	2	23	80	0.2875000
NODE_9078_length_893_cov_19.423174	351	431	5	31	80	0.3875000
NODE_9078_length_893_cov_19.423174	351	431	6	20	80	0.2500000
NODE_9078_length_893_cov_19.423174	427	507	0	9	80	0.1125000
NODE_9078_length_893_cov_19.423174	427	507	2	7	80	0.0875000
NODE_9078_length_893_cov_19.423174	427	507	4	7	80	0.0875000
NODE_9078_length_893_cov_19.423174	427	507	6	40	80	0.5000000
NODE_9078_length_893_cov_19.423174	427	507	10	3	80	0.0375000
NODE_9078_length_893_cov_19.423174	427	507	12	14	80	0.1750000
NODE_9078_length_893_cov_19.423174	480	560	6	10	80	0.1250000
NODE_9078_length_893_cov_19.423174	480	560	8	10	80	0.1250000
NODE_9078_length_893_cov_19.423174	480	560	10	20	80	0.2500000
NODE_9078_length_893_cov_19.423174	480	560	12	40	80	0.5000000
NODE_9079_length_893_cov_19.389169	360	440	0	25	80	0.3125000
NODE_9079_length_893_cov_19.389169	360	440	14	55	80	0.6875000
NODE_9079_length_893_cov_19.389169	413	493	14	69	80	0.8625000
NODE_9079_length_893_cov_19.389169	413	493	16	11	80	0.1375000
NODE_9079_length_893_cov_19.389169	489	569	2	64	80	0.8000000
NODE_9079_length_893_cov_19.389169	489	569	15	1	80	0.0125000
NODE_9079_length_893_cov_19.389169	489	569	16	15	80	0.1875000
NODE_9079_length_893_cov_19.389169	542	622	0	11	80	0.1375000
NODE_9079_length_893_cov_19.389169	542	622	2	69	80	0.8625000
NODE_9080_length_893_cov_18.152393	394	474	0	16	80	0.2000000
NODE_9080_length_893_cov_18.152393	394	474	2	5	80	0.0625000
NODE_9080_length_893_cov_18.152393	394	474	3	59	80	0.7375000
NODE_9080_length_893_cov_18.152393	447	527	1	14	80	0.1750000
NODE_9080_length_893_cov_18.152393	447	527	3	66	80	0.8250000
NODE_9081_length_893_cov_15.960957	442	522	4	80	80	1.0000000
NODE_9081_length_893_cov_15.960957	495	575	0	41	80	0.5125000
NODE_9081_length_893_cov_15.960957	495	575	4	39	80	0.4875000
NODE_9082_length_893_cov_13.119647	473	553	0	80	80	1.0000000
NODE_9082_length_893_cov_13.119647	526	606	0	80	80	1.0000000
NODE_9084_length_893_cov_5.549118	353	415	0	24	62	0.3870968
NODE_9084_length_893_cov_5.549118	353	415	4	19	62	0.3064516
NODE_9084_length_893_cov_5.549118	353	415	6	19	62	0.3064516
NODE_9100_length_893_cov_1.141058	28	108	6	11	80	0.1375000
NODE_9100_length_893_cov_1.141058	28	108	8	4	80	0.0500000
NODE_9100_length_893_cov_1.141058	28	108	10	65	80	0.8125000
NODE_9104_length_892_cov_74.968474	333	413	1	80	80	1.0000000
NODE_9104_length_892_cov_74.968474	386	466	1	61	80	0.7625000
NODE_9104_length_892_cov_74.968474	386	466	2	5	80	0.0625000
NODE_9104_length_892_cov_74.968474	386	466	3	14	80	0.1750000
NODE_9104_length_892_cov_74.968474	462	542	1	21	80	0.2625000
NODE_9104_length_892_cov_74.968474	462	542	2	38	80	0.4750000
NODE_9104_length_892_cov_74.968474	462	542	3	21	80	0.2625000
NODE_9104_length_892_cov_74.968474	515	595	1	74	80	0.9250000
NODE_9104_length_892_cov_74.968474	515	595	3	6	80	0.0750000
NODE_9105_length_892_cov_54.549811	463	550	0	56	87	0.6436782
NODE_9105_length_892_cov_54.549811	463	550	4	11	87	0.1264368
NODE_9105_length_892_cov_54.549811	463	550	6	20	87	0.2298851
NODE_9105_length_892_cov_54.549811	523	603	2	24	80	0.3000000
NODE_9105_length_892_cov_54.549811	523	603	4	7	80	0.0875000
NODE_9105_length_892_cov_54.549811	523	603	6	49	80	0.6125000
NODE_9105_length_892_cov_54.549811	599	679	0	50	80	0.6250000
NODE_9105_length_892_cov_54.549811	599	679	2	30	80	0.3750000
NODE_9106_length_892_cov_37.887768	373	453	2	11	80	0.1375000
NODE_9106_length_892_cov_37.887768	373	453	4	32	80	0.4000000
NODE_9106_length_892_cov_37.887768	373	453	5	34	80	0.4250000
NODE_9106_length_892_cov_37.887768	373	453	6	3	80	0.0375000
NODE_9106_length_892_cov_37.887768	426	506	4	46	80	0.5750000
NODE_9106_length_892_cov_37.887768	426	506	5	24	80	0.3000000
NODE_9106_length_892_cov_37.887768	426	506	6	10	80	0.1250000
NODE_9107_length_892_cov_19.732661	361	441	2	22	80	0.2750000
NODE_9107_length_892_cov_19.732661	361	441	6	23	80	0.2875000
NODE_9107_length_892_cov_19.732661	361	441	8	35	80	0.4375000
NODE_9107_length_892_cov_19.732661	414	494	0	41	80	0.5125000
NODE_9107_length_892_cov_19.732661	414	494	2	34	80	0.4250000
NODE_9107_length_892_cov_19.732661	414	494	6	5	80	0.0625000
NODE_9108_length_892_cov_19.052963	290	370	6	80	80	1.0000000
NODE_9108_length_892_cov_19.052963	343	423	0	46	80	0.5750000
NODE_9108_length_892_cov_19.052963	343	423	6	34	80	0.4250000
NODE_9108_length_892_cov_19.052963	419	499	0	80	80	1.0000000
NODE_9108_length_892_cov_19.052963	472	552	0	80	80	1.0000000
NODE_9109_length_892_cov_17.276166	341	421	0	45	80	0.5625000
NODE_9109_length_892_cov_17.276166	341	421	2	19	80	0.2375000
NODE_9109_length_892_cov_17.276166	341	421	4	1	80	0.0125000
NODE_9109_length_892_cov_17.276166	341	421	5	1	80	0.0125000
NODE_9109_length_892_cov_17.276166	341	421	6	14	80	0.1750000
NODE_9109_length_892_cov_17.276166	394	474	2	11	80	0.1375000
NODE_9109_length_892_cov_17.276166	394	474	4	7	80	0.0875000
NODE_9109_length_892_cov_17.276166	394	474	5	1	80	0.0125000
NODE_9109_length_892_cov_17.276166	394	474	6	61	80	0.7625000
NODE_9110_length_892_cov_16.312736	411	491	0	7	80	0.0875000
NODE_9110_length_892_cov_16.312736	411	491	4	73	80	0.9125000
NODE_9110_length_892_cov_16.312736	464	544	0	60	80	0.7500000
NODE_9110_length_892_cov_16.312736	464	544	4	20	80	0.2500000
NODE_9111_length_892_cov_15.808323	395	475	8	80	80	1.0000000
NODE_9111_length_892_cov_15.808323	448	528	0	8	80	0.1000000
NODE_9111_length_892_cov_15.808323	448	528	4	10	80	0.1250000
NODE_9111_length_892_cov_15.808323	448	528	8	62	80	0.7750000
NODE_9112_length_892_cov_14.020177	522	602	0	80	80	1.0000000
NODE_9112_length_892_cov_14.020177	575	655	0	80	80	1.0000000
NODE_9114_length_892_cov_8.798235	400	480	0	80	80	1.0000000
NODE_9114_length_892_cov_8.798235	453	533	0	80	80	1.0000000
NODE_9115_length_892_cov_8.413619	428	508	0	12	80	0.1500000
NODE_9115_length_892_cov_8.413619	428	508	2	68	80	0.8500000
NODE_9115_length_892_cov_8.413619	481	561	0	38	80	0.4750000
NODE_9115_length_892_cov_8.413619	481	561	2	42	80	0.5250000
NODE_9116_length_892_cov_6.694830	374	454	0	18	80	0.2250000
NODE_9116_length_892_cov_6.694830	374	454	2	62	80	0.7750000
NODE_9116_length_892_cov_6.694830	427	507	0	71	80	0.8875000
NODE_9116_length_892_cov_6.694830	427	507	2	9	80	0.1125000
NODE_9134_length_891_cov_30.166667	295	375	0	31	80	0.3875000
NODE_9134_length_891_cov_30.166667	295	375	4	49	80	0.6125000
NODE_9134_length_891_cov_30.166667	348	428	0	15	80	0.1875000
NODE_9134_length_891_cov_30.166667	348	428	4	65	80	0.8125000
NODE_9135_length_891_cov_26.333333	319	399	2	80	80	1.0000000
NODE_9135_length_891_cov_26.333333	372	452	1	19	80	0.2375000
NODE_9135_length_891_cov_26.333333	372	452	2	61	80	0.7625000
NODE_9136_length_891_cov_22.228535	336	416	0	40	80	0.5000000
NODE_9136_length_891_cov_22.228535	336	416	2	40	80	0.5000000
NODE_9136_length_891_cov_22.228535	389	469	2	80	80	1.0000000
NODE_9137_length_891_cov_20.446970	377	457	0	80	80	1.0000000
NODE_9137_length_891_cov_20.446970	430	510	0	80	80	1.0000000
NODE_9138_length_891_cov_20.226010	310	390	0	80	80	1.0000000
NODE_9138_length_891_cov_20.226010	363	443	0	80	80	1.0000000
NODE_9140_length_891_cov_13.207071	392	472	0	80	80	1.0000000
NODE_9140_length_891_cov_13.207071	445	525	0	80	80	1.0000000
NODE_9141_length_891_cov_11.579545	379	459	0	9	80	0.1125000
NODE_9141_length_891_cov_11.579545	379	459	2	71	80	0.8875000
NODE_9141_length_891_cov_11.579545	432	512	0	62	80	0.7750000
NODE_9141_length_891_cov_11.579545	432	512	2	18	80	0.2250000
NODE_9142_length_891_cov_11.117424	499	579	0	56	80	0.7000000
NODE_9142_length_891_cov_11.117424	499	579	2	24	80	0.3000000
NODE_9142_length_891_cov_11.117424	552	632	0	3	80	0.0375000
NODE_9142_length_891_cov_11.117424	552	632	2	77	80	0.9625000
NODE_9153_length_890_cov_29.070796	284	364	0	80	80	1.0000000
NODE_9153_length_890_cov_29.070796	337	417	0	80	80	1.0000000
NODE_9153_length_890_cov_29.070796	413	497	0	84	84	1.0000000
NODE_9153_length_890_cov_29.070796	470	550	0	30	80	0.3750000
NODE_9153_length_890_cov_29.070796	470	550	2	50	80	0.6250000
NODE_9154_length_890_cov_27.295828	550	630	0	20	80	0.2500000
NODE_9154_length_890_cov_27.295828	550	630	2	60	80	0.7500000
NODE_9154_length_890_cov_27.295828	603	683	0	6	80	0.0750000
NODE_9154_length_890_cov_27.295828	603	683	2	74	80	0.9250000
NODE_9155_length_890_cov_18.088496	80	135	0	55	55	1.0000000
NODE_9155_length_890_cov_18.088496	276	356	4	38	80	0.4750000
NODE_9155_length_890_cov_18.088496	276	356	6	30	80	0.3750000
NODE_9155_length_890_cov_18.088496	276	356	8	4	80	0.0500000
NODE_9155_length_890_cov_18.088496	276	356	10	8	80	0.1000000
NODE_9155_length_890_cov_18.088496	329	406	6	40	77	0.5194805
NODE_9155_length_890_cov_18.088496	329	406	8	4	77	0.0519481
NODE_9155_length_890_cov_18.088496	329	406	10	33	77	0.4285714
NODE_9156_length_890_cov_16.831858	402	482	2	17	80	0.2125000
NODE_9156_length_890_cov_16.831858	402	482	3	1	80	0.0125000
NODE_9156_length_890_cov_16.831858	402	482	4	21	80	0.2625000
NODE_9156_length_890_cov_16.831858	402	482	6	12	80	0.1500000
NODE_9156_length_890_cov_16.831858	402	482	10	29	80	0.3625000
NODE_9156_length_890_cov_16.831858	455	535	5	28	80	0.3500000
NODE_9156_length_890_cov_16.831858	455	535	8	18	80	0.2250000
NODE_9156_length_890_cov_16.831858	455	535	10	34	80	0.4250000
NODE_9157_length_890_cov_11.881163	222	302	0	80	80	1.0000000
NODE_9157_length_890_cov_11.881163	275	355	0	36	80	0.4500000
NODE_9157_length_890_cov_11.881163	275	355	2	44	80	0.5500000
NODE_9158_length_890_cov_8.676359	335	415	0	80	80	1.0000000
NODE_9158_length_890_cov_8.676359	388	468	0	80	80	1.0000000
NODE_9183_length_889_cov_61.520253	334	414	0	80	80	1.0000000
NODE_9183_length_889_cov_61.520253	387	467	0	80	80	1.0000000
NODE_9183_length_889_cov_61.520253	463	543	0	80	80	1.0000000
NODE_9183_length_889_cov_61.520253	516	596	0	80	80	1.0000000
NODE_9184_length_889_cov_30.012658	311	391	0	12	80	0.1500000
NODE_9184_length_889_cov_30.012658	311	391	7	1	80	0.0125000
NODE_9184_length_889_cov_30.012658	311	391	8	16	80	0.2000000
NODE_9184_length_889_cov_30.012658	311	391	10	34	80	0.4250000
NODE_9184_length_889_cov_30.012658	311	391	18	17	80	0.2125000
NODE_9184_length_889_cov_30.012658	364	444	8	10	80	0.1250000
NODE_9184_length_889_cov_30.012658	364	444	10	10	80	0.1250000
NODE_9184_length_889_cov_30.012658	364	444	16	3	80	0.0375000
NODE_9184_length_889_cov_30.012658	364	444	18	57	80	0.7125000
NODE_9185_length_889_cov_28.217722	413	483	0	70	70	1.0000000
NODE_9185_length_889_cov_28.217722	466	542	0	76	76	1.0000000
NODE_9186_length_889_cov_27.924051	379	449	0	70	70	1.0000000
NODE_9186_length_889_cov_27.924051	432	512	0	80	80	1.0000000
NODE_9187_length_889_cov_25.887342	227	285	0	4	58	0.0689655
NODE_9187_length_889_cov_25.887342	227	285	2	21	58	0.3620690
NODE_9187_length_889_cov_25.887342	227	285	6	33	58	0.5689655
NODE_9187_length_889_cov_25.887342	258	337	2	4	79	0.0506329
NODE_9187_length_889_cov_25.887342	258	337	5	2	79	0.0253165
NODE_9187_length_889_cov_25.887342	258	337	6	73	79	0.9240506
NODE_9188_length_889_cov_22.992405	451	531	2	3	80	0.0375000
NODE_9188_length_889_cov_22.992405	451	531	4	3	80	0.0375000
NODE_9188_length_889_cov_22.992405	451	531	6	74	80	0.9250000
NODE_9188_length_889_cov_22.992405	504	584	0	45	80	0.5625000
NODE_9188_length_889_cov_22.992405	504	584	2	11	80	0.1375000
NODE_9188_length_889_cov_22.992405	504	584	6	24	80	0.3000000
NODE_9189_length_889_cov_20.703797	331	411	0	23	80	0.2875000
NODE_9189_length_889_cov_20.703797	331	411	2	57	80	0.7125000
NODE_9189_length_889_cov_20.703797	384	464	0	44	80	0.5500000
NODE_9189_length_889_cov_20.703797	384	464	2	36	80	0.4500000
NODE_9190_length_889_cov_20.226582	234	314	2	80	80	1.0000000
NODE_9190_length_889_cov_20.226582	287	367	0	29	80	0.3625000
NODE_9190_length_889_cov_20.226582	287	367	2	51	80	0.6375000
NODE_9191_length_889_cov_15.587342	407	487	9	42	80	0.5250000
NODE_9191_length_889_cov_15.587342	407	487	10	13	80	0.1625000
NODE_9191_length_889_cov_15.587342	407	487	12	8	80	0.1000000
NODE_9191_length_889_cov_15.587342	407	487	15	1	80	0.0125000
NODE_9191_length_889_cov_15.587342	407	487	19	16	80	0.2000000
NODE_9191_length_889_cov_15.587342	460	540	10	4	80	0.0500000
NODE_9191_length_889_cov_15.587342	460	540	12	41	80	0.5125000
NODE_9191_length_889_cov_15.587342	460	540	13	18	80	0.2250000
NODE_9191_length_889_cov_15.587342	460	540	15	1	80	0.0125000
NODE_9191_length_889_cov_15.587342	460	540	19	16	80	0.2000000
NODE_9192_length_889_cov_12.669620	313	393	0	22	80	0.2750000
NODE_9192_length_889_cov_12.669620	313	393	2	5	80	0.0625000
NODE_9192_length_889_cov_12.669620	313	393	4	3	80	0.0375000
NODE_9192_length_889_cov_12.669620	313	393	10	24	80	0.3000000
NODE_9192_length_889_cov_12.669620	313	393	12	26	80	0.3250000
NODE_9192_length_889_cov_12.669620	366	446	10	34	80	0.4250000
NODE_9192_length_889_cov_12.669620	366	446	12	46	80	0.5750000
NODE_9193_length_889_cov_12.198734	399	479	9	6	80	0.0750000
NODE_9193_length_889_cov_12.198734	399	479	10	74	80	0.9250000
NODE_9193_length_889_cov_12.198734	452	532	0	26	80	0.3250000
NODE_9193_length_889_cov_12.198734	452	532	9	16	80	0.2000000
NODE_9193_length_889_cov_12.198734	452	532	10	38	80	0.4750000
NODE_9197_length_889_cov_3.841772	187	267	0	80	80	1.0000000
NODE_9197_length_889_cov_3.841772	240	320	0	80	80	1.0000000
NODE_9213_length_888_cov_37.102662	490	570	0	61	80	0.7625000
NODE_9213_length_888_cov_37.102662	490	570	2	19	80	0.2375000
NODE_9213_length_888_cov_37.102662	543	623	0	32	80	0.4000000
NODE_9213_length_888_cov_37.102662	543	623	2	48	80	0.6000000
NODE_9214_length_888_cov_28.230672	366	446	0	29	80	0.3625000
NODE_9214_length_888_cov_28.230672	366	446	2	30	80	0.3750000
NODE_9214_length_888_cov_28.230672	366	446	4	5	80	0.0625000
NODE_9214_length_888_cov_28.230672	366	446	6	16	80	0.2000000
NODE_9214_length_888_cov_28.230672	419	499	2	6	80	0.0750000
NODE_9214_length_888_cov_28.230672	419	499	4	42	80	0.5250000
NODE_9214_length_888_cov_28.230672	419	499	6	32	80	0.4000000
NODE_9215_length_888_cov_25.243346	391	471	8	23	80	0.2875000
NODE_9215_length_888_cov_25.243346	391	471	9	34	80	0.4250000
NODE_9215_length_888_cov_25.243346	391	471	63	23	80	0.2875000
NODE_9215_length_888_cov_25.243346	444	524	9	4	80	0.0500000
NODE_9215_length_888_cov_25.243346	444	524	55	34	80	0.4250000
NODE_9215_length_888_cov_25.243346	444	524	63	25	80	0.3125000
NODE_9215_length_888_cov_25.243346	444	524	64	17	80	0.2125000
NODE_9216_length_888_cov_21.045627	236	316	2	46	80	0.5750000
NODE_9216_length_888_cov_21.045627	236	316	8	30	80	0.3750000
NODE_9216_length_888_cov_21.045627	236	316	14	4	80	0.0500000
NODE_9216_length_888_cov_21.045627	289	367	6	6	78	0.0769231
NODE_9216_length_888_cov_21.045627	289	367	8	23	78	0.2948718
NODE_9216_length_888_cov_21.045627	289	367	11	2	78	0.0256410
NODE_9216_length_888_cov_21.045627	289	367	12	38	78	0.4871795
NODE_9216_length_888_cov_21.045627	289	367	14	9	78	0.1153846
NODE_9218_length_888_cov_13.447402	515	595	0	80	80	1.0000000
NODE_9218_length_888_cov_13.447402	568	648	0	80	80	1.0000000
NODE_9219_length_888_cov_12.806084	179	259	0	80	80	1.0000000
NODE_9219_length_888_cov_12.806084	232	312	0	80	80	1.0000000
NODE_9219_length_888_cov_12.806084	308	388	0	80	80	1.0000000
NODE_9219_length_888_cov_12.806084	361	441	0	80	80	1.0000000
NODE_9220_length_888_cov_12.551331	365	445	1	17	80	0.2125000
NODE_9220_length_888_cov_12.551331	365	445	3	6	80	0.0750000
NODE_9220_length_888_cov_12.551331	365	445	5	44	80	0.5500000
NODE_9220_length_888_cov_12.551331	365	445	7	13	80	0.1625000
NODE_9220_length_888_cov_12.551331	418	498	0	47	80	0.5875000
NODE_9220_length_888_cov_12.551331	418	498	1	23	80	0.2875000
NODE_9220_length_888_cov_12.551331	418	498	3	6	80	0.0750000
NODE_9220_length_888_cov_12.551331	418	498	5	4	80	0.0500000
NODE_9228_length_888_cov_2.041825	42	102	0	60	60	1.0000000
NODE_9237_length_887_cov_32.927665	514	594	0	16	80	0.2000000
NODE_9237_length_887_cov_32.927665	514	594	14	64	80	0.8000000
NODE_9237_length_887_cov_32.927665	567	647	0	69	80	0.8625000
NODE_9237_length_887_cov_32.927665	567	647	14	11	80	0.1375000
NODE_9238_length_887_cov_26.920051	358	438	0	80	80	1.0000000
NODE_9238_length_887_cov_26.920051	411	491	0	80	80	1.0000000
NODE_9239_length_887_cov_20.714467	304	384	0	71	80	0.8875000
NODE_9239_length_887_cov_20.714467	304	384	2	9	80	0.1125000
NODE_9239_length_887_cov_20.714467	357	433	0	26	76	0.3421053
NODE_9239_length_887_cov_20.714467	357	433	2	50	76	0.6578947
NODE_9240_length_887_cov_19.771574	407	487	0	80	80	1.0000000
NODE_9240_length_887_cov_19.771574	460	540	0	80	80	1.0000000
NODE_9241_length_887_cov_14.535533	333	413	0	60	80	0.7500000
NODE_9241_length_887_cov_14.535533	333	413	2	20	80	0.2500000
NODE_9241_length_887_cov_14.535533	386	466	0	80	80	1.0000000
NODE_9242_length_887_cov_14.114213	345	425	0	19	80	0.2375000
NODE_9242_length_887_cov_14.114213	345	425	2	61	80	0.7625000
NODE_9242_length_887_cov_14.114213	398	478	0	37	80	0.4625000
NODE_9242_length_887_cov_14.114213	398	478	2	43	80	0.5375000
NODE_9243_length_887_cov_9.451777	406	486	0	48	80	0.6000000
NODE_9243_length_887_cov_9.451777	406	486	2	32	80	0.4000000
NODE_9243_length_887_cov_9.451777	459	539	0	80	80	1.0000000
NODE_9245_length_887_cov_6.656091	473	553	0	46	80	0.5750000
NODE_9245_length_887_cov_6.656091	473	553	2	34	80	0.4250000
NODE_9245_length_887_cov_6.656091	526	606	0	10	80	0.1250000
NODE_9245_length_887_cov_6.656091	526	606	2	70	80	0.8750000
NODE_9246_length_887_cov_4.719543	420	500	0	80	80	1.0000000
NODE_9246_length_887_cov_4.719543	473	553	0	80	80	1.0000000
NODE_9250_length_887_cov_2.583756	385	429	0	44	44	1.0000000
NODE_9250_length_887_cov_2.583756	393	428	0	35	35	1.0000000
NODE_9261_length_887_cov_1.087563	754	829	0	75	75	1.0000000
NODE_9264_length_886_cov_35.482846	365	445	2	26	80	0.3250000
NODE_9264_length_886_cov_35.482846	365	445	4	28	80	0.3500000
NODE_9264_length_886_cov_35.482846	365	445	6	26	80	0.3250000
NODE_9264_length_886_cov_35.482846	418	498	0	5	80	0.0625000
NODE_9264_length_886_cov_35.482846	418	498	4	75	80	0.9375000
NODE_9265_length_886_cov_31.939009	438	518	0	64	80	0.8000000
NODE_9265_length_886_cov_31.939009	438	518	4	16	80	0.2000000
NODE_9265_length_886_cov_31.939009	491	571	0	11	80	0.1375000
NODE_9265_length_886_cov_31.939009	491	571	4	69	80	0.8625000
NODE_9266_length_886_cov_25.301144	326	406	0	50	80	0.6250000
NODE_9266_length_886_cov_25.301144	326	406	5	23	80	0.2875000
NODE_9266_length_886_cov_25.301144	326	406	6	7	80	0.0875000
NODE_9266_length_886_cov_25.301144	326	406	0	50	80	0.6250000
NODE_9266_length_886_cov_25.301144	326	406	5	23	80	0.2875000
NODE_9266_length_886_cov_25.301144	326	406	6	7	80	0.0875000
NODE_9266_length_886_cov_25.301144	379	459	5	20	80	0.2500000
NODE_9266_length_886_cov_25.301144	379	459	6	60	80	0.7500000
NODE_9266_length_886_cov_25.301144	379	459	5	20	80	0.2500000
NODE_9266_length_886_cov_25.301144	379	459	6	60	80	0.7500000
NODE_9267_length_886_cov_14.463787	327	407	0	21	80	0.2625000
NODE_9267_length_886_cov_14.463787	327	407	6	59	80	0.7375000
NODE_9267_length_886_cov_14.463787	380	460	0	27	80	0.3375000
NODE_9267_length_886_cov_14.463787	380	460	5	23	80	0.2875000
NODE_9267_length_886_cov_14.463787	380	460	6	30	80	0.3750000
NODE_9286_length_885_cov_35.510178	373	453	0	80	80	1.0000000
NODE_9286_length_885_cov_35.510178	426	506	0	80	80	1.0000000
NODE_9287_length_885_cov_31.857506	368	448	0	80	80	1.0000000
NODE_9287_length_885_cov_31.857506	421	501	0	39	80	0.4875000
NODE_9287_length_885_cov_31.857506	421	501	2	41	80	0.5125000
NODE_9288_length_885_cov_31.195929	395	475	9	12	80	0.1500000
NODE_9288_length_885_cov_31.195929	395	475	10	35	80	0.4375000
NODE_9288_length_885_cov_31.195929	395	475	15	2	80	0.0250000
NODE_9288_length_885_cov_31.195929	395	475	18	4	80	0.0500000
NODE_9288_length_885_cov_31.195929	395	475	19	2	80	0.0250000
NODE_9288_length_885_cov_31.195929	395	475	20	6	80	0.0750000
NODE_9288_length_885_cov_31.195929	395	475	21	19	80	0.2375000
NODE_9288_length_885_cov_31.195929	448	528	10	12	80	0.1500000
NODE_9288_length_885_cov_31.195929	448	528	12	21	80	0.2625000
NODE_9288_length_885_cov_31.195929	448	528	18	24	80	0.3000000
NODE_9288_length_885_cov_31.195929	448	528	20	6	80	0.0750000
NODE_9288_length_885_cov_31.195929	448	528	21	17	80	0.2125000
NODE_9289_length_885_cov_23.735369	356	436	0	80	80	1.0000000
NODE_9289_length_885_cov_23.735369	409	489	0	80	80	1.0000000
NODE_9289_length_885_cov_23.735369	485	565	0	80	80	1.0000000
NODE_9289_length_885_cov_23.735369	538	618	0	80	80	1.0000000
NODE_9290_length_885_cov_22.174300	340	420	0	80	80	1.0000000
NODE_9290_length_885_cov_22.174300	393	473	0	80	80	1.0000000
NODE_9290_length_885_cov_22.174300	469	549	0	73	80	0.9125000
NODE_9290_length_885_cov_22.174300	469	549	2	7	80	0.0875000
NODE_9290_length_885_cov_22.174300	522	602	0	23	80	0.2875000
NODE_9290_length_885_cov_22.174300	522	602	2	57	80	0.7125000
NODE_9291_length_885_cov_17.852417	413	493	0	80	80	1.0000000
NODE_9291_length_885_cov_17.852417	466	546	0	80	80	1.0000000
NODE_9292_length_885_cov_15.652672	346	426	0	5	80	0.0625000
NODE_9292_length_885_cov_15.652672	346	426	2	75	80	0.9375000
NODE_9292_length_885_cov_15.652672	399	479	0	58	80	0.7250000
NODE_9292_length_885_cov_15.652672	399	479	2	22	80	0.2750000
NODE_9292_length_885_cov_15.652672	475	555	0	80	80	1.0000000
NODE_9292_length_885_cov_15.652672	528	608	0	80	80	1.0000000
NODE_9293_length_885_cov_11.648855	530	610	0	53	80	0.6625000
NODE_9293_length_885_cov_11.648855	530	610	2	27	80	0.3375000
NODE_9293_length_885_cov_11.648855	583	663	0	80	80	1.0000000
NODE_9294_length_885_cov_9.707379	611	691	0	80	80	1.0000000
NODE_9294_length_885_cov_9.707379	664	744	0	80	80	1.0000000
NODE_9311_length_884_cov_73.050955	536	616	2	1	80	0.0125000
NODE_9311_length_884_cov_73.050955	536	616	6	54	80	0.6750000
NODE_9311_length_884_cov_73.050955	536	616	8	10	80	0.1250000
NODE_9311_length_884_cov_73.050955	536	616	10	1	80	0.0125000
NODE_9311_length_884_cov_73.050955	536	616	11	6	80	0.0750000
NODE_9311_length_884_cov_73.050955	536	616	17	4	80	0.0500000
NODE_9311_length_884_cov_73.050955	536	616	22	4	80	0.0500000
NODE_9311_length_884_cov_73.050955	589	669	2	1	80	0.0125000
NODE_9311_length_884_cov_73.050955	589	669	6	6	80	0.0750000
NODE_9311_length_884_cov_73.050955	589	669	8	5	80	0.0625000
NODE_9311_length_884_cov_73.050955	589	669	10	1	80	0.0125000
NODE_9311_length_884_cov_73.050955	589	669	11	6	80	0.0750000
NODE_9311_length_884_cov_73.050955	589	669	16	4	80	0.0500000
NODE_9311_length_884_cov_73.050955	589	669	17	4	80	0.0500000
NODE_9311_length_884_cov_73.050955	589	669	19	2	80	0.0250000
NODE_9311_length_884_cov_73.050955	589	669	20	20	80	0.2500000
NODE_9311_length_884_cov_73.050955	589	669	22	31	80	0.3875000
NODE_9312_length_884_cov_28.373248	381	461	0	80	80	1.0000000
NODE_9312_length_884_cov_28.373248	434	514	0	80	80	1.0000000
NODE_9313_length_884_cov_20.649682	463	543	0	26	80	0.3250000
NODE_9313_length_884_cov_20.649682	463	543	10	54	80	0.6750000
NODE_9313_length_884_cov_20.649682	516	596	0	12	80	0.1500000
NODE_9313_length_884_cov_20.649682	516	596	6	18	80	0.2250000
NODE_9313_length_884_cov_20.649682	516	596	10	50	80	0.6250000
NODE_9314_length_884_cov_13.391083	225	305	0	80	80	1.0000000
NODE_9314_length_884_cov_13.391083	278	358	0	80	80	1.0000000
NODE_9315_length_884_cov_9.192357	278	358	4	46	80	0.5750000
NODE_9315_length_884_cov_9.192357	278	358	10	2	80	0.0250000
NODE_9315_length_884_cov_9.192357	278	358	12	28	80	0.3500000
NODE_9315_length_884_cov_9.192357	278	358	14	4	80	0.0500000
NODE_9315_length_884_cov_9.192357	331	411	10	49	80	0.6125000
NODE_9315_length_884_cov_9.192357	331	411	12	31	80	0.3875000
NODE_9315_length_884_cov_9.192357	407	487	0	34	80	0.4250000
NODE_9315_length_884_cov_9.192357	407	487	6	40	80	0.5000000
NODE_9315_length_884_cov_9.192357	407	487	10	6	80	0.0750000
NODE_9315_length_884_cov_9.192357	460	540	0	80	80	1.0000000
NODE_9335_length_883_cov_46.780612	344	424	0	13	80	0.1625000
NODE_9335_length_883_cov_46.780612	344	424	1	2	80	0.0250000
NODE_9335_length_883_cov_46.780612	344	424	2	65	80	0.8125000
NODE_9335_length_883_cov_46.780612	397	477	0	66	80	0.8250000
NODE_9335_length_883_cov_46.780612	397	477	1	2	80	0.0250000
NODE_9335_length_883_cov_46.780612	397	477	2	12	80	0.1500000
NODE_9336_length_883_cov_46.304847	387	467	0	3	80	0.0375000
NODE_9336_length_883_cov_46.304847	387	467	1	9	80	0.1125000
NODE_9336_length_883_cov_46.304847	387	467	2	68	80	0.8500000
NODE_9336_length_883_cov_46.304847	440	520	2	80	80	1.0000000
NODE_9337_length_883_cov_39.579082	410	490	0	80	80	1.0000000
NODE_9337_length_883_cov_39.579082	463	543	0	80	80	1.0000000
NODE_9338_length_883_cov_28.307398	379	459	2	9	80	0.1125000
NODE_9338_length_883_cov_28.307398	379	459	12	65	80	0.8125000
NODE_9338_length_883_cov_28.307398	379	459	13	1	80	0.0125000
NODE_9338_length_883_cov_28.307398	379	459	14	5	80	0.0625000
NODE_9338_length_883_cov_28.307398	432	512	12	27	80	0.3375000
NODE_9338_length_883_cov_28.307398	432	512	14	53	80	0.6625000
NODE_9339_length_883_cov_24.927296	429	509	0	45	80	0.5625000
NODE_9339_length_883_cov_24.927296	429	509	2	35	80	0.4375000
NODE_9339_length_883_cov_24.927296	482	562	0	80	80	1.0000000
NODE_9341_length_883_cov_17.445153	326	406	2	9	80	0.1125000
NODE_9341_length_883_cov_17.445153	326	406	4	30	80	0.3750000
NODE_9341_length_883_cov_17.445153	326	406	6	41	80	0.5125000
NODE_9341_length_883_cov_17.445153	379	459	2	21	80	0.2625000
NODE_9341_length_883_cov_17.445153	379	459	4	32	80	0.4000000
NODE_9341_length_883_cov_17.445153	379	459	6	27	80	0.3375000
NODE_9342_length_883_cov_14.660714	319	395	0	19	76	0.2500000
NODE_9342_length_883_cov_14.660714	319	395	1	1	76	0.0131579
NODE_9342_length_883_cov_14.660714	319	395	2	56	76	0.7368421
NODE_9342_length_883_cov_14.660714	740	816	0	11	76	0.1447368
NODE_9342_length_883_cov_14.660714	740	816	2	65	76	0.8552632
NODE_9343_length_883_cov_11.052296	223	303	0	80	80	1.0000000
NODE_9343_length_883_cov_11.052296	276	356	0	66	80	0.8250000
NODE_9343_length_883_cov_11.052296	276	356	2	14	80	0.1750000
NODE_9344_length_883_cov_6.873724	0	66	0	1	66	0.0151515
NODE_9344_length_883_cov_6.873724	0	66	4	1	66	0.0151515
NODE_9344_length_883_cov_6.873724	0	66	8	3	66	0.0454545
NODE_9344_length_883_cov_6.873724	0	66	17	3	66	0.0454545
NODE_9344_length_883_cov_6.873724	0	66	23	2	66	0.0303030
NODE_9344_length_883_cov_6.873724	0	66	25	3	66	0.0454545
NODE_9344_length_883_cov_6.873724	0	66	27	1	66	0.0151515
NODE_9344_length_883_cov_6.873724	0	66	28	9	66	0.1363636
NODE_9344_length_883_cov_6.873724	0	66	35	5	66	0.0757576
NODE_9344_length_883_cov_6.873724	0	66	36	3	66	0.0454545
NODE_9344_length_883_cov_6.873724	0	66	37	5	66	0.0757576
NODE_9344_length_883_cov_6.873724	0	66	39	30	66	0.4545455
NODE_9345_length_883_cov_3.873724	471	551	0	80	80	1.0000000
NODE_9345_length_883_cov_3.873724	524	604	0	80	80	1.0000000
NODE_9346_length_883_cov_3.247449	294	374	0	80	80	1.0000000
NODE_9346_length_883_cov_3.247449	347	427	0	80	80	1.0000000
NODE_9370_length_882_cov_24.241379	438	518	0	60	80	0.7500000
NODE_9370_length_882_cov_24.241379	438	518	2	20	80	0.2500000
NODE_9370_length_882_cov_24.241379	491	571	0	15	80	0.1875000
NODE_9370_length_882_cov_24.241379	491	571	2	65	80	0.8125000
NODE_9371_length_882_cov_23.145594	355	435	0	7	80	0.0875000
NODE_9371_length_882_cov_23.145594	355	435	2	73	80	0.9125000
NODE_9371_length_882_cov_23.145594	408	488	0	45	80	0.5625000
NODE_9371_length_882_cov_23.145594	408	488	2	35	80	0.4375000
NODE_9372_length_882_cov_21.401022	335	415	4	63	80	0.7875000
NODE_9372_length_882_cov_21.401022	335	415	6	17	80	0.2125000
NODE_9372_length_882_cov_21.401022	388	468	0	39	80	0.4875000
NODE_9372_length_882_cov_21.401022	388	468	4	41	80	0.5125000
NODE_9373_length_882_cov_19.579821	456	511	0	55	55	1.0000000
NODE_9373_length_882_cov_19.579821	506	586	0	40	80	0.5000000
NODE_9373_length_882_cov_19.579821	506	586	2	40	80	0.5000000
NODE_9373_length_882_cov_19.579821	559	639	2	80	80	1.0000000
NODE_9374_length_882_cov_19.342273	298	378	0	80	80	1.0000000
NODE_9374_length_882_cov_19.342273	351	431	0	80	80	1.0000000
NODE_9374_length_882_cov_19.342273	427	508	0	20	81	0.2469136
NODE_9374_length_882_cov_19.342273	427	508	2	9	81	0.1111111
NODE_9374_length_882_cov_19.342273	427	508	5	34	81	0.4197531
NODE_9374_length_882_cov_19.342273	427	508	10	7	81	0.0864198
NODE_9374_length_882_cov_19.342273	427	508	12	11	81	0.1358025
NODE_9374_length_882_cov_19.342273	481	561	5	9	80	0.1125000
NODE_9374_length_882_cov_19.342273	481	561	9	12	80	0.1500000
NODE_9374_length_882_cov_19.342273	481	561	10	35	80	0.4375000
NODE_9374_length_882_cov_19.342273	481	561	12	19	80	0.2375000
NODE_9374_length_882_cov_19.342273	481	561	13	5	80	0.0625000
NODE_9375_length_882_cov_11.873563	267	347	0	80	80	1.0000000
NODE_9375_length_882_cov_11.873563	320	400	0	80	80	1.0000000
NODE_9376_length_882_cov_8.794381	430	510	0	80	80	1.0000000
NODE_9376_length_882_cov_8.794381	483	563	0	80	80	1.0000000
NODE_9377_length_882_cov_7.537676	527	608	0	81	81	1.0000000
NODE_9379_length_882_cov_6.696041	355	435	0	80	80	1.0000000
NODE_9379_length_882_cov_6.696041	408	488	0	80	80	1.0000000
NODE_9380_length_882_cov_4.734355	585	665	0	80	80	1.0000000
NODE_9380_length_882_cov_4.734355	638	718	0	80	80	1.0000000
NODE_9398_length_881_cov_32.875959	444	524	1	44	80	0.5500000
NODE_9398_length_881_cov_32.875959	444	524	6	5	80	0.0625000
NODE_9398_length_881_cov_32.875959	444	524	7	31	80	0.3875000
NODE_9398_length_881_cov_32.875959	497	577	0	26	80	0.3250000
NODE_9398_length_881_cov_32.875959	497	577	6	32	80	0.4000000
NODE_9398_length_881_cov_32.875959	497	577	7	22	80	0.2750000
NODE_9399_length_881_cov_25.750639	43	117	20	26	74	0.3513514
NODE_9399_length_881_cov_25.750639	43	117	24	4	74	0.0540541
NODE_9399_length_881_cov_25.750639	43	117	25	3	74	0.0405405
NODE_9399_length_881_cov_25.750639	43	117	26	41	74	0.5540541
NODE_9399_length_881_cov_25.750639	116	193	6	6	77	0.0779221
NODE_9399_length_881_cov_25.750639	116	193	7	14	77	0.1818182
NODE_9399_length_881_cov_25.750639	116	193	21	15	77	0.1948052
NODE_9399_length_881_cov_25.750639	116	193	24	1	77	0.0129870
NODE_9399_length_881_cov_25.750639	116	193	25	12	77	0.1558442
NODE_9399_length_881_cov_25.750639	116	193	26	20	77	0.2597403
NODE_9399_length_881_cov_25.750639	116	193	27	9	77	0.1168831
NODE_9400_length_881_cov_23.897698	286	365	0	77	79	0.9746835
NODE_9400_length_881_cov_23.897698	286	365	2	2	79	0.0253165
NODE_9400_length_881_cov_23.897698	338	418	0	25	80	0.3125000
NODE_9400_length_881_cov_23.897698	338	418	2	55	80	0.6875000
NODE_9401_length_881_cov_20.656010	359	439	0	80	80	1.0000000
NODE_9401_length_881_cov_20.656010	412	492	0	80	80	1.0000000
NODE_9402_length_881_cov_20.340153	242	322	0	65	80	0.8125000
NODE_9402_length_881_cov_20.340153	242	322	2	15	80	0.1875000
NODE_9402_length_881_cov_20.340153	295	375	0	80	80	1.0000000
NODE_9403_length_881_cov_18.234015	420	500	0	11	80	0.1375000
NODE_9403_length_881_cov_18.234015	420	500	2	69	80	0.8625000
NODE_9403_length_881_cov_18.234015	473	553	0	64	80	0.8000000
NODE_9403_length_881_cov_18.234015	473	553	2	16	80	0.2000000
NODE_9404_length_881_cov_17.748082	291	371	0	80	80	1.0000000
NODE_9404_length_881_cov_17.748082	344	424	0	80	80	1.0000000
NODE_9405_length_881_cov_12.884910	332	412	4	44	80	0.5500000
NODE_9405_length_881_cov_12.884910	332	412	6	36	80	0.4500000
NODE_9405_length_881_cov_12.884910	385	465	0	48	80	0.6000000
NODE_9405_length_881_cov_12.884910	385	465	4	32	80	0.4000000
NODE_9406_length_881_cov_6.473146	474	553	0	49	79	0.6202531
NODE_9406_length_881_cov_6.473146	474	553	6	30	79	0.3797468
NODE_9406_length_881_cov_6.473146	514	594	0	80	80	1.0000000
NODE_9406_length_881_cov_6.473146	526	565	0	39	39	1.0000000
NODE_9406_length_881_cov_6.473146	555	606	0	51	51	1.0000000
NODE_9406_length_881_cov_6.473146	567	647	0	80	80	1.0000000
NODE_9407_length_881_cov_5.615090	547	627	0	80	80	1.0000000
NODE_9407_length_881_cov_5.615090	600	680	0	80	80	1.0000000
NODE_9424_length_880_cov_26.663252	320	400	0	80	80	1.0000000
NODE_9424_length_880_cov_26.663252	373	453	0	80	80	1.0000000
NODE_9425_length_880_cov_21.828425	328	408	0	80	80	1.0000000
NODE_9425_length_880_cov_21.828425	381	461	0	80	80	1.0000000
NODE_9426_length_880_cov_20.245839	427	507	0	80	80	1.0000000
NODE_9426_length_880_cov_20.245839	480	560	0	80	80	1.0000000
NODE_9427_length_880_cov_19.434059	0	69	0	69	69	1.0000000
NODE_9428_length_880_cov_11.843790	363	430	2	40	67	0.5970149
NODE_9428_length_880_cov_11.843790	363	430	4	27	67	0.4029851
NODE_9429_length_880_cov_11.544174	185	265	2	20	80	0.2500000
NODE_9429_length_880_cov_11.544174	185	265	4	24	80	0.3000000
NODE_9429_length_880_cov_11.544174	185	265	6	36	80	0.4500000
NODE_9429_length_880_cov_11.544174	238	318	0	16	80	0.2000000
NODE_9429_length_880_cov_11.544174	238	318	2	57	80	0.7125000
NODE_9429_length_880_cov_11.544174	238	318	6	7	80	0.0875000
NODE_9430_length_880_cov_10.956466	354	434	0	80	80	1.0000000
NODE_9430_length_880_cov_10.956466	407	487	0	80	80	1.0000000
NODE_9431_length_880_cov_10.008963	395	474	0	54	79	0.6835443
NODE_9431_length_880_cov_10.008963	395	474	2	25	79	0.3164557
NODE_9431_length_880_cov_10.008963	448	527	0	2	79	0.0253165
NODE_9431_length_880_cov_10.008963	448	527	2	77	79	0.9746835
NODE_9453_length_879_cov_23.565385	326	406	0	80	80	1.0000000
NODE_9453_length_879_cov_23.565385	379	459	0	80	80	1.0000000
NODE_9453_length_879_cov_23.565385	455	535	0	80	80	1.0000000
NODE_9453_length_879_cov_23.565385	508	586	0	78	78	1.0000000
NODE_9454_length_879_cov_20.758974	355	439	2	84	84	1.0000000
NODE_9454_length_879_cov_20.758974	412	492	0	41	80	0.5125000
NODE_9454_length_879_cov_20.758974	412	492	2	39	80	0.4875000
NODE_9455_length_879_cov_19.685897	295	375	0	51	80	0.6375000
NODE_9455_length_879_cov_19.685897	295	375	2	29	80	0.3625000
NODE_9455_length_879_cov_19.685897	348	428	0	13	80	0.1625000
NODE_9455_length_879_cov_19.685897	348	428	2	67	80	0.8375000
NODE_9456_length_879_cov_17.738462	413	488	0	75	75	1.0000000
NODE_9456_length_879_cov_17.738462	569	649	0	80	80	1.0000000
NODE_9456_length_879_cov_17.738462	569	649	0	80	80	1.0000000
NODE_9456_length_879_cov_17.738462	569	649	0	80	80	1.0000000
NODE_9456_length_879_cov_17.738462	622	676	0	54	54	1.0000000
NODE_9458_length_879_cov_10.756410	335	415	0	40	80	0.5000000
NODE_9458_length_879_cov_10.756410	335	415	2	40	80	0.5000000
NODE_9458_length_879_cov_10.756410	388	468	0	21	80	0.2625000
NODE_9458_length_879_cov_10.756410	388	468	2	59	80	0.7375000
NODE_9459_length_879_cov_7.432051	234	314	2	68	80	0.8500000
NODE_9459_length_879_cov_7.432051	234	314	4	12	80	0.1500000
NODE_9459_length_879_cov_7.432051	288	367	0	22	79	0.2784810
NODE_9459_length_879_cov_7.432051	288	367	2	57	79	0.7215190
NODE_9473_length_878_cov_230.436457	415	495	0	24	80	0.3000000
NODE_9473_length_878_cov_230.436457	415	495	2	56	80	0.7000000
NODE_9473_length_878_cov_230.436457	468	548	0	77	80	0.9625000
NODE_9473_length_878_cov_230.436457	468	548	2	3	80	0.0375000
NODE_9474_length_878_cov_49.514763	410	490	0	80	80	1.0000000
NODE_9474_length_878_cov_49.514763	463	543	0	80	80	1.0000000
NODE_9475_length_878_cov_38.862644	365	445	0	80	80	1.0000000
NODE_9475_length_878_cov_38.862644	418	498	0	80	80	1.0000000
NODE_9476_length_878_cov_36.517330	346	426	0	41	80	0.5125000
NODE_9476_length_878_cov_36.517330	346	426	2	39	80	0.4875000
NODE_9476_length_878_cov_36.517330	399	479	0	80	80	1.0000000
NODE_9476_length_878_cov_36.517330	475	555	0	80	80	1.0000000
NODE_9476_length_878_cov_36.517330	528	608	0	80	80	1.0000000
NODE_9477_length_878_cov_34.404365	627	707	45	1	80	0.0125000
NODE_9477_length_878_cov_34.404365	627	707	47	4	80	0.0500000
NODE_9477_length_878_cov_34.404365	627	707	49	1	80	0.0125000
NODE_9477_length_878_cov_34.404365	627	707	64	1	80	0.0125000
NODE_9477_length_878_cov_34.404365	627	707	69	1	80	0.0125000
NODE_9477_length_878_cov_34.404365	627	707	73	10	80	0.1250000
NODE_9477_length_878_cov_34.404365	627	707	74	2	80	0.0250000
NODE_9477_length_878_cov_34.404365	627	707	75	7	80	0.0875000
NODE_9477_length_878_cov_34.404365	627	707	76	20	80	0.2500000
NODE_9477_length_878_cov_34.404365	627	707	79	1	80	0.0125000
NODE_9477_length_878_cov_34.404365	627	707	80	21	80	0.2625000
NODE_9477_length_878_cov_34.404365	627	707	81	3	80	0.0375000
NODE_9477_length_878_cov_34.404365	627	707	82	2	80	0.0250000
NODE_9477_length_878_cov_34.404365	627	707	84	2	80	0.0250000
NODE_9477_length_878_cov_34.404365	627	707	85	4	80	0.0500000
NODE_9477_length_878_cov_34.404365	627	695	45	1	68	0.0147059
NODE_9477_length_878_cov_34.404365	627	695	47	4	68	0.0588235
NODE_9477_length_878_cov_34.404365	627	695	49	1	68	0.0147059
NODE_9477_length_878_cov_34.404365	627	695	64	1	68	0.0147059
NODE_9477_length_878_cov_34.404365	627	695	73	4	68	0.0588235
NODE_9477_length_878_cov_34.404365	627	695	74	2	68	0.0294118
NODE_9477_length_878_cov_34.404365	627	695	75	2	68	0.0294118
NODE_9477_length_878_cov_34.404365	627	695	76	20	68	0.2941177
NODE_9477_length_878_cov_34.404365	627	695	79	1	68	0.0147059
NODE_9477_length_878_cov_34.404365	627	695	80	21	68	0.3088235
NODE_9477_length_878_cov_34.404365	627	695	81	3	68	0.0441176
NODE_9477_length_878_cov_34.404365	627	695	82	2	68	0.0294118
NODE_9477_length_878_cov_34.404365	627	695	84	2	68	0.0294118
NODE_9477_length_878_cov_34.404365	627	695	85	4	68	0.0588235
NODE_9477_length_878_cov_34.404365	680	760	69	1	80	0.0125000
NODE_9477_length_878_cov_34.404365	680	760	73	11	80	0.1375000
NODE_9477_length_878_cov_34.404365	680	760	75	7	80	0.0875000
NODE_9477_length_878_cov_34.404365	680	760	76	2	80	0.0250000
NODE_9477_length_878_cov_34.404365	680	760	77	6	80	0.0750000
NODE_9477_length_878_cov_34.404365	680	760	79	2	80	0.0250000
NODE_9477_length_878_cov_34.404365	680	760	80	2	80	0.0250000
NODE_9477_length_878_cov_34.404365	680	760	81	1	80	0.0125000
NODE_9477_length_878_cov_34.404365	680	760	83	3	80	0.0375000
NODE_9477_length_878_cov_34.404365	680	760	84	4	80	0.0500000
NODE_9477_length_878_cov_34.404365	680	760	85	9	80	0.1125000
NODE_9477_length_878_cov_34.404365	680	760	86	7	80	0.0875000
NODE_9477_length_878_cov_34.404365	680	760	87	1	80	0.0125000
NODE_9477_length_878_cov_34.404365	680	760	88	2	80	0.0250000
NODE_9477_length_878_cov_34.404365	680	760	89	10	80	0.1250000
NODE_9477_length_878_cov_34.404365	680	760	90	3	80	0.0375000
NODE_9477_length_878_cov_34.404365	680	760	92	4	80	0.0500000
NODE_9477_length_878_cov_34.404365	680	760	95	5	80	0.0625000
NODE_9478_length_878_cov_28.761232	467	547	0	80	80	1.0000000
NODE_9478_length_878_cov_28.761232	520	600	0	80	80	1.0000000
NODE_9479_length_878_cov_24.899872	316	396	0	48	80	0.6000000
NODE_9479_length_878_cov_24.899872	316	396	4	32	80	0.4000000
NODE_9479_length_878_cov_24.899872	369	449	4	62	80	0.7750000
NODE_9479_length_878_cov_24.899872	369	449	8	18	80	0.2250000
NODE_9479_length_878_cov_24.899872	445	525	0	12	80	0.1500000
NODE_9479_length_878_cov_24.899872	445	525	4	68	80	0.8500000
NODE_9479_length_878_cov_24.899872	498	578	0	65	80	0.8125000
NODE_9479_length_878_cov_24.899872	498	578	4	15	80	0.1875000
NODE_9480_length_878_cov_21.446727	377	457	0	33	80	0.4125000
NODE_9480_length_878_cov_21.446727	377	457	2	47	80	0.5875000
NODE_9480_length_878_cov_21.446727	430	510	0	80	80	1.0000000
NODE_9481_length_878_cov_20.553273	424	504	0	80	80	1.0000000
NODE_9481_length_878_cov_20.553273	477	557	0	80	80	1.0000000
NODE_9482_length_878_cov_14.016688	214	294	0	80	80	1.0000000
NODE_9482_length_878_cov_14.016688	267	347	0	80	80	1.0000000
NODE_9483_length_878_cov_9.252888	423	503	0	80	80	1.0000000
NODE_9483_length_878_cov_9.252888	476	556	0	80	80	1.0000000
NODE_9484_length_878_cov_8.695764	333	413	0	80	80	1.0000000
NODE_9484_length_878_cov_8.695764	386	466	0	80	80	1.0000000
NODE_9485_length_878_cov_6.686778	65	145	0	80	80	1.0000000
NODE_9485_length_878_cov_6.686778	118	198	0	80	80	1.0000000
NODE_9487_length_878_cov_6.328626	426	506	0	80	80	1.0000000
NODE_9487_length_878_cov_6.328626	479	559	0	80	80	1.0000000
NODE_9488_length_878_cov_5.771502	470	513	0	43	43	1.0000000
NODE_9490_length_878_cov_2.672657	499	579	0	80	80	1.0000000
NODE_9490_length_878_cov_2.672657	552	631	0	79	79	1.0000000
NODE_9507_length_877_cov_59.021851	324	404	0	80	80	1.0000000
NODE_9507_length_877_cov_59.021851	377	457	0	80	80	1.0000000
NODE_9508_length_877_cov_54.422879	418	498	0	80	80	1.0000000
NODE_9508_length_877_cov_54.422879	471	551	0	80	80	1.0000000
NODE_9509_length_877_cov_47.672237	451	527	0	40	76	0.5263158
NODE_9509_length_877_cov_47.672237	451	527	2	36	76	0.4736842
NODE_9509_length_877_cov_47.672237	500	580	0	10	80	0.1250000
NODE_9509_length_877_cov_47.672237	500	580	2	70	80	0.8750000
NODE_9510_length_877_cov_29.884319	349	429	11	15	80	0.1875000
NODE_9510_length_877_cov_29.884319	349	429	14	2	80	0.0250000
NODE_9510_length_877_cov_29.884319	349	429	15	24	80	0.3000000
NODE_9510_length_877_cov_29.884319	349	429	16	7	80	0.0875000
NODE_9510_length_877_cov_29.884319	349	429	17	32	80	0.4000000
NODE_9510_length_877_cov_29.884319	402	482	0	6	80	0.0750000
NODE_9510_length_877_cov_29.884319	402	482	2	2	80	0.0250000
NODE_9510_length_877_cov_29.884319	402	482	4	16	80	0.2000000
NODE_9510_length_877_cov_29.884319	402	482	8	3	80	0.0375000
NODE_9510_length_877_cov_29.884319	402	482	13	1	80	0.0125000
NODE_9510_length_877_cov_29.884319	402	482	14	18	80	0.2250000
NODE_9510_length_877_cov_29.884319	402	482	15	13	80	0.1625000
NODE_9510_length_877_cov_29.884319	402	482	17	21	80	0.2625000
NODE_9511_length_877_cov_17.681234	423	503	2	72	80	0.9000000
NODE_9511_length_877_cov_17.681234	423	503	4	7	80	0.0875000
NODE_9511_length_877_cov_17.681234	423	503	6	1	80	0.0125000
NODE_9511_length_877_cov_17.681234	476	556	0	36	80	0.4500000
NODE_9511_length_877_cov_17.681234	476	556	2	44	80	0.5500000
NODE_9512_length_877_cov_17.520566	228	308	0	62	80	0.7750000
NODE_9512_length_877_cov_17.520566	228	308	2	18	80	0.2250000
NODE_9512_length_877_cov_17.520566	281	361	0	17	80	0.2125000
NODE_9512_length_877_cov_17.520566	281	361	2	63	80	0.7875000
NODE_9513_length_877_cov_17.374036	362	442	0	80	80	1.0000000
NODE_9513_length_877_cov_17.374036	415	495	0	80	80	1.0000000
NODE_9515_length_877_cov_9.320051	395	475	0	80	80	1.0000000
NODE_9515_length_877_cov_9.320051	448	528	0	80	80	1.0000000
NODE_9517_length_877_cov_6.755784	222	302	0	80	80	1.0000000
NODE_9517_length_877_cov_6.755784	275	354	0	79	79	1.0000000
NODE_9537_length_876_cov_46.021879	389	469	0	1	80	0.0125000
NODE_9537_length_876_cov_46.021879	389	469	2	79	80	0.9875000
NODE_9537_length_876_cov_46.021879	442	522	0	54	80	0.6750000
NODE_9537_length_876_cov_46.021879	442	522	2	26	80	0.3250000
NODE_9538_length_876_cov_34.441441	379	459	1	41	80	0.5125000
NODE_9538_length_876_cov_34.441441	379	459	2	8	80	0.1000000
NODE_9538_length_876_cov_34.441441	379	459	6	31	80	0.3875000
NODE_9538_length_876_cov_34.441441	432	512	6	80	80	1.0000000
NODE_9539_length_876_cov_30.742600	344	424	0	61	80	0.7625000
NODE_9539_length_876_cov_30.742600	344	424	2	7	80	0.0875000
NODE_9539_length_876_cov_30.742600	344	424	4	12	80	0.1500000
NODE_9539_length_876_cov_30.742600	397	477	0	50	80	0.6250000
NODE_9539_length_876_cov_30.742600	397	477	2	30	80	0.3750000
NODE_9540_length_876_cov_28.476190	345	425	0	36	80	0.4500000
NODE_9540_length_876_cov_28.476190	345	425	2	44	80	0.5500000
NODE_9540_length_876_cov_28.476190	398	478	0	4	80	0.0500000
NODE_9540_length_876_cov_28.476190	398	478	2	76	80	0.9500000
NODE_9541_length_876_cov_22.722008	324	404	0	20	80	0.2500000
NODE_9541_length_876_cov_22.722008	324	404	2	30	80	0.3750000
NODE_9541_length_876_cov_22.722008	324	404	4	30	80	0.3750000
NODE_9541_length_876_cov_22.722008	377	457	0	73	80	0.9125000
NODE_9541_length_876_cov_22.722008	377	457	2	7	80	0.0875000
NODE_9542_length_876_cov_17.458172	367	447	0	80	80	1.0000000
NODE_9542_length_876_cov_17.458172	420	500	0	80	80	1.0000000
NODE_9561_length_875_cov_52.965206	190	270	23	5	80	0.0625000
NODE_9561_length_875_cov_52.965206	190	270	24	59	80	0.7375000
NODE_9561_length_875_cov_52.965206	190	270	25	16	80	0.2000000
NODE_9561_length_875_cov_52.965206	243	323	0	20	80	0.2500000
NODE_9561_length_875_cov_52.965206	243	323	23	38	80	0.4750000
NODE_9561_length_875_cov_52.965206	243	323	24	16	80	0.2000000
NODE_9561_length_875_cov_52.965206	243	323	25	6	80	0.0750000
NODE_9561_length_875_cov_52.965206	319	399	0	80	80	1.0000000
NODE_9561_length_875_cov_52.965206	372	447	0	75	75	1.0000000
NODE_9562_length_875_cov_35.634021	260	340	4	80	80	1.0000000
NODE_9562_length_875_cov_35.634021	313	393	0	28	80	0.3500000
NODE_9562_length_875_cov_35.634021	313	393	4	52	80	0.6500000
NODE_9562_length_875_cov_35.634021	389	469	0	49	80	0.6125000
NODE_9562_length_875_cov_35.634021	389	469	6	31	80	0.3875000
NODE_9562_length_875_cov_35.634021	442	522	6	80	80	1.0000000
NODE_9563_length_875_cov_33.771907	363	441	0	78	78	1.0000000
NODE_9563_length_875_cov_33.771907	414	494	0	54	80	0.6750000
NODE_9563_length_875_cov_33.771907	414	494	2	26	80	0.3250000
NODE_9564_length_875_cov_29.698454	322	402	0	7	80	0.0875000
NODE_9564_length_875_cov_29.698454	322	402	2	73	80	0.9125000
NODE_9564_length_875_cov_29.698454	375	455	0	54	80	0.6750000
NODE_9564_length_875_cov_29.698454	375	455	2	26	80	0.3250000
NODE_9565_length_875_cov_23.041237	364	444	0	80	80	1.0000000
NODE_9565_length_875_cov_23.041237	417	497	0	80	80	1.0000000
NODE_9565_length_875_cov_23.041237	493	573	0	80	80	1.0000000
NODE_9565_length_875_cov_23.041237	546	626	0	80	80	1.0000000
NODE_9566_length_875_cov_9.800258	242	322	0	80	80	1.0000000
NODE_9566_length_875_cov_9.800258	295	376	0	81	81	1.0000000
NODE_9567_length_875_cov_8.195876	407	487	0	15	80	0.1875000
NODE_9567_length_875_cov_8.195876	407	487	2	30	80	0.3750000
NODE_9567_length_875_cov_8.195876	407	487	4	7	80	0.0875000
NODE_9567_length_875_cov_8.195876	407	487	6	28	80	0.3500000
NODE_9567_length_875_cov_8.195876	460	540	0	68	80	0.8500000
NODE_9567_length_875_cov_8.195876	460	540	2	12	80	0.1500000
NODE_9585_length_874_cov_48.925161	185	265	0	7	80	0.0875000
NODE_9585_length_874_cov_48.925161	185	265	6	73	80	0.9125000
NODE_9585_length_874_cov_48.925161	238	318	0	40	80	0.5000000
NODE_9585_length_874_cov_48.925161	238	318	6	40	80	0.5000000
NODE_9587_length_874_cov_37.354839	199	279	0	80	80	1.0000000
NODE_9587_length_874_cov_37.354839	252	332	0	80	80	1.0000000
NODE_9588_length_874_cov_35.040000	231	311	0	22	80	0.2750000
NODE_9588_length_874_cov_35.040000	231	311	4	11	80	0.1375000
NODE_9588_length_874_cov_35.040000	231	311	6	15	80	0.1875000
NODE_9588_length_874_cov_35.040000	231	311	8	32	80	0.4000000
NODE_9588_length_874_cov_35.040000	284	364	4	14	80	0.1750000
NODE_9588_length_874_cov_35.040000	284	364	8	66	80	0.8250000
NODE_9589_length_874_cov_23.415484	327	407	0	8	80	0.1000000
NODE_9589_length_874_cov_23.415484	327	407	4	72	80	0.9000000
NODE_9589_length_874_cov_23.415484	380	460	0	56	80	0.7000000
NODE_9589_length_874_cov_23.415484	380	460	4	24	80	0.3000000
NODE_9589_length_874_cov_23.415484	456	536	0	80	80	1.0000000
NODE_9589_length_874_cov_23.415484	509	589	0	80	80	1.0000000
NODE_9590_length_874_cov_21.885161	279	359	0	80	80	1.0000000
NODE_9590_length_874_cov_21.885161	332	412	0	80	80	1.0000000
NODE_9591_length_874_cov_11.172903	67	147	0	80	80	1.0000000
NODE_9591_length_874_cov_11.172903	120	200	0	80	80	1.0000000
NODE_9592_length_874_cov_9.645161	424	504	0	80	80	1.0000000
NODE_9592_length_874_cov_9.645161	477	557	0	80	80	1.0000000
NODE_9593_length_874_cov_8.637419	359	439	0	80	80	1.0000000
NODE_9593_length_874_cov_8.637419	412	499	0	87	87	1.0000000
NODE_9596_length_874_cov_4.785806	829	874	2	45	45	1.0000000
NODE_9618_length_873_cov_100.625323	50	130	16	4	80	0.0500000
NODE_9618_length_873_cov_100.625323	50	130	18	1	80	0.0125000
NODE_9618_length_873_cov_100.625323	50	130	26	4	80	0.0500000
NODE_9618_length_873_cov_100.625323	50	130	28	9	80	0.1125000
NODE_9618_length_873_cov_100.625323	50	130	32	2	80	0.0250000
NODE_9618_length_873_cov_100.625323	50	130	34	5	80	0.0625000
NODE_9618_length_873_cov_100.625323	50	130	36	55	80	0.6875000
NODE_9619_length_873_cov_45.633075	226	306	0	80	80	1.0000000
NODE_9619_length_873_cov_45.633075	279	359	0	80	80	1.0000000
NODE_9619_length_873_cov_45.633075	693	773	0	80	80	1.0000000
NODE_9619_length_873_cov_45.633075	746	826	0	27	80	0.3375000
NODE_9619_length_873_cov_45.633075	746	826	2	53	80	0.6625000
NODE_9620_length_873_cov_39.224806	190	270	0	80	80	1.0000000
NODE_9620_length_873_cov_39.224806	243	307	0	64	64	1.0000000
NODE_9620_length_873_cov_39.224806	390	470	1	80	80	1.0000000
NODE_9620_length_873_cov_39.224806	443	523	0	28	80	0.3500000
NODE_9620_length_873_cov_39.224806	443	523	1	52	80	0.6500000
NODE_9620_length_873_cov_39.224806	504	523	0	19	19	1.0000000
NODE_9620_length_873_cov_39.224806	519	599	0	17	80	0.2125000
NODE_9620_length_873_cov_39.224806	519	599	1	63	80	0.7875000
NODE_9620_length_873_cov_39.224806	572	652	1	80	80	1.0000000
NODE_9621_length_873_cov_27.992248	372	452	0	80	80	1.0000000
NODE_9621_length_873_cov_27.992248	425	505	0	80	80	1.0000000
NODE_9622_length_873_cov_23.270026	390	470	0	11	80	0.1375000
NODE_9622_length_873_cov_23.270026	390	470	4	2	80	0.0250000
NODE_9622_length_873_cov_23.270026	390	470	8	67	80	0.8375000
NODE_9622_length_873_cov_23.270026	443	528	0	69	85	0.8117647
NODE_9622_length_873_cov_23.270026	443	528	4	2	85	0.0235294
NODE_9622_length_873_cov_23.270026	443	528	8	14	85	0.1647059
NODE_9623_length_873_cov_23.197674	293	373	0	80	80	1.0000000
NODE_9623_length_873_cov_23.197674	346	426	0	80	80	1.0000000
NODE_9624_length_873_cov_20.432817	347	427	4	43	80	0.5375000
NODE_9624_length_873_cov_20.432817	347	427	8	37	80	0.4625000
NODE_9624_length_873_cov_20.432817	400	480	0	16	80	0.2000000
NODE_9624_length_873_cov_20.432817	400	480	4	50	80	0.6250000
NODE_9624_length_873_cov_20.432817	400	480	8	14	80	0.1750000
NODE_9624_length_873_cov_20.432817	476	556	0	80	80	1.0000000
NODE_9624_length_873_cov_20.432817	529	609	0	80	80	1.0000000
NODE_9625_length_873_cov_19.913437	445	525	0	80	80	1.0000000
NODE_9625_length_873_cov_19.913437	498	578	0	80	80	1.0000000
NODE_9626_length_873_cov_16.718346	276	356	0	6	80	0.0750000
NODE_9626_length_873_cov_16.718346	276	356	4	53	80	0.6625000
NODE_9626_length_873_cov_16.718346	276	356	6	21	80	0.2625000
NODE_9626_length_873_cov_16.718346	329	409	0	9	80	0.1125000
NODE_9626_length_873_cov_16.718346	329	409	2	30	80	0.3750000
NODE_9626_length_873_cov_16.718346	329	409	4	6	80	0.0750000
NODE_9626_length_873_cov_16.718346	329	409	6	35	80	0.4375000
NODE_9627_length_873_cov_16.422481	423	503	6	80	80	1.0000000
NODE_9627_length_873_cov_16.422481	476	556	0	36	80	0.4500000
NODE_9627_length_873_cov_16.422481	476	556	2	1	80	0.0125000
NODE_9627_length_873_cov_16.422481	476	556	6	43	80	0.5375000
NODE_9628_length_873_cov_11.198966	410	490	0	80	80	1.0000000
NODE_9628_length_873_cov_11.198966	463	543	0	80	80	1.0000000
NODE_9629_length_873_cov_9.799742	334	414	0	80	80	1.0000000
NODE_9629_length_873_cov_9.799742	387	467	0	80	80	1.0000000
NODE_9632_length_873_cov_3.828165	490	570	0	80	80	1.0000000
NODE_9632_length_873_cov_3.828165	543	583	0	33	40	0.8250000
NODE_9632_length_873_cov_3.828165	543	583	2	7	40	0.1750000
NODE_9632_length_873_cov_3.828165	690	735	0	45	45	1.0000000
NODE_9633_length_873_cov_3.443152	716	746	0	30	30	1.0000000
NODE_9647_length_873_cov_1.239018	593	658	0	13	65	0.2000000
NODE_9647_length_873_cov_1.239018	593	658	2	2	65	0.0307692
NODE_9647_length_873_cov_1.239018	593	658	4	4	65	0.0615385
NODE_9647_length_873_cov_1.239018	593	658	8	14	65	0.2153846
NODE_9647_length_873_cov_1.239018	593	658	10	5	65	0.0769231
NODE_9647_length_873_cov_1.239018	593	658	12	3	65	0.0461538
NODE_9647_length_873_cov_1.239018	593	658	14	24	65	0.3692308
NODE_9651_length_872_cov_47.732212	432	512	0	80	80	1.0000000
NODE_9651_length_872_cov_47.732212	484	564	0	80	80	1.0000000
NODE_9651_length_872_cov_47.732212	560	640	0	80	80	1.0000000
NODE_9651_length_872_cov_47.732212	613	693	0	80	80	1.0000000
NODE_9652_length_872_cov_16.204398	349	429	0	80	80	1.0000000
NODE_9652_length_872_cov_16.204398	402	482	0	80	80	1.0000000
NODE_9652_length_872_cov_16.204398	478	558	0	80	80	1.0000000
NODE_9652_length_872_cov_16.204398	531	611	0	80	80	1.0000000
NODE_9653_length_872_cov_12.835705	376	456	0	80	80	1.0000000
NODE_9653_length_872_cov_12.835705	429	509	0	80	80	1.0000000
NODE_9654_length_872_cov_9.657180	356	431	0	75	75	1.0000000
NODE_9660_length_872_cov_3.531695	425	505	0	80	80	1.0000000
NODE_9660_length_872_cov_3.531695	478	559	0	81	81	1.0000000
NODE_9673_length_871_cov_56.841969	265	345	0	80	80	1.0000000
NODE_9673_length_871_cov_56.841969	318	398	0	80	80	1.0000000
NODE_9673_length_871_cov_56.841969	394	474	0	31	80	0.3875000
NODE_9673_length_871_cov_56.841969	394	474	2	49	80	0.6125000
NODE_9673_length_871_cov_56.841969	447	527	0	20	80	0.2500000
NODE_9673_length_871_cov_56.841969	447	527	1	5	80	0.0625000
NODE_9673_length_871_cov_56.841969	447	527	2	55	80	0.6875000
NODE_9674_length_871_cov_47.528497	461	541	0	20	80	0.2500000
NODE_9674_length_871_cov_47.528497	461	541	1	37	80	0.4625000
NODE_9674_length_871_cov_47.528497	461	541	2	23	80	0.2875000
NODE_9674_length_871_cov_47.528497	514	594	1	4	80	0.0500000
NODE_9674_length_871_cov_47.528497	514	594	2	34	80	0.4250000
NODE_9674_length_871_cov_47.528497	514	594	4	42	80	0.5250000
NODE_9675_length_871_cov_31.145078	326	406	0	80	80	1.0000000
NODE_9675_length_871_cov_31.145078	379	459	0	80	80	1.0000000
NODE_9676_length_871_cov_27.993523	379	459	0	16	80	0.2000000
NODE_9676_length_871_cov_27.993523	379	459	2	36	80	0.4500000
NODE_9676_length_871_cov_27.993523	379	459	4	28	80	0.3500000
NODE_9676_length_871_cov_27.993523	432	512	2	32	80	0.4000000
NODE_9676_length_871_cov_27.993523	432	512	4	48	80	0.6000000
NODE_9677_length_871_cov_25.954663	463	543	40	36	80	0.4500000
NODE_9677_length_871_cov_25.954663	463	543	84	44	80	0.5500000
NODE_9677_length_871_cov_25.954663	516	596	65	4	80	0.0500000
NODE_9677_length_871_cov_25.954663	516	596	67	4	80	0.0500000
NODE_9677_length_871_cov_25.954663	516	596	68	20	80	0.2500000
NODE_9677_length_871_cov_25.954663	516	596	69	1	80	0.0125000
NODE_9677_length_871_cov_25.954663	516	596	70	2	80	0.0250000
NODE_9677_length_871_cov_25.954663	516	596	71	2	80	0.0250000
NODE_9677_length_871_cov_25.954663	516	596	72	8	80	0.1000000
NODE_9677_length_871_cov_25.954663	516	596	73	4	80	0.0500000
NODE_9677_length_871_cov_25.954663	516	596	81	3	80	0.0375000
NODE_9677_length_871_cov_25.954663	516	596	84	32	80	0.4000000
NODE_9678_length_871_cov_24.069948	492	558	0	66	66	1.0000000
NODE_9678_length_871_cov_24.069948	558	634	0	76	76	1.0000000
NODE_9679_length_871_cov_23.953368	445	522	2	18	77	0.2337662
NODE_9679_length_871_cov_23.953368	445	522	3	31	77	0.4025974
NODE_9679_length_871_cov_23.953368	445	522	4	2	77	0.0259740
NODE_9679_length_871_cov_23.953368	445	522	5	15	77	0.1948052
NODE_9679_length_871_cov_23.953368	445	522	6	1	77	0.0129870
NODE_9679_length_871_cov_23.953368	445	522	8	1	77	0.0129870
NODE_9679_length_871_cov_23.953368	445	522	10	9	77	0.1168831
NODE_9680_length_871_cov_19.304404	335	415	0	80	80	1.0000000
NODE_9680_length_871_cov_19.304404	388	468	0	80	80	1.0000000
NODE_9682_length_871_cov_18.108808	370	450	0	80	80	1.0000000
NODE_9682_length_871_cov_18.108808	423	503	0	80	80	1.0000000
NODE_9683_length_871_cov_17.034974	362	442	0	37	80	0.4625000
NODE_9683_length_871_cov_17.034974	362	442	2	43	80	0.5375000
NODE_9683_length_871_cov_17.034974	415	495	2	80	80	1.0000000
NODE_9684_length_871_cov_16.768135	374	454	0	80	80	1.0000000
NODE_9685_length_871_cov_14.196891	267	347	0	39	80	0.4875000
NODE_9685_length_871_cov_14.196891	267	347	6	41	80	0.5125000
NODE_9685_length_871_cov_14.196891	320	400	6	60	80	0.7500000
NODE_9685_length_871_cov_14.196891	320	400	8	20	80	0.2500000
NODE_9686_length_871_cov_13.443005	246	326	0	80	80	1.0000000
NODE_9686_length_871_cov_13.443005	299	322	0	23	23	1.0000000
NODE_9687_length_871_cov_11.839378	29	109	0	44	80	0.5500000
NODE_9687_length_871_cov_11.839378	29	109	2	36	80	0.4500000
NODE_9687_length_871_cov_11.839378	82	149	2	67	67	1.0000000
NODE_9687_length_871_cov_11.839378	331	411	0	80	80	1.0000000
NODE_9687_length_871_cov_11.839378	384	464	0	80	80	1.0000000
NODE_9689_length_871_cov_5.730570	316	373	0	57	57	1.0000000
NODE_9694_length_871_cov_3.544041	428	508	0	80	80	1.0000000
NODE_9694_length_871_cov_3.544041	481	561	0	80	80	1.0000000
NODE_9716_length_870_cov_43.400778	542	622	4	13	80	0.1625000
NODE_9716_length_870_cov_43.400778	542	622	29	13	80	0.1625000
NODE_9716_length_870_cov_43.400778	542	622	30	17	80	0.2125000
NODE_9716_length_870_cov_43.400778	542	622	33	35	80	0.4375000
NODE_9716_length_870_cov_43.400778	542	622	34	2	80	0.0250000
NODE_9716_length_870_cov_43.400778	595	675	29	66	80	0.8250000
NODE_9716_length_870_cov_43.400778	595	675	30	14	80	0.1750000
NODE_9719_length_870_cov_28.249027	442	524	0	82	82	1.0000000
NODE_9719_length_870_cov_28.249027	497	577	0	80	80	1.0000000
NODE_9720_length_870_cov_26.992218	240	320	0	21	80	0.2625000
NODE_9720_length_870_cov_26.992218	240	320	2	59	80	0.7375000
NODE_9720_length_870_cov_26.992218	293	373	0	13	80	0.1625000
NODE_9720_length_870_cov_26.992218	293	373	2	46	80	0.5750000
NODE_9720_length_870_cov_26.992218	293	373	4	21	80	0.2625000
NODE_9720_length_870_cov_26.992218	369	449	4	17	80	0.2125000
NODE_9720_length_870_cov_26.992218	369	449	6	63	80	0.7875000
NODE_9720_length_870_cov_26.992218	422	502	2	14	80	0.1750000
NODE_9720_length_870_cov_26.992218	422	502	4	31	80	0.3875000
NODE_9720_length_870_cov_26.992218	422	502	6	29	80	0.3625000
NODE_9720_length_870_cov_26.992218	422	502	8	6	80	0.0750000
NODE_9721_length_870_cov_25.806744	186	237	4	4	51	0.0784314
NODE_9721_length_870_cov_25.806744	186	237	6	33	51	0.6470588
NODE_9721_length_870_cov_25.806744	186	237	8	14	51	0.2745098
NODE_9721_length_870_cov_25.806744	391	471	0	2	80	0.0250000
NODE_9721_length_870_cov_25.806744	391	471	2	78	80	0.9750000
NODE_9721_length_870_cov_25.806744	444	524	0	14	80	0.1750000
NODE_9721_length_870_cov_25.806744	444	524	2	66	80	0.8250000
NODE_9722_length_870_cov_18.862516	345	425	0	46	80	0.5750000
NODE_9722_length_870_cov_18.862516	345	425	2	4	80	0.0500000
NODE_9722_length_870_cov_18.862516	345	425	4	30	80	0.3750000
NODE_9722_length_870_cov_18.862516	398	478	4	59	80	0.7375000
NODE_9722_length_870_cov_18.862516	398	478	6	21	80	0.2625000
NODE_9723_length_870_cov_15.686122	330	410	0	80	80	1.0000000
NODE_9723_length_870_cov_15.686122	383	463	0	80	80	1.0000000
NODE_9725_length_870_cov_13.334630	479	559	0	80	80	1.0000000
NODE_9725_length_870_cov_13.334630	532	612	0	80	80	1.0000000
NODE_9726_length_870_cov_9.712062	410	490	0	80	80	1.0000000
NODE_9726_length_870_cov_9.712062	463	542	0	79	79	1.0000000
NODE_9728_length_870_cov_7.556420	448	528	0	4	80	0.0500000
NODE_9728_length_870_cov_7.556420	448	528	2	76	80	0.9500000
NODE_9728_length_870_cov_7.556420	501	581	0	57	80	0.7125000
NODE_9728_length_870_cov_7.556420	501	581	2	23	80	0.2875000
NODE_9746_length_869_cov_42.784416	395	475	0	80	80	1.0000000
NODE_9746_length_869_cov_42.784416	448	528	0	76	80	0.9500000
NODE_9746_length_869_cov_42.784416	448	528	2	4	80	0.0500000
NODE_9747_length_869_cov_29.525974	211	291	0	80	80	1.0000000
NODE_9747_length_869_cov_29.525974	264	344	0	80	80	1.0000000
NODE_9748_length_869_cov_16.258442	389	469	0	80	80	1.0000000
NODE_9748_length_869_cov_16.258442	442	522	0	80	80	1.0000000
NODE_9749_length_869_cov_15.940260	321	401	0	36	80	0.4500000
NODE_9749_length_869_cov_15.940260	321	401	6	44	80	0.5500000
NODE_9749_length_869_cov_15.940260	374	454	0	13	80	0.1625000
NODE_9749_length_869_cov_15.940260	374	454	6	67	80	0.8375000
NODE_9750_length_869_cov_9.619481	402	442	152	1	40	0.0250000
NODE_9750_length_869_cov_9.619481	402	442	153	3	40	0.0750000
NODE_9750_length_869_cov_9.619481	402	442	154	1	40	0.0250000
NODE_9750_length_869_cov_9.619481	402	442	157	2	40	0.0500000
NODE_9750_length_869_cov_9.619481	402	442	158	4	40	0.1000000
NODE_9750_length_869_cov_9.619481	402	442	160	1	40	0.0250000
NODE_9750_length_869_cov_9.619481	402	442	164	2	40	0.0500000
NODE_9750_length_869_cov_9.619481	402	442	165	2	40	0.0500000
NODE_9750_length_869_cov_9.619481	402	442	166	1	40	0.0250000
NODE_9750_length_869_cov_9.619481	402	442	171	1	40	0.0250000
NODE_9750_length_869_cov_9.619481	402	442	172	1	40	0.0250000
NODE_9750_length_869_cov_9.619481	402	442	173	1	40	0.0250000
NODE_9750_length_869_cov_9.619481	402	442	175	3	40	0.0750000
NODE_9750_length_869_cov_9.619481	402	442	176	1	40	0.0250000
NODE_9750_length_869_cov_9.619481	402	442	177	4	40	0.1000000
NODE_9750_length_869_cov_9.619481	402	442	178	1	40	0.0250000
NODE_9750_length_869_cov_9.619481	402	442	179	2	40	0.0500000
NODE_9750_length_869_cov_9.619481	402	442	180	1	40	0.0250000
NODE_9750_length_869_cov_9.619481	402	442	194	1	40	0.0250000
NODE_9750_length_869_cov_9.619481	402	442	198	1	40	0.0250000
NODE_9750_length_869_cov_9.619481	402	442	203	1	40	0.0250000
NODE_9750_length_869_cov_9.619481	402	442	212	1	40	0.0250000
NODE_9750_length_869_cov_9.619481	402	442	233	2	40	0.0500000
NODE_9750_length_869_cov_9.619481	402	442	235	1	40	0.0250000
NODE_9750_length_869_cov_9.619481	402	442	241	1	40	0.0250000
NODE_9751_length_869_cov_7.123377	392	472	0	80	80	1.0000000
NODE_9751_length_869_cov_7.123377	445	525	0	80	80	1.0000000
NODE_9753_length_869_cov_3.658442	310	378	0	68	68	1.0000000
NODE_9777_length_868_cov_57.465540	355	435	0	7	80	0.0875000
NODE_9777_length_868_cov_57.465540	355	435	2	34	80	0.4250000
NODE_9777_length_868_cov_57.465540	355	435	5	39	80	0.4875000
NODE_9778_length_868_cov_46.509753	0	65	0	65	65	1.0000000
NODE_9778_length_868_cov_46.509753	0	65	0	65	65	1.0000000
NODE_9778_length_868_cov_46.509753	0	65	0	65	65	1.0000000
NODE_9778_length_868_cov_46.509753	0	65	0	65	65	1.0000000
NODE_9778_length_868_cov_46.509753	61	141	0	18	80	0.2250000
NODE_9778_length_868_cov_46.509753	61	141	2	62	80	0.7750000
NODE_9778_length_868_cov_46.509753	61	141	0	18	80	0.2250000
NODE_9778_length_868_cov_46.509753	61	141	2	62	80	0.7750000
NODE_9778_length_868_cov_46.509753	114	194	0	21	80	0.2625000
NODE_9778_length_868_cov_46.509753	114	194	2	59	80	0.7375000
NODE_9778_length_868_cov_46.509753	114	194	0	21	80	0.2625000
NODE_9778_length_868_cov_46.509753	114	194	2	59	80	0.7375000
NODE_9779_length_868_cov_26.092328	318	398	0	74	80	0.9250000
NODE_9779_length_868_cov_26.092328	318	398	2	6	80	0.0750000
NODE_9779_length_868_cov_26.092328	371	451	0	80	80	1.0000000
NODE_9781_length_868_cov_22.555267	377	457	8	66	80	0.8250000
NODE_9781_length_868_cov_22.555267	377	457	10	14	80	0.1750000
NODE_9781_length_868_cov_22.555267	430	510	0	14	80	0.1750000
NODE_9781_length_868_cov_22.555267	430	510	2	8	80	0.1000000
NODE_9781_length_868_cov_22.555267	430	510	8	58	80	0.7250000
NODE_9782_length_868_cov_20.466840	259	339	0	57	80	0.7125000
NODE_9782_length_868_cov_20.466840	259	339	2	23	80	0.2875000
NODE_9782_length_868_cov_20.466840	312	392	0	80	80	1.0000000
NODE_9782_length_868_cov_20.466840	388	468	0	80	80	1.0000000
NODE_9782_length_868_cov_20.466840	441	521	0	80	80	1.0000000
NODE_9783_length_868_cov_20.414824	311	391	0	60	80	0.7500000
NODE_9783_length_868_cov_20.414824	311	391	2	20	80	0.2500000
NODE_9783_length_868_cov_20.414824	364	444	0	80	80	1.0000000
NODE_9784_length_868_cov_17.613784	340	420	0	80	80	1.0000000
NODE_9784_length_868_cov_17.613784	393	473	0	80	80	1.0000000
NODE_9785_length_868_cov_15.768531	353	433	0	80	80	1.0000000
NODE_9785_length_868_cov_15.768531	406	486	0	80	80	1.0000000
NODE_9786_length_868_cov_13.997399	611	691	0	12	80	0.1500000
NODE_9786_length_868_cov_13.997399	611	691	6	68	80	0.8500000
NODE_9786_length_868_cov_13.997399	664	744	0	65	80	0.8125000
NODE_9786_length_868_cov_13.997399	664	744	6	15	80	0.1875000
NODE_9787_length_868_cov_13.224967	451	531	0	30	80	0.3750000
NODE_9787_length_868_cov_13.224967	451	531	2	24	80	0.3000000
NODE_9787_length_868_cov_13.224967	451	531	4	26	80	0.3250000
NODE_9787_length_868_cov_13.224967	504	583	2	1	79	0.0126582
NODE_9787_length_868_cov_13.224967	504	583	4	78	79	0.9873418
NODE_9788_length_868_cov_11.851756	363	422	0	59	59	1.0000000
NODE_9788_length_868_cov_11.851756	395	475	0	80	80	1.0000000
NODE_9789_length_868_cov_11.352406	361	441	0	80	80	1.0000000
NODE_9789_length_868_cov_11.352406	414	494	0	80	80	1.0000000
NODE_9790_length_868_cov_11.335501	289	369	0	15	80	0.1875000
NODE_9790_length_868_cov_11.335501	289	369	2	65	80	0.8125000
NODE_9790_length_868_cov_11.335501	342	422	0	19	80	0.2375000
NODE_9790_length_868_cov_11.335501	342	422	2	61	80	0.7625000
NODE_9791_length_868_cov_8.455137	401	481	0	9	80	0.1125000
NODE_9791_length_868_cov_8.455137	401	481	4	19	80	0.2375000
NODE_9791_length_868_cov_8.455137	401	481	8	52	80	0.6500000
NODE_9791_length_868_cov_8.455137	454	534	0	34	80	0.4250000
NODE_9791_length_868_cov_8.455137	454	534	4	12	80	0.1500000
NODE_9791_length_868_cov_8.455137	454	534	8	34	80	0.4250000
NODE_9816_length_867_cov_27.756510	333	376	0	43	43	1.0000000
NODE_9816_length_867_cov_27.756510	349	429	0	80	80	1.0000000
NODE_9816_length_867_cov_27.756510	425	505	0	80	80	1.0000000
NODE_9816_length_867_cov_27.756510	478	542	0	64	64	1.0000000
NODE_9817_length_867_cov_25.354167	280	345	2	19	65	0.2923077
NODE_9817_length_867_cov_25.354167	280	345	4	11	65	0.1692308
NODE_9817_length_867_cov_25.354167	280	345	5	32	65	0.4923077
NODE_9817_length_867_cov_25.354167	280	345	6	3	65	0.0461538
NODE_9817_length_867_cov_25.354167	325	397	4	61	72	0.8472222
NODE_9817_length_867_cov_25.354167	325	397	5	8	72	0.1111111
NODE_9817_length_867_cov_25.354167	325	397	6	3	72	0.0416667
NODE_9818_length_867_cov_23.968750	369	449	0	80	80	1.0000000
NODE_9818_length_867_cov_23.968750	422	502	0	80	80	1.0000000
NODE_9819_length_867_cov_21.220052	524	604	0	62	80	0.7750000
NODE_9819_length_867_cov_21.220052	524	604	2	18	80	0.2250000
NODE_9819_length_867_cov_21.220052	577	657	0	9	80	0.1125000
NODE_9819_length_867_cov_21.220052	577	657	2	71	80	0.8875000
NODE_9820_length_867_cov_15.042969	287	364	0	4	77	0.0519481
NODE_9820_length_867_cov_15.042969	287	364	2	73	77	0.9480519
NODE_9821_length_867_cov_11.057292	305	373	0	29	68	0.4264706
NODE_9821_length_867_cov_11.057292	305	373	2	39	68	0.5735294
NODE_9821_length_867_cov_11.057292	346	426	0	6	80	0.0750000
NODE_9821_length_867_cov_11.057292	346	426	2	74	80	0.9250000
NODE_9821_length_867_cov_11.057292	475	555	0	80	80	1.0000000
NODE_9822_length_867_cov_8.127604	347	427	0	80	80	1.0000000
NODE_9822_length_867_cov_8.127604	400	480	0	80	80	1.0000000
NODE_9823_length_867_cov_7.621094	292	372	0	80	80	1.0000000
NODE_9823_length_867_cov_7.621094	345	425	0	80	80	1.0000000
NODE_9826_length_867_cov_5.494792	445	525	0	80	80	1.0000000
NODE_9826_length_867_cov_5.494792	498	578	0	80	80	1.0000000
NODE_9857_length_866_cov_49.224250	269	349	0	80	80	1.0000000
NODE_9857_length_866_cov_49.224250	322	402	0	37	80	0.4625000
NODE_9857_length_866_cov_49.224250	322	402	4	5	80	0.0625000
NODE_9857_length_866_cov_49.224250	322	402	6	38	80	0.4750000
NODE_9858_length_866_cov_47.160365	428	508	0	45	80	0.5625000
NODE_9858_length_866_cov_47.160365	428	508	4	35	80	0.4375000
NODE_9858_length_866_cov_47.160365	481	561	0	19	80	0.2375000
NODE_9858_length_866_cov_47.160365	481	561	4	61	80	0.7625000
NODE_9858_length_866_cov_47.160365	557	637	0	16	80	0.2000000
NODE_9858_length_866_cov_47.160365	557	637	2	45	80	0.5625000
NODE_9858_length_866_cov_47.160365	557	637	4	19	80	0.2375000
NODE_9858_length_866_cov_47.160365	610	690	0	19	80	0.2375000
NODE_9858_length_866_cov_47.160365	610	690	2	25	80	0.3125000
NODE_9858_length_866_cov_47.160365	610	690	4	36	80	0.4500000
NODE_9859_length_866_cov_23.398957	281	361	0	26	80	0.3250000
NODE_9859_length_866_cov_23.398957	281	361	2	54	80	0.6750000
NODE_9859_length_866_cov_23.398957	334	414	0	14	80	0.1750000
NODE_9859_length_866_cov_23.398957	334	414	2	66	80	0.8250000
NODE_9860_length_866_cov_22.186441	455	535	0	31	80	0.3875000
NODE_9860_length_866_cov_22.186441	455	535	2	49	80	0.6125000
NODE_9860_length_866_cov_22.186441	508	588	0	80	80	1.0000000
NODE_9861_length_866_cov_18.362451	451	531	0	4	80	0.0500000
NODE_9861_length_866_cov_18.362451	451	531	7	1	80	0.0125000
NODE_9861_length_866_cov_18.362451	451	531	8	8	80	0.1000000
NODE_9861_length_866_cov_18.362451	451	531	15	1	80	0.0125000
NODE_9861_length_866_cov_18.362451	451	531	16	66	80	0.8250000
NODE_9861_length_866_cov_18.362451	504	584	0	57	80	0.7125000
NODE_9861_length_866_cov_18.362451	504	584	7	1	80	0.0125000
NODE_9861_length_866_cov_18.362451	504	584	8	8	80	0.1000000
NODE_9861_length_866_cov_18.362451	504	584	15	1	80	0.0125000
NODE_9861_length_866_cov_18.362451	504	584	16	13	80	0.1625000
NODE_9862_length_866_cov_16.830508	372	452	0	76	80	0.9500000
NODE_9862_length_866_cov_16.830508	372	452	2	4	80	0.0500000
NODE_9862_length_866_cov_16.830508	425	505	0	23	80	0.2875000
NODE_9862_length_866_cov_16.830508	425	505	2	57	80	0.7125000
NODE_9882_length_865_cov_63.137076	288	368	0	80	80	1.0000000
NODE_9882_length_865_cov_63.137076	341	421	0	80	80	1.0000000
NODE_9883_length_865_cov_19.882507	335	415	0	80	80	1.0000000
NODE_9883_length_865_cov_19.882507	388	468	0	80	80	1.0000000
NODE_9884_length_865_cov_17.784595	306	386	0	80	80	1.0000000
NODE_9884_length_865_cov_17.784595	359	439	0	61	80	0.7625000
NODE_9884_length_865_cov_17.784595	359	439	2	19	80	0.2375000
NODE_9885_length_865_cov_16.150131	451	531	4	20	80	0.2500000
NODE_9885_length_865_cov_16.150131	451	531	6	60	80	0.7500000
NODE_9885_length_865_cov_16.150131	504	584	0	4	80	0.0500000
NODE_9885_length_865_cov_16.150131	504	584	2	27	80	0.3375000
NODE_9885_length_865_cov_16.150131	504	584	3	1	80	0.0125000
NODE_9885_length_865_cov_16.150131	504	584	4	41	80	0.5125000
NODE_9885_length_865_cov_16.150131	504	584	6	7	80	0.0875000
NODE_9886_length_865_cov_14.751958	473	553	0	80	80	1.0000000
NODE_9886_length_865_cov_14.751958	473	553	0	80	80	1.0000000
NODE_9886_length_865_cov_14.751958	526	589	0	63	63	1.0000000
NODE_9886_length_865_cov_14.751958	526	606	0	80	80	1.0000000
NODE_9887_length_865_cov_10.937337	422	502	0	80	80	1.0000000
NODE_9887_length_865_cov_10.937337	475	555	0	80	80	1.0000000
NODE_9889_length_865_cov_9.167102	389	469	0	27	80	0.3375000
NODE_9889_length_865_cov_9.167102	389	469	2	53	80	0.6625000
NODE_9889_length_865_cov_9.167102	442	522	0	31	80	0.3875000
NODE_9889_length_865_cov_9.167102	442	522	2	49	80	0.6125000
NODE_9912_length_864_cov_13.398693	491	571	1	62	80	0.7750000
NODE_9912_length_864_cov_13.398693	491	571	3	18	80	0.2250000
NODE_9912_length_864_cov_13.398693	544	624	0	14	80	0.1750000
NODE_9912_length_864_cov_13.398693	544	624	1	31	80	0.3875000
NODE_9912_length_864_cov_13.398693	544	624	3	35	80	0.4375000
NODE_9913_length_864_cov_8.466667	308	388	8	80	80	1.0000000
NODE_9913_length_864_cov_8.466667	361	441	0	49	80	0.6125000
NODE_9913_length_864_cov_8.466667	361	441	8	31	80	0.3875000
NODE_9917_length_864_cov_3.947712	651	676	0	25	25	1.0000000
NODE_9917_length_864_cov_3.947712	725	805	2	66	80	0.8250000
NODE_9917_length_864_cov_3.947712	725	805	4	14	80	0.1750000
NODE_9917_length_864_cov_3.947712	778	844	2	66	66	1.0000000
NODE_9931_length_863_cov_72.856021	241	321	1	39	80	0.4875000
NODE_9931_length_863_cov_72.856021	241	321	2	41	80	0.5125000
NODE_9931_length_863_cov_72.856021	294	374	1	80	80	1.0000000
NODE_9931_length_863_cov_72.856021	370	450	0	58	80	0.7250000
NODE_9931_length_863_cov_72.856021	370	450	1	5	80	0.0625000
NODE_9931_length_863_cov_72.856021	370	450	4	17	80	0.2125000
NODE_9931_length_863_cov_72.856021	423	503	0	10	80	0.1250000
NODE_9931_length_863_cov_72.856021	423	503	4	31	80	0.3875000
NODE_9931_length_863_cov_72.856021	423	503	8	39	80	0.4875000
NODE_9932_length_863_cov_37.130890	363	443	0	80	80	1.0000000
NODE_9932_length_863_cov_37.130890	416	496	0	80	80	1.0000000
NODE_9932_length_863_cov_37.130890	492	572	0	74	80	0.9250000
NODE_9932_length_863_cov_37.130890	492	572	2	6	80	0.0750000
NODE_9932_length_863_cov_37.130890	545	617	0	21	72	0.2916667
NODE_9932_length_863_cov_37.130890	545	617	2	51	72	0.7083333
NODE_9933_length_863_cov_33.159686	287	367	0	80	80	1.0000000
NODE_9933_length_863_cov_33.159686	340	420	0	80	80	1.0000000
NODE_9934_length_863_cov_24.714660	370	450	0	80	80	1.0000000
NODE_9934_length_863_cov_24.714660	423	503	0	80	80	1.0000000
NODE_9935_length_863_cov_21.945026	341	421	0	80	80	1.0000000
NODE_9935_length_863_cov_21.945026	394	474	0	32	80	0.4000000
NODE_9935_length_863_cov_21.945026	394	474	2	48	80	0.6000000
NODE_9936_length_863_cov_19.794503	393	473	0	11	80	0.1375000
NODE_9936_length_863_cov_19.794503	393	473	4	69	80	0.8625000
NODE_9936_length_863_cov_19.794503	446	526	0	64	80	0.8000000
NODE_9936_length_863_cov_19.794503	446	526	4	16	80	0.2000000
NODE_9937_length_863_cov_11.778796	303	383	0	26	80	0.3250000
NODE_9937_length_863_cov_11.778796	303	383	2	54	80	0.6750000
NODE_9937_length_863_cov_11.778796	356	436	0	31	80	0.3875000
NODE_9937_length_863_cov_11.778796	356	436	2	49	80	0.6125000
NODE_9938_length_863_cov_10.026178	283	363	0	22	80	0.2750000
NODE_9938_length_863_cov_10.026178	283	363	6	58	80	0.7250000
NODE_9938_length_863_cov_10.026178	336	416	0	32	80	0.4000000
NODE_9938_length_863_cov_10.026178	336	416	6	48	80	0.6000000
NODE_9957_length_862_cov_46.811271	272	352	0	80	80	1.0000000
NODE_9957_length_862_cov_46.811271	325	405	0	80	80	1.0000000
NODE_9957_length_862_cov_46.811271	401	481	0	80	80	1.0000000
NODE_9957_length_862_cov_46.811271	454	534	0	80	80	1.0000000
NODE_9958_length_862_cov_34.638270	259	339	0	17	80	0.2125000
NODE_9958_length_862_cov_34.638270	259	339	2	60	80	0.7500000
NODE_9958_length_862_cov_34.638270	259	339	4	3	80	0.0375000
NODE_9958_length_862_cov_34.638270	312	392	0	52	80	0.6500000
NODE_9958_length_862_cov_34.638270	312	392	2	28	80	0.3500000
NODE_9958_length_862_cov_34.638270	388	468	0	27	80	0.3375000
NODE_9958_length_862_cov_34.638270	388	468	2	53	80	0.6625000
NODE_9958_length_862_cov_34.638270	441	521	0	20	80	0.2500000
NODE_9958_length_862_cov_34.638270	441	521	2	60	80	0.7500000
NODE_9959_length_862_cov_32.068152	468	548	0	50	80	0.6250000
NODE_9959_length_862_cov_32.068152	468	548	4	30	80	0.3750000
NODE_9959_length_862_cov_32.068152	521	601	4	80	80	1.0000000
NODE_9960_length_862_cov_23.584535	526	606	0	80	80	1.0000000
NODE_9960_length_862_cov_23.584535	579	659	0	80	80	1.0000000
NODE_9961_length_862_cov_19.980341	347	427	0	45	80	0.5625000
NODE_9961_length_862_cov_19.980341	347	427	2	33	80	0.4125000
NODE_9961_length_862_cov_19.980341	347	427	8	2	80	0.0250000
NODE_9961_length_862_cov_19.980341	400	480	2	25	80	0.3125000
NODE_9961_length_862_cov_19.980341	400	480	6	7	80	0.0875000
NODE_9961_length_862_cov_19.980341	400	480	8	48	80	0.6000000
NODE_9962_length_862_cov_19.079948	379	459	0	80	80	1.0000000
NODE_9962_length_862_cov_19.079948	432	512	0	80	80	1.0000000
NODE_9963_length_862_cov_18.425950	94	174	0	80	80	1.0000000
NODE_9963_length_862_cov_18.425950	147	201	0	54	54	1.0000000
NODE_9963_length_862_cov_18.425950	392	472	0	80	80	1.0000000
NODE_9963_length_862_cov_18.425950	445	525	0	65	80	0.8125000
NODE_9963_length_862_cov_18.425950	445	525	2	15	80	0.1875000
NODE_9964_length_862_cov_11.740498	348	428	0	24	80	0.3000000
NODE_9964_length_862_cov_11.740498	348	428	2	1	80	0.0125000
NODE_9964_length_862_cov_11.740498	348	428	4	55	80	0.6875000
NODE_9964_length_862_cov_11.740498	401	481	0	11	80	0.1375000
NODE_9964_length_862_cov_11.740498	401	481	2	9	80	0.1125000
NODE_9964_length_862_cov_11.740498	401	481	4	60	80	0.7500000
NODE_9965_length_862_cov_11.685452	292	372	0	80	80	1.0000000
NODE_9965_length_862_cov_11.685452	345	425	0	80	80	1.0000000
NODE_9966_length_862_cov_8.259502	385	465	0	64	80	0.8000000
NODE_9966_length_862_cov_8.259502	385	465	2	16	80	0.2000000
NODE_9966_length_862_cov_8.259502	438	518	0	80	80	1.0000000
NODE_9970_length_862_cov_2.895151	388	468	0	44	80	0.5500000
NODE_9970_length_862_cov_2.895151	388	468	2	36	80	0.4500000
NODE_9970_length_862_cov_2.895151	441	521	0	80	80	1.0000000
NODE_9984_length_861_cov_52.679790	450	530	0	63	80	0.7875000
NODE_9984_length_861_cov_52.679790	450	530	2	17	80	0.2125000
NODE_9984_length_861_cov_52.679790	503	583	0	10	80	0.1250000
NODE_9984_length_861_cov_52.679790	503	583	2	39	80	0.4875000
NODE_9984_length_861_cov_52.679790	503	583	4	31	80	0.3875000
NODE_9985_length_861_cov_34.868766	470	550	2	80	80	1.0000000
NODE_9985_length_861_cov_34.868766	523	603	0	34	80	0.4250000
NODE_9985_length_861_cov_34.868766	523	603	2	46	80	0.5750000
NODE_9986_length_861_cov_25.622047	145	225	0	22	80	0.2750000
NODE_9986_length_861_cov_25.622047	145	225	2	41	80	0.5125000
NODE_9986_length_861_cov_25.622047	145	225	4	17	80	0.2125000
NODE_9986_length_861_cov_25.622047	198	278	2	63	80	0.7875000
NODE_9986_length_861_cov_25.622047	198	278	4	17	80	0.2125000
NODE_9987_length_861_cov_22.052493	401	481	0	80	80	1.0000000
NODE_9987_length_861_cov_22.052493	454	534	0	80	80	1.0000000
NODE_9988_length_861_cov_19.913386	400	480	0	23	80	0.2875000
NODE_9988_length_861_cov_19.913386	400	480	9	1	80	0.0125000
NODE_9988_length_861_cov_19.913386	400	480	10	56	80	0.7000000
NODE_9988_length_861_cov_19.913386	453	533	0	11	80	0.1375000
NODE_9988_length_861_cov_19.913386	453	533	9	1	80	0.0125000
NODE_9988_length_861_cov_19.913386	453	533	10	68	80	0.8500000
NODE_9989_length_861_cov_15.237533	492	572	0	80	80	1.0000000
NODE_9989_length_861_cov_15.237533	545	625	0	80	80	1.0000000
NODE_9990_length_861_cov_12.460630	451	531	0	80	80	1.0000000
NODE_9990_length_861_cov_12.460630	504	584	0	80	80	1.0000000
NODE_9991_length_861_cov_9.463255	446	526	0	80	80	1.0000000
NODE_9991_length_861_cov_9.463255	499	579	0	80	80	1.0000000
NODE_9992_length_861_cov_9.435696	348	423	0	22	75	0.2933333
NODE_9992_length_861_cov_9.435696	348	423	2	53	75	0.7066666
NODE_9993_length_861_cov_7.009186	51	91	0	40	40	1.0000000
NODE_9993_length_861_cov_7.009186	185	265	0	80	80	1.0000000
NODE_9993_length_861_cov_7.009186	238	318	0	80	80	1.0000000
NODE_10019_length_860_cov_54.315375	245	325	0	80	80	1.0000000
NODE_10019_length_860_cov_54.315375	298	378	0	80	80	1.0000000
NODE_10019_length_860_cov_54.315375	374	454	0	14	80	0.1750000
NODE_10019_length_860_cov_54.315375	374	454	8	12	80	0.1500000
NODE_10019_length_860_cov_54.315375	374	454	10	54	80	0.6750000
NODE_10019_length_860_cov_54.315375	427	507	0	4	80	0.0500000
NODE_10019_length_860_cov_54.315375	427	507	10	76	80	0.9500000
NODE_10020_length_860_cov_29.618922	356	436	0	80	80	1.0000000
NODE_10020_length_860_cov_29.618922	409	489	0	80	80	1.0000000
NODE_10021_length_860_cov_15.152431	393	473	0	34	80	0.4250000
NODE_10021_length_860_cov_15.152431	393	473	2	46	80	0.5750000
NODE_10021_length_860_cov_15.152431	446	526	2	71	80	0.8875000
NODE_10021_length_860_cov_15.152431	446	526	4	9	80	0.1125000
NODE_10022_length_860_cov_11.320631	343	423	0	38	80	0.4750000
NODE_10022_length_860_cov_11.320631	343	423	2	42	80	0.5250000
NODE_10022_length_860_cov_11.320631	396	476	0	80	80	1.0000000
NODE_10049_length_859_cov_48.173684	432	512	2	76	80	0.9500000
NODE_10049_length_859_cov_48.173684	432	512	4	4	80	0.0500000
NODE_10049_length_859_cov_48.173684	485	565	2	28	80	0.3500000
NODE_10049_length_859_cov_48.173684	485	565	4	26	80	0.3250000
NODE_10049_length_859_cov_48.173684	485	565	6	26	80	0.3250000
NODE_10050_length_859_cov_24.957895	402	482	0	6	80	0.0750000
NODE_10050_length_859_cov_24.957895	402	482	5	36	80	0.4500000
NODE_10050_length_859_cov_24.957895	402	482	10	5	80	0.0625000
NODE_10050_length_859_cov_24.957895	402	482	12	33	80	0.4125000
NODE_10050_length_859_cov_24.957895	455	535	0	17	80	0.2125000
NODE_10050_length_859_cov_24.957895	455	535	2	42	80	0.5250000
NODE_10050_length_859_cov_24.957895	455	535	5	21	80	0.2625000
NODE_10051_length_859_cov_23.431579	251	331	0	78	80	0.9750000
NODE_10051_length_859_cov_23.431579	251	331	1	2	80	0.0250000
NODE_10051_length_859_cov_23.431579	304	384	0	25	80	0.3125000
NODE_10051_length_859_cov_23.431579	304	384	1	16	80	0.2000000
NODE_10051_length_859_cov_23.431579	304	384	2	39	80	0.4875000
NODE_10052_length_859_cov_20.523684	341	421	0	80	80	1.0000000
NODE_10052_length_859_cov_20.523684	394	474	0	80	80	1.0000000
NODE_10053_length_859_cov_17.996053	316	396	0	80	80	1.0000000
NODE_10053_length_859_cov_17.996053	369	449	0	80	80	1.0000000
NODE_10054_length_859_cov_16.757895	404	484	0	80	80	1.0000000
NODE_10054_length_859_cov_16.757895	457	537	0	80	80	1.0000000
NODE_10055_length_859_cov_15.852632	346	426	0	72	80	0.9000000
NODE_10055_length_859_cov_15.852632	346	426	2	8	80	0.1000000
NODE_10055_length_859_cov_15.852632	399	479	0	19	80	0.2375000
NODE_10055_length_859_cov_15.852632	399	479	2	16	80	0.2000000
NODE_10055_length_859_cov_15.852632	399	479	3	18	80	0.2250000
NODE_10055_length_859_cov_15.852632	399	479	4	27	80	0.3375000
NODE_10056_length_859_cov_11.584211	407	487	0	77	80	0.9625000
NODE_10056_length_859_cov_11.584211	407	487	2	3	80	0.0375000
NODE_10056_length_859_cov_11.584211	460	540	0	80	80	1.0000000
NODE_10057_length_859_cov_10.296053	368	448	0	80	80	1.0000000
NODE_10057_length_859_cov_10.296053	421	501	0	80	80	1.0000000
NODE_10066_length_859_cov_2.359211	498	578	0	80	80	1.0000000
NODE_10066_length_859_cov_2.359211	551	631	0	80	80	1.0000000
NODE_10079_length_858_cov_54.677207	277	357	0	80	80	1.0000000
NODE_10079_length_858_cov_54.677207	330	410	0	80	80	1.0000000
NODE_10080_length_858_cov_40.584980	500	580	0	80	80	1.0000000
NODE_10080_length_858_cov_40.584980	553	633	0	80	80	1.0000000
NODE_10081_length_858_cov_30.177866	363	443	4	38	80	0.4750000
NODE_10081_length_858_cov_30.177866	363	443	6	23	80	0.2875000
NODE_10081_length_858_cov_30.177866	363	443	8	19	80	0.2375000
NODE_10081_length_858_cov_30.177866	416	496	2	1	80	0.0125000
NODE_10081_length_858_cov_30.177866	416	496	4	68	80	0.8500000
NODE_10081_length_858_cov_30.177866	416	496	6	11	80	0.1375000
NODE_10081_length_858_cov_30.177866	492	572	0	22	80	0.2750000
NODE_10081_length_858_cov_30.177866	492	572	1	22	80	0.2750000
NODE_10081_length_858_cov_30.177866	492	572	4	36	80	0.4500000
NODE_10081_length_858_cov_30.177866	545	625	0	5	80	0.0625000
NODE_10081_length_858_cov_30.177866	545	625	1	75	80	0.9375000
NODE_10082_length_858_cov_18.534914	371	451	0	80	80	1.0000000
NODE_10082_length_858_cov_18.534914	424	504	0	80	80	1.0000000
NODE_10083_length_858_cov_15.378129	232	312	0	80	80	1.0000000
NODE_10083_length_858_cov_15.378129	285	365	0	29	80	0.3625000
NODE_10083_length_858_cov_15.378129	285	365	2	45	80	0.5625000
NODE_10083_length_858_cov_15.378129	285	365	4	6	80	0.0750000
NODE_10084_length_858_cov_12.310935	335	415	3	7	80	0.0875000
NODE_10084_length_858_cov_12.310935	335	415	5	31	80	0.3875000
NODE_10084_length_858_cov_12.310935	335	415	6	42	80	0.5250000
NODE_10084_length_858_cov_12.310935	388	468	0	31	80	0.3875000
NODE_10084_length_858_cov_12.310935	388	468	2	4	80	0.0500000
NODE_10084_length_858_cov_12.310935	388	468	6	45	80	0.5625000
NODE_10085_length_858_cov_7.835310	396	479	0	83	83	1.0000000
NODE_10085_length_858_cov_7.835310	452	532	0	80	80	1.0000000
NODE_10088_length_858_cov_4.953887	474	554	0	16	80	0.2000000
NODE_10088_length_858_cov_4.953887	474	554	2	64	80	0.8000000
NODE_10088_length_858_cov_4.953887	527	607	0	69	80	0.8625000
NODE_10088_length_858_cov_4.953887	527	607	2	11	80	0.1375000
NODE_10091_length_858_cov_3.475626	428	502	0	74	74	1.0000000
NODE_10091_length_858_cov_3.475626	498	578	0	38	80	0.4750000
NODE_10091_length_858_cov_3.475626	498	578	2	42	80	0.5250000
NODE_10091_length_858_cov_3.475626	551	631	2	75	80	0.9375000
NODE_10091_length_858_cov_3.475626	551	631	4	5	80	0.0625000
NODE_10108_length_857_cov_33.449868	384	455	0	28	71	0.3943662
NODE_10108_length_857_cov_33.449868	384	455	4	43	71	0.6056338
NODE_10108_length_857_cov_33.449868	437	518	0	2	81	0.0246914
NODE_10108_length_857_cov_33.449868	437	518	4	79	81	0.9753087
NODE_10109_length_857_cov_32.527704	391	471	0	21	80	0.2625000
NODE_10109_length_857_cov_32.527704	391	471	4	15	80	0.1875000
NODE_10109_length_857_cov_32.527704	391	471	6	40	80	0.5000000
NODE_10109_length_857_cov_32.527704	391	471	8	2	80	0.0250000
NODE_10109_length_857_cov_32.527704	391	471	11	2	80	0.0250000
NODE_10109_length_857_cov_32.527704	444	524	0	67	80	0.8375000
NODE_10109_length_857_cov_32.527704	444	524	2	7	80	0.0875000
NODE_10109_length_857_cov_32.527704	444	524	4	6	80	0.0750000
NODE_10110_length_857_cov_27.853562	310	390	0	55	80	0.6875000
NODE_10110_length_857_cov_27.853562	310	390	5	25	80	0.3125000
NODE_10110_length_857_cov_27.853562	363	443	0	2	80	0.0250000
NODE_10110_length_857_cov_27.853562	363	443	5	59	80	0.7375000
NODE_10110_length_857_cov_27.853562	363	443	6	19	80	0.2375000
NODE_10111_length_857_cov_24.654354	282	362	2	80	80	1.0000000
NODE_10111_length_857_cov_24.654354	335	415	0	23	80	0.2875000
NODE_10111_length_857_cov_24.654354	335	415	2	57	80	0.7125000
NODE_10112_length_857_cov_22.604222	374	456	0	82	82	1.0000000
NODE_10112_length_857_cov_22.604222	427	509	0	82	82	1.0000000
NODE_10113_length_857_cov_17.399736	320	400	0	8	80	0.1000000
NODE_10113_length_857_cov_17.399736	320	400	2	72	80	0.9000000
NODE_10113_length_857_cov_17.399736	373	453	0	29	80	0.3625000
NODE_10113_length_857_cov_17.399736	373	453	2	51	80	0.6375000
NODE_10114_length_857_cov_17.069921	388	468	0	41	80	0.5125000
NODE_10114_length_857_cov_17.069921	388	468	4	15	80	0.1875000
NODE_10114_length_857_cov_17.069921	388	468	6	24	80	0.3000000
NODE_10114_length_857_cov_17.069921	441	521	0	80	80	1.0000000
NODE_10115_length_857_cov_11.816623	433	513	2	29	80	0.3625000
NODE_10115_length_857_cov_11.816623	433	513	4	42	80	0.5250000
NODE_10115_length_857_cov_11.816623	433	513	6	9	80	0.1125000
NODE_10115_length_857_cov_11.816623	486	566	0	39	80	0.4875000
NODE_10115_length_857_cov_11.816623	486	566	4	41	80	0.5125000
NODE_10116_length_857_cov_6.733509	513	593	0	14	80	0.1750000
NODE_10116_length_857_cov_6.733509	513	593	3	66	80	0.8250000
NODE_10117_length_857_cov_6.251979	298	378	0	22	80	0.2750000
NODE_10117_length_857_cov_6.251979	298	378	2	58	80	0.7250000
NODE_10117_length_857_cov_6.251979	351	431	0	75	80	0.9375000
NODE_10117_length_857_cov_6.251979	351	431	2	5	80	0.0625000
NODE_10118_length_857_cov_5.827177	323	403	0	80	80	1.0000000
NODE_10118_length_857_cov_5.827177	376	456	0	80	80	1.0000000
NODE_10120_length_857_cov_4.530343	362	442	0	27	80	0.3375000
NODE_10120_length_857_cov_4.530343	362	442	2	53	80	0.6625000
NODE_10120_length_857_cov_4.530343	415	495	0	80	80	1.0000000
NODE_10128_length_857_cov_1.464380	179	249	10	8	70	0.1142857
NODE_10128_length_857_cov_1.464380	179	249	12	5	70	0.0714286
NODE_10128_length_857_cov_1.464380	179	249	14	5	70	0.0714286
NODE_10128_length_857_cov_1.464380	179	249	16	52	70	0.7428572
NODE_10128_length_857_cov_1.464380	222	288	12	2	66	0.0303030
NODE_10128_length_857_cov_1.464380	222	288	14	13	66	0.1969697
NODE_10128_length_857_cov_1.464380	222	288	16	28	66	0.4242424
NODE_10128_length_857_cov_1.464380	222	288	18	6	66	0.0909091
NODE_10128_length_857_cov_1.464380	222	288	20	13	66	0.1969697
NODE_10128_length_857_cov_1.464380	222	288	22	4	66	0.0606061
NODE_10138_length_856_cov_39.147952	157	237	0	45	80	0.5625000
NODE_10138_length_856_cov_39.147952	157	237	4	12	80	0.1500000
NODE_10138_length_856_cov_39.147952	157	237	8	23	80	0.2875000
NODE_10138_length_856_cov_39.147952	210	290	4	4	80	0.0500000
NODE_10138_length_856_cov_39.147952	210	290	8	76	80	0.9500000
NODE_10138_length_856_cov_39.147952	286	366	0	2	80	0.0250000
NODE_10138_length_856_cov_39.147952	286	366	4	12	80	0.1500000
NODE_10138_length_856_cov_39.147952	286	366	7	1	80	0.0125000
NODE_10138_length_856_cov_39.147952	286	366	8	65	80	0.8125000
NODE_10138_length_856_cov_39.147952	339	419	0	55	80	0.6875000
NODE_10138_length_856_cov_39.147952	339	419	4	12	80	0.1500000
NODE_10138_length_856_cov_39.147952	339	419	7	1	80	0.0125000
NODE_10138_length_856_cov_39.147952	339	419	8	12	80	0.1500000
NODE_10139_length_856_cov_21.937913	353	433	0	80	80	1.0000000
NODE_10139_length_856_cov_21.937913	406	486	0	80	80	1.0000000
NODE_10140_length_856_cov_20.227213	375	459	0	84	84	1.0000000
NODE_10140_length_856_cov_20.227213	432	512	0	80	80	1.0000000
NODE_10141_length_856_cov_18.445178	340	420	0	80	80	1.0000000
NODE_10141_length_856_cov_18.445178	393	473	0	80	80	1.0000000
NODE_10142_length_856_cov_16.564069	462	543	0	11	81	0.1358025
NODE_10142_length_856_cov_16.564069	462	543	2	70	81	0.8641976
NODE_10142_length_856_cov_16.564069	516	596	0	57	80	0.7125000
NODE_10142_length_856_cov_16.564069	516	596	2	23	80	0.2875000
NODE_10142_length_856_cov_16.564069	516	593	0	54	77	0.7012987
NODE_10142_length_856_cov_16.564069	516	593	2	23	77	0.2987013
NODE_10143_length_856_cov_15.803170	403	483	0	80	80	1.0000000
NODE_10143_length_856_cov_15.803170	456	536	0	80	80	1.0000000
NODE_10144_length_856_cov_12.904888	345	425	0	80	80	1.0000000
NODE_10144_length_856_cov_12.904888	398	478	0	80	80	1.0000000
NODE_10145_length_856_cov_9.881110	338	418	0	80	80	1.0000000
NODE_10145_length_856_cov_9.881110	391	471	0	29	80	0.3625000
NODE_10145_length_856_cov_9.881110	391	471	2	51	80	0.6375000
NODE_10146_length_856_cov_5.875826	405	485	0	34	80	0.4250000
NODE_10146_length_856_cov_5.875826	405	485	4	46	80	0.5750000
NODE_10146_length_856_cov_5.875826	458	538	0	27	80	0.3375000
NODE_10146_length_856_cov_5.875826	458	538	4	53	80	0.6625000
NODE_10149_length_856_cov_4.821664	466	546	0	80	80	1.0000000
NODE_10149_length_856_cov_4.821664	519	599	0	80	80	1.0000000
NODE_10151_length_856_cov_4.195509	248	328	0	67	80	0.8375000
NODE_10151_length_856_cov_4.195509	248	328	2	13	80	0.1625000
NODE_10151_length_856_cov_4.195509	301	381	0	80	80	1.0000000
NODE_10152_length_856_cov_3.899604	262	339	0	61	77	0.7922078
NODE_10152_length_856_cov_3.899604	262	339	4	16	77	0.2077922
NODE_10152_length_856_cov_3.899604	312	392	0	11	80	0.1375000
NODE_10152_length_856_cov_3.899604	312	392	4	69	80	0.8625000
NODE_10176_length_855_cov_28.312169	541	621	0	26	80	0.3250000
NODE_10176_length_855_cov_28.312169	541	621	1	1	80	0.0125000
NODE_10176_length_855_cov_28.312169	541	621	2	53	80	0.6625000
NODE_10176_length_855_cov_28.312169	594	674	0	79	80	0.9875000
NODE_10176_length_855_cov_28.312169	594	674	1	1	80	0.0125000
NODE_10177_length_855_cov_19.392857	692	772	0	14	80	0.1750000
NODE_10177_length_855_cov_19.392857	692	772	4	66	80	0.8250000
NODE_10177_length_855_cov_19.392857	745	825	0	67	80	0.8375000
NODE_10177_length_855_cov_19.392857	745	825	4	13	80	0.1625000
NODE_10178_length_855_cov_13.402116	343	423	0	24	80	0.3000000
NODE_10178_length_855_cov_13.402116	343	423	6	56	80	0.7000000
NODE_10178_length_855_cov_13.402116	396	476	0	18	80	0.2250000
NODE_10178_length_855_cov_13.402116	396	476	6	62	80	0.7750000
NODE_10179_length_855_cov_13.116402	295	375	0	80	80	1.0000000
NODE_10179_length_855_cov_13.116402	348	428	0	80	80	1.0000000
NODE_10180_length_855_cov_11.179894	360	436	0	76	76	1.0000000
NODE_10180_length_855_cov_11.179894	409	489	0	80	80	1.0000000
NODE_10183_length_855_cov_8.593915	339	419	0	80	80	1.0000000
NODE_10183_length_855_cov_8.593915	392	472	0	80	80	1.0000000
NODE_10206_length_854_cov_64.200000	586	666	0	2	80	0.0250000
NODE_10206_length_854_cov_64.200000	586	666	2	78	80	0.9750000
NODE_10206_length_854_cov_64.200000	639	719	0	55	80	0.6875000
NODE_10206_length_854_cov_64.200000	639	719	2	25	80	0.3125000
NODE_10207_length_854_cov_46.037086	348	428	0	25	80	0.3125000
NODE_10207_length_854_cov_46.037086	348	428	4	13	80	0.1625000
NODE_10207_length_854_cov_46.037086	348	428	8	12	80	0.1500000
NODE_10207_length_854_cov_46.037086	348	428	10	30	80	0.3750000
NODE_10207_length_854_cov_46.037086	401	481	2	8	80	0.1000000
NODE_10207_length_854_cov_46.037086	401	481	4	1	80	0.0125000
NODE_10207_length_854_cov_46.037086	401	481	8	5	80	0.0625000
NODE_10207_length_854_cov_46.037086	401	481	10	35	80	0.4375000
NODE_10207_length_854_cov_46.037086	401	481	12	31	80	0.3875000
NODE_10207_length_854_cov_46.037086	458	481	2	8	23	0.3478261
NODE_10207_length_854_cov_46.037086	458	481	4	1	23	0.0434783
NODE_10207_length_854_cov_46.037086	458	481	8	5	23	0.2173913
NODE_10207_length_854_cov_46.037086	458	481	12	9	23	0.3913043
NODE_10208_length_854_cov_45.633113	393	473	2	46	80	0.5750000
NODE_10208_length_854_cov_45.633113	393	473	4	34	80	0.4250000
NODE_10208_length_854_cov_45.633113	446	526	0	19	80	0.2375000
NODE_10208_length_854_cov_45.633113	446	526	2	52	80	0.6500000
NODE_10208_length_854_cov_45.633113	446	526	4	9	80	0.1125000
NODE_10209_length_854_cov_40.407947	489	569	0	80	80	1.0000000
NODE_10209_length_854_cov_40.407947	542	622	0	80	80	1.0000000
NODE_10210_length_854_cov_29.773510	450	530	0	59	80	0.7375000
NODE_10210_length_854_cov_29.773510	450	530	2	21	80	0.2625000
NODE_10210_length_854_cov_29.773510	503	583	0	25	80	0.3125000
NODE_10210_length_854_cov_29.773510	503	583	2	55	80	0.6875000
NODE_10211_length_854_cov_22.968212	318	398	0	80	80	1.0000000
NODE_10211_length_854_cov_22.968212	371	451	0	80	80	1.0000000
NODE_10212_length_854_cov_18.038411	387	467	0	41	80	0.5125000
NODE_10212_length_854_cov_18.038411	387	467	4	5	80	0.0625000
NODE_10212_length_854_cov_18.038411	387	467	10	1	80	0.0125000
NODE_10212_length_854_cov_18.038411	387	467	13	1	80	0.0125000
NODE_10212_length_854_cov_18.038411	387	467	14	32	80	0.4000000
NODE_10212_length_854_cov_18.038411	440	520	14	80	80	1.0000000
NODE_10213_length_854_cov_13.774834	330	410	3	80	80	1.0000000
NODE_10213_length_854_cov_13.774834	383	463	0	23	80	0.2875000
NODE_10213_length_854_cov_13.774834	383	463	1	10	80	0.1250000
NODE_10213_length_854_cov_13.774834	383	463	3	47	80	0.5875000
NODE_10214_length_854_cov_11.998675	366	446	0	80	80	1.0000000
NODE_10214_length_854_cov_11.998675	419	499	0	80	80	1.0000000
NODE_10215_length_854_cov_7.600000	298	378	0	80	80	1.0000000
NODE_10215_length_854_cov_7.600000	351	431	0	80	80	1.0000000
NODE_10218_length_854_cov_4.939073	603	633	0	4	30	0.1333333
NODE_10218_length_854_cov_4.939073	603	633	2	26	30	0.8666667
NODE_10226_length_854_cov_2.354967	613	633	0	20	20	1.0000000
NODE_10239_length_853_cov_61.988064	380	460	0	80	80	1.0000000
NODE_10239_length_853_cov_61.988064	433	513	0	80	80	1.0000000
NODE_10240_length_853_cov_33.683024	384	464	0	41	80	0.5125000
NODE_10240_length_853_cov_33.683024	384	464	5	1	80	0.0125000
NODE_10240_length_853_cov_33.683024	384	464	6	38	80	0.4750000
NODE_10240_length_853_cov_33.683024	437	517	6	80	80	1.0000000
NODE_10241_length_853_cov_31.965517	224	305	0	17	81	0.2098765
NODE_10241_length_853_cov_31.965517	224	305	4	64	81	0.7901235
NODE_10241_length_853_cov_31.965517	278	358	0	10	80	0.1250000
NODE_10241_length_853_cov_31.965517	278	358	1	18	80	0.2250000
NODE_10241_length_853_cov_31.965517	278	358	4	36	80	0.4500000
NODE_10241_length_853_cov_31.965517	278	358	5	16	80	0.2000000
NODE_10241_length_853_cov_31.965517	354	434	2	11	80	0.1375000
NODE_10241_length_853_cov_31.965517	354	434	5	28	80	0.3500000
NODE_10241_length_853_cov_31.965517	354	434	6	41	80	0.5125000
NODE_10241_length_853_cov_31.965517	407	466	2	43	59	0.7288136
NODE_10241_length_853_cov_31.965517	407	466	6	16	59	0.2711864
NODE_10242_length_853_cov_16.551724	247	327	0	38	80	0.4750000
NODE_10242_length_853_cov_16.551724	247	327	2	20	80	0.2500000
NODE_10242_length_853_cov_16.551724	247	327	4	22	80	0.2750000
NODE_10242_length_853_cov_16.551724	300	380	0	80	80	1.0000000
NODE_10242_length_853_cov_16.551724	376	456	0	25	80	0.3125000
NODE_10242_length_853_cov_16.551724	376	456	4	55	80	0.6875000
NODE_10242_length_853_cov_16.551724	429	509	4	80	80	1.0000000
NODE_10243_length_853_cov_15.395225	395	475	0	74	80	0.9250000
NODE_10243_length_853_cov_15.395225	395	475	2	6	80	0.0750000
NODE_10243_length_853_cov_15.395225	448	528	0	21	80	0.2625000
NODE_10243_length_853_cov_15.395225	448	528	2	59	80	0.7375000
NODE_10244_length_853_cov_15.086207	355	434	0	6	79	0.0759494
NODE_10244_length_853_cov_15.086207	355	434	2	73	79	0.9240506
NODE_10244_length_853_cov_15.086207	408	488	0	45	80	0.5625000
NODE_10244_length_853_cov_15.086207	408	488	2	35	80	0.4375000
NODE_10245_length_853_cov_14.929708	160	240	0	32	80	0.4000000
NODE_10245_length_853_cov_14.929708	160	240	5	48	80	0.6000000
NODE_10245_length_853_cov_14.929708	213	293	5	43	80	0.5375000
NODE_10245_length_853_cov_14.929708	213	293	6	37	80	0.4625000
NODE_10246_length_853_cov_11.299735	395	475	0	78	80	0.9750000
NODE_10246_length_853_cov_11.299735	395	475	2	2	80	0.0250000
NODE_10246_length_853_cov_11.299735	448	528	0	80	80	1.0000000
NODE_10247_length_853_cov_9.571618	479	559	0	80	80	1.0000000
NODE_10247_length_853_cov_9.571618	532	612	0	80	80	1.0000000
NODE_10248_length_853_cov_7.828912	265	345	0	63	80	0.7875000
NODE_10248_length_853_cov_7.828912	265	345	2	17	80	0.2125000
NODE_10248_length_853_cov_7.828912	318	398	0	10	80	0.1250000
NODE_10248_length_853_cov_7.828912	318	398	2	70	80	0.8750000
NODE_10249_length_853_cov_7.623342	255	335	0	80	80	1.0000000
NODE_10249_length_853_cov_7.623342	308	388	0	80	80	1.0000000
NODE_10253_length_853_cov_3.173740	212	292	0	80	80	1.0000000
NODE_10253_length_853_cov_3.173740	265	343	0	78	78	1.0000000
NODE_10258_length_853_cov_1.823607	710	773	0	63	63	1.0000000
NODE_10258_length_853_cov_1.823607	711	773	0	62	62	1.0000000
NODE_10258_length_853_cov_1.823607	711	773	0	62	62	1.0000000
NODE_10258_length_853_cov_1.823607	746	826	0	80	80	1.0000000
NODE_10267_length_852_cov_30.022576	279	359	0	25	80	0.3125000
NODE_10267_length_852_cov_30.022576	279	359	12	55	80	0.6875000
NODE_10267_length_852_cov_30.022576	332	412	0	17	80	0.2125000
NODE_10267_length_852_cov_30.022576	332	412	12	63	80	0.7875000
NODE_10268_length_852_cov_19.373174	353	433	0	66	80	0.8250000
NODE_10268_length_852_cov_19.373174	353	433	2	14	80	0.1750000
NODE_10268_length_852_cov_19.373174	406	486	0	80	80	1.0000000
NODE_10269_length_852_cov_18.853918	297	377	0	20	80	0.2500000
NODE_10269_length_852_cov_18.853918	297	377	6	9	80	0.1125000
NODE_10269_length_852_cov_18.853918	297	377	8	51	80	0.6375000
NODE_10269_length_852_cov_18.853918	350	430	0	73	80	0.9125000
NODE_10269_length_852_cov_18.853918	350	430	6	7	80	0.0875000
NODE_10269_length_852_cov_18.853918	426	506	0	80	80	1.0000000
NODE_10269_length_852_cov_18.853918	489	559	0	70	70	1.0000000
NODE_10270_length_852_cov_17.391766	472	552	0	80	80	1.0000000
NODE_10270_length_852_cov_17.391766	525	605	0	80	80	1.0000000
NODE_10271_length_852_cov_8.818061	513	593	0	80	80	1.0000000
NODE_10271_length_852_cov_8.818061	566	646	0	80	80	1.0000000
NODE_10274_length_852_cov_4.403718	493	573	0	36	80	0.4500000
NODE_10274_length_852_cov_4.403718	493	573	2	44	80	0.5500000
NODE_10274_length_852_cov_4.403718	546	626	0	19	80	0.2375000
NODE_10274_length_852_cov_4.403718	546	626	2	61	80	0.7625000
NODE_10285_length_851_cov_33.953457	329	409	0	18	80	0.2250000
NODE_10285_length_851_cov_33.953457	329	409	6	62	80	0.7750000
NODE_10285_length_851_cov_33.953457	382	462	0	71	80	0.8875000
NODE_10285_length_851_cov_33.953457	382	462	6	9	80	0.1125000
NODE_10286_length_851_cov_30.488032	395	475	0	80	80	1.0000000
NODE_10286_length_851_cov_30.488032	448	528	0	80	80	1.0000000
NODE_10287_length_851_cov_27.481383	353	433	0	80	80	1.0000000
NODE_10287_length_851_cov_27.481383	406	486	0	69	80	0.8625000
NODE_10287_length_851_cov_27.481383	406	486	2	11	80	0.1375000
NODE_10288_length_851_cov_23.656915	345	425	0	22	80	0.2750000
NODE_10288_length_851_cov_23.656915	345	425	2	31	80	0.3875000
NODE_10288_length_851_cov_23.656915	345	425	4	27	80	0.3375000
NODE_10288_length_851_cov_23.656915	398	478	0	75	80	0.9375000
NODE_10288_length_851_cov_23.656915	398	478	2	5	80	0.0625000
NODE_10289_length_851_cov_19.769947	298	378	0	60	80	0.7500000
NODE_10289_length_851_cov_19.769947	298	378	2	20	80	0.2500000
NODE_10289_length_851_cov_19.769947	351	431	0	7	80	0.0875000
NODE_10289_length_851_cov_19.769947	351	431	2	73	80	0.9125000
NODE_10290_length_851_cov_17.386968	459	539	0	80	80	1.0000000
NODE_10290_length_851_cov_17.386968	512	592	0	80	80	1.0000000
NODE_10291_length_851_cov_13.519947	323	403	0	3	80	0.0375000
NODE_10291_length_851_cov_13.519947	323	403	4	77	80	0.9625000
NODE_10291_length_851_cov_13.519947	376	456	0	49	80	0.6125000
NODE_10291_length_851_cov_13.519947	376	456	2	7	80	0.0875000
NODE_10291_length_851_cov_13.519947	376	456	4	24	80	0.3000000
NODE_10292_length_851_cov_11.771277	403	483	4	56	80	0.7000000
NODE_10292_length_851_cov_11.771277	403	483	6	24	80	0.3000000
NODE_10292_length_851_cov_11.771277	456	536	0	38	80	0.4750000
NODE_10292_length_851_cov_11.771277	456	536	2	9	80	0.1125000
NODE_10292_length_851_cov_11.771277	456	536	4	33	80	0.4125000
NODE_10293_length_851_cov_11.698138	227	307	0	23	80	0.2875000
NODE_10293_length_851_cov_11.698138	227	307	2	57	80	0.7125000
NODE_10293_length_851_cov_11.698138	280	360	2	80	80	1.0000000
NODE_10293_length_851_cov_11.698138	356	436	2	25	80	0.3125000
NODE_10293_length_851_cov_11.698138	356	436	4	17	80	0.2125000
NODE_10293_length_851_cov_11.698138	356	436	10	4	80	0.0500000
NODE_10293_length_851_cov_11.698138	356	436	12	34	80	0.4250000
NODE_10293_length_851_cov_11.698138	409	489	10	30	80	0.3750000
NODE_10293_length_851_cov_11.698138	409	489	12	50	80	0.6250000
NODE_10294_length_851_cov_11.672872	372	452	5	9	80	0.1125000
NODE_10294_length_851_cov_11.672872	372	452	6	71	80	0.8875000
NODE_10294_length_851_cov_11.672872	425	505	0	45	80	0.5625000
NODE_10294_length_851_cov_11.672872	425	505	4	4	80	0.0500000
NODE_10294_length_851_cov_11.672872	425	505	5	13	80	0.1625000
NODE_10294_length_851_cov_11.672872	425	505	6	18	80	0.2250000
NODE_10295_length_851_cov_10.938830	418	499	2	14	81	0.1728395
NODE_10295_length_851_cov_10.938830	418	499	4	38	81	0.4691358
NODE_10295_length_851_cov_10.938830	418	499	6	29	81	0.3580247
NODE_10296_length_851_cov_10.074468	454	534	0	80	80	1.0000000
NODE_10296_length_851_cov_10.074468	507	587	0	80	80	1.0000000
NODE_10297_length_851_cov_7.599734	330	410	0	80	80	1.0000000
NODE_10297_length_851_cov_7.599734	383	463	0	80	80	1.0000000
NODE_10298_length_851_cov_5.639628	379	459	0	80	80	1.0000000
NODE_10298_length_851_cov_5.639628	432	512	0	80	80	1.0000000
NODE_10300_length_851_cov_3.880319	729	765	2	36	36	1.0000000
NODE_10300_length_851_cov_3.880319	743	824	2	81	81	1.0000000
NODE_10301_length_851_cov_3.823138	380	460	0	6	80	0.0750000
NODE_10301_length_851_cov_3.823138	380	460	2	74	80	0.9250000
NODE_10301_length_851_cov_3.823138	433	513	0	8	80	0.1000000
NODE_10301_length_851_cov_3.823138	433	513	2	72	80	0.9000000
NODE_10318_length_851_cov_1.130319	33	103	0	70	70	1.0000000
NODE_10326_length_850_cov_36.527297	360	440	0	80	80	1.0000000
NODE_10326_length_850_cov_36.527297	413	493	0	80	80	1.0000000
NODE_10327_length_850_cov_31.006658	330	410	2	80	80	1.0000000
NODE_10327_length_850_cov_31.006658	383	463	2	79	80	0.9875000
NODE_10327_length_850_cov_31.006658	383	463	3	1	80	0.0125000
NODE_10328_length_850_cov_30.460719	251	331	11	11	80	0.1375000
NODE_10328_length_850_cov_30.460719	251	331	12	69	80	0.8625000
NODE_10328_length_850_cov_30.460719	304	384	0	14	80	0.1750000
NODE_10328_length_850_cov_30.460719	304	384	11	50	80	0.6250000
NODE_10328_length_850_cov_30.460719	304	384	12	16	80	0.2000000
NODE_10329_length_850_cov_25.263648	355	435	0	20	80	0.2500000
NODE_10329_length_850_cov_25.263648	355	435	2	60	80	0.7500000
NODE_10329_length_850_cov_25.263648	408	488	2	30	80	0.3750000
NODE_10329_length_850_cov_25.263648	408	488	6	37	80	0.4625000
NODE_10329_length_850_cov_25.263648	408	488	8	13	80	0.1625000
NODE_10330_length_850_cov_21.368842	290	370	0	30	80	0.3750000
NODE_10330_length_850_cov_21.368842	290	370	4	26	80	0.3250000
NODE_10330_length_850_cov_21.368842	290	370	8	24	80	0.3000000
NODE_10330_length_850_cov_21.368842	343	423	4	14	80	0.1750000
NODE_10330_length_850_cov_21.368842	343	423	8	66	80	0.8250000
NODE_10331_length_850_cov_20.500666	318	398	0	80	80	1.0000000
NODE_10331_length_850_cov_20.500666	371	451	0	80	80	1.0000000
NODE_10332_length_850_cov_17.268975	398	478	0	80	80	1.0000000
NODE_10332_length_850_cov_17.268975	451	531	0	80	80	1.0000000
NODE_10333_length_850_cov_14.728362	379	459	0	80	80	1.0000000
NODE_10333_length_850_cov_14.728362	432	512	0	80	80	1.0000000
NODE_10334_length_850_cov_14.230360	313	393	0	67	80	0.8375000
NODE_10334_length_850_cov_14.230360	313	393	2	13	80	0.1625000
NODE_10334_length_850_cov_14.230360	366	446	0	15	80	0.1875000
NODE_10334_length_850_cov_14.230360	366	446	2	65	80	0.8125000
NODE_10335_length_850_cov_12.387483	337	417	0	63	80	0.7875000
NODE_10335_length_850_cov_12.387483	337	417	2	17	80	0.2125000
NODE_10335_length_850_cov_12.387483	390	470	0	10	80	0.1250000
NODE_10335_length_850_cov_12.387483	390	470	2	70	80	0.8750000
NODE_10335_length_850_cov_12.387483	466	545	0	23	79	0.2911392
NODE_10335_length_850_cov_12.387483	466	545	2	56	79	0.7088608
NODE_10335_length_850_cov_12.387483	518	598	0	76	80	0.9500000
NODE_10335_length_850_cov_12.387483	518	598	2	4	80	0.0500000
NODE_10336_length_850_cov_11.402130	329	409	0	27	80	0.3375000
NODE_10336_length_850_cov_11.402130	329	409	4	53	80	0.6625000
NODE_10336_length_850_cov_11.402130	382	462	0	3	80	0.0375000
NODE_10336_length_850_cov_11.402130	382	462	4	77	80	0.9625000
NODE_10337_length_850_cov_10.326232	330	410	0	80	80	1.0000000
NODE_10337_length_850_cov_10.326232	383	463	0	80	80	1.0000000
NODE_10338_length_850_cov_9.675100	464	544	0	80	80	1.0000000
NODE_10338_length_850_cov_9.675100	517	597	0	80	80	1.0000000
NODE_10367_length_849_cov_43.137333	336	416	0	66	80	0.8250000
NODE_10367_length_849_cov_43.137333	336	416	2	14	80	0.1750000
NODE_10367_length_849_cov_43.137333	389	469	0	13	80	0.1625000
NODE_10367_length_849_cov_43.137333	389	469	2	31	80	0.3875000
NODE_10367_length_849_cov_43.137333	389	469	4	36	80	0.4500000
NODE_10368_length_849_cov_36.562667	326	406	0	80	80	1.0000000
NODE_10368_length_849_cov_36.562667	379	459	0	30	80	0.3750000
NODE_10368_length_849_cov_36.562667	379	459	2	50	80	0.6250000
NODE_10369_length_849_cov_35.449333	408	488	0	20	80	0.2500000
NODE_10369_length_849_cov_35.449333	408	488	2	6	80	0.0750000
NODE_10369_length_849_cov_35.449333	408	488	8	54	80	0.6750000
NODE_10369_length_849_cov_35.449333	461	541	0	5	80	0.0625000
NODE_10369_length_849_cov_35.449333	461	541	6	35	80	0.4375000
NODE_10369_length_849_cov_35.449333	461	541	8	40	80	0.5000000
NODE_10370_length_849_cov_29.989333	332	412	0	41	80	0.5125000
NODE_10370_length_849_cov_29.989333	332	412	2	6	80	0.0750000
NODE_10370_length_849_cov_29.989333	332	412	4	31	80	0.3875000
NODE_10370_length_849_cov_29.989333	332	412	6	2	80	0.0250000
NODE_10370_length_849_cov_29.989333	385	465	4	25	80	0.3125000
NODE_10370_length_849_cov_29.989333	385	465	5	4	80	0.0500000
NODE_10370_length_849_cov_29.989333	385	465	6	45	80	0.5625000
NODE_10370_length_849_cov_29.989333	385	465	7	6	80	0.0750000
NODE_10371_length_849_cov_17.974667	343	423	6	80	80	1.0000000
NODE_10371_length_849_cov_17.974667	396	476	0	52	80	0.6500000
NODE_10371_length_849_cov_17.974667	396	476	5	1	80	0.0125000
NODE_10371_length_849_cov_17.974667	396	476	6	27	80	0.3375000
NODE_10372_length_849_cov_17.018667	360	440	0	36	80	0.4500000
NODE_10372_length_849_cov_17.018667	360	440	2	25	80	0.3125000
NODE_10372_length_849_cov_17.018667	360	440	4	19	80	0.2375000
NODE_10372_length_849_cov_17.018667	416	493	2	35	77	0.4545455
NODE_10372_length_849_cov_17.018667	416	493	4	42	77	0.5454546
NODE_10373_length_849_cov_15.581333	287	367	0	5	80	0.0625000
NODE_10373_length_849_cov_15.581333	287	367	4	37	80	0.4625000
NODE_10373_length_849_cov_15.581333	287	367	6	38	80	0.4750000
NODE_10373_length_849_cov_15.581333	340	420	0	11	80	0.1375000
NODE_10373_length_849_cov_15.581333	340	420	2	47	80	0.5875000
NODE_10373_length_849_cov_15.581333	340	420	4	22	80	0.2750000
NODE_10373_length_849_cov_15.581333	416	496	0	52	80	0.6500000
NODE_10373_length_849_cov_15.581333	416	496	2	28	80	0.3500000
NODE_10373_length_849_cov_15.581333	469	549	0	80	80	1.0000000
NODE_10374_length_849_cov_9.460000	370	450	0	80	80	1.0000000
NODE_10374_length_849_cov_9.460000	423	503	0	80	80	1.0000000
NODE_10375_length_849_cov_4.893333	427	507	0	61	80	0.7625000
NODE_10375_length_849_cov_4.893333	427	507	4	19	80	0.2375000
NODE_10375_length_849_cov_4.893333	480	560	0	80	80	1.0000000
NODE_10376_length_849_cov_4.860000	380	460	0	80	80	1.0000000
NODE_10376_length_849_cov_4.860000	433	513	0	36	80	0.4500000
NODE_10376_length_849_cov_4.860000	433	513	2	44	80	0.5500000
NODE_10379_length_849_cov_2.761333	254	334	0	80	80	1.0000000
NODE_10396_length_848_cov_27.287049	253	333	5	3	80	0.0375000
NODE_10396_length_848_cov_27.287049	253	333	6	18	80	0.2250000
NODE_10396_length_848_cov_27.287049	253	333	7	22	80	0.2750000
NODE_10396_length_848_cov_27.287049	253	333	11	37	80	0.4625000
NODE_10396_length_848_cov_27.287049	306	386	4	30	80	0.3750000
NODE_10396_length_848_cov_27.287049	306	386	5	26	80	0.3250000
NODE_10396_length_848_cov_27.287049	306	386	11	24	80	0.3000000
NODE_10396_length_848_cov_27.287049	382	458	0	25	76	0.3289474
NODE_10396_length_848_cov_27.287049	382	458	4	51	76	0.6710526
NODE_10396_length_848_cov_27.287049	435	513	0	78	78	1.0000000
NODE_10397_length_848_cov_23.511348	248	328	0	80	80	1.0000000
NODE_10397_length_848_cov_23.511348	301	381	0	80	80	1.0000000
NODE_10397_length_848_cov_23.511348	377	457	0	80	80	1.0000000
NODE_10397_length_848_cov_23.511348	430	508	0	38	78	0.4871795
NODE_10397_length_848_cov_23.511348	430	508	2	40	78	0.5128205
NODE_10398_length_848_cov_21.939920	295	375	0	80	80	1.0000000
NODE_10398_length_848_cov_21.939920	348	428	0	80	80	1.0000000
NODE_10399_length_848_cov_21.937250	434	514	0	44	80	0.5500000
NODE_10399_length_848_cov_21.937250	434	514	2	36	80	0.4500000
NODE_10399_length_848_cov_21.937250	487	567	2	80	80	1.0000000
NODE_10400_length_848_cov_19.500668	367	392	0	6	25	0.2400000
NODE_10400_length_848_cov_19.500668	367	392	6	19	25	0.7600000
NODE_10400_length_848_cov_19.500668	388	468	6	19	80	0.2375000
NODE_10400_length_848_cov_19.500668	388	468	8	1	80	0.0125000
NODE_10400_length_848_cov_19.500668	388	468	13	19	80	0.2375000
NODE_10400_length_848_cov_19.500668	388	468	14	41	80	0.5125000
NODE_10400_length_848_cov_19.500668	441	521	2	16	80	0.2000000
NODE_10400_length_848_cov_19.500668	441	521	8	7	80	0.0875000
NODE_10400_length_848_cov_19.500668	441	521	9	1	80	0.0125000
NODE_10400_length_848_cov_19.500668	441	521	10	30	80	0.3750000
NODE_10400_length_848_cov_19.500668	441	521	13	19	80	0.2375000
NODE_10400_length_848_cov_19.500668	441	521	14	7	80	0.0875000
NODE_10400_length_848_cov_19.500668	443	512	2	7	69	0.1014493
NODE_10400_length_848_cov_19.500668	443	512	8	7	69	0.1014493
NODE_10400_length_848_cov_19.500668	443	512	9	1	69	0.0144928
NODE_10400_length_848_cov_19.500668	443	512	10	30	69	0.4347826
NODE_10400_length_848_cov_19.500668	443	512	13	19	69	0.2753623
NODE_10400_length_848_cov_19.500668	443	512	14	5	69	0.0724638
NODE_10400_length_848_cov_19.500668	443	472	8	5	29	0.1724138
NODE_10400_length_848_cov_19.500668	443	472	13	19	29	0.6551724
NODE_10400_length_848_cov_19.500668	443	472	14	5	29	0.1724138
NODE_10401_length_848_cov_16.566088	323	403	0	21	80	0.2625000
NODE_10401_length_848_cov_16.566088	323	403	4	23	80	0.2875000
NODE_10401_length_848_cov_16.566088	323	403	9	36	80	0.4500000
NODE_10401_length_848_cov_16.566088	376	456	5	16	80	0.2000000
NODE_10401_length_848_cov_16.566088	376	456	9	43	80	0.5375000
NODE_10401_length_848_cov_16.566088	376	456	10	21	80	0.2625000
NODE_10402_length_848_cov_16.109479	256	336	0	9	80	0.1125000
NODE_10402_length_848_cov_16.109479	256	336	2	71	80	0.8875000
NODE_10402_length_848_cov_16.109479	309	389	0	12	80	0.1500000
NODE_10402_length_848_cov_16.109479	309	389	2	68	80	0.8500000
NODE_10402_length_848_cov_16.109479	385	465	0	38	80	0.4750000
NODE_10402_length_848_cov_16.109479	385	465	2	42	80	0.5250000
NODE_10402_length_848_cov_16.109479	438	518	0	80	80	1.0000000
NODE_10403_length_848_cov_15.919893	492	568	0	6	76	0.0789474
NODE_10403_length_848_cov_15.919893	492	568	4	70	76	0.9210526
NODE_10403_length_848_cov_15.919893	541	621	0	59	80	0.7375000
NODE_10403_length_848_cov_15.919893	541	621	4	21	80	0.2625000
NODE_10404_length_848_cov_13.979973	269	349	0	51	80	0.6375000
NODE_10404_length_848_cov_13.979973	269	349	2	29	80	0.3625000
NODE_10404_length_848_cov_13.979973	322	402	2	80	80	1.0000000
NODE_10405_length_848_cov_13.073431	343	423	5	1	80	0.0125000
NODE_10405_length_848_cov_13.073431	343	423	10	13	80	0.1625000
NODE_10405_length_848_cov_13.073431	343	423	11	66	80	0.8250000
NODE_10405_length_848_cov_13.073431	396	476	2	28	80	0.3500000
NODE_10405_length_848_cov_13.073431	396	476	5	20	80	0.2500000
NODE_10405_length_848_cov_13.073431	396	476	7	6	80	0.0750000
NODE_10405_length_848_cov_13.073431	396	476	10	13	80	0.1625000
NODE_10405_length_848_cov_13.073431	396	476	11	13	80	0.1625000
NODE_10406_length_848_cov_8.523364	232	312	0	50	80	0.6250000
NODE_10406_length_848_cov_8.523364	232	312	2	30	80	0.3750000
NODE_10406_length_848_cov_8.523364	285	365	0	14	80	0.1750000
NODE_10406_length_848_cov_8.523364	285	365	2	66	80	0.8250000
NODE_10406_length_848_cov_8.523364	361	441	0	76	80	0.9500000
NODE_10406_length_848_cov_8.523364	361	441	2	4	80	0.0500000
NODE_10406_length_848_cov_8.523364	414	494	0	80	80	1.0000000
NODE_10408_length_848_cov_5.903872	251	331	0	58	80	0.7250000
NODE_10408_length_848_cov_5.903872	251	331	4	22	80	0.2750000
NODE_10408_length_848_cov_5.903872	304	383	0	5	79	0.0632911
NODE_10408_length_848_cov_5.903872	304	383	4	74	79	0.9367089
NODE_10409_length_848_cov_5.236315	378	458	0	60	80	0.7500000
NODE_10409_length_848_cov_5.236315	378	458	2	20	80	0.2500000
NODE_10409_length_848_cov_5.236315	431	507	0	7	76	0.0921053
NODE_10409_length_848_cov_5.236315	431	507	2	69	76	0.9078947
NODE_10424_length_847_cov_56.417112	576	656	0	80	80	1.0000000
NODE_10424_length_847_cov_56.417112	629	709	0	80	80	1.0000000
NODE_10425_length_847_cov_27.292781	390	470	2	17	80	0.2125000
NODE_10425_length_847_cov_27.292781	390	470	8	63	80	0.7875000
NODE_10425_length_847_cov_27.292781	443	523	0	27	80	0.3375000
NODE_10425_length_847_cov_27.292781	443	523	2	43	80	0.5375000
NODE_10425_length_847_cov_27.292781	443	523	8	10	80	0.1250000
NODE_10426_length_847_cov_24.954545	342	422	0	80	80	1.0000000
NODE_10426_length_847_cov_24.954545	395	475	0	80	80	1.0000000
NODE_10427_length_847_cov_20.310160	341	421	0	20	80	0.2500000
NODE_10427_length_847_cov_20.310160	341	421	13	1	80	0.0125000
NODE_10427_length_847_cov_20.310160	341	421	14	11	80	0.1375000
NODE_10427_length_847_cov_20.310160	341	421	15	40	80	0.5000000
NODE_10427_length_847_cov_20.310160	341	421	16	8	80	0.1000000
NODE_10427_length_847_cov_20.310160	394	474	14	26	80	0.3250000
NODE_10427_length_847_cov_20.310160	394	474	15	46	80	0.5750000
NODE_10427_length_847_cov_20.310160	394	474	16	8	80	0.1000000
NODE_10428_length_847_cov_19.002674	368	448	0	67	80	0.8375000
NODE_10428_length_847_cov_19.002674	368	448	2	13	80	0.1625000
NODE_10428_length_847_cov_19.002674	421	501	0	14	80	0.1750000
NODE_10428_length_847_cov_19.002674	421	501	2	66	80	0.8250000
NODE_10429_length_847_cov_16.879679	218	298	3	80	80	1.0000000
NODE_10429_length_847_cov_16.879679	271	351	3	34	80	0.4250000
NODE_10429_length_847_cov_16.879679	271	351	4	44	80	0.5500000
NODE_10429_length_847_cov_16.879679	271	351	5	2	80	0.0250000
NODE_10431_length_847_cov_11.784759	298	378	0	2	80	0.0250000
NODE_10431_length_847_cov_11.784759	298	378	2	78	80	0.9750000
NODE_10431_length_847_cov_11.784759	351	431	0	55	80	0.6875000
NODE_10431_length_847_cov_11.784759	351	431	2	25	80	0.3125000
NODE_10431_length_847_cov_11.784759	427	507	0	80	80	1.0000000
NODE_10431_length_847_cov_11.784759	480	560	0	33	80	0.4125000
NODE_10431_length_847_cov_11.784759	480	560	2	1	80	0.0125000
NODE_10431_length_847_cov_11.784759	480	560	3	46	80	0.5750000
NODE_10432_length_847_cov_11.604278	407	487	0	80	80	1.0000000
NODE_10432_length_847_cov_11.604278	460	540	0	80	80	1.0000000
NODE_10433_length_847_cov_10.221925	395	475	0	15	80	0.1875000
NODE_10433_length_847_cov_10.221925	395	475	4	65	80	0.8125000
NODE_10433_length_847_cov_10.221925	448	528	0	68	80	0.8500000
NODE_10433_length_847_cov_10.221925	448	528	4	12	80	0.1500000
NODE_10434_length_847_cov_4.602941	97	154	14	1	57	0.0175439
NODE_10434_length_847_cov_4.602941	97	154	17	2	57	0.0350877
NODE_10434_length_847_cov_4.602941	97	154	18	2	57	0.0350877
NODE_10434_length_847_cov_4.602941	97	154	19	1	57	0.0175439
NODE_10434_length_847_cov_4.602941	97	154	20	3	57	0.0526316
NODE_10434_length_847_cov_4.602941	97	154	21	8	57	0.1403509
NODE_10434_length_847_cov_4.602941	97	154	23	3	57	0.0526316
NODE_10434_length_847_cov_4.602941	97	154	25	37	57	0.6491228
NODE_10434_length_847_cov_4.602941	127	207	0	10	80	0.1250000
NODE_10434_length_847_cov_4.602941	127	207	2	2	80	0.0250000
NODE_10434_length_847_cov_4.602941	127	207	4	3	80	0.0375000
NODE_10434_length_847_cov_4.602941	127	207	6	3	80	0.0375000
NODE_10434_length_847_cov_4.602941	127	207	8	2	80	0.0250000
NODE_10434_length_847_cov_4.602941	127	207	9	4	80	0.0500000
NODE_10434_length_847_cov_4.602941	127	207	10	10	80	0.1250000
NODE_10434_length_847_cov_4.602941	127	207	12	8	80	0.1000000
NODE_10434_length_847_cov_4.602941	127	207	14	12	80	0.1500000
NODE_10434_length_847_cov_4.602941	127	207	17	2	80	0.0250000
NODE_10434_length_847_cov_4.602941	127	207	18	2	80	0.0250000
NODE_10434_length_847_cov_4.602941	127	207	20	3	80	0.0375000
NODE_10434_length_847_cov_4.602941	127	207	21	3	80	0.0375000
NODE_10434_length_847_cov_4.602941	127	207	23	1	80	0.0125000
NODE_10434_length_847_cov_4.602941	127	207	25	15	80	0.1875000
NODE_10456_length_846_cov_39.476573	336	416	0	43	80	0.5375000
NODE_10456_length_846_cov_39.476573	336	416	4	37	80	0.4625000
NODE_10456_length_846_cov_39.476573	389	469	0	4	80	0.0500000
NODE_10456_length_846_cov_39.476573	389	469	2	8	80	0.1000000
NODE_10456_length_846_cov_39.476573	389	469	4	68	80	0.8500000
NODE_10456_length_846_cov_39.476573	465	545	0	80	80	1.0000000
NODE_10456_length_846_cov_39.476573	518	598	0	80	80	1.0000000
NODE_10457_length_846_cov_37.297189	312	392	0	80	80	1.0000000
NODE_10457_length_846_cov_37.297189	365	445	0	52	80	0.6500000
NODE_10457_length_846_cov_37.297189	365	445	6	28	80	0.3500000
NODE_10458_length_846_cov_32.852744	279	359	0	54	80	0.6750000
NODE_10458_length_846_cov_32.852744	279	359	2	26	80	0.3250000
NODE_10458_length_846_cov_32.852744	332	412	0	2	80	0.0250000
NODE_10458_length_846_cov_32.852744	332	412	2	78	80	0.9750000
NODE_10459_length_846_cov_31.717537	290	370	0	80	80	1.0000000
NODE_10459_length_846_cov_31.717537	343	423	0	80	80	1.0000000
NODE_10460_length_846_cov_24.380187	350	430	0	47	80	0.5875000
NODE_10460_length_846_cov_24.380187	350	430	2	33	80	0.4125000
NODE_10460_length_846_cov_24.380187	403	483	0	20	80	0.2500000
NODE_10460_length_846_cov_24.380187	403	483	2	60	80	0.7500000
NODE_10461_length_846_cov_16.155288	364	444	0	25	80	0.3125000
NODE_10461_length_846_cov_16.155288	364	444	2	55	80	0.6875000
NODE_10461_length_846_cov_16.155288	417	497	0	1	80	0.0125000
NODE_10461_length_846_cov_16.155288	417	497	2	79	80	0.9875000
NODE_10462_length_846_cov_15.917001	398	478	0	80	80	1.0000000
NODE_10462_length_846_cov_15.917001	451	531	0	80	80	1.0000000
NODE_10463_length_846_cov_15.275770	355	435	0	80	80	1.0000000
NODE_10463_length_846_cov_15.275770	408	488	0	80	80	1.0000000
NODE_10464_length_846_cov_13.618474	216	296	2	80	80	1.0000000
NODE_10464_length_846_cov_13.618474	269	349	1	14	80	0.1750000
NODE_10464_length_846_cov_13.618474	269	349	2	44	80	0.5500000
NODE_10464_length_846_cov_13.618474	269	349	3	22	80	0.2750000
NODE_10464_length_846_cov_13.618474	345	425	2	19	80	0.2375000
NODE_10464_length_846_cov_13.618474	345	425	3	20	80	0.2500000
NODE_10464_length_846_cov_13.618474	345	425	4	41	80	0.5125000
NODE_10464_length_846_cov_13.618474	398	478	0	15	80	0.1875000
NODE_10464_length_846_cov_13.618474	398	478	2	34	80	0.4250000
NODE_10464_length_846_cov_13.618474	398	478	4	31	80	0.3875000
NODE_10465_length_846_cov_12.878179	425	505	0	80	80	1.0000000
NODE_10465_length_846_cov_12.878179	478	558	0	62	80	0.7750000
NODE_10465_length_846_cov_12.878179	478	558	2	18	80	0.2250000
NODE_10467_length_846_cov_7.232932	407	487	0	2	80	0.0250000
NODE_10467_length_846_cov_7.232932	407	487	2	78	80	0.9750000
NODE_10467_length_846_cov_7.232932	460	540	0	55	80	0.6875000
NODE_10467_length_846_cov_7.232932	460	540	2	25	80	0.3125000
NODE_10468_length_846_cov_6.776439	320	400	2	5	80	0.0625000
NODE_10468_length_846_cov_6.776439	320	400	4	41	80	0.5125000
NODE_10468_length_846_cov_6.776439	320	400	6	34	80	0.4250000
NODE_10468_length_846_cov_6.776439	373	453	0	9	80	0.1125000
NODE_10468_length_846_cov_6.776439	373	453	4	71	80	0.8875000
NODE_10472_length_846_cov_3.025435	190	270	0	80	80	1.0000000
NODE_10472_length_846_cov_3.025435	243	323	0	80	80	1.0000000
NODE_10488_length_845_cov_34.458445	213	293	2	44	80	0.5500000
NODE_10488_length_845_cov_34.458445	213	293	4	23	80	0.2875000
NODE_10488_length_845_cov_34.458445	213	293	12	3	80	0.0375000
NODE_10488_length_845_cov_34.458445	213	293	16	10	80	0.1250000
NODE_10488_length_845_cov_34.458445	266	346	2	14	80	0.1750000
NODE_10488_length_845_cov_34.458445	266	346	12	3	80	0.0375000
NODE_10488_length_845_cov_34.458445	266	346	14	3	80	0.0375000
NODE_10488_length_845_cov_34.458445	266	346	16	26	80	0.3250000
NODE_10488_length_845_cov_34.458445	266	346	18	34	80	0.4250000
NODE_10489_length_845_cov_33.025469	309	389	0	80	80	1.0000000
NODE_10489_length_845_cov_33.025469	362	442	0	80	80	1.0000000
NODE_10490_length_845_cov_30.331099	288	368	0	29	80	0.3625000
NODE_10490_length_845_cov_30.331099	288	368	2	5	80	0.0625000
NODE_10490_length_845_cov_30.331099	288	368	4	1	80	0.0125000
NODE_10490_length_845_cov_30.331099	288	368	5	24	80	0.3000000
NODE_10490_length_845_cov_30.331099	288	368	6	8	80	0.1000000
NODE_10490_length_845_cov_30.331099	288	368	8	13	80	0.1625000
NODE_10490_length_845_cov_30.331099	341	421	5	6	80	0.0750000
NODE_10490_length_845_cov_30.331099	341	421	6	8	80	0.1000000
NODE_10490_length_845_cov_30.331099	341	421	7	24	80	0.3000000
NODE_10490_length_845_cov_30.331099	341	421	8	42	80	0.5250000
NODE_10491_length_845_cov_22.042895	455	535	0	80	80	1.0000000
NODE_10491_length_845_cov_22.042895	508	588	0	80	80	1.0000000
NODE_10492_length_845_cov_20.662198	325	406	0	81	81	1.0000000
NODE_10492_length_845_cov_20.662198	379	459	0	32	80	0.4000000
NODE_10492_length_845_cov_20.662198	379	459	2	12	80	0.1500000
NODE_10492_length_845_cov_20.662198	379	459	4	36	80	0.4500000
NODE_10493_length_845_cov_17.214477	352	432	0	80	80	1.0000000
NODE_10493_length_845_cov_17.214477	405	485	0	80	80	1.0000000
NODE_10494_length_845_cov_15.805630	409	489	2	39	80	0.4875000
NODE_10494_length_845_cov_15.805630	409	489	4	41	80	0.5125000
NODE_10494_length_845_cov_15.805630	462	542	0	7	80	0.0875000
NODE_10494_length_845_cov_15.805630	462	542	2	47	80	0.5875000
NODE_10494_length_845_cov_15.805630	462	542	4	26	80	0.3250000
NODE_10495_length_845_cov_13.443700	329	409	0	80	80	1.0000000
NODE_10495_length_845_cov_13.443700	382	462	0	80	80	1.0000000
NODE_10496_length_845_cov_12.301609	334	414	0	80	80	1.0000000
NODE_10496_length_845_cov_12.301609	387	467	0	80	80	1.0000000
NODE_10497_length_845_cov_11.836461	389	469	0	80	80	1.0000000
NODE_10497_length_845_cov_11.836461	442	522	0	80	80	1.0000000
NODE_10499_length_845_cov_8.140751	439	519	0	10	80	0.1250000
NODE_10499_length_845_cov_8.140751	439	519	2	17	80	0.2125000
NODE_10499_length_845_cov_8.140751	439	519	4	49	80	0.6125000
NODE_10499_length_845_cov_8.140751	439	519	6	4	80	0.0500000
NODE_10499_length_845_cov_8.140751	492	572	4	55	80	0.6875000
NODE_10499_length_845_cov_8.140751	492	572	6	25	80	0.3125000
NODE_10516_length_845_cov_1.680965	447	491	0	44	44	1.0000000
NODE_10528_length_844_cov_43.778523	313	393	0	30	80	0.3750000
NODE_10528_length_844_cov_43.778523	313	393	2	50	80	0.6250000
NODE_10528_length_844_cov_43.778523	366	446	0	3	80	0.0375000
NODE_10528_length_844_cov_43.778523	366	446	1	1	80	0.0125000
NODE_10528_length_844_cov_43.778523	366	446	2	76	80	0.9500000
NODE_10528_length_844_cov_43.778523	442	522	0	2	80	0.0250000
NODE_10528_length_844_cov_43.778523	442	522	1	1	80	0.0125000
NODE_10528_length_844_cov_43.778523	442	522	2	31	80	0.3875000
NODE_10528_length_844_cov_43.778523	442	522	10	46	80	0.5750000
NODE_10528_length_844_cov_43.778523	495	575	10	80	80	1.0000000
NODE_10529_length_844_cov_36.762416	381	461	0	80	80	1.0000000
NODE_10529_length_844_cov_36.762416	434	514	0	80	80	1.0000000
NODE_10529_length_844_cov_36.762416	510	590	0	80	80	1.0000000
NODE_10529_length_844_cov_36.762416	563	644	0	81	81	1.0000000
NODE_10530_length_844_cov_35.765101	424	504	0	22	80	0.2750000
NODE_10530_length_844_cov_35.765101	424	504	6	58	80	0.7250000
NODE_10530_length_844_cov_35.765101	477	557	0	73	80	0.9125000
NODE_10530_length_844_cov_35.765101	477	557	4	2	80	0.0250000
NODE_10530_length_844_cov_35.765101	477	557	6	5	80	0.0625000
NODE_10531_length_844_cov_18.445638	353	420	7	13	67	0.1940299
NODE_10531_length_844_cov_18.445638	353	420	9	14	67	0.2089552
NODE_10531_length_844_cov_18.445638	353	420	14	40	67	0.5970149
NODE_10531_length_844_cov_18.445638	393	473	12	9	80	0.1125000
NODE_10531_length_844_cov_18.445638	393	473	14	66	80	0.8250000
NODE_10531_length_844_cov_18.445638	393	473	16	5	80	0.0625000
NODE_10532_length_844_cov_12.616107	363	443	6	10	80	0.1250000
NODE_10532_length_844_cov_12.616107	363	443	7	42	80	0.5250000
NODE_10532_length_844_cov_12.616107	363	443	8	28	80	0.3500000
NODE_10532_length_844_cov_12.616107	416	496	2	17	80	0.2125000
NODE_10532_length_844_cov_12.616107	416	496	6	46	80	0.5750000
NODE_10532_length_844_cov_12.616107	416	496	8	17	80	0.2125000
NODE_10533_length_844_cov_12.092617	171	251	0	54	80	0.6750000
NODE_10533_length_844_cov_12.092617	171	251	6	26	80	0.3250000
NODE_10533_length_844_cov_12.092617	224	304	0	1	80	0.0125000
NODE_10533_length_844_cov_12.092617	224	304	6	79	80	0.9875000
NODE_10534_length_844_cov_11.883221	341	421	0	80	80	1.0000000
NODE_10534_length_844_cov_11.883221	394	474	0	80	80	1.0000000
NODE_10535_length_844_cov_10.571812	390	448	0	17	58	0.2931035
NODE_10535_length_844_cov_10.571812	390	448	2	9	58	0.1551724
NODE_10535_length_844_cov_10.571812	390	448	6	32	58	0.5517241
NODE_10537_length_844_cov_9.357047	370	450	0	80	80	1.0000000
NODE_10537_length_844_cov_9.357047	423	503	0	80	80	1.0000000
NODE_10538_length_844_cov_8.975839	355	435	0	8	80	0.1000000
NODE_10538_length_844_cov_8.975839	355	435	2	21	80	0.2625000
NODE_10538_length_844_cov_8.975839	355	435	6	51	80	0.6375000
NODE_10538_length_844_cov_8.975839	408	488	4	48	80	0.6000000
NODE_10538_length_844_cov_8.975839	408	488	6	32	80	0.4000000
NODE_10539_length_844_cov_7.347651	357	438	0	81	81	1.0000000
NODE_10539_length_844_cov_7.347651	410	491	0	81	81	1.0000000
NODE_10540_length_844_cov_6.975839	444	524	0	64	80	0.8000000
NODE_10540_length_844_cov_6.975839	444	524	2	16	80	0.2000000
NODE_10540_length_844_cov_6.975839	497	577	0	11	80	0.1375000
NODE_10540_length_844_cov_6.975839	497	577	2	69	80	0.8625000
NODE_10567_length_843_cov_48.258065	203	262	432	1	59	0.0169492
NODE_10567_length_843_cov_48.258065	203	262	438	1	59	0.0169492
NODE_10567_length_843_cov_48.258065	203	262	444	4	59	0.0677966
NODE_10567_length_843_cov_48.258065	203	262	448	1	59	0.0169492
NODE_10567_length_843_cov_48.258065	203	262	458	1	59	0.0169492
NODE_10567_length_843_cov_48.258065	203	262	461	1	59	0.0169492
NODE_10567_length_843_cov_48.258065	203	262	464	2	59	0.0338983
NODE_10567_length_843_cov_48.258065	203	262	465	1	59	0.0169492
NODE_10567_length_843_cov_48.258065	203	262	467	4	59	0.0677966
NODE_10567_length_843_cov_48.258065	203	262	471	2	59	0.0338983
NODE_10567_length_843_cov_48.258065	203	262	472	2	59	0.0338983
NODE_10567_length_843_cov_48.258065	203	262	473	1	59	0.0169492
NODE_10567_length_843_cov_48.258065	203	262	474	3	59	0.0508475
NODE_10567_length_843_cov_48.258065	203	262	475	3	59	0.0508475
NODE_10567_length_843_cov_48.258065	203	262	476	1	59	0.0169492
NODE_10567_length_843_cov_48.258065	203	262	477	3	59	0.0508475
NODE_10567_length_843_cov_48.258065	203	262	478	2	59	0.0338983
NODE_10567_length_843_cov_48.258065	203	262	479	1	59	0.0169492
NODE_10567_length_843_cov_48.258065	203	262	480	3	59	0.0508475
NODE_10567_length_843_cov_48.258065	203	262	481	1	59	0.0169492
NODE_10567_length_843_cov_48.258065	203	262	482	3	59	0.0508475
NODE_10567_length_843_cov_48.258065	203	262	485	2	59	0.0338983
NODE_10567_length_843_cov_48.258065	203	262	486	3	59	0.0508475
NODE_10567_length_843_cov_48.258065	203	262	487	1	59	0.0169492
NODE_10567_length_843_cov_48.258065	203	262	488	2	59	0.0338983
NODE_10567_length_843_cov_48.258065	203	262	489	2	59	0.0338983
NODE_10567_length_843_cov_48.258065	203	262	490	2	59	0.0338983
NODE_10567_length_843_cov_48.258065	203	262	492	1	59	0.0169492
NODE_10567_length_843_cov_48.258065	203	262	495	1	59	0.0169492
NODE_10567_length_843_cov_48.258065	203	262	499	3	59	0.0508475
NODE_10567_length_843_cov_48.258065	203	262	500	1	59	0.0169492
NODE_10568_length_843_cov_31.279570	351	431	0	80	80	1.0000000
NODE_10568_length_843_cov_31.279570	404	484	0	80	80	1.0000000
NODE_10569_length_843_cov_27.060484	423	503	0	80	80	1.0000000
NODE_10569_length_843_cov_27.060484	476	556	0	47	80	0.5875000
NODE_10569_length_843_cov_27.060484	476	556	6	33	80	0.4125000
NODE_10570_length_843_cov_22.725806	334	414	0	80	80	1.0000000
NODE_10570_length_843_cov_22.725806	339	396	0	57	57	1.0000000
NODE_10570_length_843_cov_22.725806	356	427	0	71	71	1.0000000
NODE_10570_length_843_cov_22.725806	387	455	0	68	68	1.0000000
NODE_10570_length_843_cov_22.725806	401	476	0	75	75	1.0000000
NODE_10570_length_843_cov_22.725806	418	486	0	68	68	1.0000000
NODE_10570_length_843_cov_22.725806	449	529	0	80	80	1.0000000
NODE_10571_length_843_cov_22.387097	412	492	0	80	80	1.0000000
NODE_10571_length_843_cov_22.387097	465	545	0	74	80	0.9250000
NODE_10571_length_843_cov_22.387097	465	545	1	6	80	0.0750000
NODE_10572_length_843_cov_16.326613	551	631	2	61	80	0.7625000
NODE_10572_length_843_cov_16.326613	551	631	3	1	80	0.0125000
NODE_10572_length_843_cov_16.326613	551	631	4	18	80	0.2250000
NODE_10572_length_843_cov_16.326613	604	684	2	65	80	0.8125000
NODE_10572_length_843_cov_16.326613	604	684	4	15	80	0.1875000
NODE_10573_length_843_cov_13.478495	381	461	0	80	80	1.0000000
NODE_10573_length_843_cov_13.478495	434	514	0	80	80	1.0000000
NODE_10574_length_843_cov_13.150538	448	528	0	80	80	1.0000000
NODE_10574_length_843_cov_13.150538	501	581	0	80	80	1.0000000
NODE_10575_length_843_cov_12.510753	360	440	0	46	80	0.5750000
NODE_10575_length_843_cov_12.510753	360	440	4	34	80	0.4250000
NODE_10575_length_843_cov_12.510753	413	493	4	80	80	1.0000000
NODE_10576_length_843_cov_11.090054	457	537	0	64	80	0.8000000
NODE_10576_length_843_cov_11.090054	457	537	2	16	80	0.2000000
NODE_10576_length_843_cov_11.090054	510	590	0	15	80	0.1875000
NODE_10576_length_843_cov_11.090054	510	590	2	65	80	0.8125000
NODE_10577_length_843_cov_7.672043	472	552	0	13	80	0.1625000
NODE_10577_length_843_cov_7.672043	472	552	2	67	80	0.8375000
NODE_10577_length_843_cov_7.672043	525	605	0	16	80	0.2000000
NODE_10577_length_843_cov_7.672043	525	605	2	64	80	0.8000000
NODE_10601_length_842_cov_39.518170	390	470	14	71	80	0.8875000
NODE_10601_length_842_cov_39.518170	390	470	16	9	80	0.1125000
NODE_10601_length_842_cov_39.518170	443	523	2	6	80	0.0750000
NODE_10601_length_842_cov_39.518170	443	523	4	10	80	0.1250000
NODE_10601_length_842_cov_39.518170	443	523	13	1	80	0.0125000
NODE_10601_length_842_cov_39.518170	443	523	14	60	80	0.7500000
NODE_10601_length_842_cov_39.518170	443	523	16	3	80	0.0375000
NODE_10602_length_842_cov_21.567968	331	411	0	80	80	1.0000000
NODE_10602_length_842_cov_21.567968	384	464	0	80	80	1.0000000
NODE_10603_length_842_cov_19.761777	228	308	0	80	80	1.0000000
NODE_10603_length_842_cov_19.761777	281	361	0	80	80	1.0000000
NODE_10605_length_842_cov_8.703903	641	722	0	81	81	1.0000000
NODE_10608_length_842_cov_5.305518	287	367	0	80	80	1.0000000
NODE_10608_length_842_cov_5.305518	340	420	0	80	80	1.0000000
NODE_10617_length_842_cov_1.751009	35	66	0	31	31	1.0000000
NODE_10622_length_841_cov_23.815364	292	372	0	80	80	1.0000000
NODE_10622_length_841_cov_23.815364	345	425	0	36	80	0.4500000
NODE_10622_length_841_cov_23.815364	345	425	2	44	80	0.5500000
NODE_10623_length_841_cov_18.871968	338	418	2	2	80	0.0250000
NODE_10623_length_841_cov_18.871968	338	418	4	18	80	0.2250000
NODE_10623_length_841_cov_18.871968	338	418	5	54	80	0.6750000
NODE_10623_length_841_cov_18.871968	338	418	7	6	80	0.0750000
NODE_10623_length_841_cov_18.871968	391	471	2	55	80	0.6875000
NODE_10623_length_841_cov_18.871968	391	471	5	19	80	0.2375000
NODE_10623_length_841_cov_18.871968	391	471	7	6	80	0.0750000
NODE_10624_length_841_cov_14.663073	345	425	0	80	80	1.0000000
NODE_10624_length_841_cov_14.663073	398	478	0	80	80	1.0000000
NODE_10625_length_841_cov_14.149596	341	421	0	80	80	1.0000000
NODE_10625_length_841_cov_14.149596	394	474	0	80	80	1.0000000
NODE_10626_length_841_cov_12.452830	240	320	0	70	80	0.8750000
NODE_10626_length_841_cov_12.452830	240	320	2	10	80	0.1250000
NODE_10626_length_841_cov_12.452830	293	373	0	17	80	0.2125000
NODE_10626_length_841_cov_12.452830	293	373	2	63	80	0.7875000
NODE_10628_length_841_cov_9.925876	394	474	0	17	80	0.2125000
NODE_10628_length_841_cov_9.925876	394	474	2	1	80	0.0125000
NODE_10628_length_841_cov_9.925876	394	474	4	62	80	0.7750000
NODE_10628_length_841_cov_9.925876	447	527	0	70	80	0.8750000
NODE_10628_length_841_cov_9.925876	447	527	2	1	80	0.0125000
NODE_10628_length_841_cov_9.925876	447	527	4	9	80	0.1125000
NODE_10629_length_841_cov_7.407008	317	397	0	80	80	1.0000000
NODE_10629_length_841_cov_7.407008	370	450	0	80	80	1.0000000
NODE_10632_length_841_cov_3.865229	305	356	0	27	51	0.5294118
NODE_10632_length_841_cov_3.865229	305	356	2	24	51	0.4705882
NODE_10651_length_840_cov_63.726046	461	541	0	22	80	0.2750000
NODE_10651_length_840_cov_63.726046	461	541	2	9	80	0.1125000
NODE_10651_length_840_cov_63.726046	461	541	4	49	80	0.6125000
NODE_10651_length_840_cov_63.726046	514	594	0	75	80	0.9375000
NODE_10651_length_840_cov_63.726046	514	594	2	5	80	0.0625000
NODE_10652_length_840_cov_35.874494	486	566	4	8	80	0.1000000
NODE_10652_length_840_cov_35.874494	486	566	6	17	80	0.2125000
NODE_10652_length_840_cov_35.874494	486	566	8	27	80	0.3375000
NODE_10652_length_840_cov_35.874494	486	566	10	28	80	0.3500000
NODE_10652_length_840_cov_35.874494	539	619	2	3	80	0.0375000
NODE_10652_length_840_cov_35.874494	539	619	6	17	80	0.2125000
NODE_10652_length_840_cov_35.874494	539	619	8	60	80	0.7500000
NODE_10653_length_840_cov_24.499325	224	304	2	29	80	0.3625000
NODE_10653_length_840_cov_24.499325	224	304	4	51	80	0.6375000
NODE_10653_length_840_cov_24.499325	277	357	2	33	80	0.4125000
NODE_10653_length_840_cov_24.499325	277	357	4	47	80	0.5875000
NODE_10653_length_840_cov_24.499325	353	433	0	73	80	0.9125000
NODE_10653_length_840_cov_24.499325	353	433	2	7	80	0.0875000
NODE_10653_length_840_cov_24.499325	406	486	0	80	80	1.0000000
NODE_10654_length_840_cov_23.272605	309	389	0	80	80	1.0000000
NODE_10654_length_840_cov_23.272605	362	442	0	80	80	1.0000000
NODE_10655_length_840_cov_22.221323	293	373	0	43	80	0.5375000
NODE_10655_length_840_cov_22.221323	293	373	8	37	80	0.4625000
NODE_10655_length_840_cov_22.221323	346	426	8	80	80	1.0000000
NODE_10656_length_840_cov_17.026991	348	432	0	84	84	1.0000000
NODE_10656_length_840_cov_17.026991	405	485	0	80	80	1.0000000
NODE_10657_length_840_cov_16.635628	347	427	0	80	80	1.0000000
NODE_10657_length_840_cov_16.635628	400	480	0	80	80	1.0000000
NODE_10658_length_840_cov_12.133603	336	416	0	61	80	0.7625000
NODE_10658_length_840_cov_12.133603	336	416	2	19	80	0.2375000
NODE_10658_length_840_cov_12.133603	389	469	0	80	80	1.0000000
NODE_10659_length_840_cov_12.041835	332	412	0	80	80	1.0000000
NODE_10659_length_840_cov_12.041835	385	465	0	40	80	0.5000000
NODE_10659_length_840_cov_12.041835	385	465	1	22	80	0.2750000
NODE_10659_length_840_cov_12.041835	385	465	2	18	80	0.2250000
NODE_10660_length_840_cov_10.719298	275	354	0	79	79	1.0000000
NODE_10660_length_840_cov_10.719298	327	407	0	80	80	1.0000000
NODE_10663_length_840_cov_5.207827	427	507	0	80	80	1.0000000
NODE_10663_length_840_cov_5.207827	480	560	0	80	80	1.0000000
NODE_10683_length_839_cov_274.987838	450	530	11	2	80	0.0250000
NODE_10683_length_839_cov_274.987838	450	530	14	2	80	0.0250000
NODE_10683_length_839_cov_274.987838	450	530	15	2	80	0.0250000
NODE_10683_length_839_cov_274.987838	450	530	22	2	80	0.0250000
NODE_10683_length_839_cov_274.987838	450	530	23	1	80	0.0125000
NODE_10683_length_839_cov_274.987838	450	530	25	2	80	0.0250000
NODE_10683_length_839_cov_274.987838	450	530	27	9	80	0.1125000
NODE_10683_length_839_cov_274.987838	450	530	30	4	80	0.0500000
NODE_10683_length_839_cov_274.987838	450	530	36	2	80	0.0250000
NODE_10683_length_839_cov_274.987838	450	530	37	2	80	0.0250000
NODE_10683_length_839_cov_274.987838	450	530	39	2	80	0.0250000
NODE_10683_length_839_cov_274.987838	450	530	47	1	80	0.0125000
NODE_10683_length_839_cov_274.987838	450	530	49	2	80	0.0250000
NODE_10683_length_839_cov_274.987838	450	530	53	3	80	0.0375000
NODE_10683_length_839_cov_274.987838	450	530	55	3	80	0.0375000
NODE_10683_length_839_cov_274.987838	450	530	57	1	80	0.0125000
NODE_10683_length_839_cov_274.987838	450	530	60	1	80	0.0125000
NODE_10683_length_839_cov_274.987838	450	530	64	1	80	0.0125000
NODE_10683_length_839_cov_274.987838	450	530	65	2	80	0.0250000
NODE_10683_length_839_cov_274.987838	450	530	66	8	80	0.1000000
NODE_10683_length_839_cov_274.987838	450	530	72	1	80	0.0125000
NODE_10683_length_839_cov_274.987838	450	530	75	1	80	0.0125000
NODE_10683_length_839_cov_274.987838	450	530	76	2	80	0.0250000
NODE_10683_length_839_cov_274.987838	450	530	78	1	80	0.0125000
NODE_10683_length_839_cov_274.987838	450	530	82	3	80	0.0375000
NODE_10683_length_839_cov_274.987838	450	530	83	3	80	0.0375000
NODE_10683_length_839_cov_274.987838	450	530	84	2	80	0.0250000
NODE_10683_length_839_cov_274.987838	450	530	85	2	80	0.0250000
NODE_10683_length_839_cov_274.987838	450	530	86	2	80	0.0250000
NODE_10683_length_839_cov_274.987838	450	530	88	2	80	0.0250000
NODE_10683_length_839_cov_274.987838	450	530	90	1	80	0.0125000
NODE_10683_length_839_cov_274.987838	450	530	93	1	80	0.0125000
NODE_10683_length_839_cov_274.987838	450	530	94	2	80	0.0250000
NODE_10683_length_839_cov_274.987838	450	530	96	1	80	0.0125000
NODE_10683_length_839_cov_274.987838	450	530	97	1	80	0.0125000
NODE_10683_length_839_cov_274.987838	450	530	98	2	80	0.0250000
NODE_10683_length_839_cov_274.987838	450	530	112	1	80	0.0125000
NODE_10683_length_839_cov_274.987838	503	583	75	1	80	0.0125000
NODE_10683_length_839_cov_274.987838	503	583	76	2	80	0.0250000
NODE_10683_length_839_cov_274.987838	503	583	78	1	80	0.0125000
NODE_10683_length_839_cov_274.987838	503	583	82	3	80	0.0375000
NODE_10683_length_839_cov_274.987838	503	583	83	3	80	0.0375000
NODE_10683_length_839_cov_274.987838	503	583	84	2	80	0.0250000
NODE_10683_length_839_cov_274.987838	503	583	85	2	80	0.0250000
NODE_10683_length_839_cov_274.987838	503	583	86	2	80	0.0250000
NODE_10683_length_839_cov_274.987838	503	583	88	2	80	0.0250000
NODE_10683_length_839_cov_274.987838	503	583	90	1	80	0.0125000
NODE_10683_length_839_cov_274.987838	503	583	93	1	80	0.0125000
NODE_10683_length_839_cov_274.987838	503	583	94	2	80	0.0250000
NODE_10683_length_839_cov_274.987838	503	583	96	1	80	0.0125000
NODE_10683_length_839_cov_274.987838	503	583	97	1	80	0.0125000
NODE_10683_length_839_cov_274.987838	503	583	98	2	80	0.0250000
NODE_10683_length_839_cov_274.987838	503	583	112	1	80	0.0125000
NODE_10683_length_839_cov_274.987838	503	583	114	2	80	0.0250000
NODE_10683_length_839_cov_274.987838	503	583	115	1	80	0.0125000
NODE_10683_length_839_cov_274.987838	503	583	120	1	80	0.0125000
NODE_10683_length_839_cov_274.987838	503	583	122	1	80	0.0125000
NODE_10683_length_839_cov_274.987838	503	583	132	1	80	0.0125000
NODE_10683_length_839_cov_274.987838	503	583	137	1	80	0.0125000
NODE_10683_length_839_cov_274.987838	503	583	145	1	80	0.0125000
NODE_10683_length_839_cov_274.987838	503	583	149	2	80	0.0250000
NODE_10683_length_839_cov_274.987838	503	583	154	1	80	0.0125000
NODE_10683_length_839_cov_274.987838	503	583	156	1	80	0.0125000
NODE_10683_length_839_cov_274.987838	503	583	165	1	80	0.0125000
NODE_10683_length_839_cov_274.987838	503	583	170	1	80	0.0125000
NODE_10683_length_839_cov_274.987838	503	583	172	1	80	0.0125000
NODE_10683_length_839_cov_274.987838	503	583	175	8	80	0.1000000
NODE_10683_length_839_cov_274.987838	503	583	178	1	80	0.0125000
NODE_10683_length_839_cov_274.987838	503	583	181	1	80	0.0125000
NODE_10683_length_839_cov_274.987838	503	583	184	3	80	0.0375000
NODE_10683_length_839_cov_274.987838	503	583	185	3	80	0.0375000
NODE_10683_length_839_cov_274.987838	503	583	186	2	80	0.0250000
NODE_10683_length_839_cov_274.987838	503	583	187	1	80	0.0125000
NODE_10683_length_839_cov_274.987838	503	583	188	1	80	0.0125000
NODE_10683_length_839_cov_274.987838	503	583	191	2	80	0.0250000
NODE_10683_length_839_cov_274.987838	503	583	192	1	80	0.0125000
NODE_10683_length_839_cov_274.987838	503	583	200	3	80	0.0375000
NODE_10683_length_839_cov_274.987838	503	583	202	1	80	0.0125000
NODE_10683_length_839_cov_274.987838	503	583	203	2	80	0.0250000
NODE_10683_length_839_cov_274.987838	503	583	205	2	80	0.0250000
NODE_10683_length_839_cov_274.987838	503	583	207	1	80	0.0125000
NODE_10683_length_839_cov_274.987838	503	583	208	6	80	0.0750000
NODE_10684_length_839_cov_24.500000	303	383	0	54	80	0.6750000
NODE_10684_length_839_cov_24.500000	303	383	2	26	80	0.3250000
NODE_10684_length_839_cov_24.500000	356	436	0	80	80	1.0000000
NODE_10685_length_839_cov_16.390541	477	557	0	80	80	1.0000000
NODE_10685_length_839_cov_16.390541	530	610	0	80	80	1.0000000
NODE_10686_length_839_cov_10.006757	383	463	0	80	80	1.0000000
NODE_10686_length_839_cov_10.006757	436	516	0	80	80	1.0000000
NODE_10688_length_839_cov_7.612162	308	388	0	80	80	1.0000000
NODE_10688_length_839_cov_7.612162	361	441	0	80	80	1.0000000
NODE_10689_length_839_cov_6.693243	343	423	2	77	80	0.9625000
NODE_10689_length_839_cov_6.693243	343	423	4	3	80	0.0375000
NODE_10706_length_838_cov_39.263870	383	463	0	80	80	1.0000000
NODE_10706_length_838_cov_39.263870	436	516	0	80	80	1.0000000
NODE_10707_length_838_cov_27.843031	473	553	0	55	80	0.6875000
NODE_10707_length_838_cov_27.843031	473	553	2	25	80	0.3125000
NODE_10707_length_838_cov_27.843031	526	606	0	80	80	1.0000000
NODE_10708_length_838_cov_27.238160	432	512	0	36	80	0.4500000
NODE_10708_length_838_cov_27.238160	432	512	2	44	80	0.5500000
NODE_10708_length_838_cov_27.238160	485	565	2	71	80	0.8875000
NODE_10708_length_838_cov_27.238160	485	565	4	9	80	0.1125000
NODE_10709_length_838_cov_22.691475	380	460	1	17	80	0.2125000
NODE_10709_length_838_cov_22.691475	380	460	2	63	80	0.7875000
NODE_10709_length_838_cov_22.691475	433	513	0	37	80	0.4625000
NODE_10709_length_838_cov_22.691475	433	513	1	33	80	0.4125000
NODE_10709_length_838_cov_22.691475	433	513	2	10	80	0.1250000
NODE_10710_length_838_cov_16.169147	312	392	0	80	80	1.0000000
NODE_10710_length_838_cov_16.169147	365	445	0	80	80	1.0000000
NODE_10711_length_838_cov_15.753721	328	408	0	80	80	1.0000000
NODE_10711_length_838_cov_15.753721	381	461	0	80	80	1.0000000
NODE_10712_length_838_cov_15.514208	294	374	0	10	80	0.1250000
NODE_10712_length_838_cov_15.514208	294	374	2	70	80	0.8750000
NODE_10712_length_838_cov_15.514208	347	427	0	63	80	0.7875000
NODE_10712_length_838_cov_15.514208	347	427	2	17	80	0.2125000
NODE_10713_length_838_cov_7.733424	350	430	0	32	80	0.4000000
NODE_10713_length_838_cov_7.733424	350	430	2	48	80	0.6000000
NODE_10713_length_838_cov_7.733424	403	483	0	80	80	1.0000000
NODE_10716_length_838_cov_4.511502	131	213	0	82	82	1.0000000
NODE_10716_length_838_cov_4.511502	184	252	0	68	68	1.0000000
NODE_10722_length_838_cov_2.247632	359	405	0	46	46	1.0000000
NODE_10727_length_838_cov_1.843031	732	752	0	20	20	1.0000000
NODE_10740_length_837_cov_32.691057	401	481	0	15	80	0.1875000
NODE_10740_length_837_cov_32.691057	401	481	2	65	80	0.8125000
NODE_10740_length_837_cov_32.691057	454	534	0	28	80	0.3500000
NODE_10740_length_837_cov_32.691057	454	534	2	52	80	0.6500000
NODE_10741_length_837_cov_30.995935	399	479	2	40	80	0.5000000
NODE_10741_length_837_cov_30.995935	399	479	4	40	80	0.5000000
NODE_10741_length_837_cov_30.995935	452	532	0	19	80	0.2375000
NODE_10741_length_837_cov_30.995935	452	532	2	20	80	0.2500000
NODE_10741_length_837_cov_30.995935	452	532	4	41	80	0.5125000
NODE_10742_length_837_cov_30.883469	278	358	0	49	80	0.6125000
NODE_10742_length_837_cov_30.883469	278	358	4	31	80	0.3875000
NODE_10742_length_837_cov_30.883469	331	411	2	1	80	0.0125000
NODE_10742_length_837_cov_30.883469	331	411	4	42	80	0.5250000
NODE_10742_length_837_cov_30.883469	331	411	6	37	80	0.4625000
NODE_10742_length_837_cov_30.883469	407	487	2	77	80	0.9625000
NODE_10742_length_837_cov_30.883469	407	487	6	3	80	0.0375000
NODE_10742_length_837_cov_30.883469	460	540	0	46	80	0.5750000
NODE_10742_length_837_cov_30.883469	460	540	2	34	80	0.4250000
NODE_10743_length_837_cov_14.573171	205	280	0	75	75	1.0000000
NODE_10743_length_837_cov_14.573171	258	337	0	79	79	1.0000000
NODE_10743_length_837_cov_14.573171	333	413	0	80	80	1.0000000
NODE_10743_length_837_cov_14.573171	386	466	0	80	80	1.0000000
NODE_10744_length_837_cov_12.582656	226	306	0	80	80	1.0000000
NODE_10744_length_837_cov_12.582656	279	359	0	80	80	1.0000000
NODE_10745_length_837_cov_6.998645	389	474	0	6	85	0.0705882
NODE_10745_length_837_cov_6.998645	389	474	6	79	85	0.9294118
NODE_10745_length_837_cov_6.998645	447	527	0	40	80	0.5000000
NODE_10745_length_837_cov_6.998645	447	527	6	40	80	0.5000000
NODE_10750_length_837_cov_3.119241	373	453	0	80	80	1.0000000
NODE_10750_length_837_cov_3.119241	426	506	0	34	80	0.4250000
NODE_10750_length_837_cov_3.119241	426	506	2	46	80	0.5750000
NODE_10769_length_836_cov_40.141113	224	304	0	80	80	1.0000000
NODE_10769_length_836_cov_40.141113	277	357	0	31	80	0.3875000
NODE_10769_length_836_cov_40.141113	277	357	2	49	80	0.6125000
NODE_10769_length_836_cov_40.141113	353	433	2	31	80	0.3875000
NODE_10769_length_836_cov_40.141113	353	433	4	6	80	0.0750000
NODE_10769_length_836_cov_40.141113	353	433	8	8	80	0.1000000
NODE_10769_length_836_cov_40.141113	353	433	10	35	80	0.4375000
NODE_10769_length_836_cov_40.141113	406	486	0	6	80	0.0750000
NODE_10769_length_836_cov_40.141113	406	486	6	33	80	0.4125000
NODE_10769_length_836_cov_40.141113	406	486	8	22	80	0.2750000
NODE_10769_length_836_cov_40.141113	406	486	10	19	80	0.2375000
NODE_10770_length_836_cov_27.610583	344	424	0	1	80	0.0125000
NODE_10770_length_836_cov_27.610583	344	424	2	26	80	0.3250000
NODE_10770_length_836_cov_27.610583	344	424	6	3	80	0.0375000
NODE_10770_length_836_cov_27.610583	344	424	10	2	80	0.0250000
NODE_10770_length_836_cov_27.610583	344	424	12	48	80	0.6000000
NODE_10770_length_836_cov_27.610583	397	477	0	54	80	0.6750000
NODE_10770_length_836_cov_27.610583	397	477	2	26	80	0.3250000
NODE_10771_length_836_cov_15.719132	295	375	0	22	80	0.2750000
NODE_10771_length_836_cov_15.719132	295	375	2	58	80	0.7250000
NODE_10771_length_836_cov_15.719132	348	428	0	22	80	0.2750000
NODE_10771_length_836_cov_15.719132	348	428	2	58	80	0.7250000
NODE_10772_length_836_cov_9.309362	295	375	0	47	80	0.5875000
NODE_10772_length_836_cov_9.309362	295	375	2	33	80	0.4125000
NODE_10772_length_836_cov_9.309362	348	428	0	15	80	0.1875000
NODE_10772_length_836_cov_9.309362	348	428	2	65	80	0.8125000
NODE_10773_length_836_cov_6.283582	336	416	0	42	80	0.5250000
NODE_10773_length_836_cov_6.283582	336	416	3	1	80	0.0125000
NODE_10773_length_836_cov_6.283582	336	416	4	7	80	0.0875000
NODE_10773_length_836_cov_6.283582	336	416	6	30	80	0.3750000
NODE_10773_length_836_cov_6.283582	389	469	0	1	80	0.0125000
NODE_10773_length_836_cov_6.283582	389	469	2	5	80	0.0625000
NODE_10773_length_836_cov_6.283582	389	469	5	1	80	0.0125000
NODE_10773_length_836_cov_6.283582	389	469	6	73	80	0.9125000
NODE_10774_length_836_cov_4.979647	371	451	0	80	80	1.0000000
NODE_10774_length_836_cov_4.979647	424	504	0	80	80	1.0000000
NODE_10787_length_835_cov_61.033967	253	333	0	24	80	0.3000000
NODE_10787_length_835_cov_61.033967	253	333	2	56	80	0.7000000
NODE_10787_length_835_cov_61.033967	306	386	0	27	80	0.3375000
NODE_10787_length_835_cov_61.033967	306	386	2	53	80	0.6625000
NODE_10788_length_835_cov_32.380435	390	470	0	80	80	1.0000000
NODE_10788_length_835_cov_32.380435	443	523	0	80	80	1.0000000
NODE_10789_length_835_cov_20.779891	415	495	4	63	80	0.7875000
NODE_10789_length_835_cov_20.779891	415	495	6	17	80	0.2125000
NODE_10789_length_835_cov_20.779891	468	548	0	36	80	0.4500000
NODE_10789_length_835_cov_20.779891	468	548	4	44	80	0.5500000
NODE_10808_length_835_cov_1.694293	18	80	8	1	62	0.0161290
NODE_10808_length_835_cov_1.694293	18	80	10	61	62	0.9838710
NODE_10820_length_834_cov_13.689796	213	293	0	80	80	1.0000000
NODE_10820_length_834_cov_13.689796	266	346	0	80	80	1.0000000
NODE_10822_length_834_cov_12.609524	406	486	0	80	80	1.0000000
NODE_10822_length_834_cov_12.609524	459	539	0	80	80	1.0000000
NODE_10823_length_834_cov_11.492517	248	328	0	80	80	1.0000000
NODE_10823_length_834_cov_11.492517	301	381	0	80	80	1.0000000
NODE_10824_length_834_cov_9.957823	212	292	0	26	80	0.3250000
NODE_10824_length_834_cov_9.957823	212	292	2	54	80	0.6750000
NODE_10824_length_834_cov_9.957823	265	345	2	80	80	1.0000000
NODE_10825_length_834_cov_6.448980	482	546	0	37	64	0.5781250
NODE_10825_length_834_cov_6.448980	482	546	2	27	64	0.4218750
NODE_10833_length_834_cov_2.658503	589	641	0	5	52	0.0961538
NODE_10833_length_834_cov_2.658503	589	641	2	24	52	0.4615385
NODE_10833_length_834_cov_2.658503	589	641	4	1	52	0.0192308
NODE_10833_length_834_cov_2.658503	589	641	5	22	52	0.4230769
NODE_10846_length_833_cov_57.702997	338	418	0	80	80	1.0000000
NODE_10846_length_833_cov_57.702997	391	471	0	65	80	0.8125000
NODE_10846_length_833_cov_57.702997	391	471	2	15	80	0.1875000
NODE_10847_length_833_cov_38.153951	364	444	0	20	80	0.2500000
NODE_10847_length_833_cov_38.153951	364	444	2	57	80	0.7125000
NODE_10847_length_833_cov_38.153951	364	444	4	3	80	0.0375000
NODE_10847_length_833_cov_38.153951	417	497	2	44	80	0.5500000
NODE_10847_length_833_cov_38.153951	417	497	4	36	80	0.4500000
NODE_10848_length_833_cov_34.302452	368	448	0	80	80	1.0000000
NODE_10848_length_833_cov_34.302452	421	501	0	80	80	1.0000000
NODE_10849_length_833_cov_20.452316	311	392	0	81	81	1.0000000
NODE_10849_length_833_cov_20.452316	365	445	0	80	80	1.0000000
NODE_10850_length_833_cov_16.643052	238	318	0	80	80	1.0000000
NODE_10851_length_833_cov_16.536785	84	164	0	80	80	1.0000000
NODE_10851_length_833_cov_16.536785	137	217	0	80	80	1.0000000
NODE_10865_length_833_cov_3.089918	467	547	0	80	80	1.0000000
NODE_10865_length_833_cov_3.089918	520	600	0	80	80	1.0000000
NODE_10891_length_832_cov_35.728513	460	540	0	12	80	0.1500000
NODE_10891_length_832_cov_35.728513	460	540	2	68	80	0.8500000
NODE_10891_length_832_cov_35.728513	513	593	0	65	80	0.8125000
NODE_10891_length_832_cov_35.728513	513	593	2	15	80	0.1875000
NODE_10892_length_832_cov_25.450205	292	372	0	58	80	0.7250000
NODE_10892_length_832_cov_25.450205	292	372	4	16	80	0.2000000
NODE_10892_length_832_cov_25.450205	292	372	6	6	80	0.0750000
NODE_10892_length_832_cov_25.450205	345	425	0	5	80	0.0625000
NODE_10892_length_832_cov_25.450205	345	425	4	16	80	0.2000000
NODE_10892_length_832_cov_25.450205	345	425	6	9	80	0.1125000
NODE_10892_length_832_cov_25.450205	345	425	8	50	80	0.6250000
NODE_10893_length_832_cov_18.858117	428	508	0	14	80	0.1750000
NODE_10893_length_832_cov_18.858117	428	508	4	66	80	0.8250000
NODE_10893_length_832_cov_18.858117	481	561	0	13	80	0.1625000
NODE_10893_length_832_cov_18.858117	481	561	4	67	80	0.8375000
NODE_10894_length_832_cov_17.799454	314	394	0	80	80	1.0000000
NODE_10894_length_832_cov_17.799454	367	447	0	80	80	1.0000000
NODE_10895_length_832_cov_14.811733	353	433	0	75	80	0.9375000
NODE_10895_length_832_cov_14.811733	353	433	2	5	80	0.0625000
NODE_10896_length_832_cov_14.770805	259	339	0	68	80	0.8500000
NODE_10896_length_832_cov_14.770805	259	339	1	12	80	0.1500000
NODE_10896_length_832_cov_14.770805	312	392	0	38	80	0.4750000
NODE_10896_length_832_cov_14.770805	312	392	2	17	80	0.2125000
NODE_10896_length_832_cov_14.770805	312	392	3	25	80	0.3125000
NODE_10897_length_832_cov_8.305593	266	346	0	3	80	0.0375000
NODE_10897_length_832_cov_8.305593	266	346	2	77	80	0.9625000
NODE_10897_length_832_cov_8.305593	319	399	0	32	80	0.4000000
NODE_10897_length_832_cov_8.305593	319	399	2	48	80	0.6000000
NODE_10918_length_831_cov_18.403005	371	451	0	25	80	0.3125000
NODE_10918_length_831_cov_18.403005	371	451	2	11	80	0.1375000
NODE_10918_length_831_cov_18.403005	371	451	4	44	80	0.5500000
NODE_10918_length_831_cov_18.403005	424	504	0	23	80	0.2875000
NODE_10918_length_831_cov_18.403005	424	504	2	6	80	0.0750000
NODE_10918_length_831_cov_18.403005	424	504	4	51	80	0.6375000
NODE_10919_length_831_cov_16.017760	357	437	0	5	80	0.0625000
NODE_10919_length_831_cov_16.017760	357	437	2	59	80	0.7375000
NODE_10919_length_831_cov_16.017760	357	437	4	6	80	0.0750000
NODE_10919_length_831_cov_16.017760	357	437	6	2	80	0.0250000
NODE_10919_length_831_cov_16.017760	357	437	8	8	80	0.1000000
NODE_10919_length_831_cov_16.017760	410	490	2	11	80	0.1375000
NODE_10919_length_831_cov_16.017760	410	490	4	19	80	0.2375000
NODE_10919_length_831_cov_16.017760	410	490	6	31	80	0.3875000
NODE_10919_length_831_cov_16.017760	410	490	8	19	80	0.2375000
NODE_10920_length_831_cov_13.740437	405	485	0	80	80	1.0000000
NODE_10920_length_831_cov_13.740437	458	538	0	80	80	1.0000000
NODE_10921_length_831_cov_9.595628	281	361	0	80	80	1.0000000
NODE_10921_length_831_cov_9.595628	334	414	0	80	80	1.0000000
NODE_10922_length_831_cov_8.199454	433	482	2	2	49	0.0408163
NODE_10922_length_831_cov_8.199454	433	482	4	47	49	0.9591837
NODE_10923_length_831_cov_7.607923	216	296	0	80	80	1.0000000
NODE_10923_length_831_cov_7.607923	269	349	0	80	80	1.0000000
NODE_10924_length_831_cov_6.454918	334	409	0	16	75	0.2133333
NODE_10924_length_831_cov_6.454918	334	409	2	2	75	0.0266667
NODE_10924_length_831_cov_6.454918	334	409	4	57	75	0.7600000
NODE_10924_length_831_cov_6.454918	382	462	4	27	80	0.3375000
NODE_10924_length_831_cov_6.454918	382	462	5	11	80	0.1375000
NODE_10924_length_831_cov_6.454918	382	462	6	24	80	0.3000000
NODE_10924_length_831_cov_6.454918	382	462	9	18	80	0.2250000
NODE_10960_length_830_cov_40.856361	238	318	0	61	80	0.7625000
NODE_10960_length_830_cov_40.856361	238	318	2	19	80	0.2375000
NODE_10960_length_830_cov_40.856361	291	371	0	8	80	0.1000000
NODE_10960_length_830_cov_40.856361	291	371	2	72	80	0.9000000
NODE_10961_length_830_cov_32.170999	302	378	0	76	76	1.0000000
NODE_10961_length_830_cov_32.170999	303	383	0	80	80	1.0000000
NODE_10961_length_830_cov_32.170999	356	436	0	80	80	1.0000000
NODE_10962_length_830_cov_28.041040	393	473	0	80	80	1.0000000
NODE_10962_length_830_cov_28.041040	446	526	0	80	80	1.0000000
NODE_10963_length_830_cov_20.280438	360	440	0	80	80	1.0000000
NODE_10963_length_830_cov_20.280438	413	492	0	79	79	1.0000000
NODE_10964_length_830_cov_19.495212	274	354	0	80	80	1.0000000
NODE_10964_length_830_cov_19.495212	327	407	0	80	80	1.0000000
NODE_10965_length_830_cov_18.522572	368	448	0	80	80	1.0000000
NODE_10965_length_830_cov_18.522572	421	501	0	80	80	1.0000000
NODE_10966_length_830_cov_13.830369	278	358	4	75	80	0.9375000
NODE_10966_length_830_cov_13.830369	278	358	5	3	80	0.0375000
NODE_10966_length_830_cov_13.830369	278	358	6	1	80	0.0125000
NODE_10966_length_830_cov_13.830369	278	358	8	1	80	0.0125000
NODE_10966_length_830_cov_13.830369	331	411	4	80	80	1.0000000
NODE_10967_length_830_cov_12.459644	201	281	0	80	80	1.0000000
NODE_10967_length_830_cov_12.459644	254	334	0	80	80	1.0000000
NODE_10968_length_830_cov_8.344733	450	530	0	80	80	1.0000000
NODE_10968_length_830_cov_8.344733	503	583	0	80	80	1.0000000
NODE_10969_length_830_cov_8.227086	634	714	0	80	80	1.0000000
NODE_10969_length_830_cov_8.227086	687	767	0	80	80	1.0000000
NODE_10995_length_829_cov_74.910959	271	351	0	28	80	0.3500000
NODE_10995_length_829_cov_74.910959	271	351	4	52	80	0.6500000
NODE_10995_length_829_cov_74.910959	324	404	0	33	80	0.4125000
NODE_10995_length_829_cov_74.910959	324	404	4	47	80	0.5875000
NODE_10996_length_829_cov_34.068493	302	382	0	80	80	1.0000000
NODE_10996_length_829_cov_34.068493	355	435	0	80	80	1.0000000
NODE_10997_length_829_cov_24.027397	441	521	8	80	80	1.0000000
NODE_10997_length_829_cov_24.027397	494	574	0	46	80	0.5750000
NODE_10997_length_829_cov_24.027397	494	574	4	5	80	0.0625000
NODE_10997_length_829_cov_24.027397	494	574	8	29	80	0.3625000
NODE_10998_length_829_cov_21.735616	420	500	0	2	80	0.0250000
NODE_10998_length_829_cov_21.735616	420	500	4	78	80	0.9750000
NODE_10998_length_829_cov_21.735616	473	553	0	38	80	0.4750000
NODE_10998_length_829_cov_21.735616	473	553	4	42	80	0.5250000
NODE_10999_length_829_cov_18.446575	407	487	0	24	80	0.3000000
NODE_10999_length_829_cov_18.446575	407	487	8	1	80	0.0125000
NODE_10999_length_829_cov_18.446575	407	487	10	15	80	0.1875000
NODE_10999_length_829_cov_18.446575	407	487	11	40	80	0.5000000
NODE_10999_length_829_cov_18.446575	460	540	10	42	80	0.5250000
NODE_10999_length_829_cov_18.446575	460	540	11	13	80	0.1625000
NODE_10999_length_829_cov_18.446575	460	540	20	1	80	0.0125000
NODE_10999_length_829_cov_18.446575	460	540	21	24	80	0.3000000
NODE_11000_length_829_cov_10.971233	368	448	0	80	80	1.0000000
NODE_11000_length_829_cov_10.971233	421	501	0	80	80	1.0000000
NODE_11001_length_829_cov_10.035616	387	467	0	80	80	1.0000000
NODE_11001_length_829_cov_10.035616	440	520	0	80	80	1.0000000
NODE_11002_length_829_cov_9.906849	326	406	0	80	80	1.0000000
NODE_11002_length_829_cov_9.906849	379	459	0	80	80	1.0000000
NODE_11003_length_829_cov_8.809589	450	530	0	80	80	1.0000000
NODE_11003_length_829_cov_8.809589	503	583	0	80	80	1.0000000
NODE_11006_length_829_cov_4.310959	473	553	0	80	80	1.0000000
NODE_11006_length_829_cov_4.310959	526	606	0	80	80	1.0000000
NODE_11008_length_829_cov_3.079452	507	587	0	22	80	0.2750000
NODE_11008_length_829_cov_3.079452	507	587	1	58	80	0.7250000
NODE_11008_length_829_cov_3.079452	507	587	0	22	80	0.2750000
NODE_11008_length_829_cov_3.079452	507	587	1	58	80	0.7250000
NODE_11008_length_829_cov_3.079452	560	640	0	75	80	0.9375000
NODE_11008_length_829_cov_3.079452	560	640	1	5	80	0.0625000
NODE_11025_length_828_cov_41.116598	436	516	0	11	80	0.1375000
NODE_11025_length_828_cov_41.116598	436	516	2	69	80	0.8625000
NODE_11025_length_828_cov_41.116598	489	569	0	57	80	0.7125000
NODE_11025_length_828_cov_41.116598	489	569	2	23	80	0.2875000
NODE_11026_length_828_cov_36.459534	372	452	0	80	80	1.0000000
NODE_11026_length_828_cov_36.459534	425	505	0	80	80	1.0000000
NODE_11027_length_828_cov_33.515775	443	523	0	4	80	0.0500000
NODE_11027_length_828_cov_33.515775	443	523	2	76	80	0.9500000
NODE_11027_length_828_cov_33.515775	496	576	0	5	80	0.0625000
NODE_11027_length_828_cov_33.515775	496	576	2	75	80	0.9375000
NODE_11028_length_828_cov_21.123457	380	460	0	80	80	1.0000000
NODE_11028_length_828_cov_21.123457	433	513	0	80	80	1.0000000
NODE_11029_length_828_cov_17.406036	304	392	0	88	88	1.0000000
NODE_11029_length_828_cov_17.406036	369	445	0	76	76	1.0000000
NODE_11030_length_828_cov_14.606310	287	367	0	80	80	1.0000000
NODE_11030_length_828_cov_14.606310	340	420	0	80	80	1.0000000
NODE_11031_length_828_cov_14.493827	326	406	0	73	80	0.9125000
NODE_11031_length_828_cov_14.493827	326	406	2	7	80	0.0875000
NODE_11031_length_828_cov_14.493827	379	459	0	80	80	1.0000000
NODE_11031_length_828_cov_14.493827	455	535	0	70	80	0.8750000
NODE_11031_length_828_cov_14.493827	455	535	2	10	80	0.1250000
NODE_11031_length_828_cov_14.493827	508	588	0	17	80	0.2125000
NODE_11031_length_828_cov_14.493827	508	588	2	63	80	0.7875000
NODE_11032_length_828_cov_10.550069	280	360	0	80	80	1.0000000
NODE_11032_length_828_cov_10.550069	333	413	0	80	80	1.0000000
NODE_11033_length_828_cov_9.292181	594	674	0	80	80	1.0000000
NODE_11033_length_828_cov_9.292181	647	727	0	80	80	1.0000000
NODE_11034_length_828_cov_8.747599	298	378	0	80	80	1.0000000
NODE_11034_length_828_cov_8.747599	351	431	0	80	80	1.0000000
NODE_11035_length_828_cov_8.098765	199	279	0	4	80	0.0500000
NODE_11035_length_828_cov_8.098765	199	279	2	75	80	0.9375000
NODE_11035_length_828_cov_8.098765	199	279	4	1	80	0.0125000
NODE_11035_length_828_cov_8.098765	252	332	0	12	80	0.1500000
NODE_11035_length_828_cov_8.098765	252	332	2	68	80	0.8500000
NODE_11037_length_828_cov_7.473251	300	380	0	80	80	1.0000000
NODE_11037_length_828_cov_7.473251	353	433	0	80	80	1.0000000
NODE_11039_length_828_cov_5.481481	543	623	0	80	80	1.0000000
NODE_11039_length_828_cov_5.481481	596	676	0	80	80	1.0000000
NODE_11041_length_828_cov_5.069959	259	339	0	80	80	1.0000000
NODE_11066_length_827_cov_34.567308	269	349	0	80	80	1.0000000
NODE_11066_length_827_cov_34.567308	322	402	0	45	80	0.5625000
NODE_11066_length_827_cov_34.567308	322	402	2	35	80	0.4375000
NODE_11066_length_827_cov_34.567308	398	478	2	80	80	1.0000000
NODE_11066_length_827_cov_34.567308	451	531	0	21	80	0.2625000
NODE_11066_length_827_cov_34.567308	451	531	2	59	80	0.7375000
NODE_11067_length_827_cov_31.538462	320	400	0	22	80	0.2750000
NODE_11067_length_827_cov_31.538462	320	400	4	7	80	0.0875000
NODE_11067_length_827_cov_31.538462	320	400	6	51	80	0.6375000
NODE_11067_length_827_cov_31.538462	373	453	2	29	80	0.3625000
NODE_11067_length_827_cov_31.538462	373	453	6	51	80	0.6375000
NODE_11068_length_827_cov_19.548077	464	544	0	80	80	1.0000000
NODE_11068_length_827_cov_19.548077	517	597	0	80	80	1.0000000
NODE_11069_length_827_cov_17.490385	320	400	0	80	80	1.0000000
NODE_11069_length_827_cov_17.490385	373	453	0	80	80	1.0000000
NODE_11070_length_827_cov_15.247253	205	285	0	40	80	0.5000000
NODE_11070_length_827_cov_15.247253	205	285	2	40	80	0.5000000
NODE_11070_length_827_cov_15.247253	258	338	2	80	80	1.0000000
NODE_11071_length_827_cov_14.151099	372	452	2	80	80	1.0000000
NODE_11071_length_827_cov_14.151099	425	505	0	49	80	0.6125000
NODE_11071_length_827_cov_14.151099	425	505	2	31	80	0.3875000
NODE_11072_length_827_cov_12.157967	262	342	0	31	80	0.3875000
NODE_11072_length_827_cov_12.157967	262	342	4	49	80	0.6125000
NODE_11072_length_827_cov_12.157967	315	395	0	19	80	0.2375000
NODE_11072_length_827_cov_12.157967	315	395	4	61	80	0.7625000
NODE_11073_length_827_cov_11.777473	316	396	0	25	80	0.3125000
NODE_11073_length_827_cov_11.777473	316	396	2	27	80	0.3375000
NODE_11073_length_827_cov_11.777473	316	396	4	28	80	0.3500000
NODE_11073_length_827_cov_11.777473	369	449	0	3	80	0.0375000
NODE_11073_length_827_cov_11.777473	369	449	2	77	80	0.9625000
NODE_11074_length_827_cov_11.651099	393	473	4	13	80	0.1625000
NODE_11074_length_827_cov_11.651099	393	473	5	4	80	0.0500000
NODE_11074_length_827_cov_11.651099	393	473	6	63	80	0.7875000
NODE_11074_length_827_cov_11.651099	446	526	2	13	80	0.1625000
NODE_11074_length_827_cov_11.651099	446	526	4	4	80	0.0500000
NODE_11074_length_827_cov_11.651099	446	526	5	4	80	0.0500000
NODE_11074_length_827_cov_11.651099	446	526	6	59	80	0.7375000
NODE_11075_length_827_cov_10.711538	286	366	0	71	80	0.8875000
NODE_11075_length_827_cov_10.711538	286	366	11	9	80	0.1125000
NODE_11075_length_827_cov_10.711538	339	419	0	18	80	0.2250000
NODE_11075_length_827_cov_10.711538	339	419	11	62	80	0.7750000
NODE_11076_length_827_cov_10.262363	273	353	0	80	80	1.0000000
NODE_11076_length_827_cov_10.262363	326	406	0	80	80	1.0000000
NODE_11077_length_827_cov_10.221154	256	336	0	27	80	0.3375000
NODE_11077_length_827_cov_10.221154	256	336	6	53	80	0.6625000
NODE_11078_length_827_cov_9.576923	359	439	0	80	80	1.0000000
NODE_11078_length_827_cov_9.576923	412	492	0	80	80	1.0000000
NODE_11079_length_827_cov_8.780220	361	441	0	20	80	0.2500000
NODE_11079_length_827_cov_8.780220	361	441	2	60	80	0.7500000
NODE_11079_length_827_cov_8.780220	414	494	0	39	80	0.4875000
NODE_11079_length_827_cov_8.780220	414	494	2	31	80	0.3875000
NODE_11079_length_827_cov_8.780220	414	494	4	10	80	0.1250000
NODE_11093_length_827_cov_1.412088	736	784	4	26	48	0.5416667
NODE_11093_length_827_cov_1.412088	736	784	6	22	48	0.4583333
NODE_11106_length_826_cov_34.026135	211	291	2	71	80	0.8875000
NODE_11106_length_826_cov_34.026135	211	291	4	9	80	0.1125000
NODE_11106_length_826_cov_34.026135	264	344	0	5	80	0.0625000
NODE_11106_length_826_cov_34.026135	264	344	2	75	80	0.9375000
NODE_11107_length_826_cov_24.093535	282	362	0	45	80	0.5625000
NODE_11107_length_826_cov_24.093535	282	362	2	35	80	0.4375000
NODE_11107_length_826_cov_24.093535	335	415	0	80	80	1.0000000
NODE_11108_length_826_cov_20.943604	207	287	0	39	80	0.4875000
NODE_11108_length_826_cov_20.943604	207	287	2	34	80	0.4250000
NODE_11108_length_826_cov_20.943604	207	287	6	7	80	0.0875000
NODE_11108_length_826_cov_20.943604	260	340	2	20	80	0.2500000
NODE_11108_length_826_cov_20.943604	260	340	4	22	80	0.2750000
NODE_11108_length_826_cov_20.943604	260	340	6	38	80	0.4750000
NODE_11109_length_826_cov_20.437414	413	493	0	49	80	0.6125000
NODE_11109_length_826_cov_20.437414	413	493	4	31	80	0.3875000
NODE_11109_length_826_cov_20.437414	466	546	0	6	80	0.0750000
NODE_11109_length_826_cov_20.437414	466	546	4	74	80	0.9250000
NODE_11110_length_826_cov_20.200825	432	512	0	80	80	1.0000000
NODE_11110_length_826_cov_20.200825	485	565	0	80	80	1.0000000
NODE_11111_length_826_cov_18.489684	345	425	2	58	80	0.7250000
NODE_11111_length_826_cov_18.489684	345	425	4	11	80	0.1375000
NODE_11111_length_826_cov_18.489684	345	425	6	11	80	0.1375000
NODE_11111_length_826_cov_18.489684	398	478	2	5	80	0.0625000
NODE_11111_length_826_cov_18.489684	398	478	4	64	80	0.8000000
NODE_11111_length_826_cov_18.489684	398	478	6	11	80	0.1375000
NODE_11112_length_826_cov_17.998624	336	416	0	36	80	0.4500000
NODE_11112_length_826_cov_17.998624	336	416	1	44	80	0.5500000
NODE_11112_length_826_cov_17.998624	389	469	0	80	80	1.0000000
NODE_11113_length_826_cov_17.038514	358	438	0	80	80	1.0000000
NODE_11113_length_826_cov_17.038514	411	491	0	80	80	1.0000000
NODE_11114_length_826_cov_16.777166	514	603	0	89	89	1.0000000
NODE_11115_length_826_cov_16.177442	361	441	0	75	80	0.9375000
NODE_11115_length_826_cov_16.177442	361	441	2	5	80	0.0625000
NODE_11115_length_826_cov_16.177442	414	494	0	80	80	1.0000000
NODE_11116_length_826_cov_15.134801	346	426	2	80	80	1.0000000
NODE_11116_length_826_cov_15.134801	399	479	0	45	80	0.5625000
NODE_11116_length_826_cov_15.134801	399	479	2	35	80	0.4375000
NODE_11117_length_826_cov_9.943604	320	400	0	22	80	0.2750000
NODE_11117_length_826_cov_9.943604	320	400	2	58	80	0.7250000
NODE_11117_length_826_cov_9.943604	373	453	0	57	80	0.7125000
NODE_11117_length_826_cov_9.943604	373	453	2	23	80	0.2875000
NODE_11120_length_826_cov_4.852820	501	579	0	78	78	1.0000000
NODE_11120_length_826_cov_4.852820	552	632	0	80	80	1.0000000
NODE_11161_length_825_cov_61.804408	382	462	0	47	80	0.5875000
NODE_11161_length_825_cov_61.804408	382	462	2	33	80	0.4125000
NODE_11161_length_825_cov_61.804408	435	514	0	27	79	0.3417721
NODE_11161_length_825_cov_61.804408	435	514	2	52	79	0.6582279
NODE_11162_length_825_cov_43.825069	488	568	0	56	80	0.7000000
NODE_11162_length_825_cov_43.825069	488	568	2	24	80	0.3000000
NODE_11162_length_825_cov_43.825069	541	621	0	80	80	1.0000000
NODE_11162_length_825_cov_43.825069	617	697	0	6	80	0.0750000
NODE_11162_length_825_cov_43.825069	617	697	2	13	80	0.1625000
NODE_11162_length_825_cov_43.825069	617	697	10	35	80	0.4375000
NODE_11162_length_825_cov_43.825069	617	697	11	2	80	0.0250000
NODE_11162_length_825_cov_43.825069	617	697	12	24	80	0.3000000
NODE_11162_length_825_cov_43.825069	670	750	4	8	80	0.1000000
NODE_11162_length_825_cov_43.825069	670	750	10	1	80	0.0125000
NODE_11162_length_825_cov_43.825069	670	750	11	2	80	0.0250000
NODE_11162_length_825_cov_43.825069	670	750	12	69	80	0.8625000
NODE_11163_length_825_cov_43.389807	496	576	0	34	80	0.4250000
NODE_11163_length_825_cov_43.389807	496	576	2	16	80	0.2000000
NODE_11163_length_825_cov_43.389807	496	576	6	30	80	0.3750000
NODE_11163_length_825_cov_43.389807	549	629	6	80	80	1.0000000
NODE_11164_length_825_cov_39.603306	386	466	0	80	80	1.0000000
NODE_11164_length_825_cov_39.603306	439	519	0	80	80	1.0000000
NODE_11165_length_825_cov_32.205234	354	434	2	46	80	0.5750000
NODE_11165_length_825_cov_32.205234	354	434	4	34	80	0.4250000
NODE_11165_length_825_cov_32.205234	407	487	0	44	80	0.5500000
NODE_11165_length_825_cov_32.205234	407	487	2	17	80	0.2125000
NODE_11165_length_825_cov_32.205234	407	487	4	19	80	0.2375000
NODE_11166_length_825_cov_29.411846	503	583	0	36	80	0.4500000
NODE_11166_length_825_cov_29.411846	503	583	2	44	80	0.5500000
NODE_11166_length_825_cov_29.411846	556	636	0	14	80	0.1750000
NODE_11166_length_825_cov_29.411846	556	636	2	66	80	0.8250000
NODE_11167_length_825_cov_22.428375	312	392	6	9	80	0.1125000
NODE_11167_length_825_cov_22.428375	312	392	12	14	80	0.1750000
NODE_11167_length_825_cov_22.428375	312	392	13	48	80	0.6000000
NODE_11167_length_825_cov_22.428375	312	392	14	9	80	0.1125000
NODE_11167_length_825_cov_22.428375	365	445	5	8	80	0.1000000
NODE_11167_length_825_cov_22.428375	365	445	8	27	80	0.3375000
NODE_11167_length_825_cov_22.428375	365	445	12	1	80	0.0125000
NODE_11167_length_825_cov_22.428375	365	445	13	44	80	0.5500000
NODE_11167_length_825_cov_22.428375	441	521	5	33	80	0.4125000
NODE_11167_length_825_cov_22.428375	441	521	7	47	80	0.5875000
NODE_11167_length_825_cov_22.428375	494	574	5	25	80	0.3125000
NODE_11167_length_825_cov_22.428375	494	574	7	55	80	0.6875000
NODE_11168_length_825_cov_19.964187	249	329	0	80	80	1.0000000
NODE_11168_length_825_cov_19.964187	302	382	0	80	80	1.0000000
NODE_11169_length_825_cov_13.790634	273	353	1	45	80	0.5625000
NODE_11169_length_825_cov_13.790634	273	353	3	35	80	0.4375000
NODE_11169_length_825_cov_13.790634	326	406	0	12	80	0.1500000
NODE_11169_length_825_cov_13.790634	326	406	1	68	80	0.8500000
NODE_11170_length_825_cov_11.834711	331	411	0	5	80	0.0625000
NODE_11170_length_825_cov_11.834711	331	411	2	75	80	0.9375000
NODE_11170_length_825_cov_11.834711	384	464	0	10	80	0.1250000
NODE_11170_length_825_cov_11.834711	384	464	2	22	80	0.2750000
NODE_11170_length_825_cov_11.834711	384	464	4	48	80	0.6000000
NODE_11171_length_825_cov_11.477961	392	472	2	28	80	0.3500000
NODE_11171_length_825_cov_11.477961	392	472	4	11	80	0.1375000
NODE_11171_length_825_cov_11.477961	392	472	5	41	80	0.5125000
NODE_11172_length_825_cov_8.947658	259	339	0	80	80	1.0000000
NODE_11172_length_825_cov_8.947658	312	392	0	80	80	1.0000000
NODE_11173_length_825_cov_7.811295	379	459	0	80	80	1.0000000
NODE_11173_length_825_cov_7.811295	432	512	0	80	80	1.0000000
NODE_11174_length_825_cov_7.104683	464	544	0	80	80	1.0000000
NODE_11174_length_825_cov_7.104683	517	597	0	80	80	1.0000000
NODE_11176_length_825_cov_6.252066	542	622	0	27	80	0.3375000
NODE_11176_length_825_cov_6.252066	542	622	2	33	80	0.4125000
NODE_11176_length_825_cov_6.252066	542	622	3	20	80	0.2500000
NODE_11176_length_825_cov_6.252066	595	675	0	80	80	1.0000000
NODE_11178_length_825_cov_5.230028	264	344	0	80	80	1.0000000
NODE_11178_length_825_cov_5.230028	317	372	0	55	55	1.0000000
NODE_11178_length_825_cov_5.230028	383	463	0	80	80	1.0000000
NODE_11178_length_825_cov_5.230028	436	516	0	80	80	1.0000000
NODE_11205_length_825_cov_0.765840	0	50	0	50	50	1.0000000
NODE_11207_length_824_cov_27.074483	337	412	0	75	75	1.0000000
NODE_11207_length_824_cov_27.074483	390	470	0	76	80	0.9500000
NODE_11207_length_824_cov_27.074483	390	470	2	4	80	0.0500000
NODE_11208_length_824_cov_23.936552	365	445	0	18	80	0.2250000
NODE_11208_length_824_cov_23.936552	365	445	4	62	80	0.7750000
NODE_11208_length_824_cov_23.936552	418	493	0	37	75	0.4933333
NODE_11208_length_824_cov_23.936552	418	493	4	38	75	0.5066667
NODE_11209_length_824_cov_22.129655	377	457	0	80	80	1.0000000
NODE_11209_length_824_cov_22.129655	430	510	0	80	80	1.0000000
NODE_11210_length_824_cov_17.914483	387	467	0	67	80	0.8375000
NODE_11210_length_824_cov_17.914483	387	467	2	13	80	0.1625000
NODE_11210_length_824_cov_17.914483	440	520	0	14	80	0.1750000
NODE_11210_length_824_cov_17.914483	440	520	2	66	80	0.8250000
NODE_11211_length_824_cov_16.662069	362	442	0	80	80	1.0000000
NODE_11211_length_824_cov_16.662069	415	495	0	80	80	1.0000000
NODE_11212_length_824_cov_16.306207	352	432	0	6	80	0.0750000
NODE_11212_length_824_cov_16.306207	352	432	4	6	80	0.0750000
NODE_11212_length_824_cov_16.306207	352	432	8	19	80	0.2375000
NODE_11212_length_824_cov_16.306207	352	432	10	49	80	0.6125000
NODE_11212_length_824_cov_16.306207	405	485	0	27	80	0.3375000
NODE_11212_length_824_cov_16.306207	405	485	4	2	80	0.0250000
NODE_11212_length_824_cov_16.306207	405	485	6	11	80	0.1375000
NODE_11212_length_824_cov_16.306207	405	485	10	40	80	0.5000000
NODE_11213_length_824_cov_15.891034	342	422	0	30	80	0.3750000
NODE_11213_length_824_cov_15.891034	342	422	1	9	80	0.1125000
NODE_11213_length_824_cov_15.891034	342	422	2	41	80	0.5125000
NODE_11213_length_824_cov_15.891034	395	475	0	28	80	0.3500000
NODE_11213_length_824_cov_15.891034	395	475	2	52	80	0.6500000
NODE_11214_length_824_cov_12.485517	280	360	1	11	80	0.1375000
NODE_11214_length_824_cov_12.485517	280	360	3	15	80	0.1875000
NODE_11214_length_824_cov_12.485517	280	360	4	54	80	0.6750000
NODE_11214_length_824_cov_12.485517	333	413	2	6	80	0.0750000
NODE_11214_length_824_cov_12.485517	333	413	4	74	80	0.9250000
NODE_11216_length_824_cov_5.924138	269	349	0	44	80	0.5500000
NODE_11216_length_824_cov_5.924138	269	349	2	36	80	0.4500000
NODE_11216_length_824_cov_5.924138	322	402	0	61	80	0.7625000
NODE_11216_length_824_cov_5.924138	322	402	2	19	80	0.2375000
NODE_11222_length_824_cov_3.849655	191	271	0	15	80	0.1875000
NODE_11222_length_824_cov_3.849655	191	271	2	65	80	0.8125000
NODE_11251_length_823_cov_75.169890	207	287	0	66	80	0.8250000
NODE_11251_length_823_cov_75.169890	207	287	2	8	80	0.1000000
NODE_11251_length_823_cov_75.169890	207	287	4	6	80	0.0750000
NODE_11251_length_823_cov_75.169890	260	340	0	63	80	0.7875000
NODE_11251_length_823_cov_75.169890	260	340	4	17	80	0.2125000
NODE_11251_length_823_cov_75.169890	336	416	4	80	80	1.0000000
NODE_11251_length_823_cov_75.169890	389	469	0	20	80	0.2500000
NODE_11251_length_823_cov_75.169890	389	469	4	60	80	0.7500000
NODE_11253_length_823_cov_37.738950	332	412	0	80	80	1.0000000
NODE_11253_length_823_cov_37.738950	385	466	0	81	81	1.0000000
NODE_11254_length_823_cov_29.349448	400	480	4	80	80	1.0000000
NODE_11254_length_823_cov_29.349448	453	533	0	37	80	0.4625000
NODE_11254_length_823_cov_29.349448	453	533	4	43	80	0.5375000
NODE_11255_length_823_cov_25.730663	338	418	0	39	80	0.4875000
NODE_11255_length_823_cov_25.730663	338	418	2	41	80	0.5125000
NODE_11255_length_823_cov_25.730663	391	471	0	6	80	0.0750000
NODE_11255_length_823_cov_25.730663	391	471	2	49	80	0.6125000
NODE_11255_length_823_cov_25.730663	391	471	4	25	80	0.3125000
NODE_11256_length_823_cov_24.599448	349	429	0	80	80	1.0000000
NODE_11256_length_823_cov_24.599448	402	482	0	80	80	1.0000000
NODE_11257_length_823_cov_22.149171	356	436	0	26	80	0.3250000
NODE_11257_length_823_cov_22.149171	356	436	2	54	80	0.6750000
NODE_11257_length_823_cov_22.149171	409	489	0	7	80	0.0875000
NODE_11257_length_823_cov_22.149171	409	489	2	73	80	0.9125000
NODE_11257_length_823_cov_22.149171	485	565	0	80	80	1.0000000
NODE_11257_length_823_cov_22.149171	538	618	0	80	80	1.0000000
NODE_11258_length_823_cov_20.892265	329	409	0	35	80	0.4375000
NODE_11258_length_823_cov_20.892265	329	409	2	45	80	0.5625000
NODE_11258_length_823_cov_20.892265	382	462	0	18	80	0.2250000
NODE_11258_length_823_cov_20.892265	382	462	2	62	80	0.7750000
NODE_11259_length_823_cov_19.281768	305	385	0	16	80	0.2000000
NODE_11259_length_823_cov_19.281768	305	385	2	64	80	0.8000000
NODE_11259_length_823_cov_19.281768	358	438	0	38	80	0.4750000
NODE_11259_length_823_cov_19.281768	358	438	2	42	80	0.5250000
NODE_11260_length_823_cov_15.738950	409	489	0	80	80	1.0000000
NODE_11260_length_823_cov_15.738950	462	542	0	80	80	1.0000000
NODE_11261_length_823_cov_10.729282	362	437	0	75	75	1.0000000
NODE_11261_length_823_cov_10.729282	410	484	0	74	74	1.0000000
NODE_11262_length_823_cov_9.110497	394	474	0	80	80	1.0000000
NODE_11262_length_823_cov_9.110497	447	527	0	80	80	1.0000000
NODE_11265_length_823_cov_5.511050	168	248	6	10	80	0.1250000
NODE_11265_length_823_cov_5.511050	168	248	9	13	80	0.1625000
NODE_11265_length_823_cov_5.511050	168	248	10	8	80	0.1000000
NODE_11265_length_823_cov_5.511050	168	248	11	2	80	0.0250000
NODE_11265_length_823_cov_5.511050	168	248	12	47	80	0.5875000
NODE_11265_length_823_cov_5.511050	434	485	0	23	51	0.4509804
NODE_11265_length_823_cov_5.511050	434	485	2	18	51	0.3529412
NODE_11265_length_823_cov_5.511050	434	485	4	10	51	0.1960784
NODE_11292_length_823_cov_0.968232	86	154	0	20	68	0.2941177
NODE_11292_length_823_cov_0.968232	86	154	2	5	68	0.0735294
NODE_11292_length_823_cov_0.968232	86	154	4	43	68	0.6323529
NODE_11298_length_822_cov_25.423237	377	459	0	82	82	1.0000000
NODE_11298_length_822_cov_25.423237	432	512	0	80	80	1.0000000
NODE_11299_length_822_cov_16.381743	394	474	0	80	80	1.0000000
NODE_11299_length_822_cov_16.381743	447	527	0	80	80	1.0000000
NODE_11300_length_822_cov_12.426003	223	296	0	28	73	0.3835616
NODE_11300_length_822_cov_12.426003	223	296	2	17	73	0.2328767
NODE_11300_length_822_cov_12.426003	223	296	4	28	73	0.3835616
NODE_11300_length_822_cov_12.426003	278	349	0	5	71	0.0704225
NODE_11300_length_822_cov_12.426003	278	349	2	4	71	0.0563380
NODE_11300_length_822_cov_12.426003	278	349	4	62	71	0.8732395
NODE_11301_length_822_cov_10.608575	464	544	0	35	80	0.4375000
NODE_11301_length_822_cov_10.608575	464	544	1	9	80	0.1125000
NODE_11301_length_822_cov_10.608575	464	544	2	36	80	0.4500000
NODE_11301_length_822_cov_10.608575	517	597	0	2	80	0.0250000
NODE_11301_length_822_cov_10.608575	517	597	2	78	80	0.9750000
NODE_11302_length_822_cov_9.496542	363	443	2	6	80	0.0750000
NODE_11302_length_822_cov_9.496542	363	443	4	49	80	0.6125000
NODE_11302_length_822_cov_9.496542	363	443	6	25	80	0.3125000
NODE_11302_length_822_cov_9.496542	416	496	0	39	80	0.4875000
NODE_11302_length_822_cov_9.496542	416	496	3	1	80	0.0125000
NODE_11302_length_822_cov_9.496542	416	496	4	40	80	0.5000000
NODE_11333_length_821_cov_39.818560	341	420	2	38	79	0.4810127
NODE_11333_length_821_cov_39.818560	341	420	4	27	79	0.3417721
NODE_11333_length_821_cov_39.818560	341	420	6	14	79	0.1772152
NODE_11333_length_821_cov_39.818560	393	473	0	33	80	0.4125000
NODE_11333_length_821_cov_39.818560	393	473	2	47	80	0.5875000
NODE_11334_length_821_cov_27.721607	299	379	1	13	80	0.1625000
NODE_11334_length_821_cov_27.721607	299	379	2	67	80	0.8375000
NODE_11334_length_821_cov_27.721607	352	432	2	80	80	1.0000000
NODE_11335_length_821_cov_26.252078	386	466	2	22	80	0.2750000
NODE_11335_length_821_cov_26.252078	386	466	4	58	80	0.7250000
NODE_11335_length_821_cov_26.252078	439	519	0	37	80	0.4625000
NODE_11335_length_821_cov_26.252078	439	519	2	38	80	0.4750000
NODE_11335_length_821_cov_26.252078	439	519	4	5	80	0.0625000
NODE_11336_length_821_cov_19.603878	353	433	0	8	80	0.1000000
NODE_11336_length_821_cov_19.603878	353	433	5	1	80	0.0125000
NODE_11336_length_821_cov_19.603878	353	433	6	71	80	0.8875000
NODE_11336_length_821_cov_19.603878	406	486	0	52	80	0.6500000
NODE_11336_length_821_cov_19.603878	406	486	6	28	80	0.3500000
NODE_11337_length_821_cov_15.945983	310	390	0	9	80	0.1125000
NODE_11337_length_821_cov_15.945983	310	390	2	71	80	0.8875000
NODE_11337_length_821_cov_15.945983	363	443	0	62	80	0.7750000
NODE_11337_length_821_cov_15.945983	363	443	2	18	80	0.2250000
NODE_11339_length_821_cov_8.711911	288	368	0	80	80	1.0000000
NODE_11339_length_821_cov_8.711911	341	421	0	80	80	1.0000000
NODE_11349_length_821_cov_3.026316	310	390	0	80	80	1.0000000
NODE_11349_length_821_cov_3.026316	363	443	0	80	80	1.0000000
NODE_11361_length_820_cov_67.292649	328	408	0	4	80	0.0500000
NODE_11361_length_820_cov_67.292649	328	408	2	76	80	0.9500000
NODE_11361_length_820_cov_67.292649	381	461	0	57	80	0.7125000
NODE_11361_length_820_cov_67.292649	381	461	2	23	80	0.2875000
NODE_11362_length_820_cov_26.915395	308	388	0	28	80	0.3500000
NODE_11362_length_820_cov_26.915395	308	388	2	52	80	0.6500000
NODE_11363_length_820_cov_25.253814	301	381	0	4	80	0.0500000
NODE_11363_length_820_cov_25.253814	301	381	4	6	80	0.0750000
NODE_11363_length_820_cov_25.253814	301	381	6	70	80	0.8750000
NODE_11363_length_820_cov_25.253814	354	434	0	49	80	0.6125000
NODE_11363_length_820_cov_25.253814	354	434	4	1	80	0.0125000
NODE_11363_length_820_cov_25.253814	354	434	6	30	80	0.3750000
NODE_11363_length_820_cov_25.253814	430	510	0	15	80	0.1875000
NODE_11363_length_820_cov_25.253814	430	510	1	29	80	0.3625000
NODE_11363_length_820_cov_25.253814	430	510	2	36	80	0.4500000
NODE_11363_length_820_cov_25.253814	483	563	2	80	80	1.0000000
NODE_11364_length_820_cov_16.015257	325	405	0	72	80	0.9000000
NODE_11364_length_820_cov_16.015257	325	405	2	8	80	0.1000000
NODE_11364_length_820_cov_16.015257	378	458	0	80	80	1.0000000
NODE_11365_length_820_cov_14.703190	371	451	0	34	80	0.4250000
NODE_11365_length_820_cov_14.703190	371	451	2	1	80	0.0125000
NODE_11365_length_820_cov_14.703190	371	451	3	45	80	0.5625000
NODE_11365_length_820_cov_14.703190	424	504	3	64	80	0.8000000
NODE_11365_length_820_cov_14.703190	424	504	4	16	80	0.2000000
NODE_11366_length_820_cov_14.527046	249	329	0	26	80	0.3250000
NODE_11366_length_820_cov_14.527046	249	329	2	54	80	0.6750000
NODE_11366_length_820_cov_14.527046	302	382	0	79	80	0.9875000
NODE_11366_length_820_cov_14.527046	302	382	2	1	80	0.0125000
NODE_11367_length_820_cov_14.284327	286	366	0	80	80	1.0000000
NODE_11367_length_820_cov_14.284327	339	419	0	59	80	0.7375000
NODE_11367_length_820_cov_14.284327	339	419	2	21	80	0.2625000
NODE_11367_length_820_cov_14.284327	619	699	0	35	80	0.4375000
NODE_11367_length_820_cov_14.284327	619	699	2	10	80	0.1250000
NODE_11367_length_820_cov_14.284327	619	699	6	35	80	0.4375000
NODE_11368_length_820_cov_13.036061	364	444	62	6	80	0.0750000
NODE_11368_length_820_cov_13.036061	364	444	66	74	80	0.9250000
NODE_11368_length_820_cov_13.036061	417	497	0	6	80	0.0750000
NODE_11368_length_820_cov_13.036061	417	497	4	44	80	0.5500000
NODE_11368_length_820_cov_13.036061	417	497	66	30	80	0.3750000
NODE_11369_length_820_cov_12.830791	313	393	0	80	80	1.0000000
NODE_11369_length_820_cov_12.830791	366	446	0	80	80	1.0000000
NODE_11370_length_820_cov_12.768377	366	443	0	77	77	1.0000000
NODE_11370_length_820_cov_12.768377	496	525	2	29	29	1.0000000
NODE_11371_length_820_cov_12.223301	452	519	0	67	67	1.0000000
NODE_11371_length_820_cov_12.223301	492	572	0	59	80	0.7375000
NODE_11371_length_820_cov_12.223301	492	572	2	21	80	0.2625000
NODE_11396_length_819_cov_43.027778	403	483	0	80	80	1.0000000
NODE_11396_length_819_cov_43.027778	456	536	0	80	80	1.0000000
NODE_11396_length_819_cov_43.027778	532	612	0	80	80	1.0000000
NODE_11396_length_819_cov_43.027778	585	665	0	80	80	1.0000000
NODE_11397_length_819_cov_42.758333	391	471	1	4	80	0.0500000
NODE_11397_length_819_cov_42.758333	391	471	9	33	80	0.4125000
NODE_11397_length_819_cov_42.758333	391	471	11	43	80	0.5375000
NODE_11397_length_819_cov_42.758333	444	524	3	12	80	0.1500000
NODE_11397_length_819_cov_42.758333	444	524	11	68	80	0.8500000
NODE_11398_length_819_cov_41.341667	86	166	0	80	80	1.0000000
NODE_11398_length_819_cov_41.341667	139	219	0	80	80	1.0000000
NODE_11398_length_819_cov_41.341667	215	295	0	80	80	1.0000000
NODE_11398_length_819_cov_41.341667	268	348	0	80	80	1.0000000
NODE_11399_length_819_cov_23.656944	335	415	0	80	80	1.0000000
NODE_11399_length_819_cov_23.656944	388	468	0	80	80	1.0000000
NODE_11400_length_819_cov_20.633333	475	555	6	28	80	0.3500000
NODE_11400_length_819_cov_20.633333	475	555	8	24	80	0.3000000
NODE_11400_length_819_cov_20.633333	475	555	9	1	80	0.0125000
NODE_11400_length_819_cov_20.633333	475	555	10	27	80	0.3375000
NODE_11400_length_819_cov_20.633333	528	608	1	37	80	0.4625000
NODE_11400_length_819_cov_20.633333	528	608	5	15	80	0.1875000
NODE_11400_length_819_cov_20.633333	528	608	6	28	80	0.3500000
NODE_11401_length_819_cov_18.941667	307	387	0	16	80	0.2000000
NODE_11401_length_819_cov_18.941667	307	387	2	14	80	0.1750000
NODE_11401_length_819_cov_18.941667	307	387	4	50	80	0.6250000
NODE_11401_length_819_cov_18.941667	360	440	0	4	80	0.0500000
NODE_11401_length_819_cov_18.941667	360	440	2	24	80	0.3000000
NODE_11401_length_819_cov_18.941667	360	440	4	52	80	0.6500000
NODE_11401_length_819_cov_18.941667	436	516	0	17	80	0.2125000
NODE_11401_length_819_cov_18.941667	436	516	4	63	80	0.7875000
NODE_11401_length_819_cov_18.941667	489	569	4	80	80	1.0000000
NODE_11402_length_819_cov_12.225000	431	511	0	80	80	1.0000000
NODE_11402_length_819_cov_12.225000	484	564	0	80	80	1.0000000
NODE_11403_length_819_cov_11.562500	273	353	0	80	80	1.0000000
NODE_11403_length_819_cov_11.562500	326	406	0	80	80	1.0000000
NODE_11404_length_819_cov_8.905556	477	557	0	21	80	0.2625000
NODE_11404_length_819_cov_8.905556	477	557	2	59	80	0.7375000
NODE_11404_length_819_cov_8.905556	530	610	0	11	80	0.1375000
NODE_11404_length_819_cov_8.905556	530	610	2	69	80	0.8625000
NODE_11405_length_819_cov_5.675000	232	312	0	80	80	1.0000000
NODE_11405_length_819_cov_5.675000	285	365	0	80	80	1.0000000
NODE_11431_length_818_cov_21.979138	342	422	0	37	80	0.4625000
NODE_11431_length_818_cov_21.979138	342	422	2	43	80	0.5375000
NODE_11431_length_818_cov_21.979138	395	475	0	21	80	0.2625000
NODE_11431_length_818_cov_21.979138	395	475	2	59	80	0.7375000
NODE_11432_length_818_cov_15.326843	334	414	2	2	80	0.0250000
NODE_11432_length_818_cov_15.326843	334	414	4	78	80	0.9750000
NODE_11432_length_818_cov_15.326843	387	467	0	26	80	0.3250000
NODE_11432_length_818_cov_15.326843	387	467	2	25	80	0.3125000
NODE_11432_length_818_cov_15.326843	387	467	4	29	80	0.3625000
NODE_11433_length_818_cov_14.880389	392	472	0	76	80	0.9500000
NODE_11433_length_818_cov_14.880389	392	472	4	4	80	0.0500000
NODE_11433_length_818_cov_14.880389	445	525	0	80	80	1.0000000
NODE_11434_length_818_cov_12.369958	390	470	2	56	80	0.7000000
NODE_11434_length_818_cov_12.369958	390	470	4	24	80	0.3000000
NODE_11434_length_818_cov_12.369958	443	523	0	6	80	0.0750000
NODE_11434_length_818_cov_12.369958	443	523	2	58	80	0.7250000
NODE_11434_length_818_cov_12.369958	443	523	4	16	80	0.2000000
NODE_11436_length_818_cov_8.421419	370	450	0	80	80	1.0000000
NODE_11436_length_818_cov_8.421419	423	503	0	80	80	1.0000000
NODE_11437_length_818_cov_6.439499	706	741	0	35	35	1.0000000
NODE_11439_length_818_cov_4.098748	320	390	1	8	70	0.1142857
NODE_11439_length_818_cov_4.098748	320	390	2	62	70	0.8857143
NODE_11439_length_818_cov_4.098748	416	472	0	30	56	0.5357143
NODE_11439_length_818_cov_4.098748	416	472	2	26	56	0.4642857
NODE_11457_length_817_cov_7.238162	494	574	0	80	80	1.0000000
NODE_11457_length_817_cov_7.238162	547	627	0	80	80	1.0000000
NODE_11458_length_817_cov_5.789694	400	480	0	80	80	1.0000000
NODE_11458_length_817_cov_5.789694	476	555	0	79	79	1.0000000
NODE_11458_length_817_cov_5.789694	528	608	0	80	80	1.0000000
NODE_11462_length_817_cov_4.357939	433	513	2	80	80	1.0000000
NODE_11462_length_817_cov_4.357939	486	566	0	41	80	0.5125000
NODE_11462_length_817_cov_4.357939	486	566	2	39	80	0.4875000
NODE_11486_length_817_cov_0.692201	626	696	3	6	70	0.0857143
NODE_11486_length_817_cov_0.692201	626	696	4	2	70	0.0285714
NODE_11486_length_817_cov_0.692201	626	696	6	3	70	0.0428571
NODE_11486_length_817_cov_0.692201	626	696	8	4	70	0.0571429
NODE_11486_length_817_cov_0.692201	626	696	10	9	70	0.1285714
NODE_11486_length_817_cov_0.692201	626	696	12	21	70	0.3000000
NODE_11486_length_817_cov_0.692201	626	696	14	20	70	0.2857143
NODE_11486_length_817_cov_0.692201	626	696	15	5	70	0.0714286
NODE_11488_length_816_cov_69.800558	395	475	0	30	80	0.3750000
NODE_11488_length_816_cov_69.800558	395	475	2	50	80	0.6250000
NODE_11488_length_816_cov_69.800558	448	520	0	72	72	1.0000000
NODE_11489_length_816_cov_19.044630	77	154	0	15	77	0.1948052
NODE_11489_length_816_cov_19.044630	77	154	2	62	77	0.8051948
NODE_11489_length_816_cov_19.044630	130	212	0	41	82	0.5000000
NODE_11489_length_816_cov_19.044630	130	212	2	41	82	0.5000000
NODE_11490_length_816_cov_16.418410	381	461	0	80	80	1.0000000
NODE_11490_length_816_cov_16.418410	434	514	0	80	80	1.0000000
NODE_11491_length_816_cov_15.945607	319	399	2	80	80	1.0000000
NODE_11491_length_816_cov_15.945607	372	452	0	30	80	0.3750000
NODE_11491_length_816_cov_15.945607	372	452	1	4	80	0.0500000
NODE_11491_length_816_cov_15.945607	372	452	2	46	80	0.5750000
NODE_11492_length_816_cov_12.797768	358	438	0	80	80	1.0000000
NODE_11492_length_816_cov_12.797768	411	491	0	80	80	1.0000000
NODE_11493_length_816_cov_12.086471	242	322	0	16	80	0.2000000
NODE_11493_length_816_cov_12.086471	242	322	2	64	80	0.8000000
NODE_11493_length_816_cov_12.086471	295	375	2	80	80	1.0000000
NODE_11495_length_816_cov_3.873082	412	492	2	10	80	0.1250000
NODE_11495_length_816_cov_3.873082	412	492	4	28	80	0.3500000
NODE_11495_length_816_cov_3.873082	412	492	6	10	80	0.1250000
NODE_11495_length_816_cov_3.873082	412	492	10	32	80	0.4000000
NODE_11495_length_816_cov_3.873082	465	545	2	13	80	0.1625000
NODE_11495_length_816_cov_3.873082	465	545	3	40	80	0.5000000
NODE_11495_length_816_cov_3.873082	465	545	4	27	80	0.3375000
NODE_11516_length_815_cov_48.090782	334	414	0	28	80	0.3500000
NODE_11516_length_815_cov_48.090782	334	414	2	52	80	0.6500000
NODE_11516_length_815_cov_48.090782	387	467	0	36	80	0.4500000
NODE_11516_length_815_cov_48.090782	387	467	2	44	80	0.5500000
NODE_11517_length_815_cov_27.748603	290	370	0	10	80	0.1250000
NODE_11517_length_815_cov_27.748603	290	370	4	70	80	0.8750000
NODE_11517_length_815_cov_27.748603	343	423	2	29	80	0.3625000
NODE_11517_length_815_cov_27.748603	343	423	4	51	80	0.6375000
NODE_11518_length_815_cov_23.748603	429	509	0	41	80	0.5125000
NODE_11518_length_815_cov_23.748603	429	509	2	39	80	0.4875000
NODE_11518_length_815_cov_23.748603	482	562	0	24	80	0.3000000
NODE_11518_length_815_cov_23.748603	482	562	2	56	80	0.7000000
NODE_11519_length_815_cov_14.870112	318	398	0	80	80	1.0000000
NODE_11519_length_815_cov_14.870112	371	451	0	42	80	0.5250000
NODE_11519_length_815_cov_14.870112	371	451	2	38	80	0.4750000
NODE_11520_length_815_cov_13.317039	338	418	2	24	80	0.3000000
NODE_11520_length_815_cov_13.317039	338	418	4	56	80	0.7000000
NODE_11520_length_815_cov_13.317039	391	471	0	27	80	0.3375000
NODE_11520_length_815_cov_13.317039	391	471	2	50	80	0.6250000
NODE_11520_length_815_cov_13.317039	391	471	4	3	80	0.0375000
NODE_11521_length_815_cov_12.270950	315	395	0	48	80	0.6000000
NODE_11521_length_815_cov_12.270950	315	395	4	32	80	0.4000000
NODE_11521_length_815_cov_12.270950	368	448	4	80	80	1.0000000
NODE_11522_length_815_cov_9.304469	150	230	0	50	80	0.6250000
NODE_11522_length_815_cov_9.304469	150	230	2	30	80	0.3750000
NODE_11522_length_815_cov_9.304469	203	283	0	25	80	0.3125000
NODE_11522_length_815_cov_9.304469	203	283	2	55	80	0.6875000
NODE_11524_length_815_cov_8.117318	437	517	0	9	80	0.1125000
NODE_11524_length_815_cov_8.117318	437	517	2	71	80	0.8875000
NODE_11524_length_815_cov_8.117318	490	570	0	62	80	0.7750000
NODE_11524_length_815_cov_8.117318	490	570	2	18	80	0.2250000
NODE_11530_length_815_cov_3.963687	275	355	0	80	80	1.0000000
NODE_11530_length_815_cov_3.963687	328	408	0	80	80	1.0000000
NODE_11532_length_815_cov_2.976257	441	508	2	22	67	0.3283582
NODE_11532_length_815_cov_2.976257	441	508	4	4	67	0.0597015
NODE_11532_length_815_cov_2.976257	441	508	6	1	67	0.0149254
NODE_11532_length_815_cov_2.976257	441	508	7	10	67	0.1492537
NODE_11532_length_815_cov_2.976257	441	508	8	30	67	0.4477612
NODE_11554_length_814_cov_55.545455	304	384	0	9	80	0.1125000
NODE_11554_length_814_cov_55.545455	304	384	4	71	80	0.8875000
NODE_11554_length_814_cov_55.545455	357	437	0	44	80	0.5500000
NODE_11554_length_814_cov_55.545455	357	437	3	1	80	0.0125000
NODE_11554_length_814_cov_55.545455	357	437	4	35	80	0.4375000
NODE_11554_length_814_cov_55.545455	517	559	4	42	42	1.0000000
NODE_11554_length_814_cov_55.545455	724	804	2	2	80	0.0250000
NODE_11554_length_814_cov_55.545455	724	804	3	2	80	0.0250000
NODE_11554_length_814_cov_55.545455	724	804	5	1	80	0.0125000
NODE_11554_length_814_cov_55.545455	724	804	7	1	80	0.0125000
NODE_11554_length_814_cov_55.545455	724	804	9	2	80	0.0250000
NODE_11554_length_814_cov_55.545455	724	804	10	2	80	0.0250000
NODE_11554_length_814_cov_55.545455	724	804	12	2	80	0.0250000
NODE_11554_length_814_cov_55.545455	724	804	14	9	80	0.1125000
NODE_11554_length_814_cov_55.545455	724	804	16	4	80	0.0500000
NODE_11554_length_814_cov_55.545455	724	804	18	21	80	0.2625000
NODE_11554_length_814_cov_55.545455	724	804	20	4	80	0.0500000
NODE_11554_length_814_cov_55.545455	724	804	24	13	80	0.1625000
NODE_11554_length_814_cov_55.545455	724	804	26	17	80	0.2125000
NODE_11555_length_814_cov_32.216783	317	397	0	80	80	1.0000000
NODE_11555_length_814_cov_32.216783	370	450	0	80	80	1.0000000
NODE_11556_length_814_cov_19.507692	174	254	2	80	80	1.0000000
NODE_11556_length_814_cov_19.507692	227	307	0	36	80	0.4500000
NODE_11556_length_814_cov_19.507692	227	307	2	44	80	0.5500000
NODE_11556_length_814_cov_19.507692	303	383	0	80	80	1.0000000
NODE_11556_length_814_cov_19.507692	356	436	0	80	80	1.0000000
NODE_11557_length_814_cov_18.579021	433	513	0	80	80	1.0000000
NODE_11557_length_814_cov_18.579021	486	566	0	47	80	0.5875000
NODE_11557_length_814_cov_18.579021	486	566	2	33	80	0.4125000
NODE_11558_length_814_cov_17.183217	339	419	0	80	80	1.0000000
NODE_11558_length_814_cov_17.183217	392	472	0	80	80	1.0000000
NODE_11559_length_814_cov_15.306294	238	318	0	80	80	1.0000000
NODE_11559_length_814_cov_15.306294	291	371	0	80	80	1.0000000
NODE_11560_length_814_cov_11.511888	397	477	0	80	80	1.0000000
NODE_11560_length_814_cov_11.511888	459	530	0	71	71	1.0000000
NODE_11561_length_814_cov_10.395804	305	385	4	61	80	0.7625000
NODE_11561_length_814_cov_10.395804	305	385	5	1	80	0.0125000
NODE_11561_length_814_cov_10.395804	305	385	7	12	80	0.1500000
NODE_11561_length_814_cov_10.395804	305	385	8	6	80	0.0750000
NODE_11561_length_814_cov_10.395804	358	438	4	57	80	0.7125000
NODE_11561_length_814_cov_10.395804	358	438	7	17	80	0.2125000
NODE_11561_length_814_cov_10.395804	358	438	8	6	80	0.0750000
NODE_11562_length_814_cov_9.692308	347	427	2	30	80	0.3750000
NODE_11562_length_814_cov_9.692308	347	427	8	5	80	0.0625000
NODE_11562_length_814_cov_9.692308	347	427	14	11	80	0.1375000
NODE_11562_length_814_cov_9.692308	347	427	16	12	80	0.1500000
NODE_11562_length_814_cov_9.692308	347	427	20	22	80	0.2750000
NODE_11562_length_814_cov_9.692308	400	480	14	5	80	0.0625000
NODE_11562_length_814_cov_9.692308	400	480	18	3	80	0.0375000
NODE_11562_length_814_cov_9.692308	400	480	20	72	80	0.9000000
NODE_11564_length_814_cov_9.274126	245	325	0	80	80	1.0000000
NODE_11564_length_814_cov_9.274126	298	378	0	80	80	1.0000000
NODE_11565_length_814_cov_8.973427	271	351	0	80	80	1.0000000
NODE_11565_length_814_cov_8.973427	324	404	0	80	80	1.0000000
NODE_11573_length_814_cov_2.145455	273	327	2	54	54	1.0000000
NODE_11573_length_814_cov_2.145455	307	371	0	27	64	0.4218750
NODE_11573_length_814_cov_2.145455	307	371	2	37	64	0.5781250
NODE_11587_length_813_cov_39.228291	225	305	0	23	80	0.2875000
NODE_11587_length_813_cov_39.228291	225	305	3	1	80	0.0125000
NODE_11587_length_813_cov_39.228291	225	305	4	49	80	0.6125000
NODE_11587_length_813_cov_39.228291	225	305	6	7	80	0.0875000
NODE_11587_length_813_cov_39.228291	278	358	2	38	80	0.4750000
NODE_11587_length_813_cov_39.228291	278	358	4	20	80	0.2500000
NODE_11587_length_813_cov_39.228291	278	358	6	22	80	0.2750000
NODE_11588_length_813_cov_36.570028	406	486	0	21	80	0.2625000
NODE_11588_length_813_cov_36.570028	406	486	2	59	80	0.7375000
NODE_11588_length_813_cov_36.570028	459	539	0	73	80	0.9125000
NODE_11588_length_813_cov_36.570028	459	539	2	7	80	0.0875000
NODE_11589_length_813_cov_26.718487	209	289	0	67	80	0.8375000
NODE_11589_length_813_cov_26.718487	209	289	2	13	80	0.1625000
NODE_11589_length_813_cov_26.718487	262	342	0	14	80	0.1750000
NODE_11589_length_813_cov_26.718487	262	342	2	66	80	0.8250000
NODE_11590_length_813_cov_17.537815	335	415	0	80	80	1.0000000
NODE_11590_length_813_cov_17.537815	388	468	0	80	80	1.0000000
NODE_11591_length_813_cov_14.243697	279	359	0	80	80	1.0000000
NODE_11591_length_813_cov_14.243697	332	412	0	80	80	1.0000000
NODE_11592_length_813_cov_13.984594	307	387	0	80	80	1.0000000
NODE_11592_length_813_cov_13.984594	360	440	0	80	80	1.0000000
NODE_11593_length_813_cov_13.242297	336	416	0	61	80	0.7625000
NODE_11593_length_813_cov_13.242297	336	416	2	19	80	0.2375000
NODE_11593_length_813_cov_13.242297	389	469	0	8	80	0.1000000
NODE_11593_length_813_cov_13.242297	389	469	2	57	80	0.7125000
NODE_11593_length_813_cov_13.242297	389	469	4	15	80	0.1875000
NODE_11594_length_813_cov_11.985994	374	454	2	80	80	1.0000000
NODE_11594_length_813_cov_11.985994	427	507	0	53	80	0.6625000
NODE_11594_length_813_cov_11.985994	427	507	2	27	80	0.3375000
NODE_11595_length_813_cov_11.668067	279	359	0	80	80	1.0000000
NODE_11595_length_813_cov_11.668067	332	412	0	80	80	1.0000000
NODE_11596_length_813_cov_8.149860	538	618	0	80	80	1.0000000
NODE_11596_length_813_cov_8.149860	591	671	0	80	80	1.0000000
NODE_11597_length_813_cov_7.098039	234	314	0	23	80	0.2875000
NODE_11597_length_813_cov_7.098039	234	314	2	35	80	0.4375000
NODE_11597_length_813_cov_7.098039	234	314	4	22	80	0.2750000
NODE_11597_length_813_cov_7.098039	287	367	2	24	80	0.3000000
NODE_11597_length_813_cov_7.098039	287	367	4	56	80	0.7000000
NODE_11613_length_812_cov_45.183731	435	515	0	22	80	0.2750000
NODE_11613_length_812_cov_45.183731	435	515	4	58	80	0.7250000
NODE_11613_length_812_cov_45.183731	488	568	0	41	80	0.5125000
NODE_11613_length_812_cov_45.183731	488	568	4	39	80	0.4875000
NODE_11614_length_812_cov_23.862553	386	466	0	80	80	1.0000000
NODE_11614_length_812_cov_23.862553	439	519	0	80	80	1.0000000
NODE_11615_length_812_cov_23.516129	295	375	0	80	80	1.0000000
NODE_11615_length_812_cov_23.516129	348	428	0	80	80	1.0000000
NODE_11616_length_812_cov_15.577840	509	589	0	80	80	1.0000000
NODE_11616_length_812_cov_15.577840	562	644	0	82	82	1.0000000
NODE_11617_length_812_cov_13.277700	257	331	0	65	74	0.8783784
NODE_11617_length_812_cov_13.277700	257	331	2	9	74	0.1216216
NODE_11617_length_812_cov_13.277700	304	384	0	25	80	0.3125000
NODE_11617_length_812_cov_13.277700	304	384	2	55	80	0.6875000
NODE_11619_length_812_cov_6.697055	309	389	0	80	80	1.0000000
NODE_11619_length_812_cov_6.697055	362	442	0	43	80	0.5375000
NODE_11619_length_812_cov_6.697055	362	442	2	37	80	0.4625000
NODE_11642_length_811_cov_65.762640	418	492	70	13	74	0.1756757
NODE_11642_length_811_cov_65.762640	418	492	71	1	74	0.0135135
NODE_11642_length_811_cov_65.762640	418	492	73	5	74	0.0675676
NODE_11642_length_811_cov_65.762640	418	492	74	1	74	0.0135135
NODE_11642_length_811_cov_65.762640	418	492	75	2	74	0.0270270
NODE_11642_length_811_cov_65.762640	418	492	76	3	74	0.0405405
NODE_11642_length_811_cov_65.762640	418	492	77	19	74	0.2567568
NODE_11642_length_811_cov_65.762640	418	492	78	2	74	0.0270270
NODE_11642_length_811_cov_65.762640	418	492	79	6	74	0.0810811
NODE_11642_length_811_cov_65.762640	418	492	80	11	74	0.1486486
NODE_11642_length_811_cov_65.762640	418	492	81	11	74	0.1486486
NODE_11642_length_811_cov_65.762640	471	545	22	8	74	0.1081081
NODE_11642_length_811_cov_65.762640	471	545	23	1	74	0.0135135
NODE_11642_length_811_cov_65.762640	471	545	28	15	74	0.2027027
NODE_11642_length_811_cov_65.762640	471	545	42	7	74	0.0945946
NODE_11642_length_811_cov_65.762640	471	545	44	2	74	0.0270270
NODE_11642_length_811_cov_65.762640	471	545	51	8	74	0.1081081
NODE_11642_length_811_cov_65.762640	471	545	57	6	74	0.0810811
NODE_11642_length_811_cov_65.762640	471	545	59	2	74	0.0270270
NODE_11642_length_811_cov_65.762640	471	545	69	4	74	0.0540541
NODE_11642_length_811_cov_65.762640	471	545	71	1	74	0.0135135
NODE_11642_length_811_cov_65.762640	471	545	74	1	74	0.0135135
NODE_11642_length_811_cov_65.762640	471	545	75	2	74	0.0270270
NODE_11642_length_811_cov_65.762640	471	545	77	17	74	0.2297297
NODE_11643_length_811_cov_62.933989	457	537	0	31	80	0.3875000
NODE_11643_length_811_cov_62.933989	457	537	6	49	80	0.6125000
NODE_11643_length_811_cov_62.933989	510	590	0	17	80	0.2125000
NODE_11643_length_811_cov_62.933989	510	590	6	63	80	0.7875000
NODE_11644_length_811_cov_26.401685	397	477	0	37	80	0.4625000
NODE_11644_length_811_cov_26.401685	397	477	4	43	80	0.5375000
NODE_11644_length_811_cov_26.401685	450	530	2	9	80	0.1125000
NODE_11644_length_811_cov_26.401685	450	530	4	45	80	0.5625000
NODE_11644_length_811_cov_26.401685	450	530	6	26	80	0.3250000
NODE_11645_length_811_cov_23.009831	189	269	0	80	80	1.0000000
NODE_11645_length_811_cov_23.009831	242	322	0	66	80	0.8250000
NODE_11645_length_811_cov_23.009831	242	322	2	14	80	0.1750000
NODE_11646_length_811_cov_20.523876	375	455	0	42	80	0.5250000
NODE_11646_length_811_cov_20.523876	375	455	2	38	80	0.4750000
NODE_11646_length_811_cov_20.523876	428	508	0	80	80	1.0000000
NODE_11647_length_811_cov_17.386236	421	501	0	80	80	1.0000000
NODE_11647_length_811_cov_17.386236	474	554	0	80	80	1.0000000
NODE_11648_length_811_cov_15.279494	368	448	0	80	80	1.0000000
NODE_11648_length_811_cov_15.279494	421	502	0	81	81	1.0000000
NODE_11649_length_811_cov_14.543539	222	302	2	80	80	1.0000000
NODE_11649_length_811_cov_14.543539	275	355	2	55	80	0.6875000
NODE_11649_length_811_cov_14.543539	275	355	4	25	80	0.3125000
NODE_11650_length_811_cov_12.196629	402	482	0	80	80	1.0000000
NODE_11650_length_811_cov_12.196629	455	535	0	80	80	1.0000000
NODE_11651_length_811_cov_12.117978	289	369	0	34	80	0.4250000
NODE_11651_length_811_cov_12.117978	289	369	2	46	80	0.5750000
NODE_11651_length_811_cov_12.117978	342	422	0	25	80	0.3125000
NODE_11651_length_811_cov_12.117978	342	422	2	55	80	0.6875000
NODE_11652_length_811_cov_11.886236	330	410	0	23	80	0.2875000
NODE_11652_length_811_cov_11.886236	330	410	2	57	80	0.7125000
NODE_11652_length_811_cov_11.886236	383	463	0	16	80	0.2000000
NODE_11652_length_811_cov_11.886236	383	463	2	64	80	0.8000000
NODE_11653_length_811_cov_10.602528	342	422	0	80	80	1.0000000
NODE_11653_length_811_cov_10.602528	395	461	0	66	66	1.0000000
NODE_11653_length_811_cov_10.602528	452	519	0	67	67	1.0000000
NODE_11653_length_811_cov_10.602528	492	572	0	80	80	1.0000000
NODE_11654_length_811_cov_7.539326	324	404	0	80	80	1.0000000
NODE_11654_length_811_cov_7.539326	377	457	0	80	80	1.0000000
NODE_11655_length_811_cov_6.398876	419	499	0	80	80	1.0000000
NODE_11655_length_811_cov_6.398876	472	552	0	80	80	1.0000000
NODE_11657_length_811_cov_5.939607	496	527	0	31	31	1.0000000
NODE_11657_length_811_cov_5.939607	528	603	0	16	75	0.2133333
NODE_11657_length_811_cov_5.939607	528	603	8	59	75	0.7866667
NODE_11669_length_811_cov_1.501404	645	676	4	3	31	0.0967742
NODE_11669_length_811_cov_1.501404	645	676	6	28	31	0.9032258
NODE_11684_length_810_cov_42.358650	484	564	1	80	80	1.0000000
NODE_11684_length_810_cov_42.358650	537	617	0	38	80	0.4750000
NODE_11684_length_810_cov_42.358650	537	617	1	42	80	0.5250000
NODE_11685_length_810_cov_38.604782	370	450	0	15	80	0.1875000
NODE_11685_length_810_cov_38.604782	370	450	2	65	80	0.8125000
NODE_11685_length_810_cov_38.604782	423	499	0	36	76	0.4736842
NODE_11685_length_810_cov_38.604782	423	499	2	40	76	0.5263158
NODE_11686_length_810_cov_20.354430	338	418	0	59	80	0.7375000
NODE_11686_length_810_cov_20.354430	338	418	2	21	80	0.2625000
NODE_11686_length_810_cov_20.354430	391	471	0	6	80	0.0750000
NODE_11686_length_810_cov_20.354430	391	471	2	74	80	0.9250000
NODE_11688_length_810_cov_12.367089	144	224	0	24	80	0.3000000
NODE_11688_length_810_cov_12.367089	144	224	6	56	80	0.7000000
NODE_11688_length_810_cov_12.367089	197	277	6	80	80	1.0000000
NODE_11689_length_810_cov_8.886076	333	399	0	66	66	1.0000000
NODE_11690_length_810_cov_8.291139	446	526	0	7	80	0.0875000
NODE_11690_length_810_cov_8.291139	446	526	2	23	80	0.2875000
NODE_11690_length_810_cov_8.291139	446	526	4	50	80	0.6250000
NODE_11690_length_810_cov_8.291139	499	579	0	30	80	0.3750000
NODE_11690_length_810_cov_8.291139	499	579	4	50	80	0.6250000
NODE_11692_length_810_cov_7.213783	335	406	0	71	71	1.0000000
NODE_11692_length_810_cov_7.213783	335	416	0	81	81	1.0000000
NODE_11692_length_810_cov_7.213783	379	459	0	80	80	1.0000000
NODE_11714_length_809_cov_40.536620	428	500	0	72	72	1.0000000
NODE_11714_length_809_cov_40.536620	473	553	0	80	80	1.0000000
NODE_11715_length_809_cov_15.871831	385	465	0	80	80	1.0000000
NODE_11715_length_809_cov_15.871831	402	465	0	63	63	1.0000000
NODE_11715_length_809_cov_15.871831	438	518	0	80	80	1.0000000
NODE_11715_length_809_cov_15.871831	438	518	0	80	80	1.0000000
NODE_11716_length_809_cov_15.019718	286	366	0	80	80	1.0000000
NODE_11716_length_809_cov_15.019718	339	419	0	80	80	1.0000000
NODE_11718_length_809_cov_4.483099	244	324	0	80	80	1.0000000
NODE_11718_length_809_cov_4.483099	278	324	0	46	46	1.0000000
NODE_11718_length_809_cov_4.483099	298	377	0	79	79	1.0000000
NODE_11718_length_809_cov_4.483099	308	377	0	69	69	1.0000000
NODE_11738_length_808_cov_45.023977	325	405	0	42	80	0.5250000
NODE_11738_length_808_cov_45.023977	325	405	2	8	80	0.1000000
NODE_11738_length_808_cov_45.023977	325	405	6	30	80	0.3750000
NODE_11738_length_808_cov_45.023977	378	458	6	80	80	1.0000000
NODE_11739_length_808_cov_24.087447	287	367	0	80	80	1.0000000
NODE_11739_length_808_cov_24.087447	340	420	0	41	80	0.5125000
NODE_11739_length_808_cov_24.087447	340	420	2	39	80	0.4875000
NODE_11740_length_808_cov_21.867419	324	404	0	72	80	0.9000000
NODE_11740_length_808_cov_21.867419	324	404	2	8	80	0.1000000
NODE_11740_length_808_cov_21.867419	377	457	0	19	80	0.2375000
NODE_11740_length_808_cov_21.867419	377	457	2	33	80	0.4125000
NODE_11740_length_808_cov_21.867419	377	457	4	28	80	0.3500000
NODE_11741_length_808_cov_16.289140	333	413	0	80	80	1.0000000
NODE_11741_length_808_cov_16.289140	386	466	0	80	80	1.0000000
NODE_11742_length_808_cov_14.489422	307	387	0	5	80	0.0625000
NODE_11742_length_808_cov_14.489422	307	387	2	60	80	0.7500000
NODE_11742_length_808_cov_14.489422	307	387	4	15	80	0.1875000
NODE_11742_length_808_cov_14.489422	360	440	0	6	80	0.0750000
NODE_11742_length_808_cov_14.489422	360	440	2	57	80	0.7125000
NODE_11742_length_808_cov_14.489422	360	440	4	17	80	0.2125000
NODE_11744_length_808_cov_10.507757	317	397	0	80	80	1.0000000
NODE_11744_length_808_cov_10.507757	370	450	0	80	80	1.0000000
NODE_11745_length_808_cov_10.066291	483	563	0	80	80	1.0000000
NODE_11745_length_808_cov_10.066291	536	616	0	80	80	1.0000000
NODE_11746_length_808_cov_7.581100	358	438	0	13	80	0.1625000
NODE_11746_length_808_cov_7.581100	358	438	2	67	80	0.8375000
NODE_11746_length_808_cov_7.581100	411	491	0	55	80	0.6875000
NODE_11746_length_808_cov_7.581100	411	491	2	25	80	0.3125000
NODE_11756_length_808_cov_3.283498	471	551	0	80	80	1.0000000
NODE_11756_length_808_cov_3.283498	524	604	0	80	80	1.0000000
NODE_11783_length_807_cov_67.341808	2	25	15	1	23	0.0434783
NODE_11783_length_807_cov_67.341808	2	25	21	1	23	0.0434783
NODE_11783_length_807_cov_67.341808	2	25	23	2	23	0.0869565
NODE_11783_length_807_cov_67.341808	2	25	24	1	23	0.0434783
NODE_11783_length_807_cov_67.341808	2	25	29	1	23	0.0434783
NODE_11783_length_807_cov_67.341808	2	25	31	1	23	0.0434783
NODE_11783_length_807_cov_67.341808	2	25	39	1	23	0.0434783
NODE_11783_length_807_cov_67.341808	2	25	47	1	23	0.0434783
NODE_11783_length_807_cov_67.341808	2	25	58	1	23	0.0434783
NODE_11783_length_807_cov_67.341808	2	25	60	1	23	0.0434783
NODE_11783_length_807_cov_67.341808	2	25	62	1	23	0.0434783
NODE_11783_length_807_cov_67.341808	2	25	66	1	23	0.0434783
NODE_11783_length_807_cov_67.341808	2	25	70	1	23	0.0434783
NODE_11783_length_807_cov_67.341808	2	25	71	1	23	0.0434783
NODE_11783_length_807_cov_67.341808	2	25	76	1	23	0.0434783
NODE_11783_length_807_cov_67.341808	2	25	79	2	23	0.0869565
NODE_11783_length_807_cov_67.341808	2	25	87	1	23	0.0434783
NODE_11783_length_807_cov_67.341808	2	25	91	1	23	0.0434783
NODE_11783_length_807_cov_67.341808	2	25	95	1	23	0.0434783
NODE_11783_length_807_cov_67.341808	2	25	107	1	23	0.0434783
NODE_11783_length_807_cov_67.341808	2	25	112	1	23	0.0434783
NODE_11783_length_807_cov_67.341808	339	370	254	1	31	0.0322581
NODE_11783_length_807_cov_67.341808	339	370	256	1	31	0.0322581
NODE_11783_length_807_cov_67.341808	339	370	261	1	31	0.0322581
NODE_11783_length_807_cov_67.341808	339	370	273	1	31	0.0322581
NODE_11783_length_807_cov_67.341808	339	370	275	1	31	0.0322581
NODE_11783_length_807_cov_67.341808	339	370	277	1	31	0.0322581
NODE_11783_length_807_cov_67.341808	339	370	280	1	31	0.0322581
NODE_11783_length_807_cov_67.341808	339	370	287	1	31	0.0322581
NODE_11783_length_807_cov_67.341808	339	370	290	1	31	0.0322581
NODE_11783_length_807_cov_67.341808	339	370	294	3	31	0.0967742
NODE_11783_length_807_cov_67.341808	339	370	299	1	31	0.0322581
NODE_11783_length_807_cov_67.341808	339	370	306	1	31	0.0322581
NODE_11783_length_807_cov_67.341808	339	370	307	1	31	0.0322581
NODE_11783_length_807_cov_67.341808	339	370	311	1	31	0.0322581
NODE_11783_length_807_cov_67.341808	339	370	318	1	31	0.0322581
NODE_11783_length_807_cov_67.341808	339	370	323	1	31	0.0322581
NODE_11783_length_807_cov_67.341808	339	370	325	1	31	0.0322581
NODE_11783_length_807_cov_67.341808	339	370	328	1	31	0.0322581
NODE_11783_length_807_cov_67.341808	339	370	337	1	31	0.0322581
NODE_11783_length_807_cov_67.341808	339	370	339	1	31	0.0322581
NODE_11783_length_807_cov_67.341808	339	370	345	2	31	0.0645161
NODE_11783_length_807_cov_67.341808	339	370	349	1	31	0.0322581
NODE_11783_length_807_cov_67.341808	339	370	350	1	31	0.0322581
NODE_11783_length_807_cov_67.341808	339	370	351	1	31	0.0322581
NODE_11783_length_807_cov_67.341808	339	370	354	1	31	0.0322581
NODE_11783_length_807_cov_67.341808	339	370	355	3	31	0.0967742
NODE_11783_length_807_cov_67.341808	343	423	275	1	80	0.0125000
NODE_11783_length_807_cov_67.341808	343	423	277	1	80	0.0125000
NODE_11783_length_807_cov_67.341808	343	423	280	1	80	0.0125000
NODE_11783_length_807_cov_67.341808	343	423	287	1	80	0.0125000
NODE_11783_length_807_cov_67.341808	343	423	290	1	80	0.0125000
NODE_11783_length_807_cov_67.341808	343	423	294	3	80	0.0375000
NODE_11783_length_807_cov_67.341808	343	423	299	1	80	0.0125000
NODE_11783_length_807_cov_67.341808	343	423	306	1	80	0.0125000
NODE_11783_length_807_cov_67.341808	343	423	307	1	80	0.0125000
NODE_11783_length_807_cov_67.341808	343	423	311	1	80	0.0125000
NODE_11783_length_807_cov_67.341808	343	423	318	1	80	0.0125000
NODE_11783_length_807_cov_67.341808	343	423	323	1	80	0.0125000
NODE_11783_length_807_cov_67.341808	343	423	325	1	80	0.0125000
NODE_11783_length_807_cov_67.341808	343	423	328	1	80	0.0125000
NODE_11783_length_807_cov_67.341808	343	423	337	1	80	0.0125000
NODE_11783_length_807_cov_67.341808	343	423	339	1	80	0.0125000
NODE_11783_length_807_cov_67.341808	343	423	345	2	80	0.0250000
NODE_11783_length_807_cov_67.341808	343	423	349	1	80	0.0125000
NODE_11783_length_807_cov_67.341808	343	423	350	1	80	0.0125000
NODE_11783_length_807_cov_67.341808	343	423	351	1	80	0.0125000
NODE_11783_length_807_cov_67.341808	343	423	354	1	80	0.0125000
NODE_11783_length_807_cov_67.341808	343	423	355	3	80	0.0375000
NODE_11783_length_807_cov_67.341808	343	423	359	3	80	0.0375000
NODE_11783_length_807_cov_67.341808	343	423	360	1	80	0.0125000
NODE_11783_length_807_cov_67.341808	343	423	361	1	80	0.0125000
NODE_11783_length_807_cov_67.341808	343	423	363	1	80	0.0125000
NODE_11783_length_807_cov_67.341808	343	423	367	1	80	0.0125000
NODE_11783_length_807_cov_67.341808	343	423	370	2	80	0.0250000
NODE_11783_length_807_cov_67.341808	343	423	376	1	80	0.0125000
NODE_11783_length_807_cov_67.341808	343	423	378	1	80	0.0125000
NODE_11783_length_807_cov_67.341808	343	423	391	1	80	0.0125000
NODE_11783_length_807_cov_67.341808	343	423	393	1	80	0.0125000
NODE_11783_length_807_cov_67.341808	343	423	397	3	80	0.0375000
NODE_11783_length_807_cov_67.341808	343	423	405	1	80	0.0125000
NODE_11783_length_807_cov_67.341808	343	423	406	1	80	0.0125000
NODE_11783_length_807_cov_67.341808	343	423	407	2	80	0.0250000
NODE_11783_length_807_cov_67.341808	343	423	409	3	80	0.0375000
NODE_11783_length_807_cov_67.341808	343	423	410	3	80	0.0375000
NODE_11783_length_807_cov_67.341808	343	423	411	2	80	0.0250000
NODE_11783_length_807_cov_67.341808	343	423	415	1	80	0.0125000
NODE_11783_length_807_cov_67.341808	343	423	423	1	80	0.0125000
NODE_11783_length_807_cov_67.341808	343	423	433	1	80	0.0125000
NODE_11783_length_807_cov_67.341808	343	423	438	3	80	0.0375000
NODE_11783_length_807_cov_67.341808	343	423	440	3	80	0.0375000
NODE_11783_length_807_cov_67.341808	343	423	444	1	80	0.0125000
NODE_11783_length_807_cov_67.341808	343	423	446	1	80	0.0125000
NODE_11783_length_807_cov_67.341808	343	423	447	1	80	0.0125000
NODE_11783_length_807_cov_67.341808	343	423	449	2	80	0.0250000
NODE_11783_length_807_cov_67.341808	343	423	452	1	80	0.0125000
NODE_11783_length_807_cov_67.341808	343	423	454	1	80	0.0125000
NODE_11783_length_807_cov_67.341808	343	423	455	2	80	0.0250000
NODE_11783_length_807_cov_67.341808	343	423	456	2	80	0.0250000
NODE_11783_length_807_cov_67.341808	343	423	458	1	80	0.0125000
NODE_11783_length_807_cov_67.341808	343	423	463	1	80	0.0125000
NODE_11783_length_807_cov_67.341808	343	423	464	1	80	0.0125000
NODE_11783_length_807_cov_67.341808	343	423	470	1	80	0.0125000
NODE_11783_length_807_cov_67.341808	343	423	475	1	80	0.0125000
NODE_11784_length_807_cov_54.980226	683	749	107	1	66	0.0151515
NODE_11784_length_807_cov_54.980226	683	749	109	1	66	0.0151515
NODE_11784_length_807_cov_54.980226	683	749	111	1	66	0.0151515
NODE_11784_length_807_cov_54.980226	683	749	113	2	66	0.0303030
NODE_11784_length_807_cov_54.980226	683	749	115	1	66	0.0151515
NODE_11784_length_807_cov_54.980226	683	749	117	1	66	0.0151515
NODE_11784_length_807_cov_54.980226	683	749	119	10	66	0.1515152
NODE_11784_length_807_cov_54.980226	683	749	121	1	66	0.0151515
NODE_11784_length_807_cov_54.980226	683	749	123	3	66	0.0454545
NODE_11784_length_807_cov_54.980226	683	749	125	6	66	0.0909091
NODE_11784_length_807_cov_54.980226	683	749	127	2	66	0.0303030
NODE_11784_length_807_cov_54.980226	683	749	128	2	66	0.0303030
NODE_11784_length_807_cov_54.980226	683	749	131	2	66	0.0303030
NODE_11784_length_807_cov_54.980226	683	749	132	2	66	0.0303030
NODE_11784_length_807_cov_54.980226	683	749	133	4	66	0.0606061
NODE_11784_length_807_cov_54.980226	683	749	134	4	66	0.0606061
NODE_11784_length_807_cov_54.980226	683	749	135	3	66	0.0454545
NODE_11784_length_807_cov_54.980226	683	749	136	6	66	0.0909091
NODE_11784_length_807_cov_54.980226	683	749	137	10	66	0.1515152
NODE_11784_length_807_cov_54.980226	683	749	139	4	66	0.0606061
NODE_11784_length_807_cov_54.980226	727	802	21	1	75	0.0133333
NODE_11784_length_807_cov_54.980226	727	802	23	1	75	0.0133333
NODE_11784_length_807_cov_54.980226	727	802	28	2	75	0.0266667
NODE_11784_length_807_cov_54.980226	727	802	29	2	75	0.0266667
NODE_11784_length_807_cov_54.980226	727	802	31	2	75	0.0266667
NODE_11784_length_807_cov_54.980226	727	802	35	2	75	0.0266667
NODE_11784_length_807_cov_54.980226	727	802	39	2	75	0.0266667
NODE_11784_length_807_cov_54.980226	727	802	40	3	75	0.0400000
NODE_11784_length_807_cov_54.980226	727	802	42	1	75	0.0133333
NODE_11784_length_807_cov_54.980226	727	802	44	1	75	0.0133333
NODE_11784_length_807_cov_54.980226	727	802	49	2	75	0.0266667
NODE_11784_length_807_cov_54.980226	727	802	51	1	75	0.0133333
NODE_11784_length_807_cov_54.980226	727	802	53	1	75	0.0133333
NODE_11784_length_807_cov_54.980226	727	802	55	2	75	0.0266667
NODE_11784_length_807_cov_54.980226	727	802	59	1	75	0.0133333
NODE_11784_length_807_cov_54.980226	727	802	63	1	75	0.0133333
NODE_11784_length_807_cov_54.980226	727	802	67	1	75	0.0133333
NODE_11784_length_807_cov_54.980226	727	802	69	1	75	0.0133333
NODE_11784_length_807_cov_54.980226	727	802	71	2	75	0.0266667
NODE_11784_length_807_cov_54.980226	727	802	73	1	75	0.0133333
NODE_11784_length_807_cov_54.980226	727	802	76	3	75	0.0400000
NODE_11784_length_807_cov_54.980226	727	802	77	1	75	0.0133333
NODE_11784_length_807_cov_54.980226	727	802	79	2	75	0.0266667
NODE_11784_length_807_cov_54.980226	727	802	80	2	75	0.0266667
NODE_11784_length_807_cov_54.980226	727	802	82	1	75	0.0133333
NODE_11784_length_807_cov_54.980226	727	802	83	1	75	0.0133333
NODE_11784_length_807_cov_54.980226	727	802	85	9	75	0.1200000
NODE_11784_length_807_cov_54.980226	727	802	98	1	75	0.0133333
NODE_11784_length_807_cov_54.980226	727	802	103	2	75	0.0266667
NODE_11784_length_807_cov_54.980226	727	802	105	1	75	0.0133333
NODE_11784_length_807_cov_54.980226	727	802	107	1	75	0.0133333
NODE_11784_length_807_cov_54.980226	727	802	109	1	75	0.0133333
NODE_11784_length_807_cov_54.980226	727	802	111	1	75	0.0133333
NODE_11784_length_807_cov_54.980226	727	802	113	2	75	0.0266667
NODE_11784_length_807_cov_54.980226	727	802	115	1	75	0.0133333
NODE_11784_length_807_cov_54.980226	727	802	117	1	75	0.0133333
NODE_11784_length_807_cov_54.980226	727	802	119	10	75	0.1333333
NODE_11784_length_807_cov_54.980226	727	802	121	1	75	0.0133333
NODE_11784_length_807_cov_54.980226	727	802	123	3	75	0.0400000
NODE_11784_length_807_cov_54.980226	727	802	125	1	75	0.0133333
NODE_11785_length_807_cov_37.306497	435	515	0	53	80	0.6625000
NODE_11785_length_807_cov_37.306497	435	515	3	1	80	0.0125000
NODE_11785_length_807_cov_37.306497	435	515	4	26	80	0.3250000
NODE_11785_length_807_cov_37.306497	488	568	3	1	80	0.0125000
NODE_11785_length_807_cov_37.306497	488	568	4	79	80	0.9875000
NODE_11786_length_807_cov_31.177966	287	367	0	80	80	1.0000000
NODE_11786_length_807_cov_31.177966	340	420	0	80	80	1.0000000
NODE_11787_length_807_cov_30.638418	250	329	0	79	79	1.0000000
NODE_11787_length_807_cov_30.638418	302	382	0	80	80	1.0000000
NODE_11787_length_807_cov_30.638418	378	458	0	80	80	1.0000000
NODE_11787_length_807_cov_30.638418	431	511	0	80	80	1.0000000
NODE_11788_length_807_cov_29.725989	362	442	0	2	80	0.0250000
NODE_11788_length_807_cov_29.725989	362	442	2	78	80	0.9750000
NODE_11788_length_807_cov_29.725989	415	495	0	55	80	0.6875000
NODE_11788_length_807_cov_29.725989	415	495	2	25	80	0.3125000
NODE_11789_length_807_cov_23.200565	441	521	2	7	80	0.0875000
NODE_11789_length_807_cov_23.200565	441	521	4	23	80	0.2875000
NODE_11789_length_807_cov_23.200565	441	521	6	6	80	0.0750000
NODE_11789_length_807_cov_23.200565	441	521	8	44	80	0.5500000
NODE_11789_length_807_cov_23.200565	494	574	0	34	80	0.4250000
NODE_11789_length_807_cov_23.200565	494	574	4	29	80	0.3625000
NODE_11789_length_807_cov_23.200565	494	574	6	6	80	0.0750000
NODE_11789_length_807_cov_23.200565	494	574	8	11	80	0.1375000
NODE_11790_length_807_cov_21.888418	319	386	0	67	67	1.0000000
NODE_11790_length_807_cov_21.888418	390	440	0	50	50	1.0000000
NODE_11791_length_807_cov_17.480226	339	419	0	80	80	1.0000000
NODE_11791_length_807_cov_17.480226	392	472	0	80	80	1.0000000
NODE_11792_length_807_cov_14.895480	350	430	0	32	80	0.4000000
NODE_11792_length_807_cov_14.895480	350	430	2	48	80	0.6000000
NODE_11792_length_807_cov_14.895480	403	483	0	34	80	0.4250000
NODE_11792_length_807_cov_14.895480	403	483	2	46	80	0.5750000
NODE_11794_length_807_cov_12.255650	440	520	0	80	80	1.0000000
NODE_11794_length_807_cov_12.255650	493	573	0	80	80	1.0000000
NODE_11795_length_807_cov_11.129944	359	439	0	29	80	0.3625000
NODE_11795_length_807_cov_11.129944	359	439	2	51	80	0.6375000
NODE_11795_length_807_cov_11.129944	412	492	0	14	80	0.1750000
NODE_11795_length_807_cov_11.129944	412	492	2	66	80	0.8250000
NODE_11801_length_807_cov_3.847458	322	385	0	63	63	1.0000000
NODE_11822_length_806_cov_35.650636	397	477	0	80	80	1.0000000
NODE_11822_length_806_cov_35.650636	450	530	0	80	80	1.0000000
NODE_11822_length_806_cov_35.650636	526	606	0	20	80	0.2500000
NODE_11822_length_806_cov_35.650636	526	606	2	60	80	0.7500000
NODE_11822_length_806_cov_35.650636	579	667	0	43	88	0.4886364
NODE_11822_length_806_cov_35.650636	579	667	2	45	88	0.5113636
NODE_11823_length_806_cov_29.615276	377	457	2	2	80	0.0250000
NODE_11823_length_806_cov_29.615276	377	457	16	51	80	0.6375000
NODE_11823_length_806_cov_29.615276	377	457	17	27	80	0.3375000
NODE_11823_length_806_cov_29.615276	430	510	1	36	80	0.4500000
NODE_11823_length_806_cov_29.615276	430	510	2	19	80	0.2375000
NODE_11823_length_806_cov_29.615276	430	510	16	25	80	0.3125000
NODE_11824_length_806_cov_23.680339	394	474	0	6	80	0.0750000
NODE_11824_length_806_cov_23.680339	394	474	2	64	80	0.8000000
NODE_11824_length_806_cov_23.680339	394	474	4	9	80	0.1125000
NODE_11824_length_806_cov_23.680339	394	474	6	1	80	0.0125000
NODE_11824_length_806_cov_23.680339	447	527	0	59	80	0.7375000
NODE_11824_length_806_cov_23.680339	447	527	2	21	80	0.2625000
NODE_11825_length_806_cov_19.107496	239	293	0	54	54	1.0000000
NODE_11825_length_806_cov_19.107496	248	293	0	45	45	1.0000000
NODE_11825_length_806_cov_19.107496	266	345	0	79	79	1.0000000
NODE_11825_length_806_cov_19.107496	266	345	0	79	79	1.0000000
NODE_11825_length_806_cov_19.107496	421	501	0	14	80	0.1750000
NODE_11825_length_806_cov_19.107496	421	501	4	66	80	0.8250000
NODE_11826_length_806_cov_17.551627	308	388	0	38	80	0.4750000
NODE_11826_length_806_cov_17.551627	308	388	1	42	80	0.5250000
NODE_11826_length_806_cov_17.551627	361	441	1	28	80	0.3500000
NODE_11826_length_806_cov_17.551627	361	441	2	52	80	0.6500000
NODE_11827_length_806_cov_15.608204	408	488	0	39	80	0.4875000
NODE_11827_length_806_cov_15.608204	408	488	2	41	80	0.5125000
NODE_11827_length_806_cov_15.608204	461	543	0	6	82	0.0731707
NODE_11827_length_806_cov_15.608204	461	543	2	76	82	0.9268293
NODE_11864_length_805_cov_94.121813	398	478	0	7	80	0.0875000
NODE_11864_length_805_cov_94.121813	398	478	2	73	80	0.9125000
NODE_11864_length_805_cov_94.121813	451	531	0	60	80	0.7500000
NODE_11864_length_805_cov_94.121813	451	531	2	20	80	0.2500000
NODE_11865_length_805_cov_54.001416	284	364	0	80	80	1.0000000
NODE_11865_length_805_cov_54.001416	337	417	0	80	80	1.0000000
NODE_11865_length_805_cov_54.001416	413	493	0	17	80	0.2125000
NODE_11865_length_805_cov_54.001416	413	493	1	50	80	0.6250000
NODE_11865_length_805_cov_54.001416	413	493	2	13	80	0.1625000
NODE_11865_length_805_cov_54.001416	466	546	1	14	80	0.1750000
NODE_11865_length_805_cov_54.001416	466	546	2	66	80	0.8250000
NODE_11866_length_805_cov_42.325779	377	457	0	50	80	0.6250000
NODE_11866_length_805_cov_42.325779	377	457	2	15	80	0.1875000
NODE_11866_length_805_cov_42.325779	377	457	4	15	80	0.1875000
NODE_11866_length_805_cov_42.325779	430	510	2	12	80	0.1500000
NODE_11866_length_805_cov_42.325779	430	510	4	68	80	0.8500000
NODE_11867_length_805_cov_36.742210	345	425	2	34	80	0.4250000
NODE_11867_length_805_cov_36.742210	345	425	4	20	80	0.2500000
NODE_11867_length_805_cov_36.742210	345	425	6	26	80	0.3250000
NODE_11867_length_805_cov_36.742210	398	478	0	33	80	0.4125000
NODE_11867_length_805_cov_36.742210	398	478	2	47	80	0.5875000
NODE_11868_length_805_cov_25.879603	361	441	0	80	80	1.0000000
NODE_11868_length_805_cov_25.879603	414	494	0	80	80	1.0000000
NODE_11869_length_805_cov_25.048159	306	386	0	44	80	0.5500000
NODE_11869_length_805_cov_25.048159	306	386	2	36	80	0.4500000
NODE_11869_length_805_cov_25.048159	359	439	0	80	80	1.0000000
NODE_11870_length_805_cov_15.453258	311	391	0	32	80	0.4000000
NODE_11870_length_805_cov_15.453258	311	391	4	48	80	0.6000000
NODE_11870_length_805_cov_15.453258	364	444	0	11	80	0.1375000
NODE_11870_length_805_cov_15.453258	364	444	4	69	80	0.8625000
NODE_11871_length_805_cov_14.930595	264	344	0	80	80	1.0000000
NODE_11871_length_805_cov_14.930595	317	397	0	75	80	0.9375000
NODE_11871_length_805_cov_14.930595	317	397	2	5	80	0.0625000
NODE_11872_length_805_cov_10.888102	259	339	0	80	80	1.0000000
NODE_11872_length_805_cov_10.888102	312	392	0	80	80	1.0000000
NODE_11873_length_805_cov_10.716714	348	428	0	80	80	1.0000000
NODE_11873_length_805_cov_10.716714	401	481	0	80	80	1.0000000
NODE_11876_length_805_cov_7.212465	374	454	6	39	80	0.4875000
NODE_11876_length_805_cov_7.212465	374	454	8	41	80	0.5125000
NODE_11876_length_805_cov_7.212465	427	507	0	6	80	0.0750000
NODE_11876_length_805_cov_7.212465	427	507	2	39	80	0.4875000
NODE_11876_length_805_cov_7.212465	427	507	8	35	80	0.4375000
NODE_11877_length_805_cov_5.637394	323	403	0	80	80	1.0000000
NODE_11877_length_805_cov_5.637394	376	456	0	80	80	1.0000000
NODE_11878_length_805_cov_4.001416	304	384	0	80	80	1.0000000
NODE_11878_length_805_cov_4.001416	357	437	0	80	80	1.0000000
NODE_11903_length_804_cov_26.204255	319	399	0	63	80	0.7875000
NODE_11903_length_804_cov_26.204255	319	399	4	17	80	0.2125000
NODE_11903_length_804_cov_26.204255	372	452	0	10	80	0.1250000
NODE_11903_length_804_cov_26.204255	372	452	4	70	80	0.8750000
NODE_11904_length_804_cov_25.978723	242	322	0	80	80	1.0000000
NODE_11904_length_804_cov_25.978723	295	375	0	80	80	1.0000000
NODE_11904_length_804_cov_25.978723	371	451	0	30	80	0.3750000
NODE_11904_length_804_cov_25.978723	371	451	2	35	80	0.4375000
NODE_11904_length_804_cov_25.978723	371	451	6	15	80	0.1875000
NODE_11904_length_804_cov_25.978723	424	504	2	12	80	0.1500000
NODE_11904_length_804_cov_25.978723	424	504	4	17	80	0.2125000
NODE_11904_length_804_cov_25.978723	424	504	6	51	80	0.6375000
NODE_11905_length_804_cov_25.628369	444	524	0	80	80	1.0000000
NODE_11905_length_804_cov_25.628369	497	577	0	80	80	1.0000000
NODE_11906_length_804_cov_22.438298	269	349	0	80	80	1.0000000
NODE_11906_length_804_cov_22.438298	322	402	0	80	80	1.0000000
NODE_11907_length_804_cov_17.425532	273	353	0	2	80	0.0250000
NODE_11907_length_804_cov_17.425532	273	353	2	78	80	0.9750000
NODE_11907_length_804_cov_17.425532	326	406	0	2	80	0.0250000
NODE_11907_length_804_cov_17.425532	326	406	2	78	80	0.9750000
NODE_11908_length_804_cov_16.849645	229	309	1	77	80	0.9625000
NODE_11908_length_804_cov_16.849645	229	309	2	3	80	0.0375000
NODE_11908_length_804_cov_16.849645	282	362	1	24	80	0.3000000
NODE_11908_length_804_cov_16.849645	282	362	2	56	80	0.7000000
NODE_11909_length_804_cov_16.024113	499	579	0	34	80	0.4250000
NODE_11909_length_804_cov_16.024113	499	579	2	46	80	0.5750000
NODE_11909_length_804_cov_16.024113	552	632	0	9	80	0.1125000
NODE_11909_length_804_cov_16.024113	552	632	2	71	80	0.8875000
NODE_11910_length_804_cov_14.567376	375	455	2	80	80	1.0000000
NODE_11910_length_804_cov_14.567376	428	508	0	31	80	0.3875000
NODE_11910_length_804_cov_14.567376	428	508	2	49	80	0.6125000
NODE_11911_length_804_cov_14.011348	262	342	0	9	80	0.1125000
NODE_11911_length_804_cov_14.011348	262	342	4	32	80	0.4000000
NODE_11911_length_804_cov_14.011348	262	342	6	39	80	0.4875000
NODE_11911_length_804_cov_14.011348	315	395	0	15	80	0.1875000
NODE_11911_length_804_cov_14.011348	315	395	2	37	80	0.4625000
NODE_11911_length_804_cov_14.011348	315	395	6	28	80	0.3500000
NODE_11912_length_804_cov_13.800000	289	318	0	29	29	1.0000000
NODE_11913_length_804_cov_12.585816	396	476	0	80	80	1.0000000
NODE_11913_length_804_cov_12.585816	449	529	0	80	80	1.0000000
NODE_11914_length_804_cov_12.375887	190	270	0	80	80	1.0000000
NODE_11914_length_804_cov_12.375887	243	323	0	80	80	1.0000000
NODE_11915_length_804_cov_10.947518	363	443	0	80	80	1.0000000
NODE_11915_length_804_cov_10.947518	416	496	0	80	80	1.0000000
NODE_11916_length_804_cov_8.164539	427	507	0	80	80	1.0000000
NODE_11916_length_804_cov_8.164539	480	560	0	27	80	0.3375000
NODE_11916_length_804_cov_8.164539	480	560	2	53	80	0.6625000
NODE_11917_length_804_cov_7.462411	345	425	0	80	80	1.0000000
NODE_11917_length_804_cov_7.462411	398	478	0	80	80	1.0000000
NODE_11919_length_804_cov_3.663830	736	799	0	63	63	1.0000000
NODE_11933_length_804_cov_1.303546	480	560	0	80	80	1.0000000
NODE_11933_length_804_cov_1.303546	533	613	0	80	80	1.0000000
NODE_11942_length_803_cov_40.930398	374	454	0	8	80	0.1000000
NODE_11942_length_803_cov_40.930398	374	454	4	65	80	0.8125000
NODE_11942_length_803_cov_40.930398	374	454	6	7	80	0.0875000
NODE_11942_length_803_cov_40.930398	427	507	4	20	80	0.2500000
NODE_11942_length_803_cov_40.930398	427	507	6	43	80	0.5375000
NODE_11942_length_803_cov_40.930398	427	507	8	3	80	0.0375000
NODE_11942_length_803_cov_40.930398	427	507	10	14	80	0.1750000
NODE_11944_length_803_cov_28.346591	242	322	0	6	80	0.0750000
NODE_11944_length_803_cov_28.346591	242	322	17	22	80	0.2750000
NODE_11944_length_803_cov_28.346591	242	322	19	21	80	0.2625000
NODE_11944_length_803_cov_28.346591	242	322	20	26	80	0.3250000
NODE_11944_length_803_cov_28.346591	242	322	22	5	80	0.0625000
NODE_11944_length_803_cov_28.346591	295	375	19	8	80	0.1000000
NODE_11944_length_803_cov_28.346591	295	375	20	22	80	0.2750000
NODE_11944_length_803_cov_28.346591	295	375	21	17	80	0.2125000
NODE_11944_length_803_cov_28.346591	295	375	22	33	80	0.4125000
NODE_11945_length_803_cov_23.420455	288	368	0	17	80	0.2125000
NODE_11945_length_803_cov_23.420455	288	368	2	63	80	0.7875000
NODE_11945_length_803_cov_23.420455	341	421	0	70	80	0.8750000
NODE_11945_length_803_cov_23.420455	341	421	2	10	80	0.1250000
NODE_11946_length_803_cov_20.977273	316	396	0	36	80	0.4500000
NODE_11946_length_803_cov_20.977273	316	396	2	44	80	0.5500000
NODE_11946_length_803_cov_20.977273	369	449	2	80	80	1.0000000
NODE_11947_length_803_cov_18.458807	307	387	0	61	80	0.7625000
NODE_11947_length_803_cov_18.458807	307	387	2	19	80	0.2375000
NODE_11947_length_803_cov_18.458807	360	440	0	80	80	1.0000000
NODE_11948_length_803_cov_14.411932	386	466	0	80	80	1.0000000
NODE_11948_length_803_cov_14.411932	439	519	0	80	80	1.0000000
NODE_11949_length_803_cov_10.157670	319	399	0	80	80	1.0000000
NODE_11949_length_803_cov_10.157670	372	452	0	80	80	1.0000000
NODE_11950_length_803_cov_8.977273	362	442	0	80	80	1.0000000
NODE_11950_length_803_cov_8.977273	415	485	0	70	70	1.0000000
NODE_11951_length_803_cov_7.735795	195	275	0	41	80	0.5125000
NODE_11951_length_803_cov_7.735795	195	275	2	39	80	0.4875000
NODE_11951_length_803_cov_7.735795	248	328	0	15	80	0.1875000
NODE_11951_length_803_cov_7.735795	248	328	2	65	80	0.8125000
NODE_11955_length_803_cov_4.613636	266	346	4	17	80	0.2125000
NODE_11955_length_803_cov_4.613636	266	346	6	63	80	0.7875000
NODE_11955_length_803_cov_4.613636	319	399	0	45	80	0.5625000
NODE_11955_length_803_cov_4.613636	319	399	4	25	80	0.3125000
NODE_11955_length_803_cov_4.613636	319	399	6	10	80	0.1250000
NODE_11957_length_803_cov_4.220170	72	152	4	1	80	0.0125000
NODE_11957_length_803_cov_4.220170	72	152	6	1	80	0.0125000
NODE_11957_length_803_cov_4.220170	72	152	8	17	80	0.2125000
NODE_11957_length_803_cov_4.220170	72	152	10	5	80	0.0625000
NODE_11957_length_803_cov_4.220170	72	152	12	56	80	0.7000000
NODE_11957_length_803_cov_4.220170	130	207	0	4	77	0.0519481
NODE_11957_length_803_cov_4.220170	130	207	2	25	77	0.3246753
NODE_11957_length_803_cov_4.220170	130	207	4	2	77	0.0259740
NODE_11957_length_803_cov_4.220170	130	207	6	9	77	0.1168831
NODE_11957_length_803_cov_4.220170	130	207	8	8	77	0.1038961
NODE_11957_length_803_cov_4.220170	130	207	10	3	77	0.0389610
NODE_11957_length_803_cov_4.220170	130	207	12	26	77	0.3376623
NODE_11985_length_802_cov_42.294452	289	369	0	52	80	0.6500000
NODE_11985_length_802_cov_42.294452	289	369	1	28	80	0.3500000
NODE_11985_length_802_cov_42.294452	342	422	0	80	80	1.0000000
NODE_11986_length_802_cov_31.896159	246	326	0	14	80	0.1750000
NODE_11986_length_802_cov_31.896159	246	326	2	17	80	0.2125000
NODE_11986_length_802_cov_31.896159	246	326	8	16	80	0.2000000
NODE_11986_length_802_cov_31.896159	246	326	9	1	80	0.0125000
NODE_11986_length_802_cov_31.896159	246	326	10	32	80	0.4000000
NODE_11986_length_802_cov_31.896159	299	379	8	54	80	0.6750000
NODE_11986_length_802_cov_31.896159	299	379	10	26	80	0.3250000
NODE_11987_length_802_cov_30.786629	419	499	2	15	80	0.1875000
NODE_11987_length_802_cov_30.786629	419	499	4	65	80	0.8125000
NODE_11987_length_802_cov_30.786629	472	552	2	50	80	0.6250000
NODE_11987_length_802_cov_30.786629	472	552	4	30	80	0.3750000
NODE_11988_length_802_cov_19.540541	368	448	0	80	80	1.0000000
NODE_11988_length_802_cov_19.540541	421	501	0	67	80	0.8375000
NODE_11988_length_802_cov_19.540541	421	501	2	13	80	0.1625000
NODE_11989_length_802_cov_17.689900	268	348	0	24	80	0.3000000
NODE_11989_length_802_cov_17.689900	268	348	2	56	80	0.7000000
NODE_11989_length_802_cov_17.689900	321	401	0	44	80	0.5500000
NODE_11989_length_802_cov_17.689900	321	401	2	36	80	0.4500000
NODE_11990_length_802_cov_16.432432	364	444	0	44	80	0.5500000
NODE_11990_length_802_cov_16.432432	364	444	2	36	80	0.4500000
NODE_11990_length_802_cov_16.432432	417	497	0	80	80	1.0000000
NODE_11991_length_802_cov_15.409673	317	397	0	31	80	0.3875000
NODE_11991_length_802_cov_15.409673	317	397	2	8	80	0.1000000
NODE_11991_length_802_cov_15.409673	317	397	6	41	80	0.5125000
NODE_11991_length_802_cov_15.409673	370	450	0	12	80	0.1500000
NODE_11991_length_802_cov_15.409673	370	450	2	2	80	0.0250000
NODE_11991_length_802_cov_15.409673	370	450	6	66	80	0.8250000
NODE_11992_length_802_cov_12.507824	340	420	0	80	80	1.0000000
NODE_11992_length_802_cov_12.507824	393	473	0	80	80	1.0000000
NODE_11993_length_802_cov_9.310100	374	454	0	80	80	1.0000000
NODE_11993_length_802_cov_9.310100	427	507	0	80	80	1.0000000
NODE_11994_length_802_cov_8.421053	272	351	0	79	79	1.0000000
NODE_11994_length_802_cov_8.421053	324	404	0	80	80	1.0000000
NODE_11997_length_802_cov_5.576102	294	374	0	80	80	1.0000000
NODE_11997_length_802_cov_5.576102	347	427	0	80	80	1.0000000
NODE_12025_length_801_cov_35.199430	334	414	6	80	80	1.0000000
NODE_12025_length_801_cov_35.199430	387	467	0	14	80	0.1750000
NODE_12025_length_801_cov_35.199430	387	467	6	66	80	0.8250000
NODE_12026_length_801_cov_20.096866	347	427	0	80	80	1.0000000
NODE_12026_length_801_cov_20.096866	400	480	0	80	80	1.0000000
NODE_12027_length_801_cov_18.643875	355	435	0	80	80	1.0000000
NODE_12027_length_801_cov_18.643875	408	488	0	80	80	1.0000000
NODE_12028_length_801_cov_16.099715	427	507	0	80	80	1.0000000
NODE_12028_length_801_cov_16.099715	480	560	0	80	80	1.0000000
NODE_12029_length_801_cov_12.307692	332	412	0	80	80	1.0000000
NODE_12029_length_801_cov_12.307692	385	465	0	80	80	1.0000000
NODE_12030_length_801_cov_11.464387	293	373	0	80	80	1.0000000
NODE_12030_length_801_cov_11.464387	346	426	0	80	80	1.0000000
NODE_12031_length_801_cov_8.562678	309	389	0	80	80	1.0000000
NODE_12031_length_801_cov_8.562678	362	442	0	80	80	1.0000000
NODE_12032_length_801_cov_3.927350	339	419	0	80	80	1.0000000
NODE_12032_length_801_cov_3.927350	392	472	0	80	80	1.0000000
NODE_12053_length_800_cov_72.029957	245	325	0	80	80	1.0000000
NODE_12053_length_800_cov_72.029957	298	378	0	80	80	1.0000000
NODE_12054_length_800_cov_22.631954	297	377	0	42	80	0.5250000
NODE_12054_length_800_cov_22.631954	297	377	2	38	80	0.4750000
NODE_12054_length_800_cov_22.631954	350	430	0	80	80	1.0000000
NODE_12055_length_800_cov_9.457917	409	489	0	45	80	0.5625000
NODE_12055_length_800_cov_9.457917	409	489	2	35	80	0.4375000
NODE_12055_length_800_cov_9.457917	462	542	0	80	80	1.0000000
NODE_12084_length_799_cov_101.640000	101	132	59	1	31	0.0322581
NODE_12084_length_799_cov_101.640000	101	132	65	1	31	0.0322581
NODE_12084_length_799_cov_101.640000	101	132	67	1	31	0.0322581
NODE_12084_length_799_cov_101.640000	101	132	71	1	31	0.0322581
NODE_12084_length_799_cov_101.640000	101	132	73	2	31	0.0645161
NODE_12084_length_799_cov_101.640000	101	132	78	1	31	0.0322581
NODE_12084_length_799_cov_101.640000	101	132	80	1	31	0.0322581
NODE_12084_length_799_cov_101.640000	101	132	86	3	31	0.0967742
NODE_12084_length_799_cov_101.640000	101	132	89	1	31	0.0322581
NODE_12084_length_799_cov_101.640000	101	132	96	1	31	0.0322581
NODE_12084_length_799_cov_101.640000	101	132	101	1	31	0.0322581
NODE_12084_length_799_cov_101.640000	101	132	105	2	31	0.0645161
NODE_12084_length_799_cov_101.640000	101	132	109	1	31	0.0322581
NODE_12084_length_799_cov_101.640000	101	132	112	2	31	0.0645161
NODE_12084_length_799_cov_101.640000	101	132	114	1	31	0.0322581
NODE_12084_length_799_cov_101.640000	101	132	118	1	31	0.0322581
NODE_12084_length_799_cov_101.640000	101	132	119	1	31	0.0322581
NODE_12084_length_799_cov_101.640000	101	132	125	2	31	0.0645161
NODE_12084_length_799_cov_101.640000	101	132	135	1	31	0.0322581
NODE_12084_length_799_cov_101.640000	101	132	136	1	31	0.0322581
NODE_12084_length_799_cov_101.640000	101	132	137	1	31	0.0322581
NODE_12084_length_799_cov_101.640000	101	132	151	1	31	0.0322581
NODE_12084_length_799_cov_101.640000	101	132	160	1	31	0.0322581
NODE_12084_length_799_cov_101.640000	101	132	164	2	31	0.0645161
NODE_12085_length_799_cov_33.630000	367	447	0	80	80	1.0000000
NODE_12085_length_799_cov_33.630000	420	500	0	80	80	1.0000000
NODE_12086_length_799_cov_15.717143	408	488	0	1	80	0.0125000
NODE_12086_length_799_cov_15.717143	408	488	2	6	80	0.0750000
NODE_12086_length_799_cov_15.717143	408	488	4	26	80	0.3250000
NODE_12086_length_799_cov_15.717143	408	488	6	47	80	0.5875000
NODE_12086_length_799_cov_15.717143	461	541	0	26	80	0.3250000
NODE_12086_length_799_cov_15.717143	461	541	2	25	80	0.3125000
NODE_12086_length_799_cov_15.717143	461	541	4	24	80	0.3000000
NODE_12086_length_799_cov_15.717143	461	541	6	5	80	0.0625000
NODE_12087_length_799_cov_15.175714	293	373	0	2	80	0.0250000
NODE_12087_length_799_cov_15.175714	293	373	4	77	80	0.9625000
NODE_12087_length_799_cov_15.175714	293	373	8	1	80	0.0125000
NODE_12087_length_799_cov_15.175714	346	426	4	26	80	0.3250000
NODE_12087_length_799_cov_15.175714	346	426	8	50	80	0.6250000
NODE_12087_length_799_cov_15.175714	346	426	11	1	80	0.0125000
NODE_12087_length_799_cov_15.175714	346	426	12	3	80	0.0375000
NODE_12088_length_799_cov_8.444286	408	488	0	21	80	0.2625000
NODE_12088_length_799_cov_8.444286	408	488	2	23	80	0.2875000
NODE_12088_length_799_cov_8.444286	408	488	4	36	80	0.4500000
NODE_12088_length_799_cov_8.444286	461	541	0	74	80	0.9250000
NODE_12088_length_799_cov_8.444286	461	541	2	6	80	0.0750000
NODE_12120_length_798_cov_42.629471	148	228	0	80	80	1.0000000
NODE_12120_length_798_cov_42.629471	201	281	0	80	80	1.0000000
NODE_12121_length_798_cov_23.658083	368	448	2	80	80	1.0000000
NODE_12121_length_798_cov_23.658083	421	501	0	2	80	0.0250000
NODE_12121_length_798_cov_23.658083	421	501	1	45	80	0.5625000
NODE_12121_length_798_cov_23.658083	421	501	2	33	80	0.4125000
NODE_12122_length_798_cov_15.037196	341	421	0	58	80	0.7250000
NODE_12122_length_798_cov_15.037196	341	421	2	22	80	0.2750000
NODE_12122_length_798_cov_15.037196	394	474	0	5	80	0.0625000
NODE_12122_length_798_cov_15.037196	394	474	2	75	80	0.9375000
NODE_12123_length_798_cov_6.816881	404	483	0	79	79	1.0000000
NODE_12123_length_798_cov_6.816881	457	536	0	79	79	1.0000000
NODE_12129_length_798_cov_2.796853	246	326	0	80	80	1.0000000
NODE_12129_length_798_cov_2.796853	299	379	0	69	80	0.8625000
NODE_12129_length_798_cov_2.796853	299	379	2	11	80	0.1375000
NODE_12151_length_797_cov_24.340974	207	287	0	19	80	0.2375000
NODE_12151_length_797_cov_24.340974	207	287	2	38	80	0.4750000
NODE_12151_length_797_cov_24.340974	207	287	4	23	80	0.2875000
NODE_12151_length_797_cov_24.340974	260	340	2	12	80	0.1500000
NODE_12151_length_797_cov_24.340974	260	340	4	68	80	0.8500000
NODE_12152_length_797_cov_21.071633	372	452	0	24	80	0.3000000
NODE_12152_length_797_cov_21.071633	372	452	6	55	80	0.6875000
NODE_12152_length_797_cov_21.071633	372	452	7	1	80	0.0125000
NODE_12152_length_797_cov_21.071633	425	505	2	22	80	0.2750000
NODE_12152_length_797_cov_21.071633	425	505	6	26	80	0.3250000
NODE_12152_length_797_cov_21.071633	425	505	7	28	80	0.3500000
NODE_12152_length_797_cov_21.071633	425	505	8	4	80	0.0500000
NODE_12153_length_797_cov_18.286533	346	426	0	80	80	1.0000000
NODE_12153_length_797_cov_18.286533	399	479	0	80	80	1.0000000
NODE_12154_length_797_cov_16.628940	322	402	0	32	80	0.4000000
NODE_12154_length_797_cov_16.628940	322	402	2	48	80	0.6000000
NODE_12154_length_797_cov_16.628940	375	455	0	10	80	0.1250000
NODE_12154_length_797_cov_16.628940	375	455	2	70	80	0.8750000
NODE_12155_length_797_cov_15.266476	299	379	0	62	80	0.7750000
NODE_12155_length_797_cov_15.266476	299	379	2	18	80	0.2250000
NODE_12155_length_797_cov_15.266476	352	432	0	80	80	1.0000000
NODE_12156_length_797_cov_15.035817	263	343	0	70	80	0.8750000
NODE_12156_length_797_cov_15.035817	263	343	2	10	80	0.1250000
NODE_12156_length_797_cov_15.035817	316	396	0	80	80	1.0000000
NODE_12157_length_797_cov_12.934097	403	484	2	20	81	0.2469136
NODE_12157_length_797_cov_12.934097	403	484	4	61	81	0.7530864
NODE_12157_length_797_cov_12.934097	457	537	0	35	80	0.4375000
NODE_12157_length_797_cov_12.934097	457	537	2	8	80	0.1000000
NODE_12157_length_797_cov_12.934097	457	537	4	37	80	0.4625000
NODE_12158_length_797_cov_11.140401	201	281	0	35	80	0.4375000
NODE_12158_length_797_cov_11.140401	201	281	2	45	80	0.5625000
NODE_12158_length_797_cov_11.140401	254	334	0	80	80	1.0000000
NODE_12159_length_797_cov_8.681948	284	364	0	80	80	1.0000000
NODE_12159_length_797_cov_8.681948	337	417	0	80	80	1.0000000
NODE_12160_length_797_cov_7.616046	314	397	0	83	83	1.0000000
NODE_12160_length_797_cov_7.616046	370	450	0	80	80	1.0000000
NODE_12161_length_797_cov_7.487106	275	347	0	72	72	1.0000000
NODE_12161_length_797_cov_7.487106	320	400	0	80	80	1.0000000
NODE_12163_length_797_cov_6.068768	357	437	0	80	80	1.0000000
NODE_12163_length_797_cov_6.068768	410	490	0	80	80	1.0000000
NODE_12186_length_796_cov_20.862267	262	342	0	80	80	1.0000000
NODE_12186_length_796_cov_20.862267	315	395	0	80	80	1.0000000
NODE_12187_length_796_cov_18.291248	283	363	4	11	80	0.1375000
NODE_12187_length_796_cov_18.291248	283	363	124	33	80	0.4125000
NODE_12187_length_796_cov_18.291248	283	363	126	6	80	0.0750000
NODE_12187_length_796_cov_18.291248	283	363	151	1	80	0.0125000
NODE_12187_length_796_cov_18.291248	283	363	152	1	80	0.0125000
NODE_12187_length_796_cov_18.291248	283	363	153	1	80	0.0125000
NODE_12187_length_796_cov_18.291248	283	363	160	2	80	0.0250000
NODE_12187_length_796_cov_18.291248	283	363	161	2	80	0.0250000
NODE_12187_length_796_cov_18.291248	283	363	162	1	80	0.0125000
NODE_12187_length_796_cov_18.291248	283	363	170	1	80	0.0125000
NODE_12187_length_796_cov_18.291248	283	363	171	21	80	0.2625000
NODE_12187_length_796_cov_18.291248	336	416	107	14	80	0.1750000
NODE_12187_length_796_cov_18.291248	336	416	109	3	80	0.0375000
NODE_12187_length_796_cov_18.291248	336	416	110	6	80	0.0750000
NODE_12187_length_796_cov_18.291248	336	416	111	1	80	0.0125000
NODE_12187_length_796_cov_18.291248	336	416	112	3	80	0.0375000
NODE_12187_length_796_cov_18.291248	336	416	113	1	80	0.0125000
NODE_12187_length_796_cov_18.291248	336	416	115	2	80	0.0250000
NODE_12187_length_796_cov_18.291248	336	416	116	2	80	0.0250000
NODE_12187_length_796_cov_18.291248	336	416	122	2	80	0.0250000
NODE_12187_length_796_cov_18.291248	336	416	130	3	80	0.0375000
NODE_12187_length_796_cov_18.291248	336	416	131	3	80	0.0375000
NODE_12187_length_796_cov_18.291248	336	416	134	1	80	0.0125000
NODE_12187_length_796_cov_18.291248	336	416	139	1	80	0.0125000
NODE_12187_length_796_cov_18.291248	336	416	140	2	80	0.0250000
NODE_12187_length_796_cov_18.291248	336	416	143	4	80	0.0500000
NODE_12187_length_796_cov_18.291248	336	416	147	1	80	0.0125000
NODE_12187_length_796_cov_18.291248	336	416	148	1	80	0.0125000
NODE_12187_length_796_cov_18.291248	336	416	149	2	80	0.0250000
NODE_12187_length_796_cov_18.291248	336	416	151	2	80	0.0250000
NODE_12187_length_796_cov_18.291248	336	416	152	1	80	0.0125000
NODE_12187_length_796_cov_18.291248	336	416	153	1	80	0.0125000
NODE_12187_length_796_cov_18.291248	336	416	160	2	80	0.0250000
NODE_12187_length_796_cov_18.291248	336	416	161	2	80	0.0250000
NODE_12187_length_796_cov_18.291248	336	416	162	1	80	0.0125000
NODE_12187_length_796_cov_18.291248	336	416	170	1	80	0.0125000
NODE_12187_length_796_cov_18.291248	336	416	171	18	80	0.2250000
NODE_12189_length_796_cov_7.880918	388	460	1	9	72	0.1250000
NODE_12189_length_796_cov_7.880918	388	460	2	63	72	0.8750000
NODE_12189_length_796_cov_7.880918	442	513	1	62	71	0.8732395
NODE_12189_length_796_cov_7.880918	442	513	2	9	71	0.1267606
NODE_12216_length_795_cov_31.729885	298	378	0	23	80	0.2875000
NODE_12216_length_795_cov_31.729885	298	378	4	57	80	0.7125000
NODE_12216_length_795_cov_31.729885	351	431	0	41	80	0.5125000
NODE_12216_length_795_cov_31.729885	351	431	4	39	80	0.4875000
NODE_12217_length_795_cov_26.760057	367	447	2	19	80	0.2375000
NODE_12217_length_795_cov_26.760057	367	447	6	58	80	0.7250000
NODE_12217_length_795_cov_26.760057	367	447	8	3	80	0.0375000
NODE_12217_length_795_cov_26.760057	420	500	6	80	80	1.0000000
NODE_12218_length_795_cov_24.522989	352	432	0	37	80	0.4625000
NODE_12218_length_795_cov_24.522989	352	432	2	43	80	0.5375000
NODE_12218_length_795_cov_24.522989	405	485	0	55	80	0.6875000
NODE_12218_length_795_cov_24.522989	405	485	2	25	80	0.3125000
NODE_12219_length_795_cov_22.747126	363	443	0	14	80	0.1750000
NODE_12219_length_795_cov_22.747126	363	443	2	49	80	0.6125000
NODE_12219_length_795_cov_22.747126	363	443	6	17	80	0.2125000
NODE_12219_length_795_cov_22.747126	416	496	2	10	80	0.1250000
NODE_12219_length_795_cov_22.747126	416	496	4	39	80	0.4875000
NODE_12219_length_795_cov_22.747126	416	496	6	31	80	0.3875000
NODE_12220_length_795_cov_9.439655	425	505	2	26	80	0.3250000
NODE_12220_length_795_cov_9.439655	425	505	4	54	80	0.6750000
NODE_12220_length_795_cov_9.439655	478	558	1	1	80	0.0125000
NODE_12220_length_795_cov_9.439655	478	558	2	29	80	0.3625000
NODE_12220_length_795_cov_9.439655	478	558	4	50	80	0.6250000
NODE_12232_length_795_cov_3.359195	349	429	0	80	80	1.0000000
NODE_12232_length_795_cov_3.359195	402	482	0	80	80	1.0000000
NODE_12256_length_794_cov_24.680576	326	406	4	34	80	0.4250000
NODE_12256_length_794_cov_24.680576	326	406	6	31	80	0.3875000
NODE_12256_length_794_cov_24.680576	326	406	8	15	80	0.1875000
NODE_12256_length_794_cov_24.680576	379	459	0	8	80	0.1000000
NODE_12256_length_794_cov_24.680576	379	459	2	17	80	0.2125000
NODE_12256_length_794_cov_24.680576	379	459	4	2	80	0.0250000
NODE_12256_length_794_cov_24.680576	379	459	6	16	80	0.2000000
NODE_12256_length_794_cov_24.680576	379	459	8	37	80	0.4625000
NODE_12257_length_794_cov_20.057554	153	233	0	80	80	1.0000000
NODE_12257_length_794_cov_20.057554	206	286	0	80	80	1.0000000
NODE_12257_length_794_cov_20.057554	282	362	0	80	80	1.0000000
NODE_12257_length_794_cov_20.057554	335	415	0	80	80	1.0000000
NODE_12258_length_794_cov_16.602878	361	441	0	80	80	1.0000000
NODE_12258_length_794_cov_16.602878	414	494	0	80	80	1.0000000
NODE_12259_length_794_cov_16.362590	337	417	0	80	80	1.0000000
NODE_12259_length_794_cov_16.362590	390	470	0	80	80	1.0000000
NODE_12260_length_794_cov_14.444604	101	160	0	59	59	1.0000000
NODE_12260_length_794_cov_14.444604	409	489	0	80	80	1.0000000
NODE_12260_length_794_cov_14.444604	462	542	0	44	80	0.5500000
NODE_12260_length_794_cov_14.444604	462	542	2	36	80	0.4500000
NODE_12261_length_794_cov_12.866187	442	522	2	78	80	0.9750000
NODE_12261_length_794_cov_12.866187	442	522	4	2	80	0.0250000
NODE_12261_length_794_cov_12.866187	495	575	0	35	80	0.4375000
NODE_12261_length_794_cov_12.866187	495	575	2	45	80	0.5625000
NODE_12262_length_794_cov_12.287770	235	315	0	80	80	1.0000000
NODE_12262_length_794_cov_12.287770	288	368	0	80	80	1.0000000
NODE_12263_length_794_cov_11.210072	315	395	0	80	80	1.0000000
NODE_12263_length_794_cov_11.210072	368	448	0	35	80	0.4375000
NODE_12263_length_794_cov_11.210072	368	448	2	1	80	0.0125000
NODE_12263_length_794_cov_11.210072	368	448	3	12	80	0.1500000
NODE_12263_length_794_cov_11.210072	368	448	4	32	80	0.4000000
NODE_12264_length_794_cov_10.638849	325	406	0	81	81	1.0000000
NODE_12264_length_794_cov_10.638849	379	459	0	80	80	1.0000000
NODE_12266_length_794_cov_6.274820	412	492	0	2	80	0.0250000
NODE_12266_length_794_cov_6.274820	412	492	6	78	80	0.9750000
NODE_12266_length_794_cov_6.274820	465	545	0	55	80	0.6875000
NODE_12266_length_794_cov_6.274820	465	545	6	25	80	0.3125000
NODE_12271_length_794_cov_3.197122	273	338	0	65	65	1.0000000
NODE_12282_length_794_cov_1.848921	246	326	0	80	80	1.0000000
NODE_12282_length_794_cov_1.848921	299	379	0	80	80	1.0000000
NODE_12295_length_793_cov_29.878963	326	406	2	47	80	0.5875000
NODE_12295_length_793_cov_29.878963	326	406	3	1	80	0.0125000
NODE_12295_length_793_cov_29.878963	326	406	4	32	80	0.4000000
NODE_12295_length_793_cov_29.878963	379	459	2	41	80	0.5125000
NODE_12295_length_793_cov_29.878963	379	459	4	39	80	0.4875000
NODE_12296_length_793_cov_25.981268	310	390	0	80	80	1.0000000
NODE_12296_length_793_cov_25.981268	363	445	0	82	82	1.0000000
NODE_12297_length_793_cov_24.840058	331	411	0	25	80	0.3125000
NODE_12297_length_793_cov_24.840058	331	411	3	1	80	0.0125000
NODE_12297_length_793_cov_24.840058	331	411	4	54	80	0.6750000
NODE_12297_length_793_cov_24.840058	384	464	0	78	80	0.9750000
NODE_12297_length_793_cov_24.840058	384	464	3	1	80	0.0125000
NODE_12297_length_793_cov_24.840058	384	464	4	1	80	0.0125000
NODE_12298_length_793_cov_21.707493	398	478	0	34	80	0.4250000
NODE_12298_length_793_cov_21.707493	398	478	1	18	80	0.2250000
NODE_12298_length_793_cov_21.707493	398	478	3	1	80	0.0125000
NODE_12298_length_793_cov_21.707493	398	478	4	12	80	0.1500000
NODE_12298_length_793_cov_21.707493	398	478	5	14	80	0.1750000
NODE_12298_length_793_cov_21.707493	398	478	6	1	80	0.0125000
NODE_12298_length_793_cov_21.707493	451	531	0	80	80	1.0000000
NODE_12299_length_793_cov_8.358790	257	337	4	19	80	0.2375000
NODE_12299_length_793_cov_8.358790	257	337	6	61	80	0.7625000
NODE_12299_length_793_cov_8.358790	310	390	0	33	80	0.4125000
NODE_12299_length_793_cov_8.358790	310	390	4	39	80	0.4875000
NODE_12299_length_793_cov_8.358790	310	390	6	8	80	0.1000000
NODE_12300_length_793_cov_8.236311	477	557	0	80	80	1.0000000
NODE_12300_length_793_cov_8.236311	530	610	0	80	80	1.0000000
NODE_12302_length_793_cov_6.763689	461	541	0	80	80	1.0000000
NODE_12302_length_793_cov_6.763689	514	594	0	80	80	1.0000000
NODE_12307_length_793_cov_4.465418	501	549	4	4	48	0.0833333
NODE_12307_length_793_cov_4.465418	501	549	7	5	48	0.1041667
NODE_12307_length_793_cov_4.465418	501	549	8	39	48	0.8125000
NODE_12311_length_793_cov_4.138329	174	254	0	18	80	0.2250000
NODE_12311_length_793_cov_4.138329	174	254	3	62	80	0.7750000
NODE_12311_length_793_cov_4.138329	227	307	0	71	80	0.8875000
NODE_12311_length_793_cov_4.138329	227	307	3	9	80	0.1125000
NODE_12338_length_792_cov_40.025974	198	278	0	27	80	0.3375000
NODE_12338_length_792_cov_40.025974	198	278	2	53	80	0.6625000
NODE_12338_length_792_cov_40.025974	251	331	0	15	80	0.1875000
NODE_12338_length_792_cov_40.025974	251	331	2	65	80	0.8125000
NODE_12338_length_792_cov_40.025974	327	408	0	69	81	0.8518519
NODE_12338_length_792_cov_40.025974	327	408	2	12	81	0.1481481
NODE_12338_length_792_cov_40.025974	381	461	0	15	80	0.1875000
NODE_12338_length_792_cov_40.025974	381	461	2	65	80	0.8125000
NODE_12339_length_792_cov_31.176046	331	411	0	80	80	1.0000000
NODE_12339_length_792_cov_31.176046	384	463	0	48	79	0.6075949
NODE_12339_length_792_cov_31.176046	384	463	2	2	79	0.0253165
NODE_12339_length_792_cov_31.176046	384	463	6	29	79	0.3670886
NODE_12339_length_792_cov_31.176046	459	539	6	80	80	1.0000000
NODE_12339_length_792_cov_31.176046	512	546	2	3	34	0.0882353
NODE_12339_length_792_cov_31.176046	512	546	6	31	34	0.9117647
NODE_12340_length_792_cov_21.347763	303	383	0	63	80	0.7875000
NODE_12340_length_792_cov_21.347763	303	383	2	17	80	0.2125000
NODE_12340_length_792_cov_21.347763	356	436	0	10	80	0.1250000
NODE_12340_length_792_cov_21.347763	356	436	2	70	80	0.8750000
NODE_12341_length_792_cov_20.142857	361	441	6	40	80	0.5000000
NODE_12341_length_792_cov_20.142857	361	441	12	40	80	0.5000000
NODE_12341_length_792_cov_20.142857	414	494	6	6	80	0.0750000
NODE_12341_length_792_cov_20.142857	414	494	8	11	80	0.1375000
NODE_12341_length_792_cov_20.142857	414	494	12	63	80	0.7875000
NODE_12342_length_792_cov_18.733045	320	400	0	80	80	1.0000000
NODE_12342_length_792_cov_18.733045	373	453	0	80	80	1.0000000
NODE_12343_length_792_cov_12.024531	369	449	0	44	80	0.5500000
NODE_12343_length_792_cov_12.024531	369	449	2	36	80	0.4500000
NODE_12343_length_792_cov_12.024531	422	502	0	80	80	1.0000000
NODE_12372_length_791_cov_53.573699	287	359	0	72	72	1.0000000
NODE_12372_length_791_cov_53.573699	332	412	0	80	80	1.0000000
NODE_12373_length_791_cov_40.416185	238	318	0	39	80	0.4875000
NODE_12373_length_791_cov_40.416185	238	318	4	41	80	0.5125000
NODE_12373_length_791_cov_40.416185	291	371	0	8	80	0.1000000
NODE_12373_length_791_cov_40.416185	291	371	4	72	80	0.9000000
NODE_12374_length_791_cov_38.791908	309	389	3	80	80	1.0000000
NODE_12374_length_791_cov_38.791908	362	442	0	3	80	0.0375000
NODE_12374_length_791_cov_38.791908	362	442	1	39	80	0.4875000
NODE_12374_length_791_cov_38.791908	362	442	3	38	80	0.4750000
NODE_12375_length_791_cov_23.468208	328	408	0	6	80	0.0750000
NODE_12375_length_791_cov_23.468208	328	408	2	29	80	0.3625000
NODE_12375_length_791_cov_23.468208	328	408	3	1	80	0.0125000
NODE_12375_length_791_cov_23.468208	328	408	4	44	80	0.5500000
NODE_12375_length_791_cov_23.468208	381	461	2	41	80	0.5125000
NODE_12375_length_791_cov_23.468208	381	461	4	39	80	0.4875000
NODE_12376_length_791_cov_20.897399	299	379	0	75	80	0.9375000
NODE_12376_length_791_cov_20.897399	299	379	4	5	80	0.0625000
NODE_12376_length_791_cov_20.897399	352	432	0	49	80	0.6125000
NODE_12376_length_791_cov_20.897399	352	432	4	31	80	0.3875000
NODE_12377_length_791_cov_13.504335	339	419	0	80	80	1.0000000
NODE_12377_length_791_cov_13.504335	392	472	0	80	80	1.0000000
NODE_12379_length_791_cov_12.547688	338	418	0	1	80	0.0125000
NODE_12379_length_791_cov_12.547688	338	418	2	79	80	0.9875000
NODE_12379_length_791_cov_12.547688	391	471	0	39	80	0.4875000
NODE_12379_length_791_cov_12.547688	391	471	2	41	80	0.5125000
NODE_12380_length_791_cov_11.791908	440	520	4	80	80	1.0000000
NODE_12380_length_791_cov_11.791908	493	573	2	19	80	0.2375000
NODE_12380_length_791_cov_11.791908	493	573	4	45	80	0.5625000
NODE_12380_length_791_cov_11.791908	493	573	6	16	80	0.2000000
NODE_12381_length_791_cov_11.011561	337	417	0	43	80	0.5375000
NODE_12381_length_791_cov_11.011561	337	417	2	37	80	0.4625000
NODE_12381_length_791_cov_11.011561	390	470	0	80	80	1.0000000
NODE_12382_length_791_cov_8.757225	325	405	0	50	80	0.6250000
NODE_12382_length_791_cov_8.757225	325	405	2	30	80	0.3750000
NODE_12382_length_791_cov_8.757225	378	458	2	80	80	1.0000000
NODE_12384_length_791_cov_8.125723	416	496	0	3	80	0.0375000
NODE_12384_length_791_cov_8.125723	416	496	2	77	80	0.9625000
NODE_12384_length_791_cov_8.125723	469	549	0	45	80	0.5625000
NODE_12384_length_791_cov_8.125723	469	549	2	35	80	0.4375000
NODE_12409_length_790_cov_48.021708	526	606	0	21	80	0.2625000
NODE_12409_length_790_cov_48.021708	526	606	6	59	80	0.7375000
NODE_12409_length_790_cov_48.021708	579	659	0	2	80	0.0250000
NODE_12409_length_790_cov_48.021708	579	659	5	1	80	0.0125000
NODE_12409_length_790_cov_48.021708	579	659	6	77	80	0.9625000
NODE_12410_length_790_cov_44.151954	343	423	0	21	80	0.2625000
NODE_12410_length_790_cov_44.151954	343	423	4	59	80	0.7375000
NODE_12410_length_790_cov_44.151954	396	438	4	38	42	0.9047619
NODE_12410_length_790_cov_44.151954	396	438	6	4	42	0.0952381
NODE_12410_length_790_cov_44.151954	696	776	12	1	80	0.0125000
NODE_12410_length_790_cov_44.151954	696	776	14	4	80	0.0500000
NODE_12410_length_790_cov_44.151954	696	776	16	2	80	0.0250000
NODE_12410_length_790_cov_44.151954	696	776	20	1	80	0.0125000
NODE_12410_length_790_cov_44.151954	696	776	23	1	80	0.0125000
NODE_12410_length_790_cov_44.151954	696	776	27	1	80	0.0125000
NODE_12410_length_790_cov_44.151954	696	776	28	1	80	0.0125000
NODE_12410_length_790_cov_44.151954	696	776	38	1	80	0.0125000
NODE_12410_length_790_cov_44.151954	696	776	40	1	80	0.0125000
NODE_12410_length_790_cov_44.151954	696	776	44	2	80	0.0250000
NODE_12410_length_790_cov_44.151954	696	776	48	1	80	0.0125000
NODE_12410_length_790_cov_44.151954	696	776	66	2	80	0.0250000
NODE_12410_length_790_cov_44.151954	696	776	68	1	80	0.0125000
NODE_12410_length_790_cov_44.151954	696	776	82	3	80	0.0375000
NODE_12410_length_790_cov_44.151954	696	776	86	1	80	0.0125000
NODE_12410_length_790_cov_44.151954	696	776	90	2	80	0.0250000
NODE_12410_length_790_cov_44.151954	696	776	94	3	80	0.0375000
NODE_12410_length_790_cov_44.151954	696	776	98	4	80	0.0500000
NODE_12410_length_790_cov_44.151954	696	776	100	6	80	0.0750000
NODE_12410_length_790_cov_44.151954	696	776	102	3	80	0.0375000
NODE_12410_length_790_cov_44.151954	696	776	104	3	80	0.0375000
NODE_12410_length_790_cov_44.151954	696	776	108	2	80	0.0250000
NODE_12410_length_790_cov_44.151954	696	776	113	1	80	0.0125000
NODE_12410_length_790_cov_44.151954	696	776	124	5	80	0.0625000
NODE_12410_length_790_cov_44.151954	696	776	126	7	80	0.0875000
NODE_12410_length_790_cov_44.151954	696	776	128	2	80	0.0250000
NODE_12410_length_790_cov_44.151954	696	776	130	5	80	0.0625000
NODE_12410_length_790_cov_44.151954	696	776	134	1	80	0.0125000
NODE_12410_length_790_cov_44.151954	696	776	136	8	80	0.1000000
NODE_12410_length_790_cov_44.151954	696	776	140	3	80	0.0375000
NODE_12410_length_790_cov_44.151954	696	776	142	2	80	0.0250000
NODE_12411_length_790_cov_27.144718	291	371	0	80	80	1.0000000
NODE_12411_length_790_cov_27.144718	344	424	0	80	80	1.0000000
NODE_12412_length_790_cov_16.973951	232	312	0	42	80	0.5250000
NODE_12412_length_790_cov_16.973951	232	312	8	38	80	0.4750000
NODE_12412_length_790_cov_16.973951	285	365	0	23	80	0.2875000
NODE_12412_length_790_cov_16.973951	285	365	8	57	80	0.7125000
NODE_12413_length_790_cov_13.374819	204	284	0	11	80	0.1375000
NODE_12413_length_790_cov_13.374819	204	284	2	69	80	0.8625000
NODE_12413_length_790_cov_13.374819	257	337	0	64	80	0.8000000
NODE_12413_length_790_cov_13.374819	257	337	2	16	80	0.2000000
NODE_12415_length_790_cov_10.613603	302	382	2	42	80	0.5250000
NODE_12415_length_790_cov_10.613603	302	382	6	38	80	0.4750000
NODE_12415_length_790_cov_10.613603	355	435	6	64	80	0.8000000
NODE_12415_length_790_cov_10.613603	355	435	8	16	80	0.2000000
NODE_12418_length_790_cov_5.493488	271	351	0	80	80	1.0000000
NODE_12418_length_790_cov_5.493488	324	404	0	80	80	1.0000000
NODE_12434_length_790_cov_1.463097	313	376	0	23	63	0.3650794
NODE_12434_length_790_cov_1.463097	313	376	2	40	63	0.6349207
NODE_12452_length_789_cov_39.123188	226	306	0	78	80	0.9750000
NODE_12452_length_789_cov_39.123188	226	306	2	2	80	0.0250000
NODE_12452_length_789_cov_39.123188	279	359	0	80	80	1.0000000
NODE_12453_length_789_cov_37.205797	423	503	0	80	80	1.0000000
NODE_12453_length_789_cov_37.205797	476	556	0	80	80	1.0000000
NODE_12454_length_789_cov_31.311594	223	303	0	80	80	1.0000000
NODE_12454_length_789_cov_31.311594	276	356	0	80	80	1.0000000
NODE_12455_length_789_cov_30.536232	306	386	3	9	80	0.1125000
NODE_12455_length_789_cov_30.536232	306	386	4	6	80	0.0750000
NODE_12455_length_789_cov_30.536232	306	386	7	2	80	0.0250000
NODE_12455_length_789_cov_30.536232	306	386	8	26	80	0.3250000
NODE_12455_length_789_cov_30.536232	306	386	9	27	80	0.3375000
NODE_12455_length_789_cov_30.536232	306	386	10	10	80	0.1250000
NODE_12455_length_789_cov_30.536232	359	439	4	59	80	0.7375000
NODE_12455_length_789_cov_30.536232	359	439	8	12	80	0.1500000
NODE_12455_length_789_cov_30.536232	359	439	10	9	80	0.1125000
NODE_12456_length_789_cov_24.886957	343	423	0	80	80	1.0000000
NODE_12456_length_789_cov_24.886957	396	476	0	80	80	1.0000000
NODE_12457_length_789_cov_23.539130	357	437	0	8	80	0.1000000
NODE_12457_length_789_cov_23.539130	357	437	2	42	80	0.5250000
NODE_12457_length_789_cov_23.539130	357	437	4	30	80	0.3750000
NODE_12457_length_789_cov_23.539130	410	490	0	8	80	0.1000000
NODE_12457_length_789_cov_23.539130	410	490	2	39	80	0.4875000
NODE_12457_length_789_cov_23.539130	410	490	4	33	80	0.4125000
NODE_12458_length_789_cov_16.169565	392	472	0	74	80	0.9250000
NODE_12458_length_789_cov_16.169565	392	472	2	6	80	0.0750000
NODE_12458_length_789_cov_16.169565	445	525	0	80	80	1.0000000
NODE_12459_length_789_cov_15.175362	242	322	0	80	80	1.0000000
NODE_12459_length_789_cov_15.175362	295	375	0	80	80	1.0000000
NODE_12459_length_789_cov_15.175362	371	451	0	80	80	1.0000000
NODE_12459_length_789_cov_15.175362	424	504	0	80	80	1.0000000
NODE_12460_length_789_cov_7.276812	306	386	0	80	80	1.0000000
NODE_12460_length_789_cov_7.276812	359	439	0	80	80	1.0000000
NODE_12482_length_788_cov_43.091437	335	415	6	5	80	0.0625000
NODE_12482_length_788_cov_43.091437	335	415	8	64	80	0.8000000
NODE_12482_length_788_cov_43.091437	335	415	10	11	80	0.1375000
NODE_12482_length_788_cov_43.091437	388	460	4	4	72	0.0555556
NODE_12482_length_788_cov_43.091437	388	460	7	1	72	0.0138889
NODE_12482_length_788_cov_43.091437	388	460	8	67	72	0.9305556
NODE_12483_length_788_cov_38.914369	345	425	1	33	80	0.4125000
NODE_12483_length_788_cov_38.914369	345	425	7	47	80	0.5875000
NODE_12483_length_788_cov_38.914369	398	478	0	33	80	0.4125000
NODE_12483_length_788_cov_38.914369	398	478	6	7	80	0.0875000
NODE_12483_length_788_cov_38.914369	398	478	7	40	80	0.5000000
NODE_12484_length_788_cov_36.148041	320	400	0	80	80	1.0000000
NODE_12484_length_788_cov_36.148041	373	453	0	80	80	1.0000000
NODE_12485_length_788_cov_35.460087	346	426	0	80	80	1.0000000
NODE_12485_length_788_cov_35.460087	399	479	0	80	80	1.0000000
NODE_12486_length_788_cov_30.785196	278	358	0	80	80	1.0000000
NODE_12486_length_788_cov_30.785196	331	411	0	56	80	0.7000000
NODE_12486_length_788_cov_30.785196	331	411	2	24	80	0.3000000
NODE_12488_length_788_cov_20.867925	300	380	1	4	80	0.0500000
NODE_12488_length_788_cov_20.867925	300	380	2	76	80	0.9500000
NODE_12488_length_788_cov_20.867925	353	430	0	49	77	0.6363636
NODE_12488_length_788_cov_20.867925	353	430	1	5	77	0.0649351
NODE_12488_length_788_cov_20.867925	353	430	2	23	77	0.2987013
NODE_12489_length_788_cov_20.821480	322	402	0	80	80	1.0000000
NODE_12489_length_788_cov_20.821480	375	455	0	80	80	1.0000000
NODE_12490_length_788_cov_15.570392	342	422	0	80	80	1.0000000
NODE_12490_length_788_cov_15.570392	395	475	0	80	80	1.0000000
NODE_12491_length_788_cov_12.235123	241	321	0	80	80	1.0000000
NODE_12491_length_788_cov_12.235123	294	374	0	80	80	1.0000000
NODE_12492_length_788_cov_10.509434	405	480	0	75	75	1.0000000
NODE_12493_length_788_cov_9.737300	310	390	0	80	80	1.0000000
NODE_12493_length_788_cov_9.737300	363	443	0	37	80	0.4625000
NODE_12493_length_788_cov_9.737300	363	443	2	43	80	0.5375000
NODE_12494_length_788_cov_8.872279	280	360	4	3	80	0.0375000
NODE_12494_length_788_cov_8.872279	280	360	6	16	80	0.2000000
NODE_12494_length_788_cov_8.872279	280	360	9	10	80	0.1250000
NODE_12494_length_788_cov_8.872279	280	360	12	34	80	0.4250000
NODE_12494_length_788_cov_8.872279	280	360	14	17	80	0.2125000
NODE_12494_length_788_cov_8.872279	333	413	10	43	80	0.5375000
NODE_12494_length_788_cov_8.872279	333	413	12	37	80	0.4625000
NODE_12516_length_787_cov_34.683140	274	335	0	61	61	1.0000000
NODE_12516_length_787_cov_34.683140	319	380	0	61	61	1.0000000
NODE_12517_length_787_cov_28.039244	252	329	8	39	77	0.5064935
NODE_12517_length_787_cov_28.039244	252	329	15	4	77	0.0519481
NODE_12517_length_787_cov_28.039244	252	329	16	34	77	0.4415585
NODE_12517_length_787_cov_28.039244	302	370	8	17	68	0.2500000
NODE_12517_length_787_cov_28.039244	302	370	14	12	68	0.1764706
NODE_12517_length_787_cov_28.039244	302	370	15	16	68	0.2352941
NODE_12517_length_787_cov_28.039244	302	370	16	23	68	0.3382353
NODE_12518_length_787_cov_25.422965	351	431	0	54	80	0.6750000
NODE_12518_length_787_cov_25.422965	351	431	2	26	80	0.3250000
NODE_12518_length_787_cov_25.422965	404	484	0	29	80	0.3625000
NODE_12518_length_787_cov_25.422965	404	484	2	51	80	0.6375000
NODE_12519_length_787_cov_24.857558	319	399	1	22	80	0.2750000
NODE_12519_length_787_cov_24.857558	319	399	2	58	80	0.7250000
NODE_12519_length_787_cov_24.857558	372	452	0	19	80	0.2375000
NODE_12519_length_787_cov_24.857558	372	452	1	56	80	0.7000000
NODE_12519_length_787_cov_24.857558	372	452	2	5	80	0.0625000
NODE_12520_length_787_cov_21.357558	291	371	0	38	80	0.4750000
NODE_12520_length_787_cov_21.357558	291	371	2	42	80	0.5250000
NODE_12520_length_787_cov_21.357558	344	424	2	65	80	0.8125000
NODE_12520_length_787_cov_21.357558	344	424	4	15	80	0.1875000
NODE_12521_length_787_cov_17.360465	396	476	2	80	80	1.0000000
NODE_12521_length_787_cov_17.360465	449	529	0	28	80	0.3500000
NODE_12521_length_787_cov_17.360465	449	529	2	52	80	0.6500000
NODE_12522_length_787_cov_14.677326	178	258	0	57	80	0.7125000
NODE_12522_length_787_cov_14.677326	178	258	4	23	80	0.2875000
NODE_12522_length_787_cov_14.677326	231	311	0	4	80	0.0500000
NODE_12522_length_787_cov_14.677326	231	311	4	40	80	0.5000000
NODE_12522_length_787_cov_14.677326	231	311	8	36	80	0.4500000
NODE_12523_length_787_cov_12.959302	331	411	0	80	80	1.0000000
NODE_12523_length_787_cov_12.959302	384	464	0	80	80	1.0000000
NODE_12524_length_787_cov_12.748547	426	506	0	57	80	0.7125000
NODE_12524_length_787_cov_12.748547	426	506	4	23	80	0.2875000
NODE_12524_length_787_cov_12.748547	479	559	0	4	80	0.0500000
NODE_12524_length_787_cov_12.748547	479	559	3	2	80	0.0250000
NODE_12524_length_787_cov_12.748547	479	559	4	74	80	0.9250000
NODE_12525_length_787_cov_12.369186	338	418	4	32	80	0.4000000
NODE_12525_length_787_cov_12.369186	338	418	8	28	80	0.3500000
NODE_12525_length_787_cov_12.369186	338	418	10	9	80	0.1125000
NODE_12525_length_787_cov_12.369186	338	418	12	11	80	0.1375000
NODE_12525_length_787_cov_12.369186	391	471	0	15	80	0.1875000
NODE_12525_length_787_cov_12.369186	391	471	8	65	80	0.8125000
NODE_12526_length_787_cov_9.213663	376	456	0	80	80	1.0000000
NODE_12527_length_787_cov_8.857558	344	424	0	24	80	0.3000000
NODE_12527_length_787_cov_8.857558	344	424	2	5	80	0.0625000
NODE_12527_length_787_cov_8.857558	344	424	8	12	80	0.1500000
NODE_12527_length_787_cov_8.857558	344	424	10	30	80	0.3750000
NODE_12527_length_787_cov_8.857558	344	424	16	9	80	0.1125000
NODE_12527_length_787_cov_8.857558	397	477	10	18	80	0.2250000
NODE_12527_length_787_cov_8.857558	397	477	12	17	80	0.2125000
NODE_12527_length_787_cov_8.857558	397	477	14	14	80	0.1750000
NODE_12527_length_787_cov_8.857558	397	477	16	31	80	0.3875000
NODE_12529_length_787_cov_8.186047	508	552	0	44	44	1.0000000
NODE_12541_length_787_cov_2.188953	505	552	0	47	47	1.0000000
NODE_12562_length_786_cov_36.441048	431	511	1	33	80	0.4125000
NODE_12562_length_786_cov_36.441048	431	511	2	47	80	0.5875000
NODE_12562_length_786_cov_36.441048	484	564	1	37	80	0.4625000
NODE_12562_length_786_cov_36.441048	484	564	2	43	80	0.5375000
NODE_12563_length_786_cov_23.771470	235	315	0	80	80	1.0000000
NODE_12563_length_786_cov_23.771470	288	368	0	80	80	1.0000000
NODE_12564_length_786_cov_23.333333	361	436	0	22	75	0.2933333
NODE_12564_length_786_cov_23.333333	361	436	2	8	75	0.1066667
NODE_12564_length_786_cov_23.333333	361	436	4	13	75	0.1733333
NODE_12564_length_786_cov_23.333333	361	436	8	12	75	0.1600000
NODE_12564_length_786_cov_23.333333	361	436	14	3	75	0.0400000
NODE_12564_length_786_cov_23.333333	361	436	20	2	75	0.0266667
NODE_12564_length_786_cov_23.333333	361	436	22	9	75	0.1200000
NODE_12564_length_786_cov_23.333333	361	436	26	2	75	0.0266667
NODE_12564_length_786_cov_23.333333	361	436	29	1	75	0.0133333
NODE_12564_length_786_cov_23.333333	361	436	30	3	75	0.0400000
NODE_12564_length_786_cov_23.333333	362	436	0	21	74	0.2837838
NODE_12564_length_786_cov_23.333333	362	436	2	8	74	0.1081081
NODE_12564_length_786_cov_23.333333	362	436	4	13	74	0.1756757
NODE_12564_length_786_cov_23.333333	362	436	8	12	74	0.1621622
NODE_12564_length_786_cov_23.333333	362	436	14	3	74	0.0405405
NODE_12564_length_786_cov_23.333333	362	436	20	2	74	0.0270270
NODE_12564_length_786_cov_23.333333	362	436	22	9	74	0.1216216
NODE_12564_length_786_cov_23.333333	362	436	26	2	74	0.0270270
NODE_12564_length_786_cov_23.333333	362	436	29	1	74	0.0135135
NODE_12564_length_786_cov_23.333333	362	436	30	3	74	0.0405405
NODE_12564_length_786_cov_23.333333	375	436	0	8	61	0.1311475
NODE_12564_length_786_cov_23.333333	375	436	2	8	61	0.1311475
NODE_12564_length_786_cov_23.333333	375	436	4	13	61	0.2131148
NODE_12564_length_786_cov_23.333333	375	436	8	12	61	0.1967213
NODE_12564_length_786_cov_23.333333	375	436	14	3	61	0.0491803
NODE_12564_length_786_cov_23.333333	375	436	20	2	61	0.0327869
NODE_12564_length_786_cov_23.333333	375	436	22	9	61	0.1475410
NODE_12564_length_786_cov_23.333333	375	436	26	2	61	0.0327869
NODE_12564_length_786_cov_23.333333	375	436	29	1	61	0.0163934
NODE_12564_length_786_cov_23.333333	375	436	30	3	61	0.0491803
NODE_12564_length_786_cov_23.333333	414	489	8	2	75	0.0266667
NODE_12564_length_786_cov_23.333333	414	489	14	3	75	0.0400000
NODE_12564_length_786_cov_23.333333	414	489	20	2	75	0.0266667
NODE_12564_length_786_cov_23.333333	414	489	22	9	75	0.1200000
NODE_12564_length_786_cov_23.333333	414	489	26	2	75	0.0266667
NODE_12564_length_786_cov_23.333333	414	489	29	1	75	0.0133333
NODE_12564_length_786_cov_23.333333	414	489	30	24	75	0.3200000
NODE_12564_length_786_cov_23.333333	414	489	31	8	75	0.1066667
NODE_12564_length_786_cov_23.333333	414	489	32	24	75	0.3200000
NODE_12564_length_786_cov_23.333333	414	489	8	2	75	0.0266667
NODE_12564_length_786_cov_23.333333	414	489	14	3	75	0.0400000
NODE_12564_length_786_cov_23.333333	414	489	20	2	75	0.0266667
NODE_12564_length_786_cov_23.333333	414	489	22	9	75	0.1200000
NODE_12564_length_786_cov_23.333333	414	489	26	2	75	0.0266667
NODE_12564_length_786_cov_23.333333	414	489	29	1	75	0.0133333
NODE_12564_length_786_cov_23.333333	414	489	30	24	75	0.3200000
NODE_12564_length_786_cov_23.333333	414	489	31	8	75	0.1066667
NODE_12564_length_786_cov_23.333333	414	489	32	24	75	0.3200000
NODE_12564_length_786_cov_23.333333	414	489	8	2	75	0.0266667
NODE_12564_length_786_cov_23.333333	414	489	14	3	75	0.0400000
NODE_12564_length_786_cov_23.333333	414	489	20	2	75	0.0266667
NODE_12564_length_786_cov_23.333333	414	489	22	9	75	0.1200000
NODE_12564_length_786_cov_23.333333	414	489	26	2	75	0.0266667
NODE_12564_length_786_cov_23.333333	414	489	29	1	75	0.0133333
NODE_12564_length_786_cov_23.333333	414	489	30	24	75	0.3200000
NODE_12564_length_786_cov_23.333333	414	489	31	8	75	0.1066667
NODE_12564_length_786_cov_23.333333	414	489	32	24	75	0.3200000
NODE_12564_length_786_cov_23.333333	490	564	8	7	74	0.0945946
NODE_12564_length_786_cov_23.333333	490	564	10	17	74	0.2297297
NODE_12564_length_786_cov_23.333333	490	564	11	2	74	0.0270270
NODE_12564_length_786_cov_23.333333	490	564	15	4	74	0.0540541
NODE_12564_length_786_cov_23.333333	490	564	21	7	74	0.0945946
NODE_12564_length_786_cov_23.333333	490	564	23	8	74	0.1081081
NODE_12564_length_786_cov_23.333333	490	564	27	17	74	0.2297297
NODE_12564_length_786_cov_23.333333	490	564	31	12	74	0.1621622
NODE_12565_length_786_cov_19.279476	310	375	0	65	65	1.0000000
NODE_12565_length_786_cov_19.279476	371	441	0	70	70	1.0000000
NODE_12565_length_786_cov_19.279476	371	451	0	80	80	1.0000000
NODE_12565_length_786_cov_19.279476	424	491	0	67	67	1.0000000
NODE_12566_length_786_cov_18.652111	251	331	0	80	80	1.0000000
NODE_12566_length_786_cov_18.652111	304	384	0	80	80	1.0000000
NODE_12567_length_786_cov_16.704512	319	399	0	80	80	1.0000000
NODE_12567_length_786_cov_16.704512	372	452	0	80	80	1.0000000
NODE_12568_length_786_cov_16.254731	378	458	0	25	80	0.3125000
NODE_12568_length_786_cov_16.254731	378	458	2	55	80	0.6875000
NODE_12568_length_786_cov_16.254731	431	511	0	69	80	0.8625000
NODE_12568_length_786_cov_16.254731	431	511	2	11	80	0.1375000
NODE_12571_length_786_cov_10.053857	381	461	0	80	80	1.0000000
NODE_12571_length_786_cov_10.053857	434	514	0	80	80	1.0000000
NODE_12572_length_786_cov_7.455604	400	473	0	73	73	1.0000000
NODE_12572_length_786_cov_7.455604	453	533	0	80	80	1.0000000
NODE_12573_length_786_cov_7.119360	276	356	0	16	80	0.2000000
NODE_12573_length_786_cov_7.119360	276	356	4	2	80	0.0250000
NODE_12573_length_786_cov_7.119360	276	356	8	62	80	0.7750000
NODE_12573_length_786_cov_7.119360	329	409	8	80	80	1.0000000
NODE_12575_length_786_cov_6.771470	382	462	0	80	80	1.0000000
NODE_12575_length_786_cov_6.771470	435	515	0	80	80	1.0000000
NODE_12603_length_785_cov_83.972303	315	395	0	80	80	1.0000000
NODE_12603_length_785_cov_83.972303	368	448	0	80	80	1.0000000
NODE_12604_length_785_cov_33.911079	477	557	0	31	80	0.3875000
NODE_12604_length_785_cov_33.911079	477	557	8	25	80	0.3125000
NODE_12604_length_785_cov_33.911079	477	557	10	24	80	0.3000000
NODE_12604_length_785_cov_33.911079	530	610	0	8	80	0.1000000
NODE_12604_length_785_cov_33.911079	530	610	2	2	80	0.0250000
NODE_12604_length_785_cov_33.911079	530	610	8	3	80	0.0375000
NODE_12604_length_785_cov_33.911079	530	610	10	67	80	0.8375000
NODE_12605_length_785_cov_21.174927	265	299	6	25	34	0.7352941
NODE_12605_length_785_cov_21.174927	265	299	10	9	34	0.2647059
NODE_12605_length_785_cov_21.174927	295	375	4	23	80	0.2875000
NODE_12605_length_785_cov_21.174927	295	375	6	15	80	0.1875000
NODE_12605_length_785_cov_21.174927	295	375	8	35	80	0.4375000
NODE_12605_length_785_cov_21.174927	295	375	10	7	80	0.0875000
NODE_12605_length_785_cov_21.174927	348	428	0	43	80	0.5375000
NODE_12605_length_785_cov_21.174927	348	428	4	33	80	0.4125000
NODE_12605_length_785_cov_21.174927	348	428	6	4	80	0.0500000
NODE_12606_length_785_cov_18.612245	291	371	0	26	80	0.3250000
NODE_12606_length_785_cov_18.612245	291	371	4	2	80	0.0250000
NODE_12606_length_785_cov_18.612245	291	371	8	9	80	0.1125000
NODE_12606_length_785_cov_18.612245	291	371	10	43	80	0.5375000
NODE_12606_length_785_cov_18.612245	344	424	0	5	80	0.0625000
NODE_12606_length_785_cov_18.612245	344	424	4	6	80	0.0750000
NODE_12606_length_785_cov_18.612245	344	424	10	69	80	0.8625000
NODE_12606_length_785_cov_18.612245	684	705	2	21	21	1.0000000
NODE_12607_length_785_cov_9.893586	153	233	0	34	80	0.4250000
NODE_12607_length_785_cov_9.893586	153	233	2	46	80	0.5750000
NODE_12607_length_785_cov_9.893586	206	286	0	80	80	1.0000000
NODE_12645_length_784_cov_203.604380	5	85	149	1	80	0.0125000
NODE_12645_length_784_cov_203.604380	5	85	150	1	80	0.0125000
NODE_12645_length_784_cov_203.604380	5	85	156	1	80	0.0125000
NODE_12645_length_784_cov_203.604380	5	85	168	1	80	0.0125000
NODE_12645_length_784_cov_203.604380	5	85	198	1	80	0.0125000
NODE_12645_length_784_cov_203.604380	5	85	208	1	80	0.0125000
NODE_12645_length_784_cov_203.604380	5	85	243	1	80	0.0125000
NODE_12645_length_784_cov_203.604380	5	85	250	1	80	0.0125000
NODE_12645_length_784_cov_203.604380	5	85	276	1	80	0.0125000
NODE_12645_length_784_cov_203.604380	5	85	280	1	80	0.0125000
NODE_12645_length_784_cov_203.604380	5	85	302	1	80	0.0125000
NODE_12645_length_784_cov_203.604380	5	85	308	1	80	0.0125000
NODE_12645_length_784_cov_203.604380	5	85	317	1	80	0.0125000
NODE_12645_length_784_cov_203.604380	5	85	359	1	80	0.0125000
NODE_12645_length_784_cov_203.604380	5	85	373	1	80	0.0125000
NODE_12645_length_784_cov_203.604380	5	85	374	1	80	0.0125000
NODE_12645_length_784_cov_203.604380	5	85	414	1	80	0.0125000
NODE_12645_length_784_cov_203.604380	5	85	426	1	80	0.0125000
NODE_12645_length_784_cov_203.604380	5	85	440	1	80	0.0125000
NODE_12645_length_784_cov_203.604380	5	85	447	1	80	0.0125000
NODE_12645_length_784_cov_203.604380	5	85	463	1	80	0.0125000
NODE_12645_length_784_cov_203.604380	5	85	481	1	80	0.0125000
NODE_12645_length_784_cov_203.604380	5	85	486	1	80	0.0125000
NODE_12645_length_784_cov_203.604380	5	85	496	1	80	0.0125000
NODE_12645_length_784_cov_203.604380	5	85	504	1	80	0.0125000
NODE_12645_length_784_cov_203.604380	5	85	513	1	80	0.0125000
NODE_12645_length_784_cov_203.604380	5	85	524	1	80	0.0125000
NODE_12645_length_784_cov_203.604380	5	85	530	1	80	0.0125000
NODE_12645_length_784_cov_203.604380	5	85	532	1	80	0.0125000
NODE_12645_length_784_cov_203.604380	5	85	536	1	80	0.0125000
NODE_12645_length_784_cov_203.604380	5	85	546	1	80	0.0125000
NODE_12645_length_784_cov_203.604380	5	85	552	1	80	0.0125000
NODE_12645_length_784_cov_203.604380	5	85	562	1	80	0.0125000
NODE_12645_length_784_cov_203.604380	5	85	569	1	80	0.0125000
NODE_12645_length_784_cov_203.604380	5	85	574	1	80	0.0125000
NODE_12645_length_784_cov_203.604380	5	85	581	1	80	0.0125000
NODE_12645_length_784_cov_203.604380	5	85	598	1	80	0.0125000
NODE_12645_length_784_cov_203.604380	5	85	610	1	80	0.0125000
NODE_12645_length_784_cov_203.604380	5	85	646	1	80	0.0125000
NODE_12645_length_784_cov_203.604380	5	85	652	1	80	0.0125000
NODE_12645_length_784_cov_203.604380	5	85	657	1	80	0.0125000
NODE_12645_length_784_cov_203.604380	5	85	661	1	80	0.0125000
NODE_12645_length_784_cov_203.604380	5	85	670	1	80	0.0125000
NODE_12645_length_784_cov_203.604380	5	85	673	2	80	0.0250000
NODE_12645_length_784_cov_203.604380	5	85	676	1	80	0.0125000
NODE_12645_length_784_cov_203.604380	5	85	680	1	80	0.0125000
NODE_12645_length_784_cov_203.604380	5	85	686	1	80	0.0125000
NODE_12645_length_784_cov_203.604380	5	85	688	1	80	0.0125000
NODE_12645_length_784_cov_203.604380	5	85	689	1	80	0.0125000
NODE_12645_length_784_cov_203.604380	5	85	694	1	80	0.0125000
NODE_12645_length_784_cov_203.604380	5	85	698	1	80	0.0125000
NODE_12645_length_784_cov_203.604380	5	85	700	1	80	0.0125000
NODE_12645_length_784_cov_203.604380	5	85	715	1	80	0.0125000
NODE_12645_length_784_cov_203.604380	5	85	718	1	80	0.0125000
NODE_12645_length_784_cov_203.604380	5	85	719	2	80	0.0250000
NODE_12645_length_784_cov_203.604380	5	85	720	1	80	0.0125000
NODE_12645_length_784_cov_203.604380	5	85	728	1	80	0.0125000
NODE_12645_length_784_cov_203.604380	5	85	734	3	80	0.0375000
NODE_12645_length_784_cov_203.604380	5	85	736	1	80	0.0125000
NODE_12645_length_784_cov_203.604380	5	85	739	1	80	0.0125000
NODE_12645_length_784_cov_203.604380	5	85	740	1	80	0.0125000
NODE_12645_length_784_cov_203.604380	5	85	742	1	80	0.0125000
NODE_12645_length_784_cov_203.604380	5	85	751	1	80	0.0125000
NODE_12645_length_784_cov_203.604380	5	85	758	1	80	0.0125000
NODE_12645_length_784_cov_203.604380	5	85	768	1	80	0.0125000
NODE_12645_length_784_cov_203.604380	5	85	773	1	80	0.0125000
NODE_12645_length_784_cov_203.604380	5	85	777	1	80	0.0125000
NODE_12645_length_784_cov_203.604380	5	85	780	1	80	0.0125000
NODE_12645_length_784_cov_203.604380	5	85	782	2	80	0.0250000
NODE_12645_length_784_cov_203.604380	5	85	784	1	80	0.0125000
NODE_12645_length_784_cov_203.604380	5	85	785	2	80	0.0250000
NODE_12645_length_784_cov_203.604380	5	85	792	1	80	0.0125000
NODE_12645_length_784_cov_203.604380	5	85	793	1	80	0.0125000
NODE_12645_length_784_cov_203.604380	5	85	796	1	80	0.0125000
NODE_12645_length_784_cov_203.604380	58	138	649	1	80	0.0125000
NODE_12645_length_784_cov_203.604380	58	138	651	1	80	0.0125000
NODE_12645_length_784_cov_203.604380	58	138	654	2	80	0.0250000
NODE_12645_length_784_cov_203.604380	58	138	658	1	80	0.0125000
NODE_12645_length_784_cov_203.604380	58	138	671	1	80	0.0125000
NODE_12645_length_784_cov_203.604380	58	138	685	1	80	0.0125000
NODE_12645_length_784_cov_203.604380	58	138	687	1	80	0.0125000
NODE_12645_length_784_cov_203.604380	58	138	690	1	80	0.0125000
NODE_12645_length_784_cov_203.604380	58	138	700	1	80	0.0125000
NODE_12645_length_784_cov_203.604380	58	138	701	1	80	0.0125000
NODE_12645_length_784_cov_203.604380	58	138	702	1	80	0.0125000
NODE_12645_length_784_cov_203.604380	58	138	715	1	80	0.0125000
NODE_12645_length_784_cov_203.604380	58	138	716	1	80	0.0125000
NODE_12645_length_784_cov_203.604380	58	138	718	1	80	0.0125000
NODE_12645_length_784_cov_203.604380	58	138	719	2	80	0.0250000
NODE_12645_length_784_cov_203.604380	58	138	720	1	80	0.0125000
NODE_12645_length_784_cov_203.604380	58	138	728	1	80	0.0125000
NODE_12645_length_784_cov_203.604380	58	138	731	1	80	0.0125000
NODE_12645_length_784_cov_203.604380	58	138	734	3	80	0.0375000
NODE_12645_length_784_cov_203.604380	58	138	736	1	80	0.0125000
NODE_12645_length_784_cov_203.604380	58	138	739	1	80	0.0125000
NODE_12645_length_784_cov_203.604380	58	138	740	1	80	0.0125000
NODE_12645_length_784_cov_203.604380	58	138	742	1	80	0.0125000
NODE_12645_length_784_cov_203.604380	58	138	743	1	80	0.0125000
NODE_12645_length_784_cov_203.604380	58	138	749	2	80	0.0250000
NODE_12645_length_784_cov_203.604380	58	138	751	1	80	0.0125000
NODE_12645_length_784_cov_203.604380	58	138	757	1	80	0.0125000
NODE_12645_length_784_cov_203.604380	58	138	758	1	80	0.0125000
NODE_12645_length_784_cov_203.604380	58	138	765	1	80	0.0125000
NODE_12645_length_784_cov_203.604380	58	138	767	1	80	0.0125000
NODE_12645_length_784_cov_203.604380	58	138	768	1	80	0.0125000
NODE_12645_length_784_cov_203.604380	58	138	771	1	80	0.0125000
NODE_12645_length_784_cov_203.604380	58	138	773	1	80	0.0125000
NODE_12645_length_784_cov_203.604380	58	138	777	1	80	0.0125000
NODE_12645_length_784_cov_203.604380	58	138	780	1	80	0.0125000
NODE_12645_length_784_cov_203.604380	58	138	782	3	80	0.0375000
NODE_12645_length_784_cov_203.604380	58	138	783	1	80	0.0125000
NODE_12645_length_784_cov_203.604380	58	138	784	2	80	0.0250000
NODE_12645_length_784_cov_203.604380	58	138	785	2	80	0.0250000
NODE_12645_length_784_cov_203.604380	58	138	788	1	80	0.0125000
NODE_12645_length_784_cov_203.604380	58	138	792	1	80	0.0125000
NODE_12645_length_784_cov_203.604380	58	138	793	1	80	0.0125000
NODE_12645_length_784_cov_203.604380	58	138	795	1	80	0.0125000
NODE_12645_length_784_cov_203.604380	58	138	796	1	80	0.0125000
NODE_12645_length_784_cov_203.604380	58	138	801	1	80	0.0125000
NODE_12645_length_784_cov_203.604380	58	138	802	1	80	0.0125000
NODE_12645_length_784_cov_203.604380	58	138	804	2	80	0.0250000
NODE_12645_length_784_cov_203.604380	58	138	808	1	80	0.0125000
NODE_12645_length_784_cov_203.604380	58	138	810	1	80	0.0125000
NODE_12645_length_784_cov_203.604380	58	138	811	1	80	0.0125000
NODE_12645_length_784_cov_203.604380	58	138	813	1	80	0.0125000
NODE_12645_length_784_cov_203.604380	58	138	818	1	80	0.0125000
NODE_12645_length_784_cov_203.604380	58	138	824	1	80	0.0125000
NODE_12645_length_784_cov_203.604380	58	138	830	2	80	0.0250000
NODE_12645_length_784_cov_203.604380	58	138	834	3	80	0.0375000
NODE_12645_length_784_cov_203.604380	58	138	838	1	80	0.0125000
NODE_12645_length_784_cov_203.604380	58	138	841	1	80	0.0125000
NODE_12645_length_784_cov_203.604380	58	138	843	1	80	0.0125000
NODE_12645_length_784_cov_203.604380	58	138	848	1	80	0.0125000
NODE_12645_length_784_cov_203.604380	58	138	851	3	80	0.0375000
NODE_12645_length_784_cov_203.604380	58	138	852	1	80	0.0125000
NODE_12645_length_784_cov_203.604380	58	138	854	1	80	0.0125000
NODE_12645_length_784_cov_203.604380	58	138	856	2	80	0.0250000
NODE_12645_length_784_cov_203.604380	58	138	858	1	80	0.0125000
NODE_12646_length_784_cov_45.210219	49	129	0	80	80	1.0000000
NODE_12646_length_784_cov_45.210219	102	182	0	80	80	1.0000000
NODE_12646_length_784_cov_45.210219	218	298	0	80	80	1.0000000
NODE_12646_length_784_cov_45.210219	271	351	0	80	80	1.0000000
NODE_12646_length_784_cov_45.210219	347	427	0	80	80	1.0000000
NODE_12646_length_784_cov_45.210219	347	427	0	80	80	1.0000000
NODE_12646_length_784_cov_45.210219	347	427	0	80	80	1.0000000
NODE_12646_length_784_cov_45.210219	400	447	0	47	47	1.0000000
NODE_12646_length_784_cov_45.210219	400	480	0	80	80	1.0000000
NODE_12646_length_784_cov_45.210219	400	455	0	55	55	1.0000000
NODE_12647_length_784_cov_33.543066	405	485	0	50	80	0.6250000
NODE_12647_length_784_cov_33.543066	405	485	12	30	80	0.3750000
NODE_12647_length_784_cov_33.543066	458	538	0	80	80	1.0000000
NODE_12648_length_784_cov_21.762044	318	398	0	80	80	1.0000000
NODE_12648_length_784_cov_21.762044	371	451	0	80	80	1.0000000
NODE_12649_length_784_cov_20.583942	286	366	0	80	80	1.0000000
NODE_12649_length_784_cov_20.583942	339	419	0	80	80	1.0000000
NODE_12649_length_784_cov_20.583942	415	495	0	80	80	1.0000000
NODE_12649_length_784_cov_20.583942	468	548	0	80	80	1.0000000
NODE_12650_length_784_cov_19.448175	217	297	0	80	80	1.0000000
NODE_12650_length_784_cov_19.448175	270	350	0	80	80	1.0000000
NODE_12652_length_784_cov_12.480292	297	377	0	8	80	0.1000000
NODE_12652_length_784_cov_12.480292	297	377	2	72	80	0.9000000
NODE_12652_length_784_cov_12.480292	350	430	0	61	80	0.7625000
NODE_12652_length_784_cov_12.480292	350	430	2	19	80	0.2375000
NODE_12653_length_784_cov_9.296350	250	330	0	80	80	1.0000000
NODE_12653_length_784_cov_9.296350	303	383	0	80	80	1.0000000
NODE_12653_length_784_cov_9.296350	379	459	0	80	80	1.0000000
NODE_12653_length_784_cov_9.296350	432	512	0	80	80	1.0000000
NODE_12654_length_784_cov_6.316788	274	354	0	80	80	1.0000000
NODE_12654_length_784_cov_6.316788	327	407	0	80	80	1.0000000
NODE_12688_length_783_cov_41.849415	459	539	0	80	80	1.0000000
NODE_12688_length_783_cov_41.849415	512	592	0	80	80	1.0000000
NODE_12689_length_783_cov_39.881579	230	310	0	80	80	1.0000000
NODE_12689_length_783_cov_39.881579	283	363	0	80	80	1.0000000
NODE_12689_length_783_cov_39.881579	359	439	0	80	80	1.0000000
NODE_12689_length_783_cov_39.881579	412	492	0	80	80	1.0000000
NODE_12690_length_783_cov_35.967836	229	309	0	80	80	1.0000000
NODE_12690_length_783_cov_35.967836	282	362	0	32	80	0.4000000
NODE_12690_length_783_cov_35.967836	282	362	2	48	80	0.6000000
NODE_12691_length_783_cov_28.203216	292	372	2	41	80	0.5125000
NODE_12691_length_783_cov_28.203216	292	372	3	1	80	0.0125000
NODE_12691_length_783_cov_28.203216	292	372	4	38	80	0.4750000
NODE_12691_length_783_cov_28.203216	345	425	2	9	80	0.1125000
NODE_12691_length_783_cov_28.203216	345	425	3	45	80	0.5625000
NODE_12691_length_783_cov_28.203216	345	425	4	26	80	0.3250000
NODE_12692_length_783_cov_16.695906	393	473	0	80	80	1.0000000
NODE_12692_length_783_cov_16.695906	446	526	0	80	80	1.0000000
NODE_12693_length_783_cov_15.656433	418	498	0	80	80	1.0000000
NODE_12693_length_783_cov_15.656433	471	551	0	80	80	1.0000000
NODE_12694_length_783_cov_14.904971	321	401	0	24	80	0.3000000
NODE_12694_length_783_cov_14.904971	321	401	2	56	80	0.7000000
NODE_12694_length_783_cov_14.904971	374	454	0	45	80	0.5625000
NODE_12694_length_783_cov_14.904971	374	454	2	35	80	0.4375000
NODE_12728_length_782_cov_22.461201	347	427	3	41	80	0.5125000
NODE_12728_length_782_cov_22.461201	347	427	6	39	80	0.4875000
NODE_12728_length_782_cov_22.461201	400	480	3	28	80	0.3500000
NODE_12728_length_782_cov_22.461201	400	480	6	52	80	0.6500000
NODE_12729_length_782_cov_19.163982	306	386	0	16	80	0.2000000
NODE_12729_length_782_cov_19.163982	306	386	2	64	80	0.8000000
NODE_12729_length_782_cov_19.163982	382	462	0	2	80	0.0250000
NODE_12729_length_782_cov_19.163982	382	462	2	6	80	0.0750000
NODE_12729_length_782_cov_19.163982	382	462	5	1	80	0.0125000
NODE_12729_length_782_cov_19.163982	382	462	6	71	80	0.8875000
NODE_12729_length_782_cov_19.163982	435	515	0	31	80	0.3875000
NODE_12729_length_782_cov_19.163982	435	515	2	5	80	0.0625000
NODE_12729_length_782_cov_19.163982	435	515	6	44	80	0.5500000
NODE_12730_length_782_cov_19.090776	295	375	0	80	80	1.0000000
NODE_12730_length_782_cov_19.090776	348	428	0	80	80	1.0000000
NODE_12731_length_782_cov_13.509517	323	403	0	80	80	1.0000000
NODE_12731_length_782_cov_13.509517	376	456	0	39	80	0.4875000
NODE_12731_length_782_cov_13.509517	376	456	4	41	80	0.5125000
NODE_12732_length_782_cov_11.364568	367	447	0	80	80	1.0000000
NODE_12732_length_782_cov_11.364568	420	500	0	80	80	1.0000000
NODE_12735_length_782_cov_7.976574	245	325	0	80	80	1.0000000
NODE_12735_length_782_cov_7.976574	298	378	0	80	80	1.0000000
NODE_12737_length_782_cov_5.500732	384	464	0	80	80	1.0000000
NODE_12737_length_782_cov_5.500732	437	517	0	80	80	1.0000000
NODE_12739_length_782_cov_4.434846	309	389	0	80	80	1.0000000
NODE_12739_length_782_cov_4.434846	362	442	0	80	80	1.0000000
NODE_12740_length_782_cov_3.352855	177	196	0	19	19	1.0000000
NODE_12741_length_782_cov_3.231332	160	240	0	11	80	0.1375000
NODE_12741_length_782_cov_3.231332	160	240	2	69	80	0.8625000
NODE_12741_length_782_cov_3.231332	213	298	0	69	85	0.8117647
NODE_12741_length_782_cov_3.231332	213	298	2	16	85	0.1882353
NODE_12765_length_781_cov_34.247801	174	254	0	38	80	0.4750000
NODE_12765_length_781_cov_34.247801	174	254	2	42	80	0.5250000
NODE_12765_length_781_cov_34.247801	227	307	2	80	80	1.0000000
NODE_12766_length_781_cov_27.530792	490	570	2	37	80	0.4625000
NODE_12766_length_781_cov_27.530792	490	570	4	37	80	0.4625000
NODE_12766_length_781_cov_27.530792	490	570	6	6	80	0.0750000
NODE_12766_length_781_cov_27.530792	543	623	4	80	80	1.0000000
NODE_12766_length_781_cov_27.530792	619	699	0	43	80	0.5375000
NODE_12766_length_781_cov_27.530792	619	699	4	37	80	0.4625000
NODE_12766_length_781_cov_27.530792	672	752	0	80	80	1.0000000
NODE_12767_length_781_cov_22.768328	427	507	0	80	80	1.0000000
NODE_12767_length_781_cov_22.768328	480	560	0	80	80	1.0000000
NODE_12768_length_781_cov_17.894428	411	491	0	80	80	1.0000000
NODE_12768_length_781_cov_17.894428	464	544	0	80	80	1.0000000
NODE_12769_length_781_cov_14.922287	486	565	0	34	79	0.4303797
NODE_12769_length_781_cov_14.922287	486	565	2	45	79	0.5696203
NODE_12769_length_781_cov_14.922287	538	618	2	80	80	1.0000000
NODE_12770_length_781_cov_12.529326	318	398	0	80	80	1.0000000
NODE_12770_length_781_cov_12.529326	371	451	0	80	80	1.0000000
NODE_12771_length_781_cov_10.303519	444	524	2	3	80	0.0375000
NODE_12771_length_781_cov_10.303519	444	524	6	70	80	0.8750000
NODE_12771_length_781_cov_10.303519	444	524	8	7	80	0.0875000
NODE_12772_length_781_cov_9.851906	374	454	0	80	80	1.0000000
NODE_12772_length_781_cov_9.851906	427	507	0	80	80	1.0000000
NODE_12775_length_781_cov_8.557185	113	194	0	81	81	1.0000000
NODE_12775_length_781_cov_8.557185	166	239	0	73	73	1.0000000
NODE_12778_length_781_cov_4.734604	30	110	0	80	80	1.0000000
NODE_12778_length_781_cov_4.734604	83	163	0	80	80	1.0000000
NODE_12780_length_781_cov_4.077713	269	349	0	80	80	1.0000000
NODE_12780_length_781_cov_4.077713	322	402	0	80	80	1.0000000
NODE_12812_length_780_cov_37.693098	165	245	0	20	80	0.2500000
NODE_12812_length_780_cov_37.693098	165	245	2	49	80	0.6125000
NODE_12812_length_780_cov_37.693098	165	245	3	1	80	0.0125000
NODE_12812_length_780_cov_37.693098	165	245	4	4	80	0.0500000
NODE_12812_length_780_cov_37.693098	165	245	6	6	80	0.0750000
NODE_12812_length_780_cov_37.693098	218	298	2	16	80	0.2000000
NODE_12812_length_780_cov_37.693098	218	298	3	1	80	0.0125000
NODE_12812_length_780_cov_37.693098	218	298	4	5	80	0.0625000
NODE_12812_length_780_cov_37.693098	218	298	6	23	80	0.2875000
NODE_12812_length_780_cov_37.693098	218	298	8	35	80	0.4375000
NODE_12813_length_780_cov_22.132159	407	487	4	80	80	1.0000000
NODE_12813_length_780_cov_22.132159	460	540	0	41	80	0.5125000
NODE_12813_length_780_cov_22.132159	460	540	4	39	80	0.4875000
NODE_12814_length_780_cov_21.831131	299	379	0	11	80	0.1375000
NODE_12814_length_780_cov_21.831131	299	379	2	69	80	0.8625000
NODE_12814_length_780_cov_21.831131	352	432	0	13	80	0.1625000
NODE_12814_length_780_cov_21.831131	352	432	2	67	80	0.8375000
NODE_12815_length_780_cov_16.722467	165	245	0	80	80	1.0000000
NODE_12815_length_780_cov_16.722467	218	298	0	80	80	1.0000000
NODE_12816_length_780_cov_13.189427	150	254	0	104	104	1.0000000
NODE_12816_length_780_cov_13.189427	227	307	0	80	80	1.0000000
NODE_12817_length_780_cov_12.910426	276	356	0	22	80	0.2750000
NODE_12817_length_780_cov_12.910426	276	356	4	58	80	0.7250000
NODE_12817_length_780_cov_12.910426	329	409	0	30	80	0.3750000
NODE_12817_length_780_cov_12.910426	329	409	4	50	80	0.6250000
NODE_12818_length_780_cov_8.455213	141	221	0	24	80	0.3000000
NODE_12818_length_780_cov_8.455213	141	221	3	1	80	0.0125000
NODE_12818_length_780_cov_8.455213	141	221	4	55	80	0.6875000
NODE_12818_length_780_cov_8.455213	194	274	0	31	80	0.3875000
NODE_12818_length_780_cov_8.455213	194	274	4	49	80	0.6125000
NODE_12848_length_779_cov_51.022059	8	43	0	35	35	1.0000000
NODE_12848_length_779_cov_51.022059	53	96	0	43	43	1.0000000
NODE_12848_length_779_cov_51.022059	97	177	0	80	80	1.0000000
NODE_12848_length_779_cov_51.022059	150	230	0	80	80	1.0000000
NODE_12849_length_779_cov_23.682353	362	442	0	80	80	1.0000000
NODE_12849_length_779_cov_23.682353	415	495	0	76	80	0.9500000
NODE_12849_length_779_cov_23.682353	415	495	2	4	80	0.0500000
NODE_12850_length_779_cov_15.994118	320	400	2	2	80	0.0250000
NODE_12850_length_779_cov_15.994118	320	400	4	4	80	0.0500000
NODE_12850_length_779_cov_15.994118	320	400	6	40	80	0.5000000
NODE_12850_length_779_cov_15.994118	320	400	8	28	80	0.3500000
NODE_12850_length_779_cov_15.994118	320	400	10	6	80	0.0750000
NODE_12850_length_779_cov_15.994118	373	453	2	50	80	0.6250000
NODE_12850_length_779_cov_15.994118	373	453	4	9	80	0.1125000
NODE_12850_length_779_cov_15.994118	373	453	6	15	80	0.1875000
NODE_12850_length_779_cov_15.994118	373	453	8	6	80	0.0750000
NODE_12851_length_779_cov_14.386765	258	320	0	52	62	0.8387097
NODE_12851_length_779_cov_14.386765	258	320	2	10	62	0.1612903
NODE_12851_length_779_cov_14.386765	293	368	0	17	75	0.2266667
NODE_12851_length_779_cov_14.386765	293	368	2	58	75	0.7733333
NODE_12851_length_779_cov_14.386765	369	443	4	10	74	0.1351351
NODE_12851_length_779_cov_14.386765	369	443	6	10	74	0.1351351
NODE_12851_length_779_cov_14.386765	369	443	8	38	74	0.5135135
NODE_12851_length_779_cov_14.386765	369	443	10	16	74	0.2162162
NODE_12852_length_779_cov_11.861765	180	263	0	83	83	1.0000000
NODE_12852_length_779_cov_11.861765	236	316	0	80	80	1.0000000
NODE_12852_length_779_cov_11.861765	312	392	0	5	80	0.0625000
NODE_12852_length_779_cov_11.861765	312	392	2	4	80	0.0500000
NODE_12852_length_779_cov_11.861765	312	392	4	71	80	0.8875000
NODE_12852_length_779_cov_11.861765	365	445	0	33	80	0.4125000
NODE_12852_length_779_cov_11.861765	365	445	2	1	80	0.0125000
NODE_12852_length_779_cov_11.861765	365	445	4	46	80	0.5750000
NODE_12853_length_779_cov_11.735294	285	365	0	80	80	1.0000000
NODE_12853_length_779_cov_11.735294	338	418	0	80	80	1.0000000
NODE_12854_length_779_cov_7.211765	333	413	0	80	80	1.0000000
NODE_12854_length_779_cov_7.211765	386	466	0	80	80	1.0000000
NODE_12857_length_779_cov_5.611765	271	351	0	80	80	1.0000000
NODE_12857_length_779_cov_5.611765	324	404	0	80	80	1.0000000
NODE_12859_length_779_cov_4.695588	216	296	0	25	80	0.3125000
NODE_12859_length_779_cov_4.695588	216	296	2	5	80	0.0625000
NODE_12859_length_779_cov_4.695588	216	296	4	5	80	0.0625000
NODE_12859_length_779_cov_4.695588	216	296	6	4	80	0.0500000
NODE_12859_length_779_cov_4.695588	216	296	8	41	80	0.5125000
NODE_12859_length_779_cov_4.695588	269	349	0	78	80	0.9750000
NODE_12859_length_779_cov_4.695588	269	349	2	2	80	0.0250000
NODE_12863_length_779_cov_2.329412	615	672	4	5	57	0.0877193
NODE_12863_length_779_cov_2.329412	615	672	5	1	57	0.0175439
NODE_12863_length_779_cov_2.329412	615	672	6	20	57	0.3508772
NODE_12863_length_779_cov_2.329412	615	672	8	5	57	0.0877193
NODE_12863_length_779_cov_2.329412	615	672	10	26	57	0.4561403
NODE_12883_length_778_cov_21.615611	325	405	0	80	80	1.0000000
NODE_12883_length_778_cov_21.615611	378	458	0	80	80	1.0000000
NODE_12884_length_778_cov_19.549337	348	428	0	49	80	0.6125000
NODE_12884_length_778_cov_19.549337	348	428	4	31	80	0.3875000
NODE_12884_length_778_cov_19.549337	401	481	0	18	80	0.2250000
NODE_12884_length_778_cov_19.549337	401	481	4	62	80	0.7750000
NODE_12885_length_778_cov_15.403535	312	392	0	23	80	0.2875000
NODE_12885_length_778_cov_15.403535	312	392	2	57	80	0.7125000
NODE_12885_length_778_cov_15.403535	365	445	0	13	80	0.1625000
NODE_12885_length_778_cov_15.403535	365	445	2	67	80	0.8375000
NODE_12886_length_778_cov_14.614138	101	181	0	80	80	1.0000000
NODE_12886_length_778_cov_14.614138	154	234	0	80	80	1.0000000
NODE_12887_length_778_cov_13.368189	256	336	0	56	80	0.7000000
NODE_12887_length_778_cov_13.368189	256	336	2	24	80	0.3000000
NODE_12887_length_778_cov_13.368189	309	389	0	80	80	1.0000000
NODE_12891_length_778_cov_6.307806	349	429	0	7	80	0.0875000
NODE_12891_length_778_cov_6.307806	349	429	5	22	80	0.2750000
NODE_12891_length_778_cov_6.307806	349	429	6	51	80	0.6375000
NODE_12891_length_778_cov_6.307806	402	482	5	48	80	0.6000000
NODE_12891_length_778_cov_6.307806	402	482	6	32	80	0.4000000
NODE_12893_length_778_cov_5.985272	385	465	0	80	80	1.0000000
NODE_12893_length_778_cov_5.985272	438	518	0	80	80	1.0000000
NODE_12928_length_777_cov_25.504425	323	403	0	80	80	1.0000000
NODE_12928_length_777_cov_25.504425	376	456	0	80	80	1.0000000
NODE_12929_length_777_cov_25.410029	346	426	2	10	80	0.1250000
NODE_12929_length_777_cov_25.410029	346	426	4	70	80	0.8750000
NODE_12929_length_777_cov_25.410029	399	479	0	25	80	0.3125000
NODE_12929_length_777_cov_25.410029	399	479	2	10	80	0.1250000
NODE_12929_length_777_cov_25.410029	399	479	4	45	80	0.5625000
NODE_12930_length_777_cov_25.333333	97	177	0	80	80	1.0000000
NODE_12930_length_777_cov_25.333333	150	230	0	32	80	0.4000000
NODE_12930_length_777_cov_25.333333	150	230	2	48	80	0.6000000
NODE_12931_length_777_cov_21.600295	408	485	2	58	77	0.7532467
NODE_12931_length_777_cov_21.600295	408	485	4	19	77	0.2467532
NODE_12931_length_777_cov_21.600295	458	538	0	2	80	0.0250000
NODE_12931_length_777_cov_21.600295	458	538	2	78	80	0.9750000
NODE_12932_length_777_cov_19.561947	343	423	0	33	80	0.4125000
NODE_12932_length_777_cov_19.561947	343	423	2	1	80	0.0125000
NODE_12932_length_777_cov_19.561947	343	423	4	46	80	0.5750000
NODE_12932_length_777_cov_19.561947	396	476	0	26	80	0.3250000
NODE_12932_length_777_cov_19.561947	396	476	2	25	80	0.3125000
NODE_12932_length_777_cov_19.561947	396	476	4	29	80	0.3625000
NODE_12933_length_777_cov_16.961652	264	344	0	57	80	0.7125000
NODE_12933_length_777_cov_16.961652	264	344	2	23	80	0.2875000
NODE_12933_length_777_cov_16.961652	317	397	0	14	80	0.1750000
NODE_12933_length_777_cov_16.961652	317	397	2	66	80	0.8250000
NODE_12934_length_777_cov_16.081121	299	379	0	28	80	0.3500000
NODE_12934_length_777_cov_16.081121	299	379	2	52	80	0.6500000
NODE_12934_length_777_cov_16.081121	352	432	0	80	80	1.0000000
NODE_12935_length_777_cov_13.827434	380	460	22	5	80	0.0625000
NODE_12935_length_777_cov_13.827434	380	460	23	27	80	0.3375000
NODE_12935_length_777_cov_13.827434	380	460	24	20	80	0.2500000
NODE_12935_length_777_cov_13.827434	380	460	25	7	80	0.0875000
NODE_12935_length_777_cov_13.827434	380	460	26	6	80	0.0750000
NODE_12935_length_777_cov_13.827434	380	460	27	6	80	0.0750000
NODE_12935_length_777_cov_13.827434	380	460	29	9	80	0.1125000
NODE_12935_length_777_cov_13.827434	433	513	16	8	80	0.1000000
NODE_12935_length_777_cov_13.827434	433	513	18	6	80	0.0750000
NODE_12935_length_777_cov_13.827434	433	513	20	14	80	0.1750000
NODE_12935_length_777_cov_13.827434	433	513	22	9	80	0.1125000
NODE_12935_length_777_cov_13.827434	433	513	24	7	80	0.0875000
NODE_12935_length_777_cov_13.827434	433	513	25	1	80	0.0125000
NODE_12935_length_777_cov_13.827434	433	513	26	6	80	0.0750000
NODE_12935_length_777_cov_13.827434	433	513	27	16	80	0.2000000
NODE_12935_length_777_cov_13.827434	433	513	28	4	80	0.0500000
NODE_12935_length_777_cov_13.827434	433	513	29	9	80	0.1125000
NODE_12936_length_777_cov_12.497050	413	493	0	80	80	1.0000000
NODE_12936_length_777_cov_12.497050	466	546	0	80	80	1.0000000
NODE_12937_length_777_cov_10.787611	213	286	0	73	73	1.0000000
NODE_12938_length_777_cov_8.530973	362	422	3	18	60	0.3000000
NODE_12938_length_777_cov_8.530973	362	422	6	42	60	0.7000000
NODE_12939_length_777_cov_7.634218	79	159	0	80	80	1.0000000
NODE_12939_length_777_cov_7.634218	132	212	0	80	80	1.0000000
NODE_12940_length_777_cov_6.963127	256	336	0	72	80	0.9000000
NODE_12940_length_777_cov_6.963127	256	336	2	8	80	0.1000000
NODE_12940_length_777_cov_6.963127	309	389	0	19	80	0.2375000
NODE_12940_length_777_cov_6.963127	309	389	2	61	80	0.7625000
NODE_12941_length_777_cov_6.417404	565	638	0	73	73	1.0000000
NODE_12942_length_777_cov_5.868732	443	523	0	53	80	0.6625000
NODE_12942_length_777_cov_5.868732	443	523	2	27	80	0.3375000
NODE_12942_length_777_cov_5.868732	496	576	0	80	80	1.0000000
NODE_12971_length_776_cov_81.002954	237	317	4	14	80	0.1750000
NODE_12971_length_776_cov_81.002954	237	317	6	50	80	0.6250000
NODE_12971_length_776_cov_81.002954	237	317	7	2	80	0.0250000
NODE_12971_length_776_cov_81.002954	237	317	13	1	80	0.0125000
NODE_12971_length_776_cov_81.002954	237	317	37	1	80	0.0125000
NODE_12971_length_776_cov_81.002954	237	317	40	1	80	0.0125000
NODE_12971_length_776_cov_81.002954	237	317	54	1	80	0.0125000
NODE_12971_length_776_cov_81.002954	237	317	60	1	80	0.0125000
NODE_12971_length_776_cov_81.002954	237	317	74	1	80	0.0125000
NODE_12971_length_776_cov_81.002954	237	317	80	1	80	0.0125000
NODE_12971_length_776_cov_81.002954	237	317	87	1	80	0.0125000
NODE_12971_length_776_cov_81.002954	237	317	107	1	80	0.0125000
NODE_12971_length_776_cov_81.002954	237	317	114	1	80	0.0125000
NODE_12971_length_776_cov_81.002954	237	317	116	1	80	0.0125000
NODE_12971_length_776_cov_81.002954	237	317	117	1	80	0.0125000
NODE_12971_length_776_cov_81.002954	237	317	127	1	80	0.0125000
NODE_12971_length_776_cov_81.002954	237	317	136	1	80	0.0125000
NODE_12971_length_776_cov_81.002954	290	370	0	22	80	0.2750000
NODE_12971_length_776_cov_81.002954	290	370	2	1	80	0.0125000
NODE_12971_length_776_cov_81.002954	290	370	4	44	80	0.5500000
NODE_12971_length_776_cov_81.002954	290	370	6	13	80	0.1625000
NODE_12972_length_776_cov_40.502216	345	425	0	1	80	0.0125000
NODE_12972_length_776_cov_40.502216	345	425	6	24	80	0.3000000
NODE_12972_length_776_cov_40.502216	345	425	10	12	80	0.1500000
NODE_12972_length_776_cov_40.502216	345	425	12	43	80	0.5375000
NODE_12972_length_776_cov_40.502216	398	478	0	54	80	0.6750000
NODE_12972_length_776_cov_40.502216	398	478	6	24	80	0.3000000
NODE_12972_length_776_cov_40.502216	398	478	10	2	80	0.0250000
NODE_12973_length_776_cov_34.921713	204	284	0	80	80	1.0000000
NODE_12973_length_776_cov_34.921713	257	337	0	29	80	0.3625000
NODE_12973_length_776_cov_34.921713	257	337	2	51	80	0.6375000
NODE_12974_length_776_cov_29.998523	177	257	0	80	80	1.0000000
NODE_12974_length_776_cov_29.998523	230	310	0	80	80	1.0000000
NODE_12975_length_776_cov_25.683900	417	497	0	25	80	0.3125000
NODE_12975_length_776_cov_25.683900	417	497	4	55	80	0.6875000
NODE_12975_length_776_cov_25.683900	470	550	4	34	80	0.4250000
NODE_12975_length_776_cov_25.683900	470	550	6	30	80	0.3750000
NODE_12975_length_776_cov_25.683900	470	550	8	14	80	0.1750000
NODE_12975_length_776_cov_25.683900	470	550	10	2	80	0.0250000
NODE_12976_length_776_cov_22.276219	367	447	4	9	80	0.1125000
NODE_12976_length_776_cov_22.276219	367	447	8	1	80	0.0125000
NODE_12976_length_776_cov_22.276219	367	447	12	21	80	0.2625000
NODE_12976_length_776_cov_22.276219	367	447	14	49	80	0.6125000
NODE_12976_length_776_cov_22.276219	420	500	12	22	80	0.2750000
NODE_12976_length_776_cov_22.276219	420	500	14	42	80	0.5250000
NODE_12976_length_776_cov_22.276219	420	500	16	16	80	0.2000000
NODE_12977_length_776_cov_19.574594	242	322	0	80	80	1.0000000
NODE_12977_length_776_cov_19.574594	295	375	0	80	80	1.0000000
NODE_12978_length_776_cov_18.262925	384	464	2	19	80	0.2375000
NODE_12978_length_776_cov_18.262925	384	464	4	61	80	0.7625000
NODE_12978_length_776_cov_18.262925	437	517	2	35	80	0.4375000
NODE_12978_length_776_cov_18.262925	437	517	4	45	80	0.5625000
NODE_12979_length_776_cov_16.023634	334	414	0	28	80	0.3500000
NODE_12979_length_776_cov_16.023634	334	414	2	52	80	0.6500000
NODE_12979_length_776_cov_16.023634	387	467	0	38	80	0.4750000
NODE_12979_length_776_cov_16.023634	387	467	2	42	80	0.5250000
NODE_12980_length_776_cov_15.841950	282	362	0	55	80	0.6875000
NODE_12980_length_776_cov_15.841950	282	362	4	25	80	0.3125000
NODE_12980_length_776_cov_15.841950	335	415	0	3	80	0.0375000
NODE_12980_length_776_cov_15.841950	335	415	4	77	80	0.9625000
NODE_12981_length_776_cov_14.131462	240	320	0	80	80	1.0000000
NODE_12981_length_776_cov_14.131462	293	373	0	80	80	1.0000000
NODE_12981_length_776_cov_14.131462	369	449	0	80	80	1.0000000
NODE_12981_length_776_cov_14.131462	422	502	0	80	80	1.0000000
NODE_12983_length_776_cov_13.890694	302	382	0	80	80	1.0000000
NODE_12983_length_776_cov_13.890694	355	435	0	80	80	1.0000000
NODE_12984_length_776_cov_12.097489	488	568	0	23	80	0.2875000
NODE_12984_length_776_cov_12.097489	488	568	2	57	80	0.7125000
NODE_12984_length_776_cov_12.097489	541	621	0	37	80	0.4625000
NODE_12984_length_776_cov_12.097489	541	621	2	43	80	0.5375000
NODE_12985_length_776_cov_11.923191	422	498	0	76	76	1.0000000
NODE_12985_length_776_cov_11.923191	475	551	0	27	76	0.3552631
NODE_12985_length_776_cov_11.923191	475	551	1	29	76	0.3815790
NODE_12985_length_776_cov_11.923191	475	551	2	20	76	0.2631579
NODE_12986_length_776_cov_11.163959	312	392	2	53	80	0.6625000
NODE_12986_length_776_cov_11.163959	312	392	4	27	80	0.3375000
NODE_12986_length_776_cov_11.163959	365	445	0	4	80	0.0500000
NODE_12986_length_776_cov_11.163959	365	445	2	76	80	0.9500000
NODE_12987_length_776_cov_9.754801	370	450	6	77	80	0.9625000
NODE_12987_length_776_cov_9.754801	370	450	7	3	80	0.0375000
NODE_12987_length_776_cov_9.754801	423	503	2	20	80	0.2500000
NODE_12987_length_776_cov_9.754801	423	503	6	24	80	0.3000000
NODE_12987_length_776_cov_9.754801	423	503	7	13	80	0.1625000
NODE_12987_length_776_cov_9.754801	423	503	8	23	80	0.2875000
NODE_12989_length_776_cov_8.271787	332	412	0	80	80	1.0000000
NODE_12989_length_776_cov_8.271787	385	465	0	80	80	1.0000000
NODE_12990_length_776_cov_4.874446	330	410	0	80	80	1.0000000
NODE_12990_length_776_cov_4.874446	383	463	0	80	80	1.0000000
NODE_13022_length_775_cov_33.612426	372	452	0	5	80	0.0625000
NODE_13022_length_775_cov_33.612426	372	452	2	23	80	0.2875000
NODE_13022_length_775_cov_33.612426	372	452	4	52	80	0.6500000
NODE_13022_length_775_cov_33.612426	425	505	0	3	80	0.0375000
NODE_13022_length_775_cov_33.612426	425	505	2	32	80	0.4000000
NODE_13022_length_775_cov_33.612426	425	505	4	45	80	0.5625000
NODE_13023_length_775_cov_25.500000	361	434	0	73	73	1.0000000
NODE_13023_length_775_cov_25.500000	413	487	0	74	74	1.0000000
NODE_13024_length_775_cov_24.128698	220	300	0	51	80	0.6375000
NODE_13024_length_775_cov_24.128698	220	300	2	29	80	0.3625000
NODE_13024_length_775_cov_24.128698	273	353	0	25	80	0.3125000
NODE_13024_length_775_cov_24.128698	273	353	2	55	80	0.6875000
NODE_13026_length_775_cov_16.165680	358	438	2	23	80	0.2875000
NODE_13026_length_775_cov_16.165680	358	438	3	47	80	0.5875000
NODE_13026_length_775_cov_16.165680	358	438	4	10	80	0.1250000
NODE_13026_length_775_cov_16.165680	411	491	0	40	80	0.5000000
NODE_13026_length_775_cov_16.165680	411	491	2	36	80	0.4500000
NODE_13026_length_775_cov_16.165680	411	491	4	4	80	0.0500000
NODE_13027_length_775_cov_8.522189	440	520	4	17	80	0.2125000
NODE_13027_length_775_cov_8.522189	440	520	6	2	80	0.0250000
NODE_13027_length_775_cov_8.522189	440	520	8	58	80	0.7250000
NODE_13027_length_775_cov_8.522189	440	520	10	3	80	0.0375000
NODE_13027_length_775_cov_8.522189	493	573	0	28	80	0.3500000
NODE_13027_length_775_cov_8.522189	493	573	2	6	80	0.0750000
NODE_13027_length_775_cov_8.522189	493	573	4	1	80	0.0125000
NODE_13027_length_775_cov_8.522189	493	573	6	8	80	0.1000000
NODE_13027_length_775_cov_8.522189	493	573	8	37	80	0.4625000
NODE_13028_length_775_cov_8.258876	247	327	0	80	80	1.0000000
NODE_13028_length_775_cov_8.258876	300	380	0	80	80	1.0000000
NODE_13031_length_775_cov_3.786982	299	379	0	19	80	0.2375000
NODE_13031_length_775_cov_3.786982	299	379	2	61	80	0.7625000
NODE_13031_length_775_cov_3.786982	352	432	0	72	80	0.9000000
NODE_13031_length_775_cov_3.786982	352	432	2	8	80	0.1000000
NODE_13059_length_774_cov_27.386667	433	514	0	24	81	0.2962963
NODE_13059_length_774_cov_27.386667	433	514	1	57	81	0.7037037
NODE_13059_length_774_cov_27.386667	487	567	0	17	80	0.2125000
NODE_13059_length_774_cov_27.386667	487	567	1	63	80	0.7875000
NODE_13060_length_774_cov_19.721481	239	319	0	80	80	1.0000000
NODE_13060_length_774_cov_19.721481	292	372	0	80	80	1.0000000
NODE_13063_length_774_cov_4.594074	216	294	2	78	78	1.0000000
NODE_13063_length_774_cov_4.594074	269	347	2	72	78	0.9230769
NODE_13063_length_774_cov_4.594074	269	347	4	6	78	0.0769231
NODE_13063_length_774_cov_4.594074	405	485	0	17	80	0.2125000
NODE_13063_length_774_cov_4.594074	405	485	4	51	80	0.6375000
NODE_13063_length_774_cov_4.594074	405	485	6	12	80	0.1500000
NODE_13103_length_773_cov_60.566766	249	328	0	14	79	0.1772152
NODE_13103_length_773_cov_60.566766	249	328	3	18	79	0.2278481
NODE_13103_length_773_cov_60.566766	249	328	4	47	79	0.5949367
NODE_13103_length_773_cov_60.566766	304	381	0	5	77	0.0649351
NODE_13103_length_773_cov_60.566766	304	381	3	66	77	0.8571429
NODE_13103_length_773_cov_60.566766	304	381	4	6	77	0.0779221
NODE_13104_length_773_cov_27.299703	230	310	0	59	80	0.7375000
NODE_13104_length_773_cov_27.299703	230	310	4	21	80	0.2625000
NODE_13104_length_773_cov_27.299703	283	363	0	80	80	1.0000000
NODE_13105_length_773_cov_24.250742	392	470	2	38	78	0.4871795
NODE_13105_length_773_cov_24.250742	392	470	4	40	78	0.5128205
NODE_13105_length_773_cov_24.250742	443	523	0	28	80	0.3500000
NODE_13105_length_773_cov_24.250742	443	523	2	52	80	0.6500000
NODE_13106_length_773_cov_20.683976	367	447	2	80	80	1.0000000
NODE_13106_length_773_cov_20.683976	420	500	0	43	80	0.5375000
NODE_13106_length_773_cov_20.683976	420	500	2	37	80	0.4625000
NODE_13107_length_773_cov_18.498516	248	328	2	63	80	0.7875000
NODE_13107_length_773_cov_18.498516	248	328	4	17	80	0.2125000
NODE_13107_length_773_cov_18.498516	301	381	0	29	80	0.3625000
NODE_13107_length_773_cov_18.498516	301	381	2	51	80	0.6375000
NODE_13108_length_773_cov_14.063798	405	485	0	34	80	0.4250000
NODE_13108_length_773_cov_14.063798	405	485	2	46	80	0.5750000
NODE_13108_length_773_cov_14.063798	458	538	0	80	80	1.0000000
NODE_13109_length_773_cov_12.482196	421	501	0	8	80	0.1000000
NODE_13109_length_773_cov_12.482196	421	501	2	25	80	0.3125000
NODE_13109_length_773_cov_12.482196	421	501	6	24	80	0.3000000
NODE_13109_length_773_cov_12.482196	421	501	9	4	80	0.0500000
NODE_13109_length_773_cov_12.482196	421	501	12	19	80	0.2375000
NODE_13109_length_773_cov_12.482196	474	554	6	21	80	0.2625000
NODE_13109_length_773_cov_12.482196	474	554	9	4	80	0.0500000
NODE_13109_length_773_cov_12.482196	474	554	10	16	80	0.2000000
NODE_13109_length_773_cov_12.482196	474	554	12	39	80	0.4875000
NODE_13114_length_773_cov_9.136499	214	294	0	80	80	1.0000000
NODE_13114_length_773_cov_9.136499	267	347	0	80	80	1.0000000
NODE_13115_length_773_cov_8.609792	461	541	0	40	80	0.5000000
NODE_13115_length_773_cov_8.609792	461	541	2	40	80	0.5000000
NODE_13115_length_773_cov_8.609792	514	594	2	80	80	1.0000000
NODE_13116_length_773_cov_7.224036	200	280	0	9	80	0.1125000
NODE_13116_length_773_cov_7.224036	200	280	2	71	80	0.8875000
NODE_13116_length_773_cov_7.224036	253	333	0	23	80	0.2875000
NODE_13116_length_773_cov_7.224036	253	333	2	57	80	0.7125000
NODE_13117_length_773_cov_6.910979	522	615	0	93	93	1.0000000
NODE_13117_length_773_cov_6.910979	588	668	0	80	80	1.0000000
NODE_13147_length_772_cov_28.044577	231	311	0	80	80	1.0000000
NODE_13147_length_772_cov_28.044577	284	364	0	80	80	1.0000000
NODE_13149_length_772_cov_9.523031	288	368	0	80	80	1.0000000
NODE_13149_length_772_cov_9.523031	341	421	0	80	80	1.0000000
NODE_13150_length_772_cov_8.778603	133	213	0	80	80	1.0000000
NODE_13150_length_772_cov_8.778603	186	266	0	80	80	1.0000000
NODE_13151_length_772_cov_7.921248	351	431	0	80	80	1.0000000
NODE_13151_length_772_cov_7.921248	404	480	0	76	76	1.0000000
NODE_13152_length_772_cov_7.059435	276	356	0	80	80	1.0000000
NODE_13152_length_772_cov_7.059435	329	409	0	80	80	1.0000000
NODE_13153_length_772_cov_5.536404	269	299	0	30	30	1.0000000
NODE_13153_length_772_cov_5.536404	272	341	0	69	69	1.0000000
NODE_13156_length_772_cov_4.838039	430	510	0	80	80	1.0000000
NODE_13156_length_772_cov_4.838039	483	563	0	80	80	1.0000000
NODE_13162_length_772_cov_3.041605	339	419	0	58	80	0.7250000
NODE_13162_length_772_cov_3.041605	339	419	2	22	80	0.2750000
NODE_13162_length_772_cov_3.041605	392	472	0	41	80	0.5125000
NODE_13162_length_772_cov_3.041605	392	472	2	39	80	0.4875000
NODE_13195_length_771_cov_36.729167	223	304	0	81	81	1.0000000
NODE_13195_length_771_cov_36.729167	277	357	0	80	80	1.0000000
NODE_13195_length_771_cov_36.729167	353	434	0	81	81	1.0000000
NODE_13195_length_771_cov_36.729167	407	487	0	80	80	1.0000000
NODE_13196_length_771_cov_28.903274	337	417	0	50	80	0.6250000
NODE_13196_length_771_cov_28.903274	337	417	2	30	80	0.3750000
NODE_13196_length_771_cov_28.903274	390	470	0	17	80	0.2125000
NODE_13196_length_771_cov_28.903274	390	470	2	55	80	0.6875000
NODE_13196_length_771_cov_28.903274	390	470	4	8	80	0.1000000
NODE_13197_length_771_cov_28.165179	453	533	0	80	80	1.0000000
NODE_13197_length_771_cov_28.165179	506	586	0	80	80	1.0000000
NODE_13198_length_771_cov_14.336310	259	339	0	80	80	1.0000000
NODE_13198_length_771_cov_14.336310	312	392	0	80	80	1.0000000
NODE_13199_length_771_cov_13.592262	428	508	0	80	80	1.0000000
NODE_13199_length_771_cov_13.592262	481	561	0	80	80	1.0000000
NODE_13200_length_771_cov_12.226190	407	487	3	3	80	0.0375000
NODE_13200_length_771_cov_12.226190	407	487	5	1	80	0.0125000
NODE_13200_length_771_cov_12.226190	407	487	6	76	80	0.9500000
NODE_13200_length_771_cov_12.226190	460	540	0	45	80	0.5625000
NODE_13200_length_771_cov_12.226190	460	540	3	11	80	0.1375000
NODE_13200_length_771_cov_12.226190	460	540	5	1	80	0.0125000
NODE_13200_length_771_cov_12.226190	460	540	6	23	80	0.2875000
NODE_13201_length_771_cov_11.188988	348	428	0	80	80	1.0000000
NODE_13201_length_771_cov_11.188988	401	481	0	80	80	1.0000000
NODE_13202_length_771_cov_10.525298	171	251	0	57	80	0.7125000
NODE_13202_length_771_cov_10.525298	171	251	2	9	80	0.1125000
NODE_13202_length_771_cov_10.525298	171	251	4	14	80	0.1750000
NODE_13202_length_771_cov_10.525298	224	304	0	4	80	0.0500000
NODE_13202_length_771_cov_10.525298	224	304	2	9	80	0.1125000
NODE_13202_length_771_cov_10.525298	224	304	4	67	80	0.8375000
NODE_13207_length_771_cov_3.357143	238	318	0	34	80	0.4250000
NODE_13207_length_771_cov_3.357143	238	318	2	25	80	0.3125000
NODE_13207_length_771_cov_3.357143	238	318	4	21	80	0.2625000
NODE_13207_length_771_cov_3.357143	291	371	0	80	80	1.0000000
NODE_13209_length_771_cov_3.129464	476	518	4	15	42	0.3571429
NODE_13209_length_771_cov_3.129464	476	518	8	27	42	0.6428571
NODE_13238_length_770_cov_45.312966	212	292	0	80	80	1.0000000
NODE_13238_length_770_cov_45.312966	265	345	0	80	80	1.0000000
NODE_13239_length_770_cov_23.153502	348	428	0	80	80	1.0000000
NODE_13239_length_770_cov_23.153502	401	481	0	33	80	0.4125000
NODE_13239_length_770_cov_23.153502	401	481	2	47	80	0.5875000
NODE_13240_length_770_cov_22.463487	340	420	0	80	80	1.0000000
NODE_13240_length_770_cov_22.463487	393	473	0	36	80	0.4500000
NODE_13240_length_770_cov_22.463487	393	473	2	44	80	0.5500000
NODE_13241_length_770_cov_18.594635	335	416	0	21	81	0.2592593
NODE_13241_length_770_cov_18.594635	335	416	9	23	81	0.2839506
NODE_13241_length_770_cov_18.594635	335	416	10	37	81	0.4567901
NODE_13241_length_770_cov_18.594635	389	469	10	80	80	1.0000000
NODE_13242_length_770_cov_18.092399	292	372	0	80	80	1.0000000
NODE_13242_length_770_cov_18.092399	345	425	0	80	80	1.0000000
NODE_13243_length_770_cov_7.064083	294	374	0	80	80	1.0000000
NODE_13243_length_770_cov_7.064083	347	426	0	79	79	1.0000000
NODE_13246_length_770_cov_5.184799	341	421	0	80	80	1.0000000
NODE_13246_length_770_cov_5.184799	394	474	0	80	80	1.0000000
NODE_13250_length_770_cov_4.120715	325	405	0	49	80	0.6125000
NODE_13250_length_770_cov_4.120715	325	405	2	31	80	0.3875000
NODE_13250_length_770_cov_4.120715	378	458	2	37	80	0.4625000
NODE_13250_length_770_cov_4.120715	378	458	4	43	80	0.5375000
NODE_13272_length_769_cov_11.008955	355	435	2	15	80	0.1875000
NODE_13272_length_769_cov_11.008955	355	435	4	34	80	0.4250000
NODE_13272_length_769_cov_11.008955	355	435	6	31	80	0.3875000
NODE_13272_length_769_cov_11.008955	408	488	0	34	80	0.4250000
NODE_13272_length_769_cov_11.008955	408	488	2	6	80	0.0750000
NODE_13272_length_769_cov_11.008955	408	488	4	27	80	0.3375000
NODE_13272_length_769_cov_11.008955	408	488	6	13	80	0.1625000
NODE_13274_length_769_cov_9.077612	263	343	7	6	80	0.0750000
NODE_13274_length_769_cov_9.077612	263	343	12	1	80	0.0125000
NODE_13274_length_769_cov_9.077612	263	343	13	44	80	0.5500000
NODE_13274_length_769_cov_9.077612	263	343	15	17	80	0.2125000
NODE_13274_length_769_cov_9.077612	263	343	17	12	80	0.1500000
NODE_13274_length_769_cov_9.077612	316	396	12	6	80	0.0750000
NODE_13274_length_769_cov_9.077612	316	396	15	37	80	0.4625000
NODE_13274_length_769_cov_9.077612	316	396	16	22	80	0.2750000
NODE_13274_length_769_cov_9.077612	316	396	17	15	80	0.1875000
NODE_13275_length_769_cov_7.034328	289	367	0	78	78	1.0000000
NODE_13275_length_769_cov_7.034328	340	420	0	80	80	1.0000000
NODE_13307_length_769_cov_1.262687	620	668	0	48	48	1.0000000
NODE_13316_length_768_cov_19.195815	266	346	0	80	80	1.0000000
NODE_13316_length_768_cov_19.195815	319	399	0	80	80	1.0000000
NODE_13316_length_768_cov_19.195815	395	475	0	80	80	1.0000000
NODE_13316_length_768_cov_19.195815	448	528	0	80	80	1.0000000
NODE_13317_length_768_cov_16.420030	246	326	0	80	80	1.0000000
NODE_13317_length_768_cov_16.420030	299	379	0	80	80	1.0000000
NODE_13318_length_768_cov_14.508221	309	389	0	80	80	1.0000000
NODE_13318_length_768_cov_14.508221	362	442	0	80	80	1.0000000
NODE_13319_length_768_cov_11.635277	309	389	2	80	80	1.0000000
NODE_13319_length_768_cov_11.635277	362	442	0	13	80	0.1625000
NODE_13319_length_768_cov_11.635277	362	442	2	67	80	0.8375000
NODE_13321_length_768_cov_9.064275	392	472	0	80	80	1.0000000
NODE_13321_length_768_cov_9.064275	445	525	0	35	80	0.4375000
NODE_13321_length_768_cov_9.064275	445	525	2	45	80	0.5625000
NODE_13324_length_768_cov_3.605381	512	592	0	80	80	1.0000000
NODE_13324_length_768_cov_3.605381	565	645	0	80	80	1.0000000
NODE_13354_length_767_cov_38.161677	28	108	10	1	80	0.0125000
NODE_13354_length_767_cov_38.161677	28	108	12	1	80	0.0125000
NODE_13354_length_767_cov_38.161677	28	108	14	2	80	0.0250000
NODE_13354_length_767_cov_38.161677	28	108	16	3	80	0.0375000
NODE_13354_length_767_cov_38.161677	28	108	18	6	80	0.0750000
NODE_13354_length_767_cov_38.161677	28	108	20	67	80	0.8375000
NODE_13354_length_767_cov_38.161677	254	334	0	26	80	0.3250000
NODE_13354_length_767_cov_38.161677	254	334	2	54	80	0.6750000
NODE_13354_length_767_cov_38.161677	307	387	2	56	80	0.7000000
NODE_13354_length_767_cov_38.161677	307	387	4	24	80	0.3000000
NODE_13355_length_767_cov_24.107784	279	359	0	25	80	0.3125000
NODE_13355_length_767_cov_24.107784	279	359	2	55	80	0.6875000
NODE_13355_length_767_cov_24.107784	332	412	0	78	80	0.9750000
NODE_13355_length_767_cov_24.107784	332	412	2	2	80	0.0250000
NODE_13356_length_767_cov_22.823353	286	366	0	80	80	1.0000000
NODE_13356_length_767_cov_22.823353	339	419	0	80	80	1.0000000
NODE_13357_length_767_cov_20.898204	312	392	0	39	80	0.4875000
NODE_13357_length_767_cov_20.898204	312	392	2	1	80	0.0125000
NODE_13357_length_767_cov_20.898204	312	392	4	40	80	0.5000000
NODE_13357_length_767_cov_20.898204	365	445	0	1	80	0.0125000
NODE_13357_length_767_cov_20.898204	365	445	2	42	80	0.5250000
NODE_13357_length_767_cov_20.898204	365	445	4	37	80	0.4625000
NODE_13358_length_767_cov_20.058383	357	439	0	82	82	1.0000000
NODE_13358_length_767_cov_20.058383	410	490	0	80	80	1.0000000
NODE_13359_length_767_cov_20.020958	191	271	1	24	80	0.3000000
NODE_13359_length_767_cov_20.020958	191	271	2	24	80	0.3000000
NODE_13359_length_767_cov_20.020958	191	271	3	32	80	0.4000000
NODE_13359_length_767_cov_20.020958	244	324	1	26	80	0.3250000
NODE_13359_length_767_cov_20.020958	244	324	3	54	80	0.6750000
NODE_13360_length_767_cov_18.687126	270	350	0	80	80	1.0000000
NODE_13360_length_767_cov_18.687126	323	403	0	65	80	0.8125000
NODE_13360_length_767_cov_18.687126	323	403	2	15	80	0.1875000
NODE_13362_length_767_cov_13.323353	45	125	0	80	80	1.0000000
NODE_13362_length_767_cov_13.323353	98	178	0	80	80	1.0000000
NODE_13366_length_767_cov_8.787425	377	447	2	70	70	1.0000000
NODE_13366_length_767_cov_8.787425	420	500	0	49	80	0.6125000
NODE_13366_length_767_cov_8.787425	420	500	2	31	80	0.3875000
NODE_13367_length_767_cov_7.206587	306	386	0	10	80	0.1250000
NODE_13367_length_767_cov_7.206587	306	386	2	22	80	0.2750000
NODE_13367_length_767_cov_7.206587	306	386	4	48	80	0.6000000
NODE_13367_length_767_cov_7.206587	359	440	0	64	81	0.7901235
NODE_13367_length_767_cov_7.206587	359	440	2	17	81	0.2098765
NODE_13403_length_766_cov_59.388306	322	402	0	30	80	0.3750000
NODE_13403_length_766_cov_59.388306	322	402	2	50	80	0.6250000
NODE_13403_length_766_cov_59.388306	375	455	0	80	80	1.0000000
NODE_13403_length_766_cov_59.388306	451	531	0	80	80	1.0000000
NODE_13403_length_766_cov_59.388306	504	584	0	80	80	1.0000000
NODE_13404_length_766_cov_23.361319	308	388	0	80	80	1.0000000
NODE_13404_length_766_cov_23.361319	361	441	0	80	80	1.0000000
NODE_13405_length_766_cov_22.751124	229	309	0	56	80	0.7000000
NODE_13405_length_766_cov_22.751124	229	309	2	24	80	0.3000000
NODE_13405_length_766_cov_22.751124	282	362	0	80	80	1.0000000
NODE_13406_length_766_cov_20.011994	285	363	2	68	78	0.8717949
NODE_13406_length_766_cov_20.011994	285	363	4	10	78	0.1282051
NODE_13406_length_766_cov_20.011994	336	416	2	80	80	1.0000000
NODE_13407_length_766_cov_18.685157	288	368	0	8	80	0.1000000
NODE_13407_length_766_cov_18.685157	288	368	2	72	80	0.9000000
NODE_13407_length_766_cov_18.685157	341	421	0	32	80	0.4000000
NODE_13407_length_766_cov_18.685157	341	421	2	48	80	0.6000000
NODE_13408_length_766_cov_13.131934	271	351	0	80	80	1.0000000
NODE_13408_length_766_cov_13.131934	324	404	0	80	80	1.0000000
NODE_13410_length_766_cov_9.479760	274	354	0	80	80	1.0000000
NODE_13410_length_766_cov_9.479760	327	407	0	80	80	1.0000000
NODE_13415_length_766_cov_4.500750	333	413	9	1	80	0.0125000
NODE_13415_length_766_cov_4.500750	333	413	10	21	80	0.2625000
NODE_13415_length_766_cov_4.500750	333	413	12	26	80	0.3250000
NODE_13415_length_766_cov_4.500750	333	413	14	22	80	0.2750000
NODE_13415_length_766_cov_4.500750	333	413	16	10	80	0.1250000
NODE_13415_length_766_cov_4.500750	369	404	12	26	35	0.7428572
NODE_13415_length_766_cov_4.500750	369	404	14	7	35	0.2000000
NODE_13415_length_766_cov_4.500750	369	404	16	2	35	0.0571429
NODE_13415_length_766_cov_4.500750	371	413	12	26	42	0.6190476
NODE_13415_length_766_cov_4.500750	371	413	14	16	42	0.3809524
NODE_13415_length_766_cov_4.500750	397	466	8	42	69	0.6086956
NODE_13415_length_766_cov_4.500750	397	466	12	6	69	0.0869565
NODE_13415_length_766_cov_4.500750	397	466	14	21	69	0.3043478
NODE_13447_length_765_cov_92.851351	16	96	2	1	80	0.0125000
NODE_13447_length_765_cov_92.851351	16	96	6	10	80	0.1250000
NODE_13447_length_765_cov_92.851351	16	96	8	3	80	0.0375000
NODE_13447_length_765_cov_92.851351	16	96	10	1	80	0.0125000
NODE_13447_length_765_cov_92.851351	16	96	12	3	80	0.0375000
NODE_13447_length_765_cov_92.851351	16	96	14	1	80	0.0125000
NODE_13447_length_765_cov_92.851351	16	96	16	2	80	0.0250000
NODE_13447_length_765_cov_92.851351	16	96	18	4	80	0.0500000
NODE_13447_length_765_cov_92.851351	16	96	20	2	80	0.0250000
NODE_13447_length_765_cov_92.851351	16	96	22	1	80	0.0125000
NODE_13447_length_765_cov_92.851351	16	96	24	1	80	0.0125000
NODE_13447_length_765_cov_92.851351	16	96	26	3	80	0.0375000
NODE_13447_length_765_cov_92.851351	16	96	37	1	80	0.0125000
NODE_13447_length_765_cov_92.851351	16	96	38	2	80	0.0250000
NODE_13447_length_765_cov_92.851351	16	96	43	4	80	0.0500000
NODE_13447_length_765_cov_92.851351	16	96	45	1	80	0.0125000
NODE_13447_length_765_cov_92.851351	16	96	47	2	80	0.0250000
NODE_13447_length_765_cov_92.851351	16	96	49	7	80	0.0875000
NODE_13447_length_765_cov_92.851351	16	96	51	1	80	0.0125000
NODE_13447_length_765_cov_92.851351	16	96	53	6	80	0.0750000
NODE_13447_length_765_cov_92.851351	16	96	55	2	80	0.0250000
NODE_13447_length_765_cov_92.851351	16	96	56	3	80	0.0375000
NODE_13447_length_765_cov_92.851351	16	96	57	1	80	0.0125000
NODE_13447_length_765_cov_92.851351	16	96	59	6	80	0.0750000
NODE_13447_length_765_cov_92.851351	16	96	60	1	80	0.0125000
NODE_13447_length_765_cov_92.851351	16	96	62	2	80	0.0250000
NODE_13447_length_765_cov_92.851351	16	96	66	1	80	0.0125000
NODE_13447_length_765_cov_92.851351	16	96	72	3	80	0.0375000
NODE_13447_length_765_cov_92.851351	16	96	76	3	80	0.0375000
NODE_13447_length_765_cov_92.851351	16	96	82	2	80	0.0250000
NODE_13448_length_765_cov_36.345345	504	584	0	80	80	1.0000000
NODE_13448_length_765_cov_36.345345	557	637	0	80	80	1.0000000
NODE_13449_length_765_cov_27.334835	370	450	0	80	80	1.0000000
NODE_13449_length_765_cov_27.334835	423	503	0	80	80	1.0000000
NODE_13450_length_765_cov_23.355856	251	331	0	50	80	0.6250000
NODE_13450_length_765_cov_23.355856	251	331	4	19	80	0.2375000
NODE_13450_length_765_cov_23.355856	251	331	6	1	80	0.0125000
NODE_13450_length_765_cov_23.355856	251	331	7	10	80	0.1250000
NODE_13450_length_765_cov_23.355856	304	384	4	16	80	0.2000000
NODE_13450_length_765_cov_23.355856	304	384	6	1	80	0.0125000
NODE_13450_length_765_cov_23.355856	304	384	7	62	80	0.7750000
NODE_13450_length_765_cov_23.355856	304	384	8	1	80	0.0125000
NODE_13450_length_765_cov_23.355856	380	460	4	9	80	0.1125000
NODE_13450_length_765_cov_23.355856	380	460	6	1	80	0.0125000
NODE_13450_length_765_cov_23.355856	380	460	7	70	80	0.8750000
NODE_13450_length_765_cov_23.355856	433	506	2	36	73	0.4931507
NODE_13450_length_765_cov_23.355856	433	506	4	12	73	0.1643836
NODE_13450_length_765_cov_23.355856	433	506	6	8	73	0.1095890
NODE_13450_length_765_cov_23.355856	433	506	7	17	73	0.2328767
NODE_13451_length_765_cov_23.322823	256	336	0	80	80	1.0000000
NODE_13451_length_765_cov_23.322823	309	389	0	80	80	1.0000000
NODE_13452_length_765_cov_21.741742	379	452	0	73	73	1.0000000
NODE_13452_length_765_cov_21.741742	425	505	0	80	80	1.0000000
NODE_13453_length_765_cov_14.253754	450	530	5	17	80	0.2125000
NODE_13453_length_765_cov_14.253754	450	530	7	3	80	0.0375000
NODE_13453_length_765_cov_14.253754	450	530	9	25	80	0.3125000
NODE_13453_length_765_cov_14.253754	450	530	10	35	80	0.4375000
NODE_13453_length_765_cov_14.253754	503	583	4	37	80	0.4625000
NODE_13453_length_765_cov_14.253754	503	583	5	20	80	0.2500000
NODE_13453_length_765_cov_14.253754	503	583	7	7	80	0.0875000
NODE_13453_length_765_cov_14.253754	503	583	9	16	80	0.2000000
NODE_13454_length_765_cov_13.627628	313	393	0	80	80	1.0000000
NODE_13454_length_765_cov_13.627628	366	446	0	78	80	0.9750000
NODE_13454_length_765_cov_13.627628	366	446	2	2	80	0.0250000
NODE_13455_length_765_cov_5.561562	319	349	0	30	30	1.0000000
NODE_13458_length_765_cov_4.367868	433	513	0	80	80	1.0000000
NODE_13458_length_765_cov_4.367868	486	566	0	80	80	1.0000000
NODE_13483_length_764_cov_30.096241	436	516	0	80	80	1.0000000
NODE_13483_length_764_cov_30.096241	489	569	0	80	80	1.0000000
NODE_13484_length_764_cov_29.218045	304	384	0	80	80	1.0000000
NODE_13484_length_764_cov_29.218045	357	437	0	80	80	1.0000000
NODE_13485_length_764_cov_25.951880	421	501	0	32	80	0.4000000
NODE_13485_length_764_cov_25.951880	421	501	1	48	80	0.6000000
NODE_13485_length_764_cov_25.951880	474	554	0	80	80	1.0000000
NODE_13486_length_764_cov_23.590977	204	284	6	28	80	0.3500000
NODE_13486_length_764_cov_23.590977	204	284	8	52	80	0.6500000
NODE_13486_length_764_cov_23.590977	257	337	2	23	80	0.2875000
NODE_13486_length_764_cov_23.590977	257	337	4	10	80	0.1250000
NODE_13486_length_764_cov_23.590977	257	337	6	33	80	0.4125000
NODE_13486_length_764_cov_23.590977	257	337	8	14	80	0.1750000
NODE_13488_length_764_cov_6.804511	281	361	0	80	80	1.0000000
NODE_13488_length_764_cov_6.804511	334	414	0	80	80	1.0000000
NODE_13489_length_764_cov_6.700752	392	458	2	10	66	0.1515152
NODE_13489_length_764_cov_6.700752	392	458	4	3	66	0.0454545
NODE_13489_length_764_cov_6.700752	392	458	6	53	66	0.8030303
NODE_13508_length_764_cov_1.171429	475	537	0	36	62	0.5806451
NODE_13508_length_764_cov_1.171429	475	537	2	26	62	0.4193548
NODE_13520_length_763_cov_28.807229	311	391	0	80	80	1.0000000
NODE_13520_length_763_cov_28.807229	364	444	0	80	80	1.0000000
NODE_13521_length_763_cov_25.299699	598	673	4	10	75	0.1333333
NODE_13521_length_763_cov_25.299699	598	673	8	65	75	0.8666667
NODE_13521_length_763_cov_25.299699	598	678	4	10	80	0.1250000
NODE_13521_length_763_cov_25.299699	598	678	8	70	80	0.8750000
NODE_13521_length_763_cov_25.299699	605	675	4	3	70	0.0428571
NODE_13521_length_763_cov_25.299699	605	675	8	67	70	0.9571428
NODE_13521_length_763_cov_25.299699	607	678	4	1	71	0.0140845
NODE_13521_length_763_cov_25.299699	607	678	8	70	71	0.9859155
NODE_13521_length_763_cov_25.299699	651	731	8	80	80	1.0000000
NODE_13521_length_763_cov_25.299699	651	731	8	80	80	1.0000000
NODE_13521_length_763_cov_25.299699	651	731	8	80	80	1.0000000
NODE_13521_length_763_cov_25.299699	651	731	8	80	80	1.0000000
NODE_13522_length_763_cov_12.887048	336	416	0	80	80	1.0000000
NODE_13522_length_763_cov_12.887048	389	469	0	80	80	1.0000000
NODE_13523_length_763_cov_11.599398	547	627	0	80	80	1.0000000
NODE_13523_length_763_cov_11.599398	600	680	0	80	80	1.0000000
NODE_13524_length_763_cov_9.378012	297	377	0	80	80	1.0000000
NODE_13524_length_763_cov_9.378012	350	430	0	80	80	1.0000000
NODE_13526_length_763_cov_7.246988	368	448	0	21	80	0.2625000
NODE_13526_length_763_cov_7.246988	368	448	2	59	80	0.7375000
NODE_13526_length_763_cov_7.246988	421	501	0	74	80	0.9250000
NODE_13526_length_763_cov_7.246988	421	501	2	6	80	0.0750000
NODE_13527_length_763_cov_6.414157	371	451	0	80	80	1.0000000
NODE_13527_length_763_cov_6.414157	424	504	0	80	80	1.0000000
NODE_13558_length_762_cov_21.236802	368	448	0	23	80	0.2875000
NODE_13558_length_762_cov_21.236802	368	448	6	11	80	0.1375000
NODE_13558_length_762_cov_21.236802	368	448	8	46	80	0.5750000
NODE_13558_length_762_cov_21.236802	421	501	2	16	80	0.2000000
NODE_13558_length_762_cov_21.236802	421	501	8	64	80	0.8000000
NODE_13559_length_762_cov_19.984917	327	407	4	20	80	0.2500000
NODE_13559_length_762_cov_19.984917	327	407	10	26	80	0.3250000
NODE_13559_length_762_cov_19.984917	327	407	18	34	80	0.4250000
NODE_13559_length_762_cov_19.984917	380	460	7	16	80	0.2000000
NODE_13559_length_762_cov_19.984917	380	460	12	9	80	0.1125000
NODE_13559_length_762_cov_19.984917	380	460	13	6	80	0.0750000
NODE_13559_length_762_cov_19.984917	380	460	14	3	80	0.0375000
NODE_13559_length_762_cov_19.984917	380	460	18	46	80	0.5750000
NODE_13560_length_762_cov_15.975867	318	398	0	80	80	1.0000000
NODE_13560_length_762_cov_15.975867	371	439	0	68	68	1.0000000
NODE_13561_length_762_cov_12.728507	381	461	0	80	80	1.0000000
NODE_13561_length_762_cov_12.728507	434	514	0	80	80	1.0000000
NODE_13562_length_762_cov_10.078431	277	357	0	80	80	1.0000000
NODE_13562_length_762_cov_10.078431	330	410	0	80	80	1.0000000
NODE_13563_length_762_cov_9.705882	339	419	0	80	80	1.0000000
NODE_13563_length_762_cov_9.705882	392	472	0	80	80	1.0000000
NODE_13564_length_762_cov_7.276018	316	395	0	28	79	0.3544304
NODE_13564_length_762_cov_7.276018	316	395	4	24	79	0.3037975
NODE_13564_length_762_cov_7.276018	316	395	6	20	79	0.2531646
NODE_13564_length_762_cov_7.276018	316	395	8	7	79	0.0886076
NODE_13564_length_762_cov_7.276018	368	448	6	20	80	0.2500000
NODE_13564_length_762_cov_7.276018	368	448	8	9	80	0.1125000
NODE_13564_length_762_cov_7.276018	368	448	10	51	80	0.6375000
NODE_13565_length_762_cov_6.168929	222	302	0	80	80	1.0000000
NODE_13565_length_762_cov_6.168929	275	355	0	80	80	1.0000000
NODE_13613_length_761_cov_44.243202	531	582	0	51	51	1.0000000
NODE_13614_length_761_cov_38.809668	342	422	0	80	80	1.0000000
NODE_13614_length_761_cov_38.809668	395	475	0	80	80	1.0000000
NODE_13615_length_761_cov_38.694864	314	394	2	60	80	0.7500000
NODE_13615_length_761_cov_38.694864	314	394	4	20	80	0.2500000
NODE_13615_length_761_cov_38.694864	367	447	0	25	80	0.3125000
NODE_13615_length_761_cov_38.694864	367	447	2	44	80	0.5500000
NODE_13615_length_761_cov_38.694864	367	447	4	11	80	0.1375000
NODE_13616_length_761_cov_32.382175	432	512	8	24	80	0.3000000
NODE_13616_length_761_cov_32.382175	432	512	9	1	80	0.0125000
NODE_13616_length_761_cov_32.382175	432	512	10	55	80	0.6875000
NODE_13616_length_761_cov_32.382175	485	565	0	4	80	0.0500000
NODE_13616_length_761_cov_32.382175	485	565	2	44	80	0.5500000
NODE_13616_length_761_cov_32.382175	485	565	7	4	80	0.0500000
NODE_13616_length_761_cov_32.382175	485	565	9	2	80	0.0250000
NODE_13616_length_761_cov_32.382175	485	565	10	26	80	0.3250000
NODE_13617_length_761_cov_31.444109	323	403	0	80	80	1.0000000
NODE_13617_length_761_cov_31.444109	376	467	0	91	91	1.0000000
NODE_13618_length_761_cov_14.004532	366	446	2	26	80	0.3250000
NODE_13618_length_761_cov_14.004532	366	446	3	34	80	0.4250000
NODE_13618_length_761_cov_14.004532	366	446	4	20	80	0.2500000
NODE_13618_length_761_cov_14.004532	419	499	2	18	80	0.2250000
NODE_13618_length_761_cov_14.004532	419	499	4	62	80	0.7750000
NODE_13619_length_761_cov_13.287009	336	415	2	15	79	0.1898734
NODE_13619_length_761_cov_13.287009	336	415	6	64	79	0.8101266
NODE_13619_length_761_cov_13.287009	388	468	0	41	80	0.5125000
NODE_13619_length_761_cov_13.287009	388	468	2	27	80	0.3375000
NODE_13619_length_761_cov_13.287009	388	468	6	12	80	0.1500000
NODE_13621_length_761_cov_9.654079	274	354	0	31	80	0.3875000
NODE_13621_length_761_cov_9.654079	274	354	2	29	80	0.3625000
NODE_13621_length_761_cov_9.654079	274	354	4	20	80	0.2500000
NODE_13621_length_761_cov_9.654079	327	407	0	1	80	0.0125000
NODE_13621_length_761_cov_9.654079	327	407	2	16	80	0.2000000
NODE_13621_length_761_cov_9.654079	327	407	4	63	80	0.7875000
NODE_13622_length_761_cov_7.306647	308	388	0	14	80	0.1750000
NODE_13622_length_761_cov_7.306647	308	388	2	66	80	0.8250000
NODE_13622_length_761_cov_7.306647	361	441	0	67	80	0.8375000
NODE_13622_length_761_cov_7.306647	361	441	2	13	80	0.1625000
NODE_13625_length_761_cov_4.314199	354	434	0	80	80	1.0000000
NODE_13625_length_761_cov_4.314199	407	487	0	80	80	1.0000000
NODE_13658_length_760_cov_48.290469	215	295	0	80	80	1.0000000
NODE_13658_length_760_cov_48.290469	268	348	0	80	80	1.0000000
NODE_13658_length_760_cov_48.290469	344	424	0	80	80	1.0000000
NODE_13658_length_760_cov_48.290469	397	477	0	80	80	1.0000000
NODE_13659_length_760_cov_28.314675	384	464	0	38	80	0.4750000
NODE_13659_length_760_cov_28.314675	384	464	2	38	80	0.4750000
NODE_13659_length_760_cov_28.314675	384	464	4	4	80	0.0500000
NODE_13659_length_760_cov_28.314675	437	517	2	55	80	0.6875000
NODE_13659_length_760_cov_28.314675	437	517	4	25	80	0.3125000
NODE_13660_length_760_cov_27.981846	432	512	0	80	80	1.0000000
NODE_13660_length_760_cov_27.981846	485	565	0	80	80	1.0000000
NODE_13661_length_760_cov_17.500756	372	452	1	80	80	1.0000000
NODE_13661_length_760_cov_17.500756	425	505	1	80	80	1.0000000
NODE_13662_length_760_cov_17.420575	183	263	4	80	80	1.0000000
NODE_13662_length_760_cov_17.420575	236	316	2	17	80	0.2125000
NODE_13662_length_760_cov_17.420575	236	316	4	63	80	0.7875000
NODE_13663_length_760_cov_13.444781	357	437	0	4	80	0.0500000
NODE_13663_length_760_cov_13.444781	357	437	4	76	80	0.9500000
NODE_13663_length_760_cov_13.444781	410	490	0	20	80	0.2500000
NODE_13663_length_760_cov_13.444781	410	490	4	60	80	0.7500000
NODE_13664_length_760_cov_13.196672	282	362	0	80	80	1.0000000
NODE_13664_length_760_cov_13.196672	335	415	0	80	80	1.0000000
NODE_13665_length_760_cov_12.692890	295	375	0	80	80	1.0000000
NODE_13665_length_760_cov_12.692890	348	428	0	36	80	0.4500000
NODE_13665_length_760_cov_12.692890	348	428	4	44	80	0.5500000
NODE_13671_length_760_cov_4.282905	388	468	0	42	80	0.5250000
NODE_13671_length_760_cov_4.282905	388	468	2	38	80	0.4750000
NODE_13671_length_760_cov_4.282905	441	521	2	80	80	1.0000000
NODE_13671_length_760_cov_4.282905	517	597	0	8	80	0.1000000
NODE_13671_length_760_cov_4.282905	517	597	2	72	80	0.9000000
NODE_13683_length_760_cov_1.990923	490	570	0	49	80	0.6125000
NODE_13683_length_760_cov_1.990923	490	570	1	21	80	0.2625000
NODE_13683_length_760_cov_1.990923	490	570	2	2	80	0.0250000
NODE_13683_length_760_cov_1.990923	490	570	4	8	80	0.1000000
NODE_13683_length_760_cov_1.990923	543	623	1	17	80	0.2125000
NODE_13683_length_760_cov_1.990923	543	623	2	2	80	0.0250000
NODE_13683_length_760_cov_1.990923	543	623	4	46	80	0.5750000
NODE_13683_length_760_cov_1.990923	543	623	8	5	80	0.0625000
NODE_13683_length_760_cov_1.990923	543	623	12	10	80	0.1250000
NODE_13709_length_759_cov_24.757576	376	456	16	80	80	1.0000000
NODE_13709_length_759_cov_24.757576	429	509	0	29	80	0.3625000
NODE_13709_length_759_cov_24.757576	429	509	5	1	80	0.0125000
NODE_13709_length_759_cov_24.757576	429	509	7	1	80	0.0125000
NODE_13709_length_759_cov_24.757576	429	509	8	19	80	0.2375000
NODE_13709_length_759_cov_24.757576	429	509	14	1	80	0.0125000
NODE_13709_length_759_cov_24.757576	429	509	16	29	80	0.3625000
NODE_13710_length_759_cov_14.356061	210	290	0	80	80	1.0000000
NODE_13710_length_759_cov_14.356061	263	343	0	80	80	1.0000000
NODE_13711_length_759_cov_10.956061	328	408	2	19	80	0.2375000
NODE_13711_length_759_cov_10.956061	328	408	4	16	80	0.2000000
NODE_13711_length_759_cov_10.956061	328	408	6	45	80	0.5625000
NODE_13711_length_759_cov_10.956061	381	461	0	33	80	0.4125000
NODE_13711_length_759_cov_10.956061	381	461	2	39	80	0.4875000
NODE_13711_length_759_cov_10.956061	381	461	6	8	80	0.1000000
NODE_13712_length_759_cov_10.639394	330	410	4	36	80	0.4500000
NODE_13712_length_759_cov_10.639394	330	410	6	44	80	0.5500000
NODE_13712_length_759_cov_10.639394	383	463	2	53	80	0.6625000
NODE_13712_length_759_cov_10.639394	383	463	6	27	80	0.3375000
NODE_13713_length_759_cov_9.192424	209	290	16	2	81	0.0246914
NODE_13713_length_759_cov_9.192424	209	290	18	3	81	0.0370370
NODE_13713_length_759_cov_9.192424	209	290	20	1	81	0.0123457
NODE_13713_length_759_cov_9.192424	209	290	22	3	81	0.0370370
NODE_13713_length_759_cov_9.192424	209	290	24	1	81	0.0123457
NODE_13713_length_759_cov_9.192424	209	290	26	2	81	0.0246914
NODE_13713_length_759_cov_9.192424	209	290	28	1	81	0.0123457
NODE_13713_length_759_cov_9.192424	209	290	33	6	81	0.0740741
NODE_13713_length_759_cov_9.192424	209	290	34	3	81	0.0370370
NODE_13713_length_759_cov_9.192424	209	290	38	1	81	0.0123457
NODE_13713_length_759_cov_9.192424	209	290	39	27	81	0.3333333
NODE_13713_length_759_cov_9.192424	209	290	40	1	81	0.0123457
NODE_13713_length_759_cov_9.192424	209	290	41	24	81	0.2962963
NODE_13713_length_759_cov_9.192424	209	290	42	2	81	0.0246914
NODE_13713_length_759_cov_9.192424	209	290	46	4	81	0.0493827
NODE_13713_length_759_cov_9.192424	262	310	7	2	48	0.0416667
NODE_13713_length_759_cov_9.192424	262	310	9	4	48	0.0833333
NODE_13713_length_759_cov_9.192424	262	310	10	1	48	0.0208333
NODE_13713_length_759_cov_9.192424	262	310	12	5	48	0.1041667
NODE_13713_length_759_cov_9.192424	262	310	14	2	48	0.0416667
NODE_13713_length_759_cov_9.192424	262	310	16	4	48	0.0833333
NODE_13713_length_759_cov_9.192424	262	310	18	3	48	0.0625000
NODE_13713_length_759_cov_9.192424	262	310	20	1	48	0.0208333
NODE_13713_length_759_cov_9.192424	262	310	22	3	48	0.0625000
NODE_13713_length_759_cov_9.192424	262	310	24	5	48	0.1041667
NODE_13713_length_759_cov_9.192424	262	310	26	2	48	0.0416667
NODE_13713_length_759_cov_9.192424	262	310	28	1	48	0.0208333
NODE_13713_length_759_cov_9.192424	262	310	33	6	48	0.1250000
NODE_13713_length_759_cov_9.192424	262	310	34	3	48	0.0625000
NODE_13713_length_759_cov_9.192424	262	310	38	1	48	0.0208333
NODE_13713_length_759_cov_9.192424	262	310	39	5	48	0.1041667
NODE_13714_length_759_cov_8.771212	292	372	0	80	80	1.0000000
NODE_13714_length_759_cov_8.771212	345	425	0	80	80	1.0000000
NODE_13715_length_759_cov_8.650000	324	404	0	80	80	1.0000000
NODE_13715_length_759_cov_8.650000	377	457	0	80	80	1.0000000
NODE_13716_length_759_cov_8.268182	604	684	2	69	80	0.8625000
NODE_13716_length_759_cov_8.268182	604	684	4	11	80	0.1375000
NODE_13716_length_759_cov_8.268182	657	737	2	76	80	0.9500000
NODE_13716_length_759_cov_8.268182	657	737	4	4	80	0.0500000
NODE_13717_length_759_cov_6.833333	381	461	0	80	80	1.0000000
NODE_13717_length_759_cov_6.833333	434	515	0	81	81	1.0000000
NODE_13718_length_759_cov_6.407576	319	399	0	32	80	0.4000000
NODE_13718_length_759_cov_6.407576	319	399	6	48	80	0.6000000
NODE_13718_length_759_cov_6.407576	372	452	0	80	80	1.0000000
NODE_13725_length_759_cov_3.400000	355	435	0	69	80	0.8625000
NODE_13725_length_759_cov_3.400000	355	435	2	11	80	0.1375000
NODE_13725_length_759_cov_3.400000	408	488	0	80	80	1.0000000
NODE_13726_length_759_cov_3.346970	240	322	0	75	82	0.9146342
NODE_13726_length_759_cov_3.346970	240	322	2	7	82	0.0853659
NODE_13760_length_758_cov_38.414264	215	295	0	22	80	0.2750000
NODE_13760_length_758_cov_38.414264	215	295	2	58	80	0.7250000
NODE_13760_length_758_cov_38.414264	268	348	0	21	80	0.2625000
NODE_13760_length_758_cov_38.414264	268	348	2	59	80	0.7375000
NODE_13760_length_758_cov_38.414264	344	424	0	80	80	1.0000000
NODE_13760_length_758_cov_38.414264	397	477	0	80	80	1.0000000
NODE_13761_length_758_cov_36.722307	331	411	0	2	80	0.0250000
NODE_13761_length_758_cov_36.722307	331	411	7	36	80	0.4500000
NODE_13761_length_758_cov_36.722307	331	411	8	42	80	0.5250000
NODE_13761_length_758_cov_36.722307	384	464	0	55	80	0.6875000
NODE_13761_length_758_cov_36.722307	384	464	7	25	80	0.3125000
NODE_13762_length_758_cov_29.910470	235	315	0	21	80	0.2625000
NODE_13762_length_758_cov_29.910470	235	315	1	59	80	0.7375000
NODE_13762_length_758_cov_29.910470	288	368	0	74	80	0.9250000
NODE_13762_length_758_cov_29.910470	288	368	1	6	80	0.0750000
NODE_13763_length_758_cov_16.226100	386	466	0	80	80	1.0000000
NODE_13763_length_758_cov_16.226100	439	519	0	80	80	1.0000000
NODE_13764_length_758_cov_16.097117	311	391	0	80	80	1.0000000
NODE_13764_length_758_cov_16.097117	364	444	0	80	80	1.0000000
NODE_13765_length_758_cov_15.525038	260	340	0	40	80	0.5000000
NODE_13765_length_758_cov_15.525038	260	340	4	40	80	0.5000000
NODE_13765_length_758_cov_15.525038	313	393	4	50	80	0.6250000
NODE_13765_length_758_cov_15.525038	313	393	6	30	80	0.3750000
NODE_13768_length_758_cov_9.153263	224	299	0	75	75	1.0000000
NODE_13771_length_758_cov_4.241275	508	588	0	80	80	1.0000000
NODE_13772_length_758_cov_3.902883	346	426	0	42	80	0.5250000
NODE_13772_length_758_cov_3.902883	346	426	2	38	80	0.4750000
NODE_13772_length_758_cov_3.902883	399	479	0	80	80	1.0000000
NODE_13794_length_757_cov_49.057751	155	235	0	80	80	1.0000000
NODE_13794_length_757_cov_49.057751	208	288	0	80	80	1.0000000
NODE_13795_length_757_cov_29.954407	181	262	0	81	81	1.0000000
NODE_13795_length_757_cov_29.954407	235	315	0	28	80	0.3500000
NODE_13795_length_757_cov_29.954407	235	315	6	52	80	0.6500000
NODE_13795_length_757_cov_29.954407	311	391	0	37	80	0.4625000
NODE_13795_length_757_cov_29.954407	311	391	2	8	80	0.1000000
NODE_13795_length_757_cov_29.954407	311	391	6	35	80	0.4375000
NODE_13795_length_757_cov_29.954407	364	444	0	80	80	1.0000000
NODE_13796_length_757_cov_25.565350	352	432	0	80	80	1.0000000
NODE_13796_length_757_cov_25.565350	405	483	0	78	78	1.0000000
NODE_13797_length_757_cov_18.338906	264	344	0	80	80	1.0000000
NODE_13797_length_757_cov_18.338906	317	397	0	80	80	1.0000000
NODE_13798_length_757_cov_15.879939	58	138	0	80	80	1.0000000
NODE_13798_length_757_cov_15.879939	111	191	0	80	80	1.0000000
NODE_13800_length_757_cov_15.291793	314	394	0	65	80	0.8125000
NODE_13800_length_757_cov_15.291793	314	394	2	15	80	0.1875000
NODE_13800_length_757_cov_15.291793	367	447	0	12	80	0.1500000
NODE_13800_length_757_cov_15.291793	367	447	2	68	80	0.8500000
NODE_13807_length_757_cov_3.182371	423	503	0	80	80	1.0000000
NODE_13807_length_757_cov_3.182371	476	556	0	80	80	1.0000000
NODE_13832_length_756_cov_26.441400	287	367	1	80	80	1.0000000
NODE_13832_length_756_cov_26.441400	340	420	0	28	80	0.3500000
NODE_13832_length_756_cov_26.441400	340	420	1	52	80	0.6500000
NODE_13834_length_756_cov_13.097412	154	234	0	80	80	1.0000000
NODE_13834_length_756_cov_13.097412	207	287	0	80	80	1.0000000
NODE_13835_length_756_cov_12.732116	377	457	13	3	80	0.0375000
NODE_13835_length_756_cov_12.732116	377	457	21	17	80	0.2125000
NODE_13835_length_756_cov_12.732116	377	457	22	60	80	0.7500000
NODE_13836_length_756_cov_9.254186	241	321	0	80	80	1.0000000
NODE_13836_length_756_cov_9.254186	294	374	0	80	80	1.0000000
NODE_13837_length_756_cov_8.304414	363	409	0	46	46	1.0000000
NODE_13838_length_756_cov_8.105023	271	351	3	15	80	0.1875000
NODE_13838_length_756_cov_8.105023	271	351	4	41	80	0.5125000
NODE_13838_length_756_cov_8.105023	271	351	5	13	80	0.1625000
NODE_13838_length_756_cov_8.105023	271	351	6	11	80	0.1375000
NODE_13838_length_756_cov_8.105023	324	404	2	28	80	0.3500000
NODE_13838_length_756_cov_8.105023	324	404	3	40	80	0.5000000
NODE_13838_length_756_cov_8.105023	324	404	5	12	80	0.1500000
NODE_13840_length_756_cov_6.622527	431	511	5	24	80	0.3000000
NODE_13840_length_756_cov_6.622527	431	511	6	56	80	0.7000000
NODE_13840_length_756_cov_6.622527	484	565	1	2	81	0.0246914
NODE_13840_length_756_cov_6.622527	484	565	2	30	81	0.3703704
NODE_13840_length_756_cov_6.622527	484	565	6	49	81	0.6049383
NODE_13888_length_755_cov_64.705793	303	383	0	11	80	0.1375000
NODE_13888_length_755_cov_64.705793	303	383	2	69	80	0.8625000
NODE_13888_length_755_cov_64.705793	356	436	0	64	80	0.8000000
NODE_13888_length_755_cov_64.705793	356	436	2	16	80	0.2000000
NODE_13889_length_755_cov_58.214939	425	505	0	29	80	0.3625000
NODE_13889_length_755_cov_58.214939	425	505	5	1	80	0.0125000
NODE_13889_length_755_cov_58.214939	425	505	7	6	80	0.0750000
NODE_13889_length_755_cov_58.214939	425	505	9	21	80	0.2625000
NODE_13889_length_755_cov_58.214939	425	505	10	23	80	0.2875000
NODE_13889_length_755_cov_58.214939	425	505	0	29	80	0.3625000
NODE_13889_length_755_cov_58.214939	425	505	5	1	80	0.0125000
NODE_13889_length_755_cov_58.214939	425	505	7	6	80	0.0750000
NODE_13889_length_755_cov_58.214939	425	505	9	21	80	0.2625000
NODE_13889_length_755_cov_58.214939	425	505	10	23	80	0.2875000
NODE_13889_length_755_cov_58.214939	478	556	0	78	78	1.0000000
NODE_13889_length_755_cov_58.214939	478	556	0	78	78	1.0000000
NODE_13890_length_755_cov_25.945122	237	317	22	32	80	0.4000000
NODE_13890_length_755_cov_25.945122	237	317	27	6	80	0.0750000
NODE_13890_length_755_cov_25.945122	237	317	28	42	80	0.5250000
NODE_13890_length_755_cov_25.945122	290	370	17	46	80	0.5750000
NODE_13890_length_755_cov_25.945122	290	370	24	1	80	0.0125000
NODE_13890_length_755_cov_25.945122	290	370	27	11	80	0.1375000
NODE_13890_length_755_cov_25.945122	290	370	28	22	80	0.2750000
NODE_13891_length_755_cov_24.263720	334	414	0	80	80	1.0000000
NODE_13891_length_755_cov_24.263720	387	467	0	80	80	1.0000000
NODE_13892_length_755_cov_15.559451	306	386	0	80	80	1.0000000
NODE_13892_length_755_cov_15.559451	359	439	0	80	80	1.0000000
NODE_13894_length_755_cov_10.196646	332	412	0	80	80	1.0000000
NODE_13894_length_755_cov_10.196646	385	465	0	27	80	0.3375000
NODE_13894_length_755_cov_10.196646	385	465	8	53	80	0.6625000
NODE_13895_length_755_cov_9.772866	210	290	2	69	80	0.8625000
NODE_13895_length_755_cov_9.772866	210	290	4	11	80	0.1375000
NODE_13895_length_755_cov_9.772866	263	343	2	75	80	0.9375000
NODE_13895_length_755_cov_9.772866	263	343	4	5	80	0.0625000
NODE_13936_length_754_cov_87.432061	208	288	0	27	80	0.3375000
NODE_13936_length_754_cov_87.432061	208	288	1	12	80	0.1500000
NODE_13936_length_754_cov_87.432061	208	288	9	39	80	0.4875000
NODE_13936_length_754_cov_87.432061	208	288	10	2	80	0.0250000
NODE_13936_length_754_cov_87.432061	261	341	2	13	80	0.1625000
NODE_13936_length_754_cov_87.432061	261	341	9	25	80	0.3125000
NODE_13936_length_754_cov_87.432061	261	341	10	42	80	0.5250000
NODE_13937_length_754_cov_16.549618	156	236	0	80	80	1.0000000
NODE_13937_length_754_cov_16.549618	209	289	0	80	80	1.0000000
NODE_13939_length_754_cov_9.068702	316	396	0	80	80	1.0000000
NODE_13939_length_754_cov_9.068702	369	449	0	80	80	1.0000000
NODE_13940_length_754_cov_5.925191	287	367	0	80	80	1.0000000
NODE_13940_length_754_cov_5.925191	340	420	0	80	80	1.0000000
NODE_13974_length_753_cov_10.434251	386	466	0	80	80	1.0000000
NODE_13974_length_753_cov_10.434251	439	519	0	80	80	1.0000000
NODE_13976_length_753_cov_7.056575	344	424	0	80	80	1.0000000
NODE_13976_length_753_cov_7.056575	397	477	0	80	80	1.0000000
NODE_13977_length_753_cov_4.597859	321	401	0	18	80	0.2250000
NODE_13977_length_753_cov_4.597859	321	401	2	62	80	0.7750000
NODE_13977_length_753_cov_4.597859	374	454	2	80	80	1.0000000
NODE_14003_length_752_cov_66.281776	617	697	18	6	80	0.0750000
NODE_14003_length_752_cov_66.281776	617	697	20	5	80	0.0625000
NODE_14003_length_752_cov_66.281776	617	697	22	13	80	0.1625000
NODE_14003_length_752_cov_66.281776	617	697	24	7	80	0.0875000
NODE_14003_length_752_cov_66.281776	617	697	28	10	80	0.1250000
NODE_14003_length_752_cov_66.281776	617	697	29	9	80	0.1125000
NODE_14003_length_752_cov_66.281776	617	697	30	3	80	0.0375000
NODE_14003_length_752_cov_66.281776	617	697	31	11	80	0.1375000
NODE_14003_length_752_cov_66.281776	617	697	32	6	80	0.0750000
NODE_14003_length_752_cov_66.281776	617	697	33	9	80	0.1125000
NODE_14003_length_752_cov_66.281776	617	697	34	1	80	0.0125000
NODE_14003_length_752_cov_66.281776	670	751	0	10	81	0.1234568
NODE_14003_length_752_cov_66.281776	670	751	2	12	81	0.1481481
NODE_14003_length_752_cov_66.281776	670	751	8	21	81	0.2592593
NODE_14003_length_752_cov_66.281776	670	751	13	1	81	0.0123457
NODE_14003_length_752_cov_66.281776	670	751	18	16	81	0.1975309
NODE_14003_length_752_cov_66.281776	670	751	20	5	81	0.0617284
NODE_14003_length_752_cov_66.281776	670	751	22	13	81	0.1604938
NODE_14003_length_752_cov_66.281776	670	751	24	3	81	0.0370370
NODE_14004_length_752_cov_60.274119	193	273	0	80	80	1.0000000
NODE_14004_length_752_cov_60.274119	246	326	0	80	80	1.0000000
NODE_14005_length_752_cov_19.811639	299	379	0	7	80	0.0875000
NODE_14005_length_752_cov_19.811639	299	379	2	73	80	0.9125000
NODE_14005_length_752_cov_19.811639	352	432	0	60	80	0.7500000
NODE_14005_length_752_cov_19.811639	352	432	2	20	80	0.2500000
NODE_14006_length_752_cov_17.661562	118	198	2	3	80	0.0375000
NODE_14006_length_752_cov_17.661562	118	198	4	39	80	0.4875000
NODE_14006_length_752_cov_17.661562	118	198	11	1	80	0.0125000
NODE_14006_length_752_cov_17.661562	118	198	12	36	80	0.4500000
NODE_14006_length_752_cov_17.661562	118	198	14	1	80	0.0125000
NODE_14006_length_752_cov_17.661562	171	251	0	1	80	0.0125000
NODE_14006_length_752_cov_17.661562	171	251	2	3	80	0.0375000
NODE_14006_length_752_cov_17.661562	171	251	9	1	80	0.0125000
NODE_14006_length_752_cov_17.661562	171	251	10	48	80	0.6000000
NODE_14006_length_752_cov_17.661562	171	251	12	26	80	0.3250000
NODE_14006_length_752_cov_17.661562	171	251	14	1	80	0.0125000
NODE_14007_length_752_cov_13.275651	241	321	2	31	80	0.3875000
NODE_14007_length_752_cov_13.275651	241	321	4	49	80	0.6125000
NODE_14007_length_752_cov_13.275651	294	374	0	22	80	0.2750000
NODE_14007_length_752_cov_13.275651	294	374	2	3	80	0.0375000
NODE_14007_length_752_cov_13.275651	294	374	4	55	80	0.6875000
NODE_14008_length_752_cov_10.928025	313	393	11	3	80	0.0375000
NODE_14008_length_752_cov_10.928025	313	393	12	13	80	0.1625000
NODE_14008_length_752_cov_10.928025	313	393	13	1	80	0.0125000
NODE_14008_length_752_cov_10.928025	313	393	14	11	80	0.1375000
NODE_14008_length_752_cov_10.928025	313	393	15	1	80	0.0125000
NODE_14008_length_752_cov_10.928025	313	393	16	6	80	0.0750000
NODE_14008_length_752_cov_10.928025	313	393	18	25	80	0.3125000
NODE_14008_length_752_cov_10.928025	313	393	20	20	80	0.2500000
NODE_14011_length_752_cov_9.558959	249	329	0	80	80	1.0000000
NODE_14011_length_752_cov_9.558959	302	382	0	80	80	1.0000000
NODE_14014_length_752_cov_8.281776	237	317	0	26	80	0.3250000
NODE_14014_length_752_cov_8.281776	237	317	2	54	80	0.6750000
NODE_14014_length_752_cov_8.281776	290	370	0	40	80	0.5000000
NODE_14014_length_752_cov_8.281776	290	370	2	40	80	0.5000000
NODE_14015_length_752_cov_8.082695	352	432	0	34	80	0.4250000
NODE_14015_length_752_cov_8.082695	352	432	2	46	80	0.5750000
NODE_14015_length_752_cov_8.082695	405	485	0	34	80	0.4250000
NODE_14015_length_752_cov_8.082695	405	485	2	46	80	0.5750000
NODE_14044_length_751_cov_20.730061	238	318	0	80	80	1.0000000
NODE_14044_length_751_cov_20.730061	291	371	0	80	80	1.0000000
NODE_14045_length_751_cov_18.478528	328	409	0	35	81	0.4320988
NODE_14045_length_751_cov_18.478528	328	409	2	46	81	0.5679013
NODE_14045_length_751_cov_18.478528	382	462	0	80	80	1.0000000
NODE_14046_length_751_cov_13.016871	172	252	0	80	80	1.0000000
NODE_14046_length_751_cov_13.016871	225	305	0	80	80	1.0000000
NODE_14047_length_751_cov_12.363497	397	477	0	80	80	1.0000000
NODE_14047_length_751_cov_12.363497	450	530	0	51	80	0.6375000
NODE_14047_length_751_cov_12.363497	450	530	1	29	80	0.3625000
NODE_14085_length_750_cov_46.371736	396	476	0	17	80	0.2125000
NODE_14085_length_750_cov_46.371736	396	476	2	63	80	0.7875000
NODE_14085_length_750_cov_46.371736	449	529	0	54	80	0.6750000
NODE_14085_length_750_cov_46.371736	449	529	2	26	80	0.3250000
NODE_14086_length_750_cov_24.428571	524	604	50	2	80	0.0250000
NODE_14086_length_750_cov_24.428571	524	604	54	1	80	0.0125000
NODE_14086_length_750_cov_24.428571	524	604	60	1	80	0.0125000
NODE_14086_length_750_cov_24.428571	524	604	66	3	80	0.0375000
NODE_14086_length_750_cov_24.428571	524	604	69	6	80	0.0750000
NODE_14086_length_750_cov_24.428571	524	604	71	1	80	0.0125000
NODE_14086_length_750_cov_24.428571	524	604	72	4	80	0.0500000
NODE_14086_length_750_cov_24.428571	524	604	74	3	80	0.0375000
NODE_14086_length_750_cov_24.428571	524	604	76	4	80	0.0500000
NODE_14086_length_750_cov_24.428571	524	604	77	1	80	0.0125000
NODE_14086_length_750_cov_24.428571	524	604	78	3	80	0.0375000
NODE_14086_length_750_cov_24.428571	524	604	79	2	80	0.0250000
NODE_14086_length_750_cov_24.428571	524	604	80	20	80	0.2500000
NODE_14086_length_750_cov_24.428571	524	604	82	2	80	0.0250000
NODE_14086_length_750_cov_24.428571	524	604	83	8	80	0.1000000
NODE_14086_length_750_cov_24.428571	524	604	84	1	80	0.0125000
NODE_14086_length_750_cov_24.428571	524	604	85	15	80	0.1875000
NODE_14086_length_750_cov_24.428571	524	604	87	3	80	0.0375000
NODE_14086_length_750_cov_24.428571	683	746	0	63	63	1.0000000
NODE_14087_length_750_cov_24.311828	325	405	0	8	80	0.1000000
NODE_14087_length_750_cov_24.311828	325	405	2	68	80	0.8500000
NODE_14087_length_750_cov_24.311828	325	405	4	4	80	0.0500000
NODE_14087_length_750_cov_24.311828	378	458	0	10	80	0.1250000
NODE_14087_length_750_cov_24.311828	378	458	2	66	80	0.8250000
NODE_14087_length_750_cov_24.311828	378	458	4	4	80	0.0500000
NODE_14089_length_750_cov_8.529954	336	416	0	80	80	1.0000000
NODE_14089_length_750_cov_8.529954	395	469	0	74	74	1.0000000
NODE_14137_length_749_cov_18.986154	221	301	0	80	80	1.0000000
NODE_14137_length_749_cov_18.986154	274	354	0	80	80	1.0000000
NODE_14138_length_749_cov_18.836923	273	355	0	82	82	1.0000000
NODE_14138_length_749_cov_18.836923	328	408	0	80	80	1.0000000
NODE_14138_length_749_cov_18.836923	404	484	0	69	80	0.8625000
NODE_14138_length_749_cov_18.836923	404	484	2	11	80	0.1375000
NODE_14138_length_749_cov_18.836923	457	535	0	16	78	0.2051282
NODE_14138_length_749_cov_18.836923	457	535	2	62	78	0.7948718
NODE_14139_length_749_cov_16.160000	232	253	6	21	21	1.0000000
NODE_14139_length_749_cov_16.160000	232	306	6	74	74	1.0000000
NODE_14140_length_749_cov_16.115385	307	387	0	53	80	0.6625000
NODE_14140_length_749_cov_16.115385	307	387	2	27	80	0.3375000
NODE_14140_length_749_cov_16.115385	360	440	2	80	80	1.0000000
NODE_14141_length_749_cov_11.210769	340	420	0	80	80	1.0000000
NODE_14141_length_749_cov_11.210769	393	473	0	80	80	1.0000000
NODE_14142_length_749_cov_8.424615	372	452	0	80	80	1.0000000
NODE_14142_length_749_cov_8.424615	425	505	0	80	80	1.0000000
NODE_14145_length_749_cov_4.521538	550	630	0	80	80	1.0000000
NODE_14145_length_749_cov_4.521538	603	683	0	80	80	1.0000000
NODE_14185_length_748_cov_55.348228	393	473	2	51	80	0.6375000
NODE_14185_length_748_cov_55.348228	393	473	4	29	80	0.3625000
NODE_14185_length_748_cov_55.348228	446	526	0	18	80	0.2250000
NODE_14185_length_748_cov_55.348228	446	526	2	59	80	0.7375000
NODE_14185_length_748_cov_55.348228	446	526	4	3	80	0.0375000
NODE_14186_length_748_cov_51.838213	369	449	0	59	80	0.7375000
NODE_14186_length_748_cov_51.838213	369	449	2	10	80	0.1250000
NODE_14186_length_748_cov_51.838213	369	449	4	11	80	0.1375000
NODE_14186_length_748_cov_51.838213	422	502	0	6	80	0.0750000
NODE_14186_length_748_cov_51.838213	422	502	2	10	80	0.1250000
NODE_14186_length_748_cov_51.838213	422	502	4	64	80	0.8000000
NODE_14187_length_748_cov_46.952234	293	373	0	12	80	0.1500000
NODE_14187_length_748_cov_46.952234	293	373	2	14	80	0.1750000
NODE_14187_length_748_cov_46.952234	293	373	4	54	80	0.6750000
NODE_14187_length_748_cov_46.952234	346	426	0	16	80	0.2000000
NODE_14187_length_748_cov_46.952234	346	426	2	20	80	0.2500000
NODE_14187_length_748_cov_46.952234	346	426	4	44	80	0.5500000
NODE_14188_length_748_cov_45.001541	272	352	0	80	80	1.0000000
NODE_14188_length_748_cov_45.001541	325	405	0	80	80	1.0000000
NODE_14189_length_748_cov_34.355932	488	568	0	80	80	1.0000000
NODE_14189_length_748_cov_34.355932	541	621	0	80	80	1.0000000
NODE_14190_length_748_cov_25.972265	297	377	20	15	80	0.1875000
NODE_14190_length_748_cov_25.972265	297	377	24	14	80	0.1750000
NODE_14190_length_748_cov_25.972265	297	377	31	24	80	0.3000000
NODE_14190_length_748_cov_25.972265	297	377	33	11	80	0.1375000
NODE_14190_length_748_cov_25.972265	297	377	34	16	80	0.2000000
NODE_14190_length_748_cov_25.972265	350	430	0	15	80	0.1875000
NODE_14190_length_748_cov_25.972265	350	430	6	16	80	0.2000000
NODE_14190_length_748_cov_25.972265	350	430	12	21	80	0.2625000
NODE_14190_length_748_cov_25.972265	350	430	20	16	80	0.2000000
NODE_14190_length_748_cov_25.972265	350	430	24	12	80	0.1500000
NODE_14191_length_748_cov_21.050847	362	442	0	80	80	1.0000000
NODE_14191_length_748_cov_21.050847	415	495	0	80	80	1.0000000
NODE_14192_length_748_cov_20.682589	353	433	2	18	80	0.2250000
NODE_14192_length_748_cov_20.682589	353	433	6	40	80	0.5000000
NODE_14192_length_748_cov_20.682589	353	433	8	22	80	0.2750000
NODE_14192_length_748_cov_20.682589	406	486	0	13	80	0.1625000
NODE_14192_length_748_cov_20.682589	406	486	3	1	80	0.0125000
NODE_14192_length_748_cov_20.682589	406	486	4	32	80	0.4000000
NODE_14192_length_748_cov_20.682589	406	486	6	5	80	0.0625000
NODE_14192_length_748_cov_20.682589	406	486	8	29	80	0.3625000
NODE_14193_length_748_cov_19.081664	261	341	4	80	80	1.0000000
NODE_14193_length_748_cov_19.081664	314	394	0	24	80	0.3000000
NODE_14193_length_748_cov_19.081664	314	394	2	7	80	0.0875000
NODE_14193_length_748_cov_19.081664	314	394	4	49	80	0.6125000
NODE_14193_length_748_cov_19.081664	390	470	0	80	80	1.0000000
NODE_14193_length_748_cov_19.081664	443	522	0	79	79	1.0000000
NODE_14194_length_748_cov_16.579353	81	161	4	47	80	0.5875000
NODE_14194_length_748_cov_16.579353	81	161	6	14	80	0.1750000
NODE_14194_length_748_cov_16.579353	81	161	8	19	80	0.2375000
NODE_14194_length_748_cov_16.579353	134	214	6	14	80	0.1750000
NODE_14194_length_748_cov_16.579353	134	214	8	35	80	0.4375000
NODE_14194_length_748_cov_16.579353	134	214	9	2	80	0.0250000
NODE_14194_length_748_cov_16.579353	134	214	10	29	80	0.3625000
NODE_14194_length_748_cov_16.579353	210	290	8	40	80	0.5000000
NODE_14194_length_748_cov_16.579353	210	290	10	26	80	0.3250000
NODE_14194_length_748_cov_16.579353	210	290	12	9	80	0.1125000
NODE_14194_length_748_cov_16.579353	210	290	16	5	80	0.0625000
NODE_14194_length_748_cov_16.579353	263	343	2	1	80	0.0125000
NODE_14194_length_748_cov_16.579353	263	343	8	60	80	0.7500000
NODE_14194_length_748_cov_16.579353	263	343	10	19	80	0.2375000
NODE_14196_length_748_cov_11.983051	375	455	0	80	80	1.0000000
NODE_14196_length_748_cov_11.983051	428	508	0	80	80	1.0000000
NODE_14197_length_748_cov_11.474576	257	337	0	80	80	1.0000000
NODE_14197_length_748_cov_11.474576	310	390	0	80	80	1.0000000
NODE_14200_length_748_cov_7.979969	223	303	0	26	80	0.3250000
NODE_14200_length_748_cov_7.979969	223	303	2	54	80	0.6750000
NODE_14200_length_748_cov_7.979969	276	356	0	79	80	0.9875000
NODE_14200_length_748_cov_7.979969	276	356	2	1	80	0.0125000
NODE_14240_length_747_cov_24.279321	205	285	0	30	80	0.3750000
NODE_14240_length_747_cov_24.279321	205	285	4	50	80	0.6250000
NODE_14240_length_747_cov_24.279321	258	338	0	18	80	0.2250000
NODE_14240_length_747_cov_24.279321	258	338	4	62	80	0.7750000
NODE_14241_length_747_cov_15.438272	352	432	0	80	80	1.0000000
NODE_14241_length_747_cov_15.438272	405	485	0	67	80	0.8375000
NODE_14241_length_747_cov_15.438272	405	485	2	13	80	0.1625000
NODE_14244_length_747_cov_7.979938	237	317	0	80	80	1.0000000
NODE_14244_length_747_cov_7.979938	290	370	0	40	80	0.5000000
NODE_14244_length_747_cov_7.979938	290	370	1	40	80	0.5000000
NODE_14248_length_747_cov_4.918210	157	237	0	80	80	1.0000000
NODE_14248_length_747_cov_4.918210	210	290	0	80	80	1.0000000
NODE_14277_length_746_cov_44.041731	153	233	0	20	80	0.2500000
NODE_14277_length_746_cov_44.041731	153	233	2	60	80	0.7500000
NODE_14277_length_746_cov_44.041731	206	286	0	57	80	0.7125000
NODE_14277_length_746_cov_44.041731	206	286	2	23	80	0.2875000
NODE_14278_length_746_cov_24.435858	334	414	4	9	80	0.1125000
NODE_14278_length_746_cov_24.435858	334	414	6	71	80	0.8875000
NODE_14278_length_746_cov_24.435858	387	467	2	25	80	0.3125000
NODE_14278_length_746_cov_24.435858	387	467	4	11	80	0.1375000
NODE_14278_length_746_cov_24.435858	387	467	6	44	80	0.5500000
NODE_14279_length_746_cov_20.225657	114	194	0	80	80	1.0000000
NODE_14279_length_746_cov_20.225657	167	247	0	80	80	1.0000000
NODE_14280_length_746_cov_17.919629	330	410	0	46	80	0.5750000
NODE_14280_length_746_cov_17.919629	330	410	2	34	80	0.4250000
NODE_14280_length_746_cov_17.919629	383	463	2	80	80	1.0000000
NODE_14281_length_746_cov_17.523957	292	372	0	80	80	1.0000000
NODE_14281_length_746_cov_17.523957	345	425	0	80	80	1.0000000
NODE_14282_length_746_cov_17.214838	306	386	0	35	80	0.4375000
NODE_14282_length_746_cov_17.214838	306	386	2	45	80	0.5625000
NODE_14282_length_746_cov_17.214838	359	439	0	26	80	0.3250000
NODE_14282_length_746_cov_17.214838	359	439	2	54	80	0.6750000
NODE_14283_length_746_cov_16.765070	344	424	2	80	80	1.0000000
NODE_14283_length_746_cov_16.765070	397	477	0	51	80	0.6375000
NODE_14283_length_746_cov_16.765070	397	477	2	29	80	0.3625000
NODE_14284_length_746_cov_13.153014	126	206	0	80	80	1.0000000
NODE_14284_length_746_cov_13.153014	179	259	0	80	80	1.0000000
NODE_14284_length_746_cov_13.153014	244	263	0	19	19	1.0000000
NODE_14285_length_746_cov_12.316847	364	442	0	78	78	1.0000000
NODE_14286_length_746_cov_11.301391	349	429	0	42	80	0.5250000
NODE_14286_length_746_cov_11.301391	349	429	2	30	80	0.3750000
NODE_14286_length_746_cov_11.301391	349	429	4	8	80	0.1000000
NODE_14286_length_746_cov_11.301391	402	482	2	19	80	0.2375000
NODE_14286_length_746_cov_11.301391	402	482	4	61	80	0.7625000
NODE_14302_length_746_cov_2.639876	331	411	4	25	80	0.3125000
NODE_14302_length_746_cov_2.639876	331	411	6	5	80	0.0625000
NODE_14302_length_746_cov_2.639876	331	411	8	50	80	0.6250000
NODE_14307_length_746_cov_1.879444	435	502	0	67	67	1.0000000
NODE_14310_length_746_cov_1.727975	65	121	0	56	56	1.0000000
NODE_14310_length_746_cov_1.727975	494	540	0	28	46	0.6086956
NODE_14310_length_746_cov_1.727975	494	540	2	18	46	0.3913043
NODE_14329_length_745_cov_40.360681	257	337	0	6	80	0.0750000
NODE_14329_length_745_cov_40.360681	257	337	4	51	80	0.6375000
NODE_14329_length_745_cov_40.360681	257	337	12	23	80	0.2875000
NODE_14329_length_745_cov_40.360681	310	390	4	4	80	0.0500000
NODE_14329_length_745_cov_40.360681	310	390	8	41	80	0.5125000
NODE_14329_length_745_cov_40.360681	310	390	12	35	80	0.4375000
NODE_14330_length_745_cov_30.817337	339	419	0	42	80	0.5250000
NODE_14330_length_745_cov_30.817337	339	419	2	1	80	0.0125000
NODE_14330_length_745_cov_30.817337	339	419	8	37	80	0.4625000
NODE_14330_length_745_cov_30.817337	392	459	5	1	67	0.0149254
NODE_14330_length_745_cov_30.817337	392	459	7	7	67	0.1044776
NODE_14330_length_745_cov_30.817337	392	459	8	59	67	0.8805970
NODE_14335_length_745_cov_8.620743	225	275	0	50	50	1.0000000
NODE_14335_length_745_cov_8.620743	248	328	0	80	80	1.0000000
NODE_14343_length_745_cov_3.922601	249	280	32	3	31	0.0967742
NODE_14343_length_745_cov_3.922601	249	280	37	1	31	0.0322581
NODE_14343_length_745_cov_3.922601	249	280	38	3	31	0.0967742
NODE_14343_length_745_cov_3.922601	249	280	40	7	31	0.2258064
NODE_14343_length_745_cov_3.922601	249	280	42	17	31	0.5483871
NODE_14343_length_745_cov_3.922601	253	333	18	10	80	0.1250000
NODE_14343_length_745_cov_3.922601	253	333	19	1	80	0.0125000
NODE_14343_length_745_cov_3.922601	253	333	20	4	80	0.0500000
NODE_14343_length_745_cov_3.922601	253	333	24	19	80	0.2375000
NODE_14343_length_745_cov_3.922601	253	333	34	1	80	0.0125000
NODE_14343_length_745_cov_3.922601	253	333	36	15	80	0.1875000
NODE_14343_length_745_cov_3.922601	253	333	38	6	80	0.0750000
NODE_14343_length_745_cov_3.922601	253	333	40	7	80	0.0875000
NODE_14343_length_745_cov_3.922601	253	333	42	17	80	0.2125000
NODE_14381_length_744_cov_44.953488	553	633	0	76	80	0.9500000
NODE_14381_length_744_cov_44.953488	553	633	10	4	80	0.0500000
NODE_14381_length_744_cov_44.953488	553	633	0	76	80	0.9500000
NODE_14381_length_744_cov_44.953488	553	633	10	4	80	0.0500000
NODE_14381_length_744_cov_44.953488	553	633	0	76	80	0.9500000
NODE_14381_length_744_cov_44.953488	553	633	10	4	80	0.0500000
NODE_14381_length_744_cov_44.953488	553	633	0	76	80	0.9500000
NODE_14381_length_744_cov_44.953488	553	633	10	4	80	0.0500000
NODE_14382_length_744_cov_35.333333	163	243	4	46	80	0.5750000
NODE_14382_length_744_cov_35.333333	163	243	8	29	80	0.3625000
NODE_14382_length_744_cov_35.333333	163	243	11	5	80	0.0625000
NODE_14382_length_744_cov_35.333333	216	296	0	45	80	0.5625000
NODE_14382_length_744_cov_35.333333	216	296	4	35	80	0.4375000
NODE_14382_length_744_cov_35.333333	292	372	0	34	80	0.4250000
NODE_14382_length_744_cov_35.333333	292	372	4	36	80	0.4500000
NODE_14382_length_744_cov_35.333333	292	372	6	10	80	0.1250000
NODE_14382_length_744_cov_35.333333	345	425	4	17	80	0.2125000
NODE_14382_length_744_cov_35.333333	345	425	6	36	80	0.4500000
NODE_14382_length_744_cov_35.333333	345	425	7	1	80	0.0125000
NODE_14382_length_744_cov_35.333333	345	425	10	26	80	0.3250000
NODE_14383_length_744_cov_34.503876	294	374	0	23	80	0.2875000
NODE_14383_length_744_cov_34.503876	294	374	1	1	80	0.0125000
NODE_14383_length_744_cov_34.503876	294	374	2	56	80	0.7000000
NODE_14383_length_744_cov_34.503876	347	427	0	23	80	0.2875000
NODE_14383_length_744_cov_34.503876	347	427	1	1	80	0.0125000
NODE_14383_length_744_cov_34.503876	347	427	2	56	80	0.7000000
NODE_14384_length_744_cov_32.282171	333	403	0	70	70	1.0000000
NODE_14384_length_744_cov_32.282171	440	520	0	80	80	1.0000000
NODE_14384_length_744_cov_32.282171	493	573	0	80	80	1.0000000
NODE_14390_length_744_cov_4.537984	260	340	0	63	80	0.7875000
NODE_14390_length_744_cov_4.537984	260	340	2	17	80	0.2125000
NODE_14390_length_744_cov_4.537984	313	393	0	10	80	0.1250000
NODE_14390_length_744_cov_4.537984	313	393	2	29	80	0.3625000
NODE_14390_length_744_cov_4.537984	313	393	4	41	80	0.5125000
NODE_14396_length_744_cov_2.784496	335	387	0	3	52	0.0576923
NODE_14396_length_744_cov_2.784496	335	387	8	29	52	0.5576923
NODE_14396_length_744_cov_2.784496	335	387	10	20	52	0.3846154
NODE_14396_length_744_cov_2.784496	360	437	2	5	77	0.0649351
NODE_14396_length_744_cov_2.784496	360	437	8	7	77	0.0909091
NODE_14396_length_744_cov_2.784496	360	437	10	65	77	0.8441558
NODE_14427_length_743_cov_26.369565	354	434	0	80	80	1.0000000
NODE_14427_length_743_cov_26.369565	407	487	0	80	80	1.0000000
NODE_14428_length_743_cov_21.759317	138	218	0	80	80	1.0000000
NODE_14428_length_743_cov_21.759317	191	271	0	46	80	0.5750000
NODE_14428_length_743_cov_21.759317	191	271	2	34	80	0.4250000
NODE_14429_length_743_cov_18.173913	213	293	0	80	80	1.0000000
NODE_14429_length_743_cov_18.173913	266	346	0	80	80	1.0000000
NODE_14431_length_743_cov_17.066770	400	480	0	18	80	0.2250000
NODE_14431_length_743_cov_17.066770	400	480	2	62	80	0.7750000
NODE_14431_length_743_cov_17.066770	453	532	0	19	79	0.2405063
NODE_14431_length_743_cov_17.066770	453	532	2	60	79	0.7594936
NODE_14432_length_743_cov_16.354037	350	430	0	25	80	0.3125000
NODE_14432_length_743_cov_16.354037	350	430	4	55	80	0.6875000
NODE_14432_length_743_cov_16.354037	403	483	0	78	80	0.9750000
NODE_14432_length_743_cov_16.354037	403	483	4	2	80	0.0250000
NODE_14433_length_743_cov_15.667702	220	300	2	9	80	0.1125000
NODE_14433_length_743_cov_15.667702	220	300	4	71	80	0.8875000
NODE_14433_length_743_cov_15.667702	273	353	0	22	80	0.2750000
NODE_14433_length_743_cov_15.667702	273	353	2	29	80	0.3625000
NODE_14433_length_743_cov_15.667702	273	353	4	29	80	0.3625000
NODE_14433_length_743_cov_15.667702	349	429	0	80	80	1.0000000
NODE_14433_length_743_cov_15.667702	402	482	0	80	80	1.0000000
NODE_14434_length_743_cov_14.975155	289	362	2	11	73	0.1506849
NODE_14434_length_743_cov_14.975155	289	362	4	62	73	0.8493150
NODE_14435_length_743_cov_14.100932	232	312	0	80	80	1.0000000
NODE_14435_length_743_cov_14.100932	285	365	0	80	80	1.0000000
NODE_14435_length_743_cov_14.100932	361	441	0	80	80	1.0000000
NODE_14435_length_743_cov_14.100932	414	494	0	80	80	1.0000000
NODE_14436_length_743_cov_12.968944	268	348	0	80	80	1.0000000
NODE_14436_length_743_cov_12.968944	321	401	0	80	80	1.0000000
NODE_14437_length_743_cov_12.847826	485	565	4	73	80	0.9125000
NODE_14437_length_743_cov_12.847826	485	565	6	7	80	0.0875000
NODE_14437_length_743_cov_12.847826	538	618	0	28	80	0.3500000
NODE_14437_length_743_cov_12.847826	538	618	4	52	80	0.6500000
NODE_14438_length_743_cov_11.871118	403	483	0	58	80	0.7250000
NODE_14438_length_743_cov_11.871118	403	483	2	22	80	0.2750000
NODE_14438_length_743_cov_11.871118	456	536	0	80	80	1.0000000
NODE_14439_length_743_cov_11.760870	337	417	0	10	80	0.1250000
NODE_14439_length_743_cov_11.760870	337	417	2	70	80	0.8750000
NODE_14439_length_743_cov_11.760870	390	470	0	56	80	0.7000000
NODE_14439_length_743_cov_11.760870	390	470	2	24	80	0.3000000
NODE_14440_length_743_cov_9.006211	351	431	0	80	80	1.0000000
NODE_14440_length_743_cov_9.006211	404	484	0	80	80	1.0000000
NODE_14441_length_743_cov_8.063665	290	370	3	19	80	0.2375000
NODE_14441_length_743_cov_8.063665	290	370	4	61	80	0.7625000
NODE_14441_length_743_cov_8.063665	343	423	1	2	80	0.0250000
NODE_14441_length_743_cov_8.063665	343	423	3	70	80	0.8750000
NODE_14441_length_743_cov_8.063665	343	423	4	8	80	0.1000000
NODE_14456_length_743_cov_2.029503	260	284	0	24	24	1.0000000
NODE_14456_length_743_cov_2.029503	301	363	0	62	62	1.0000000
NODE_14473_length_743_cov_0.989130	592	670	0	1	78	0.0128205
NODE_14473_length_743_cov_0.989130	592	670	2	3	78	0.0384615
NODE_14473_length_743_cov_0.989130	592	670	4	6	78	0.0769231
NODE_14473_length_743_cov_0.989130	592	670	10	2	78	0.0256410
NODE_14473_length_743_cov_0.989130	592	670	12	1	78	0.0128205
NODE_14473_length_743_cov_0.989130	592	670	21	2	78	0.0256410
NODE_14473_length_743_cov_0.989130	592	670	47	3	78	0.0384615
NODE_14473_length_743_cov_0.989130	592	670	53	1	78	0.0128205
NODE_14473_length_743_cov_0.989130	592	670	67	1	78	0.0128205
NODE_14473_length_743_cov_0.989130	592	670	71	4	78	0.0512821
NODE_14473_length_743_cov_0.989130	592	670	75	4	78	0.0512821
NODE_14473_length_743_cov_0.989130	592	670	80	1	78	0.0128205
NODE_14473_length_743_cov_0.989130	592	670	84	23	78	0.2948718
NODE_14473_length_743_cov_0.989130	592	670	86	26	78	0.3333333
NODE_14477_length_742_cov_23.664075	271	351	0	4	80	0.0500000
NODE_14477_length_742_cov_23.664075	271	351	2	76	80	0.9500000
NODE_14477_length_742_cov_23.664075	324	404	0	22	80	0.2750000
NODE_14477_length_742_cov_23.664075	324	404	2	58	80	0.7250000
NODE_14478_length_742_cov_19.488336	288	368	0	80	80	1.0000000
NODE_14478_length_742_cov_19.488336	341	421	0	80	80	1.0000000
NODE_14479_length_742_cov_18.528771	319	399	0	80	80	1.0000000
NODE_14479_length_742_cov_18.528771	372	452	0	80	80	1.0000000
NODE_14480_length_742_cov_17.401244	126	206	0	26	80	0.3250000
NODE_14480_length_742_cov_17.401244	126	206	4	3	80	0.0375000
NODE_14480_length_742_cov_17.401244	126	206	8	51	80	0.6375000
NODE_14480_length_742_cov_17.401244	179	259	0	41	80	0.5125000
NODE_14480_length_742_cov_17.401244	179	259	2	38	80	0.4750000
NODE_14480_length_742_cov_17.401244	179	259	4	1	80	0.0125000
NODE_14482_length_742_cov_7.679627	274	354	0	46	80	0.5750000
NODE_14482_length_742_cov_7.679627	274	354	2	34	80	0.4250000
NODE_14482_length_742_cov_7.679627	327	407	2	80	80	1.0000000
NODE_14521_length_741_cov_12.168224	316	392	0	20	76	0.2631579
NODE_14521_length_741_cov_12.168224	316	392	2	56	76	0.7368421
NODE_14521_length_741_cov_12.168224	598	663	0	65	65	1.0000000
NODE_14522_length_741_cov_8.542056	198	278	0	80	80	1.0000000
NODE_14522_length_741_cov_8.542056	251	331	0	80	80	1.0000000
NODE_14525_length_741_cov_5.989097	457	538	4	21	81	0.2592593
NODE_14525_length_741_cov_5.989097	457	538	6	48	81	0.5925926
NODE_14525_length_741_cov_5.989097	457	538	8	12	81	0.1481481
NODE_14536_length_741_cov_2.556075	212	289	0	47	77	0.6103896
NODE_14536_length_741_cov_2.556075	212	289	1	28	77	0.3636364
NODE_14536_length_741_cov_2.556075	212	289	2	1	77	0.0129870
NODE_14536_length_741_cov_2.556075	212	289	8	1	77	0.0129870
NODE_14571_length_740_cov_54.372855	192	272	0	80	80	1.0000000
NODE_14571_length_740_cov_54.372855	245	325	0	80	80	1.0000000
NODE_14571_length_740_cov_54.372855	321	401	0	80	80	1.0000000
NODE_14571_length_740_cov_54.372855	374	454	0	80	80	1.0000000
NODE_14572_length_740_cov_51.758190	194	274	0	80	80	1.0000000
NODE_14572_length_740_cov_51.758190	247	327	0	80	80	1.0000000
NODE_14573_length_740_cov_34.185647	359	439	0	26	80	0.3250000
NODE_14573_length_740_cov_34.185647	359	439	2	25	80	0.3125000
NODE_14573_length_740_cov_34.185647	359	439	6	29	80	0.3625000
NODE_14573_length_740_cov_34.185647	412	492	0	79	80	0.9875000
NODE_14573_length_740_cov_34.185647	412	492	2	1	80	0.0125000
NODE_14574_length_740_cov_24.794072	286	366	0	7	80	0.0875000
NODE_14574_length_740_cov_24.794072	286	366	1	73	80	0.9125000
NODE_14574_length_740_cov_24.794072	339	419	1	58	80	0.7250000
NODE_14574_length_740_cov_24.794072	339	419	2	22	80	0.2750000
NODE_14575_length_740_cov_20.361934	316	396	0	49	80	0.6125000
NODE_14575_length_740_cov_20.361934	316	396	2	31	80	0.3875000
NODE_14575_length_740_cov_20.361934	369	449	2	80	80	1.0000000
NODE_14576_length_740_cov_18.982839	266	348	0	82	82	1.0000000
NODE_14576_length_740_cov_18.982839	321	401	0	80	80	1.0000000
NODE_14577_length_740_cov_16.755070	354	434	0	77	80	0.9625000
NODE_14577_length_740_cov_16.755070	354	434	2	3	80	0.0375000
NODE_14577_length_740_cov_16.755070	407	487	0	24	80	0.3000000
NODE_14577_length_740_cov_16.755070	407	487	2	20	80	0.2500000
NODE_14577_length_740_cov_16.755070	407	487	4	36	80	0.4500000
NODE_14579_length_740_cov_7.585023	206	286	0	80	80	1.0000000
NODE_14579_length_740_cov_7.585023	259	339	0	80	80	1.0000000
NODE_14580_length_740_cov_7.174727	165	245	2	23	80	0.2875000
NODE_14580_length_740_cov_7.174727	165	245	4	20	80	0.2500000
NODE_14580_length_740_cov_7.174727	165	245	6	17	80	0.2125000
NODE_14580_length_740_cov_7.174727	165	245	7	20	80	0.2500000
NODE_14580_length_740_cov_7.174727	218	298	4	13	80	0.1625000
NODE_14580_length_740_cov_7.174727	218	298	6	2	80	0.0250000
NODE_14580_length_740_cov_7.174727	218	298	7	25	80	0.3125000
NODE_14580_length_740_cov_7.174727	218	298	8	40	80	0.5000000
NODE_14614_length_739_cov_52.970312	346	426	2	47	80	0.5875000
NODE_14614_length_739_cov_52.970312	346	426	4	33	80	0.4125000
NODE_14614_length_739_cov_52.970312	399	479	2	49	80	0.6125000
NODE_14614_length_739_cov_52.970312	399	479	4	31	80	0.3875000
NODE_14615_length_739_cov_31.175000	204	284	0	10	80	0.1250000
NODE_14615_length_739_cov_31.175000	204	284	2	7	80	0.0875000
NODE_14615_length_739_cov_31.175000	204	284	6	63	80	0.7875000
NODE_14615_length_739_cov_31.175000	257	337	2	9	80	0.1125000
NODE_14615_length_739_cov_31.175000	257	337	4	8	80	0.1000000
NODE_14615_length_739_cov_31.175000	257	337	6	63	80	0.7875000
NODE_14616_length_739_cov_25.482813	487	567	0	80	80	1.0000000
NODE_14616_length_739_cov_25.482813	540	620	0	80	80	1.0000000
NODE_14617_length_739_cov_24.871875	191	271	0	24	80	0.3000000
NODE_14617_length_739_cov_24.871875	191	271	2	56	80	0.7000000
NODE_14617_length_739_cov_24.871875	244	324	0	13	80	0.1625000
NODE_14617_length_739_cov_24.871875	244	324	2	67	80	0.8375000
NODE_14618_length_739_cov_18.360937	146	226	0	80	80	1.0000000
NODE_14618_length_739_cov_18.360937	199	279	0	80	80	1.0000000
NODE_14619_length_739_cov_13.195312	273	353	0	8	80	0.1000000
NODE_14619_length_739_cov_13.195312	273	353	4	45	80	0.5625000
NODE_14619_length_739_cov_13.195312	273	353	10	27	80	0.3375000
NODE_14619_length_739_cov_13.195312	326	406	6	19	80	0.2375000
NODE_14619_length_739_cov_13.195312	326	406	10	61	80	0.7625000
NODE_14620_length_739_cov_10.314063	231	311	0	80	80	1.0000000
NODE_14620_length_739_cov_10.314063	284	364	0	80	80	1.0000000
NODE_14622_length_739_cov_8.523438	468	548	0	80	80	1.0000000
NODE_14622_length_739_cov_8.523438	521	600	0	79	79	1.0000000
NODE_14623_length_739_cov_7.398438	342	422	0	5	80	0.0625000
NODE_14623_length_739_cov_7.398438	342	422	2	58	80	0.7250000
NODE_14623_length_739_cov_7.398438	342	422	4	17	80	0.2125000
NODE_14623_length_739_cov_7.398438	395	475	0	58	80	0.7250000
NODE_14623_length_739_cov_7.398438	395	475	2	22	80	0.2750000
NODE_14625_length_739_cov_5.826562	252	332	4	80	80	1.0000000
NODE_14625_length_739_cov_5.826562	305	385	0	45	80	0.5625000
NODE_14625_length_739_cov_5.826562	305	385	4	35	80	0.4375000
NODE_14634_length_739_cov_3.232813	355	435	0	80	80	1.0000000
NODE_14634_length_739_cov_3.232813	408	488	0	80	80	1.0000000
NODE_14679_length_738_cov_35.278560	274	318	66	2	44	0.0454545
NODE_14679_length_738_cov_35.278560	274	318	68	2	44	0.0454545
NODE_14679_length_738_cov_35.278560	274	318	76	1	44	0.0227273
NODE_14679_length_738_cov_35.278560	274	318	78	7	44	0.1590909
NODE_14679_length_738_cov_35.278560	274	318	83	1	44	0.0227273
NODE_14679_length_738_cov_35.278560	274	318	85	1	44	0.0227273
NODE_14679_length_738_cov_35.278560	274	318	87	1	44	0.0227273
NODE_14679_length_738_cov_35.278560	274	318	88	4	44	0.0909091
NODE_14679_length_738_cov_35.278560	274	318	90	2	44	0.0454545
NODE_14679_length_738_cov_35.278560	274	318	92	2	44	0.0454545
NODE_14679_length_738_cov_35.278560	274	318	94	6	44	0.1363636
NODE_14679_length_738_cov_35.278560	274	318	96	2	44	0.0454545
NODE_14679_length_738_cov_35.278560	274	318	98	1	44	0.0227273
NODE_14679_length_738_cov_35.278560	274	318	99	1	44	0.0227273
NODE_14679_length_738_cov_35.278560	274	318	100	1	44	0.0227273
NODE_14679_length_738_cov_35.278560	274	318	101	3	44	0.0681818
NODE_14679_length_738_cov_35.278560	274	318	103	3	44	0.0681818
NODE_14679_length_738_cov_35.278560	274	318	104	2	44	0.0454545
NODE_14679_length_738_cov_35.278560	274	318	105	2	44	0.0454545
NODE_14680_length_738_cov_21.672926	208	288	0	80	80	1.0000000
NODE_14680_length_738_cov_21.672926	261	341	0	80	80	1.0000000
NODE_14681_length_738_cov_15.665102	302	382	0	80	80	1.0000000
NODE_14681_length_738_cov_15.665102	355	435	0	80	80	1.0000000
NODE_14682_length_738_cov_15.661972	338	418	0	80	80	1.0000000
NODE_14682_length_738_cov_15.661972	391	471	0	80	80	1.0000000
NODE_14683_length_738_cov_12.594679	49	129	0	80	80	1.0000000
NODE_14683_length_738_cov_12.594679	102	182	0	80	80	1.0000000
NODE_14683_length_738_cov_12.594679	178	258	0	80	80	1.0000000
NODE_14683_length_738_cov_12.594679	231	311	0	80	80	1.0000000
NODE_14691_length_738_cov_4.056338	254	326	0	60	72	0.8333333
NODE_14691_length_738_cov_4.056338	254	326	6	12	72	0.1666667
NODE_14691_length_738_cov_4.056338	437	528	2	43	91	0.4725275
NODE_14691_length_738_cov_4.056338	437	528	6	24	91	0.2637363
NODE_14691_length_738_cov_4.056338	437	528	7	2	91	0.0219780
NODE_14691_length_738_cov_4.056338	437	528	8	4	91	0.0439560
NODE_14691_length_738_cov_4.056338	437	528	10	11	91	0.1208791
NODE_14691_length_738_cov_4.056338	437	528	12	7	91	0.0769231
NODE_14724_length_737_cov_22.363636	303	383	6	4	80	0.0500000
NODE_14724_length_737_cov_22.363636	303	383	11	41	80	0.5125000
NODE_14724_length_737_cov_22.363636	303	383	12	35	80	0.4375000
NODE_14724_length_737_cov_22.363636	356	436	0	28	80	0.3500000
NODE_14724_length_737_cov_22.363636	356	436	6	29	80	0.3625000
NODE_14724_length_737_cov_22.363636	356	436	11	23	80	0.2875000
NODE_14725_length_737_cov_21.318182	208	288	0	18	80	0.2250000
NODE_14725_length_737_cov_21.318182	208	288	2	62	80	0.7750000
NODE_14725_length_737_cov_21.318182	261	341	0	27	80	0.3375000
NODE_14725_length_737_cov_21.318182	261	341	1	44	80	0.5500000
NODE_14725_length_737_cov_21.318182	261	341	2	9	80	0.1125000
NODE_14726_length_737_cov_17.161442	346	426	0	44	80	0.5500000
NODE_14726_length_737_cov_17.161442	346	426	2	36	80	0.4500000
NODE_14726_length_737_cov_17.161442	399	479	0	80	80	1.0000000
NODE_14727_length_737_cov_11.835423	211	291	0	80	80	1.0000000
NODE_14727_length_737_cov_11.835423	264	344	0	80	80	1.0000000
NODE_14729_length_737_cov_6.782132	488	548	0	60	60	1.0000000
NODE_14732_length_737_cov_6.089342	241	321	0	5	80	0.0625000
NODE_14732_length_737_cov_6.089342	241	321	2	61	80	0.7625000
NODE_14732_length_737_cov_6.089342	241	321	4	14	80	0.1750000
NODE_14732_length_737_cov_6.089342	294	374	0	58	80	0.7250000
NODE_14732_length_737_cov_6.089342	294	374	2	22	80	0.2750000
NODE_14747_length_737_cov_2.548589	386	416	0	30	30	1.0000000
NODE_14781_length_736_cov_46.601256	226	306	0	80	80	1.0000000
NODE_14781_length_736_cov_46.601256	279	359	0	30	80	0.3750000
NODE_14781_length_736_cov_46.601256	279	359	2	50	80	0.6250000
NODE_14782_length_736_cov_32.442700	215	295	0	80	80	1.0000000
NODE_14782_length_736_cov_32.442700	268	350	0	82	82	1.0000000
NODE_14783_length_736_cov_26.364207	220	300	1	34	80	0.4250000
NODE_14783_length_736_cov_26.364207	220	300	2	46	80	0.5750000
NODE_14783_length_736_cov_26.364207	273	353	1	49	80	0.6125000
NODE_14783_length_736_cov_26.364207	273	353	2	31	80	0.3875000
NODE_14785_length_736_cov_10.317111	313	393	0	80	80	1.0000000
NODE_14785_length_736_cov_10.317111	366	446	0	80	80	1.0000000
NODE_14786_length_736_cov_9.188383	292	372	0	80	80	1.0000000
NODE_14786_length_736_cov_9.188383	345	425	0	80	80	1.0000000
NODE_14787_length_736_cov_8.149137	315	391	0	76	76	1.0000000
NODE_14787_length_736_cov_8.149137	365	445	0	80	80	1.0000000
NODE_14788_length_736_cov_8.103611	295	375	0	80	80	1.0000000
NODE_14788_length_736_cov_8.103611	348	428	0	52	80	0.6500000
NODE_14788_length_736_cov_8.103611	348	428	2	28	80	0.3500000
NODE_14789_length_736_cov_7.513344	239	319	0	80	80	1.0000000
NODE_14789_length_736_cov_7.513344	292	372	0	80	80	1.0000000
NODE_14792_length_736_cov_5.967033	253	333	0	39	80	0.4875000
NODE_14792_length_736_cov_5.967033	253	333	6	36	80	0.4500000
NODE_14792_length_736_cov_5.967033	253	333	8	5	80	0.0625000
NODE_14792_length_736_cov_5.967033	306	386	6	22	80	0.2750000
NODE_14792_length_736_cov_5.967033	306	386	8	56	80	0.7000000
NODE_14792_length_736_cov_5.967033	306	386	10	2	80	0.0250000
NODE_14795_length_736_cov_4.908948	258	338	0	38	80	0.4750000
NODE_14795_length_736_cov_4.908948	258	338	6	17	80	0.2125000
NODE_14795_length_736_cov_4.908948	258	338	8	25	80	0.3125000
NODE_14795_length_736_cov_4.908948	311	391	0	80	80	1.0000000
NODE_14825_length_735_cov_21.099057	265	345	0	80	80	1.0000000
NODE_14825_length_735_cov_21.099057	318	398	0	80	80	1.0000000
NODE_14826_length_735_cov_16.696541	190	270	0	80	80	1.0000000
NODE_14826_length_735_cov_16.696541	243	323	0	42	80	0.5250000
NODE_14826_length_735_cov_16.696541	243	323	2	38	80	0.4750000
NODE_14826_length_735_cov_16.696541	479	538	0	59	59	1.0000000
NODE_14827_length_735_cov_13.143082	231	311	0	80	80	1.0000000
NODE_14827_length_735_cov_13.143082	284	364	0	80	80	1.0000000
NODE_14828_length_735_cov_12.415094	434	514	0	12	80	0.1500000
NODE_14828_length_735_cov_12.415094	434	514	2	4	80	0.0500000
NODE_14828_length_735_cov_12.415094	434	514	4	64	80	0.8000000
NODE_14828_length_735_cov_12.415094	487	567	0	26	80	0.3250000
NODE_14828_length_735_cov_12.415094	487	567	2	29	80	0.3625000
NODE_14828_length_735_cov_12.415094	487	567	4	25	80	0.3125000
NODE_14836_length_735_cov_5.603774	326	394	0	68	68	1.0000000
NODE_14836_length_735_cov_5.603774	367	409	0	42	42	1.0000000
NODE_14880_length_734_cov_26.787402	209	289	0	55	80	0.6875000
NODE_14880_length_734_cov_26.787402	209	289	5	1	80	0.0125000
NODE_14880_length_734_cov_26.787402	209	289	6	24	80	0.3000000
NODE_14880_length_734_cov_26.787402	262	342	0	2	80	0.0250000
NODE_14880_length_734_cov_26.787402	262	342	5	1	80	0.0125000
NODE_14880_length_734_cov_26.787402	262	342	6	25	80	0.3125000
NODE_14880_length_734_cov_26.787402	262	342	8	52	80	0.6500000
NODE_14881_length_734_cov_23.214173	200	280	0	75	80	0.9375000
NODE_14881_length_734_cov_23.214173	200	280	2	5	80	0.0625000
NODE_14881_length_734_cov_23.214173	253	333	0	22	80	0.2750000
NODE_14881_length_734_cov_23.214173	253	333	2	36	80	0.4500000
NODE_14881_length_734_cov_23.214173	253	333	6	22	80	0.2750000
NODE_14883_length_734_cov_21.645669	245	325	0	80	80	1.0000000
NODE_14883_length_734_cov_21.645669	298	378	0	80	80	1.0000000
NODE_14884_length_734_cov_14.393701	249	329	0	37	80	0.4625000
NODE_14884_length_734_cov_14.393701	249	329	6	43	80	0.5375000
NODE_14884_length_734_cov_14.393701	302	382	6	80	80	1.0000000
NODE_14885_length_734_cov_11.324409	133	196	12	10	63	0.1587302
NODE_14885_length_734_cov_11.324409	133	196	14	53	63	0.8412699
NODE_14885_length_734_cov_11.324409	169	229	0	11	60	0.1833333
NODE_14885_length_734_cov_11.324409	169	229	12	14	60	0.2333333
NODE_14885_length_734_cov_11.324409	169	229	14	35	60	0.5833333
NODE_14886_length_734_cov_10.872441	302	331	2	29	29	1.0000000
NODE_14890_length_734_cov_6.352756	371	451	4	2	80	0.0250000
NODE_14890_length_734_cov_6.352756	371	451	6	2	80	0.0250000
NODE_14890_length_734_cov_6.352756	371	451	7	35	80	0.4375000
NODE_14890_length_734_cov_6.352756	371	451	9	22	80	0.2750000
NODE_14890_length_734_cov_6.352756	371	451	10	19	80	0.2375000
NODE_14890_length_734_cov_6.352756	424	504	2	30	80	0.3750000
NODE_14890_length_734_cov_6.352756	424	504	4	25	80	0.3125000
NODE_14890_length_734_cov_6.352756	424	504	9	6	80	0.0750000
NODE_14890_length_734_cov_6.352756	424	504	10	19	80	0.2375000
NODE_14896_length_734_cov_2.705512	231	302	0	71	71	1.0000000
NODE_14934_length_733_cov_35.041009	268	348	6	80	80	1.0000000
NODE_14934_length_733_cov_35.041009	321	402	0	52	81	0.6419753
NODE_14934_length_733_cov_35.041009	321	402	6	29	81	0.3580247
NODE_14935_length_733_cov_29.810726	28	108	0	80	80	1.0000000
NODE_14935_length_733_cov_29.810726	81	161	0	80	80	1.0000000
NODE_14935_length_733_cov_29.810726	157	237	0	80	80	1.0000000
NODE_14935_length_733_cov_29.810726	210	290	0	80	80	1.0000000
NODE_14936_length_733_cov_13.738170	333	413	0	48	80	0.6000000
NODE_14936_length_733_cov_13.738170	333	413	2	32	80	0.4000000
NODE_14936_length_733_cov_13.738170	386	466	0	15	80	0.1875000
NODE_14936_length_733_cov_13.738170	386	466	2	65	80	0.8125000
NODE_14937_length_733_cov_11.471609	314	389	0	75	75	1.0000000
NODE_14938_length_733_cov_11.321767	245	325	0	80	80	1.0000000
NODE_14938_length_733_cov_11.321767	298	378	0	80	80	1.0000000
NODE_14940_length_733_cov_8.481073	318	395	0	65	77	0.8441558
NODE_14940_length_733_cov_8.481073	318	395	2	12	77	0.1558442
NODE_14940_length_733_cov_8.481073	371	451	0	12	80	0.1500000
NODE_14940_length_733_cov_8.481073	371	451	2	68	80	0.8500000
NODE_14944_length_733_cov_5.485804	659	715	12	4	56	0.0714286
NODE_14944_length_733_cov_5.485804	659	715	14	14	56	0.2500000
NODE_14944_length_733_cov_5.485804	659	715	16	1	56	0.0178571
NODE_14944_length_733_cov_5.485804	659	715	18	37	56	0.6607143
NODE_14944_length_733_cov_5.485804	696	733	6	6	37	0.1621622
NODE_14944_length_733_cov_5.485804	696	733	8	9	37	0.2432432
NODE_14944_length_733_cov_5.485804	696	733	10	3	37	0.0810811
NODE_14944_length_733_cov_5.485804	696	733	12	4	37	0.1081081
NODE_14944_length_733_cov_5.485804	696	733	14	14	37	0.3783784
NODE_14944_length_733_cov_5.485804	696	733	16	1	37	0.0270270
NODE_14957_length_733_cov_2.272871	312	392	0	80	80	1.0000000
NODE_14957_length_733_cov_2.272871	365	445	0	80	80	1.0000000
NODE_14975_length_732_cov_19.519747	229	309	0	13	80	0.1625000
NODE_14975_length_732_cov_19.519747	229	309	2	67	80	0.8375000
NODE_14975_length_732_cov_19.519747	282	362	0	66	80	0.8250000
NODE_14975_length_732_cov_19.519747	282	362	2	14	80	0.1750000
NODE_14976_length_732_cov_10.846761	247	327	0	80	80	1.0000000
NODE_14976_length_732_cov_10.846761	300	380	0	80	80	1.0000000
NODE_14977_length_732_cov_9.807267	276	356	0	31	80	0.3875000
NODE_14977_length_732_cov_9.807267	276	356	2	49	80	0.6125000
NODE_14977_length_732_cov_9.807267	329	409	2	80	80	1.0000000
NODE_14978_length_732_cov_8.053712	415	495	0	32	80	0.4000000
NODE_14978_length_732_cov_8.053712	415	495	2	48	80	0.6000000
NODE_14978_length_732_cov_8.053712	468	548	0	80	80	1.0000000
NODE_14980_length_732_cov_5.194313	319	399	0	80	80	1.0000000
NODE_14980_length_732_cov_5.194313	372	452	0	80	80	1.0000000
NODE_14981_length_732_cov_4.998420	293	373	0	80	80	1.0000000
NODE_14981_length_732_cov_4.998420	346	426	0	80	80	1.0000000
NODE_14983_length_732_cov_4.758294	483	524	0	41	41	1.0000000
NODE_15021_length_731_cov_36.123418	464	544	2	10	80	0.1250000
NODE_15021_length_731_cov_36.123418	464	544	6	40	80	0.5000000
NODE_15021_length_731_cov_36.123418	464	544	8	30	80	0.3750000
NODE_15021_length_731_cov_36.123418	517	597	0	21	80	0.2625000
NODE_15021_length_731_cov_36.123418	517	597	2	42	80	0.5250000
NODE_15021_length_731_cov_36.123418	517	597	6	17	80	0.2125000
NODE_15022_length_731_cov_27.721519	294	374	0	6	80	0.0750000
NODE_15022_length_731_cov_27.721519	294	374	4	74	80	0.9250000
NODE_15022_length_731_cov_27.721519	347	427	0	47	80	0.5875000
NODE_15022_length_731_cov_27.721519	347	427	4	33	80	0.4125000
NODE_15023_length_731_cov_19.655063	394	474	2	23	80	0.2875000
NODE_15023_length_731_cov_19.655063	394	474	6	57	80	0.7125000
NODE_15023_length_731_cov_19.655063	447	527	0	42	80	0.5250000
NODE_15023_length_731_cov_19.655063	447	527	1	7	80	0.0875000
NODE_15023_length_731_cov_19.655063	447	527	2	20	80	0.2500000
NODE_15023_length_731_cov_19.655063	447	527	6	11	80	0.1375000
NODE_15024_length_731_cov_16.346519	429	509	0	7	80	0.0875000
NODE_15024_length_731_cov_16.346519	429	509	2	73	80	0.9125000
NODE_15024_length_731_cov_16.346519	482	562	0	60	80	0.7500000
NODE_15024_length_731_cov_16.346519	482	562	2	20	80	0.2500000
NODE_15025_length_731_cov_13.892405	321	401	1	4	80	0.0500000
NODE_15025_length_731_cov_13.892405	321	401	3	26	80	0.3250000
NODE_15025_length_731_cov_13.892405	321	401	4	14	80	0.1750000
NODE_15025_length_731_cov_13.892405	321	401	5	36	80	0.4500000
NODE_15025_length_731_cov_13.892405	374	454	1	57	80	0.7125000
NODE_15025_length_731_cov_13.892405	374	454	3	23	80	0.2875000
NODE_15027_length_731_cov_8.800633	218	298	0	73	80	0.9125000
NODE_15027_length_731_cov_8.800633	218	298	2	7	80	0.0875000
NODE_15027_length_731_cov_8.800633	271	352	0	20	81	0.2469136
NODE_15027_length_731_cov_8.800633	271	352	2	61	81	0.7530864
NODE_15028_length_731_cov_7.658228	335	406	0	39	71	0.5492958
NODE_15028_length_731_cov_7.658228	335	406	8	8	71	0.1126761
NODE_15028_length_731_cov_7.658228	335	406	12	24	71	0.3380282
NODE_15028_length_731_cov_7.658228	387	468	4	1	81	0.0123457
NODE_15028_length_731_cov_7.658228	387	468	12	80	81	0.9876543
NODE_15031_length_731_cov_5.471519	261	341	0	80	80	1.0000000
NODE_15031_length_731_cov_5.471519	314	394	0	80	80	1.0000000
NODE_15034_length_731_cov_4.083861	361	441	0	11	80	0.1375000
NODE_15034_length_731_cov_4.083861	361	441	2	24	80	0.3000000
NODE_15034_length_731_cov_4.083861	361	441	4	45	80	0.5625000
NODE_15034_length_731_cov_4.083861	458	482	0	24	24	1.0000000
NODE_15050_length_731_cov_2.226266	466	548	0	11	82	0.1341463
NODE_15050_length_731_cov_2.226266	466	548	2	71	82	0.8658537
NODE_15077_length_730_cov_51.556260	349	429	12	80	80	1.0000000
NODE_15077_length_730_cov_51.556260	402	482	0	43	80	0.5375000
NODE_15077_length_730_cov_51.556260	402	482	12	37	80	0.4625000
NODE_15078_length_730_cov_39.862124	370	450	0	80	80	1.0000000
NODE_15078_length_730_cov_39.862124	423	503	0	80	80	1.0000000
NODE_15079_length_730_cov_15.801902	261	341	0	8	80	0.1000000
NODE_15079_length_730_cov_15.801902	261	341	2	72	80	0.9000000
NODE_15079_length_730_cov_15.801902	314	394	0	61	80	0.7625000
NODE_15079_length_730_cov_15.801902	314	394	2	19	80	0.2375000
NODE_15080_length_730_cov_11.746434	242	322	0	80	80	1.0000000
NODE_15080_length_730_cov_11.746434	295	375	0	80	80	1.0000000
NODE_15081_length_730_cov_9.209192	358	438	0	80	80	1.0000000
NODE_15081_length_730_cov_9.209192	411	483	0	72	72	1.0000000
NODE_15131_length_729_cov_44.188889	418	498	2	50	80	0.6250000
NODE_15131_length_729_cov_44.188889	418	498	6	5	80	0.0625000
NODE_15131_length_729_cov_44.188889	418	498	8	25	80	0.3125000
NODE_15131_length_729_cov_44.188889	471	551	0	2	80	0.0250000
NODE_15131_length_729_cov_44.188889	471	551	6	56	80	0.7000000
NODE_15131_length_729_cov_44.188889	471	551	8	22	80	0.2750000
NODE_15132_length_729_cov_40.390476	330	410	0	17	80	0.2125000
NODE_15132_length_729_cov_40.390476	330	410	2	63	80	0.7875000
NODE_15132_length_729_cov_40.390476	383	463	0	70	80	0.8750000
NODE_15132_length_729_cov_40.390476	383	463	2	10	80	0.1250000
NODE_15133_length_729_cov_35.973016	231	311	2	21	80	0.2625000
NODE_15133_length_729_cov_35.973016	231	311	4	59	80	0.7375000
NODE_15133_length_729_cov_35.973016	284	363	0	11	79	0.1392405
NODE_15133_length_729_cov_35.973016	284	363	2	62	79	0.7848101
NODE_15133_length_729_cov_35.973016	284	363	4	6	79	0.0759494
NODE_15134_length_729_cov_18.357143	170	250	0	13	80	0.1625000
NODE_15134_length_729_cov_18.357143	170	250	2	51	80	0.6375000
NODE_15134_length_729_cov_18.357143	170	250	4	16	80	0.2000000
NODE_15134_length_729_cov_18.357143	223	303	2	40	80	0.5000000
NODE_15134_length_729_cov_18.357143	223	303	4	40	80	0.5000000
NODE_15135_length_729_cov_17.928571	194	274	0	52	80	0.6500000
NODE_15135_length_729_cov_17.928571	194	274	2	28	80	0.3500000
NODE_15135_length_729_cov_17.928571	247	327	0	5	80	0.0625000
NODE_15135_length_729_cov_17.928571	247	327	2	75	80	0.9375000
NODE_15136_length_729_cov_17.373016	369	449	0	80	80	1.0000000
NODE_15136_length_729_cov_17.373016	422	502	0	80	80	1.0000000
NODE_15137_length_729_cov_12.452381	347	427	0	80	80	1.0000000
NODE_15137_length_729_cov_12.452381	400	480	0	80	80	1.0000000
NODE_15138_length_729_cov_10.388889	296	376	0	62	80	0.7750000
NODE_15138_length_729_cov_10.388889	296	376	1	18	80	0.2250000
NODE_15138_length_729_cov_10.388889	349	429	0	80	80	1.0000000
NODE_15185_length_728_cov_23.503975	338	418	0	6	80	0.0750000
NODE_15185_length_728_cov_23.503975	338	418	5	41	80	0.5125000
NODE_15185_length_728_cov_23.503975	338	418	6	33	80	0.4125000
NODE_15185_length_728_cov_23.503975	391	471	1	1	80	0.0125000
NODE_15185_length_728_cov_23.503975	391	471	2	11	80	0.1375000
NODE_15185_length_728_cov_23.503975	391	471	5	23	80	0.2875000
NODE_15185_length_728_cov_23.503975	391	471	6	45	80	0.5625000
NODE_15186_length_728_cov_22.496025	310	390	0	80	80	1.0000000
NODE_15186_length_728_cov_22.496025	363	443	0	78	80	0.9750000
NODE_15186_length_728_cov_22.496025	363	443	2	2	80	0.0250000
NODE_15187_length_728_cov_16.596184	257	337	0	80	80	1.0000000
NODE_15187_length_728_cov_16.596184	310	387	0	77	77	1.0000000
NODE_15188_length_728_cov_16.114467	192	272	0	80	80	1.0000000
NODE_15188_length_728_cov_16.114467	245	325	0	80	80	1.0000000
NODE_15189_length_728_cov_15.128776	298	377	0	5	79	0.0632911
NODE_15189_length_728_cov_15.128776	298	377	6	3	79	0.0379747
NODE_15189_length_728_cov_15.128776	298	377	9	54	79	0.6835443
NODE_15189_length_728_cov_15.128776	298	377	12	17	79	0.2151899
NODE_15189_length_728_cov_15.128776	350	430	0	4	80	0.0500000
NODE_15189_length_728_cov_15.128776	350	430	2	14	80	0.1750000
NODE_15189_length_728_cov_15.128776	350	430	3	19	80	0.2375000
NODE_15189_length_728_cov_15.128776	350	430	9	10	80	0.1250000
NODE_15189_length_728_cov_15.128776	350	430	10	1	80	0.0125000
NODE_15189_length_728_cov_15.128776	350	430	12	32	80	0.4000000
NODE_15190_length_728_cov_10.613672	269	349	0	80	80	1.0000000
NODE_15190_length_728_cov_10.613672	322	402	0	80	80	1.0000000
NODE_15191_length_728_cov_7.613672	408	488	0	80	80	1.0000000
NODE_15191_length_728_cov_7.613672	461	541	0	80	80	1.0000000
NODE_15196_length_728_cov_3.405405	335	415	0	50	80	0.6250000
NODE_15196_length_728_cov_3.405405	335	415	4	30	80	0.3750000
NODE_15244_length_727_cov_34.883758	57	137	0	12	80	0.1500000
NODE_15244_length_727_cov_34.883758	57	137	4	33	80	0.4125000
NODE_15244_length_727_cov_34.883758	57	137	6	35	80	0.4375000
NODE_15244_length_727_cov_34.883758	57	137	0	12	80	0.1500000
NODE_15244_length_727_cov_34.883758	57	137	4	33	80	0.4125000
NODE_15244_length_727_cov_34.883758	57	137	6	35	80	0.4375000
NODE_15244_length_727_cov_34.883758	57	137	0	12	80	0.1500000
NODE_15244_length_727_cov_34.883758	57	137	4	33	80	0.4125000
NODE_15244_length_727_cov_34.883758	57	137	6	35	80	0.4375000
NODE_15244_length_727_cov_34.883758	110	190	2	2	80	0.0250000
NODE_15244_length_727_cov_34.883758	110	190	6	78	80	0.9750000
NODE_15244_length_727_cov_34.883758	110	190	2	2	80	0.0250000
NODE_15244_length_727_cov_34.883758	110	190	6	78	80	0.9750000
NODE_15245_length_727_cov_32.025478	275	355	0	80	80	1.0000000
NODE_15245_length_727_cov_32.025478	328	408	0	80	80	1.0000000
NODE_15246_length_727_cov_28.523885	307	381	0	52	74	0.7027027
NODE_15246_length_727_cov_28.523885	307	381	2	22	74	0.2972973
NODE_15246_length_727_cov_28.523885	360	381	0	21	21	1.0000000
NODE_15246_length_727_cov_28.523885	378	415	0	37	37	1.0000000
NODE_15247_length_727_cov_25.826433	325	405	0	80	80	1.0000000
NODE_15247_length_727_cov_25.826433	378	458	0	80	80	1.0000000
NODE_15248_length_727_cov_22.253185	150	230	1	13	80	0.1625000
NODE_15248_length_727_cov_22.253185	150	230	2	59	80	0.7375000
NODE_15248_length_727_cov_22.253185	150	230	6	8	80	0.1000000
NODE_15248_length_727_cov_22.253185	203	283	2	19	80	0.2375000
NODE_15248_length_727_cov_22.253185	203	283	6	27	80	0.3375000
NODE_15248_length_727_cov_22.253185	203	283	8	34	80	0.4250000
NODE_15249_length_727_cov_18.972930	263	343	5	32	80	0.4000000
NODE_15249_length_727_cov_18.972930	263	343	7	15	80	0.1875000
NODE_15249_length_727_cov_18.972930	263	343	9	33	80	0.4125000
NODE_15249_length_727_cov_18.972930	316	396	0	15	80	0.1875000
NODE_15249_length_727_cov_18.972930	316	396	2	5	80	0.0625000
NODE_15249_length_727_cov_18.972930	316	396	4	16	80	0.2000000
NODE_15249_length_727_cov_18.972930	316	396	5	40	80	0.5000000
NODE_15249_length_727_cov_18.972930	316	396	7	4	80	0.0500000
NODE_15250_length_727_cov_15.531847	269	349	0	8	80	0.1000000
NODE_15250_length_727_cov_15.531847	269	349	8	33	80	0.4125000
NODE_15250_length_727_cov_15.531847	269	349	9	39	80	0.4875000
NODE_15250_length_727_cov_15.531847	322	402	0	30	80	0.3750000
NODE_15250_length_727_cov_15.531847	322	402	4	31	80	0.3875000
NODE_15250_length_727_cov_15.531847	322	402	9	19	80	0.2375000
NODE_15252_length_727_cov_10.178344	280	360	0	80	80	1.0000000
NODE_15252_length_727_cov_10.178344	333	413	0	80	80	1.0000000
NODE_15258_length_727_cov_4.955414	360	440	0	80	80	1.0000000
NODE_15258_length_727_cov_4.955414	413	493	0	39	80	0.4875000
NODE_15258_length_727_cov_4.955414	413	493	2	41	80	0.5125000
NODE_15287_length_726_cov_52.923445	415	495	0	42	80	0.5250000
NODE_15287_length_726_cov_52.923445	415	495	4	38	80	0.4750000
NODE_15287_length_726_cov_52.923445	468	548	0	36	80	0.4500000
NODE_15287_length_726_cov_52.923445	468	548	2	40	80	0.5000000
NODE_15287_length_726_cov_52.923445	468	548	3	4	80	0.0500000
NODE_15288_length_726_cov_35.896332	108	188	0	80	80	1.0000000
NODE_15288_length_726_cov_35.896332	161	241	0	80	80	1.0000000
NODE_15288_length_726_cov_35.896332	237	317	0	80	80	1.0000000
NODE_15288_length_726_cov_35.896332	290	370	0	80	80	1.0000000
NODE_15291_length_726_cov_8.534290	355	435	0	80	80	1.0000000
NODE_15291_length_726_cov_8.534290	408	488	0	80	80	1.0000000
NODE_15330_length_725_cov_40.856230	203	283	0	80	80	1.0000000
NODE_15330_length_725_cov_40.856230	256	336	0	80	80	1.0000000
NODE_15330_length_725_cov_40.856230	332	412	0	26	80	0.3250000
NODE_15330_length_725_cov_40.856230	332	412	1	3	80	0.0375000
NODE_15330_length_725_cov_40.856230	332	412	6	40	80	0.5000000
NODE_15330_length_725_cov_40.856230	332	412	10	11	80	0.1375000
NODE_15330_length_725_cov_40.856230	385	465	6	16	80	0.2000000
NODE_15330_length_725_cov_40.856230	385	465	7	3	80	0.0375000
NODE_15330_length_725_cov_40.856230	385	465	9	21	80	0.2625000
NODE_15330_length_725_cov_40.856230	385	465	10	22	80	0.2750000
NODE_15330_length_725_cov_40.856230	385	465	11	18	80	0.2250000
NODE_15331_length_725_cov_25.036741	366	446	0	80	80	1.0000000
NODE_15331_length_725_cov_25.036741	419	499	0	73	80	0.9125000
NODE_15331_length_725_cov_25.036741	419	499	2	7	80	0.0875000
NODE_15332_length_725_cov_23.009585	455	536	0	27	81	0.3333333
NODE_15332_length_725_cov_23.009585	455	536	2	54	81	0.6666667
NODE_15333_length_725_cov_20.474441	112	192	0	21	80	0.2625000
NODE_15333_length_725_cov_20.474441	112	192	2	46	80	0.5750000
NODE_15333_length_725_cov_20.474441	112	192	4	13	80	0.1625000
NODE_15333_length_725_cov_20.474441	165	245	2	38	80	0.4750000
NODE_15333_length_725_cov_20.474441	165	245	4	42	80	0.5250000
NODE_15334_length_725_cov_15.455272	106	186	0	18	80	0.2250000
NODE_15334_length_725_cov_15.455272	106	186	2	3	80	0.0375000
NODE_15334_length_725_cov_15.455272	106	186	6	21	80	0.2625000
NODE_15334_length_725_cov_15.455272	106	186	12	38	80	0.4750000
NODE_15334_length_725_cov_15.455272	159	239	0	71	80	0.8875000
NODE_15334_length_725_cov_15.455272	159	239	2	3	80	0.0375000
NODE_15334_length_725_cov_15.455272	159	239	6	6	80	0.0750000
NODE_15334_length_725_cov_15.455272	235	315	0	19	80	0.2375000
NODE_15334_length_725_cov_15.455272	235	315	2	61	80	0.7625000
NODE_15334_length_725_cov_15.455272	288	368	0	16	80	0.2000000
NODE_15334_length_725_cov_15.455272	288	368	2	64	80	0.8000000
NODE_15335_length_725_cov_10.426518	289	369	0	77	80	0.9625000
NODE_15335_length_725_cov_10.426518	289	369	2	3	80	0.0375000
NODE_15335_length_725_cov_10.426518	342	422	0	24	80	0.3000000
NODE_15335_length_725_cov_10.426518	342	422	2	56	80	0.7000000
NODE_15337_length_725_cov_7.781150	189	269	0	80	80	1.0000000
NODE_15337_length_725_cov_7.781150	242	322	0	59	80	0.7375000
NODE_15337_length_725_cov_7.781150	242	322	4	21	80	0.2625000
NODE_15388_length_724_cov_28.132800	354	434	0	39	80	0.4875000
NODE_15388_length_724_cov_28.132800	354	434	4	41	80	0.5125000
NODE_15388_length_724_cov_28.132800	407	473	0	14	66	0.2121212
NODE_15388_length_724_cov_28.132800	407	473	4	52	66	0.7878788
NODE_15389_length_724_cov_24.710400	376	461	0	42	85	0.4941176
NODE_15389_length_724_cov_24.710400	376	461	4	43	85	0.5058824
NODE_15389_length_724_cov_24.710400	434	514	0	5	80	0.0625000
NODE_15389_length_724_cov_24.710400	434	514	4	75	80	0.9375000
NODE_15390_length_724_cov_13.960000	152	232	0	80	80	1.0000000
NODE_15390_length_724_cov_13.960000	205	248	0	43	43	1.0000000
NODE_15390_length_724_cov_13.960000	237	286	0	49	49	1.0000000
NODE_15390_length_724_cov_13.960000	259	302	0	43	43	1.0000000
NODE_15390_length_724_cov_13.960000	288	340	0	52	52	1.0000000
NODE_15390_length_724_cov_13.960000	313	393	0	80	80	1.0000000
NODE_15391_length_724_cov_13.065600	215	295	0	80	80	1.0000000
NODE_15391_length_724_cov_13.065600	268	347	0	79	79	1.0000000
NODE_15393_length_724_cov_10.358400	257	337	0	80	80	1.0000000
NODE_15393_length_724_cov_10.358400	310	385	0	75	75	1.0000000
NODE_15396_length_724_cov_6.451200	151	231	0	80	80	1.0000000
NODE_15396_length_724_cov_6.451200	202	282	0	80	80	1.0000000
NODE_15397_length_724_cov_5.921600	165	213	0	48	48	1.0000000
NODE_15399_length_724_cov_5.028800	416	469	0	21	53	0.3962264
NODE_15399_length_724_cov_5.028800	416	469	2	32	53	0.6037736
NODE_15399_length_724_cov_5.028800	488	526	2	30	38	0.7894737
NODE_15399_length_724_cov_5.028800	488	526	4	8	38	0.2105263
NODE_15403_length_724_cov_3.315200	166	246	0	80	80	1.0000000
NODE_15403_length_724_cov_3.315200	219	299	0	80	80	1.0000000
NODE_15442_length_723_cov_81.453526	205	285	0	36	80	0.4500000
NODE_15442_length_723_cov_81.453526	205	285	4	44	80	0.5500000
NODE_15442_length_723_cov_81.453526	258	338	0	23	80	0.2875000
NODE_15442_length_723_cov_81.453526	258	338	2	5	80	0.0625000
NODE_15442_length_723_cov_81.453526	258	338	4	52	80	0.6500000
NODE_15443_length_723_cov_33.075321	254	329	0	75	75	1.0000000
NODE_15443_length_723_cov_33.075321	307	387	0	80	80	1.0000000
NODE_15444_length_723_cov_25.410256	291	371	0	80	80	1.0000000
NODE_15444_length_723_cov_25.410256	344	424	0	80	80	1.0000000
NODE_15445_length_723_cov_18.097756	233	313	0	80	80	1.0000000
NODE_15445_length_723_cov_18.097756	286	351	0	65	65	1.0000000
NODE_15446_length_723_cov_14.113782	311	391	0	80	80	1.0000000
NODE_15446_length_723_cov_14.113782	364	444	0	80	80	1.0000000
NODE_15447_length_723_cov_11.634615	299	379	0	80	80	1.0000000
NODE_15447_length_723_cov_11.634615	352	432	0	80	80	1.0000000
NODE_15448_length_723_cov_8.342949	357	437	0	80	80	1.0000000
NODE_15448_length_723_cov_8.342949	410	490	0	80	80	1.0000000
NODE_15455_length_723_cov_2.711538	379	422	0	43	43	1.0000000
NODE_15459_length_723_cov_2.573718	383	413	6	18	30	0.6000000
NODE_15459_length_723_cov_2.573718	383	413	8	12	30	0.4000000
NODE_15495_length_722_cov_19.182986	180	260	0	40	80	0.5000000
NODE_15495_length_722_cov_19.182986	180	260	6	40	80	0.5000000
NODE_15495_length_722_cov_19.182986	233	313	5	18	80	0.2250000
NODE_15495_length_722_cov_19.182986	233	313	6	62	80	0.7750000
NODE_15496_length_722_cov_13.582665	192	272	0	80	80	1.0000000
NODE_15496_length_722_cov_13.582665	245	326	0	64	81	0.7901235
NODE_15496_length_722_cov_13.582665	245	326	2	17	81	0.2098765
NODE_15497_length_722_cov_9.202247	347	427	0	80	80	1.0000000
NODE_15497_length_722_cov_9.202247	400	480	0	80	80	1.0000000
NODE_15500_length_722_cov_6.707865	343	423	2	80	80	1.0000000
NODE_15500_length_722_cov_6.707865	396	476	0	53	80	0.6625000
NODE_15500_length_722_cov_6.707865	396	476	2	27	80	0.3375000
NODE_15504_length_722_cov_4.985554	332	393	0	61	61	1.0000000
NODE_15508_length_722_cov_3.977528	217	297	0	80	80	1.0000000
NODE_15508_length_722_cov_3.977528	270	350	0	51	80	0.6375000
NODE_15508_length_722_cov_3.977528	270	350	4	29	80	0.3625000
NODE_15553_length_721_cov_105.927653	425	505	1	80	80	1.0000000
NODE_15553_length_721_cov_105.927653	478	558	0	32	80	0.4000000
NODE_15553_length_721_cov_105.927653	478	558	1	48	80	0.6000000
NODE_15554_length_721_cov_49.660772	304	384	0	80	80	1.0000000
NODE_15554_length_721_cov_49.660772	357	437	0	80	80	1.0000000
NODE_15555_length_721_cov_46.991961	341	421	0	80	80	1.0000000
NODE_15555_length_721_cov_46.991961	394	474	0	80	80	1.0000000
NODE_15556_length_721_cov_38.864952	208	288	0	80	80	1.0000000
NODE_15556_length_721_cov_38.864952	269	341	0	72	72	1.0000000
NODE_15556_length_721_cov_38.864952	337	417	0	80	80	1.0000000
NODE_15556_length_721_cov_38.864952	390	467	0	47	77	0.6103896
NODE_15556_length_721_cov_38.864952	390	467	2	30	77	0.3896104
NODE_15557_length_721_cov_29.016077	192	272	0	78	80	0.9750000
NODE_15557_length_721_cov_29.016077	192	272	2	2	80	0.0250000
NODE_15557_length_721_cov_29.016077	251	325	0	74	74	1.0000000
NODE_15558_length_721_cov_26.196141	398	478	0	80	80	1.0000000
NODE_15558_length_721_cov_26.196141	451	531	0	80	80	1.0000000
NODE_15560_length_721_cov_20.054662	178	258	0	18	80	0.2250000
NODE_15560_length_721_cov_20.054662	178	258	2	62	80	0.7750000
NODE_15560_length_721_cov_20.054662	231	311	0	58	80	0.7250000
NODE_15560_length_721_cov_20.054662	231	311	2	22	80	0.2750000
NODE_15561_length_721_cov_13.670418	263	343	0	80	80	1.0000000
NODE_15561_length_721_cov_13.670418	316	396	0	80	80	1.0000000
NODE_15562_length_721_cov_13.652733	268	350	0	25	82	0.3048781
NODE_15562_length_721_cov_13.652733	268	350	2	57	82	0.6951219
NODE_15562_length_721_cov_13.652733	321	403	2	82	82	1.0000000
NODE_15563_length_721_cov_13.120579	312	392	8	18	80	0.2250000
NODE_15563_length_721_cov_13.120579	312	392	12	16	80	0.2000000
NODE_15563_length_721_cov_13.120579	312	392	18	46	80	0.5750000
NODE_15563_length_721_cov_13.120579	365	445	8	36	80	0.4500000
NODE_15563_length_721_cov_13.120579	365	445	16	2	80	0.0250000
NODE_15563_length_721_cov_13.120579	365	445	18	34	80	0.4250000
NODE_15563_length_721_cov_13.120579	365	445	20	8	80	0.1000000
NODE_15572_length_721_cov_4.491961	210	280	4	13	70	0.1857143
NODE_15572_length_721_cov_4.491961	210	280	6	19	70	0.2714286
NODE_15572_length_721_cov_4.491961	210	280	7	1	70	0.0142857
NODE_15572_length_721_cov_4.491961	210	280	8	37	70	0.5285714
NODE_15572_length_721_cov_4.491961	253	333	8	41	80	0.5125000
NODE_15572_length_721_cov_4.491961	253	333	10	39	80	0.4875000
NODE_15572_length_721_cov_4.491961	470	521	0	51	51	1.0000000
NODE_15608_length_720_cov_17.449275	267	347	1	14	80	0.1750000
NODE_15608_length_720_cov_17.449275	267	347	2	3	80	0.0375000
NODE_15608_length_720_cov_17.449275	267	347	22	2	80	0.0250000
NODE_15608_length_720_cov_17.449275	267	347	23	44	80	0.5500000
NODE_15608_length_720_cov_17.449275	267	347	24	17	80	0.2125000
NODE_15608_length_720_cov_17.449275	320	400	18	44	80	0.5500000
NODE_15608_length_720_cov_17.449275	320	400	19	1	80	0.0125000
NODE_15608_length_720_cov_17.449275	320	400	20	1	80	0.0125000
NODE_15608_length_720_cov_17.449275	320	400	21	6	80	0.0750000
NODE_15608_length_720_cov_17.449275	320	400	22	3	80	0.0375000
NODE_15608_length_720_cov_17.449275	320	400	23	25	80	0.3125000
NODE_15609_length_720_cov_14.814815	261	341	0	80	80	1.0000000
NODE_15609_length_720_cov_14.814815	314	394	0	80	80	1.0000000
NODE_15610_length_720_cov_14.107890	290	370	0	80	80	1.0000000
NODE_15610_length_720_cov_14.107890	343	423	0	80	80	1.0000000
NODE_15612_length_720_cov_12.924316	314	394	0	42	80	0.5250000
NODE_15612_length_720_cov_12.924316	314	394	2	21	80	0.2625000
NODE_15612_length_720_cov_12.924316	314	394	4	17	80	0.2125000
NODE_15612_length_720_cov_12.924316	367	447	2	10	80	0.1250000
NODE_15612_length_720_cov_12.924316	367	447	4	70	80	0.8750000
NODE_15614_length_720_cov_10.389694	435	515	0	41	80	0.5125000
NODE_15614_length_720_cov_10.389694	435	515	2	39	80	0.4875000
NODE_15614_length_720_cov_10.389694	488	568	0	19	80	0.2375000
NODE_15614_length_720_cov_10.389694	488	568	2	61	80	0.7625000
NODE_15620_length_720_cov_5.278583	309	389	0	80	80	1.0000000
NODE_15620_length_720_cov_5.278583	362	442	0	80	80	1.0000000
NODE_15624_length_720_cov_3.792271	157	235	0	78	78	1.0000000
NODE_15624_length_720_cov_3.792271	215	265	0	50	50	1.0000000
NODE_15658_length_719_cov_30.256452	279	359	0	53	80	0.6625000
NODE_15658_length_719_cov_30.256452	279	359	4	27	80	0.3375000
NODE_15658_length_719_cov_30.256452	332	412	0	27	80	0.3375000
NODE_15658_length_719_cov_30.256452	332	412	4	53	80	0.6625000
NODE_15659_length_719_cov_29.093548	310	390	0	44	80	0.5500000
NODE_15659_length_719_cov_29.093548	310	390	2	23	80	0.2875000
NODE_15659_length_719_cov_29.093548	310	390	11	1	80	0.0125000
NODE_15659_length_719_cov_29.093548	310	390	12	12	80	0.1500000
NODE_15659_length_719_cov_29.093548	363	443	2	14	80	0.1750000
NODE_15659_length_719_cov_29.093548	363	443	10	25	80	0.3125000
NODE_15659_length_719_cov_29.093548	363	443	11	1	80	0.0125000
NODE_15659_length_719_cov_29.093548	363	443	12	40	80	0.5000000
NODE_15660_length_719_cov_10.988710	195	275	0	15	80	0.1875000
NODE_15660_length_719_cov_10.988710	195	275	4	18	80	0.2250000
NODE_15660_length_719_cov_10.988710	195	275	6	47	80	0.5875000
NODE_15660_length_719_cov_10.988710	248	328	6	72	80	0.9000000
NODE_15660_length_719_cov_10.988710	248	328	7	8	80	0.1000000
NODE_15661_length_719_cov_10.837097	259	339	0	80	80	1.0000000
NODE_15661_length_719_cov_10.837097	312	392	0	80	80	1.0000000
NODE_15662_length_719_cov_7.622581	288	368	0	80	80	1.0000000
NODE_15662_length_719_cov_7.622581	341	421	0	80	80	1.0000000
NODE_15663_length_719_cov_7.570968	351	431	2	6	80	0.0750000
NODE_15663_length_719_cov_7.570968	351	431	4	62	80	0.7750000
NODE_15663_length_719_cov_7.570968	351	431	6	12	80	0.1500000
NODE_15663_length_719_cov_7.570968	404	484	0	28	80	0.3500000
NODE_15663_length_719_cov_7.570968	404	484	4	52	80	0.6500000
NODE_15672_length_719_cov_4.264516	251	281	2	30	30	1.0000000
NODE_15684_length_719_cov_1.629032	88	163	0	75	75	1.0000000
NODE_15706_length_718_cov_35.382876	296	376	17	7	80	0.0875000
NODE_15706_length_718_cov_35.382876	296	376	18	73	80	0.9125000
NODE_15706_length_718_cov_35.382876	296	376	17	7	80	0.0875000
NODE_15706_length_718_cov_35.382876	296	376	18	73	80	0.9125000
NODE_15706_length_718_cov_35.382876	349	429	0	16	80	0.2000000
NODE_15706_length_718_cov_35.382876	349	429	16	1	80	0.0125000
NODE_15706_length_718_cov_35.382876	349	429	17	43	80	0.5375000
NODE_15706_length_718_cov_35.382876	349	429	18	20	80	0.2500000
NODE_15706_length_718_cov_35.382876	349	429	0	16	80	0.2000000
NODE_15706_length_718_cov_35.382876	349	429	16	1	80	0.0125000
NODE_15706_length_718_cov_35.382876	349	429	17	43	80	0.5375000
NODE_15706_length_718_cov_35.382876	349	429	18	20	80	0.2500000
NODE_15707_length_718_cov_24.211632	313	393	0	80	80	1.0000000
NODE_15707_length_718_cov_24.211632	366	446	0	80	80	1.0000000
NODE_15708_length_718_cov_18.300485	217	297	2	80	80	1.0000000
NODE_15708_length_718_cov_18.300485	270	350	0	46	80	0.5750000
NODE_15708_length_718_cov_18.300485	270	350	2	34	80	0.4250000
NODE_15709_length_718_cov_14.757674	383	463	0	80	80	1.0000000
NODE_15709_length_718_cov_14.757674	436	516	0	80	80	1.0000000
NODE_15710_length_718_cov_14.355412	254	334	1	22	80	0.2750000
NODE_15710_length_718_cov_14.355412	254	334	3	29	80	0.3625000
NODE_15710_length_718_cov_14.355412	254	334	4	29	80	0.3625000
NODE_15710_length_718_cov_14.355412	307	387	1	4	80	0.0500000
NODE_15710_length_718_cov_14.355412	307	387	2	5	80	0.0625000
NODE_15710_length_718_cov_14.355412	307	387	3	8	80	0.1000000
NODE_15710_length_718_cov_14.355412	307	387	4	63	80	0.7875000
NODE_15715_length_718_cov_4.804523	263	343	0	80	80	1.0000000
NODE_15715_length_718_cov_4.804523	316	396	0	80	80	1.0000000
NODE_15750_length_717_cov_28.377023	335	415	0	80	80	1.0000000
NODE_15750_length_717_cov_28.377023	388	468	0	80	80	1.0000000
NODE_15751_length_717_cov_23.275081	162	242	0	20	80	0.2500000
NODE_15751_length_717_cov_23.275081	162	242	2	60	80	0.7500000
NODE_15751_length_717_cov_23.275081	215	295	0	30	80	0.3750000
NODE_15751_length_717_cov_23.275081	215	295	2	50	80	0.6250000
NODE_15752_length_717_cov_18.564725	319	399	0	80	80	1.0000000
NODE_15752_length_717_cov_18.564725	372	452	0	80	80	1.0000000
NODE_15753_length_717_cov_18.389968	358	438	0	11	80	0.1375000
NODE_15753_length_717_cov_18.389968	358	438	2	69	80	0.8625000
NODE_15753_length_717_cov_18.389968	411	491	0	64	80	0.8000000
NODE_15753_length_717_cov_18.389968	411	491	2	16	80	0.2000000
NODE_15754_length_717_cov_17.932039	241	321	1	2	80	0.0250000
NODE_15754_length_717_cov_17.932039	241	321	3	2	80	0.0250000
NODE_15754_length_717_cov_17.932039	241	321	4	6	80	0.0750000
NODE_15754_length_717_cov_17.932039	241	321	6	9	80	0.1125000
NODE_15754_length_717_cov_17.932039	241	321	10	15	80	0.1875000
NODE_15754_length_717_cov_17.932039	241	321	12	46	80	0.5750000
NODE_15754_length_717_cov_17.932039	294	374	0	27	80	0.3375000
NODE_15754_length_717_cov_17.932039	294	374	1	28	80	0.3500000
NODE_15754_length_717_cov_17.932039	294	374	3	2	80	0.0250000
NODE_15754_length_717_cov_17.932039	294	374	4	6	80	0.0750000
NODE_15754_length_717_cov_17.932039	294	374	6	9	80	0.1125000
NODE_15754_length_717_cov_17.932039	294	374	10	8	80	0.1000000
NODE_15755_length_717_cov_14.637540	298	378	0	80	80	1.0000000
NODE_15755_length_717_cov_14.637540	351	431	0	80	80	1.0000000
NODE_15756_length_717_cov_12.279935	113	196	0	83	83	1.0000000
NODE_15756_length_717_cov_12.279935	169	249	0	80	80	1.0000000
NODE_15757_length_717_cov_10.711974	353	431	2	36	78	0.4615385
NODE_15757_length_717_cov_10.711974	353	431	4	11	78	0.1410256
NODE_15757_length_717_cov_10.711974	353	431	6	6	78	0.0769231
NODE_15757_length_717_cov_10.711974	353	431	8	13	78	0.1666667
NODE_15757_length_717_cov_10.711974	353	431	10	12	78	0.1538462
NODE_15758_length_717_cov_9.399676	331	411	0	80	80	1.0000000
NODE_15758_length_717_cov_9.399676	384	464	0	80	80	1.0000000
NODE_15762_length_717_cov_5.341424	475	555	0	80	80	1.0000000
NODE_15762_length_717_cov_5.341424	528	608	0	80	80	1.0000000
NODE_15770_length_717_cov_3.187702	285	322	0	37	37	1.0000000
NODE_15805_length_716_cov_16.800648	430	510	0	80	80	1.0000000
NODE_15805_length_716_cov_16.800648	483	563	0	80	80	1.0000000
NODE_15806_length_716_cov_12.565640	356	436	0	80	80	1.0000000
NODE_15806_length_716_cov_12.565640	409	489	0	80	80	1.0000000
NODE_15807_length_716_cov_9.277147	385	465	0	36	80	0.4500000
NODE_15807_length_716_cov_9.277147	385	465	2	44	80	0.5500000
NODE_15807_length_716_cov_9.277147	438	518	2	42	80	0.5250000
NODE_15807_length_716_cov_9.277147	438	518	4	38	80	0.4750000
NODE_15808_length_716_cov_9.257699	302	382	0	80	80	1.0000000
NODE_15808_length_716_cov_9.257699	355	435	0	80	80	1.0000000
NODE_15809_length_716_cov_6.761750	263	343	0	80	80	1.0000000
NODE_15809_length_716_cov_6.761750	316	396	0	50	80	0.6250000
NODE_15809_length_716_cov_6.761750	316	396	2	30	80	0.3750000
NODE_15812_length_716_cov_4.909238	236	316	0	80	80	1.0000000
NODE_15812_length_716_cov_4.909238	289	369	0	80	80	1.0000000
NODE_15824_length_716_cov_2.068071	453	481	0	28	28	1.0000000
NODE_15853_length_715_cov_38.795455	260	340	0	80	80	1.0000000
NODE_15853_length_715_cov_38.795455	313	393	0	80	80	1.0000000
NODE_15854_length_715_cov_30.344156	316	396	0	60	80	0.7500000
NODE_15854_length_715_cov_30.344156	316	396	2	20	80	0.2500000
NODE_15854_length_715_cov_30.344156	369	449	0	80	80	1.0000000
NODE_15857_length_715_cov_11.209416	484	564	0	80	80	1.0000000
NODE_15857_length_715_cov_11.209416	537	617	0	47	80	0.5875000
NODE_15857_length_715_cov_11.209416	537	617	1	33	80	0.4125000
NODE_15858_length_715_cov_10.894481	189	242	0	53	53	1.0000000
NODE_15859_length_715_cov_10.628247	502	582	0	80	80	1.0000000
NODE_15859_length_715_cov_10.628247	555	635	0	80	80	1.0000000
NODE_15860_length_715_cov_8.647727	138	218	0	78	80	0.9750000
NODE_15860_length_715_cov_8.647727	138	218	3	2	80	0.0250000
NODE_15860_length_715_cov_8.647727	191	271	0	25	80	0.3125000
NODE_15860_length_715_cov_8.647727	191	271	3	31	80	0.3875000
NODE_15860_length_715_cov_8.647727	191	271	4	24	80	0.3000000
NODE_15861_length_715_cov_8.412338	364	444	0	46	80	0.5750000
NODE_15861_length_715_cov_8.412338	364	444	2	34	80	0.4250000
NODE_15861_length_715_cov_8.412338	417	497	0	6	80	0.0750000
NODE_15861_length_715_cov_8.412338	417	497	2	74	80	0.9250000
NODE_15864_length_715_cov_5.373377	318	398	0	80	80	1.0000000
NODE_15864_length_715_cov_5.373377	371	451	0	80	80	1.0000000
NODE_15898_length_715_cov_1.271104	331	397	0	10	66	0.1515152
NODE_15898_length_715_cov_1.271104	331	397	2	56	66	0.8484849
NODE_15910_length_714_cov_18.621138	297	377	0	7	80	0.0875000
NODE_15910_length_714_cov_18.621138	297	377	2	66	80	0.8250000
NODE_15910_length_714_cov_18.621138	297	377	4	7	80	0.0875000
NODE_15910_length_714_cov_18.621138	350	430	2	47	80	0.5875000
NODE_15910_length_714_cov_18.621138	350	430	4	33	80	0.4125000
NODE_15911_length_714_cov_15.468293	268	348	0	80	80	1.0000000
NODE_15911_length_714_cov_15.468293	321	401	0	80	80	1.0000000
NODE_15913_length_714_cov_10.530081	218	298	0	80	80	1.0000000
NODE_15913_length_714_cov_10.530081	271	351	0	80	80	1.0000000
NODE_15913_length_714_cov_10.530081	354	434	0	80	80	1.0000000
NODE_15913_length_714_cov_10.530081	407	487	0	80	80	1.0000000
NODE_15914_length_714_cov_8.365854	285	365	0	80	80	1.0000000
NODE_15914_length_714_cov_8.365854	338	418	0	80	80	1.0000000
NODE_15919_length_714_cov_6.993496	263	343	2	80	80	1.0000000
NODE_15919_length_714_cov_6.993496	316	384	0	5	68	0.0735294
NODE_15919_length_714_cov_6.993496	316	384	2	63	68	0.9264706
NODE_15921_length_714_cov_4.224390	218	288	0	70	70	1.0000000
NODE_15921_length_714_cov_4.224390	271	351	0	80	80	1.0000000
NODE_15969_length_713_cov_19.304560	271	351	0	44	80	0.5500000
NODE_15969_length_713_cov_19.304560	271	351	6	36	80	0.4500000
NODE_15969_length_713_cov_19.304560	324	404	6	80	80	1.0000000
NODE_15970_length_713_cov_16.926710	262	342	4	17	80	0.2125000
NODE_15970_length_713_cov_16.926710	262	342	7	43	80	0.5375000
NODE_15970_length_713_cov_16.926710	262	342	8	20	80	0.2500000
NODE_15970_length_713_cov_16.926710	315	395	2	28	80	0.3500000
NODE_15970_length_713_cov_16.926710	315	395	4	18	80	0.2250000
NODE_15970_length_713_cov_16.926710	315	395	6	24	80	0.3000000
NODE_15970_length_713_cov_16.926710	315	395	7	10	80	0.1250000
NODE_15973_length_713_cov_7.159609	351	431	0	80	80	1.0000000
NODE_15973_length_713_cov_7.159609	404	484	0	80	80	1.0000000
NODE_15974_length_713_cov_6.723127	379	427	11	20	48	0.4166667
NODE_15974_length_713_cov_6.723127	379	427	16	28	48	0.5833333
NODE_15975_length_713_cov_4.954397	90	171	0	5	81	0.0617284
NODE_15975_length_713_cov_4.954397	90	171	2	59	81	0.7283950
NODE_15975_length_713_cov_4.954397	90	171	4	17	81	0.2098765
NODE_15975_length_713_cov_4.954397	144	224	2	58	80	0.7250000
NODE_15975_length_713_cov_4.954397	144	224	4	22	80	0.2750000
NODE_15980_length_713_cov_4.302932	402	482	0	19	80	0.2375000
NODE_15980_length_713_cov_4.302932	402	482	2	61	80	0.7625000
NODE_15980_length_713_cov_4.302932	455	535	0	72	80	0.9000000
NODE_15980_length_713_cov_4.302932	455	535	2	8	80	0.1000000
NODE_16004_length_713_cov_1.939739	15	75	0	60	60	1.0000000
NODE_16010_length_713_cov_1.605863	81	161	0	80	80	1.0000000
NODE_16010_length_713_cov_1.605863	134	214	0	27	80	0.3375000
NODE_16010_length_713_cov_1.605863	134	214	2	53	80	0.6625000
NODE_16052_length_712_cov_32.931485	289	369	0	80	80	1.0000000
NODE_16052_length_712_cov_32.931485	342	422	0	80	80	1.0000000
NODE_16053_length_712_cov_31.752039	185	251	0	66	66	1.0000000
NODE_16053_length_712_cov_31.752039	228	307	0	79	79	1.0000000
NODE_16054_length_712_cov_22.567700	228	308	0	80	80	1.0000000
NODE_16054_length_712_cov_22.567700	281	361	0	80	80	1.0000000
NODE_16055_length_712_cov_19.306688	238	318	0	24	80	0.3000000
NODE_16055_length_712_cov_19.306688	238	318	3	1	80	0.0125000
NODE_16055_length_712_cov_19.306688	238	318	4	9	80	0.1125000
NODE_16055_length_712_cov_19.306688	238	318	8	46	80	0.5750000
NODE_16055_length_712_cov_19.306688	291	371	0	9	80	0.1125000
NODE_16055_length_712_cov_19.306688	291	371	4	16	80	0.2000000
NODE_16055_length_712_cov_19.306688	291	371	8	55	80	0.6875000
NODE_16056_length_712_cov_14.929853	332	412	0	2	80	0.0250000
NODE_16056_length_712_cov_14.929853	332	412	2	78	80	0.9750000
NODE_16056_length_712_cov_14.929853	385	465	0	39	80	0.4875000
NODE_16056_length_712_cov_14.929853	385	465	2	41	80	0.5125000
NODE_16057_length_712_cov_14.228385	250	330	0	80	80	1.0000000
NODE_16057_length_712_cov_14.228385	303	383	0	80	80	1.0000000
NODE_16059_length_712_cov_9.221860	326	406	0	80	80	1.0000000
NODE_16059_length_712_cov_9.221860	379	463	0	84	84	1.0000000
NODE_16060_length_712_cov_8.368679	331	411	0	80	80	1.0000000
NODE_16060_length_712_cov_8.368679	384	464	0	80	80	1.0000000
NODE_16079_length_712_cov_2.350734	466	510	0	1	44	0.0227273
NODE_16079_length_712_cov_2.350734	466	510	2	43	44	0.9772727
NODE_16118_length_711_cov_36.459150	146	223	0	77	77	1.0000000
NODE_16118_length_711_cov_36.459150	199	280	0	81	81	1.0000000
NODE_16119_length_711_cov_26.702614	460	540	0	26	80	0.3250000
NODE_16119_length_711_cov_26.702614	460	540	8	54	80	0.6750000
NODE_16119_length_711_cov_26.702614	513	593	7	44	80	0.5500000
NODE_16119_length_711_cov_26.702614	513	593	8	36	80	0.4500000
NODE_16120_length_711_cov_19.632353	329	409	0	47	80	0.5875000
NODE_16120_length_711_cov_19.632353	329	409	1	33	80	0.4125000
NODE_16120_length_711_cov_19.632353	382	462	0	2	80	0.0250000
NODE_16120_length_711_cov_19.632353	382	462	1	35	80	0.4375000
NODE_16120_length_711_cov_19.632353	382	462	2	43	80	0.5375000
NODE_16121_length_711_cov_19.267974	283	363	0	80	80	1.0000000
NODE_16121_length_711_cov_19.267974	336	416	0	80	80	1.0000000
NODE_16122_length_711_cov_12.813725	255	334	0	79	79	1.0000000
NODE_16123_length_711_cov_12.147059	314	394	0	80	80	1.0000000
NODE_16123_length_711_cov_12.147059	367	447	0	80	80	1.0000000
NODE_16124_length_711_cov_10.009804	336	415	0	15	79	0.1898734
NODE_16124_length_711_cov_10.009804	336	415	2	64	79	0.8101266
NODE_16127_length_711_cov_5.619281	276	356	0	80	80	1.0000000
NODE_16127_length_711_cov_5.619281	329	409	0	80	80	1.0000000
NODE_16130_length_711_cov_4.040850	165	245	6	80	80	1.0000000
NODE_16130_length_711_cov_4.040850	218	298	0	21	80	0.2625000
NODE_16130_length_711_cov_4.040850	218	298	6	59	80	0.7375000
NODE_16167_length_710_cov_73.721768	626	706	0	80	80	1.0000000
NODE_16168_length_710_cov_21.772504	292	372	0	21	80	0.2625000
NODE_16168_length_710_cov_21.772504	292	372	2	11	80	0.1375000
NODE_16168_length_710_cov_21.772504	292	372	4	19	80	0.2375000
NODE_16168_length_710_cov_21.772504	292	372	6	29	80	0.3625000
NODE_16168_length_710_cov_21.772504	345	425	4	9	80	0.1125000
NODE_16168_length_710_cov_21.772504	345	425	6	71	80	0.8875000
NODE_16169_length_710_cov_21.597381	18	54	0	34	36	0.9444444
NODE_16169_length_710_cov_21.597381	18	54	2	2	36	0.0555556
NODE_16170_length_710_cov_13.155483	306	386	4	9	80	0.1125000
NODE_16170_length_710_cov_13.155483	306	386	6	6	80	0.0750000
NODE_16170_length_710_cov_13.155483	306	386	8	10	80	0.1250000
NODE_16170_length_710_cov_13.155483	306	386	12	10	80	0.1250000
NODE_16170_length_710_cov_13.155483	306	386	13	1	80	0.0125000
NODE_16170_length_710_cov_13.155483	306	386	14	44	80	0.5500000
NODE_16170_length_710_cov_13.155483	359	439	2	42	80	0.5250000
NODE_16170_length_710_cov_13.155483	359	439	4	20	80	0.2500000
NODE_16170_length_710_cov_13.155483	359	439	6	6	80	0.0750000
NODE_16170_length_710_cov_13.155483	359	439	8	10	80	0.1250000
NODE_16170_length_710_cov_13.155483	359	439	13	1	80	0.0125000
NODE_16170_length_710_cov_13.155483	359	439	14	1	80	0.0125000
NODE_16173_length_710_cov_8.031097	316	396	2	80	80	1.0000000
NODE_16173_length_710_cov_8.031097	369	449	0	30	80	0.3750000
NODE_16173_length_710_cov_8.031097	369	449	2	50	80	0.6250000
NODE_16175_length_710_cov_6.664484	264	344	0	80	80	1.0000000
NODE_16178_length_710_cov_5.590835	352	421	0	24	69	0.3478261
NODE_16178_length_710_cov_5.590835	352	421	6	38	69	0.5507246
NODE_16178_length_710_cov_5.590835	352	421	8	7	69	0.1014493
NODE_16178_length_710_cov_5.590835	394	474	6	20	80	0.2500000
NODE_16178_length_710_cov_5.590835	394	474	8	60	80	0.7500000
NODE_16180_length_710_cov_5.356792	248	328	0	13	80	0.1625000
NODE_16180_length_710_cov_5.356792	248	328	10	26	80	0.3250000
NODE_16180_length_710_cov_5.356792	248	328	12	3	80	0.0375000
NODE_16180_length_710_cov_5.356792	248	328	14	38	80	0.4750000
NODE_16180_length_710_cov_5.356792	301	381	0	7	80	0.0875000
NODE_16180_length_710_cov_5.356792	301	381	1	12	80	0.1500000
NODE_16180_length_710_cov_5.356792	301	381	8	1	80	0.0125000
NODE_16180_length_710_cov_5.356792	301	381	12	36	80	0.4500000
NODE_16180_length_710_cov_5.356792	301	381	14	24	80	0.3000000
NODE_16233_length_709_cov_12.227869	347	427	0	80	80	1.0000000
NODE_16233_length_709_cov_12.227869	400	480	0	80	80	1.0000000
NODE_16234_length_709_cov_10.531148	279	359	8	10	80	0.1250000
NODE_16234_length_709_cov_10.531148	279	359	10	1	80	0.0125000
NODE_16234_length_709_cov_10.531148	279	359	12	36	80	0.4500000
NODE_16234_length_709_cov_10.531148	279	359	14	33	80	0.4125000
NODE_16234_length_709_cov_10.531148	332	412	0	43	80	0.5375000
NODE_16234_length_709_cov_10.531148	332	412	6	1	80	0.0125000
NODE_16234_length_709_cov_10.531148	332	412	7	1	80	0.0125000
NODE_16234_length_709_cov_10.531148	332	412	8	3	80	0.0375000
NODE_16234_length_709_cov_10.531148	332	412	10	6	80	0.0750000
NODE_16234_length_709_cov_10.531148	332	412	14	26	80	0.3250000
NODE_16238_length_709_cov_7.181967	225	305	2	46	80	0.5750000
NODE_16238_length_709_cov_7.181967	225	305	4	34	80	0.4250000
NODE_16238_length_709_cov_7.181967	279	312	2	3	33	0.0909091
NODE_16238_length_709_cov_7.181967	279	312	4	30	33	0.9090909
NODE_16241_length_709_cov_5.888525	239	319	0	80	80	1.0000000
NODE_16241_length_709_cov_5.888525	292	372	0	60	80	0.7500000
NODE_16241_length_709_cov_5.888525	292	372	2	20	80	0.2500000
NODE_16294_length_708_cov_42.435140	307	387	0	76	80	0.9500000
NODE_16294_length_708_cov_42.435140	307	387	1	4	80	0.0500000
NODE_16294_length_708_cov_42.435140	360	440	0	80	80	1.0000000
NODE_16296_length_708_cov_33.412151	235	315	0	37	80	0.4625000
NODE_16296_length_708_cov_33.412151	235	315	2	43	80	0.5375000
NODE_16296_length_708_cov_33.412151	288	368	0	21	80	0.2625000
NODE_16296_length_708_cov_33.412151	288	368	2	59	80	0.7375000
NODE_16297_length_708_cov_23.034483	316	396	0	80	80	1.0000000
NODE_16297_length_708_cov_23.034483	369	449	0	80	80	1.0000000
NODE_16298_length_708_cov_20.449918	254	334	0	80	80	1.0000000
NODE_16298_length_708_cov_20.449918	307	387	0	80	80	1.0000000
NODE_16299_length_708_cov_19.998358	238	318	0	80	80	1.0000000
NODE_16299_length_708_cov_19.998358	291	371	0	80	80	1.0000000
NODE_16300_length_708_cov_19.021346	366	446	0	80	80	1.0000000
NODE_16300_length_708_cov_19.021346	419	499	0	80	80	1.0000000
NODE_16302_length_708_cov_12.228243	181	263	0	82	82	1.0000000
NODE_16302_length_708_cov_12.228243	188	268	0	80	80	1.0000000
NODE_16302_length_708_cov_12.228243	236	316	0	80	80	1.0000000
NODE_16302_length_708_cov_12.228243	312	392	0	80	80	1.0000000
NODE_16302_length_708_cov_12.228243	312	392	0	80	80	1.0000000
NODE_16302_length_708_cov_12.228243	365	445	0	80	80	1.0000000
NODE_16303_length_708_cov_11.338259	255	335	0	80	80	1.0000000
NODE_16303_length_708_cov_11.338259	308	388	0	80	80	1.0000000
NODE_16305_length_708_cov_9.676519	219	299	0	27	80	0.3375000
NODE_16305_length_708_cov_9.676519	219	299	2	53	80	0.6625000
NODE_16305_length_708_cov_9.676519	272	352	0	71	80	0.8875000
NODE_16305_length_708_cov_9.676519	272	352	2	9	80	0.1125000
NODE_16306_length_708_cov_8.638752	324	399	0	75	75	1.0000000
NODE_16330_length_708_cov_2.699507	358	398	0	40	40	1.0000000
NODE_16370_length_707_cov_30.067434	325	405	0	27	80	0.3375000
NODE_16370_length_707_cov_30.067434	325	405	2	53	80	0.6625000
NODE_16370_length_707_cov_30.067434	378	458	0	80	80	1.0000000
NODE_16371_length_707_cov_26.555921	241	321	0	80	80	1.0000000
NODE_16371_length_707_cov_26.555921	294	374	0	80	80	1.0000000
NODE_16372_length_707_cov_23.972039	322	402	0	72	80	0.9000000
NODE_16372_length_707_cov_23.972039	322	402	2	8	80	0.1000000
NODE_16372_length_707_cov_23.972039	375	455	0	80	80	1.0000000
NODE_16373_length_707_cov_20.348684	157	237	0	80	80	1.0000000
NODE_16373_length_707_cov_20.348684	210	281	0	71	71	1.0000000
NODE_16374_length_707_cov_18.970395	253	333	0	80	80	1.0000000
NODE_16374_length_707_cov_18.970395	306	386	0	80	80	1.0000000
NODE_16375_length_707_cov_14.324013	302	382	0	80	80	1.0000000
NODE_16375_length_707_cov_14.324013	355	435	0	80	80	1.0000000
NODE_16378_length_707_cov_5.062500	313	393	2	80	80	1.0000000
NODE_16441_length_706_cov_34.116969	272	352	0	80	80	1.0000000
NODE_16441_length_706_cov_34.116969	325	405	0	80	80	1.0000000
NODE_16442_length_706_cov_27.220758	229	309	0	19	80	0.2375000
NODE_16442_length_706_cov_27.220758	229	309	2	9	80	0.1125000
NODE_16442_length_706_cov_27.220758	229	309	4	2	80	0.0250000
NODE_16442_length_706_cov_27.220758	229	309	6	50	80	0.6250000
NODE_16442_length_706_cov_27.220758	282	362	2	14	80	0.1750000
NODE_16442_length_706_cov_27.220758	282	362	4	29	80	0.3625000
NODE_16442_length_706_cov_27.220758	282	362	6	37	80	0.4625000
NODE_16443_length_706_cov_20.380560	264	344	0	80	80	1.0000000
NODE_16443_length_706_cov_20.380560	317	397	0	80	80	1.0000000
NODE_16444_length_706_cov_19.525535	289	369	0	80	80	1.0000000
NODE_16444_length_706_cov_19.525535	342	422	0	80	80	1.0000000
NODE_16454_length_706_cov_3.344316	465	545	0	80	80	1.0000000
NODE_16454_length_706_cov_3.344316	518	598	0	80	80	1.0000000
NODE_16494_length_705_cov_19.211221	118	198	6	12	80	0.1500000
NODE_16494_length_705_cov_19.211221	118	198	8	7	80	0.0875000
NODE_16494_length_705_cov_19.211221	118	198	10	61	80	0.7625000
NODE_16494_length_705_cov_19.211221	171	250	0	36	79	0.4556962
NODE_16494_length_705_cov_19.211221	171	250	6	28	79	0.3544304
NODE_16494_length_705_cov_19.211221	171	250	8	7	79	0.0886076
NODE_16494_length_705_cov_19.211221	171	250	10	8	79	0.1012658
NODE_16495_length_705_cov_16.338284	291	339	13	25	48	0.5208333
NODE_16495_length_705_cov_16.338284	291	339	14	23	48	0.4791667
NODE_16495_length_705_cov_16.338284	336	406	0	10	70	0.1428571
NODE_16495_length_705_cov_16.338284	336	406	1	18	70	0.2571429
NODE_16495_length_705_cov_16.338284	336	406	2	5	70	0.0714286
NODE_16495_length_705_cov_16.338284	336	406	7	15	70	0.2142857
NODE_16495_length_705_cov_16.338284	336	406	13	22	70	0.3142857
NODE_16496_length_705_cov_14.354785	209	289	0	80	80	1.0000000
NODE_16496_length_705_cov_14.354785	262	342	0	80	80	1.0000000
NODE_16497_length_705_cov_12.231023	293	373	0	80	80	1.0000000
NODE_16497_length_705_cov_12.231023	346	426	0	80	80	1.0000000
NODE_16498_length_705_cov_11.836634	390	470	0	36	80	0.4500000
NODE_16498_length_705_cov_11.836634	390	470	2	44	80	0.5500000
NODE_16498_length_705_cov_11.836634	443	523	2	55	80	0.6875000
NODE_16498_length_705_cov_11.836634	443	523	4	25	80	0.3125000
NODE_16499_length_705_cov_10.049505	382	479	0	77	97	0.7938144
NODE_16499_length_705_cov_10.049505	382	479	2	20	97	0.2061856
NODE_16499_length_705_cov_10.049505	452	532	0	80	80	1.0000000
NODE_16507_length_705_cov_4.275578	358	438	0	80	80	1.0000000
NODE_16507_length_705_cov_4.275578	411	491	0	80	80	1.0000000
NODE_16509_length_705_cov_4.018152	306	364	2	58	58	1.0000000
NODE_16509_length_705_cov_4.018152	337	410	0	7	73	0.0958904
NODE_16509_length_705_cov_4.018152	337	410	2	66	73	0.9041096
NODE_16511_length_705_cov_3.620462	253	315	4	8	62	0.1290323
NODE_16511_length_705_cov_3.620462	253	315	5	6	62	0.0967742
NODE_16511_length_705_cov_3.620462	253	315	7	4	62	0.0645161
NODE_16511_length_705_cov_3.620462	253	315	8	7	62	0.1129032
NODE_16511_length_705_cov_3.620462	253	315	9	13	62	0.2096774
NODE_16511_length_705_cov_3.620462	253	315	10	24	62	0.3870968
NODE_16511_length_705_cov_3.620462	308	368	3	14	60	0.2333333
NODE_16511_length_705_cov_3.620462	308	368	4	7	60	0.1166667
NODE_16511_length_705_cov_3.620462	308	368	7	20	60	0.3333333
NODE_16511_length_705_cov_3.620462	308	368	8	6	60	0.1000000
NODE_16511_length_705_cov_3.620462	308	368	9	13	60	0.2166667
NODE_16527_length_705_cov_1.607261	462	531	4	69	69	1.0000000
NODE_16549_length_705_cov_0.529703	33	97	0	23	64	0.3593750
NODE_16549_length_705_cov_0.529703	33	97	2	2	64	0.0312500
NODE_16549_length_705_cov_0.529703	33	97	4	11	64	0.1718750
NODE_16549_length_705_cov_0.529703	33	97	6	10	64	0.1562500
NODE_16549_length_705_cov_0.529703	33	97	8	18	64	0.2812500
NODE_16549_length_705_cov_0.529703	86	150	4	12	64	0.1875000
NODE_16549_length_705_cov_0.529703	86	150	6	20	64	0.3125000
NODE_16549_length_705_cov_0.529703	86	150	8	32	64	0.5000000
NODE_16550_length_704_cov_18.256198	295	375	0	80	80	1.0000000
NODE_16550_length_704_cov_18.256198	348	428	0	80	80	1.0000000
NODE_16552_length_704_cov_16.662810	264	344	4	5	80	0.0625000
NODE_16552_length_704_cov_16.662810	264	344	6	42	80	0.5250000
NODE_16552_length_704_cov_16.662810	264	344	8	33	80	0.4125000
NODE_16552_length_704_cov_16.662810	317	397	2	48	80	0.6000000
NODE_16552_length_704_cov_16.662810	317	397	8	32	80	0.4000000
NODE_16553_length_704_cov_12.641322	294	374	0	16	80	0.2000000
NODE_16553_length_704_cov_12.641322	294	374	2	64	80	0.8000000
NODE_16553_length_704_cov_12.641322	347	427	0	41	80	0.5125000
NODE_16553_length_704_cov_12.641322	347	427	2	39	80	0.4875000
NODE_16557_length_704_cov_5.603306	440	498	0	58	58	1.0000000
NODE_16564_length_704_cov_3.535537	303	383	4	76	80	0.9500000
NODE_16564_length_704_cov_3.535537	303	383	6	4	80	0.0500000
NODE_16564_length_704_cov_3.535537	369	436	2	15	67	0.2238806
NODE_16564_length_704_cov_3.535537	369	436	4	52	67	0.7761194
NODE_16578_length_704_cov_1.963636	345	425	2	1	80	0.0125000
NODE_16578_length_704_cov_1.963636	345	425	4	63	80	0.7875000
NODE_16578_length_704_cov_1.963636	345	425	6	16	80	0.2000000
NODE_16578_length_704_cov_1.963636	398	478	4	29	80	0.3625000
NODE_16578_length_704_cov_1.963636	398	478	6	51	80	0.6375000
NODE_16598_length_703_cov_44.102649	514	594	0	80	80	1.0000000
NODE_16598_length_703_cov_44.102649	567	647	0	80	80	1.0000000
NODE_16599_length_703_cov_33.067881	521	594	111	1	73	0.0136986
NODE_16599_length_703_cov_33.067881	521	594	113	4	73	0.0547945
NODE_16599_length_703_cov_33.067881	521	594	117	2	73	0.0273973
NODE_16599_length_703_cov_33.067881	521	594	119	1	73	0.0136986
NODE_16599_length_703_cov_33.067881	521	594	121	2	73	0.0273973
NODE_16599_length_703_cov_33.067881	521	594	122	3	73	0.0410959
NODE_16599_length_703_cov_33.067881	521	594	124	1	73	0.0136986
NODE_16599_length_703_cov_33.067881	521	594	126	2	73	0.0273973
NODE_16599_length_703_cov_33.067881	521	594	127	1	73	0.0136986
NODE_16599_length_703_cov_33.067881	521	594	131	6	73	0.0821918
NODE_16599_length_703_cov_33.067881	521	594	133	4	73	0.0547945
NODE_16599_length_703_cov_33.067881	521	594	137	2	73	0.0273973
NODE_16599_length_703_cov_33.067881	521	594	139	4	73	0.0547945
NODE_16599_length_703_cov_33.067881	521	594	140	9	73	0.1232877
NODE_16599_length_703_cov_33.067881	521	594	144	2	73	0.0273973
NODE_16599_length_703_cov_33.067881	521	594	145	2	73	0.0273973
NODE_16599_length_703_cov_33.067881	521	594	150	2	73	0.0273973
NODE_16599_length_703_cov_33.067881	521	594	152	2	73	0.0273973
NODE_16599_length_703_cov_33.067881	521	594	153	1	73	0.0136986
NODE_16599_length_703_cov_33.067881	521	594	154	3	73	0.0410959
NODE_16599_length_703_cov_33.067881	521	594	156	7	73	0.0958904
NODE_16599_length_703_cov_33.067881	521	594	157	2	73	0.0273973
NODE_16599_length_703_cov_33.067881	521	594	158	3	73	0.0410959
NODE_16599_length_703_cov_33.067881	521	594	160	5	73	0.0684932
NODE_16599_length_703_cov_33.067881	521	594	161	1	73	0.0136986
NODE_16599_length_703_cov_33.067881	521	594	162	1	73	0.0136986
NODE_16599_length_703_cov_33.067881	561	602	111	4	41	0.0975610
NODE_16599_length_703_cov_33.067881	561	602	113	9	41	0.2195122
NODE_16599_length_703_cov_33.067881	561	602	117	2	41	0.0487805
NODE_16599_length_703_cov_33.067881	561	602	119	1	41	0.0243902
NODE_16599_length_703_cov_33.067881	561	602	121	2	41	0.0487805
NODE_16599_length_703_cov_33.067881	561	602	127	1	41	0.0243902
NODE_16599_length_703_cov_33.067881	561	602	131	6	41	0.1463415
NODE_16599_length_703_cov_33.067881	561	602	133	2	41	0.0487805
NODE_16599_length_703_cov_33.067881	561	602	139	1	41	0.0243902
NODE_16599_length_703_cov_33.067881	561	602	140	9	41	0.2195122
NODE_16599_length_703_cov_33.067881	561	602	144	1	41	0.0243902
NODE_16599_length_703_cov_33.067881	561	602	145	2	41	0.0487805
NODE_16599_length_703_cov_33.067881	561	602	150	1	41	0.0243902
NODE_16600_length_703_cov_30.266556	312	392	0	80	80	1.0000000
NODE_16600_length_703_cov_30.266556	365	445	0	80	80	1.0000000
NODE_16601_length_703_cov_17.006623	449	529	0	42	80	0.5250000
NODE_16601_length_703_cov_17.006623	449	529	2	38	80	0.4750000
NODE_16601_length_703_cov_17.006623	502	582	0	33	80	0.4125000
NODE_16601_length_703_cov_17.006623	502	582	2	47	80	0.5875000
NODE_16602_length_703_cov_14.801325	383	463	0	17	80	0.2125000
NODE_16602_length_703_cov_14.801325	383	463	2	63	80	0.7875000
NODE_16602_length_703_cov_14.801325	436	516	0	70	80	0.8750000
NODE_16602_length_703_cov_14.801325	436	516	2	10	80	0.1250000
NODE_16603_length_703_cov_11.766556	308	388	0	17	80	0.2125000
NODE_16603_length_703_cov_11.766556	308	388	2	4	80	0.0500000
NODE_16603_length_703_cov_11.766556	308	388	4	59	80	0.7375000
NODE_16603_length_703_cov_11.766556	361	441	2	51	80	0.6375000
NODE_16603_length_703_cov_11.766556	361	441	4	29	80	0.3625000
NODE_16604_length_703_cov_10.405629	213	293	4	4	80	0.0500000
NODE_16604_length_703_cov_10.405629	213	293	8	17	80	0.2125000
NODE_16604_length_703_cov_10.405629	213	293	10	54	80	0.6750000
NODE_16604_length_703_cov_10.405629	213	293	12	5	80	0.0625000
NODE_16604_length_703_cov_10.405629	266	301	4	12	35	0.3428572
NODE_16604_length_703_cov_10.405629	266	301	8	17	35	0.4857143
NODE_16604_length_703_cov_10.405629	266	301	10	6	35	0.1714286
NODE_16605_length_703_cov_6.966887	381	440	0	59	59	1.0000000
NODE_16616_length_703_cov_3.491722	256	309	0	32	53	0.6037736
NODE_16616_length_703_cov_3.491722	256	309	2	21	53	0.3962264
NODE_16616_length_703_cov_3.491722	257	337	0	60	80	0.7500000
NODE_16616_length_703_cov_3.491722	257	337	2	20	80	0.2500000
NODE_16616_length_703_cov_3.491722	305	362	0	54	57	0.9473684
NODE_16616_length_703_cov_3.491722	305	362	2	3	57	0.0526316
NODE_16624_length_703_cov_2.687086	216	296	0	80	80	1.0000000
NODE_16624_length_703_cov_2.687086	269	349	0	80	80	1.0000000
NODE_16663_length_702_cov_49.784411	221	299	2	78	78	1.0000000
NODE_16663_length_702_cov_49.784411	277	352	0	6	75	0.0800000
NODE_16663_length_702_cov_49.784411	277	352	2	69	75	0.9200000
NODE_16664_length_702_cov_26.570481	201	281	0	59	80	0.7375000
NODE_16664_length_702_cov_26.570481	201	281	2	21	80	0.2625000
NODE_16664_length_702_cov_26.570481	254	334	0	80	80	1.0000000
NODE_16665_length_702_cov_23.971808	139	219	0	80	80	1.0000000
NODE_16665_length_702_cov_23.971808	192	272	0	80	80	1.0000000
NODE_16665_length_702_cov_23.971808	268	348	0	63	80	0.7875000
NODE_16665_length_702_cov_23.971808	268	348	2	17	80	0.2125000
NODE_16665_length_702_cov_23.971808	321	401	0	10	80	0.1250000
NODE_16665_length_702_cov_23.971808	321	401	2	70	80	0.8750000
NODE_16666_length_702_cov_23.827529	448	528	0	80	80	1.0000000
NODE_16666_length_702_cov_23.827529	501	581	0	80	80	1.0000000
NODE_16667_length_702_cov_14.661692	424	504	0	30	80	0.3750000
NODE_16667_length_702_cov_14.661692	424	504	2	8	80	0.1000000
NODE_16667_length_702_cov_14.661692	424	504	4	42	80	0.5250000
NODE_16667_length_702_cov_14.661692	477	557	0	24	80	0.3000000
NODE_16667_length_702_cov_14.661692	477	557	4	56	80	0.7000000
NODE_16668_length_702_cov_13.908789	259	304	0	20	45	0.4444444
NODE_16668_length_702_cov_13.908789	259	304	6	10	45	0.2222222
NODE_16668_length_702_cov_13.908789	259	304	11	2	45	0.0444444
NODE_16668_length_702_cov_13.908789	259	304	14	2	45	0.0444444
NODE_16668_length_702_cov_13.908789	259	304	15	1	45	0.0222222
NODE_16668_length_702_cov_13.908789	259	304	16	10	45	0.2222222
NODE_16668_length_702_cov_13.908789	277	357	0	2	80	0.0250000
NODE_16668_length_702_cov_13.908789	277	357	6	10	80	0.1250000
NODE_16668_length_702_cov_13.908789	277	357	10	3	80	0.0375000
NODE_16668_length_702_cov_13.908789	277	357	11	2	80	0.0250000
NODE_16668_length_702_cov_13.908789	277	357	14	11	80	0.1375000
NODE_16668_length_702_cov_13.908789	277	357	15	1	80	0.0125000
NODE_16668_length_702_cov_13.908789	277	357	16	51	80	0.6375000
NODE_16668_length_702_cov_13.908789	289	357	10	3	68	0.0441176
NODE_16668_length_702_cov_13.908789	289	357	11	2	68	0.0294118
NODE_16668_length_702_cov_13.908789	289	357	14	11	68	0.1617647
NODE_16668_length_702_cov_13.908789	289	357	15	1	68	0.0147059
NODE_16668_length_702_cov_13.908789	289	357	16	51	68	0.7500000
NODE_16669_length_702_cov_8.502488	337	417	0	80	80	1.0000000
NODE_16669_length_702_cov_8.502488	390	470	0	80	80	1.0000000
NODE_16671_length_702_cov_6.470978	209	289	0	43	80	0.5375000
NODE_16671_length_702_cov_6.470978	209	289	4	37	80	0.4625000
NODE_16671_length_702_cov_6.470978	262	342	0	80	80	1.0000000
NODE_16729_length_701_cov_38.715947	178	258	4	33	80	0.4125000
NODE_16729_length_701_cov_38.715947	178	258	5	16	80	0.2000000
NODE_16729_length_701_cov_38.715947	178	258	6	19	80	0.2375000
NODE_16729_length_701_cov_38.715947	178	258	8	12	80	0.1500000
NODE_16729_length_701_cov_38.715947	231	311	0	5	80	0.0625000
NODE_16729_length_701_cov_38.715947	231	311	4	65	80	0.8125000
NODE_16729_length_701_cov_38.715947	231	311	8	10	80	0.1250000
NODE_16729_length_701_cov_38.715947	307	387	0	80	80	1.0000000
NODE_16729_length_701_cov_38.715947	360	440	0	80	80	1.0000000
NODE_16730_length_701_cov_28.059801	432	513	0	81	81	1.0000000
NODE_16730_length_701_cov_28.059801	486	566	0	80	80	1.0000000
NODE_16731_length_701_cov_18.387043	258	338	0	80	80	1.0000000
NODE_16731_length_701_cov_18.387043	311	391	0	80	80	1.0000000
NODE_16732_length_701_cov_17.122924	295	367	17	5	72	0.0694444
NODE_16732_length_701_cov_17.122924	295	367	19	1	72	0.0138889
NODE_16732_length_701_cov_17.122924	295	367	21	25	72	0.3472222
NODE_16732_length_701_cov_17.122924	295	367	22	13	72	0.1805556
NODE_16732_length_701_cov_17.122924	295	367	23	2	72	0.0277778
NODE_16732_length_701_cov_17.122924	295	367	26	7	72	0.0972222
NODE_16732_length_701_cov_17.122924	295	367	28	13	72	0.1805556
NODE_16732_length_701_cov_17.122924	295	367	30	6	72	0.0833333
NODE_16733_length_701_cov_16.114618	242	322	0	80	80	1.0000000
NODE_16733_length_701_cov_16.114618	295	375	0	80	80	1.0000000
NODE_16734_length_701_cov_15.588040	399	479	0	22	80	0.2750000
NODE_16734_length_701_cov_15.588040	399	479	8	1	80	0.0125000
NODE_16734_length_701_cov_15.588040	399	479	9	23	80	0.2875000
NODE_16734_length_701_cov_15.588040	399	479	10	12	80	0.1500000
NODE_16734_length_701_cov_15.588040	399	479	11	3	80	0.0375000
NODE_16734_length_701_cov_15.588040	399	479	12	19	80	0.2375000
NODE_16734_length_701_cov_15.588040	452	532	2	2	80	0.0250000
NODE_16734_length_701_cov_15.588040	452	532	9	1	80	0.0125000
NODE_16734_length_701_cov_15.588040	452	532	10	20	80	0.2500000
NODE_16734_length_701_cov_15.588040	452	532	11	30	80	0.3750000
NODE_16734_length_701_cov_15.588040	452	532	12	27	80	0.3375000
NODE_16736_length_701_cov_11.420266	229	309	0	80	80	1.0000000
NODE_16736_length_701_cov_11.420266	282	362	0	80	80	1.0000000
NODE_16737_length_701_cov_10.411960	202	283	0	47	81	0.5802469
NODE_16737_length_701_cov_10.411960	202	283	3	3	81	0.0370370
NODE_16737_length_701_cov_10.411960	202	283	6	31	81	0.3827161
NODE_16737_length_701_cov_10.411960	256	336	6	28	80	0.3500000
NODE_16737_length_701_cov_10.411960	256	336	10	52	80	0.6500000
NODE_16738_length_701_cov_9.107973	400	480	0	80	80	1.0000000
NODE_16738_length_701_cov_9.107973	453	533	0	80	80	1.0000000
NODE_16739_length_701_cov_8.877076	283	363	0	80	80	1.0000000
NODE_16739_length_701_cov_8.877076	336	416	0	80	80	1.0000000
NODE_16740_length_701_cov_8.543189	341	421	0	80	80	1.0000000
NODE_16740_length_701_cov_8.543189	394	474	0	80	80	1.0000000
NODE_16742_length_701_cov_6.317276	273	353	0	42	80	0.5250000
NODE_16742_length_701_cov_6.317276	273	353	1	38	80	0.4750000
NODE_16742_length_701_cov_6.317276	326	382	1	48	56	0.8571429
NODE_16742_length_701_cov_6.317276	326	382	2	8	56	0.1428571
NODE_16747_length_701_cov_5.081395	318	374	0	4	56	0.0714286
NODE_16747_length_701_cov_5.081395	318	374	2	4	56	0.0714286
NODE_16747_length_701_cov_5.081395	318	374	6	48	56	0.8571429
NODE_16752_length_701_cov_3.320598	207	287	0	80	80	1.0000000
NODE_16752_length_701_cov_3.320598	260	340	0	80	80	1.0000000
NODE_16794_length_700_cov_22.241265	326	406	10	2	80	0.0250000
NODE_16794_length_700_cov_22.241265	326	406	11	4	80	0.0500000
NODE_16794_length_700_cov_22.241265	326	406	12	3	80	0.0375000
NODE_16794_length_700_cov_22.241265	326	406	13	4	80	0.0500000
NODE_16794_length_700_cov_22.241265	326	406	18	9	80	0.1125000
NODE_16794_length_700_cov_22.241265	326	406	20	27	80	0.3375000
NODE_16794_length_700_cov_22.241265	326	406	23	20	80	0.2500000
NODE_16794_length_700_cov_22.241265	326	406	25	9	80	0.1125000
NODE_16794_length_700_cov_22.241265	326	406	27	2	80	0.0250000
NODE_16796_length_700_cov_11.730449	294	374	0	78	80	0.9750000
NODE_16796_length_700_cov_11.730449	294	374	2	2	80	0.0250000
NODE_16796_length_700_cov_11.730449	347	427	0	25	80	0.3125000
NODE_16796_length_700_cov_11.730449	347	427	2	55	80	0.6875000
NODE_16800_length_700_cov_7.291181	317	397	0	80	80	1.0000000
NODE_16800_length_700_cov_7.291181	370	450	0	33	80	0.4125000
NODE_16800_length_700_cov_7.291181	370	450	2	47	80	0.5875000
NODE_16801_length_700_cov_6.557404	353	404	2	31	51	0.6078432
NODE_16801_length_700_cov_6.557404	353	404	4	20	51	0.3921569
NODE_16802_length_700_cov_5.475874	301	381	0	80	80	1.0000000
NODE_16802_length_700_cov_5.475874	354	434	0	80	80	1.0000000
NODE_16803_length_700_cov_3.960067	158	234	0	76	76	1.0000000
NODE_16803_length_700_cov_3.960067	209	291	0	82	82	1.0000000
NODE_16822_length_700_cov_1.517471	324	404	0	80	80	1.0000000
NODE_16822_length_700_cov_1.517471	377	457	0	80	80	1.0000000
NODE_16844_length_699_cov_18.446667	185	265	0	80	80	1.0000000
NODE_16844_length_699_cov_18.446667	238	318	0	80	80	1.0000000
NODE_16845_length_699_cov_18.383333	258	338	0	80	80	1.0000000
NODE_16845_length_699_cov_18.383333	311	391	0	80	80	1.0000000
NODE_16846_length_699_cov_18.103333	218	298	0	80	80	1.0000000
NODE_16846_length_699_cov_18.103333	271	351	0	80	80	1.0000000
NODE_16847_length_699_cov_15.636667	279	359	0	28	80	0.3500000
NODE_16847_length_699_cov_15.636667	279	359	2	10	80	0.1250000
NODE_16847_length_699_cov_15.636667	279	359	4	9	80	0.1125000
NODE_16847_length_699_cov_15.636667	279	359	6	33	80	0.4125000
NODE_16847_length_699_cov_15.636667	332	412	4	12	80	0.1500000
NODE_16847_length_699_cov_15.636667	332	412	6	68	80	0.8500000
NODE_16848_length_699_cov_15.113333	313	393	1	58	80	0.7250000
NODE_16848_length_699_cov_15.113333	313	393	3	22	80	0.2750000
NODE_16848_length_699_cov_15.113333	366	446	0	5	80	0.0625000
NODE_16848_length_699_cov_15.113333	366	446	1	5	80	0.0625000
NODE_16848_length_699_cov_15.113333	366	446	2	14	80	0.1750000
NODE_16848_length_699_cov_15.113333	366	446	3	56	80	0.7000000
NODE_16849_length_699_cov_10.070000	233	313	0	80	80	1.0000000
NODE_16849_length_699_cov_10.070000	286	366	0	80	80	1.0000000
NODE_16849_length_699_cov_10.070000	362	442	0	80	80	1.0000000
NODE_16849_length_699_cov_10.070000	415	495	0	80	80	1.0000000
NODE_16850_length_699_cov_8.083333	347	427	0	5	80	0.0625000
NODE_16850_length_699_cov_8.083333	347	427	2	75	80	0.9375000
NODE_16850_length_699_cov_8.083333	400	480	0	58	80	0.7250000
NODE_16850_length_699_cov_8.083333	400	480	2	22	80	0.2750000
NODE_16851_length_699_cov_7.758333	307	387	0	80	80	1.0000000
NODE_16851_length_699_cov_7.758333	360	440	0	80	80	1.0000000
NODE_16852_length_699_cov_7.713333	252	332	0	80	80	1.0000000
NODE_16852_length_699_cov_7.713333	305	385	0	80	80	1.0000000
NODE_16853_length_699_cov_7.186667	271	332	0	61	61	1.0000000
NODE_16853_length_699_cov_7.186667	348	428	0	80	80	1.0000000
NODE_16857_length_699_cov_5.815000	243	316	2	27	73	0.3698630
NODE_16857_length_699_cov_5.815000	243	316	4	28	73	0.3835616
NODE_16857_length_699_cov_5.815000	243	316	6	18	73	0.2465753
NODE_16857_length_699_cov_5.815000	293	374	2	58	81	0.7160494
NODE_16857_length_699_cov_5.815000	293	374	6	1	81	0.0123457
NODE_16857_length_699_cov_5.815000	293	374	7	22	81	0.2716049
NODE_16858_length_699_cov_5.520000	302	382	0	40	80	0.5000000
NODE_16858_length_699_cov_5.520000	302	382	1	21	80	0.2625000
NODE_16858_length_699_cov_5.520000	302	382	2	19	80	0.2375000
NODE_16858_length_699_cov_5.520000	355	435	0	80	80	1.0000000
NODE_16860_length_699_cov_4.051667	289	369	0	80	80	1.0000000
NODE_16860_length_699_cov_4.051667	342	422	0	80	80	1.0000000
NODE_16868_length_699_cov_2.498333	204	284	0	80	80	1.0000000
NODE_16868_length_699_cov_2.498333	257	337	0	80	80	1.0000000
NODE_16908_length_698_cov_47.350584	321	401	0	19	80	0.2375000
NODE_16908_length_698_cov_47.350584	321	401	4	61	80	0.7625000
NODE_16908_length_698_cov_47.350584	374	454	0	51	80	0.6375000
NODE_16908_length_698_cov_47.350584	374	454	4	29	80	0.3625000
NODE_16909_length_698_cov_42.848080	255	335	0	80	80	1.0000000
NODE_16909_length_698_cov_42.848080	308	388	0	80	80	1.0000000
NODE_16910_length_698_cov_36.697830	366	446	0	80	80	1.0000000
NODE_16910_length_698_cov_36.697830	419	484	0	65	65	1.0000000
NODE_16911_length_698_cov_23.874791	222	302	0	80	80	1.0000000
NODE_16911_length_698_cov_23.874791	275	355	0	80	80	1.0000000
NODE_16912_length_698_cov_7.133556	360	440	0	80	80	1.0000000
NODE_16912_length_698_cov_7.133556	413	493	0	80	80	1.0000000
NODE_16913_length_698_cov_6.520868	267	347	0	80	80	1.0000000
NODE_16913_length_698_cov_6.520868	320	400	0	80	80	1.0000000
NODE_16917_length_698_cov_4.762938	329	359	0	30	30	1.0000000
NODE_16926_length_698_cov_2.577629	309	389	0	25	80	0.3125000
NODE_16926_length_698_cov_2.577629	309	389	2	55	80	0.6875000
NODE_16926_length_698_cov_2.577629	362	442	0	78	80	0.9750000
NODE_16926_length_698_cov_2.577629	362	442	2	2	80	0.0250000
NODE_16962_length_697_cov_16.013378	305	385	0	80	80	1.0000000
NODE_16962_length_697_cov_16.013378	358	438	0	80	80	1.0000000
NODE_16963_length_697_cov_14.411371	440	520	0	80	80	1.0000000
NODE_16963_length_697_cov_14.411371	493	573	0	80	80	1.0000000
NODE_16964_length_697_cov_14.282609	257	354	2	96	97	0.9896907
NODE_16964_length_697_cov_14.282609	257	354	4	1	97	0.0103093
NODE_16964_length_697_cov_14.282609	327	385	0	13	58	0.2241379
NODE_16964_length_697_cov_14.282609	327	385	1	1	58	0.0172414
NODE_16964_length_697_cov_14.282609	327	385	2	32	58	0.5517241
NODE_16964_length_697_cov_14.282609	327	385	8	12	58	0.2068966
NODE_16965_length_697_cov_9.969900	360	440	0	53	80	0.6625000
NODE_16965_length_697_cov_9.969900	360	440	1	27	80	0.3375000
NODE_16965_length_697_cov_9.969900	413	493	0	48	80	0.6000000
NODE_16965_length_697_cov_9.969900	413	493	2	32	80	0.4000000
NODE_16968_length_697_cov_6.117057	236	316	0	80	80	1.0000000
NODE_16968_length_697_cov_6.117057	289	369	0	80	80	1.0000000
NODE_17025_length_696_cov_28.360134	319	399	0	80	80	1.0000000
NODE_17025_length_696_cov_28.360134	372	452	0	80	80	1.0000000
NODE_17026_length_696_cov_18.708543	367	447	0	80	80	1.0000000
NODE_17026_length_696_cov_18.708543	420	500	0	80	80	1.0000000
NODE_17027_length_696_cov_18.170854	390	470	0	80	80	1.0000000
NODE_17027_length_696_cov_18.170854	443	523	0	80	80	1.0000000
NODE_17028_length_696_cov_13.738693	266	346	0	9	80	0.1125000
NODE_17028_length_696_cov_13.738693	266	346	2	71	80	0.8875000
NODE_17028_length_696_cov_13.738693	319	399	0	62	80	0.7750000
NODE_17028_length_696_cov_13.738693	319	399	2	18	80	0.2250000
NODE_17030_length_696_cov_10.693467	239	266	6	27	27	1.0000000
NODE_17031_length_696_cov_9.949749	248	328	0	80	80	1.0000000
NODE_17031_length_696_cov_9.949749	301	381	0	80	80	1.0000000
NODE_17032_length_696_cov_8.658291	247	327	0	80	80	1.0000000
NODE_17032_length_696_cov_8.658291	300	380	0	80	80	1.0000000
NODE_17032_length_696_cov_8.658291	376	456	0	80	80	1.0000000
NODE_17032_length_696_cov_8.658291	429	509	0	80	80	1.0000000
NODE_17068_length_696_cov_1.675042	498	543	0	45	45	1.0000000
NODE_17100_length_695_cov_24.112416	388	468	0	80	80	1.0000000
NODE_17100_length_695_cov_24.112416	441	521	0	80	80	1.0000000
NODE_17101_length_695_cov_12.152685	349	429	0	22	80	0.2750000
NODE_17101_length_695_cov_12.152685	349	429	2	20	80	0.2500000
NODE_17101_length_695_cov_12.152685	349	429	4	38	80	0.4750000
NODE_17101_length_695_cov_12.152685	402	482	0	19	80	0.2375000
NODE_17101_length_695_cov_12.152685	402	482	2	9	80	0.1125000
NODE_17101_length_695_cov_12.152685	402	482	4	52	80	0.6500000
NODE_17103_length_695_cov_8.466443	345	425	0	80	80	1.0000000
NODE_17103_length_695_cov_8.466443	398	478	0	80	80	1.0000000
NODE_17106_length_695_cov_5.661074	283	363	0	49	80	0.6125000
NODE_17106_length_695_cov_5.661074	283	363	2	31	80	0.3875000
NODE_17106_length_695_cov_5.661074	346	416	2	70	70	1.0000000
NODE_17124_length_695_cov_2.050336	36	112	0	76	76	1.0000000
NODE_17161_length_694_cov_46.675630	30	110	0	80	80	1.0000000
NODE_17161_length_694_cov_46.675630	83	163	0	80	80	1.0000000
NODE_17161_length_694_cov_46.675630	159	239	0	80	80	1.0000000
NODE_17161_length_694_cov_46.675630	212	292	0	80	80	1.0000000
NODE_17162_length_694_cov_12.850420	326	406	0	80	80	1.0000000
NODE_17162_length_694_cov_12.850420	379	459	0	80	80	1.0000000
NODE_17163_length_694_cov_7.236975	318	396	0	30	78	0.3846154
NODE_17163_length_694_cov_7.236975	318	396	1	12	78	0.1538462
NODE_17163_length_694_cov_7.236975	318	396	2	36	78	0.4615385
NODE_17163_length_694_cov_7.236975	371	450	0	67	79	0.8481013
NODE_17163_length_694_cov_7.236975	371	450	6	12	79	0.1518987
NODE_17166_length_694_cov_5.554622	404	484	0	18	80	0.2250000
NODE_17166_length_694_cov_5.554622	404	484	4	62	80	0.7750000
NODE_17166_length_694_cov_5.554622	457	537	2	20	80	0.2500000
NODE_17166_length_694_cov_5.554622	457	537	4	44	80	0.5500000
NODE_17166_length_694_cov_5.554622	457	537	6	16	80	0.2000000
NODE_17168_length_694_cov_5.373109	152	232	2	80	80	1.0000000
NODE_17168_length_694_cov_5.373109	205	285	0	53	80	0.6625000
NODE_17168_length_694_cov_5.373109	205	285	2	27	80	0.3375000
NODE_17227_length_693_cov_26.616162	435	515	0	80	80	1.0000000
NODE_17227_length_693_cov_26.616162	488	568	0	80	80	1.0000000
NODE_17228_length_693_cov_23.552189	193	273	0	80	80	1.0000000
NODE_17228_length_693_cov_23.552189	246	326	0	80	80	1.0000000
NODE_17229_length_693_cov_22.848485	231	311	0	66	80	0.8250000
NODE_17229_length_693_cov_22.848485	231	311	6	14	80	0.1750000
NODE_17229_length_693_cov_22.848485	284	364	0	13	80	0.1625000
NODE_17229_length_693_cov_22.848485	284	364	6	67	80	0.8375000
NODE_17230_length_693_cov_13.616162	219	299	0	58	80	0.7250000
NODE_17230_length_693_cov_13.616162	219	299	2	22	80	0.2750000
NODE_17230_length_693_cov_13.616162	272	352	0	5	80	0.0625000
NODE_17230_length_693_cov_13.616162	272	352	2	75	80	0.9375000
NODE_17231_length_693_cov_12.382155	305	385	0	80	80	1.0000000
NODE_17231_length_693_cov_12.382155	358	424	0	66	66	1.0000000
NODE_17232_length_693_cov_10.053872	279	359	0	58	80	0.7250000
NODE_17232_length_693_cov_10.053872	279	359	6	22	80	0.2750000
NODE_17232_length_693_cov_10.053872	332	412	0	5	80	0.0625000
NODE_17232_length_693_cov_10.053872	332	412	4	1	80	0.0125000
NODE_17232_length_693_cov_10.053872	332	412	6	74	80	0.9250000
NODE_17233_length_693_cov_9.659933	247	327	4	80	80	1.0000000
NODE_17233_length_693_cov_9.659933	300	380	0	36	80	0.4500000
NODE_17233_length_693_cov_9.659933	300	380	4	44	80	0.5500000
NODE_17235_length_693_cov_8.077441	343	423	0	80	80	1.0000000
NODE_17235_length_693_cov_8.077441	396	476	0	80	80	1.0000000
NODE_17243_length_693_cov_3.680135	250	321	0	71	71	1.0000000
NODE_17280_length_692_cov_33.416526	462	542	2	54	80	0.6750000
NODE_17280_length_692_cov_33.416526	462	542	4	26	80	0.3250000
NODE_17280_length_692_cov_33.416526	515	595	0	34	80	0.4250000
NODE_17280_length_692_cov_33.416526	515	595	2	46	80	0.5750000
NODE_17281_length_692_cov_17.559865	291	371	0	80	80	1.0000000
NODE_17282_length_692_cov_15.070826	304	375	0	10	71	0.1408451
NODE_17282_length_692_cov_15.070826	304	375	2	61	71	0.8591549
NODE_17283_length_692_cov_13.279933	308	388	0	80	80	1.0000000
NODE_17283_length_692_cov_13.279933	361	441	0	80	80	1.0000000
NODE_17285_length_692_cov_10.750422	317	397	0	80	80	1.0000000
NODE_17287_length_692_cov_7.497470	175	255	0	80	80	1.0000000
NODE_17287_length_692_cov_7.497470	228	312	0	84	84	1.0000000
NODE_17289_length_692_cov_7.370995	235	315	2	11	80	0.1375000
NODE_17289_length_692_cov_7.370995	235	315	4	32	80	0.4000000
NODE_17289_length_692_cov_7.370995	235	315	10	37	80	0.4625000
NODE_17289_length_692_cov_7.370995	288	369	8	34	81	0.4197531
NODE_17289_length_692_cov_7.370995	288	369	10	47	81	0.5802469
NODE_17328_length_692_cov_1.514334	404	484	0	3	80	0.0375000
NODE_17328_length_692_cov_1.514334	404	484	2	59	80	0.7375000
NODE_17328_length_692_cov_1.514334	404	484	3	1	80	0.0125000
NODE_17328_length_692_cov_1.514334	404	484	4	17	80	0.2125000
NODE_17350_length_691_cov_115.233108	276	356	2	12	80	0.1500000
NODE_17350_length_691_cov_115.233108	276	356	4	38	80	0.4750000
NODE_17350_length_691_cov_115.233108	276	356	5	30	80	0.3750000
NODE_17350_length_691_cov_115.233108	329	409	4	63	80	0.7875000
NODE_17350_length_691_cov_115.233108	329	409	5	17	80	0.2125000
NODE_17350_length_691_cov_115.233108	405	485	4	4	80	0.0500000
NODE_17350_length_691_cov_115.233108	405	485	5	3	80	0.0375000
NODE_17350_length_691_cov_115.233108	405	485	7	7	80	0.0875000
NODE_17350_length_691_cov_115.233108	405	485	9	3	80	0.0375000
NODE_17350_length_691_cov_115.233108	405	485	11	3	80	0.0375000
NODE_17350_length_691_cov_115.233108	405	485	18	5	80	0.0625000
NODE_17350_length_691_cov_115.233108	405	485	21	4	80	0.0500000
NODE_17350_length_691_cov_115.233108	405	485	25	5	80	0.0625000
NODE_17350_length_691_cov_115.233108	405	485	28	5	80	0.0625000
NODE_17350_length_691_cov_115.233108	405	485	36	1	80	0.0125000
NODE_17350_length_691_cov_115.233108	405	485	42	3	80	0.0375000
NODE_17350_length_691_cov_115.233108	405	485	48	3	80	0.0375000
NODE_17350_length_691_cov_115.233108	405	485	52	3	80	0.0375000
NODE_17350_length_691_cov_115.233108	405	485	67	1	80	0.0125000
NODE_17350_length_691_cov_115.233108	405	485	77	2	80	0.0250000
NODE_17350_length_691_cov_115.233108	405	485	79	2	80	0.0250000
NODE_17350_length_691_cov_115.233108	405	485	81	5	80	0.0625000
NODE_17350_length_691_cov_115.233108	405	485	86	1	80	0.0125000
NODE_17350_length_691_cov_115.233108	405	485	90	2	80	0.0250000
NODE_17350_length_691_cov_115.233108	405	485	91	2	80	0.0250000
NODE_17350_length_691_cov_115.233108	405	485	94	3	80	0.0375000
NODE_17350_length_691_cov_115.233108	405	485	95	1	80	0.0125000
NODE_17350_length_691_cov_115.233108	405	485	96	7	80	0.0875000
NODE_17350_length_691_cov_115.233108	405	485	99	5	80	0.0625000
NODE_17350_length_691_cov_115.233108	458	538	79	1	80	0.0125000
NODE_17350_length_691_cov_115.233108	458	538	81	5	80	0.0625000
NODE_17350_length_691_cov_115.233108	458	538	86	1	80	0.0125000
NODE_17350_length_691_cov_115.233108	458	538	90	2	80	0.0250000
NODE_17350_length_691_cov_115.233108	458	538	91	2	80	0.0250000
NODE_17350_length_691_cov_115.233108	458	538	94	3	80	0.0375000
NODE_17350_length_691_cov_115.233108	458	538	95	1	80	0.0125000
NODE_17350_length_691_cov_115.233108	458	538	96	7	80	0.0875000
NODE_17350_length_691_cov_115.233108	458	538	99	5	80	0.0625000
NODE_17350_length_691_cov_115.233108	458	538	103	20	80	0.2500000
NODE_17350_length_691_cov_115.233108	458	538	106	2	80	0.0250000
NODE_17350_length_691_cov_115.233108	458	538	108	1	80	0.0125000
NODE_17350_length_691_cov_115.233108	458	538	109	3	80	0.0375000
NODE_17350_length_691_cov_115.233108	458	538	111	3	80	0.0375000
NODE_17350_length_691_cov_115.233108	458	538	112	13	80	0.1625000
NODE_17350_length_691_cov_115.233108	458	538	114	2	80	0.0250000
NODE_17350_length_691_cov_115.233108	458	538	116	1	80	0.0125000
NODE_17350_length_691_cov_115.233108	458	538	118	2	80	0.0250000
NODE_17350_length_691_cov_115.233108	458	538	124	5	80	0.0625000
NODE_17350_length_691_cov_115.233108	458	538	126	1	80	0.0125000
NODE_17351_length_691_cov_26.076014	188	268	0	29	80	0.3625000
NODE_17351_length_691_cov_26.076014	188	268	1	33	80	0.4125000
NODE_17351_length_691_cov_26.076014	188	268	2	18	80	0.2250000
NODE_17351_length_691_cov_26.076014	241	321	1	9	80	0.1125000
NODE_17351_length_691_cov_26.076014	241	321	2	71	80	0.8875000
NODE_17352_length_691_cov_21.991554	288	368	0	80	80	1.0000000
NODE_17352_length_691_cov_21.991554	341	419	0	78	78	1.0000000
NODE_17353_length_691_cov_14.908784	226	306	0	80	80	1.0000000
NODE_17353_length_691_cov_14.908784	279	359	0	80	80	1.0000000
NODE_17358_length_691_cov_5.670608	325	402	0	77	77	1.0000000
NODE_17358_length_691_cov_5.670608	375	455	0	80	80	1.0000000
NODE_17361_length_691_cov_4.866554	103	183	0	80	80	1.0000000
NODE_17361_length_691_cov_4.866554	156	236	0	80	80	1.0000000
NODE_17367_length_691_cov_3.388514	304	384	0	80	80	1.0000000
NODE_17367_length_691_cov_3.388514	357	437	0	63	80	0.7875000
NODE_17367_length_691_cov_3.388514	357	437	2	17	80	0.2125000
NODE_17415_length_690_cov_39.538071	563	612	0	49	49	1.0000000
NODE_17415_length_690_cov_39.538071	598	678	0	80	80	1.0000000
NODE_17415_length_690_cov_39.538071	651	690	0	39	39	1.0000000
NODE_17417_length_690_cov_30.336717	319	394	0	69	75	0.9200000
NODE_17417_length_690_cov_30.336717	319	394	2	6	75	0.0800000
NODE_17417_length_690_cov_30.336717	372	453	0	16	81	0.1975309
NODE_17417_length_690_cov_30.336717	372	453	2	65	81	0.8024691
NODE_17417_length_690_cov_30.336717	449	529	0	64	80	0.8000000
NODE_17417_length_690_cov_30.336717	449	529	2	16	80	0.2000000
NODE_17417_length_690_cov_30.336717	502	582	0	80	80	1.0000000
NODE_17418_length_690_cov_26.888325	270	350	0	80	80	1.0000000
NODE_17418_length_690_cov_26.888325	323	403	0	80	80	1.0000000
NODE_17419_length_690_cov_23.360406	131	211	0	80	80	1.0000000
NODE_17419_length_690_cov_23.360406	188	264	0	76	76	1.0000000
NODE_17420_length_690_cov_18.737733	316	396	0	80	80	1.0000000
NODE_17420_length_690_cov_18.737733	369	449	0	80	80	1.0000000
NODE_17421_length_690_cov_16.593909	364	444	0	80	80	1.0000000
NODE_17421_length_690_cov_16.593909	417	497	0	80	80	1.0000000
NODE_17422_length_690_cov_12.896785	320	400	0	80	80	1.0000000
NODE_17422_length_690_cov_12.896785	373	453	0	80	80	1.0000000
NODE_17423_length_690_cov_10.818951	349	429	0	80	80	1.0000000
NODE_17424_length_690_cov_7.015228	273	353	0	80	80	1.0000000
NODE_17424_length_690_cov_7.015228	326	406	0	80	80	1.0000000
NODE_17429_length_690_cov_4.793570	316	365	236	1	49	0.0204082
NODE_17429_length_690_cov_4.793570	316	365	244	3	49	0.0612245
NODE_17429_length_690_cov_4.793570	316	365	246	2	49	0.0408163
NODE_17429_length_690_cov_4.793570	316	365	248	1	49	0.0204082
NODE_17429_length_690_cov_4.793570	316	365	253	1	49	0.0204082
NODE_17429_length_690_cov_4.793570	316	365	254	1	49	0.0204082
NODE_17429_length_690_cov_4.793570	316	365	255	1	49	0.0204082
NODE_17429_length_690_cov_4.793570	316	365	256	2	49	0.0408163
NODE_17429_length_690_cov_4.793570	316	365	257	1	49	0.0204082
NODE_17429_length_690_cov_4.793570	316	365	260	1	49	0.0204082
NODE_17429_length_690_cov_4.793570	316	365	262	1	49	0.0204082
NODE_17429_length_690_cov_4.793570	316	365	264	1	49	0.0204082
NODE_17429_length_690_cov_4.793570	316	365	265	1	49	0.0204082
NODE_17429_length_690_cov_4.793570	316	365	266	1	49	0.0204082
NODE_17429_length_690_cov_4.793570	316	365	267	1	49	0.0204082
NODE_17429_length_690_cov_4.793570	316	365	268	1	49	0.0204082
NODE_17429_length_690_cov_4.793570	316	365	270	4	49	0.0816327
NODE_17429_length_690_cov_4.793570	316	365	271	3	49	0.0612245
NODE_17429_length_690_cov_4.793570	316	365	272	8	49	0.1632653
NODE_17429_length_690_cov_4.793570	316	365	273	2	49	0.0408163
NODE_17429_length_690_cov_4.793570	316	365	274	4	49	0.0816327
NODE_17429_length_690_cov_4.793570	316	365	275	1	49	0.0204082
NODE_17429_length_690_cov_4.793570	316	365	277	2	49	0.0408163
NODE_17429_length_690_cov_4.793570	316	365	279	1	49	0.0204082
NODE_17429_length_690_cov_4.793570	316	365	280	3	49	0.0612245
NODE_17429_length_690_cov_4.793570	316	365	282	1	49	0.0204082
NODE_17430_length_690_cov_4.717428	316	396	0	80	80	1.0000000
NODE_17430_length_690_cov_4.717428	369	449	0	80	80	1.0000000
NODE_17484_length_689_cov_45.984746	244	322	4	21	78	0.2692308
NODE_17484_length_689_cov_45.984746	244	322	5	57	78	0.7307692
NODE_17484_length_689_cov_45.984746	297	377	2	13	80	0.1625000
NODE_17484_length_689_cov_45.984746	297	377	5	55	80	0.6875000
NODE_17484_length_689_cov_45.984746	297	377	6	12	80	0.1500000
NODE_17485_length_689_cov_35.705085	436	516	0	22	80	0.2750000
NODE_17485_length_689_cov_35.705085	436	516	2	33	80	0.4125000
NODE_17485_length_689_cov_35.705085	436	516	39	20	80	0.2500000
NODE_17485_length_689_cov_35.705085	436	516	40	5	80	0.0625000
NODE_17485_length_689_cov_35.705085	489	569	2	2	80	0.0250000
NODE_17485_length_689_cov_35.705085	489	569	38	13	80	0.1625000
NODE_17485_length_689_cov_35.705085	489	569	39	20	80	0.2500000
NODE_17485_length_689_cov_35.705085	489	569	40	45	80	0.5625000
NODE_17486_length_689_cov_25.372881	211	291	0	80	80	1.0000000
NODE_17486_length_689_cov_25.372881	264	344	0	78	80	0.9750000
NODE_17486_length_689_cov_25.372881	264	344	2	2	80	0.0250000
NODE_17487_length_689_cov_20.138983	319	399	0	28	80	0.3500000
NODE_17487_length_689_cov_20.138983	319	399	2	52	80	0.6500000
NODE_17487_length_689_cov_20.138983	372	452	0	7	80	0.0875000
NODE_17487_length_689_cov_20.138983	372	452	2	73	80	0.9125000
NODE_17488_length_689_cov_14.377966	351	431	4	65	80	0.8125000
NODE_17488_length_689_cov_14.377966	351	431	6	15	80	0.1875000
NODE_17488_length_689_cov_14.377966	404	484	2	40	80	0.5000000
NODE_17488_length_689_cov_14.377966	404	484	4	12	80	0.1500000
NODE_17488_length_689_cov_14.377966	404	484	6	28	80	0.3500000
NODE_17489_length_689_cov_9.477966	201	281	0	80	80	1.0000000
NODE_17489_length_689_cov_9.477966	254	334	0	80	80	1.0000000
NODE_17491_length_689_cov_7.367797	122	207	10	2	85	0.0235294
NODE_17491_length_689_cov_7.367797	122	207	12	18	85	0.2117647
NODE_17491_length_689_cov_7.367797	122	207	14	41	85	0.4823529
NODE_17491_length_689_cov_7.367797	122	207	15	2	85	0.0235294
NODE_17491_length_689_cov_7.367797	122	207	16	22	85	0.2588235
NODE_17492_length_689_cov_6.649153	242	322	0	80	80	1.0000000
NODE_17492_length_689_cov_6.649153	295	375	0	80	80	1.0000000
NODE_17504_length_689_cov_2.788136	128	208	0	80	80	1.0000000
NODE_17504_length_689_cov_2.788136	181	261	0	80	80	1.0000000
NODE_17548_length_688_cov_52.256367	198	278	2	19	80	0.2375000
NODE_17548_length_688_cov_52.256367	198	278	5	4	80	0.0500000
NODE_17548_length_688_cov_52.256367	198	278	6	28	80	0.3500000
NODE_17548_length_688_cov_52.256367	198	278	7	29	80	0.3625000
NODE_17548_length_688_cov_52.256367	251	331	0	28	80	0.3500000
NODE_17548_length_688_cov_52.256367	251	331	6	52	80	0.6500000
NODE_17549_length_688_cov_37.563667	373	453	0	8	80	0.1000000
NODE_17549_length_688_cov_37.563667	373	453	2	72	80	0.9000000
NODE_17549_length_688_cov_37.563667	426	506	0	61	80	0.7625000
NODE_17549_length_688_cov_37.563667	426	506	2	19	80	0.2375000
NODE_17549_length_688_cov_37.563667	514	594	2	4	80	0.0500000
NODE_17549_length_688_cov_37.563667	514	594	4	3	80	0.0375000
NODE_17549_length_688_cov_37.563667	514	594	8	8	80	0.1000000
NODE_17549_length_688_cov_37.563667	514	594	10	11	80	0.1375000
NODE_17549_length_688_cov_37.563667	514	594	14	2	80	0.0250000
NODE_17549_length_688_cov_37.563667	514	594	16	18	80	0.2250000
NODE_17549_length_688_cov_37.563667	514	594	18	3	80	0.0375000
NODE_17549_length_688_cov_37.563667	514	594	20	2	80	0.0250000
NODE_17549_length_688_cov_37.563667	514	594	22	5	80	0.0625000
NODE_17549_length_688_cov_37.563667	514	594	26	24	80	0.3000000
NODE_17549_length_688_cov_37.563667	514	594	2	4	80	0.0500000
NODE_17549_length_688_cov_37.563667	514	594	4	3	80	0.0375000
NODE_17549_length_688_cov_37.563667	514	594	8	8	80	0.1000000
NODE_17549_length_688_cov_37.563667	514	594	10	11	80	0.1375000
NODE_17549_length_688_cov_37.563667	514	594	14	2	80	0.0250000
NODE_17549_length_688_cov_37.563667	514	594	16	18	80	0.2250000
NODE_17549_length_688_cov_37.563667	514	594	18	3	80	0.0375000
NODE_17549_length_688_cov_37.563667	514	594	20	2	80	0.0250000
NODE_17549_length_688_cov_37.563667	514	594	22	5	80	0.0625000
NODE_17549_length_688_cov_37.563667	514	594	26	24	80	0.3000000
NODE_17549_length_688_cov_37.563667	514	584	2	4	70	0.0571429
NODE_17549_length_688_cov_37.563667	514	584	4	3	70	0.0428571
NODE_17549_length_688_cov_37.563667	514	584	8	8	70	0.1142857
NODE_17549_length_688_cov_37.563667	514	584	10	11	70	0.1571429
NODE_17549_length_688_cov_37.563667	514	584	14	2	70	0.0285714
NODE_17549_length_688_cov_37.563667	514	584	16	18	70	0.2571429
NODE_17549_length_688_cov_37.563667	514	584	18	3	70	0.0428571
NODE_17549_length_688_cov_37.563667	514	584	20	2	70	0.0285714
NODE_17549_length_688_cov_37.563667	514	584	22	5	70	0.0714286
NODE_17549_length_688_cov_37.563667	514	584	26	14	70	0.2000000
NODE_17549_length_688_cov_37.563667	567	647	12	5	80	0.0625000
NODE_17549_length_688_cov_37.563667	567	647	14	8	80	0.1000000
NODE_17549_length_688_cov_37.563667	567	647	18	16	80	0.2000000
NODE_17549_length_688_cov_37.563667	567	647	20	7	80	0.0875000
NODE_17549_length_688_cov_37.563667	567	647	22	5	80	0.0625000
NODE_17549_length_688_cov_37.563667	567	647	24	4	80	0.0500000
NODE_17549_length_688_cov_37.563667	567	647	26	35	80	0.4375000
NODE_17549_length_688_cov_37.563667	567	646	12	4	79	0.0506329
NODE_17549_length_688_cov_37.563667	567	646	14	8	79	0.1012658
NODE_17549_length_688_cov_37.563667	567	646	18	16	79	0.2025317
NODE_17549_length_688_cov_37.563667	567	646	20	7	79	0.0886076
NODE_17549_length_688_cov_37.563667	567	646	22	5	79	0.0632911
NODE_17549_length_688_cov_37.563667	567	646	24	4	79	0.0506329
NODE_17549_length_688_cov_37.563667	567	646	26	35	79	0.4430380
NODE_17550_length_688_cov_33.898132	373	453	11	4	80	0.0500000
NODE_17550_length_688_cov_33.898132	373	453	12	76	80	0.9500000
NODE_17550_length_688_cov_33.898132	426	506	0	52	80	0.6500000
NODE_17550_length_688_cov_33.898132	426	506	11	1	80	0.0125000
NODE_17550_length_688_cov_33.898132	426	506	12	27	80	0.3375000
NODE_17551_length_688_cov_26.769100	457	537	6	63	80	0.7875000
NODE_17551_length_688_cov_26.769100	457	537	8	17	80	0.2125000
NODE_17551_length_688_cov_26.769100	510	590	0	18	80	0.2250000
NODE_17551_length_688_cov_26.769100	510	590	2	28	80	0.3500000
NODE_17551_length_688_cov_26.769100	510	590	6	34	80	0.4250000
NODE_17552_length_688_cov_22.517827	332	412	0	48	80	0.6000000
NODE_17552_length_688_cov_22.517827	332	412	1	16	80	0.2000000
NODE_17552_length_688_cov_22.517827	332	412	2	16	80	0.2000000
NODE_17552_length_688_cov_22.517827	385	465	0	11	80	0.1375000
NODE_17552_length_688_cov_22.517827	385	465	2	44	80	0.5500000
NODE_17552_length_688_cov_22.517827	385	465	3	25	80	0.3125000
NODE_17553_length_688_cov_16.796265	225	305	0	15	80	0.1875000
NODE_17553_length_688_cov_16.796265	225	305	2	14	80	0.1750000
NODE_17553_length_688_cov_16.796265	225	305	4	51	80	0.6375000
NODE_17553_length_688_cov_16.796265	278	358	0	68	80	0.8500000
NODE_17553_length_688_cov_16.796265	278	358	2	12	80	0.1500000
NODE_17555_length_688_cov_13.758913	378	458	0	8	80	0.1000000
NODE_17555_length_688_cov_13.758913	378	458	2	72	80	0.9000000
NODE_17555_length_688_cov_13.758913	431	511	0	20	80	0.2500000
NODE_17555_length_688_cov_13.758913	431	511	2	60	80	0.7500000
NODE_17556_length_688_cov_12.511036	330	410	0	80	80	1.0000000
NODE_17556_length_688_cov_12.511036	383	463	0	51	80	0.6375000
NODE_17556_length_688_cov_12.511036	383	463	2	29	80	0.3625000
NODE_17561_length_688_cov_5.446520	366	414	0	24	48	0.5000000
NODE_17561_length_688_cov_5.446520	366	414	2	3	48	0.0625000
NODE_17561_length_688_cov_5.446520	366	414	4	21	48	0.4375000
NODE_17567_length_688_cov_3.692699	265	345	2	8	80	0.1000000
NODE_17567_length_688_cov_3.692699	265	345	3	1	80	0.0125000
NODE_17567_length_688_cov_3.692699	265	345	4	50	80	0.6250000
NODE_17567_length_688_cov_3.692699	265	345	7	1	80	0.0125000
NODE_17567_length_688_cov_3.692699	265	345	8	20	80	0.2500000
NODE_17567_length_688_cov_3.692699	322	380	4	2	58	0.0344828
NODE_17567_length_688_cov_3.692699	322	380	7	36	58	0.6206896
NODE_17567_length_688_cov_3.692699	322	380	8	20	58	0.3448276
NODE_17621_length_687_cov_50.214286	430	510	0	80	80	1.0000000
NODE_17621_length_687_cov_50.214286	483	563	0	80	80	1.0000000
NODE_17622_length_687_cov_32.564626	204	284	2	80	80	1.0000000
NODE_17622_length_687_cov_32.564626	257	337	1	1	80	0.0125000
NODE_17622_length_687_cov_32.564626	257	337	2	79	80	0.9875000
NODE_17623_length_687_cov_22.365646	231	311	0	80	80	1.0000000
NODE_17623_length_687_cov_22.365646	284	364	0	43	80	0.5375000
NODE_17623_length_687_cov_22.365646	284	364	3	2	80	0.0250000
NODE_17623_length_687_cov_22.365646	284	364	4	35	80	0.4375000
NODE_17626_length_687_cov_11.943878	233	313	0	80	80	1.0000000
NODE_17626_length_687_cov_11.943878	286	366	0	80	80	1.0000000
NODE_17627_length_687_cov_7.865646	311	391	2	35	80	0.4375000
NODE_17627_length_687_cov_7.865646	311	391	6	45	80	0.5625000
NODE_17627_length_687_cov_7.865646	364	444	0	10	80	0.1250000
NODE_17627_length_687_cov_7.865646	364	444	4	43	80	0.5375000
NODE_17627_length_687_cov_7.865646	364	444	6	27	80	0.3375000
NODE_17628_length_687_cov_7.353741	286	366	0	80	80	1.0000000
NODE_17628_length_687_cov_7.353741	339	419	0	62	80	0.7750000
NODE_17628_length_687_cov_7.353741	339	419	2	18	80	0.2250000
NODE_17631_length_687_cov_5.903061	369	449	0	80	80	1.0000000
NODE_17631_length_687_cov_5.903061	422	502	0	80	80	1.0000000
NODE_17695_length_686_cov_34.642249	355	440	0	85	85	1.0000000
NODE_17695_length_686_cov_34.642249	413	493	0	80	80	1.0000000
NODE_17697_length_686_cov_26.357751	413	493	0	80	80	1.0000000
NODE_17697_length_686_cov_26.357751	466	546	0	80	80	1.0000000
NODE_17698_length_686_cov_16.715503	400	480	0	80	80	1.0000000
NODE_17698_length_686_cov_16.715503	453	533	0	80	80	1.0000000
NODE_17757_length_685_cov_8.769625	178	258	0	30	80	0.3750000
NODE_17757_length_685_cov_8.769625	178	258	4	50	80	0.6250000
NODE_17757_length_685_cov_8.769625	222	250	0	22	28	0.7857143
NODE_17757_length_685_cov_8.769625	222	250	4	6	28	0.2142857
NODE_17757_length_685_cov_8.769625	231	311	0	80	80	1.0000000
NODE_17764_length_685_cov_4.447099	249	329	2	80	80	1.0000000
NODE_17764_length_685_cov_4.447099	302	382	0	27	80	0.3375000
NODE_17764_length_685_cov_4.447099	302	382	2	53	80	0.6625000
NODE_17768_length_685_cov_3.556314	338	418	0	80	80	1.0000000
NODE_17768_length_685_cov_3.556314	391	471	0	80	80	1.0000000
NODE_17821_length_684_cov_7.521368	189	269	1	80	80	1.0000000
NODE_17821_length_684_cov_7.521368	242	322	1	66	80	0.8250000
NODE_17821_length_684_cov_7.521368	242	322	2	14	80	0.1750000
NODE_17832_length_684_cov_3.639316	306	386	2	80	80	1.0000000
NODE_17832_length_684_cov_3.639316	359	439	0	24	80	0.3000000
NODE_17832_length_684_cov_3.639316	359	439	2	56	80	0.7000000
NODE_17866_length_683_cov_27.493151	346	426	0	2	80	0.0250000
NODE_17866_length_683_cov_27.493151	346	426	4	78	80	0.9750000
NODE_17866_length_683_cov_27.493151	399	479	0	55	80	0.6875000
NODE_17866_length_683_cov_27.493151	399	479	4	25	80	0.3125000
NODE_17867_length_683_cov_12.880137	242	321	0	21	79	0.2658228
NODE_17867_length_683_cov_12.880137	242	321	2	14	79	0.1772152
NODE_17867_length_683_cov_12.880137	242	321	4	16	79	0.2025317
NODE_17867_length_683_cov_12.880137	242	321	6	28	79	0.3544304
NODE_17868_length_683_cov_11.772260	218	274	0	56	56	1.0000000
NODE_17868_length_683_cov_11.772260	247	333	0	86	86	1.0000000
NODE_17869_length_683_cov_9.936644	435	515	0	21	80	0.2625000
NODE_17869_length_683_cov_9.936644	435	515	2	59	80	0.7375000
NODE_17869_length_683_cov_9.936644	488	568	0	29	80	0.3625000
NODE_17869_length_683_cov_9.936644	488	568	2	51	80	0.6375000
NODE_17871_length_683_cov_9.017123	296	364	0	68	68	1.0000000
NODE_17871_length_683_cov_9.017123	337	417	0	80	80	1.0000000
NODE_17873_length_683_cov_6.797945	359	415	4	28	56	0.5000000
NODE_17873_length_683_cov_6.797945	359	415	6	23	56	0.4107143
NODE_17873_length_683_cov_6.797945	359	415	8	5	56	0.0892857
NODE_17884_length_683_cov_3.176370	113	186	0	73	73	1.0000000
NODE_17947_length_682_cov_33.516295	423	503	0	80	80	1.0000000
NODE_17947_length_682_cov_33.516295	476	556	0	80	80	1.0000000
NODE_17948_length_682_cov_27.022298	479	559	2	10	80	0.1250000
NODE_17948_length_682_cov_27.022298	479	559	4	3	80	0.0375000
NODE_17948_length_682_cov_27.022298	479	559	16	1	80	0.0125000
NODE_17948_length_682_cov_27.022298	479	559	22	6	80	0.0750000
NODE_17948_length_682_cov_27.022298	479	559	24	35	80	0.4375000
NODE_17948_length_682_cov_27.022298	479	559	30	1	80	0.0125000
NODE_17948_length_682_cov_27.022298	479	559	34	3	80	0.0375000
NODE_17948_length_682_cov_27.022298	479	559	38	4	80	0.0500000
NODE_17948_length_682_cov_27.022298	479	559	42	1	80	0.0125000
NODE_17948_length_682_cov_27.022298	479	559	56	1	80	0.0125000
NODE_17948_length_682_cov_27.022298	479	559	58	4	80	0.0500000
NODE_17948_length_682_cov_27.022298	479	559	60	1	80	0.0125000
NODE_17948_length_682_cov_27.022298	479	559	64	10	80	0.1250000
NODE_17948_length_682_cov_27.022298	532	612	24	2	80	0.0250000
NODE_17948_length_682_cov_27.022298	532	612	30	1	80	0.0125000
NODE_17948_length_682_cov_27.022298	532	612	34	3	80	0.0375000
NODE_17948_length_682_cov_27.022298	532	612	38	4	80	0.0500000
NODE_17948_length_682_cov_27.022298	532	612	42	1	80	0.0125000
NODE_17948_length_682_cov_27.022298	532	612	56	1	80	0.0125000
NODE_17948_length_682_cov_27.022298	532	612	58	4	80	0.0500000
NODE_17948_length_682_cov_27.022298	532	612	60	8	80	0.1000000
NODE_17948_length_682_cov_27.022298	532	612	64	10	80	0.1250000
NODE_17948_length_682_cov_27.022298	532	612	66	14	80	0.1750000
NODE_17948_length_682_cov_27.022298	532	612	68	15	80	0.1875000
NODE_17948_length_682_cov_27.022298	532	612	70	5	80	0.0625000
NODE_17948_length_682_cov_27.022298	532	612	72	5	80	0.0625000
NODE_17948_length_682_cov_27.022298	532	612	74	5	80	0.0625000
NODE_17948_length_682_cov_27.022298	532	612	75	1	80	0.0125000
NODE_17948_length_682_cov_27.022298	532	612	76	1	80	0.0125000
NODE_17949_length_682_cov_19.612350	434	514	0	80	80	1.0000000
NODE_17949_length_682_cov_19.612350	487	567	0	80	80	1.0000000
NODE_17950_length_682_cov_16.620926	261	341	0	72	80	0.9000000
NODE_17950_length_682_cov_16.620926	261	341	1	8	80	0.1000000
NODE_17950_length_682_cov_16.620926	314	394	0	19	80	0.2375000
NODE_17950_length_682_cov_16.620926	314	394	1	33	80	0.4125000
NODE_17950_length_682_cov_16.620926	314	394	2	28	80	0.3500000
NODE_17951_length_682_cov_13.735849	251	331	0	80	80	1.0000000
NODE_17951_length_682_cov_13.735849	304	384	0	80	80	1.0000000
NODE_17952_length_682_cov_12.835334	228	308	0	80	80	1.0000000
NODE_17952_length_682_cov_12.835334	281	361	0	36	80	0.4500000
NODE_17952_length_682_cov_12.835334	281	361	2	44	80	0.5500000
NODE_17956_length_682_cov_7.504288	224	304	0	80	80	1.0000000
NODE_17956_length_682_cov_7.504288	277	357	0	80	80	1.0000000
NODE_17960_length_682_cov_5.102916	314	351	0	37	37	1.0000000
NODE_17963_length_682_cov_4.579760	152	232	0	80	80	1.0000000
NODE_17963_length_682_cov_4.579760	205	285	0	80	80	1.0000000
NODE_17967_length_682_cov_4.006861	317	397	0	80	80	1.0000000
NODE_17967_length_682_cov_4.006861	370	450	0	80	80	1.0000000
NODE_17968_length_682_cov_3.859348	160	240	4	80	80	1.0000000
NODE_17968_length_682_cov_3.859348	213	293	0	23	80	0.2875000
NODE_17968_length_682_cov_3.859348	213	293	2	3	80	0.0375000
NODE_17968_length_682_cov_3.859348	213	293	4	54	80	0.6750000
NODE_18010_length_681_cov_51.810997	181	261	0	71	80	0.8875000
NODE_18010_length_681_cov_51.810997	181	261	2	9	80	0.1125000
NODE_18010_length_681_cov_51.810997	234	316	0	18	82	0.2195122
NODE_18010_length_681_cov_51.810997	234	316	2	64	82	0.7804878
NODE_18011_length_681_cov_32.128866	347	427	1	4	80	0.0500000
NODE_18011_length_681_cov_32.128866	347	427	2	76	80	0.9500000
NODE_18011_length_681_cov_32.128866	400	475	0	32	75	0.4266667
NODE_18011_length_681_cov_32.128866	400	475	1	20	75	0.2666667
NODE_18011_length_681_cov_32.128866	400	475	2	23	75	0.3066667
NODE_18012_length_681_cov_19.079038	282	362	0	79	80	0.9875000
NODE_18012_length_681_cov_19.079038	282	362	2	1	80	0.0125000
NODE_18012_length_681_cov_19.079038	335	415	0	26	80	0.3250000
NODE_18012_length_681_cov_19.079038	335	415	2	54	80	0.6750000
NODE_18013_length_681_cov_17.053265	294	374	2	35	80	0.4375000
NODE_18013_length_681_cov_17.053265	294	374	4	45	80	0.5625000
NODE_18013_length_681_cov_17.053265	347	427	2	51	80	0.6375000
NODE_18013_length_681_cov_17.053265	347	427	4	29	80	0.3625000
NODE_18014_length_681_cov_11.183849	306	386	0	3	80	0.0375000
NODE_18014_length_681_cov_11.183849	306	386	2	77	80	0.9625000
NODE_18014_length_681_cov_11.183849	359	439	0	56	80	0.7000000
NODE_18014_length_681_cov_11.183849	359	439	2	24	80	0.3000000
NODE_18015_length_681_cov_8.065292	236	316	0	80	80	1.0000000
NODE_18015_length_681_cov_8.065292	289	369	0	80	80	1.0000000
NODE_18017_length_681_cov_6.888316	344	424	0	44	80	0.5500000
NODE_18017_length_681_cov_6.888316	344	424	2	36	80	0.4500000
NODE_18017_length_681_cov_6.888316	397	477	0	26	80	0.3250000
NODE_18017_length_681_cov_6.888316	397	477	2	54	80	0.6750000
NODE_18080_length_680_cov_35.695353	348	428	4	80	80	1.0000000
NODE_18080_length_680_cov_35.695353	401	481	0	5	80	0.0625000
NODE_18080_length_680_cov_35.695353	401	481	3	1	80	0.0125000
NODE_18080_length_680_cov_35.695353	401	481	4	74	80	0.9250000
NODE_18081_length_680_cov_17.500861	296	376	0	80	80	1.0000000
NODE_18081_length_680_cov_17.500861	349	429	0	80	80	1.0000000
NODE_18082_length_680_cov_16.685026	260	340	0	59	80	0.7375000
NODE_18082_length_680_cov_16.685026	260	340	2	21	80	0.2625000
NODE_18082_length_680_cov_16.685026	313	393	0	80	80	1.0000000
NODE_18083_length_680_cov_15.345955	332	412	0	80	80	1.0000000
NODE_18083_length_680_cov_15.345955	385	465	0	80	80	1.0000000
NODE_18089_length_680_cov_3.858864	458	538	0	14	80	0.1750000
NODE_18089_length_680_cov_3.858864	458	538	4	66	80	0.8250000
NODE_18107_length_680_cov_1.879518	236	256	0	20	20	1.0000000
NODE_18146_length_679_cov_52.046552	367	447	0	3	80	0.0375000
NODE_18146_length_679_cov_52.046552	367	447	2	77	80	0.9625000
NODE_18146_length_679_cov_52.046552	420	500	0	56	80	0.7000000
NODE_18146_length_679_cov_52.046552	420	500	2	24	80	0.3000000
NODE_18147_length_679_cov_40.353448	179	259	0	80	80	1.0000000
NODE_18147_length_679_cov_40.353448	232	312	0	80	80	1.0000000
NODE_18148_length_679_cov_38.144828	364	428	2	10	64	0.1562500
NODE_18148_length_679_cov_38.144828	364	428	4	31	64	0.4843750
NODE_18148_length_679_cov_38.144828	364	428	6	23	64	0.3593750
NODE_18148_length_679_cov_38.144828	401	481	1	16	80	0.2000000
NODE_18148_length_679_cov_38.144828	401	481	2	47	80	0.5875000
NODE_18148_length_679_cov_38.144828	401	481	4	17	80	0.2125000
NODE_18149_length_679_cov_17.134483	277	357	0	80	80	1.0000000
NODE_18149_length_679_cov_17.134483	330	410	0	80	80	1.0000000
NODE_18150_length_679_cov_15.046552	310	375	0	65	65	1.0000000
NODE_18151_length_679_cov_12.586207	247	327	0	80	80	1.0000000
NODE_18151_length_679_cov_12.586207	303	381	0	78	78	1.0000000
NODE_18152_length_679_cov_12.282759	337	417	0	15	80	0.1875000
NODE_18152_length_679_cov_12.282759	337	417	3	2	80	0.0250000
NODE_18152_length_679_cov_12.282759	337	417	5	3	80	0.0375000
NODE_18152_length_679_cov_12.282759	337	417	6	15	80	0.1875000
NODE_18152_length_679_cov_12.282759	337	417	8	22	80	0.2750000
NODE_18152_length_679_cov_12.282759	337	417	10	23	80	0.2875000
NODE_18152_length_679_cov_12.282759	390	470	8	14	80	0.1750000
NODE_18152_length_679_cov_12.282759	390	470	10	66	80	0.8250000
NODE_18153_length_679_cov_11.532759	205	285	2	80	80	1.0000000
NODE_18153_length_679_cov_11.532759	258	338	0	16	80	0.2000000
NODE_18153_length_679_cov_11.532759	258	338	1	4	80	0.0500000
NODE_18153_length_679_cov_11.532759	258	338	2	60	80	0.7500000
NODE_18155_length_679_cov_8.043103	269	341	0	72	72	1.0000000
NODE_18155_length_679_cov_8.043103	314	394	0	80	80	1.0000000
NODE_18156_length_679_cov_7.267241	191	271	0	80	80	1.0000000
NODE_18156_length_679_cov_7.267241	244	324	0	80	80	1.0000000
NODE_18162_length_679_cov_5.391379	279	331	14	15	52	0.2884615
NODE_18162_length_679_cov_5.391379	279	331	16	5	52	0.0961538
NODE_18162_length_679_cov_5.391379	279	331	18	32	52	0.6153846
NODE_18164_length_679_cov_3.813793	10	69	0	1	59	0.0169492
NODE_18164_length_679_cov_3.813793	10	69	6	54	59	0.9152542
NODE_18164_length_679_cov_3.813793	10	69	8	4	59	0.0677966
NODE_18164_length_679_cov_3.813793	48	122	4	1	74	0.0135135
NODE_18164_length_679_cov_3.813793	48	122	6	17	74	0.2297297
NODE_18164_length_679_cov_3.813793	48	122	8	50	74	0.6756757
NODE_18164_length_679_cov_3.813793	48	122	10	6	74	0.0810811
NODE_18217_length_678_cov_38.910190	252	332	0	80	80	1.0000000
NODE_18217_length_678_cov_38.910190	305	385	0	80	80	1.0000000
NODE_18217_length_678_cov_38.910190	381	461	0	80	80	1.0000000
NODE_18217_length_678_cov_38.910190	434	514	0	80	80	1.0000000
NODE_18218_length_678_cov_20.663212	243	323	0	80	80	1.0000000
NODE_18218_length_678_cov_20.663212	296	376	0	80	80	1.0000000
NODE_18219_length_678_cov_12.081174	243	323	0	80	80	1.0000000
NODE_18219_length_678_cov_12.081174	296	376	0	69	80	0.8625000
NODE_18219_length_678_cov_12.081174	296	376	2	11	80	0.1375000
NODE_18224_length_678_cov_6.559585	195	264	0	69	69	1.0000000
NODE_18224_length_678_cov_6.559585	237	317	0	80	80	1.0000000
NODE_18228_length_678_cov_4.462867	133	213	0	80	80	1.0000000
NODE_18228_length_678_cov_4.462867	186	266	0	80	80	1.0000000
NODE_18239_length_678_cov_2.716753	351	431	0	80	80	1.0000000
NODE_18239_length_678_cov_2.716753	404	484	0	80	80	1.0000000
NODE_18289_length_677_cov_22.235294	274	354	0	15	80	0.1875000
NODE_18289_length_677_cov_22.235294	274	354	2	65	80	0.8125000
NODE_18289_length_677_cov_22.235294	327	407	0	61	80	0.7625000
NODE_18289_length_677_cov_22.235294	327	407	2	19	80	0.2375000
NODE_18290_length_677_cov_16.410035	124	206	0	82	82	1.0000000
NODE_18290_length_677_cov_16.410035	177	261	0	84	84	1.0000000
NODE_18291_length_677_cov_11.031142	393	473	0	80	80	1.0000000
NODE_18291_length_677_cov_11.031142	446	526	0	80	80	1.0000000
NODE_18292_length_677_cov_10.129758	258	338	2	22	80	0.2750000
NODE_18292_length_677_cov_10.129758	258	338	3	10	80	0.1250000
NODE_18292_length_677_cov_10.129758	258	338	4	48	80	0.6000000
NODE_18292_length_677_cov_10.129758	311	391	0	22	80	0.2750000
NODE_18292_length_677_cov_10.129758	311	391	2	53	80	0.6625000
NODE_18292_length_677_cov_10.129758	311	391	3	5	80	0.0625000
NODE_18295_length_677_cov_6.660900	217	297	50	5	80	0.0625000
NODE_18295_length_677_cov_6.660900	217	297	58	7	80	0.0875000
NODE_18295_length_677_cov_6.660900	217	297	60	5	80	0.0625000
NODE_18295_length_677_cov_6.660900	217	297	62	7	80	0.0875000
NODE_18295_length_677_cov_6.660900	217	297	67	1	80	0.0125000
NODE_18295_length_677_cov_6.660900	217	297	68	2	80	0.0250000
NODE_18295_length_677_cov_6.660900	217	297	70	53	80	0.6625000
NODE_18297_length_677_cov_5.228374	366	446	0	80	80	1.0000000
NODE_18312_length_677_cov_2.306228	230	278	4	3	48	0.0625000
NODE_18312_length_677_cov_2.306228	230	278	7	1	48	0.0208333
NODE_18312_length_677_cov_2.306228	230	278	8	44	48	0.9166667
NODE_18329_length_677_cov_1.709343	369	449	0	47	80	0.5875000
NODE_18329_length_677_cov_1.709343	369	449	2	33	80	0.4125000
NODE_18329_length_677_cov_1.709343	422	502	0	20	80	0.2500000
NODE_18329_length_677_cov_1.709343	422	502	2	60	80	0.7500000
NODE_18368_length_676_cov_66.473137	286	366	0	80	80	1.0000000
NODE_18368_length_676_cov_66.473137	339	419	0	43	80	0.5375000
NODE_18368_length_676_cov_66.473137	339	419	4	1	80	0.0125000
NODE_18368_length_676_cov_66.473137	339	419	14	1	80	0.0125000
NODE_18368_length_676_cov_66.473137	339	419	18	1	80	0.0125000
NODE_18368_length_676_cov_66.473137	339	419	32	1	80	0.0125000
NODE_18368_length_676_cov_66.473137	339	419	35	1	80	0.0125000
NODE_18368_length_676_cov_66.473137	339	419	41	1	80	0.0125000
NODE_18368_length_676_cov_66.473137	339	419	43	1	80	0.0125000
NODE_18368_length_676_cov_66.473137	339	419	44	2	80	0.0250000
NODE_18368_length_676_cov_66.473137	339	419	45	1	80	0.0125000
NODE_18368_length_676_cov_66.473137	339	419	53	1	80	0.0125000
NODE_18368_length_676_cov_66.473137	339	419	54	3	80	0.0375000
NODE_18368_length_676_cov_66.473137	339	419	56	1	80	0.0125000
NODE_18368_length_676_cov_66.473137	339	419	58	1	80	0.0125000
NODE_18368_length_676_cov_66.473137	339	419	62	5	80	0.0625000
NODE_18368_length_676_cov_66.473137	339	419	63	12	80	0.1500000
NODE_18368_length_676_cov_66.473137	339	419	65	1	80	0.0125000
NODE_18368_length_676_cov_66.473137	339	419	66	2	80	0.0250000
NODE_18368_length_676_cov_66.473137	339	419	67	1	80	0.0125000
NODE_18368_length_676_cov_66.473137	383	419	14	1	36	0.0277778
NODE_18368_length_676_cov_66.473137	383	419	18	1	36	0.0277778
NODE_18368_length_676_cov_66.473137	383	419	32	1	36	0.0277778
NODE_18368_length_676_cov_66.473137	383	419	35	1	36	0.0277778
NODE_18368_length_676_cov_66.473137	383	419	41	1	36	0.0277778
NODE_18368_length_676_cov_66.473137	383	419	43	1	36	0.0277778
NODE_18368_length_676_cov_66.473137	383	419	44	2	36	0.0555556
NODE_18368_length_676_cov_66.473137	383	419	45	1	36	0.0277778
NODE_18368_length_676_cov_66.473137	383	419	53	1	36	0.0277778
NODE_18368_length_676_cov_66.473137	383	419	54	3	36	0.0833333
NODE_18368_length_676_cov_66.473137	383	419	56	1	36	0.0277778
NODE_18368_length_676_cov_66.473137	383	419	58	1	36	0.0277778
NODE_18368_length_676_cov_66.473137	383	419	62	5	36	0.1388889
NODE_18368_length_676_cov_66.473137	383	419	63	12	36	0.3333333
NODE_18368_length_676_cov_66.473137	383	419	65	1	36	0.0277778
NODE_18368_length_676_cov_66.473137	383	419	66	2	36	0.0555556
NODE_18368_length_676_cov_66.473137	383	419	67	1	36	0.0277778
NODE_18368_length_676_cov_66.473137	383	419	14	1	36	0.0277778
NODE_18368_length_676_cov_66.473137	383	419	18	1	36	0.0277778
NODE_18368_length_676_cov_66.473137	383	419	32	1	36	0.0277778
NODE_18368_length_676_cov_66.473137	383	419	35	1	36	0.0277778
NODE_18368_length_676_cov_66.473137	383	419	41	1	36	0.0277778
NODE_18368_length_676_cov_66.473137	383	419	43	1	36	0.0277778
NODE_18368_length_676_cov_66.473137	383	419	44	2	36	0.0555556
NODE_18368_length_676_cov_66.473137	383	419	45	1	36	0.0277778
NODE_18368_length_676_cov_66.473137	383	419	53	1	36	0.0277778
NODE_18368_length_676_cov_66.473137	383	419	54	3	36	0.0833333
NODE_18368_length_676_cov_66.473137	383	419	56	1	36	0.0277778
NODE_18368_length_676_cov_66.473137	383	419	58	1	36	0.0277778
NODE_18368_length_676_cov_66.473137	383	419	62	5	36	0.1388889
NODE_18368_length_676_cov_66.473137	383	419	63	12	36	0.3333333
NODE_18368_length_676_cov_66.473137	383	419	65	1	36	0.0277778
NODE_18368_length_676_cov_66.473137	383	419	66	2	36	0.0555556
NODE_18368_length_676_cov_66.473137	383	419	67	1	36	0.0277778
NODE_18368_length_676_cov_66.473137	398	419	62	5	21	0.2380952
NODE_18368_length_676_cov_66.473137	398	419	63	12	21	0.5714286
NODE_18368_length_676_cov_66.473137	398	419	65	1	21	0.0476190
NODE_18368_length_676_cov_66.473137	398	419	66	2	21	0.0952381
NODE_18368_length_676_cov_66.473137	398	419	67	1	21	0.0476190
NODE_18369_length_676_cov_14.429809	259	330	2	40	71	0.5633803
NODE_18369_length_676_cov_14.429809	259	330	8	31	71	0.4366197
NODE_18370_length_676_cov_13.882149	292	372	0	12	80	0.1500000
NODE_18370_length_676_cov_13.882149	292	372	2	68	80	0.8500000
NODE_18370_length_676_cov_13.882149	345	425	0	11	80	0.1375000
NODE_18370_length_676_cov_13.882149	345	425	2	69	80	0.8625000
NODE_18374_length_676_cov_7.225303	363	443	0	80	80	1.0000000
NODE_18374_length_676_cov_7.225303	416	496	0	80	80	1.0000000
NODE_18375_length_676_cov_6.740035	373	433	0	60	60	1.0000000
NODE_18375_length_676_cov_6.740035	406	486	0	80	80	1.0000000
NODE_18378_length_676_cov_4.658579	167	240	0	73	73	1.0000000
NODE_18397_length_676_cov_2.292894	146	226	4	12	80	0.1500000
NODE_18397_length_676_cov_2.292894	146	226	6	48	80	0.6000000
NODE_18397_length_676_cov_2.292894	146	226	8	20	80	0.2500000
NODE_18401_length_676_cov_2.157712	175	226	0	51	51	1.0000000
NODE_18417_length_676_cov_1.547660	133	164	2	31	31	1.0000000
NODE_18447_length_675_cov_27.574653	190	270	2	6	80	0.0750000
NODE_18447_length_675_cov_27.574653	190	270	4	28	80	0.3500000
NODE_18447_length_675_cov_27.574653	190	270	6	19	80	0.2375000
NODE_18447_length_675_cov_27.574653	190	270	8	27	80	0.3375000
NODE_18447_length_675_cov_27.574653	243	323	0	32	80	0.4000000
NODE_18447_length_675_cov_27.574653	243	323	6	40	80	0.5000000
NODE_18447_length_675_cov_27.574653	243	323	8	8	80	0.1000000
NODE_18448_length_675_cov_11.895833	336	416	0	1	80	0.0125000
NODE_18448_length_675_cov_11.895833	336	416	2	79	80	0.9875000
NODE_18448_length_675_cov_11.895833	389	469	0	54	80	0.6750000
NODE_18448_length_675_cov_11.895833	389	469	2	26	80	0.3250000
NODE_18449_length_675_cov_8.157986	414	494	0	80	80	1.0000000
NODE_18449_length_675_cov_8.157986	467	547	0	80	80	1.0000000
NODE_18450_length_675_cov_8.026042	320	400	2	2	80	0.0250000
NODE_18450_length_675_cov_8.026042	320	400	4	32	80	0.4000000
NODE_18450_length_675_cov_8.026042	320	400	6	46	80	0.5750000
NODE_18450_length_675_cov_8.026042	373	453	2	20	80	0.2500000
NODE_18450_length_675_cov_8.026042	373	453	4	16	80	0.2000000
NODE_18450_length_675_cov_8.026042	373	453	6	44	80	0.5500000
NODE_18451_length_675_cov_7.277778	317	397	0	80	80	1.0000000
NODE_18455_length_675_cov_5.666667	142	222	0	65	80	0.8125000
NODE_18455_length_675_cov_5.666667	142	222	2	15	80	0.1875000
NODE_18455_length_675_cov_5.666667	195	275	0	80	80	1.0000000
NODE_18464_length_675_cov_2.751736	67	122	0	25	55	0.4545455
NODE_18464_length_675_cov_2.751736	67	122	2	30	55	0.5454546
NODE_18467_length_675_cov_2.623264	251	289	0	38	38	1.0000000
NODE_18467_length_675_cov_2.623264	279	343	0	64	64	1.0000000
NODE_18467_length_675_cov_2.623264	432	494	0	62	62	1.0000000
NODE_18515_length_674_cov_38.401739	225	305	2	80	80	1.0000000
NODE_18515_length_674_cov_38.401739	278	358	0	18	80	0.2250000
NODE_18515_length_674_cov_38.401739	278	358	1	26	80	0.3250000
NODE_18515_length_674_cov_38.401739	278	358	2	36	80	0.4500000
NODE_18516_length_674_cov_30.215652	519	599	10	1	80	0.0125000
NODE_18516_length_674_cov_30.215652	519	599	12	5	80	0.0625000
NODE_18516_length_674_cov_30.215652	519	599	14	7	80	0.0875000
NODE_18516_length_674_cov_30.215652	519	599	18	14	80	0.1750000
NODE_18516_length_674_cov_30.215652	519	599	20	53	80	0.6625000
NODE_18516_length_674_cov_30.215652	572	602	18	16	30	0.5333334
NODE_18516_length_674_cov_30.215652	572	602	20	14	30	0.4666667
NODE_18517_length_674_cov_19.636522	283	363	0	80	80	1.0000000
NODE_18517_length_674_cov_19.636522	336	416	0	80	80	1.0000000
NODE_18518_length_674_cov_19.436522	81	161	0	80	80	1.0000000
NODE_18518_length_674_cov_19.436522	134	214	0	80	80	1.0000000
NODE_18519_length_674_cov_16.819130	185	265	0	80	80	1.0000000
NODE_18519_length_674_cov_16.819130	238	318	0	80	80	1.0000000
NODE_18520_length_674_cov_14.733913	169	249	0	35	80	0.4375000
NODE_18520_length_674_cov_14.733913	169	249	8	24	80	0.3000000
NODE_18520_length_674_cov_14.733913	169	249	10	21	80	0.2625000
NODE_18520_length_674_cov_14.733913	222	302	8	6	80	0.0750000
NODE_18520_length_674_cov_14.733913	222	302	9	16	80	0.2000000
NODE_18520_length_674_cov_14.733913	222	302	10	58	80	0.7250000
NODE_18524_length_674_cov_7.086957	357	437	0	80	80	1.0000000
NODE_18524_length_674_cov_7.086957	410	490	0	80	80	1.0000000
NODE_18528_length_674_cov_4.808696	262	342	2	5	80	0.0625000
NODE_18528_length_674_cov_4.808696	262	342	4	23	80	0.2875000
NODE_18528_length_674_cov_4.808696	262	342	6	16	80	0.2000000
NODE_18528_length_674_cov_4.808696	262	342	8	36	80	0.4500000
NODE_18528_length_674_cov_4.808696	315	395	0	14	80	0.1750000
NODE_18528_length_674_cov_4.808696	315	395	2	5	80	0.0625000
NODE_18528_length_674_cov_4.808696	315	395	6	50	80	0.6250000
NODE_18528_length_674_cov_4.808696	315	395	8	11	80	0.1375000
NODE_18592_length_673_cov_47.109756	405	485	0	80	80	1.0000000
NODE_18592_length_673_cov_47.109756	458	538	0	80	80	1.0000000
NODE_18593_length_673_cov_20.548780	214	294	0	80	80	1.0000000
NODE_18593_length_673_cov_20.548780	267	347	0	80	80	1.0000000
NODE_18596_length_673_cov_8.306620	337	426	0	22	89	0.2471910
NODE_18596_length_673_cov_8.306620	337	426	2	42	89	0.4719101
NODE_18596_length_673_cov_8.306620	337	426	4	25	89	0.2808989
NODE_18607_length_673_cov_3.041812	196	276	0	10	80	0.1250000
NODE_18607_length_673_cov_3.041812	196	276	2	70	80	0.8750000
NODE_18607_length_673_cov_3.041812	249	329	0	33	80	0.4125000
NODE_18607_length_673_cov_3.041812	249	329	2	47	80	0.5875000
NODE_18660_length_672_cov_15.380454	282	362	0	63	80	0.7875000
NODE_18660_length_672_cov_15.380454	282	362	2	17	80	0.2125000
NODE_18660_length_672_cov_15.380454	335	415	0	80	80	1.0000000
NODE_18661_length_672_cov_9.902269	328	408	1	80	80	1.0000000
NODE_18661_length_672_cov_9.902269	381	461	0	45	80	0.5625000
NODE_18661_length_672_cov_9.902269	381	461	1	35	80	0.4375000
NODE_18662_length_672_cov_9.462478	309	389	0	80	80	1.0000000
NODE_18662_length_672_cov_9.462478	362	442	0	80	80	1.0000000
NODE_18666_length_672_cov_6.516579	354	434	0	80	80	1.0000000
NODE_18666_length_672_cov_6.516579	407	487	0	43	80	0.5375000
NODE_18666_length_672_cov_6.516579	407	487	2	37	80	0.4625000
NODE_18668_length_672_cov_6.108202	135	215	0	80	80	1.0000000
NODE_18668_length_672_cov_6.108202	188	268	0	80	80	1.0000000
NODE_18670_length_672_cov_4.949389	115	152	0	37	37	1.0000000
NODE_18670_length_672_cov_4.949389	125	205	0	80	80	1.0000000
NODE_18670_length_672_cov_4.949389	278	326	2	48	48	1.0000000
NODE_18672_length_672_cov_4.753927	378	450	0	72	72	1.0000000
NODE_18704_length_672_cov_1.713787	340	401	6	1	61	0.0163934
NODE_18704_length_672_cov_1.713787	340	401	8	60	61	0.9836066
NODE_18742_length_671_cov_28.874126	306	387	0	9	81	0.1111111
NODE_18742_length_671_cov_28.874126	306	387	2	14	81	0.1728395
NODE_18742_length_671_cov_28.874126	306	387	6	58	81	0.7160494
NODE_18742_length_671_cov_28.874126	360	440	0	10	80	0.1250000
NODE_18742_length_671_cov_28.874126	360	440	4	20	80	0.2500000
NODE_18742_length_671_cov_28.874126	360	440	6	50	80	0.6250000
NODE_18744_length_671_cov_18.526224	294	333	0	39	39	1.0000000
NODE_18744_length_671_cov_18.526224	331	404	0	73	73	1.0000000
NODE_18744_length_671_cov_18.526224	331	351	0	20	20	1.0000000
NODE_18745_length_671_cov_16.094406	417	497	0	42	80	0.5250000
NODE_18745_length_671_cov_16.094406	417	497	2	38	80	0.4750000
NODE_18745_length_671_cov_16.094406	470	550	0	21	80	0.2625000
NODE_18745_length_671_cov_16.094406	470	550	2	59	80	0.7375000
NODE_18746_length_671_cov_11.756993	337	417	0	6	80	0.0750000
NODE_18746_length_671_cov_11.756993	337	417	2	50	80	0.6250000
NODE_18746_length_671_cov_11.756993	337	417	4	24	80	0.3000000
NODE_18746_length_671_cov_11.756993	390	470	0	3	80	0.0375000
NODE_18746_length_671_cov_11.756993	390	470	4	77	80	0.9625000
NODE_18747_length_671_cov_9.237762	305	382	0	77	77	1.0000000
NODE_18748_length_671_cov_8.491259	298	379	0	81	81	1.0000000
NODE_18748_length_671_cov_8.491259	352	430	0	78	78	1.0000000
NODE_18749_length_671_cov_8.241259	97	128	4	31	31	1.0000000
NODE_18752_length_671_cov_7.201049	368	448	0	44	80	0.5500000
NODE_18752_length_671_cov_7.201049	368	448	1	36	80	0.4500000
NODE_18752_length_671_cov_7.201049	421	501	0	16	80	0.2000000
NODE_18752_length_671_cov_7.201049	421	501	1	64	80	0.8000000
NODE_18753_length_671_cov_5.680070	370	450	0	80	80	1.0000000
NODE_18753_length_671_cov_5.680070	423	503	0	80	80	1.0000000
NODE_18754_length_671_cov_4.769231	362	414	0	52	52	1.0000000
NODE_18760_length_671_cov_3.804196	360	440	0	36	80	0.4500000
NODE_18760_length_671_cov_3.804196	360	440	2	44	80	0.5500000
NODE_18812_length_670_cov_21.017513	443	523	0	80	80	1.0000000
NODE_18812_length_670_cov_21.017513	496	576	0	80	80	1.0000000
NODE_18813_length_670_cov_20.346760	372	452	0	80	80	1.0000000
NODE_18813_length_670_cov_20.346760	425	505	0	80	80	1.0000000
NODE_18814_length_670_cov_15.728546	157	237	0	80	80	1.0000000
NODE_18814_length_670_cov_15.728546	210	290	0	80	80	1.0000000
NODE_18814_length_670_cov_15.728546	286	366	0	80	80	1.0000000
NODE_18814_length_670_cov_15.728546	339	419	0	80	80	1.0000000
NODE_18818_length_670_cov_6.499124	390	470	2	77	80	0.9625000
NODE_18818_length_670_cov_6.499124	390	470	4	3	80	0.0375000
NODE_18834_length_670_cov_3.099825	159	217	0	58	58	1.0000000
NODE_18838_length_670_cov_2.700525	252	332	0	29	80	0.3625000
NODE_18838_length_670_cov_2.700525	252	332	2	51	80	0.6375000
NODE_18838_length_670_cov_2.700525	305	385	0	27	80	0.3375000
NODE_18838_length_670_cov_2.700525	305	385	2	53	80	0.6625000
NODE_18883_length_669_cov_13.307018	432	512	2	53	80	0.6625000
NODE_18883_length_669_cov_13.307018	432	512	3	1	80	0.0125000
NODE_18883_length_669_cov_13.307018	432	512	4	11	80	0.1375000
NODE_18883_length_669_cov_13.307018	432	512	5	8	80	0.1000000
NODE_18883_length_669_cov_13.307018	432	512	7	7	80	0.0875000
NODE_18883_length_669_cov_13.307018	485	565	3	1	80	0.0125000
NODE_18883_length_669_cov_13.307018	485	565	4	13	80	0.1625000
NODE_18883_length_669_cov_13.307018	485	565	5	46	80	0.5750000
NODE_18883_length_669_cov_13.307018	485	565	7	20	80	0.2500000
NODE_18886_length_669_cov_6.921053	245	325	2	80	80	1.0000000
NODE_18886_length_669_cov_6.921053	298	370	0	41	72	0.5694444
NODE_18886_length_669_cov_6.921053	298	370	2	31	72	0.4305556
NODE_18901_length_669_cov_3.633333	277	347	0	70	70	1.0000000
NODE_18909_length_669_cov_2.361404	434	490	0	56	56	1.0000000
NODE_18958_length_668_cov_23.131810	275	355	0	73	80	0.9125000
NODE_18958_length_668_cov_23.131810	275	355	2	7	80	0.0875000
NODE_18958_length_668_cov_23.131810	328	408	0	80	80	1.0000000
NODE_18959_length_668_cov_14.978910	324	404	4	14	80	0.1750000
NODE_18959_length_668_cov_14.978910	324	404	14	39	80	0.4875000
NODE_18959_length_668_cov_14.978910	324	404	16	27	80	0.3375000
NODE_18959_length_668_cov_14.978910	377	457	10	2	80	0.0250000
NODE_18959_length_668_cov_14.978910	377	457	12	48	80	0.6000000
NODE_18959_length_668_cov_14.978910	377	457	14	30	80	0.3750000
NODE_18962_length_668_cov_11.184534	187	267	13	44	80	0.5500000
NODE_18962_length_668_cov_11.184534	187	267	14	36	80	0.4500000
NODE_18962_length_668_cov_11.184534	240	320	0	18	80	0.2250000
NODE_18962_length_668_cov_11.184534	240	320	7	10	80	0.1250000
NODE_18962_length_668_cov_11.184534	240	320	13	1	80	0.0125000
NODE_18962_length_668_cov_11.184534	240	320	14	51	80	0.6375000
NODE_18963_length_668_cov_10.548330	211	291	0	80	80	1.0000000
NODE_18963_length_668_cov_10.548330	264	344	0	80	80	1.0000000
NODE_18964_length_668_cov_10.370826	226	308	0	48	82	0.5853658
NODE_18964_length_668_cov_10.370826	226	308	2	34	82	0.4146341
NODE_18964_length_668_cov_10.370826	279	361	2	82	82	1.0000000
NODE_18965_length_668_cov_10.223199	238	318	0	80	80	1.0000000
NODE_18965_length_668_cov_10.223199	291	371	0	35	80	0.4375000
NODE_18965_length_668_cov_10.223199	291	371	1	45	80	0.5625000
NODE_18967_length_668_cov_9.340949	310	390	0	80	80	1.0000000
NODE_18967_length_668_cov_9.340949	363	443	0	80	80	1.0000000
NODE_18975_length_668_cov_4.077329	304	384	2	67	80	0.8375000
NODE_18975_length_668_cov_4.077329	304	384	4	13	80	0.1625000
NODE_18975_length_668_cov_4.077329	338	367	2	29	29	1.0000000
NODE_18975_length_668_cov_4.077329	358	427	2	22	69	0.3188406
NODE_18975_length_668_cov_4.077329	358	427	4	47	69	0.6811594
NODE_19032_length_667_cov_33.848592	168	248	0	80	80	1.0000000
NODE_19032_length_667_cov_33.848592	221	301	0	80	80	1.0000000
NODE_19033_length_667_cov_21.218310	270	350	0	80	80	1.0000000
NODE_19033_length_667_cov_21.218310	323	403	0	42	80	0.5250000
NODE_19033_length_667_cov_21.218310	323	403	2	38	80	0.4750000
NODE_19034_length_667_cov_19.204225	258	338	4	28	80	0.3500000
NODE_19034_length_667_cov_19.204225	258	338	13	9	80	0.1125000
NODE_19034_length_667_cov_19.204225	258	338	18	18	80	0.2250000
NODE_19034_length_667_cov_19.204225	258	338	20	15	80	0.1875000
NODE_19034_length_667_cov_19.204225	258	338	22	10	80	0.1250000
NODE_19034_length_667_cov_19.204225	311	391	17	38	80	0.4750000
NODE_19034_length_667_cov_19.204225	311	391	18	33	80	0.4125000
NODE_19034_length_667_cov_19.204225	311	391	20	9	80	0.1125000
NODE_19036_length_667_cov_8.264085	299	379	0	80	80	1.0000000
NODE_19036_length_667_cov_8.264085	352	432	0	80	80	1.0000000
NODE_19037_length_667_cov_8.248239	76	156	0	80	80	1.0000000
NODE_19037_length_667_cov_8.248239	129	209	0	80	80	1.0000000
NODE_19038_length_667_cov_8.207746	257	323	0	66	66	1.0000000
NODE_19038_length_667_cov_8.207746	296	376	0	80	80	1.0000000
NODE_19039_length_667_cov_7.232394	357	437	0	25	80	0.3125000
NODE_19039_length_667_cov_7.232394	357	437	2	55	80	0.6875000
NODE_19039_length_667_cov_7.232394	410	490	0	21	80	0.2625000
NODE_19039_length_667_cov_7.232394	410	490	2	59	80	0.7375000
NODE_19042_length_667_cov_4.941901	199	279	0	80	80	1.0000000
NODE_19042_length_667_cov_4.941901	252	332	0	80	80	1.0000000
NODE_19053_length_667_cov_3.404930	501	536	8	31	35	0.8857143
NODE_19053_length_667_cov_3.404930	501	536	10	4	35	0.1142857
NODE_19053_length_667_cov_3.404930	503	533	8	26	30	0.8666667
NODE_19053_length_667_cov_3.404930	503	533	10	4	30	0.1333333
NODE_19100_length_666_cov_24.811287	179	254	8	4	75	0.0533333
NODE_19100_length_666_cov_24.811287	179	254	11	1	75	0.0133333
NODE_19100_length_666_cov_24.811287	179	254	13	9	75	0.1200000
NODE_19100_length_666_cov_24.811287	179	254	15	1	75	0.0133333
NODE_19100_length_666_cov_24.811287	179	254	17	2	75	0.0266667
NODE_19100_length_666_cov_24.811287	179	254	21	10	75	0.1333333
NODE_19100_length_666_cov_24.811287	179	254	22	48	75	0.6400000
NODE_19100_length_666_cov_24.811287	182	254	8	4	72	0.0555556
NODE_19100_length_666_cov_24.811287	182	254	11	1	72	0.0138889
NODE_19100_length_666_cov_24.811287	182	254	13	9	72	0.1250000
NODE_19100_length_666_cov_24.811287	182	254	15	1	72	0.0138889
NODE_19100_length_666_cov_24.811287	182	254	17	2	72	0.0277778
NODE_19100_length_666_cov_24.811287	182	254	21	10	72	0.1388889
NODE_19100_length_666_cov_24.811287	182	254	22	45	72	0.6250000
NODE_19100_length_666_cov_24.811287	227	307	0	41	80	0.5125000
NODE_19100_length_666_cov_24.811287	227	307	6	2	80	0.0250000
NODE_19100_length_666_cov_24.811287	227	307	8	14	80	0.1750000
NODE_19100_length_666_cov_24.811287	227	307	11	1	80	0.0125000
NODE_19100_length_666_cov_24.811287	227	307	13	9	80	0.1125000
NODE_19100_length_666_cov_24.811287	227	307	15	1	80	0.0125000
NODE_19100_length_666_cov_24.811287	227	307	17	2	80	0.0250000
NODE_19100_length_666_cov_24.811287	227	307	21	10	80	0.1250000
NODE_19100_length_666_cov_24.811287	227	307	0	41	80	0.5125000
NODE_19100_length_666_cov_24.811287	227	307	6	2	80	0.0250000
NODE_19100_length_666_cov_24.811287	227	307	8	14	80	0.1750000
NODE_19100_length_666_cov_24.811287	227	307	11	1	80	0.0125000
NODE_19100_length_666_cov_24.811287	227	307	13	9	80	0.1125000
NODE_19100_length_666_cov_24.811287	227	307	15	1	80	0.0125000
NODE_19100_length_666_cov_24.811287	227	307	17	2	80	0.0250000
NODE_19100_length_666_cov_24.811287	227	307	21	10	80	0.1250000
NODE_19100_length_666_cov_24.811287	303	383	0	12	80	0.1500000
NODE_19100_length_666_cov_24.811287	303	383	3	3	80	0.0375000
NODE_19100_length_666_cov_24.811287	303	383	10	1	80	0.0125000
NODE_19100_length_666_cov_24.811287	303	383	11	19	80	0.2375000
NODE_19100_length_666_cov_24.811287	303	383	28	2	80	0.0250000
NODE_19100_length_666_cov_24.811287	303	383	32	1	80	0.0125000
NODE_19100_length_666_cov_24.811287	303	383	33	1	80	0.0125000
NODE_19100_length_666_cov_24.811287	303	383	35	11	80	0.1375000
NODE_19100_length_666_cov_24.811287	303	383	37	3	80	0.0375000
NODE_19100_length_666_cov_24.811287	303	383	38	27	80	0.3375000
NODE_19100_length_666_cov_24.811287	356	436	0	6	80	0.0750000
NODE_19100_length_666_cov_24.811287	356	436	2	2	80	0.0250000
NODE_19100_length_666_cov_24.811287	356	436	14	1	80	0.0125000
NODE_19100_length_666_cov_24.811287	356	436	16	4	80	0.0500000
NODE_19100_length_666_cov_24.811287	356	436	22	7	80	0.0875000
NODE_19100_length_666_cov_24.811287	356	436	26	18	80	0.2250000
NODE_19100_length_666_cov_24.811287	356	436	30	6	80	0.0750000
NODE_19100_length_666_cov_24.811287	356	436	38	36	80	0.4500000
NODE_19102_length_666_cov_20.114638	172	252	0	65	80	0.8125000
NODE_19102_length_666_cov_20.114638	172	252	8	15	80	0.1875000
NODE_19102_length_666_cov_20.114638	225	305	0	12	80	0.1500000
NODE_19102_length_666_cov_20.114638	225	305	8	59	80	0.7375000
NODE_19102_length_666_cov_20.114638	225	305	10	9	80	0.1125000
NODE_19103_length_666_cov_16.813051	220	286	0	66	66	1.0000000
NODE_19103_length_666_cov_16.813051	259	344	0	29	85	0.3411765
NODE_19103_length_666_cov_16.813051	259	344	2	56	85	0.6588235
NODE_19104_length_666_cov_15.384480	306	386	0	21	80	0.2625000
NODE_19104_length_666_cov_15.384480	306	386	2	4	80	0.0500000
NODE_19104_length_666_cov_15.384480	306	386	4	55	80	0.6875000
NODE_19104_length_666_cov_15.384480	359	439	0	41	80	0.5125000
NODE_19104_length_666_cov_15.384480	359	439	2	10	80	0.1250000
NODE_19104_length_666_cov_15.384480	359	439	4	29	80	0.3625000
NODE_19105_length_666_cov_14.195767	485	565	0	16	80	0.2000000
NODE_19105_length_666_cov_14.195767	485	565	4	4	80	0.0500000
NODE_19105_length_666_cov_14.195767	485	565	6	60	80	0.7500000
NODE_19105_length_666_cov_14.195767	538	618	0	20	80	0.2500000
NODE_19105_length_666_cov_14.195767	538	618	4	9	80	0.1125000
NODE_19105_length_666_cov_14.195767	538	618	6	51	80	0.6375000
NODE_19108_length_666_cov_7.770723	226	306	0	80	80	1.0000000
NODE_19108_length_666_cov_7.770723	279	359	0	80	80	1.0000000
NODE_19163_length_665_cov_28.786219	391	471	0	80	80	1.0000000
NODE_19163_length_665_cov_28.786219	444	524	0	80	80	1.0000000
NODE_19164_length_665_cov_21.740283	311	391	4	35	80	0.4375000
NODE_19164_length_665_cov_21.740283	311	391	6	20	80	0.2500000
NODE_19164_length_665_cov_21.740283	311	391	7	1	80	0.0125000
NODE_19164_length_665_cov_21.740283	311	391	8	24	80	0.3000000
NODE_19164_length_665_cov_21.740283	364	444	0	9	80	0.1125000
NODE_19164_length_665_cov_21.740283	364	444	2	4	80	0.0500000
NODE_19164_length_665_cov_21.740283	364	444	6	60	80	0.7500000
NODE_19164_length_665_cov_21.740283	364	444	8	7	80	0.0875000
NODE_19165_length_665_cov_15.904594	390	470	0	80	80	1.0000000
NODE_19165_length_665_cov_15.904594	443	523	0	80	80	1.0000000
NODE_19224_length_664_cov_27.208850	259	339	0	80	80	1.0000000
NODE_19224_length_664_cov_27.208850	345	404	0	59	59	1.0000000
NODE_19225_length_664_cov_16.116814	241	321	4	80	80	1.0000000
NODE_19225_length_664_cov_16.116814	294	374	0	42	80	0.5250000
NODE_19225_length_664_cov_16.116814	294	374	4	38	80	0.4750000
NODE_19227_length_664_cov_14.185841	332	412	0	11	80	0.1375000
NODE_19227_length_664_cov_14.185841	332	412	6	69	80	0.8625000
NODE_19227_length_664_cov_14.185841	385	465	0	38	80	0.4750000
NODE_19227_length_664_cov_14.185841	385	465	6	42	80	0.5250000
NODE_19228_length_664_cov_12.256637	325	405	0	50	80	0.6250000
NODE_19228_length_664_cov_12.256637	325	405	2	30	80	0.3750000
NODE_19228_length_664_cov_12.256637	378	454	0	4	76	0.0526316
NODE_19228_length_664_cov_12.256637	378	454	2	72	76	0.9473684
NODE_19229_length_664_cov_8.378761	252	332	2	80	80	1.0000000
NODE_19229_length_664_cov_8.378761	305	385	0	22	80	0.2750000
NODE_19229_length_664_cov_8.378761	305	385	2	58	80	0.7250000
NODE_19229_length_664_cov_8.378761	381	461	0	14	80	0.1750000
NODE_19229_length_664_cov_8.378761	381	461	3	2	80	0.0250000
NODE_19229_length_664_cov_8.378761	381	461	4	2	80	0.0250000
NODE_19229_length_664_cov_8.378761	381	461	6	62	80	0.7750000
NODE_19229_length_664_cov_8.378761	434	514	0	8	80	0.1000000
NODE_19229_length_664_cov_8.378761	434	514	4	15	80	0.1875000
NODE_19229_length_664_cov_8.378761	434	514	6	57	80	0.7125000
NODE_19254_length_664_cov_1.922124	393	434	0	41	41	1.0000000
NODE_19298_length_663_cov_26.601064	398	478	0	28	80	0.3500000
NODE_19298_length_663_cov_26.601064	398	478	4	52	80	0.6500000
NODE_19298_length_663_cov_26.601064	451	531	0	32	80	0.4000000
NODE_19298_length_663_cov_26.601064	451	531	4	48	80	0.6000000
NODE_19299_length_663_cov_16.948582	368	448	2	80	80	1.0000000
NODE_19299_length_663_cov_16.948582	421	501	0	9	80	0.1125000
NODE_19299_length_663_cov_16.948582	421	501	1	9	80	0.1125000
NODE_19299_length_663_cov_16.948582	421	501	2	62	80	0.7750000
NODE_19300_length_663_cov_16.225177	118	198	4	6	80	0.0750000
NODE_19300_length_663_cov_16.225177	118	198	6	74	80	0.9250000
NODE_19300_length_663_cov_16.225177	171	251	0	33	80	0.4125000
NODE_19300_length_663_cov_16.225177	171	251	2	14	80	0.1750000
NODE_19300_length_663_cov_16.225177	171	251	6	33	80	0.4125000
NODE_19302_length_663_cov_13.748227	277	357	0	80	80	1.0000000
NODE_19302_length_663_cov_13.748227	330	410	0	80	80	1.0000000
NODE_19303_length_663_cov_10.377660	300	380	3	1	80	0.0125000
NODE_19303_length_663_cov_10.377660	300	380	4	7	80	0.0875000
NODE_19303_length_663_cov_10.377660	300	380	6	1	80	0.0125000
NODE_19303_length_663_cov_10.377660	300	380	8	19	80	0.2375000
NODE_19303_length_663_cov_10.377660	300	380	10	52	80	0.6500000
NODE_19304_length_663_cov_9.549645	199	279	0	60	80	0.7500000
NODE_19304_length_663_cov_9.549645	199	279	2	20	80	0.2500000
NODE_19304_length_663_cov_9.549645	252	332	0	80	80	1.0000000
NODE_19305_length_663_cov_7.397163	151	231	0	80	80	1.0000000
NODE_19305_length_663_cov_7.397163	204	284	0	80	80	1.0000000
NODE_19307_length_663_cov_5.081560	317	397	0	80	80	1.0000000
NODE_19368_length_662_cov_29.218472	233	313	0	80	80	1.0000000
NODE_19368_length_662_cov_29.218472	286	366	0	80	80	1.0000000
NODE_19369_length_662_cov_18.717584	193	273	0	80	80	1.0000000
NODE_19369_length_662_cov_18.717584	246	326	0	80	80	1.0000000
NODE_19370_length_662_cov_16.358792	258	338	0	80	80	1.0000000
NODE_19370_length_662_cov_16.358792	311	391	0	80	80	1.0000000
NODE_19371_length_662_cov_12.845471	259	339	0	80	80	1.0000000
NODE_19371_length_662_cov_12.845471	312	392	0	80	80	1.0000000
NODE_19372_length_662_cov_12.476021	299	379	0	25	80	0.3125000
NODE_19372_length_662_cov_12.476021	299	379	2	55	80	0.6875000
NODE_19372_length_662_cov_12.476021	352	432	0	21	80	0.2625000
NODE_19372_length_662_cov_12.476021	352	432	2	59	80	0.7375000
NODE_19373_length_662_cov_10.252220	239	319	0	79	80	0.9875000
NODE_19373_length_662_cov_10.252220	239	319	2	1	80	0.0125000
NODE_19373_length_662_cov_10.252220	292	372	0	80	80	1.0000000
NODE_19376_length_662_cov_6.335702	267	347	0	34	80	0.4250000
NODE_19376_length_662_cov_6.335702	267	347	4	46	80	0.5750000
NODE_19376_length_662_cov_6.335702	320	400	4	80	80	1.0000000
NODE_19378_length_662_cov_5.738899	295	331	0	36	36	1.0000000
NODE_19378_length_662_cov_5.738899	301	322	0	21	21	1.0000000
NODE_19402_length_662_cov_1.905861	150	230	0	62	80	0.7750000
NODE_19402_length_662_cov_1.905861	150	230	2	5	80	0.0625000
NODE_19402_length_662_cov_1.905861	150	230	4	13	80	0.1625000
NODE_19402_length_662_cov_1.905861	203	277	0	16	74	0.2162162
NODE_19402_length_662_cov_1.905861	203	277	2	7	74	0.0945946
NODE_19402_length_662_cov_1.905861	203	277	4	51	74	0.6891892
NODE_19441_length_661_cov_55.176157	236	316	16	2	80	0.0250000
NODE_19441_length_661_cov_55.176157	236	316	17	2	80	0.0250000
NODE_19441_length_661_cov_55.176157	236	316	18	15	80	0.1875000
NODE_19441_length_661_cov_55.176157	236	316	26	61	80	0.7625000
NODE_19441_length_661_cov_55.176157	289	369	0	42	80	0.5250000
NODE_19441_length_661_cov_55.176157	289	369	14	1	80	0.0125000
NODE_19441_length_661_cov_55.176157	289	369	16	12	80	0.1500000
NODE_19441_length_661_cov_55.176157	289	369	17	2	80	0.0250000
NODE_19441_length_661_cov_55.176157	289	369	18	15	80	0.1875000
NODE_19441_length_661_cov_55.176157	289	369	26	8	80	0.1000000
NODE_19442_length_661_cov_38.501779	231	311	2	47	80	0.5875000
NODE_19442_length_661_cov_38.501779	231	311	4	32	80	0.4000000
NODE_19442_length_661_cov_38.501779	231	311	6	1	80	0.0125000
NODE_19442_length_661_cov_38.501779	284	364	2	9	80	0.1125000
NODE_19442_length_661_cov_38.501779	284	364	4	70	80	0.8750000
NODE_19442_length_661_cov_38.501779	284	364	6	1	80	0.0125000
NODE_19442_length_661_cov_38.501779	360	440	0	15	80	0.1875000
NODE_19442_length_661_cov_38.501779	360	440	2	19	80	0.2375000
NODE_19442_length_661_cov_38.501779	360	440	4	46	80	0.5750000
NODE_19442_length_661_cov_38.501779	413	493	4	49	80	0.6125000
NODE_19442_length_661_cov_38.501779	413	493	5	3	80	0.0375000
NODE_19442_length_661_cov_38.501779	413	493	6	28	80	0.3500000
NODE_19443_length_661_cov_31.460854	128	208	0	80	80	1.0000000
NODE_19443_length_661_cov_31.460854	181	261	0	80	80	1.0000000
NODE_19444_length_661_cov_18.960854	216	296	0	18	80	0.2250000
NODE_19444_length_661_cov_18.960854	216	296	2	62	80	0.7750000
NODE_19444_length_661_cov_18.960854	269	349	0	71	80	0.8875000
NODE_19444_length_661_cov_18.960854	269	349	2	9	80	0.1125000
NODE_19445_length_661_cov_16.035587	201	281	0	80	80	1.0000000
NODE_19445_length_661_cov_16.035587	254	334	0	80	80	1.0000000
NODE_19447_length_661_cov_13.005338	281	343	0	62	62	1.0000000
NODE_19447_length_661_cov_13.005338	353	433	0	80	80	1.0000000
NODE_19447_length_661_cov_13.005338	406	486	0	80	80	1.0000000
NODE_19452_length_661_cov_5.670819	374	454	0	80	80	1.0000000
NODE_19452_length_661_cov_5.670819	427	507	0	80	80	1.0000000
NODE_19457_length_661_cov_4.601423	319	395	2	11	76	0.1447368
NODE_19457_length_661_cov_4.601423	319	395	4	44	76	0.5789474
NODE_19457_length_661_cov_4.601423	319	395	6	9	76	0.1184211
NODE_19457_length_661_cov_4.601423	319	395	8	12	76	0.1578947
NODE_19459_length_661_cov_3.532028	282	362	0	80	80	1.0000000
NODE_19459_length_661_cov_3.532028	335	415	0	80	80	1.0000000
NODE_19515_length_660_cov_20.741533	343	423	2	7	80	0.0875000
NODE_19515_length_660_cov_20.741533	343	423	4	19	80	0.2375000
NODE_19515_length_660_cov_20.741533	343	423	6	15	80	0.1875000
NODE_19515_length_660_cov_20.741533	343	423	8	39	80	0.4875000
NODE_19515_length_660_cov_20.741533	396	476	0	28	80	0.3500000
NODE_19515_length_660_cov_20.741533	396	476	2	32	80	0.4000000
NODE_19515_length_660_cov_20.741533	396	476	4	19	80	0.2375000
NODE_19515_length_660_cov_20.741533	396	476	8	1	80	0.0125000
NODE_19516_length_660_cov_15.089127	148	228	0	16	80	0.2000000
NODE_19516_length_660_cov_15.089127	148	228	2	64	80	0.8000000
NODE_19516_length_660_cov_15.089127	201	281	0	69	80	0.8625000
NODE_19516_length_660_cov_15.089127	201	281	2	11	80	0.1375000
NODE_19518_length_660_cov_13.301248	276	356	0	80	80	1.0000000
NODE_19518_length_660_cov_13.301248	329	409	0	76	80	0.9500000
NODE_19518_length_660_cov_13.301248	329	409	2	4	80	0.0500000
NODE_19519_length_660_cov_12.393939	234	314	0	80	80	1.0000000
NODE_19519_length_660_cov_12.393939	287	367	0	32	80	0.4000000
NODE_19519_length_660_cov_12.393939	287	367	2	48	80	0.6000000
NODE_19521_length_660_cov_11.495544	399	479	0	80	80	1.0000000
NODE_19521_length_660_cov_11.495544	452	532	0	80	80	1.0000000
NODE_19522_length_660_cov_10.522282	177	257	0	80	80	1.0000000
NODE_19522_length_660_cov_10.522282	230	311	0	81	81	1.0000000
NODE_19524_length_660_cov_8.887701	254	325	6	23	71	0.3239437
NODE_19524_length_660_cov_8.887701	254	325	8	43	71	0.6056338
NODE_19524_length_660_cov_8.887701	254	325	10	5	71	0.0704225
NODE_19527_length_660_cov_7.278075	225	305	0	80	80	1.0000000
NODE_19527_length_660_cov_7.278075	278	358	0	80	80	1.0000000
NODE_19529_length_660_cov_6.577540	350	430	2	36	80	0.4500000
NODE_19529_length_660_cov_6.577540	350	430	3	44	80	0.5500000
NODE_19529_length_660_cov_6.577540	403	483	0	17	80	0.2125000
NODE_19529_length_660_cov_6.577540	403	483	2	63	80	0.7875000
NODE_19549_length_660_cov_2.354724	421	470	2	31	49	0.6326531
NODE_19549_length_660_cov_2.354724	421	470	4	18	49	0.3673469
NODE_19594_length_659_cov_43.587500	2	82	0	80	80	1.0000000
NODE_19594_length_659_cov_43.587500	55	135	0	80	80	1.0000000
NODE_19594_length_659_cov_43.587500	131	211	0	80	80	1.0000000
NODE_19594_length_659_cov_43.587500	184	264	0	80	80	1.0000000
NODE_19595_length_659_cov_23.330357	236	316	0	68	80	0.8500000
NODE_19595_length_659_cov_23.330357	236	316	2	12	80	0.1500000
NODE_19595_length_659_cov_23.330357	289	369	0	15	80	0.1875000
NODE_19595_length_659_cov_23.330357	289	369	2	34	80	0.4250000
NODE_19595_length_659_cov_23.330357	289	369	3	5	80	0.0625000
NODE_19595_length_659_cov_23.330357	289	369	4	26	80	0.3250000
NODE_19596_length_659_cov_12.775000	255	335	0	80	80	1.0000000
NODE_19596_length_659_cov_12.775000	308	388	0	80	80	1.0000000
NODE_19598_length_659_cov_9.683929	220	298	0	78	78	1.0000000
NODE_19598_length_659_cov_9.683929	271	351	0	80	80	1.0000000
NODE_19613_length_659_cov_3.658929	305	385	0	80	80	1.0000000
NODE_19613_length_659_cov_3.658929	358	438	0	80	80	1.0000000
NODE_19678_length_658_cov_38.479428	289	369	0	80	80	1.0000000
NODE_19678_length_658_cov_38.479428	342	422	0	80	80	1.0000000
NODE_19679_length_658_cov_35.409660	242	322	0	41	80	0.5125000
NODE_19679_length_658_cov_35.409660	242	322	2	39	80	0.4875000
NODE_19679_length_658_cov_35.409660	295	375	0	80	80	1.0000000
NODE_19680_length_658_cov_20.322004	191	271	0	77	80	0.9625000
NODE_19680_length_658_cov_20.322004	191	271	3	2	80	0.0250000
NODE_19680_length_658_cov_20.322004	191	271	5	1	80	0.0125000
NODE_19680_length_658_cov_20.322004	244	321	0	24	77	0.3116883
NODE_19680_length_658_cov_20.322004	244	321	3	2	77	0.0259740
NODE_19680_length_658_cov_20.322004	244	321	5	14	77	0.1818182
NODE_19680_length_658_cov_20.322004	244	321	6	37	77	0.4805195
NODE_19680_length_658_cov_20.322004	317	397	3	18	80	0.2250000
NODE_19680_length_658_cov_20.322004	317	397	4	36	80	0.4500000
NODE_19680_length_658_cov_20.322004	317	397	6	26	80	0.3250000
NODE_19680_length_658_cov_20.322004	370	449	0	45	79	0.5696203
NODE_19680_length_658_cov_20.322004	370	449	3	25	79	0.3164557
NODE_19680_length_658_cov_20.322004	370	449	4	9	79	0.1139240
NODE_19681_length_658_cov_11.352415	324	404	0	80	80	1.0000000
NODE_19681_length_658_cov_11.352415	377	457	0	80	80	1.0000000
NODE_19685_length_658_cov_8.241503	227	307	0	80	80	1.0000000
NODE_19685_length_658_cov_8.241503	280	360	0	80	80	1.0000000
NODE_19689_length_658_cov_5.477639	450	530	2	21	80	0.2625000
NODE_19689_length_658_cov_5.477639	450	530	4	59	80	0.7375000
NODE_19705_length_658_cov_2.277281	286	366	0	60	80	0.7500000
NODE_19705_length_658_cov_2.277281	286	366	2	20	80	0.2500000
NODE_19705_length_658_cov_2.277281	339	419	0	7	80	0.0875000
NODE_19705_length_658_cov_2.277281	339	419	2	59	80	0.7375000
NODE_19705_length_658_cov_2.277281	339	419	3	2	80	0.0250000
NODE_19705_length_658_cov_2.277281	339	419	5	12	80	0.1500000
NODE_19750_length_657_cov_71.087814	306	372	8	1	66	0.0151515
NODE_19750_length_657_cov_71.087814	306	372	10	65	66	0.9848485
NODE_19750_length_657_cov_71.087814	382	462	10	5	80	0.0625000
NODE_19750_length_657_cov_71.087814	382	462	12	4	80	0.0500000
NODE_19750_length_657_cov_71.087814	382	462	19	1	80	0.0125000
NODE_19750_length_657_cov_71.087814	382	462	20	29	80	0.3625000
NODE_19750_length_657_cov_71.087814	382	462	22	30	80	0.3750000
NODE_19750_length_657_cov_71.087814	382	462	24	11	80	0.1375000
NODE_19750_length_657_cov_71.087814	382	462	10	5	80	0.0625000
NODE_19750_length_657_cov_71.087814	382	462	12	4	80	0.0500000
NODE_19750_length_657_cov_71.087814	382	462	19	1	80	0.0125000
NODE_19750_length_657_cov_71.087814	382	462	20	29	80	0.3625000
NODE_19750_length_657_cov_71.087814	382	462	22	30	80	0.3750000
NODE_19750_length_657_cov_71.087814	382	462	24	11	80	0.1375000
NODE_19750_length_657_cov_71.087814	435	515	7	7	80	0.0875000
NODE_19750_length_657_cov_71.087814	435	515	10	19	80	0.2375000
NODE_19750_length_657_cov_71.087814	435	515	12	7	80	0.0875000
NODE_19750_length_657_cov_71.087814	435	515	14	5	80	0.0625000
NODE_19750_length_657_cov_71.087814	435	515	16	1	80	0.0125000
NODE_19750_length_657_cov_71.087814	435	515	20	21	80	0.2625000
NODE_19750_length_657_cov_71.087814	435	515	21	8	80	0.1000000
NODE_19750_length_657_cov_71.087814	435	515	22	12	80	0.1500000
NODE_19750_length_657_cov_71.087814	440	515	7	7	75	0.0933333
NODE_19750_length_657_cov_71.087814	440	515	10	19	75	0.2533333
NODE_19750_length_657_cov_71.087814	440	515	12	7	75	0.0933333
NODE_19750_length_657_cov_71.087814	440	515	14	5	75	0.0666667
NODE_19750_length_657_cov_71.087814	440	515	16	1	75	0.0133333
NODE_19750_length_657_cov_71.087814	440	515	20	16	75	0.2133333
NODE_19750_length_657_cov_71.087814	440	515	21	8	75	0.1066667
NODE_19750_length_657_cov_71.087814	440	515	22	12	75	0.1600000
NODE_19751_length_657_cov_67.408602	98	178	0	67	80	0.8375000
NODE_19751_length_657_cov_67.408602	98	178	2	13	80	0.1625000
NODE_19751_length_657_cov_67.408602	151	231	0	14	80	0.1750000
NODE_19751_length_657_cov_67.408602	151	231	2	66	80	0.8250000
NODE_19752_length_657_cov_15.568100	265	345	0	80	80	1.0000000
NODE_19752_length_657_cov_15.568100	341	421	0	80	80	1.0000000
NODE_19759_length_657_cov_5.161290	185	256	0	71	71	1.0000000
NODE_19759_length_657_cov_5.161290	229	309	0	80	80	1.0000000
NODE_19824_length_656_cov_37.023339	470	550	6	5	80	0.0625000
NODE_19824_length_656_cov_37.023339	470	550	12	23	80	0.2875000
NODE_19824_length_656_cov_37.023339	470	550	14	52	80	0.6500000
NODE_19824_length_656_cov_37.023339	523	603	0	21	80	0.2625000
NODE_19824_length_656_cov_37.023339	523	603	2	28	80	0.3500000
NODE_19824_length_656_cov_37.023339	523	603	6	9	80	0.1125000
NODE_19824_length_656_cov_37.023339	523	603	12	13	80	0.1625000
NODE_19824_length_656_cov_37.023339	523	603	14	9	80	0.1125000
NODE_19825_length_656_cov_22.804309	173	253	0	37	80	0.4625000
NODE_19825_length_656_cov_22.804309	173	253	2	3	80	0.0375000
NODE_19825_length_656_cov_22.804309	173	253	4	40	80	0.5000000
NODE_19825_length_656_cov_22.804309	226	306	0	10	80	0.1250000
NODE_19825_length_656_cov_22.804309	226	306	2	10	80	0.1250000
NODE_19825_length_656_cov_22.804309	226	306	4	60	80	0.7500000
NODE_19826_length_656_cov_19.280072	345	425	0	80	80	1.0000000
NODE_19826_length_656_cov_19.280072	398	478	0	80	80	1.0000000
NODE_19827_length_656_cov_18.267504	272	352	0	80	80	1.0000000
NODE_19827_length_656_cov_18.267504	325	405	0	80	80	1.0000000
NODE_19828_length_656_cov_15.928187	223	303	0	80	80	1.0000000
NODE_19829_length_656_cov_15.091562	297	377	0	80	80	1.0000000
NODE_19829_length_656_cov_15.091562	350	430	0	80	80	1.0000000
NODE_19830_length_656_cov_12.773788	269	349	0	80	80	1.0000000
NODE_19830_length_656_cov_12.773788	322	399	0	77	77	1.0000000
NODE_19831_length_656_cov_12.493716	212	292	0	80	80	1.0000000
NODE_19831_length_656_cov_12.493716	265	345	0	80	80	1.0000000
NODE_19832_length_656_cov_10.946140	197	277	0	80	80	1.0000000
NODE_19832_length_656_cov_10.946140	250	330	0	80	80	1.0000000
NODE_19833_length_656_cov_9.412926	295	375	0	26	80	0.3250000
NODE_19833_length_656_cov_9.412926	295	375	2	54	80	0.6750000
NODE_19833_length_656_cov_9.412926	348	428	0	14	80	0.1750000
NODE_19833_length_656_cov_9.412926	348	428	2	66	80	0.8250000
NODE_19904_length_655_cov_31.019784	212	292	0	78	80	0.9750000
NODE_19904_length_655_cov_31.019784	212	292	2	2	80	0.0250000
NODE_19904_length_655_cov_31.019784	265	345	0	25	80	0.3125000
NODE_19904_length_655_cov_31.019784	265	345	2	55	80	0.6875000
NODE_19907_length_655_cov_8.672662	216	296	0	80	80	1.0000000
NODE_19907_length_655_cov_8.672662	269	349	0	80	80	1.0000000
NODE_19908_length_655_cov_8.250000	204	234	0	30	30	1.0000000
NODE_19909_length_655_cov_7.910072	366	446	0	80	80	1.0000000
NODE_19909_length_655_cov_7.910072	419	499	0	80	80	1.0000000
NODE_19916_length_655_cov_5.478417	178	255	0	77	77	1.0000000
NODE_19916_length_655_cov_5.478417	178	221	0	43	43	1.0000000
NODE_19919_length_655_cov_5.174460	347	428	0	81	81	1.0000000
NODE_19919_length_655_cov_5.174460	401	481	0	80	80	1.0000000
NODE_19979_length_654_cov_17.086486	323	403	2	43	80	0.5375000
NODE_19979_length_654_cov_17.086486	323	403	4	37	80	0.4625000
NODE_19979_length_654_cov_17.086486	376	456	0	5	80	0.0625000
NODE_19979_length_654_cov_17.086486	376	456	2	75	80	0.9375000
NODE_19980_length_654_cov_16.194595	318	398	0	80	80	1.0000000
NODE_19980_length_654_cov_16.194595	371	451	0	58	80	0.7250000
NODE_19980_length_654_cov_16.194595	371	451	2	22	80	0.2750000
NODE_19983_length_654_cov_5.556757	341	412	0	71	71	1.0000000
NODE_19990_length_654_cov_3.236036	105	181	0	76	76	1.0000000
NODE_19990_length_654_cov_3.236036	158	236	0	78	78	1.0000000
NODE_19998_length_654_cov_2.549550	279	366	0	87	87	1.0000000
NODE_20013_length_654_cov_1.790991	480	560	0	4	80	0.0500000
NODE_20013_length_654_cov_1.790991	480	560	2	76	80	0.9500000
NODE_20044_length_653_cov_70.296029	277	357	2	36	80	0.4500000
NODE_20044_length_653_cov_70.296029	277	357	8	12	80	0.1500000
NODE_20044_length_653_cov_70.296029	277	357	16	21	80	0.2625000
NODE_20044_length_653_cov_70.296029	277	357	17	2	80	0.0250000
NODE_20044_length_653_cov_70.296029	277	357	18	9	80	0.1125000
NODE_20044_length_653_cov_70.296029	330	410	10	16	80	0.2000000
NODE_20044_length_653_cov_70.296029	330	410	16	58	80	0.7250000
NODE_20044_length_653_cov_70.296029	330	410	17	1	80	0.0125000
NODE_20044_length_653_cov_70.296029	330	410	18	5	80	0.0625000
NODE_20045_length_653_cov_28.072202	302	382	0	80	80	1.0000000
NODE_20045_length_653_cov_28.072202	355	435	0	80	80	1.0000000
NODE_20046_length_653_cov_18.382671	214	294	0	80	80	1.0000000
NODE_20046_length_653_cov_18.382671	267	347	0	80	80	1.0000000
NODE_20047_length_653_cov_8.821300	292	372	0	30	80	0.3750000
NODE_20047_length_653_cov_8.821300	292	372	6	50	80	0.6250000
NODE_20047_length_653_cov_8.821300	345	425	0	80	80	1.0000000
NODE_20048_length_653_cov_8.660650	200	280	0	1	80	0.0125000
NODE_20048_length_653_cov_8.660650	200	280	4	79	80	0.9875000
NODE_20048_length_653_cov_8.660650	253	333	0	54	80	0.6750000
NODE_20048_length_653_cov_8.660650	253	333	4	26	80	0.3250000
NODE_20052_length_653_cov_5.777978	308	383	0	75	75	1.0000000
NODE_20052_length_653_cov_5.777978	361	435	0	73	74	0.9864865
NODE_20052_length_653_cov_5.777978	361	435	2	1	74	0.0135135
NODE_20054_length_653_cov_5.193141	304	356	0	52	52	1.0000000
NODE_20058_length_653_cov_4.823105	178	251	1	40	73	0.5479452
NODE_20058_length_653_cov_4.823105	178	251	3	4	73	0.0547945
NODE_20058_length_653_cov_4.823105	178	251	4	9	73	0.1232877
NODE_20058_length_653_cov_4.823105	178	251	5	20	73	0.2739726
NODE_20058_length_653_cov_4.823105	178	256	1	40	78	0.5128205
NODE_20058_length_653_cov_4.823105	178	256	3	4	78	0.0512821
NODE_20058_length_653_cov_4.823105	178	256	4	14	78	0.1794872
NODE_20058_length_653_cov_4.823105	178	256	5	20	78	0.2564103
NODE_20058_length_653_cov_4.823105	229	309	2	10	80	0.1250000
NODE_20058_length_653_cov_4.823105	229	309	4	57	80	0.7125000
NODE_20058_length_653_cov_4.823105	229	309	5	13	80	0.1625000
NODE_20058_length_653_cov_4.823105	229	309	2	10	80	0.1250000
NODE_20058_length_653_cov_4.823105	229	309	4	57	80	0.7125000
NODE_20058_length_653_cov_4.823105	229	309	5	13	80	0.1625000
NODE_20058_length_653_cov_4.823105	239	309	2	10	70	0.1428571
NODE_20058_length_653_cov_4.823105	239	309	4	57	70	0.8142857
NODE_20058_length_653_cov_4.823105	239	309	5	3	70	0.0428571
NODE_20127_length_652_cov_215.211573	185	248	4	12	63	0.1904762
NODE_20127_length_652_cov_215.211573	185	248	5	7	63	0.1111111
NODE_20127_length_652_cov_215.211573	185	248	6	1	63	0.0158730
NODE_20127_length_652_cov_215.211573	185	248	20	15	63	0.2380952
NODE_20127_length_652_cov_215.211573	185	248	22	3	63	0.0476190
NODE_20127_length_652_cov_215.211573	185	248	23	4	63	0.0634921
NODE_20127_length_652_cov_215.211573	185	248	25	5	63	0.0793651
NODE_20127_length_652_cov_215.211573	185	248	27	8	63	0.1269841
NODE_20127_length_652_cov_215.211573	185	248	29	4	63	0.0634921
NODE_20127_length_652_cov_215.211573	185	248	30	3	63	0.0476190
NODE_20127_length_652_cov_215.211573	185	248	32	1	63	0.0158730
NODE_20127_length_652_cov_215.211573	221	301	22	2	80	0.0250000
NODE_20127_length_652_cov_215.211573	221	301	23	4	80	0.0500000
NODE_20127_length_652_cov_215.211573	221	301	25	5	80	0.0625000
NODE_20127_length_652_cov_215.211573	221	301	27	8	80	0.1000000
NODE_20127_length_652_cov_215.211573	221	301	29	4	80	0.0500000
NODE_20127_length_652_cov_215.211573	221	301	30	3	80	0.0375000
NODE_20127_length_652_cov_215.211573	221	301	32	1	80	0.0125000
NODE_20127_length_652_cov_215.211573	221	301	38	10	80	0.1250000
NODE_20127_length_652_cov_215.211573	221	301	42	3	80	0.0375000
NODE_20127_length_652_cov_215.211573	221	301	44	5	80	0.0625000
NODE_20127_length_652_cov_215.211573	221	301	45	3	80	0.0375000
NODE_20127_length_652_cov_215.211573	221	301	47	1	80	0.0125000
NODE_20127_length_652_cov_215.211573	221	301	49	2	80	0.0250000
NODE_20127_length_652_cov_215.211573	221	301	51	1	80	0.0125000
NODE_20127_length_652_cov_215.211573	221	301	53	2	80	0.0250000
NODE_20127_length_652_cov_215.211573	221	301	55	10	80	0.1250000
NODE_20127_length_652_cov_215.211573	221	301	57	4	80	0.0500000
NODE_20127_length_652_cov_215.211573	221	301	59	5	80	0.0625000
NODE_20127_length_652_cov_215.211573	221	301	60	3	80	0.0375000
NODE_20127_length_652_cov_215.211573	221	301	61	4	80	0.0500000
NODE_20128_length_652_cov_21.267631	299	379	0	13	80	0.1625000
NODE_20128_length_652_cov_21.267631	299	379	4	47	80	0.5875000
NODE_20128_length_652_cov_21.267631	299	379	6	20	80	0.2500000
NODE_20128_length_652_cov_21.267631	352	432	2	31	80	0.3875000
NODE_20128_length_652_cov_21.267631	352	432	4	7	80	0.0875000
NODE_20128_length_652_cov_21.267631	352	432	6	42	80	0.5250000
NODE_20138_length_652_cov_4.622061	266	315	2	49	49	1.0000000
NODE_20138_length_652_cov_4.622061	288	368	0	32	80	0.4000000
NODE_20138_length_652_cov_4.622061	288	368	2	48	80	0.6000000
NODE_20210_length_651_cov_49.981884	425	505	9	2	80	0.0250000
NODE_20210_length_651_cov_49.981884	425	505	10	3	80	0.0375000
NODE_20210_length_651_cov_49.981884	425	505	11	8	80	0.1000000
NODE_20210_length_651_cov_49.981884	425	505	13	1	80	0.0125000
NODE_20210_length_651_cov_49.981884	425	505	17	8	80	0.1000000
NODE_20210_length_651_cov_49.981884	425	505	18	1	80	0.0125000
NODE_20210_length_651_cov_49.981884	425	505	19	8	80	0.1000000
NODE_20210_length_651_cov_49.981884	425	505	20	7	80	0.0875000
NODE_20210_length_651_cov_49.981884	425	505	24	3	80	0.0375000
NODE_20210_length_651_cov_49.981884	425	505	25	1	80	0.0125000
NODE_20210_length_651_cov_49.981884	425	505	27	11	80	0.1375000
NODE_20210_length_651_cov_49.981884	425	505	29	7	80	0.0875000
NODE_20210_length_651_cov_49.981884	425	505	31	20	80	0.2500000
NODE_20210_length_651_cov_49.981884	425	505	9	2	80	0.0250000
NODE_20210_length_651_cov_49.981884	425	505	10	3	80	0.0375000
NODE_20210_length_651_cov_49.981884	425	505	11	8	80	0.1000000
NODE_20210_length_651_cov_49.981884	425	505	13	1	80	0.0125000
NODE_20210_length_651_cov_49.981884	425	505	17	8	80	0.1000000
NODE_20210_length_651_cov_49.981884	425	505	18	1	80	0.0125000
NODE_20210_length_651_cov_49.981884	425	505	19	8	80	0.1000000
NODE_20210_length_651_cov_49.981884	425	505	20	7	80	0.0875000
NODE_20210_length_651_cov_49.981884	425	505	24	3	80	0.0375000
NODE_20210_length_651_cov_49.981884	425	505	25	1	80	0.0125000
NODE_20210_length_651_cov_49.981884	425	505	27	11	80	0.1375000
NODE_20210_length_651_cov_49.981884	425	505	29	7	80	0.0875000
NODE_20210_length_651_cov_49.981884	425	505	31	20	80	0.2500000
NODE_20210_length_651_cov_49.981884	425	505	9	2	80	0.0250000
NODE_20210_length_651_cov_49.981884	425	505	10	3	80	0.0375000
NODE_20210_length_651_cov_49.981884	425	505	11	8	80	0.1000000
NODE_20210_length_651_cov_49.981884	425	505	13	1	80	0.0125000
NODE_20210_length_651_cov_49.981884	425	505	17	8	80	0.1000000
NODE_20210_length_651_cov_49.981884	425	505	18	1	80	0.0125000
NODE_20210_length_651_cov_49.981884	425	505	19	8	80	0.1000000
NODE_20210_length_651_cov_49.981884	425	505	20	7	80	0.0875000
NODE_20210_length_651_cov_49.981884	425	505	24	3	80	0.0375000
NODE_20210_length_651_cov_49.981884	425	505	25	1	80	0.0125000
NODE_20210_length_651_cov_49.981884	425	505	27	11	80	0.1375000
NODE_20210_length_651_cov_49.981884	425	505	29	7	80	0.0875000
NODE_20210_length_651_cov_49.981884	425	505	31	20	80	0.2500000
NODE_20210_length_651_cov_49.981884	425	505	9	2	80	0.0250000
NODE_20210_length_651_cov_49.981884	425	505	10	3	80	0.0375000
NODE_20210_length_651_cov_49.981884	425	505	11	8	80	0.1000000
NODE_20210_length_651_cov_49.981884	425	505	13	1	80	0.0125000
NODE_20210_length_651_cov_49.981884	425	505	17	8	80	0.1000000
NODE_20210_length_651_cov_49.981884	425	505	18	1	80	0.0125000
NODE_20210_length_651_cov_49.981884	425	505	19	8	80	0.1000000
NODE_20210_length_651_cov_49.981884	425	505	20	7	80	0.0875000
NODE_20210_length_651_cov_49.981884	425	505	24	3	80	0.0375000
NODE_20210_length_651_cov_49.981884	425	505	25	1	80	0.0125000
NODE_20210_length_651_cov_49.981884	425	505	27	11	80	0.1375000
NODE_20210_length_651_cov_49.981884	425	505	29	7	80	0.0875000
NODE_20210_length_651_cov_49.981884	425	505	31	20	80	0.2500000
NODE_20210_length_651_cov_49.981884	478	540	2	30	62	0.4838710
NODE_20210_length_651_cov_49.981884	478	540	9	7	62	0.1129032
NODE_20210_length_651_cov_49.981884	478	540	10	3	62	0.0483871
NODE_20210_length_651_cov_49.981884	478	540	11	8	62	0.1290323
NODE_20210_length_651_cov_49.981884	478	540	13	1	62	0.0161290
NODE_20210_length_651_cov_49.981884	478	540	17	8	62	0.1290323
NODE_20210_length_651_cov_49.981884	478	540	18	1	62	0.0161290
NODE_20210_length_651_cov_49.981884	478	540	19	4	62	0.0645161
NODE_20210_length_651_cov_49.981884	478	540	2	30	62	0.4838710
NODE_20210_length_651_cov_49.981884	478	540	9	7	62	0.1129032
NODE_20210_length_651_cov_49.981884	478	540	10	3	62	0.0483871
NODE_20210_length_651_cov_49.981884	478	540	11	8	62	0.1290323
NODE_20210_length_651_cov_49.981884	478	540	13	1	62	0.0161290
NODE_20210_length_651_cov_49.981884	478	540	17	8	62	0.1290323
NODE_20210_length_651_cov_49.981884	478	540	18	1	62	0.0161290
NODE_20210_length_651_cov_49.981884	478	540	19	4	62	0.0645161
NODE_20210_length_651_cov_49.981884	478	540	2	30	62	0.4838710
NODE_20210_length_651_cov_49.981884	478	540	9	7	62	0.1129032
NODE_20210_length_651_cov_49.981884	478	540	10	3	62	0.0483871
NODE_20210_length_651_cov_49.981884	478	540	11	8	62	0.1290323
NODE_20210_length_651_cov_49.981884	478	540	13	1	62	0.0161290
NODE_20210_length_651_cov_49.981884	478	540	17	8	62	0.1290323
NODE_20210_length_651_cov_49.981884	478	540	18	1	62	0.0161290
NODE_20210_length_651_cov_49.981884	478	540	19	4	62	0.0645161
NODE_20210_length_651_cov_49.981884	478	542	2	32	64	0.5000000
NODE_20210_length_651_cov_49.981884	478	542	9	7	64	0.1093750
NODE_20210_length_651_cov_49.981884	478	542	10	3	64	0.0468750
NODE_20210_length_651_cov_49.981884	478	542	11	8	64	0.1250000
NODE_20210_length_651_cov_49.981884	478	542	13	1	64	0.0156250
NODE_20210_length_651_cov_49.981884	478	542	17	8	64	0.1250000
NODE_20210_length_651_cov_49.981884	478	542	18	1	64	0.0156250
NODE_20210_length_651_cov_49.981884	478	542	19	4	64	0.0625000
NODE_20211_length_651_cov_36.121377	422	502	23	27	80	0.3375000
NODE_20211_length_651_cov_36.121377	422	502	24	3	80	0.0375000
NODE_20211_length_651_cov_36.121377	422	502	25	28	80	0.3500000
NODE_20211_length_651_cov_36.121377	422	502	26	22	80	0.2750000
NODE_20211_length_651_cov_36.121377	475	555	0	33	80	0.4125000
NODE_20211_length_651_cov_36.121377	475	555	18	1	80	0.0125000
NODE_20211_length_651_cov_36.121377	475	555	19	6	80	0.0750000
NODE_20211_length_651_cov_36.121377	475	555	23	20	80	0.2500000
NODE_20211_length_651_cov_36.121377	475	555	25	3	80	0.0375000
NODE_20211_length_651_cov_36.121377	475	555	26	17	80	0.2125000
NODE_20212_length_651_cov_20.045290	252	332	0	3	80	0.0375000
NODE_20212_length_651_cov_20.045290	252	332	6	77	80	0.9625000
NODE_20212_length_651_cov_20.045290	305	385	6	80	80	1.0000000
NODE_20213_length_651_cov_12.704710	264	344	0	80	80	1.0000000
NODE_20213_length_651_cov_12.704710	317	397	0	80	80	1.0000000
NODE_20214_length_651_cov_11.632246	205	285	0	80	80	1.0000000
NODE_20214_length_651_cov_11.632246	258	338	0	80	80	1.0000000
NODE_20215_length_651_cov_10.074275	369	449	0	80	80	1.0000000
NODE_20215_length_651_cov_10.074275	422	502	0	80	80	1.0000000
NODE_20216_length_651_cov_9.699275	199	279	0	80	80	1.0000000
NODE_20216_length_651_cov_9.699275	252	332	0	80	80	1.0000000
NODE_20219_length_651_cov_8.309783	217	296	0	79	79	1.0000000
NODE_20219_length_651_cov_8.309783	269	349	0	80	80	1.0000000
NODE_20220_length_651_cov_5.621377	148	228	0	80	80	1.0000000
NODE_20220_length_651_cov_5.621377	201	281	0	80	80	1.0000000
NODE_20221_length_651_cov_5.610507	342	422	2	80	80	1.0000000
NODE_20221_length_651_cov_5.610507	395	475	0	22	80	0.2750000
NODE_20221_length_651_cov_5.610507	395	475	2	58	80	0.7250000
NODE_20225_length_651_cov_4.246377	299	359	0	14	60	0.2333333
NODE_20225_length_651_cov_4.246377	299	359	2	46	60	0.7666667
NODE_20238_length_651_cov_2.744565	340	421	0	81	81	1.0000000
NODE_20252_length_651_cov_2.016304	280	311	0	31	31	1.0000000
NODE_20292_length_650_cov_22.644283	233	313	0	80	80	1.0000000
NODE_20292_length_650_cov_22.644283	286	366	0	80	80	1.0000000
NODE_20293_length_650_cov_22.156080	269	349	0	80	80	1.0000000
NODE_20293_length_650_cov_22.156080	322	402	0	80	80	1.0000000
NODE_20294_length_650_cov_20.012704	186	266	0	80	80	1.0000000
NODE_20294_length_650_cov_20.012704	239	319	0	80	80	1.0000000
NODE_20295_length_650_cov_17.626134	52	132	0	80	80	1.0000000
NODE_20295_length_650_cov_17.626134	105	185	0	80	80	1.0000000
NODE_20297_length_650_cov_10.687840	289	369	0	80	80	1.0000000
NODE_20297_length_650_cov_10.687840	342	422	0	80	80	1.0000000
NODE_20301_length_650_cov_6.519056	312	365	17	2	53	0.0377358
NODE_20301_length_650_cov_6.519056	312	365	21	3	53	0.0566038
NODE_20301_length_650_cov_6.519056	312	365	23	8	53	0.1509434
NODE_20301_length_650_cov_6.519056	312	365	25	7	53	0.1320755
NODE_20301_length_650_cov_6.519056	312	365	28	1	53	0.0188679
NODE_20301_length_650_cov_6.519056	312	365	29	1	53	0.0188679
NODE_20301_length_650_cov_6.519056	312	365	31	5	53	0.0943396
NODE_20301_length_650_cov_6.519056	312	365	33	5	53	0.0943396
NODE_20301_length_650_cov_6.519056	312	365	34	1	53	0.0188679
NODE_20301_length_650_cov_6.519056	312	365	36	4	53	0.0754717
NODE_20301_length_650_cov_6.519056	312	365	38	7	53	0.1320755
NODE_20301_length_650_cov_6.519056	312	365	40	2	53	0.0377358
NODE_20301_length_650_cov_6.519056	312	365	41	7	53	0.1320755
NODE_20301_length_650_cov_6.519056	338	417	31	1	79	0.0126582
NODE_20301_length_650_cov_6.519056	338	417	33	5	79	0.0632911
NODE_20301_length_650_cov_6.519056	338	417	34	1	79	0.0126582
NODE_20301_length_650_cov_6.519056	338	417	36	4	79	0.0506329
NODE_20301_length_650_cov_6.519056	338	417	37	4	79	0.0506329
NODE_20301_length_650_cov_6.519056	338	417	38	7	79	0.0886076
NODE_20301_length_650_cov_6.519056	338	417	39	12	79	0.1518987
NODE_20301_length_650_cov_6.519056	338	417	40	31	79	0.3924051
NODE_20301_length_650_cov_6.519056	338	417	41	14	79	0.1772152
NODE_20302_length_650_cov_6.159710	243	323	0	80	80	1.0000000
NODE_20302_length_650_cov_6.159710	296	376	0	80	80	1.0000000
NODE_20318_length_650_cov_2.488203	213	266	0	53	53	1.0000000
NODE_20370_length_649_cov_20.780000	111	140	0	29	29	1.0000000
NODE_20370_length_649_cov_20.780000	111	191	0	80	80	1.0000000
NODE_20370_length_649_cov_20.780000	138	161	0	23	23	1.0000000
NODE_20370_length_649_cov_20.780000	138	214	0	76	76	1.0000000
NODE_20370_length_649_cov_20.780000	164	244	0	80	80	1.0000000
NODE_20371_length_649_cov_17.938182	162	242	0	80	80	1.0000000
NODE_20371_length_649_cov_17.938182	215	295	0	80	80	1.0000000
NODE_20372_length_649_cov_16.761818	395	475	0	80	80	1.0000000
NODE_20372_length_649_cov_16.761818	448	528	0	80	80	1.0000000
NODE_20373_length_649_cov_15.632727	226	306	0	58	80	0.7250000
NODE_20373_length_649_cov_15.632727	226	306	2	22	80	0.2750000
NODE_20373_length_649_cov_15.632727	279	359	0	14	80	0.1750000
NODE_20373_length_649_cov_15.632727	279	359	2	66	80	0.8250000
NODE_20374_length_649_cov_15.516364	329	409	0	6	80	0.0750000
NODE_20374_length_649_cov_15.516364	329	409	2	74	80	0.9250000
NODE_20374_length_649_cov_15.516364	382	462	0	8	80	0.1000000
NODE_20374_length_649_cov_15.516364	382	462	2	72	80	0.9000000
NODE_20375_length_649_cov_10.374545	453	533	0	80	80	1.0000000
NODE_20375_length_649_cov_10.374545	506	586	0	80	80	1.0000000
NODE_20382_length_649_cov_4.403636	213	293	0	80	80	1.0000000
NODE_20382_length_649_cov_4.403636	266	346	0	80	80	1.0000000
NODE_20454_length_648_cov_34.287796	343	423	0	80	80	1.0000000
NODE_20454_length_648_cov_34.287796	396	476	0	80	80	1.0000000
NODE_20454_length_648_cov_34.287796	472	552	0	80	80	1.0000000
NODE_20454_length_648_cov_34.287796	525	605	0	80	80	1.0000000
NODE_20455_length_648_cov_19.433515	259	339	0	80	80	1.0000000
NODE_20455_length_648_cov_19.433515	312	392	0	80	80	1.0000000
NODE_20457_length_648_cov_8.391621	206	286	0	80	80	1.0000000
NODE_20457_length_648_cov_8.391621	259	339	0	50	80	0.6250000
NODE_20457_length_648_cov_8.391621	259	339	2	30	80	0.3750000
NODE_20459_length_648_cov_6.573770	293	373	0	80	80	1.0000000
NODE_20459_length_648_cov_6.573770	346	426	0	80	80	1.0000000
NODE_20460_length_648_cov_6.431694	285	328	0	43	43	1.0000000
NODE_20463_length_648_cov_6.085610	257	337	0	80	80	1.0000000
NODE_20463_length_648_cov_6.085610	310	390	0	30	80	0.3750000
NODE_20463_length_648_cov_6.085610	310	390	2	50	80	0.6250000
NODE_20483_length_648_cov_2.333333	19	86	0	24	67	0.3582090
NODE_20483_length_648_cov_2.333333	19	86	2	41	67	0.6119403
NODE_20483_length_648_cov_2.333333	19	86	4	1	67	0.0149254
NODE_20483_length_648_cov_2.333333	19	86	6	1	67	0.0149254
NODE_20531_length_647_cov_18.489051	295	375	0	46	80	0.5750000
NODE_20531_length_647_cov_18.489051	295	375	2	34	80	0.4250000
NODE_20531_length_647_cov_18.489051	348	428	2	80	80	1.0000000
NODE_20532_length_647_cov_14.677007	286	366	0	80	80	1.0000000
NODE_20532_length_647_cov_14.677007	339	419	0	80	80	1.0000000
NODE_20533_length_647_cov_10.895985	231	311	4	80	80	1.0000000
NODE_20533_length_647_cov_10.895985	284	364	0	43	80	0.5375000
NODE_20533_length_647_cov_10.895985	284	364	4	37	80	0.4625000
NODE_20534_length_647_cov_9.116788	372	452	0	80	80	1.0000000
NODE_20534_length_647_cov_9.116788	425	505	0	80	80	1.0000000
NODE_20536_length_647_cov_6.410584	150	221	0	71	71	1.0000000
NODE_20536_length_647_cov_6.410584	194	274	0	80	80	1.0000000
NODE_20539_length_647_cov_5.567518	239	319	3	25	80	0.3125000
NODE_20539_length_647_cov_5.567518	239	319	5	2	80	0.0250000
NODE_20539_length_647_cov_5.567518	239	319	7	2	80	0.0250000
NODE_20539_length_647_cov_5.567518	239	319	11	42	80	0.5250000
NODE_20539_length_647_cov_5.567518	239	319	12	1	80	0.0125000
NODE_20539_length_647_cov_5.567518	239	319	13	2	80	0.0250000
NODE_20539_length_647_cov_5.567518	239	319	14	6	80	0.0750000
NODE_20539_length_647_cov_5.567518	292	355	9	1	63	0.0158730
NODE_20539_length_647_cov_5.567518	292	355	10	19	63	0.3015873
NODE_20539_length_647_cov_5.567518	292	355	11	19	63	0.3015873
NODE_20539_length_647_cov_5.567518	292	355	12	10	63	0.1587302
NODE_20539_length_647_cov_5.567518	292	355	13	7	63	0.1111111
NODE_20539_length_647_cov_5.567518	292	355	14	6	63	0.0952381
NODE_20539_length_647_cov_5.567518	292	355	15	1	63	0.0158730
NODE_20539_length_647_cov_5.567518	348	416	9	1	68	0.0147059
NODE_20539_length_647_cov_5.567518	348	416	10	13	68	0.1911765
NODE_20539_length_647_cov_5.567518	348	416	11	1	68	0.0147059
NODE_20539_length_647_cov_5.567518	348	416	12	2	68	0.0294118
NODE_20539_length_647_cov_5.567518	348	416	14	17	68	0.2500000
NODE_20539_length_647_cov_5.567518	348	416	15	4	68	0.0588235
NODE_20539_length_647_cov_5.567518	348	416	16	30	68	0.4411765
NODE_20539_length_647_cov_5.567518	401	469	10	8	68	0.1176471
NODE_20539_length_647_cov_5.567518	401	469	14	60	68	0.8823529
NODE_20544_length_647_cov_3.775547	356	399	0	43	43	1.0000000
NODE_20550_length_647_cov_2.678832	239	319	0	80	80	1.0000000
NODE_20550_length_647_cov_2.678832	292	372	0	80	80	1.0000000
NODE_20561_length_647_cov_1.937956	254	304	0	50	50	1.0000000
NODE_20607_length_646_cov_56.226691	267	347	0	80	80	1.0000000
NODE_20607_length_646_cov_56.226691	320	400	0	80	80	1.0000000
NODE_20608_length_646_cov_23.747715	76	153	0	77	77	1.0000000
NODE_20608_length_646_cov_23.747715	129	209	0	80	80	1.0000000
NODE_20609_length_646_cov_22.740402	326	406	0	10	80	0.1250000
NODE_20609_length_646_cov_22.740402	326	406	2	70	80	0.8750000
NODE_20609_length_646_cov_22.740402	379	459	0	22	80	0.2750000
NODE_20609_length_646_cov_22.740402	379	459	2	58	80	0.7250000
NODE_20610_length_646_cov_15.160878	363	443	0	33	80	0.4125000
NODE_20610_length_646_cov_15.160878	363	443	4	47	80	0.5875000
NODE_20610_length_646_cov_15.160878	416	496	0	36	80	0.4500000
NODE_20610_length_646_cov_15.160878	416	496	4	44	80	0.5500000
NODE_20611_length_646_cov_9.429616	309	389	0	12	80	0.1500000
NODE_20611_length_646_cov_9.429616	309	389	2	44	80	0.5500000
NODE_20611_length_646_cov_9.429616	309	389	6	24	80	0.3000000
NODE_20611_length_646_cov_9.429616	362	442	2	3	80	0.0375000
NODE_20611_length_646_cov_9.429616	362	442	4	37	80	0.4625000
NODE_20611_length_646_cov_9.429616	362	442	6	40	80	0.5000000
NODE_20612_length_646_cov_9.246801	149	221	0	72	72	1.0000000
NODE_20613_length_646_cov_7.539305	227	307	0	80	80	1.0000000
NODE_20613_length_646_cov_7.539305	280	360	0	80	80	1.0000000
NODE_20614_length_646_cov_6.756856	236	316	2	80	80	1.0000000
NODE_20614_length_646_cov_6.756856	289	369	2	77	80	0.9625000
NODE_20614_length_646_cov_6.756856	289	369	4	3	80	0.0375000
NODE_20615_length_646_cov_6.480804	373	437	0	3	64	0.0468750
NODE_20615_length_646_cov_6.480804	373	437	4	6	64	0.0937500
NODE_20615_length_646_cov_6.480804	373	437	6	55	64	0.8593750
NODE_20615_length_646_cov_6.480804	410	490	0	10	80	0.1250000
NODE_20615_length_646_cov_6.480804	410	490	2	16	80	0.2000000
NODE_20615_length_646_cov_6.480804	410	490	6	54	80	0.6750000
NODE_20616_length_646_cov_6.396709	194	274	0	80	80	1.0000000
NODE_20616_length_646_cov_6.396709	254	327	0	73	73	1.0000000
NODE_20619_length_646_cov_4.652651	265	345	0	80	80	1.0000000
NODE_20623_length_646_cov_4.122486	401	452	2	51	51	1.0000000
NODE_20688_length_645_cov_95.882784	179	259	0	1	80	0.0125000
NODE_20688_length_645_cov_95.882784	179	259	3	36	80	0.4500000
NODE_20688_length_645_cov_95.882784	179	259	4	43	80	0.5375000
NODE_20688_length_645_cov_95.882784	232	312	0	54	80	0.6750000
NODE_20688_length_645_cov_95.882784	232	312	4	26	80	0.3250000
NODE_20689_length_645_cov_12.985348	343	423	0	31	80	0.3875000
NODE_20689_length_645_cov_12.985348	343	423	4	49	80	0.6125000
NODE_20689_length_645_cov_12.985348	396	476	0	80	80	1.0000000
NODE_20691_length_645_cov_9.228938	254	334	0	55	80	0.6875000
NODE_20691_length_645_cov_9.228938	254	334	2	16	80	0.2000000
NODE_20691_length_645_cov_9.228938	254	334	4	9	80	0.1125000
NODE_20691_length_645_cov_9.228938	307	387	0	2	80	0.0250000
NODE_20691_length_645_cov_9.228938	307	387	2	16	80	0.2000000
NODE_20691_length_645_cov_9.228938	307	387	4	32	80	0.4000000
NODE_20691_length_645_cov_9.228938	307	387	8	30	80	0.3750000
NODE_20692_length_645_cov_9.172161	293	373	0	80	80	1.0000000
NODE_20692_length_645_cov_9.172161	346	426	0	80	80	1.0000000
NODE_20697_length_645_cov_5.609890	461	541	0	80	80	1.0000000
NODE_20697_length_645_cov_5.609890	514	594	0	80	80	1.0000000
NODE_20698_length_645_cov_4.743590	237	317	0	80	80	1.0000000
NODE_20698_length_645_cov_4.743590	290	370	0	80	80	1.0000000
NODE_20716_length_645_cov_2.177656	373	416	0	43	43	1.0000000
NODE_20762_length_644_cov_59.286239	323	401	143	2	78	0.0256410
NODE_20762_length_644_cov_59.286239	323	401	145	1	78	0.0128205
NODE_20762_length_644_cov_59.286239	323	401	147	1	78	0.0128205
NODE_20762_length_644_cov_59.286239	323	401	149	1	78	0.0128205
NODE_20762_length_644_cov_59.286239	323	401	151	1	78	0.0128205
NODE_20762_length_644_cov_59.286239	323	401	159	2	78	0.0256410
NODE_20762_length_644_cov_59.286239	323	401	161	2	78	0.0256410
NODE_20762_length_644_cov_59.286239	323	401	163	2	78	0.0256410
NODE_20762_length_644_cov_59.286239	323	401	165	3	78	0.0384615
NODE_20762_length_644_cov_59.286239	323	401	173	2	78	0.0256410
NODE_20762_length_644_cov_59.286239	323	401	177	1	78	0.0128205
NODE_20762_length_644_cov_59.286239	323	401	185	2	78	0.0256410
NODE_20762_length_644_cov_59.286239	323	401	187	1	78	0.0128205
NODE_20762_length_644_cov_59.286239	323	401	188	1	78	0.0128205
NODE_20762_length_644_cov_59.286239	323	401	190	2	78	0.0256410
NODE_20762_length_644_cov_59.286239	323	401	191	1	78	0.0128205
NODE_20762_length_644_cov_59.286239	323	401	193	2	78	0.0256410
NODE_20762_length_644_cov_59.286239	323	401	195	2	78	0.0256410
NODE_20762_length_644_cov_59.286239	323	401	200	1	78	0.0128205
NODE_20762_length_644_cov_59.286239	323	401	202	1	78	0.0128205
NODE_20762_length_644_cov_59.286239	323	401	204	1	78	0.0128205
NODE_20762_length_644_cov_59.286239	323	401	216	1	78	0.0128205
NODE_20762_length_644_cov_59.286239	323	401	218	1	78	0.0128205
NODE_20762_length_644_cov_59.286239	323	401	220	1	78	0.0128205
NODE_20762_length_644_cov_59.286239	323	401	226	1	78	0.0128205
NODE_20762_length_644_cov_59.286239	323	401	229	1	78	0.0128205
NODE_20762_length_644_cov_59.286239	323	401	233	1	78	0.0128205
NODE_20762_length_644_cov_59.286239	323	401	235	1	78	0.0128205
NODE_20762_length_644_cov_59.286239	323	401	238	2	78	0.0256410
NODE_20762_length_644_cov_59.286239	323	401	242	1	78	0.0128205
NODE_20762_length_644_cov_59.286239	323	401	244	1	78	0.0128205
NODE_20762_length_644_cov_59.286239	323	401	250	1	78	0.0128205
NODE_20762_length_644_cov_59.286239	323	401	251	1	78	0.0128205
NODE_20762_length_644_cov_59.286239	323	401	257	1	78	0.0128205
NODE_20762_length_644_cov_59.286239	323	401	259	3	78	0.0384615
NODE_20762_length_644_cov_59.286239	323	401	261	1	78	0.0128205
NODE_20762_length_644_cov_59.286239	323	401	268	1	78	0.0128205
NODE_20762_length_644_cov_59.286239	323	401	274	1	78	0.0128205
NODE_20762_length_644_cov_59.286239	323	401	276	1	78	0.0128205
NODE_20762_length_644_cov_59.286239	323	401	278	1	78	0.0128205
NODE_20762_length_644_cov_59.286239	323	401	286	1	78	0.0128205
NODE_20762_length_644_cov_59.286239	323	401	293	1	78	0.0128205
NODE_20762_length_644_cov_59.286239	323	401	295	1	78	0.0128205
NODE_20762_length_644_cov_59.286239	323	401	301	1	78	0.0128205
NODE_20762_length_644_cov_59.286239	323	401	305	1	78	0.0128205
NODE_20762_length_644_cov_59.286239	323	401	309	1	78	0.0128205
NODE_20762_length_644_cov_59.286239	323	401	310	1	78	0.0128205
NODE_20762_length_644_cov_59.286239	323	401	316	1	78	0.0128205
NODE_20762_length_644_cov_59.286239	323	401	317	3	78	0.0384615
NODE_20762_length_644_cov_59.286239	323	401	319	2	78	0.0256410
NODE_20762_length_644_cov_59.286239	323	401	321	3	78	0.0384615
NODE_20762_length_644_cov_59.286239	323	401	323	1	78	0.0128205
NODE_20762_length_644_cov_59.286239	323	401	325	2	78	0.0256410
NODE_20762_length_644_cov_59.286239	323	401	326	3	78	0.0384615
NODE_20762_length_644_cov_59.286239	323	401	328	1	78	0.0128205
NODE_20762_length_644_cov_59.286239	323	401	330	1	78	0.0128205
NODE_20763_length_644_cov_27.577982	63	143	0	75	80	0.9375000
NODE_20763_length_644_cov_27.577982	63	143	2	5	80	0.0625000
NODE_20763_length_644_cov_27.577982	116	196	0	22	80	0.2750000
NODE_20763_length_644_cov_27.577982	116	196	2	52	80	0.6500000
NODE_20763_length_644_cov_27.577982	116	196	4	6	80	0.0750000
NODE_20765_length_644_cov_10.073394	284	364	0	6	80	0.0750000
NODE_20765_length_644_cov_10.073394	284	364	2	74	80	0.9250000
NODE_20765_length_644_cov_10.073394	337	417	0	57	80	0.7125000
NODE_20765_length_644_cov_10.073394	337	417	2	23	80	0.2875000
NODE_20845_length_643_cov_27.562500	201	281	0	44	80	0.5500000
NODE_20845_length_643_cov_27.562500	201	281	2	36	80	0.4500000
NODE_20845_length_643_cov_27.562500	254	334	0	4	80	0.0500000
NODE_20845_length_643_cov_27.562500	254	334	2	76	80	0.9500000
NODE_20845_length_643_cov_27.562500	330	410	0	10	80	0.1250000
NODE_20845_length_643_cov_27.562500	330	410	6	15	80	0.1875000
NODE_20845_length_643_cov_27.562500	330	410	8	55	80	0.6875000
NODE_20845_length_643_cov_27.562500	383	463	2	17	80	0.2125000
NODE_20845_length_643_cov_27.562500	383	463	6	16	80	0.2000000
NODE_20845_length_643_cov_27.562500	383	463	8	47	80	0.5875000
NODE_20846_length_643_cov_12.895221	203	283	0	61	80	0.7625000
NODE_20846_length_643_cov_12.895221	203	283	2	19	80	0.2375000
NODE_20846_length_643_cov_12.895221	256	336	0	8	80	0.1000000
NODE_20846_length_643_cov_12.895221	256	336	2	72	80	0.9000000
NODE_20847_length_643_cov_10.501838	280	360	0	80	80	1.0000000
NODE_20847_length_643_cov_10.501838	333	413	0	80	80	1.0000000
NODE_20848_length_643_cov_9.136029	307	385	0	8	78	0.1025641
NODE_20848_length_643_cov_9.136029	307	385	2	1	78	0.0128205
NODE_20848_length_643_cov_9.136029	307	385	6	2	78	0.0256410
NODE_20848_length_643_cov_9.136029	307	385	8	67	78	0.8589743
NODE_20848_length_643_cov_9.136029	358	438	2	37	80	0.4625000
NODE_20848_length_643_cov_9.136029	358	438	6	4	80	0.0500000
NODE_20848_length_643_cov_9.136029	358	438	8	39	80	0.4875000
NODE_20849_length_643_cov_8.264706	202	282	0	80	80	1.0000000
NODE_20849_length_643_cov_8.264706	255	335	0	69	80	0.8625000
NODE_20849_length_643_cov_8.264706	255	335	4	11	80	0.1375000
NODE_20851_length_643_cov_7.137868	173	253	0	80	80	1.0000000
NODE_20851_length_643_cov_7.137868	226	306	0	80	80	1.0000000
NODE_20855_length_643_cov_5.851103	255	335	25	5	80	0.0625000
NODE_20855_length_643_cov_5.851103	255	335	27	8	80	0.1000000
NODE_20855_length_643_cov_5.851103	255	335	28	5	80	0.0625000
NODE_20855_length_643_cov_5.851103	255	335	29	4	80	0.0500000
NODE_20855_length_643_cov_5.851103	255	335	31	2	80	0.0250000
NODE_20855_length_643_cov_5.851103	255	335	33	9	80	0.1125000
NODE_20855_length_643_cov_5.851103	255	335	35	3	80	0.0375000
NODE_20855_length_643_cov_5.851103	255	335	36	12	80	0.1500000
NODE_20855_length_643_cov_5.851103	255	335	37	12	80	0.1500000
NODE_20855_length_643_cov_5.851103	255	335	38	20	80	0.2500000
NODE_20855_length_643_cov_5.851103	308	388	6	4	80	0.0500000
NODE_20855_length_643_cov_5.851103	308	388	7	2	80	0.0250000
NODE_20855_length_643_cov_5.851103	308	388	9	2	80	0.0250000
NODE_20855_length_643_cov_5.851103	308	388	10	15	80	0.1875000
NODE_20855_length_643_cov_5.851103	308	388	11	5	80	0.0625000
NODE_20855_length_643_cov_5.851103	308	388	12	6	80	0.0750000
NODE_20855_length_643_cov_5.851103	308	388	14	1	80	0.0125000
NODE_20855_length_643_cov_5.851103	308	388	16	5	80	0.0625000
NODE_20855_length_643_cov_5.851103	308	388	17	1	80	0.0125000
NODE_20855_length_643_cov_5.851103	308	388	19	2	80	0.0250000
NODE_20855_length_643_cov_5.851103	308	388	21	5	80	0.0625000
NODE_20855_length_643_cov_5.851103	308	388	23	1	80	0.0125000
NODE_20855_length_643_cov_5.851103	308	388	25	9	80	0.1125000
NODE_20855_length_643_cov_5.851103	308	388	27	8	80	0.1000000
NODE_20855_length_643_cov_5.851103	308	388	28	5	80	0.0625000
NODE_20855_length_643_cov_5.851103	308	388	29	4	80	0.0500000
NODE_20855_length_643_cov_5.851103	308	388	31	2	80	0.0250000
NODE_20855_length_643_cov_5.851103	308	388	33	3	80	0.0375000
NODE_20869_length_643_cov_3.121324	283	348	0	37	65	0.5692308
NODE_20869_length_643_cov_3.121324	283	348	2	28	65	0.4307692
NODE_20872_length_643_cov_2.806985	387	451	0	64	64	1.0000000
NODE_20942_length_642_cov_36.309392	156	236	0	45	80	0.5625000
NODE_20942_length_642_cov_36.309392	156	236	2	35	80	0.4375000
NODE_20942_length_642_cov_36.309392	209	289	0	30	80	0.3750000
NODE_20942_length_642_cov_36.309392	209	289	2	50	80	0.6250000
NODE_20943_length_642_cov_27.046041	154	234	0	80	80	1.0000000
NODE_20943_length_642_cov_27.046041	207	287	0	80	80	1.0000000
NODE_20944_length_642_cov_26.290976	209	289	0	20	80	0.2500000
NODE_20944_length_642_cov_26.290976	209	289	6	45	80	0.5625000
NODE_20944_length_642_cov_26.290976	209	289	8	15	80	0.1875000
NODE_20944_length_642_cov_26.290976	262	342	6	12	80	0.1500000
NODE_20944_length_642_cov_26.290976	262	342	8	68	80	0.8500000
NODE_20945_length_642_cov_11.651934	309	389	2	9	80	0.1125000
NODE_20945_length_642_cov_11.651934	309	389	4	71	80	0.8875000
NODE_20945_length_642_cov_11.651934	362	442	2	22	80	0.2750000
NODE_20945_length_642_cov_11.651934	362	442	4	58	80	0.7250000
NODE_20947_length_642_cov_6.692449	453	533	0	55	80	0.6875000
NODE_20947_length_642_cov_6.692449	453	533	2	25	80	0.3125000
NODE_20947_length_642_cov_6.692449	506	586	0	80	80	1.0000000
NODE_20951_length_642_cov_5.933702	260	340	0	80	80	1.0000000
NODE_20951_length_642_cov_5.933702	313	391	0	78	78	1.0000000
NODE_20967_length_642_cov_2.823204	115	158	16	9	43	0.2093023
NODE_20967_length_642_cov_2.823204	115	158	18	5	43	0.1162791
NODE_20967_length_642_cov_2.823204	115	158	20	16	43	0.3720930
NODE_20967_length_642_cov_2.823204	115	158	22	13	43	0.3023256
NODE_20967_length_642_cov_2.823204	245	300	27	2	55	0.0363636
NODE_20967_length_642_cov_2.823204	245	300	29	4	55	0.0727273
NODE_20967_length_642_cov_2.823204	245	300	31	21	55	0.3818182
NODE_20967_length_642_cov_2.823204	245	300	32	1	55	0.0181818
NODE_20967_length_642_cov_2.823204	245	300	33	10	55	0.1818182
NODE_20967_length_642_cov_2.823204	245	300	35	10	55	0.1818182
NODE_20967_length_642_cov_2.823204	245	300	37	7	55	0.1272727
NODE_20967_length_642_cov_2.823204	329	410	36	1	81	0.0123457
NODE_20967_length_642_cov_2.823204	329	410	38	1	81	0.0123457
NODE_20967_length_642_cov_2.823204	329	410	40	7	81	0.0864198
NODE_20967_length_642_cov_2.823204	329	410	41	13	81	0.1604938
NODE_20967_length_642_cov_2.823204	329	410	42	15	81	0.1851852
NODE_20967_length_642_cov_2.823204	329	410	43	22	81	0.2716049
NODE_20967_length_642_cov_2.823204	329	410	44	10	81	0.1234568
NODE_20967_length_642_cov_2.823204	329	410	45	11	81	0.1358025
NODE_20967_length_642_cov_2.823204	329	410	46	1	81	0.0123457
NODE_20991_length_642_cov_1.357274	0	75	0	71	75	0.9466667
NODE_20991_length_642_cov_1.357274	0	75	2	4	75	0.0533333
NODE_21018_length_641_cov_38.675277	284	345	2	3	61	0.0491803
NODE_21018_length_641_cov_38.675277	284	345	3	10	61	0.1639344
NODE_21018_length_641_cov_38.675277	284	345	9	1	61	0.0163934
NODE_21018_length_641_cov_38.675277	284	345	16	11	61	0.1803279
NODE_21018_length_641_cov_38.675277	284	345	28	1	61	0.0163934
NODE_21018_length_641_cov_38.675277	284	345	29	3	61	0.0491803
NODE_21018_length_641_cov_38.675277	284	345	30	18	61	0.2950820
NODE_21018_length_641_cov_38.675277	284	345	31	1	61	0.0163934
NODE_21018_length_641_cov_38.675277	284	345	32	13	61	0.2131148
NODE_21018_length_641_cov_38.675277	318	369	30	13	51	0.2549020
NODE_21018_length_641_cov_38.675277	318	369	31	1	51	0.0196078
NODE_21018_length_641_cov_38.675277	318	369	32	13	51	0.2549020
NODE_21018_length_641_cov_38.675277	318	369	33	1	51	0.0196078
NODE_21018_length_641_cov_38.675277	318	369	35	3	51	0.0588235
NODE_21018_length_641_cov_38.675277	318	369	36	19	51	0.3725490
NODE_21018_length_641_cov_38.675277	318	369	37	1	51	0.0196078
NODE_21019_length_641_cov_15.271218	260	340	0	80	80	1.0000000
NODE_21019_length_641_cov_15.271218	313	393	0	80	80	1.0000000
NODE_21021_length_641_cov_12.584871	363	443	0	80	80	1.0000000
NODE_21021_length_641_cov_12.584871	416	496	0	80	80	1.0000000
NODE_21022_length_641_cov_11.125461	38	118	0	11	80	0.1375000
NODE_21022_length_641_cov_11.125461	38	118	2	69	80	0.8625000
NODE_21022_length_641_cov_11.125461	91	171	0	60	80	0.7500000
NODE_21022_length_641_cov_11.125461	91	171	2	20	80	0.2500000
NODE_21025_length_641_cov_7.719557	84	138	0	54	54	1.0000000
NODE_21025_length_641_cov_7.719557	113	193	0	80	80	1.0000000
NODE_21026_length_641_cov_7.675277	232	312	0	80	80	1.0000000
NODE_21026_length_641_cov_7.675277	285	365	0	80	80	1.0000000
NODE_21027_length_641_cov_7.675277	255	335	8	25	80	0.3125000
NODE_21027_length_641_cov_7.675277	255	335	9	1	80	0.0125000
NODE_21027_length_641_cov_7.675277	255	335	10	54	80	0.6750000
NODE_21027_length_641_cov_7.675277	308	388	2	17	80	0.2125000
NODE_21027_length_641_cov_7.675277	308	388	4	21	80	0.2625000
NODE_21027_length_641_cov_7.675277	308	388	8	21	80	0.2625000
NODE_21027_length_641_cov_7.675277	308	388	10	21	80	0.2625000
NODE_21028_length_641_cov_7.627306	262	342	0	80	80	1.0000000
NODE_21028_length_641_cov_7.627306	315	395	0	80	80	1.0000000
NODE_21029_length_641_cov_7.282288	247	300	0	53	53	1.0000000
NODE_21031_length_641_cov_5.029520	138	218	0	80	80	1.0000000
NODE_21031_length_641_cov_5.029520	191	271	0	80	80	1.0000000
NODE_21034_length_641_cov_4.701107	238	282	0	6	44	0.1363636
NODE_21034_length_641_cov_4.701107	238	282	2	38	44	0.8636364
NODE_21109_length_640_cov_39.676525	524	597	37	1	73	0.0136986
NODE_21109_length_640_cov_39.676525	524	597	39	7	73	0.0958904
NODE_21109_length_640_cov_39.676525	524	597	41	2	73	0.0273973
NODE_21109_length_640_cov_39.676525	524	597	42	6	73	0.0821918
NODE_21109_length_640_cov_39.676525	524	597	44	4	73	0.0547945
NODE_21109_length_640_cov_39.676525	524	597	46	1	73	0.0136986
NODE_21109_length_640_cov_39.676525	524	597	48	2	73	0.0273973
NODE_21109_length_640_cov_39.676525	524	597	50	5	73	0.0684932
NODE_21109_length_640_cov_39.676525	524	597	52	1	73	0.0136986
NODE_21109_length_640_cov_39.676525	524	597	54	3	73	0.0410959
NODE_21109_length_640_cov_39.676525	524	597	56	3	73	0.0410959
NODE_21109_length_640_cov_39.676525	524	597	57	1	73	0.0136986
NODE_21109_length_640_cov_39.676525	524	597	58	3	73	0.0410959
NODE_21109_length_640_cov_39.676525	524	597	64	6	73	0.0821918
NODE_21109_length_640_cov_39.676525	524	597	67	2	73	0.0273973
NODE_21109_length_640_cov_39.676525	524	597	68	2	73	0.0273973
NODE_21109_length_640_cov_39.676525	524	597	70	2	73	0.0273973
NODE_21109_length_640_cov_39.676525	524	597	72	3	73	0.0410959
NODE_21109_length_640_cov_39.676525	524	597	73	1	73	0.0136986
NODE_21109_length_640_cov_39.676525	524	597	74	6	73	0.0821918
NODE_21109_length_640_cov_39.676525	524	597	75	3	73	0.0410959
NODE_21109_length_640_cov_39.676525	524	597	76	8	73	0.1095890
NODE_21109_length_640_cov_39.676525	524	597	78	1	73	0.0136986
NODE_21109_length_640_cov_39.676525	564	605	34	4	41	0.0975610
NODE_21109_length_640_cov_39.676525	564	605	37	5	41	0.1219512
NODE_21109_length_640_cov_39.676525	564	605	39	7	41	0.1707317
NODE_21109_length_640_cov_39.676525	564	605	41	2	41	0.0487805
NODE_21109_length_640_cov_39.676525	564	605	42	6	41	0.1463415
NODE_21109_length_640_cov_39.676525	564	605	44	4	41	0.0975610
NODE_21109_length_640_cov_39.676525	564	605	46	1	41	0.0243902
NODE_21109_length_640_cov_39.676525	564	605	48	2	41	0.0487805
NODE_21109_length_640_cov_39.676525	564	605	50	5	41	0.1219512
NODE_21109_length_640_cov_39.676525	564	605	52	1	41	0.0243902
NODE_21109_length_640_cov_39.676525	564	605	54	3	41	0.0731707
NODE_21109_length_640_cov_39.676525	564	605	56	1	41	0.0243902
NODE_21110_length_640_cov_19.578558	273	353	0	80	80	1.0000000
NODE_21110_length_640_cov_19.578558	326	406	0	80	80	1.0000000
NODE_21111_length_640_cov_15.717190	178	258	0	41	80	0.5125000
NODE_21111_length_640_cov_15.717190	178	258	2	39	80	0.4875000
NODE_21111_length_640_cov_15.717190	231	311	0	16	80	0.2000000
NODE_21111_length_640_cov_15.717190	231	311	2	64	80	0.8000000
NODE_21112_length_640_cov_15.338262	319	399	0	77	80	0.9625000
NODE_21112_length_640_cov_15.338262	319	399	2	3	80	0.0375000
NODE_21112_length_640_cov_15.338262	372	452	0	80	80	1.0000000
NODE_21113_length_640_cov_9.523105	20	43	0	23	23	1.0000000
NODE_21118_length_640_cov_5.123845	272	335	0	63	63	1.0000000
NODE_21121_length_640_cov_4.410351	254	334	0	80	80	1.0000000
NODE_21121_length_640_cov_4.410351	307	387	0	80	80	1.0000000
NODE_21129_length_640_cov_3.406654	244	324	2	12	80	0.1500000
NODE_21129_length_640_cov_3.406654	244	324	4	68	80	0.8500000
NODE_21140_length_640_cov_2.316081	21	57	0	36	36	1.0000000
NODE_21190_length_639_cov_58.092593	302	377	0	75	75	1.0000000
NODE_21190_length_639_cov_58.092593	350	430	0	80	80	1.0000000
NODE_21191_length_639_cov_32.951852	213	293	0	31	80	0.3875000
NODE_21191_length_639_cov_32.951852	213	293	2	49	80	0.6125000
NODE_21191_length_639_cov_32.951852	266	346	0	80	80	1.0000000
NODE_21192_length_639_cov_24.564815	290	370	0	80	80	1.0000000
NODE_21192_length_639_cov_24.564815	343	423	0	80	80	1.0000000
NODE_21193_length_639_cov_14.448148	288	368	0	80	80	1.0000000
NODE_21193_length_639_cov_14.448148	341	421	0	56	80	0.7000000
NODE_21193_length_639_cov_14.448148	341	421	2	24	80	0.3000000
NODE_21195_length_639_cov_9.001852	265	345	0	80	80	1.0000000
NODE_21195_length_639_cov_9.001852	318	398	0	80	80	1.0000000
NODE_21197_length_639_cov_8.444444	161	241	0	57	80	0.7125000
NODE_21197_length_639_cov_8.444444	161	241	4	23	80	0.2875000
NODE_21197_length_639_cov_8.444444	214	294	0	4	80	0.0500000
NODE_21197_length_639_cov_8.444444	214	294	3	35	80	0.4375000
NODE_21197_length_639_cov_8.444444	214	294	4	41	80	0.5125000
NODE_21202_length_639_cov_6.283333	157	176	0	19	19	1.0000000
NODE_21207_length_639_cov_4.188889	258	335	0	77	77	1.0000000
NODE_21207_length_639_cov_4.188889	308	354	0	46	46	1.0000000
NODE_21213_length_639_cov_3.448148	126	206	4	80	80	1.0000000
NODE_21213_length_639_cov_3.448148	179	259	0	46	80	0.5750000
NODE_21213_length_639_cov_3.448148	179	259	4	34	80	0.4250000
NODE_21223_length_639_cov_2.683333	256	288	0	32	32	1.0000000
NODE_21224_length_639_cov_2.555556	189	240	18	12	51	0.2352941
NODE_21224_length_639_cov_2.555556	189	240	20	22	51	0.4313726
NODE_21224_length_639_cov_2.555556	189	240	21	17	51	0.3333333
NODE_21225_length_639_cov_2.477778	562	635	0	4	73	0.0547945
NODE_21225_length_639_cov_2.477778	562	635	2	69	73	0.9452055
NODE_21265_length_639_cov_1.179630	542	564	0	22	22	1.0000000
NODE_21269_length_639_cov_1.051852	404	455	0	51	51	1.0000000
NODE_21278_length_638_cov_13.018553	273	353	6	68	80	0.8500000
NODE_21278_length_638_cov_13.018553	273	353	10	12	80	0.1500000
NODE_21278_length_638_cov_13.018553	326	406	0	27	80	0.3375000
NODE_21278_length_638_cov_13.018553	326	406	4	20	80	0.2500000
NODE_21278_length_638_cov_13.018553	326	406	6	33	80	0.4125000
NODE_21279_length_638_cov_12.656772	343	423	4	80	80	1.0000000
NODE_21279_length_638_cov_12.656772	396	476	0	27	80	0.3375000
NODE_21279_length_638_cov_12.656772	396	476	4	53	80	0.6625000
NODE_21280_length_638_cov_11.877551	298	378	0	80	80	1.0000000
NODE_21280_length_638_cov_11.877551	351	431	0	59	80	0.7375000
NODE_21280_length_638_cov_11.877551	351	431	2	21	80	0.2625000
NODE_21281_length_638_cov_8.779221	330	408	4	40	78	0.5128205
NODE_21281_length_638_cov_8.779221	330	408	6	38	78	0.4871795
NODE_21281_length_638_cov_8.779221	383	461	2	25	78	0.3205128
NODE_21281_length_638_cov_8.779221	383	461	6	53	78	0.6794872
NODE_21284_length_638_cov_5.543599	315	395	0	80	80	1.0000000
NODE_21290_length_638_cov_3.966605	307	387	0	80	80	1.0000000
NODE_21301_length_638_cov_2.786642	157	208	0	51	51	1.0000000
NODE_21301_length_638_cov_2.786642	181	261	0	39	80	0.4875000
NODE_21301_length_638_cov_2.786642	181	261	2	41	80	0.5125000
NODE_21364_length_637_cov_67.157993	285	365	0	80	80	1.0000000
NODE_21364_length_637_cov_67.157993	338	418	0	80	80	1.0000000
NODE_21364_length_637_cov_67.157993	414	494	0	80	80	1.0000000
NODE_21364_length_637_cov_67.157993	467	547	0	80	80	1.0000000
NODE_21365_length_637_cov_63.029740	195	275	0	80	80	1.0000000
NODE_21365_length_637_cov_63.029740	248	328	0	80	80	1.0000000
NODE_21366_length_637_cov_44.923792	53	133	0	76	80	0.9500000
NODE_21366_length_637_cov_44.923792	53	133	2	4	80	0.0500000
NODE_21366_length_637_cov_44.923792	54	133	0	75	79	0.9493671
NODE_21366_length_637_cov_44.923792	54	133	2	4	79	0.0506329
NODE_21366_length_637_cov_44.923792	106	186	0	41	80	0.5125000
NODE_21366_length_637_cov_44.923792	106	186	2	39	80	0.4875000
NODE_21366_length_637_cov_44.923792	106	186	0	41	80	0.5125000
NODE_21366_length_637_cov_44.923792	106	186	2	39	80	0.4875000
NODE_21366_length_637_cov_44.923792	182	262	0	80	80	1.0000000
NODE_21366_length_637_cov_44.923792	235	315	0	80	80	1.0000000
NODE_21367_length_637_cov_44.193309	193	273	0	80	80	1.0000000
NODE_21367_length_637_cov_44.193309	246	326	0	80	80	1.0000000
NODE_21368_length_637_cov_37.855019	215	295	18	5	80	0.0625000
NODE_21368_length_637_cov_37.855019	215	295	31	2	80	0.0250000
NODE_21368_length_637_cov_37.855019	215	295	32	37	80	0.4625000
NODE_21368_length_637_cov_37.855019	215	295	33	36	80	0.4500000
NODE_21368_length_637_cov_37.855019	268	347	2	41	79	0.5189874
NODE_21368_length_637_cov_37.855019	268	347	15	1	79	0.0126582
NODE_21368_length_637_cov_37.855019	268	347	17	8	79	0.1012658
NODE_21368_length_637_cov_37.855019	268	347	18	7	79	0.0886076
NODE_21368_length_637_cov_37.855019	268	347	32	1	79	0.0126582
NODE_21368_length_637_cov_37.855019	268	347	33	21	79	0.2658228
NODE_21369_length_637_cov_33.957249	332	412	2	80	80	1.0000000
NODE_21369_length_637_cov_33.957249	385	465	0	31	80	0.3875000
NODE_21369_length_637_cov_33.957249	385	465	2	49	80	0.6125000
NODE_21370_length_637_cov_23.682156	275	355	0	80	80	1.0000000
NODE_21370_length_637_cov_23.682156	328	408	0	52	80	0.6500000
NODE_21370_length_637_cov_23.682156	328	408	2	28	80	0.3500000
NODE_21371_length_637_cov_19.676580	267	347	0	80	80	1.0000000
NODE_21371_length_637_cov_19.676580	320	400	0	80	80	1.0000000
NODE_21373_length_637_cov_9.182156	226	276	0	50	50	1.0000000
NODE_21373_length_637_cov_9.182156	312	357	0	45	45	1.0000000
NODE_21374_length_637_cov_9.078067	276	357	0	31	81	0.3827161
NODE_21374_length_637_cov_9.078067	276	357	2	6	81	0.0740741
NODE_21374_length_637_cov_9.078067	276	357	4	3	81	0.0370370
NODE_21374_length_637_cov_9.078067	276	357	6	2	81	0.0246914
NODE_21374_length_637_cov_9.078067	276	357	12	3	81	0.0370370
NODE_21374_length_637_cov_9.078067	276	357	14	34	81	0.4197531
NODE_21374_length_637_cov_9.078067	276	357	16	2	81	0.0246914
NODE_21374_length_637_cov_9.078067	330	410	0	80	80	1.0000000
NODE_21375_length_637_cov_8.566914	235	315	0	80	80	1.0000000
NODE_21375_length_637_cov_8.566914	288	368	0	80	80	1.0000000
NODE_21378_length_637_cov_6.652416	337	415	0	76	78	0.9743590
NODE_21378_length_637_cov_6.652416	337	415	2	2	78	0.0256410
NODE_21378_length_637_cov_6.652416	390	472	0	23	82	0.2804878
NODE_21378_length_637_cov_6.652416	390	472	2	59	82	0.7195122
NODE_21385_length_637_cov_4.522305	284	364	0	80	80	1.0000000
NODE_21385_length_637_cov_4.522305	337	417	0	80	80	1.0000000
NODE_21389_length_637_cov_4.131970	292	370	0	78	78	1.0000000
NODE_21389_length_637_cov_4.131970	343	423	0	80	80	1.0000000
NODE_21457_length_636_cov_19.938547	214	294	0	3	80	0.0375000
NODE_21457_length_636_cov_19.938547	214	294	5	1	80	0.0125000
NODE_21457_length_636_cov_19.938547	214	294	6	23	80	0.2875000
NODE_21457_length_636_cov_19.938547	214	294	8	53	80	0.6625000
NODE_21457_length_636_cov_19.938547	267	347	2	9	80	0.1125000
NODE_21457_length_636_cov_19.938547	267	347	8	71	80	0.8875000
NODE_21458_length_636_cov_12.283054	295	375	0	70	80	0.8750000
NODE_21458_length_636_cov_12.283054	295	375	2	10	80	0.1250000
NODE_21458_length_636_cov_12.283054	348	428	0	17	80	0.2125000
NODE_21458_length_636_cov_12.283054	348	428	2	63	80	0.7875000
NODE_21460_length_636_cov_8.312849	346	413	0	67	67	1.0000000
NODE_21460_length_636_cov_8.312849	399	479	0	80	80	1.0000000
NODE_21467_length_636_cov_4.324022	185	251	0	66	66	1.0000000
NODE_21467_length_636_cov_4.324022	224	266	0	42	42	1.0000000
NODE_21467_length_636_cov_4.324022	224	264	0	40	40	1.0000000
NODE_21539_length_635_cov_45.483209	195	239	234	1	44	0.0227273
NODE_21539_length_635_cov_45.483209	195	239	235	2	44	0.0454545
NODE_21539_length_635_cov_45.483209	195	239	239	3	44	0.0681818
NODE_21539_length_635_cov_45.483209	195	239	244	1	44	0.0227273
NODE_21539_length_635_cov_45.483209	195	239	245	5	44	0.1136364
NODE_21539_length_635_cov_45.483209	195	239	246	1	44	0.0227273
NODE_21539_length_635_cov_45.483209	195	239	247	5	44	0.1136364
NODE_21539_length_635_cov_45.483209	195	239	248	2	44	0.0454545
NODE_21539_length_635_cov_45.483209	195	239	249	5	44	0.1136364
NODE_21539_length_635_cov_45.483209	195	239	251	1	44	0.0227273
NODE_21539_length_635_cov_45.483209	195	239	252	5	44	0.1136364
NODE_21539_length_635_cov_45.483209	195	239	253	4	44	0.0909091
NODE_21539_length_635_cov_45.483209	195	239	254	3	44	0.0681818
NODE_21539_length_635_cov_45.483209	195	239	255	2	44	0.0454545
NODE_21539_length_635_cov_45.483209	195	239	256	3	44	0.0681818
NODE_21539_length_635_cov_45.483209	195	239	257	1	44	0.0227273
NODE_21539_length_635_cov_45.483209	225	268	176	1	43	0.0232558
NODE_21539_length_635_cov_45.483209	225	268	182	1	43	0.0232558
NODE_21539_length_635_cov_45.483209	225	268	186	1	43	0.0232558
NODE_21539_length_635_cov_45.483209	225	268	190	3	43	0.0697674
NODE_21539_length_635_cov_45.483209	225	268	192	2	43	0.0465116
NODE_21539_length_635_cov_45.483209	225	268	200	2	43	0.0465116
NODE_21539_length_635_cov_45.483209	225	268	210	1	43	0.0232558
NODE_21539_length_635_cov_45.483209	225	268	212	1	43	0.0232558
NODE_21539_length_635_cov_45.483209	225	268	214	2	43	0.0465116
NODE_21539_length_635_cov_45.483209	225	268	218	2	43	0.0465116
NODE_21539_length_635_cov_45.483209	225	268	220	1	43	0.0232558
NODE_21539_length_635_cov_45.483209	225	268	224	3	43	0.0697674
NODE_21539_length_635_cov_45.483209	225	268	228	1	43	0.0232558
NODE_21539_length_635_cov_45.483209	225	268	232	1	43	0.0232558
NODE_21539_length_635_cov_45.483209	225	268	233	3	43	0.0697674
NODE_21539_length_635_cov_45.483209	225	268	237	2	43	0.0465116
NODE_21539_length_635_cov_45.483209	225	268	239	4	43	0.0930233
NODE_21539_length_635_cov_45.483209	225	268	244	1	43	0.0232558
NODE_21539_length_635_cov_45.483209	225	268	245	2	43	0.0465116
NODE_21539_length_635_cov_45.483209	225	268	246	1	43	0.0232558
NODE_21539_length_635_cov_45.483209	225	268	247	1	43	0.0232558
NODE_21539_length_635_cov_45.483209	225	268	249	1	43	0.0232558
NODE_21539_length_635_cov_45.483209	225	268	252	2	43	0.0465116
NODE_21539_length_635_cov_45.483209	225	268	253	4	43	0.0930233
NODE_21539_length_635_cov_45.483209	248	298	99	1	50	0.0200000
NODE_21539_length_635_cov_45.483209	248	298	101	1	50	0.0200000
NODE_21539_length_635_cov_45.483209	248	298	105	1	50	0.0200000
NODE_21539_length_635_cov_45.483209	248	298	110	1	50	0.0200000
NODE_21539_length_635_cov_45.483209	248	298	112	1	50	0.0200000
NODE_21539_length_635_cov_45.483209	248	298	117	2	50	0.0400000
NODE_21539_length_635_cov_45.483209	248	298	118	2	50	0.0400000
NODE_21539_length_635_cov_45.483209	248	298	126	1	50	0.0200000
NODE_21539_length_635_cov_45.483209	248	298	128	3	50	0.0600000
NODE_21539_length_635_cov_45.483209	248	298	142	3	50	0.0600000
NODE_21539_length_635_cov_45.483209	248	298	146	2	50	0.0400000
NODE_21539_length_635_cov_45.483209	248	298	150	1	50	0.0200000
NODE_21539_length_635_cov_45.483209	248	298	154	1	50	0.0200000
NODE_21539_length_635_cov_45.483209	248	298	157	1	50	0.0200000
NODE_21539_length_635_cov_45.483209	248	298	159	1	50	0.0200000
NODE_21539_length_635_cov_45.483209	248	298	160	1	50	0.0200000
NODE_21539_length_635_cov_45.483209	248	298	170	1	50	0.0200000
NODE_21539_length_635_cov_45.483209	248	298	172	1	50	0.0200000
NODE_21539_length_635_cov_45.483209	248	298	173	1	50	0.0200000
NODE_21539_length_635_cov_45.483209	248	298	174	1	50	0.0200000
NODE_21539_length_635_cov_45.483209	248	298	176	1	50	0.0200000
NODE_21539_length_635_cov_45.483209	248	298	177	1	50	0.0200000
NODE_21539_length_635_cov_45.483209	248	298	178	1	50	0.0200000
NODE_21539_length_635_cov_45.483209	248	298	180	1	50	0.0200000
NODE_21539_length_635_cov_45.483209	248	298	182	1	50	0.0200000
NODE_21539_length_635_cov_45.483209	248	298	186	1	50	0.0200000
NODE_21539_length_635_cov_45.483209	248	298	190	3	50	0.0600000
NODE_21539_length_635_cov_45.483209	248	298	192	2	50	0.0400000
NODE_21539_length_635_cov_45.483209	248	298	200	2	50	0.0400000
NODE_21539_length_635_cov_45.483209	248	298	210	1	50	0.0200000
NODE_21539_length_635_cov_45.483209	248	298	212	1	50	0.0200000
NODE_21539_length_635_cov_45.483209	248	298	214	2	50	0.0400000
NODE_21539_length_635_cov_45.483209	248	298	218	2	50	0.0400000
NODE_21539_length_635_cov_45.483209	248	298	220	1	50	0.0200000
NODE_21539_length_635_cov_45.483209	248	298	224	3	50	0.0600000
NODE_21541_length_635_cov_23.895522	179	259	2	74	80	0.9250000
NODE_21541_length_635_cov_23.895522	179	259	4	6	80	0.0750000
NODE_21541_length_635_cov_23.895522	232	312	0	3	80	0.0375000
NODE_21541_length_635_cov_23.895522	232	312	2	71	80	0.8875000
NODE_21541_length_635_cov_23.895522	232	312	4	6	80	0.0750000
NODE_21543_length_635_cov_14.772388	48	128	2	24	80	0.3000000
NODE_21543_length_635_cov_14.772388	48	128	4	56	80	0.7000000
NODE_21543_length_635_cov_14.772388	101	181	0	24	80	0.3000000
NODE_21543_length_635_cov_14.772388	101	181	2	31	80	0.3875000
NODE_21543_length_635_cov_14.772388	101	181	4	25	80	0.3125000
NODE_21549_length_635_cov_6.180970	276	356	0	80	80	1.0000000
NODE_21549_length_635_cov_6.180970	329	409	0	80	80	1.0000000
NODE_21554_length_635_cov_4.421642	442	522	0	80	80	1.0000000
NODE_21560_length_635_cov_2.985075	296	376	6	1	80	0.0125000
NODE_21560_length_635_cov_2.985075	296	376	10	4	80	0.0500000
NODE_21560_length_635_cov_2.985075	296	376	14	4	80	0.0500000
NODE_21560_length_635_cov_2.985075	296	376	16	23	80	0.2875000
NODE_21560_length_635_cov_2.985075	296	376	20	34	80	0.4250000
NODE_21560_length_635_cov_2.985075	296	376	22	9	80	0.1125000
NODE_21560_length_635_cov_2.985075	296	376	24	5	80	0.0625000
NODE_21625_length_634_cov_53.315888	349	429	3	2	80	0.0250000
NODE_21625_length_634_cov_53.315888	349	429	4	34	80	0.4250000
NODE_21625_length_634_cov_53.315888	349	429	6	44	80	0.5500000
NODE_21625_length_634_cov_53.315888	402	482	1	31	80	0.3875000
NODE_21625_length_634_cov_53.315888	402	482	3	11	80	0.1375000
NODE_21625_length_634_cov_53.315888	402	482	4	35	80	0.4375000
NODE_21625_length_634_cov_53.315888	402	482	6	3	80	0.0375000
NODE_21626_length_634_cov_28.530841	156	236	6	21	80	0.2625000
NODE_21626_length_634_cov_28.530841	156	236	10	16	80	0.2000000
NODE_21626_length_634_cov_28.530841	156	236	12	14	80	0.1750000
NODE_21626_length_634_cov_28.530841	156	236	14	29	80	0.3625000
NODE_21626_length_634_cov_28.530841	209	289	0	37	80	0.4625000
NODE_21626_length_634_cov_28.530841	209	289	2	3	80	0.0375000
NODE_21626_length_634_cov_28.530841	209	289	4	3	80	0.0375000
NODE_21626_length_634_cov_28.530841	209	289	6	31	80	0.3875000
NODE_21626_length_634_cov_28.530841	209	289	14	6	80	0.0750000
NODE_21627_length_634_cov_19.117757	151	229	2	17	78	0.2179487
NODE_21627_length_634_cov_19.117757	151	229	4	61	78	0.7820513
NODE_21627_length_634_cov_19.117757	204	268	0	34	64	0.5312500
NODE_21627_length_634_cov_19.117757	204	268	2	6	64	0.0937500
NODE_21627_length_634_cov_19.117757	204	268	4	24	64	0.3750000
NODE_21628_length_634_cov_18.762617	84	164	0	80	80	1.0000000
NODE_21628_length_634_cov_18.762617	137	217	0	80	80	1.0000000
NODE_21629_length_634_cov_18.136449	162	242	0	53	80	0.6625000
NODE_21629_length_634_cov_18.136449	162	242	2	27	80	0.3375000
NODE_21629_length_634_cov_18.136449	215	295	0	19	80	0.2375000
NODE_21629_length_634_cov_18.136449	215	295	2	61	80	0.7625000
NODE_21635_length_634_cov_9.988785	508	553	0	45	45	1.0000000
NODE_21636_length_634_cov_9.381308	267	353	0	86	86	1.0000000
NODE_21636_length_634_cov_9.381308	324	404	0	80	80	1.0000000
NODE_21651_length_634_cov_3.702804	460	532	0	72	72	1.0000000
NODE_21720_length_633_cov_30.076779	180	214	0	34	34	1.0000000
NODE_21720_length_633_cov_30.076779	187	267	0	80	80	1.0000000
NODE_21720_length_633_cov_30.076779	263	343	0	26	80	0.3250000
NODE_21720_length_633_cov_30.076779	263	343	2	54	80	0.6750000
NODE_21720_length_633_cov_30.076779	316	396	0	29	80	0.3625000
NODE_21720_length_633_cov_30.076779	316	396	2	51	80	0.6375000
NODE_21721_length_633_cov_17.595506	282	362	0	30	80	0.3750000
NODE_21721_length_633_cov_17.595506	282	362	12	50	80	0.6250000
NODE_21721_length_633_cov_17.595506	335	415	12	80	80	1.0000000
NODE_21722_length_633_cov_17.327715	228	308	0	80	80	1.0000000
NODE_21722_length_633_cov_17.327715	281	361	0	80	80	1.0000000
NODE_21723_length_633_cov_9.689139	79	147	0	8	68	0.1176471
NODE_21723_length_633_cov_9.689139	79	147	2	3	68	0.0441176
NODE_21723_length_633_cov_9.689139	79	147	4	9	68	0.1323529
NODE_21723_length_633_cov_9.689139	79	147	6	4	68	0.0588235
NODE_21723_length_633_cov_9.689139	79	147	8	5	68	0.0735294
NODE_21723_length_633_cov_9.689139	79	147	10	39	68	0.5735294
NODE_21729_length_633_cov_7.018727	309	389	0	35	80	0.4375000
NODE_21729_length_633_cov_7.018727	309	389	4	45	80	0.5625000
NODE_21729_length_633_cov_7.018727	362	442	0	11	80	0.1375000
NODE_21729_length_633_cov_7.018727	362	442	4	69	80	0.8625000
NODE_21755_length_633_cov_2.644195	166	240	0	74	74	1.0000000
NODE_21816_length_632_cov_25.425891	332	412	2	4	80	0.0500000
NODE_21816_length_632_cov_25.425891	332	412	4	74	80	0.9250000
NODE_21816_length_632_cov_25.425891	332	412	6	2	80	0.0250000
NODE_21816_length_632_cov_25.425891	385	465	2	57	80	0.7125000
NODE_21816_length_632_cov_25.425891	385	465	4	21	80	0.2625000
NODE_21816_length_632_cov_25.425891	385	465	6	2	80	0.0250000
NODE_21817_length_632_cov_21.613508	243	323	0	80	80	1.0000000
NODE_21817_length_632_cov_21.613508	296	376	0	80	80	1.0000000
NODE_21818_length_632_cov_16.465291	293	373	0	10	80	0.1250000
NODE_21818_length_632_cov_16.465291	293	373	2	70	80	0.8750000
NODE_21818_length_632_cov_16.465291	346	426	0	63	80	0.7875000
NODE_21818_length_632_cov_16.465291	346	426	2	17	80	0.2125000
NODE_21819_length_632_cov_13.260788	232	312	0	80	80	1.0000000
NODE_21819_length_632_cov_13.260788	285	365	0	80	80	1.0000000
NODE_21821_length_632_cov_9.106942	188	268	0	80	80	1.0000000
NODE_21821_length_632_cov_9.106942	241	321	0	80	80	1.0000000
NODE_21834_length_632_cov_4.135084	229	309	0	80	80	1.0000000
NODE_21834_length_632_cov_4.135084	282	359	0	77	77	1.0000000
NODE_21841_length_632_cov_2.939962	216	274	2	48	58	0.8275862
NODE_21841_length_632_cov_2.939962	216	274	6	10	58	0.1724138
NODE_21841_length_632_cov_2.939962	247	327	2	17	80	0.2125000
NODE_21841_length_632_cov_2.939962	247	327	4	11	80	0.1375000
NODE_21841_length_632_cov_2.939962	247	327	6	52	80	0.6500000
NODE_21848_length_632_cov_2.330206	57	76	0	19	19	1.0000000
NODE_21912_length_631_cov_31.469925	321	396	0	30	75	0.4000000
NODE_21912_length_631_cov_31.469925	321	396	1	45	75	0.6000000
NODE_21912_length_631_cov_31.469925	369	449	0	80	80	1.0000000
NODE_21913_length_631_cov_26.453008	383	463	0	80	80	1.0000000
NODE_21913_length_631_cov_26.453008	436	516	0	80	80	1.0000000
NODE_21917_length_631_cov_8.374060	318	398	0	80	80	1.0000000
NODE_21917_length_631_cov_8.374060	371	451	0	80	80	1.0000000
NODE_21924_length_631_cov_5.507519	335	386	0	41	51	0.8039216
NODE_21924_length_631_cov_5.507519	335	386	4	10	51	0.1960784
NODE_21927_length_631_cov_5.227444	443	523	0	80	80	1.0000000
NODE_21927_length_631_cov_5.227444	496	576	0	80	80	1.0000000
NODE_21942_length_631_cov_2.926692	307	354	0	47	47	1.0000000
NODE_21983_length_631_cov_1.383459	248	267	0	19	19	1.0000000
NODE_22011_length_630_cov_41.728814	6	86	0	80	80	1.0000000
NODE_22011_length_630_cov_41.728814	59	139	0	80	80	1.0000000
NODE_22012_length_630_cov_24.856874	421	501	0	27	80	0.3375000
NODE_22012_length_630_cov_24.856874	421	501	4	53	80	0.6625000
NODE_22012_length_630_cov_24.856874	474	554	0	37	80	0.4625000
NODE_22012_length_630_cov_24.856874	474	554	4	43	80	0.5375000
NODE_22013_length_630_cov_14.323917	196	276	1	79	80	0.9875000
NODE_22013_length_630_cov_14.323917	196	276	2	1	80	0.0125000
NODE_22013_length_630_cov_14.323917	249	329	1	26	80	0.3250000
NODE_22013_length_630_cov_14.323917	249	329	2	54	80	0.6750000
NODE_22014_length_630_cov_9.964218	284	364	0	80	80	1.0000000
NODE_22014_length_630_cov_9.964218	337	417	0	80	80	1.0000000
NODE_22086_length_629_cov_38.271698	288	368	0	80	80	1.0000000
NODE_22086_length_629_cov_38.271698	341	421	0	80	80	1.0000000
NODE_22087_length_629_cov_27.556604	212	292	0	61	80	0.7625000
NODE_22087_length_629_cov_27.556604	212	292	2	19	80	0.2375000
NODE_22087_length_629_cov_27.556604	265	345	0	8	80	0.1000000
NODE_22087_length_629_cov_27.556604	265	345	2	72	80	0.9000000
NODE_22088_length_629_cov_24.150943	356	436	1	2	80	0.0250000
NODE_22088_length_629_cov_24.150943	356	436	36	43	80	0.5375000
NODE_22088_length_629_cov_24.150943	356	436	37	35	80	0.4375000
NODE_22088_length_629_cov_24.150943	409	489	1	55	80	0.6875000
NODE_22088_length_629_cov_24.150943	409	489	37	25	80	0.3125000
NODE_22091_length_629_cov_13.641509	176	256	4	21	80	0.2625000
NODE_22091_length_629_cov_13.641509	176	256	5	2	80	0.0250000
NODE_22091_length_629_cov_13.641509	176	256	9	57	80	0.7125000
NODE_22091_length_629_cov_13.641509	229	309	5	25	80	0.3125000
NODE_22091_length_629_cov_13.641509	229	309	9	55	80	0.6875000
NODE_22101_length_629_cov_4.264151	362	442	0	32	80	0.4000000
NODE_22101_length_629_cov_4.264151	362	442	2	48	80	0.6000000
NODE_22188_length_628_cov_5.015123	210	274	8	13	64	0.2031250
NODE_22188_length_628_cov_5.015123	210	274	10	51	64	0.7968750
NODE_22257_length_627_cov_24.500000	217	297	0	18	80	0.2250000
NODE_22257_length_627_cov_24.500000	217	297	2	62	80	0.7750000
NODE_22257_length_627_cov_24.500000	270	350	0	71	80	0.8875000
NODE_22257_length_627_cov_24.500000	270	350	2	9	80	0.1125000
NODE_22258_length_627_cov_20.395833	84	164	0	19	80	0.2375000
NODE_22258_length_627_cov_20.395833	84	164	2	9	80	0.1125000
NODE_22258_length_627_cov_20.395833	84	164	4	52	80	0.6500000
NODE_22258_length_627_cov_20.395833	137	217	0	12	80	0.1500000
NODE_22258_length_627_cov_20.395833	137	217	2	13	80	0.1625000
NODE_22258_length_627_cov_20.395833	137	217	4	55	80	0.6875000
NODE_22259_length_627_cov_19.676136	308	388	2	15	80	0.1875000
NODE_22259_length_627_cov_19.676136	308	388	5	1	80	0.0125000
NODE_22259_length_627_cov_19.676136	308	388	6	8	80	0.1000000
NODE_22259_length_627_cov_19.676136	308	388	13	1	80	0.0125000
NODE_22259_length_627_cov_19.676136	308	388	14	4	80	0.0500000
NODE_22259_length_627_cov_19.676136	308	388	15	2	80	0.0250000
NODE_22259_length_627_cov_19.676136	308	388	16	7	80	0.0875000
NODE_22259_length_627_cov_19.676136	308	388	18	32	80	0.4000000
NODE_22259_length_627_cov_19.676136	308	388	20	10	80	0.1250000
NODE_22259_length_627_cov_19.676136	361	441	0	4	80	0.0500000
NODE_22259_length_627_cov_19.676136	361	441	7	1	80	0.0125000
NODE_22259_length_627_cov_19.676136	361	441	8	1	80	0.0125000
NODE_22259_length_627_cov_19.676136	361	441	10	20	80	0.2500000
NODE_22259_length_627_cov_19.676136	361	441	16	1	80	0.0125000
NODE_22259_length_627_cov_19.676136	361	441	18	43	80	0.5375000
NODE_22259_length_627_cov_19.676136	361	441	20	10	80	0.1250000
NODE_22260_length_627_cov_17.634470	264	296	0	32	32	1.0000000
NODE_22260_length_627_cov_17.634470	360	385	0	25	25	1.0000000
NODE_22260_length_627_cov_17.634470	365	385	0	20	20	1.0000000
NODE_22260_length_627_cov_17.634470	385	424	0	39	39	1.0000000
NODE_22267_length_627_cov_5.634470	298	346	2	48	48	1.0000000
NODE_22274_length_627_cov_4.517045	323	403	0	9	80	0.1125000
NODE_22274_length_627_cov_4.517045	323	403	4	71	80	0.8875000
NODE_22274_length_627_cov_4.517045	376	456	0	29	80	0.3625000
NODE_22274_length_627_cov_4.517045	376	456	4	51	80	0.6375000
NODE_22357_length_626_cov_24.184061	140	220	0	80	80	1.0000000
NODE_22357_length_626_cov_24.184061	193	273	0	80	80	1.0000000
NODE_22358_length_626_cov_21.189753	342	419	2	8	77	0.1038961
NODE_22358_length_626_cov_21.189753	342	419	4	24	77	0.3116883
NODE_22358_length_626_cov_21.189753	342	419	6	35	77	0.4545455
NODE_22358_length_626_cov_21.189753	342	419	8	4	77	0.0519481
NODE_22358_length_626_cov_21.189753	342	419	12	6	77	0.0779221
NODE_22358_length_626_cov_21.189753	342	419	2	8	77	0.1038961
NODE_22358_length_626_cov_21.189753	342	419	4	24	77	0.3116883
NODE_22358_length_626_cov_21.189753	342	419	6	35	77	0.4545455
NODE_22358_length_626_cov_21.189753	342	419	8	4	77	0.0519481
NODE_22358_length_626_cov_21.189753	342	419	12	6	77	0.0779221
NODE_22358_length_626_cov_21.189753	392	453	4	6	61	0.0983607
NODE_22358_length_626_cov_21.189753	392	453	6	11	61	0.1803279
NODE_22358_length_626_cov_21.189753	392	453	8	4	61	0.0655738
NODE_22358_length_626_cov_21.189753	392	453	12	8	61	0.1311475
NODE_22358_length_626_cov_21.189753	392	453	14	32	61	0.5245901
NODE_22364_length_626_cov_7.100569	236	311	0	9	75	0.1200000
NODE_22364_length_626_cov_7.100569	236	311	2	66	75	0.8800000
NODE_22364_length_626_cov_7.100569	284	364	0	2	80	0.0250000
NODE_22364_length_626_cov_7.100569	284	364	2	78	80	0.9750000
NODE_22366_length_626_cov_6.296015	193	273	0	80	80	1.0000000
NODE_22366_length_626_cov_6.296015	246	326	0	80	80	1.0000000
NODE_22367_length_626_cov_6.163188	257	337	0	80	80	1.0000000
NODE_22367_length_626_cov_6.163188	310	390	0	80	80	1.0000000
NODE_22438_length_625_cov_33.100760	239	319	0	80	80	1.0000000
NODE_22438_length_625_cov_33.100760	292	372	0	80	80	1.0000000
NODE_22438_length_625_cov_33.100760	368	448	0	80	80	1.0000000
NODE_22438_length_625_cov_33.100760	421	501	0	80	80	1.0000000
NODE_22439_length_625_cov_21.062738	267	347	0	8	80	0.1000000
NODE_22439_length_625_cov_21.062738	267	347	2	72	80	0.9000000
NODE_22439_length_625_cov_21.062738	320	400	0	61	80	0.7625000
NODE_22439_length_625_cov_21.062738	320	400	2	19	80	0.2375000
NODE_22440_length_625_cov_14.237643	28	108	0	80	80	1.0000000
NODE_22440_length_625_cov_14.237643	81	161	0	80	80	1.0000000
NODE_22441_length_625_cov_14.207224	358	438	0	80	80	1.0000000
NODE_22441_length_625_cov_14.207224	411	491	0	46	80	0.5750000
NODE_22441_length_625_cov_14.207224	411	491	2	12	80	0.1500000
NODE_22441_length_625_cov_14.207224	411	491	4	22	80	0.2750000
NODE_22455_length_625_cov_4.157795	548	600	0	52	52	1.0000000
NODE_22466_length_625_cov_2.929658	118	198	0	80	80	1.0000000
NODE_22466_length_625_cov_2.929658	171	251	0	80	80	1.0000000
NODE_22491_length_625_cov_1.570342	471	502	0	31	31	1.0000000
NODE_22542_length_624_cov_9.598095	77	126	0	49	49	1.0000000
NODE_22542_length_624_cov_9.598095	103	183	0	80	80	1.0000000
NODE_22544_length_624_cov_8.485714	271	351	0	4	80	0.0500000
NODE_22544_length_624_cov_8.485714	271	351	6	2	80	0.0250000
NODE_22544_length_624_cov_8.485714	271	351	8	40	80	0.5000000
NODE_22544_length_624_cov_8.485714	271	351	10	14	80	0.1750000
NODE_22544_length_624_cov_8.485714	271	351	14	20	80	0.2500000
NODE_22544_length_624_cov_8.485714	324	404	6	2	80	0.0250000
NODE_22544_length_624_cov_8.485714	324	404	8	26	80	0.3250000
NODE_22544_length_624_cov_8.485714	324	404	10	7	80	0.0875000
NODE_22544_length_624_cov_8.485714	324	404	11	1	80	0.0125000
NODE_22544_length_624_cov_8.485714	324	404	12	9	80	0.1125000
NODE_22544_length_624_cov_8.485714	324	404	14	35	80	0.4375000
NODE_22546_length_624_cov_6.691429	386	466	0	80	80	1.0000000
NODE_22546_length_624_cov_6.691429	439	519	0	70	80	0.8750000
NODE_22546_length_624_cov_6.691429	439	519	2	10	80	0.1250000
NODE_22547_length_624_cov_5.592381	312	387	0	28	75	0.3733333
NODE_22547_length_624_cov_5.592381	312	387	2	14	75	0.1866667
NODE_22547_length_624_cov_5.592381	312	387	4	33	75	0.4400000
NODE_22551_length_624_cov_4.638095	328	388	0	60	60	1.0000000
NODE_22642_length_623_cov_41.877863	419	499	2	25	80	0.3125000
NODE_22642_length_623_cov_41.877863	419	499	6	55	80	0.6875000
NODE_22642_length_623_cov_41.877863	472	552	2	63	80	0.7875000
NODE_22642_length_623_cov_41.877863	472	552	4	15	80	0.1875000
NODE_22642_length_623_cov_41.877863	472	552	6	2	80	0.0250000
NODE_22643_length_623_cov_31.875954	148	228	0	58	80	0.7250000
NODE_22643_length_623_cov_31.875954	148	228	3	22	80	0.2750000
NODE_22643_length_623_cov_31.875954	201	281	0	5	80	0.0625000
NODE_22643_length_623_cov_31.875954	201	281	3	48	80	0.6000000
NODE_22643_length_623_cov_31.875954	201	281	4	27	80	0.3375000
NODE_22644_length_623_cov_31.192748	313	393	0	17	80	0.2125000
NODE_22644_length_623_cov_31.192748	313	393	2	63	80	0.7875000
NODE_22644_length_623_cov_31.192748	366	446	0	64	80	0.8000000
NODE_22644_length_623_cov_31.192748	366	446	2	16	80	0.2000000
NODE_22645_length_623_cov_20.187023	287	367	0	80	80	1.0000000
NODE_22645_length_623_cov_20.187023	340	420	0	80	80	1.0000000
NODE_22646_length_623_cov_12.045802	377	457	0	58	80	0.7250000
NODE_22646_length_623_cov_12.045802	377	457	2	22	80	0.2750000
NODE_22646_length_623_cov_12.045802	430	510	0	5	80	0.0625000
NODE_22646_length_623_cov_12.045802	430	510	2	75	80	0.9375000
NODE_22668_length_623_cov_2.891221	457	535	0	61	78	0.7820513
NODE_22668_length_623_cov_2.891221	457	535	2	17	78	0.2179487
NODE_22725_length_622_cov_19.042065	368	448	0	80	80	1.0000000
NODE_22725_length_622_cov_19.042065	421	501	0	80	80	1.0000000
NODE_22726_length_622_cov_13.470363	109	189	0	80	80	1.0000000
NODE_22726_length_622_cov_13.470363	162	242	0	80	80	1.0000000
NODE_22752_length_622_cov_2.407266	94	170	0	33	76	0.4342105
NODE_22752_length_622_cov_2.407266	94	170	2	2	76	0.0263158
NODE_22752_length_622_cov_2.407266	94	170	4	5	76	0.0657895
NODE_22752_length_622_cov_2.407266	94	170	6	29	76	0.3815790
NODE_22752_length_622_cov_2.407266	94	170	8	1	76	0.0131579
NODE_22752_length_622_cov_2.407266	94	170	10	6	76	0.0789474
NODE_22796_length_622_cov_1.353728	346	376	0	30	30	1.0000000
NODE_22819_length_621_cov_46.247126	0	52	0	52	52	1.0000000
NODE_22819_length_621_cov_46.247126	25	105	0	80	80	1.0000000
NODE_22819_length_621_cov_46.247126	101	181	0	43	80	0.5375000
NODE_22819_length_621_cov_46.247126	101	181	2	37	80	0.4625000
NODE_22819_length_621_cov_46.247126	154	234	0	13	80	0.1625000
NODE_22819_length_621_cov_46.247126	154	234	2	67	80	0.8375000
NODE_22820_length_621_cov_45.764368	344	424	9	6	80	0.0750000
NODE_22820_length_621_cov_45.764368	344	424	10	74	80	0.9250000
NODE_22820_length_621_cov_45.764368	397	477	0	41	80	0.5125000
NODE_22820_length_621_cov_45.764368	397	477	9	18	80	0.2250000
NODE_22820_length_621_cov_45.764368	397	477	10	21	80	0.2625000
NODE_22821_length_621_cov_35.147510	393	473	0	30	80	0.3750000
NODE_22821_length_621_cov_35.147510	393	473	2	50	80	0.6250000
NODE_22821_length_621_cov_35.147510	446	526	0	52	80	0.6500000
NODE_22821_length_621_cov_35.147510	446	526	2	28	80	0.3500000
NODE_22822_length_621_cov_13.842912	231	311	0	80	80	1.0000000
NODE_22822_length_621_cov_13.842912	284	364	0	75	80	0.9375000
NODE_22822_length_621_cov_13.842912	284	364	2	5	80	0.0625000
NODE_22825_length_621_cov_6.279693	376	406	0	30	30	1.0000000
NODE_22845_length_621_cov_2.645594	367	426	0	59	59	1.0000000
NODE_22914_length_620_cov_23.913628	433	513	2	80	80	1.0000000
NODE_22914_length_620_cov_23.913628	486	566	0	45	80	0.5625000
NODE_22914_length_620_cov_23.913628	486	566	2	35	80	0.4375000
NODE_22915_length_620_cov_9.222649	186	266	0	80	80	1.0000000
NODE_22915_length_620_cov_9.222649	239	319	0	80	80	1.0000000
NODE_22919_length_620_cov_7.804223	57	137	0	74	80	0.9250000
NODE_22919_length_620_cov_7.804223	57	137	2	6	80	0.0750000
NODE_22919_length_620_cov_7.804223	110	190	0	21	80	0.2625000
NODE_22919_length_620_cov_7.804223	110	190	2	59	80	0.7375000
NODE_22920_length_620_cov_6.909789	199	279	0	41	80	0.5125000
NODE_22920_length_620_cov_6.909789	199	279	4	39	80	0.4875000
NODE_22920_length_620_cov_6.909789	252	332	4	80	80	1.0000000
NODE_22930_length_620_cov_4.560461	309	347	24	5	38	0.1315790
NODE_22930_length_620_cov_4.560461	309	347	26	33	38	0.8684211
NODE_22930_length_620_cov_4.560461	395	421	0	6	26	0.2307692
NODE_22930_length_620_cov_4.560461	395	421	4	20	26	0.7692308
NODE_22930_length_620_cov_4.560461	395	451	0	6	56	0.1071429
NODE_22930_length_620_cov_4.560461	395	451	4	50	56	0.8928571
NODE_23031_length_619_cov_26.309615	118	198	0	80	80	1.0000000
NODE_23031_length_619_cov_26.309615	171	251	0	80	80	1.0000000
NODE_23033_length_619_cov_10.417308	427	487	6	21	60	0.3500000
NODE_23033_length_619_cov_10.417308	427	487	9	7	60	0.1166667
NODE_23033_length_619_cov_10.417308	427	487	11	32	60	0.5333334
NODE_23034_length_619_cov_7.944231	213	293	0	69	80	0.8625000
NODE_23034_length_619_cov_7.944231	213	293	6	11	80	0.1375000
NODE_23034_length_619_cov_7.944231	266	346	0	16	80	0.2000000
NODE_23034_length_619_cov_7.944231	266	346	6	64	80	0.8000000
NODE_23135_length_618_cov_14.477842	223	299	1	45	76	0.5921053
NODE_23135_length_618_cov_14.477842	223	299	2	3	76	0.0394737
NODE_23135_length_618_cov_14.477842	223	299	3	6	76	0.0789474
NODE_23135_length_618_cov_14.477842	223	299	5	22	76	0.2894737
NODE_23135_length_618_cov_14.477842	223	299	1	45	76	0.5921053
NODE_23135_length_618_cov_14.477842	223	299	2	3	76	0.0394737
NODE_23135_length_618_cov_14.477842	223	299	3	6	76	0.0789474
NODE_23135_length_618_cov_14.477842	223	299	5	22	76	0.2894737
NODE_23135_length_618_cov_14.477842	276	337	1	1	61	0.0163934
NODE_23135_length_618_cov_14.477842	276	337	4	7	61	0.1147541
NODE_23135_length_618_cov_14.477842	276	337	5	53	61	0.8688524
NODE_23136_length_618_cov_13.840077	377	457	0	80	80	1.0000000
NODE_23136_length_618_cov_13.840077	430	510	0	80	80	1.0000000
NODE_23137_length_618_cov_12.048170	348	428	0	36	80	0.4500000
NODE_23137_length_618_cov_12.048170	348	428	2	44	80	0.5500000
NODE_23137_length_618_cov_12.048170	401	481	2	80	80	1.0000000
NODE_23138_length_618_cov_8.799615	353	433	0	75	80	0.9375000
NODE_23138_length_618_cov_8.799615	353	433	2	5	80	0.0625000
NODE_23138_length_618_cov_8.799615	406	486	0	22	80	0.2750000
NODE_23138_length_618_cov_8.799615	406	486	2	58	80	0.7250000
NODE_23147_length_618_cov_3.793834	412	478	0	66	66	1.0000000
NODE_23148_length_618_cov_3.761079	305	385	0	80	80	1.0000000
NODE_23252_length_617_cov_29.565637	378	458	0	14	80	0.1750000
NODE_23252_length_617_cov_29.565637	378	458	3	1	80	0.0125000
NODE_23252_length_617_cov_29.565637	378	458	4	65	80	0.8125000
NODE_23252_length_617_cov_29.565637	431	511	0	25	80	0.3125000
NODE_23252_length_617_cov_29.565637	431	511	4	55	80	0.6875000
NODE_23253_length_617_cov_16.781853	253	333	0	80	80	1.0000000
NODE_23253_length_617_cov_16.781853	306	386	0	80	80	1.0000000
NODE_23254_length_617_cov_9.175676	373	453	0	80	80	1.0000000
NODE_23254_length_617_cov_9.175676	426	506	0	80	80	1.0000000
NODE_23255_length_617_cov_8.774131	320	406	1	24	86	0.2790698
NODE_23255_length_617_cov_8.774131	320	406	6	11	86	0.1279070
NODE_23255_length_617_cov_8.774131	320	406	7	51	86	0.5930232
NODE_23255_length_617_cov_8.774131	379	458	0	8	79	0.1012658
NODE_23255_length_617_cov_8.774131	379	458	1	24	79	0.3037975
NODE_23255_length_617_cov_8.774131	379	458	5	1	79	0.0126582
NODE_23255_length_617_cov_8.774131	379	458	6	10	79	0.1265823
NODE_23255_length_617_cov_8.774131	379	458	7	36	79	0.4556962
NODE_23257_length_617_cov_8.416988	359	439	0	80	80	1.0000000
NODE_23257_length_617_cov_8.416988	412	492	0	80	80	1.0000000
NODE_23259_length_617_cov_7.683398	197	275	0	1	78	0.0128205
NODE_23259_length_617_cov_7.683398	197	275	2	38	78	0.4871795
NODE_23259_length_617_cov_7.683398	197	275	4	12	78	0.1538462
NODE_23259_length_617_cov_7.683398	197	275	6	27	78	0.3461539
NODE_23259_length_617_cov_7.683398	250	330	6	46	80	0.5750000
NODE_23259_length_617_cov_7.683398	250	330	8	34	80	0.4250000
NODE_23263_length_617_cov_5.330116	288	360	0	72	72	1.0000000
NODE_23263_length_617_cov_5.330116	333	413	0	80	80	1.0000000
NODE_23302_length_617_cov_1.967181	384	430	0	46	46	1.0000000
NODE_23311_length_617_cov_1.847490	273	344	2	71	71	1.0000000
NODE_23331_length_617_cov_1.322394	269	318	32	9	49	0.1836735
NODE_23331_length_617_cov_1.322394	269	318	34	27	49	0.5510204
NODE_23331_length_617_cov_1.322394	269	318	36	10	49	0.2040816
NODE_23331_length_617_cov_1.322394	269	318	38	3	49	0.0612245
NODE_23365_length_616_cov_15.914894	292	370	4	78	78	1.0000000
NODE_23365_length_616_cov_15.914894	343	423	0	52	80	0.6500000
NODE_23365_length_616_cov_15.914894	343	423	4	28	80	0.3500000
NODE_23366_length_616_cov_14.276596	191	271	0	80	80	1.0000000
NODE_23366_length_616_cov_14.276596	244	319	0	75	75	1.0000000
NODE_23366_length_616_cov_14.276596	368	448	0	72	80	0.9000000
NODE_23366_length_616_cov_14.276596	368	448	2	8	80	0.1000000
NODE_23367_length_616_cov_12.119923	273	353	0	80	80	1.0000000
NODE_23367_length_616_cov_12.119923	326	406	0	80	80	1.0000000
NODE_23373_length_616_cov_6.379110	305	385	0	30	80	0.3750000
NODE_23373_length_616_cov_6.379110	305	385	2	50	80	0.6250000
NODE_23373_length_616_cov_6.379110	358	438	2	80	80	1.0000000
NODE_23381_length_616_cov_4.441006	286	350	0	64	64	1.0000000
NODE_23381_length_616_cov_4.441006	286	306	0	20	20	1.0000000
NODE_23400_length_616_cov_2.541586	375	415	0	40	40	1.0000000
NODE_23430_length_616_cov_1.491296	105	183	0	78	78	1.0000000
NODE_23474_length_615_cov_27.519380	302	382	0	80	80	1.0000000
NODE_23474_length_615_cov_27.519380	355	435	0	80	80	1.0000000
NODE_23475_length_615_cov_17.792636	239	319	0	58	80	0.7250000
NODE_23475_length_615_cov_17.792636	239	319	2	22	80	0.2750000
NODE_23475_length_615_cov_17.792636	292	372	0	5	80	0.0625000
NODE_23475_length_615_cov_17.792636	292	372	2	75	80	0.9375000
NODE_23477_length_615_cov_11.835271	240	320	6	80	80	1.0000000
NODE_23477_length_615_cov_11.835271	293	373	1	9	80	0.1125000
NODE_23477_length_615_cov_11.835271	293	373	3	7	80	0.0875000
NODE_23477_length_615_cov_11.835271	293	373	6	64	80	0.8000000
NODE_23478_length_615_cov_8.591085	287	367	0	25	80	0.3125000
NODE_23478_length_615_cov_8.591085	287	367	2	55	80	0.6875000
NODE_23478_length_615_cov_8.591085	340	420	0	21	80	0.2625000
NODE_23478_length_615_cov_8.591085	340	420	2	59	80	0.7375000
NODE_23513_length_615_cov_2.461240	429	509	0	80	80	1.0000000
NODE_23513_length_615_cov_2.461240	482	562	0	80	80	1.0000000
NODE_23516_length_615_cov_2.379845	405	467	5	1	62	0.0161290
NODE_23516_length_615_cov_2.379845	405	467	7	1	62	0.0161290
NODE_23516_length_615_cov_2.379845	405	467	9	1	62	0.0161290
NODE_23516_length_615_cov_2.379845	405	467	13	3	62	0.0483871
NODE_23516_length_615_cov_2.379845	405	467	15	2	62	0.0322581
NODE_23516_length_615_cov_2.379845	405	467	16	10	62	0.1612903
NODE_23516_length_615_cov_2.379845	405	467	18	9	62	0.1451613
NODE_23516_length_615_cov_2.379845	405	467	24	35	62	0.5645161
NODE_23516_length_615_cov_2.379845	440	520	20	8	80	0.1000000
NODE_23516_length_615_cov_2.379845	440	520	22	18	80	0.2250000
NODE_23516_length_615_cov_2.379845	440	520	24	53	80	0.6625000
NODE_23516_length_615_cov_2.379845	440	520	26	1	80	0.0125000
NODE_23517_length_615_cov_2.294574	205	268	4	2	63	0.0317460
NODE_23517_length_615_cov_2.294574	205	268	6	61	63	0.9682540
NODE_23554_length_615_cov_1.122093	255	335	0	26	80	0.3250000
NODE_23554_length_615_cov_1.122093	255	335	2	54	80	0.6750000
NODE_23566_length_615_cov_0.887597	561	582	2	21	21	1.0000000
NODE_23575_length_614_cov_17.772816	257	337	0	21	80	0.2625000
NODE_23575_length_614_cov_17.772816	257	337	2	59	80	0.7375000
NODE_23575_length_614_cov_17.772816	310	390	0	43	80	0.5375000
NODE_23575_length_614_cov_17.772816	310	390	2	37	80	0.4625000
NODE_23576_length_614_cov_10.706796	425	505	0	36	80	0.4500000
NODE_23576_length_614_cov_10.706796	425	505	2	44	80	0.5500000
NODE_23576_length_614_cov_10.706796	478	558	0	23	80	0.2875000
NODE_23576_length_614_cov_10.706796	478	558	2	57	80	0.7125000
NODE_23578_length_614_cov_8.545631	193	273	0	3	80	0.0375000
NODE_23578_length_614_cov_8.545631	193	273	2	49	80	0.6125000
NODE_23578_length_614_cov_8.545631	193	273	8	1	80	0.0125000
NODE_23578_length_614_cov_8.545631	193	273	12	2	80	0.0250000
NODE_23578_length_614_cov_8.545631	193	273	16	2	80	0.0250000
NODE_23578_length_614_cov_8.545631	193	273	24	1	80	0.0125000
NODE_23578_length_614_cov_8.545631	193	273	26	2	80	0.0250000
NODE_23578_length_614_cov_8.545631	193	273	34	1	80	0.0125000
NODE_23578_length_614_cov_8.545631	193	273	35	6	80	0.0750000
NODE_23578_length_614_cov_8.545631	193	273	37	1	80	0.0125000
NODE_23578_length_614_cov_8.545631	193	273	39	6	80	0.0750000
NODE_23578_length_614_cov_8.545631	193	273	41	4	80	0.0500000
NODE_23578_length_614_cov_8.545631	193	273	42	2	80	0.0250000
NODE_23578_length_614_cov_8.545631	246	326	0	6	80	0.0750000
NODE_23578_length_614_cov_8.545631	246	326	2	45	80	0.5625000
NODE_23578_length_614_cov_8.545631	246	326	4	15	80	0.1875000
NODE_23578_length_614_cov_8.545631	246	326	7	3	80	0.0375000
NODE_23578_length_614_cov_8.545631	246	326	8	11	80	0.1375000
NODE_23604_length_614_cov_2.450485	315	393	0	78	78	1.0000000
NODE_23604_length_614_cov_2.450485	355	383	0	28	28	1.0000000
NODE_23604_length_614_cov_2.450485	368	448	0	28	80	0.3500000
NODE_23604_length_614_cov_2.450485	368	448	2	2	80	0.0250000
NODE_23604_length_614_cov_2.450485	368	448	4	50	80	0.6250000
NODE_23604_length_614_cov_2.450485	379	448	0	17	69	0.2463768
NODE_23604_length_614_cov_2.450485	379	448	2	2	69	0.0289855
NODE_23604_length_614_cov_2.450485	379	448	4	50	69	0.7246377
NODE_23662_length_613_cov_18.075875	211	291	0	80	80	1.0000000
NODE_23662_length_613_cov_18.075875	264	344	0	80	80	1.0000000
NODE_23663_length_613_cov_16.118677	283	363	1	9	80	0.1125000
NODE_23663_length_613_cov_16.118677	283	363	2	5	80	0.0625000
NODE_23663_length_613_cov_16.118677	283	363	5	10	80	0.1250000
NODE_23663_length_613_cov_16.118677	283	363	8	56	80	0.7000000
NODE_23663_length_613_cov_16.118677	336	416	0	10	80	0.1250000
NODE_23663_length_613_cov_16.118677	336	416	1	52	80	0.6500000
NODE_23663_length_613_cov_16.118677	336	416	2	5	80	0.0625000
NODE_23663_length_613_cov_16.118677	336	416	5	10	80	0.1250000
NODE_23663_length_613_cov_16.118677	336	416	8	3	80	0.0375000
NODE_23665_length_613_cov_12.883268	155	235	5	5	80	0.0625000
NODE_23665_length_613_cov_12.883268	155	235	6	31	80	0.3875000
NODE_23665_length_613_cov_12.883268	155	235	8	44	80	0.5500000
NODE_23665_length_613_cov_12.883268	208	288	0	10	80	0.1250000
NODE_23665_length_613_cov_12.883268	208	288	2	32	80	0.4000000
NODE_23665_length_613_cov_12.883268	208	288	5	16	80	0.2000000
NODE_23665_length_613_cov_12.883268	208	288	8	22	80	0.2750000
NODE_23674_length_613_cov_3.857977	167	247	0	80	80	1.0000000
NODE_23674_length_613_cov_3.857977	220	300	0	80	80	1.0000000
NODE_23771_length_612_cov_24.023392	173	253	0	25	80	0.3125000
NODE_23771_length_612_cov_24.023392	173	253	2	55	80	0.6875000
NODE_23771_length_612_cov_24.023392	226	306	0	13	80	0.1625000
NODE_23771_length_612_cov_24.023392	226	306	2	67	80	0.8375000
NODE_23772_length_612_cov_23.846004	141	221	4	19	80	0.2375000
NODE_23772_length_612_cov_23.846004	141	221	6	61	80	0.7625000
NODE_23772_length_612_cov_23.846004	194	274	0	50	80	0.6250000
NODE_23772_length_612_cov_23.846004	194	274	4	22	80	0.2750000
NODE_23772_length_612_cov_23.846004	194	274	6	8	80	0.1000000
NODE_23773_length_612_cov_12.448343	244	324	0	3	80	0.0375000
NODE_23773_length_612_cov_12.448343	244	324	2	77	80	0.9625000
NODE_23773_length_612_cov_12.448343	297	377	0	24	80	0.3000000
NODE_23773_length_612_cov_12.448343	297	377	2	56	80	0.7000000
NODE_23774_length_612_cov_12.068226	267	347	0	80	80	1.0000000
NODE_23774_length_612_cov_12.068226	320	400	0	80	80	1.0000000
NODE_23779_length_612_cov_6.393762	242	322	0	80	80	1.0000000
NODE_23779_length_612_cov_6.393762	295	375	0	80	80	1.0000000
NODE_23814_length_612_cov_1.904483	288	354	0	66	66	1.0000000
NODE_23869_length_611_cov_38.705078	132	212	0	19	80	0.2375000
NODE_23869_length_611_cov_38.705078	132	212	3	42	80	0.5250000
NODE_23869_length_611_cov_38.705078	132	212	5	19	80	0.2375000
NODE_23869_length_611_cov_38.705078	185	262	0	69	77	0.8961039
NODE_23869_length_611_cov_38.705078	185	262	3	8	77	0.1038961
NODE_23869_length_611_cov_38.705078	185	262	0	69	77	0.8961039
NODE_23869_length_611_cov_38.705078	185	262	3	8	77	0.1038961
NODE_23871_length_611_cov_12.669922	264	344	0	4	80	0.0500000
NODE_23871_length_611_cov_12.669922	264	344	4	76	80	0.9500000
NODE_23871_length_611_cov_12.669922	317	397	0	11	80	0.1375000
NODE_23871_length_611_cov_12.669922	317	397	4	69	80	0.8625000
NODE_23880_length_611_cov_4.943359	27	107	0	24	80	0.3000000
NODE_23880_length_611_cov_4.943359	27	107	2	56	80	0.7000000
NODE_23880_length_611_cov_4.943359	80	137	2	57	57	1.0000000
NODE_23880_length_611_cov_4.943359	143	209	0	19	66	0.2878788
NODE_23880_length_611_cov_4.943359	143	209	2	18	66	0.2727273
NODE_23880_length_611_cov_4.943359	143	209	4	29	66	0.4393939
NODE_23880_length_611_cov_4.943359	182	262	2	6	80	0.0750000
NODE_23880_length_611_cov_4.943359	182	262	4	68	80	0.8500000
NODE_23880_length_611_cov_4.943359	182	262	6	6	80	0.0750000
NODE_23894_length_611_cov_3.294922	271	300	0	29	29	1.0000000
NODE_23894_length_611_cov_3.294922	434	469	4	35	35	1.0000000
NODE_23897_length_611_cov_3.162109	313	342	2	29	29	1.0000000
NODE_23973_length_610_cov_20.673190	87	167	0	60	80	0.7500000
NODE_23973_length_610_cov_20.673190	87	167	2	20	80	0.2500000
NODE_23973_length_610_cov_20.673190	140	220	0	80	80	1.0000000
NODE_23974_length_610_cov_10.191781	250	330	0	80	80	1.0000000
NODE_23974_length_610_cov_10.191781	303	383	0	80	80	1.0000000
NODE_23980_length_610_cov_4.998043	129	181	4	52	52	1.0000000
NODE_23980_length_610_cov_4.998043	182	234	0	19	52	0.3653846
NODE_23980_length_610_cov_4.998043	182	234	2	20	52	0.3846154
NODE_23980_length_610_cov_4.998043	182	234	4	13	52	0.2500000
NODE_23989_length_610_cov_3.479452	215	267	2	51	52	0.9807692
NODE_23989_length_610_cov_3.479452	215	267	4	1	52	0.0192308
NODE_24059_length_609_cov_21.117647	80	160	0	80	80	1.0000000
NODE_24059_length_609_cov_21.117647	133	213	0	80	80	1.0000000
NODE_24060_length_609_cov_11.300000	218	298	0	25	80	0.3125000
NODE_24060_length_609_cov_11.300000	218	298	2	7	80	0.0875000
NODE_24060_length_609_cov_11.300000	218	298	4	48	80	0.6000000
NODE_24060_length_609_cov_11.300000	271	351	0	14	80	0.1750000
NODE_24060_length_609_cov_11.300000	271	351	2	20	80	0.2500000
NODE_24060_length_609_cov_11.300000	271	351	4	46	80	0.5750000
NODE_24061_length_609_cov_10.778431	239	319	0	60	80	0.7500000
NODE_24061_length_609_cov_10.778431	239	319	2	20	80	0.2500000
NODE_24061_length_609_cov_10.778431	292	372	0	7	80	0.0875000
NODE_24061_length_609_cov_10.778431	292	372	2	73	80	0.9125000
NODE_24062_length_609_cov_10.298039	340	420	0	80	80	1.0000000
NODE_24062_length_609_cov_10.298039	393	473	0	80	80	1.0000000
NODE_24062_length_609_cov_10.298039	469	537	0	68	68	1.0000000
NODE_24063_length_609_cov_10.270588	217	297	0	10	80	0.1250000
NODE_24063_length_609_cov_10.270588	217	297	18	1	80	0.0125000
NODE_24063_length_609_cov_10.270588	217	297	19	3	80	0.0375000
NODE_24063_length_609_cov_10.270588	217	297	43	21	80	0.2625000
NODE_24063_length_609_cov_10.270588	217	297	45	4	80	0.0500000
NODE_24063_length_609_cov_10.270588	217	297	46	41	80	0.5125000
NODE_24063_length_609_cov_10.270588	270	353	15	17	83	0.2048193
NODE_24063_length_609_cov_10.270588	270	353	26	4	83	0.0481928
NODE_24063_length_609_cov_10.270588	270	353	28	3	83	0.0361446
NODE_24063_length_609_cov_10.270588	270	353	29	5	83	0.0602410
NODE_24063_length_609_cov_10.270588	270	353	30	8	83	0.0963855
NODE_24063_length_609_cov_10.270588	270	353	31	2	83	0.0240964
NODE_24063_length_609_cov_10.270588	270	353	32	2	83	0.0240964
NODE_24063_length_609_cov_10.270588	270	353	33	2	83	0.0240964
NODE_24063_length_609_cov_10.270588	270	353	37	1	83	0.0120482
NODE_24063_length_609_cov_10.270588	270	353	43	2	83	0.0240964
NODE_24063_length_609_cov_10.270588	270	353	46	37	83	0.4457831
NODE_24064_length_609_cov_8.345098	408	488	0	29	80	0.3625000
NODE_24064_length_609_cov_8.345098	408	488	2	51	80	0.6375000
NODE_24064_length_609_cov_8.345098	461	515	0	13	54	0.2407407
NODE_24064_length_609_cov_8.345098	461	515	2	41	54	0.7592593
NODE_24064_length_609_cov_8.345098	537	566	0	29	29	1.0000000
NODE_24066_length_609_cov_6.054902	219	299	0	80	80	1.0000000
NODE_24066_length_609_cov_6.054902	272	352	0	80	80	1.0000000
NODE_24067_length_609_cov_5.986275	219	299	0	25	80	0.3125000
NODE_24067_length_609_cov_5.986275	219	299	2	53	80	0.6625000
NODE_24067_length_609_cov_5.986275	219	299	4	2	80	0.0250000
NODE_24067_length_609_cov_5.986275	272	352	2	46	80	0.5750000
NODE_24067_length_609_cov_5.986275	272	352	4	34	80	0.4250000
NODE_24160_length_608_cov_76.257367	300	380	1	80	80	1.0000000
NODE_24160_length_608_cov_76.257367	353	433	0	17	80	0.2125000
NODE_24160_length_608_cov_76.257367	353	433	1	63	80	0.7875000
NODE_24161_length_608_cov_13.271120	252	332	2	34	80	0.4250000
NODE_24161_length_608_cov_13.271120	252	332	5	1	80	0.0125000
NODE_24161_length_608_cov_13.271120	252	332	6	45	80	0.5625000
NODE_24161_length_608_cov_13.271120	305	385	0	5	80	0.0625000
NODE_24161_length_608_cov_13.271120	305	385	2	1	80	0.0125000
NODE_24161_length_608_cov_13.271120	305	385	6	74	80	0.9250000
NODE_24162_length_608_cov_11.583497	63	139	0	68	76	0.8947368
NODE_24162_length_608_cov_11.583497	63	139	2	8	76	0.1052632
NODE_24162_length_608_cov_11.583497	112	192	0	19	80	0.2375000
NODE_24162_length_608_cov_11.583497	112	192	2	61	80	0.7625000
NODE_24164_length_608_cov_8.076621	53	133	60	2	80	0.0250000
NODE_24164_length_608_cov_8.076621	53	133	62	1	80	0.0125000
NODE_24164_length_608_cov_8.076621	53	133	76	1	80	0.0125000
NODE_24164_length_608_cov_8.076621	53	133	78	1	80	0.0125000
NODE_24164_length_608_cov_8.076621	53	133	86	2	80	0.0250000
NODE_24164_length_608_cov_8.076621	53	133	96	1	80	0.0125000
NODE_24164_length_608_cov_8.076621	53	133	100	1	80	0.0125000
NODE_24164_length_608_cov_8.076621	53	133	105	1	80	0.0125000
NODE_24164_length_608_cov_8.076621	53	133	108	1	80	0.0125000
NODE_24164_length_608_cov_8.076621	53	133	110	1	80	0.0125000
NODE_24164_length_608_cov_8.076621	53	133	117	4	80	0.0500000
NODE_24164_length_608_cov_8.076621	53	133	118	2	80	0.0250000
NODE_24164_length_608_cov_8.076621	53	133	119	3	80	0.0375000
NODE_24164_length_608_cov_8.076621	53	133	121	6	80	0.0750000
NODE_24164_length_608_cov_8.076621	53	133	124	4	80	0.0500000
NODE_24164_length_608_cov_8.076621	53	133	125	6	80	0.0750000
NODE_24164_length_608_cov_8.076621	53	133	126	6	80	0.0750000
NODE_24164_length_608_cov_8.076621	53	133	127	5	80	0.0625000
NODE_24164_length_608_cov_8.076621	53	133	128	4	80	0.0500000
NODE_24164_length_608_cov_8.076621	53	133	129	4	80	0.0500000
NODE_24164_length_608_cov_8.076621	53	133	130	1	80	0.0125000
NODE_24164_length_608_cov_8.076621	53	133	131	4	80	0.0500000
NODE_24164_length_608_cov_8.076621	53	133	133	11	80	0.1375000
NODE_24164_length_608_cov_8.076621	53	133	135	3	80	0.0375000
NODE_24164_length_608_cov_8.076621	53	133	137	5	80	0.0625000
NODE_24164_length_608_cov_8.076621	106	186	6	6	80	0.0750000
NODE_24164_length_608_cov_8.076621	106	186	8	14	80	0.1750000
NODE_24164_length_608_cov_8.076621	106	186	10	4	80	0.0500000
NODE_24164_length_608_cov_8.076621	106	186	12	1	80	0.0125000
NODE_24164_length_608_cov_8.076621	106	186	13	2	80	0.0250000
NODE_24164_length_608_cov_8.076621	106	186	15	1	80	0.0125000
NODE_24164_length_608_cov_8.076621	106	186	21	2	80	0.0250000
NODE_24164_length_608_cov_8.076621	106	186	23	1	80	0.0125000
NODE_24164_length_608_cov_8.076621	106	186	25	5	80	0.0625000
NODE_24164_length_608_cov_8.076621	106	186	27	1	80	0.0125000
NODE_24164_length_608_cov_8.076621	106	186	28	1	80	0.0125000
NODE_24164_length_608_cov_8.076621	106	186	30	4	80	0.0500000
NODE_24164_length_608_cov_8.076621	106	186	32	1	80	0.0125000
NODE_24164_length_608_cov_8.076621	106	186	34	4	80	0.0500000
NODE_24164_length_608_cov_8.076621	106	186	46	1	80	0.0125000
NODE_24164_length_608_cov_8.076621	106	186	51	1	80	0.0125000
NODE_24164_length_608_cov_8.076621	106	186	54	2	80	0.0250000
NODE_24164_length_608_cov_8.076621	106	186	56	1	80	0.0125000
NODE_24164_length_608_cov_8.076621	106	186	60	3	80	0.0375000
NODE_24164_length_608_cov_8.076621	106	186	62	1	80	0.0125000
NODE_24164_length_608_cov_8.076621	106	186	76	1	80	0.0125000
NODE_24164_length_608_cov_8.076621	106	186	78	1	80	0.0125000
NODE_24164_length_608_cov_8.076621	106	186	86	2	80	0.0250000
NODE_24164_length_608_cov_8.076621	106	186	96	1	80	0.0125000
NODE_24164_length_608_cov_8.076621	106	186	100	1	80	0.0125000
NODE_24164_length_608_cov_8.076621	106	186	105	1	80	0.0125000
NODE_24164_length_608_cov_8.076621	106	186	108	1	80	0.0125000
NODE_24164_length_608_cov_8.076621	106	186	110	1	80	0.0125000
NODE_24164_length_608_cov_8.076621	106	186	118	2	80	0.0250000
NODE_24164_length_608_cov_8.076621	106	186	124	3	80	0.0375000
NODE_24164_length_608_cov_8.076621	106	186	125	2	80	0.0250000
NODE_24164_length_608_cov_8.076621	106	186	126	3	80	0.0375000
NODE_24164_length_608_cov_8.076621	106	186	127	5	80	0.0625000
NODE_24165_length_608_cov_7.994106	279	326	0	47	47	1.0000000
NODE_24165_length_608_cov_7.994106	348	373	0	25	25	1.0000000
NODE_24166_length_608_cov_7.939096	247	277	9	29	30	0.9666666
NODE_24166_length_608_cov_7.939096	247	277	11	1	30	0.0333333
NODE_24177_length_608_cov_3.829077	313	393	0	80	80	1.0000000
NODE_24177_length_608_cov_3.829077	366	446	0	80	80	1.0000000
NODE_24251_length_608_cov_1.064833	472	512	0	40	40	1.0000000
NODE_24281_length_607_cov_61.316929	347	427	14	24	80	0.3000000
NODE_24281_length_607_cov_61.316929	347	427	16	30	80	0.3750000
NODE_24281_length_607_cov_61.316929	347	427	19	7	80	0.0875000
NODE_24281_length_607_cov_61.316929	347	427	20	1	80	0.0125000
NODE_24281_length_607_cov_61.316929	347	427	21	16	80	0.2000000
NODE_24281_length_607_cov_61.316929	347	427	25	2	80	0.0250000
NODE_24281_length_607_cov_61.316929	347	427	14	24	80	0.3000000
NODE_24281_length_607_cov_61.316929	347	427	16	30	80	0.3750000
NODE_24281_length_607_cov_61.316929	347	427	19	7	80	0.0875000
NODE_24281_length_607_cov_61.316929	347	427	20	1	80	0.0125000
NODE_24281_length_607_cov_61.316929	347	427	21	16	80	0.2000000
NODE_24281_length_607_cov_61.316929	347	427	25	2	80	0.0250000
NODE_24281_length_607_cov_61.316929	347	427	14	24	80	0.3000000
NODE_24281_length_607_cov_61.316929	347	427	16	30	80	0.3750000
NODE_24281_length_607_cov_61.316929	347	427	19	7	80	0.0875000
NODE_24281_length_607_cov_61.316929	347	427	20	1	80	0.0125000
NODE_24281_length_607_cov_61.316929	347	427	21	16	80	0.2000000
NODE_24281_length_607_cov_61.316929	347	427	25	2	80	0.0250000
NODE_24281_length_607_cov_61.316929	364	427	14	10	63	0.1587302
NODE_24281_length_607_cov_61.316929	364	427	16	27	63	0.4285714
NODE_24281_length_607_cov_61.316929	364	427	19	7	63	0.1111111
NODE_24281_length_607_cov_61.316929	364	427	20	1	63	0.0158730
NODE_24281_length_607_cov_61.316929	364	427	21	16	63	0.2539683
NODE_24281_length_607_cov_61.316929	364	427	25	2	63	0.0317460
NODE_24281_length_607_cov_61.316929	400	480	14	1	80	0.0125000
NODE_24281_length_607_cov_61.316929	400	480	19	7	80	0.0875000
NODE_24281_length_607_cov_61.316929	400	480	20	9	80	0.1125000
NODE_24281_length_607_cov_61.316929	400	480	21	19	80	0.2375000
NODE_24281_length_607_cov_61.316929	400	480	22	17	80	0.2125000
NODE_24281_length_607_cov_61.316929	400	480	25	25	80	0.3125000
NODE_24281_length_607_cov_61.316929	400	480	26	1	80	0.0125000
NODE_24281_length_607_cov_61.316929	400	480	29	1	80	0.0125000
NODE_24281_length_607_cov_61.316929	400	480	14	1	80	0.0125000
NODE_24281_length_607_cov_61.316929	400	480	19	7	80	0.0875000
NODE_24281_length_607_cov_61.316929	400	480	20	9	80	0.1125000
NODE_24281_length_607_cov_61.316929	400	480	21	19	80	0.2375000
NODE_24281_length_607_cov_61.316929	400	480	22	17	80	0.2125000
NODE_24281_length_607_cov_61.316929	400	480	25	25	80	0.3125000
NODE_24281_length_607_cov_61.316929	400	480	26	1	80	0.0125000
NODE_24281_length_607_cov_61.316929	400	480	29	1	80	0.0125000
NODE_24281_length_607_cov_61.316929	400	480	14	1	80	0.0125000
NODE_24281_length_607_cov_61.316929	400	480	19	7	80	0.0875000
NODE_24281_length_607_cov_61.316929	400	480	20	9	80	0.1125000
NODE_24281_length_607_cov_61.316929	400	480	21	19	80	0.2375000
NODE_24281_length_607_cov_61.316929	400	480	22	17	80	0.2125000
NODE_24281_length_607_cov_61.316929	400	480	25	25	80	0.3125000
NODE_24281_length_607_cov_61.316929	400	480	26	1	80	0.0125000
NODE_24281_length_607_cov_61.316929	400	480	29	1	80	0.0125000
NODE_24281_length_607_cov_61.316929	400	480	14	1	80	0.0125000
NODE_24281_length_607_cov_61.316929	400	480	19	7	80	0.0875000
NODE_24281_length_607_cov_61.316929	400	480	20	9	80	0.1125000
NODE_24281_length_607_cov_61.316929	400	480	21	19	80	0.2375000
NODE_24281_length_607_cov_61.316929	400	480	22	17	80	0.2125000
NODE_24281_length_607_cov_61.316929	400	480	25	25	80	0.3125000
NODE_24281_length_607_cov_61.316929	400	480	26	1	80	0.0125000
NODE_24281_length_607_cov_61.316929	400	480	29	1	80	0.0125000
NODE_24281_length_607_cov_61.316929	476	556	7	5	80	0.0625000
NODE_24281_length_607_cov_61.316929	476	556	14	3	80	0.0375000
NODE_24281_length_607_cov_61.316929	476	556	17	5	80	0.0625000
NODE_24281_length_607_cov_61.316929	476	556	18	62	80	0.7750000
NODE_24281_length_607_cov_61.316929	476	556	20	1	80	0.0125000
NODE_24281_length_607_cov_61.316929	476	556	21	4	80	0.0500000
NODE_24281_length_607_cov_61.316929	476	556	7	5	80	0.0625000
NODE_24281_length_607_cov_61.316929	476	556	14	3	80	0.0375000
NODE_24281_length_607_cov_61.316929	476	556	17	5	80	0.0625000
NODE_24281_length_607_cov_61.316929	476	556	18	62	80	0.7750000
NODE_24281_length_607_cov_61.316929	476	556	20	1	80	0.0125000
NODE_24281_length_607_cov_61.316929	476	556	21	4	80	0.0500000
NODE_24281_length_607_cov_61.316929	476	556	7	5	80	0.0625000
NODE_24281_length_607_cov_61.316929	476	556	14	3	80	0.0375000
NODE_24281_length_607_cov_61.316929	476	556	17	5	80	0.0625000
NODE_24281_length_607_cov_61.316929	476	556	18	62	80	0.7750000
NODE_24281_length_607_cov_61.316929	476	556	20	1	80	0.0125000
NODE_24281_length_607_cov_61.316929	476	556	21	4	80	0.0500000
NODE_24281_length_607_cov_61.316929	529	595	0	20	66	0.3030303
NODE_24281_length_607_cov_61.316929	529	595	6	3	66	0.0454545
NODE_24281_length_607_cov_61.316929	529	595	7	21	66	0.3181818
NODE_24281_length_607_cov_61.316929	529	595	14	3	66	0.0454545
NODE_24281_length_607_cov_61.316929	529	595	17	5	66	0.0757576
NODE_24281_length_607_cov_61.316929	529	595	18	14	66	0.2121212
NODE_24281_length_607_cov_61.316929	529	607	0	32	78	0.4102564
NODE_24281_length_607_cov_61.316929	529	607	6	3	78	0.0384615
NODE_24281_length_607_cov_61.316929	529	607	7	21	78	0.2692308
NODE_24281_length_607_cov_61.316929	529	607	14	3	78	0.0384615
NODE_24281_length_607_cov_61.316929	529	607	17	5	78	0.0641026
NODE_24281_length_607_cov_61.316929	529	607	18	14	78	0.1794872
NODE_24281_length_607_cov_61.316929	529	600	0	25	71	0.3521127
NODE_24281_length_607_cov_61.316929	529	600	6	3	71	0.0422535
NODE_24281_length_607_cov_61.316929	529	600	7	21	71	0.2957746
NODE_24281_length_607_cov_61.316929	529	600	14	3	71	0.0422535
NODE_24281_length_607_cov_61.316929	529	600	17	5	71	0.0704225
NODE_24281_length_607_cov_61.316929	529	600	18	14	71	0.1971831
NODE_24281_length_607_cov_61.316929	534	607	0	32	73	0.4383562
NODE_24281_length_607_cov_61.316929	534	607	6	3	73	0.0410959
NODE_24281_length_607_cov_61.316929	534	607	7	21	73	0.2876712
NODE_24281_length_607_cov_61.316929	534	607	14	3	73	0.0410959
NODE_24281_length_607_cov_61.316929	534	607	17	5	73	0.0684932
NODE_24281_length_607_cov_61.316929	534	607	18	9	73	0.1232877
NODE_24282_length_607_cov_16.852362	383	463	0	17	80	0.2125000
NODE_24282_length_607_cov_16.852362	383	463	1	1	80	0.0125000
NODE_24282_length_607_cov_16.852362	383	463	2	62	80	0.7750000
NODE_24282_length_607_cov_16.852362	436	516	0	70	80	0.8750000
NODE_24282_length_607_cov_16.852362	436	516	1	1	80	0.0125000
NODE_24282_length_607_cov_16.852362	436	516	2	9	80	0.1125000
NODE_24283_length_607_cov_12.889764	67	147	0	80	80	1.0000000
NODE_24283_length_607_cov_12.889764	120	200	0	80	80	1.0000000
NODE_24284_length_607_cov_11.023622	122	202	0	22	80	0.2750000
NODE_24284_length_607_cov_11.023622	122	202	4	58	80	0.7250000
NODE_24284_length_607_cov_11.023622	175	255	0	17	80	0.2125000
NODE_24284_length_607_cov_11.023622	175	255	4	63	80	0.7875000
NODE_24285_length_607_cov_10.690945	199	279	2	80	80	1.0000000
NODE_24285_length_607_cov_10.690945	252	332	0	9	80	0.1125000
NODE_24285_length_607_cov_10.690945	252	332	2	71	80	0.8875000
NODE_24290_length_607_cov_5.818898	301	386	0	85	85	1.0000000
NODE_24291_length_607_cov_5.771654	278	358	0	80	80	1.0000000
NODE_24291_length_607_cov_5.771654	331	411	0	80	80	1.0000000
NODE_24295_length_607_cov_4.816929	282	362	0	80	80	1.0000000
NODE_24295_length_607_cov_4.816929	335	415	0	80	80	1.0000000
NODE_24300_length_607_cov_4.015748	295	354	0	59	59	1.0000000
NODE_24310_length_607_cov_3.088583	107	158	0	51	51	1.0000000
NODE_24331_length_607_cov_1.791339	204	247	4	3	43	0.0697674
NODE_24331_length_607_cov_1.791339	204	247	6	40	43	0.9302326
NODE_24400_length_606_cov_42.264300	182	262	0	47	80	0.5875000
NODE_24400_length_606_cov_42.264300	182	262	2	12	80	0.1500000
NODE_24400_length_606_cov_42.264300	182	262	4	21	80	0.2625000
NODE_24400_length_606_cov_42.264300	235	315	0	6	80	0.0750000
NODE_24400_length_606_cov_42.264300	235	315	4	74	80	0.9250000
NODE_24402_length_606_cov_26.341223	371	451	0	80	80	1.0000000
NODE_24402_length_606_cov_26.341223	424	504	0	80	80	1.0000000
NODE_24403_length_606_cov_14.895464	308	388	0	80	80	1.0000000
NODE_24403_length_606_cov_14.895464	361	441	0	80	80	1.0000000
NODE_24406_length_606_cov_7.934911	412	492	0	77	80	0.9625000
NODE_24406_length_606_cov_7.934911	412	492	2	3	80	0.0375000
NODE_24406_length_606_cov_7.934911	465	545	0	80	80	1.0000000
NODE_24407_length_606_cov_7.481262	250	330	0	59	80	0.7375000
NODE_24407_length_606_cov_7.481262	250	330	2	18	80	0.2250000
NODE_24407_length_606_cov_7.481262	250	330	6	3	80	0.0375000
NODE_24407_length_606_cov_7.481262	303	383	0	6	80	0.0750000
NODE_24407_length_606_cov_7.481262	303	383	2	18	80	0.2250000
NODE_24407_length_606_cov_7.481262	303	383	6	34	80	0.4250000
NODE_24407_length_606_cov_7.481262	303	383	8	4	80	0.0500000
NODE_24407_length_606_cov_7.481262	303	383	10	2	80	0.0250000
NODE_24407_length_606_cov_7.481262	303	383	12	11	80	0.1375000
NODE_24407_length_606_cov_7.481262	303	383	16	5	80	0.0625000
NODE_24409_length_606_cov_6.842209	139	219	0	29	80	0.3625000
NODE_24409_length_606_cov_6.842209	139	219	4	51	80	0.6375000
NODE_24409_length_606_cov_6.842209	192	272	0	80	80	1.0000000
NODE_24428_length_606_cov_3.384615	156	206	0	38	50	0.7600000
NODE_24428_length_606_cov_3.384615	156	206	2	12	50	0.2400000
NODE_24433_length_606_cov_2.670611	113	193	0	23	80	0.2875000
NODE_24433_length_606_cov_2.670611	113	193	6	13	80	0.1625000
NODE_24433_length_606_cov_2.670611	113	193	8	44	80	0.5500000
NODE_24525_length_605_cov_63.343874	7	83	0	76	76	1.0000000
NODE_24525_length_605_cov_63.343874	12	83	0	71	71	1.0000000
NODE_24525_length_605_cov_63.343874	17	83	0	66	66	1.0000000
NODE_24525_length_605_cov_63.343874	56	136	0	80	80	1.0000000
NODE_24525_length_605_cov_63.343874	56	136	0	80	80	1.0000000
NODE_24525_length_605_cov_63.343874	56	136	0	80	80	1.0000000
NODE_24525_length_605_cov_63.343874	132	212	0	8	80	0.1000000
NODE_24525_length_605_cov_63.343874	132	212	3	1	80	0.0125000
NODE_24525_length_605_cov_63.343874	132	212	6	71	80	0.8875000
NODE_24525_length_605_cov_63.343874	132	212	0	8	80	0.1000000
NODE_24525_length_605_cov_63.343874	132	212	3	1	80	0.0125000
NODE_24525_length_605_cov_63.343874	132	212	6	71	80	0.8875000
NODE_24525_length_605_cov_63.343874	132	210	0	8	78	0.1025641
NODE_24525_length_605_cov_63.343874	132	210	3	1	78	0.0128205
NODE_24525_length_605_cov_63.343874	132	210	6	69	78	0.8846154
NODE_24525_length_605_cov_63.343874	132	212	0	8	80	0.1000000
NODE_24525_length_605_cov_63.343874	132	212	3	1	80	0.0125000
NODE_24525_length_605_cov_63.343874	132	212	6	71	80	0.8875000
NODE_24525_length_605_cov_63.343874	132	212	0	8	80	0.1000000
NODE_24525_length_605_cov_63.343874	132	212	3	1	80	0.0125000
NODE_24525_length_605_cov_63.343874	132	212	6	71	80	0.8875000
NODE_24525_length_605_cov_63.343874	185	265	6	80	80	1.0000000
NODE_24526_length_605_cov_48.191700	298	374	0	5	76	0.0657895
NODE_24526_length_605_cov_48.191700	298	374	2	4	76	0.0526316
NODE_24526_length_605_cov_48.191700	298	374	3	67	76	0.8815789
NODE_24526_length_605_cov_48.191700	347	427	0	58	80	0.7250000
NODE_24526_length_605_cov_48.191700	347	427	2	4	80	0.0500000
NODE_24526_length_605_cov_48.191700	347	427	3	18	80	0.2250000
NODE_24528_length_605_cov_33.328063	57	137	200	1	80	0.0125000
NODE_24528_length_605_cov_33.328063	57	137	205	1	80	0.0125000
NODE_24528_length_605_cov_33.328063	57	137	209	2	80	0.0250000
NODE_24528_length_605_cov_33.328063	57	137	213	1	80	0.0125000
NODE_24528_length_605_cov_33.328063	57	137	221	1	80	0.0125000
NODE_24528_length_605_cov_33.328063	57	137	226	1	80	0.0125000
NODE_24528_length_605_cov_33.328063	57	137	227	1	80	0.0125000
NODE_24528_length_605_cov_33.328063	57	137	231	2	80	0.0250000
NODE_24528_length_605_cov_33.328063	57	137	239	1	80	0.0125000
NODE_24528_length_605_cov_33.328063	57	137	247	1	80	0.0125000
NODE_24528_length_605_cov_33.328063	57	137	249	1	80	0.0125000
NODE_24528_length_605_cov_33.328063	57	137	251	1	80	0.0125000
NODE_24528_length_605_cov_33.328063	57	137	252	1	80	0.0125000
NODE_24528_length_605_cov_33.328063	57	137	256	1	80	0.0125000
NODE_24528_length_605_cov_33.328063	57	137	267	1	80	0.0125000
NODE_24528_length_605_cov_33.328063	57	137	277	1	80	0.0125000
NODE_24528_length_605_cov_33.328063	57	137	283	1	80	0.0125000
NODE_24528_length_605_cov_33.328063	57	137	291	1	80	0.0125000
NODE_24528_length_605_cov_33.328063	57	137	294	2	80	0.0250000
NODE_24528_length_605_cov_33.328063	57	137	297	1	80	0.0125000
NODE_24528_length_605_cov_33.328063	57	137	301	1	80	0.0125000
NODE_24528_length_605_cov_33.328063	57	137	304	1	80	0.0125000
NODE_24528_length_605_cov_33.328063	57	137	306	1	80	0.0125000
NODE_24528_length_605_cov_33.328063	57	137	312	2	80	0.0250000
NODE_24528_length_605_cov_33.328063	57	137	316	1	80	0.0125000
NODE_24528_length_605_cov_33.328063	57	137	319	1	80	0.0125000
NODE_24528_length_605_cov_33.328063	57	137	326	2	80	0.0250000
NODE_24528_length_605_cov_33.328063	57	137	327	1	80	0.0125000
NODE_24528_length_605_cov_33.328063	57	137	329	1	80	0.0125000
NODE_24528_length_605_cov_33.328063	57	137	330	1	80	0.0125000
NODE_24528_length_605_cov_33.328063	57	137	332	1	80	0.0125000
NODE_24528_length_605_cov_33.328063	57	137	336	1	80	0.0125000
NODE_24528_length_605_cov_33.328063	57	137	343	3	80	0.0375000
NODE_24528_length_605_cov_33.328063	57	137	344	1	80	0.0125000
NODE_24528_length_605_cov_33.328063	57	137	346	1	80	0.0125000
NODE_24528_length_605_cov_33.328063	57	137	350	2	80	0.0250000
NODE_24528_length_605_cov_33.328063	57	137	354	1	80	0.0125000
NODE_24528_length_605_cov_33.328063	57	137	358	1	80	0.0125000
NODE_24528_length_605_cov_33.328063	57	137	363	1	80	0.0125000
NODE_24528_length_605_cov_33.328063	57	137	364	1	80	0.0125000
NODE_24528_length_605_cov_33.328063	57	137	366	2	80	0.0250000
NODE_24528_length_605_cov_33.328063	57	137	369	1	80	0.0125000
NODE_24528_length_605_cov_33.328063	57	137	379	1	80	0.0125000
NODE_24528_length_605_cov_33.328063	57	137	380	2	80	0.0250000
NODE_24528_length_605_cov_33.328063	57	137	381	1	80	0.0125000
NODE_24528_length_605_cov_33.328063	57	137	384	1	80	0.0125000
NODE_24528_length_605_cov_33.328063	57	137	385	1	80	0.0125000
NODE_24528_length_605_cov_33.328063	57	137	386	2	80	0.0250000
NODE_24528_length_605_cov_33.328063	57	137	387	1	80	0.0125000
NODE_24528_length_605_cov_33.328063	57	137	388	2	80	0.0250000
NODE_24528_length_605_cov_33.328063	57	137	389	2	80	0.0250000
NODE_24528_length_605_cov_33.328063	57	137	390	2	80	0.0250000
NODE_24528_length_605_cov_33.328063	57	137	391	3	80	0.0375000
NODE_24528_length_605_cov_33.328063	57	137	392	1	80	0.0125000
NODE_24528_length_605_cov_33.328063	57	137	399	1	80	0.0125000
NODE_24528_length_605_cov_33.328063	57	137	401	1	80	0.0125000
NODE_24528_length_605_cov_33.328063	57	137	403	5	80	0.0625000
NODE_24528_length_605_cov_33.328063	57	137	404	1	80	0.0125000
NODE_24528_length_605_cov_33.328063	57	137	417	1	80	0.0125000
NODE_24528_length_605_cov_33.328063	57	137	419	1	80	0.0125000
NODE_24528_length_605_cov_33.328063	140	175	482	1	35	0.0285714
NODE_24528_length_605_cov_33.328063	140	175	485	1	35	0.0285714
NODE_24528_length_605_cov_33.328063	140	175	489	1	35	0.0285714
NODE_24528_length_605_cov_33.328063	140	175	490	1	35	0.0285714
NODE_24528_length_605_cov_33.328063	140	175	491	1	35	0.0285714
NODE_24528_length_605_cov_33.328063	140	175	492	1	35	0.0285714
NODE_24528_length_605_cov_33.328063	140	175	498	1	35	0.0285714
NODE_24528_length_605_cov_33.328063	140	175	499	1	35	0.0285714
NODE_24528_length_605_cov_33.328063	140	175	506	1	35	0.0285714
NODE_24528_length_605_cov_33.328063	140	175	530	1	35	0.0285714
NODE_24528_length_605_cov_33.328063	140	175	540	1	35	0.0285714
NODE_24528_length_605_cov_33.328063	140	175	543	1	35	0.0285714
NODE_24528_length_605_cov_33.328063	140	175	550	1	35	0.0285714
NODE_24528_length_605_cov_33.328063	140	175	561	1	35	0.0285714
NODE_24528_length_605_cov_33.328063	140	175	573	1	35	0.0285714
NODE_24528_length_605_cov_33.328063	140	175	587	1	35	0.0285714
NODE_24528_length_605_cov_33.328063	140	175	590	1	35	0.0285714
NODE_24528_length_605_cov_33.328063	140	175	595	1	35	0.0285714
NODE_24528_length_605_cov_33.328063	140	175	605	2	35	0.0571429
NODE_24528_length_605_cov_33.328063	140	175	609	2	35	0.0571429
NODE_24528_length_605_cov_33.328063	140	175	611	1	35	0.0285714
NODE_24528_length_605_cov_33.328063	140	175	614	1	35	0.0285714
NODE_24528_length_605_cov_33.328063	140	175	616	2	35	0.0571429
NODE_24528_length_605_cov_33.328063	140	175	621	1	35	0.0285714
NODE_24528_length_605_cov_33.328063	140	175	629	1	35	0.0285714
NODE_24528_length_605_cov_33.328063	140	175	630	1	35	0.0285714
NODE_24528_length_605_cov_33.328063	140	175	632	1	35	0.0285714
NODE_24528_length_605_cov_33.328063	140	175	633	1	35	0.0285714
NODE_24528_length_605_cov_33.328063	140	175	634	1	35	0.0285714
NODE_24528_length_605_cov_33.328063	140	175	635	2	35	0.0571429
NODE_24528_length_605_cov_33.328063	140	175	644	1	35	0.0285714
NODE_24529_length_605_cov_26.717391	353	433	0	80	80	1.0000000
NODE_24529_length_605_cov_26.717391	406	486	0	80	80	1.0000000
NODE_24530_length_605_cov_17.677866	215	295	0	33	80	0.4125000
NODE_24530_length_605_cov_17.677866	215	295	2	47	80	0.5875000
NODE_24530_length_605_cov_17.677866	268	348	0	30	80	0.3750000
NODE_24530_length_605_cov_17.677866	268	348	2	50	80	0.6250000
NODE_24531_length_605_cov_15.225296	144	224	0	80	80	1.0000000
NODE_24531_length_605_cov_15.225296	197	277	0	80	80	1.0000000
NODE_24532_length_605_cov_14.990119	136	216	0	80	80	1.0000000
NODE_24532_length_605_cov_14.990119	189	269	0	80	80	1.0000000
NODE_24533_length_605_cov_10.835968	103	183	0	80	80	1.0000000
NODE_24533_length_605_cov_10.835968	156	236	0	80	80	1.0000000
NODE_24534_length_605_cov_9.169960	306	377	0	6	71	0.0845070
NODE_24534_length_605_cov_9.169960	306	377	2	49	71	0.6901408
NODE_24534_length_605_cov_9.169960	306	377	4	16	71	0.2253521
NODE_24534_length_605_cov_9.169960	359	432	0	6	73	0.0821918
NODE_24534_length_605_cov_9.169960	359	432	2	67	73	0.9178082
NODE_24546_length_605_cov_4.308300	159	239	0	69	80	0.8625000
NODE_24546_length_605_cov_4.308300	159	239	2	11	80	0.1375000
NODE_24546_length_605_cov_4.308300	271	338	12	3	67	0.0447761
NODE_24546_length_605_cov_4.308300	271	338	16	2	67	0.0298507
NODE_24546_length_605_cov_4.308300	271	338	18	4	67	0.0597015
NODE_24546_length_605_cov_4.308300	271	338	20	3	67	0.0447761
NODE_24546_length_605_cov_4.308300	271	338	22	11	67	0.1641791
NODE_24546_length_605_cov_4.308300	271	338	24	1	67	0.0149254
NODE_24546_length_605_cov_4.308300	271	338	26	1	67	0.0149254
NODE_24546_length_605_cov_4.308300	271	338	28	5	67	0.0746269
NODE_24546_length_605_cov_4.308300	271	338	30	37	67	0.5522388
NODE_24546_length_605_cov_4.308300	275	350	16	1	75	0.0133333
NODE_24546_length_605_cov_4.308300	275	350	18	4	75	0.0533333
NODE_24546_length_605_cov_4.308300	275	350	20	3	75	0.0400000
NODE_24546_length_605_cov_4.308300	275	350	22	11	75	0.1466667
NODE_24546_length_605_cov_4.308300	275	350	24	1	75	0.0133333
NODE_24546_length_605_cov_4.308300	275	350	26	2	75	0.0266667
NODE_24546_length_605_cov_4.308300	275	350	28	11	75	0.1466667
NODE_24546_length_605_cov_4.308300	275	350	30	42	75	0.5600000
NODE_24546_length_605_cov_4.308300	315	372	18	3	57	0.0526316
NODE_24546_length_605_cov_4.308300	315	372	20	7	57	0.1228070
NODE_24546_length_605_cov_4.308300	315	372	22	11	57	0.1929825
NODE_24546_length_605_cov_4.308300	315	372	24	1	57	0.0175439
NODE_24546_length_605_cov_4.308300	315	372	26	1	57	0.0175439
NODE_24546_length_605_cov_4.308300	315	372	28	6	57	0.1052632
NODE_24546_length_605_cov_4.308300	315	372	30	28	57	0.4912281
NODE_24546_length_605_cov_4.308300	328	373	16	1	45	0.0222222
NODE_24546_length_605_cov_4.308300	328	373	18	3	45	0.0666667
NODE_24546_length_605_cov_4.308300	328	373	20	7	45	0.1555556
NODE_24546_length_605_cov_4.308300	328	373	22	11	45	0.2444444
NODE_24546_length_605_cov_4.308300	328	373	24	1	45	0.0222222
NODE_24546_length_605_cov_4.308300	328	373	26	1	45	0.0222222
NODE_24546_length_605_cov_4.308300	328	373	28	6	45	0.1333333
NODE_24546_length_605_cov_4.308300	328	373	30	15	45	0.3333333
NODE_24558_length_605_cov_3.120553	216	287	0	67	71	0.9436620
NODE_24558_length_605_cov_3.120553	216	287	2	4	71	0.0563380
NODE_24561_length_605_cov_2.909091	408	487	16	10	79	0.1265823
NODE_24561_length_605_cov_2.909091	408	487	18	7	79	0.0886076
NODE_24561_length_605_cov_2.909091	408	487	20	10	79	0.1265823
NODE_24561_length_605_cov_2.909091	408	487	22	8	79	0.1012658
NODE_24561_length_605_cov_2.909091	408	487	24	44	79	0.5569620
NODE_24577_length_605_cov_1.897233	230	273	0	1	43	0.0232558
NODE_24577_length_605_cov_1.897233	230	273	2	42	43	0.9767442
NODE_24603_length_605_cov_1.339921	168	210	0	42	42	1.0000000
NODE_24636_length_604_cov_30.411881	93	173	0	80	80	1.0000000
NODE_24636_length_604_cov_30.411881	146	226	0	80	80	1.0000000
NODE_24637_length_604_cov_20.099010	414	494	0	46	80	0.5750000
NODE_24637_length_604_cov_20.099010	414	494	2	26	80	0.3250000
NODE_24637_length_604_cov_20.099010	414	494	4	8	80	0.1000000
NODE_24637_length_604_cov_20.099010	467	547	0	80	80	1.0000000
NODE_24639_length_604_cov_10.291089	184	264	0	80	80	1.0000000
NODE_24639_length_604_cov_10.291089	237	317	0	80	80	1.0000000
NODE_24646_length_604_cov_6.033663	265	345	0	37	80	0.4625000
NODE_24646_length_604_cov_6.033663	265	345	2	43	80	0.5375000
NODE_24646_length_604_cov_6.033663	318	397	0	27	79	0.3417721
NODE_24646_length_604_cov_6.033663	318	397	2	37	79	0.4683544
NODE_24646_length_604_cov_6.033663	318	397	4	2	79	0.0253165
NODE_24646_length_604_cov_6.033663	318	397	6	13	79	0.1645570
NODE_24654_length_604_cov_4.316832	40	106	0	66	66	1.0000000
NODE_24654_length_604_cov_4.316832	377	435	0	54	58	0.9310345
NODE_24654_length_604_cov_4.316832	377	435	2	4	58	0.0689655
NODE_24692_length_604_cov_1.805941	299	380	0	81	81	1.0000000
NODE_24692_length_604_cov_1.805941	353	433	0	80	80	1.0000000
NODE_24732_length_603_cov_18.761905	108	188	0	80	80	1.0000000
NODE_24732_length_603_cov_18.761905	161	241	0	80	80	1.0000000
NODE_24734_length_603_cov_8.996032	163	243	0	80	80	1.0000000
NODE_24734_length_603_cov_8.996032	216	296	0	80	80	1.0000000
NODE_24735_length_603_cov_8.970238	413	493	0	80	80	1.0000000
NODE_24736_length_603_cov_7.212302	324	404	0	80	80	1.0000000
NODE_24736_length_603_cov_7.212302	377	457	0	80	80	1.0000000
NODE_24739_length_603_cov_5.831349	351	385	0	34	34	1.0000000
NODE_24744_length_603_cov_4.744048	103	183	0	80	80	1.0000000
NODE_24744_length_603_cov_4.744048	156	236	0	80	80	1.0000000
NODE_24748_length_603_cov_4.115079	219	259	0	40	40	1.0000000
NODE_24755_length_603_cov_3.269841	186	223	0	37	37	1.0000000
NODE_24755_length_603_cov_3.269841	196	276	0	80	80	1.0000000
NODE_24755_length_603_cov_3.269841	367	441	0	74	74	1.0000000
NODE_24843_length_602_cov_33.208748	106	186	2	26	80	0.3250000
NODE_24843_length_602_cov_33.208748	106	186	6	28	80	0.3500000
NODE_24843_length_602_cov_33.208748	106	186	8	26	80	0.3250000
NODE_24843_length_602_cov_33.208748	159	239	0	17	80	0.2125000
NODE_24843_length_602_cov_33.208748	159	239	6	63	80	0.7875000
NODE_24844_length_602_cov_28.922465	319	399	0	80	80	1.0000000
NODE_24844_length_602_cov_28.922465	372	452	0	80	80	1.0000000
NODE_24846_length_602_cov_10.930417	248	328	0	80	80	1.0000000
NODE_24846_length_602_cov_10.930417	301	381	0	80	80	1.0000000
NODE_24847_length_602_cov_10.447316	148	207	12	2	59	0.0338983
NODE_24847_length_602_cov_10.447316	148	207	13	7	59	0.1186441
NODE_24847_length_602_cov_10.447316	148	207	14	1	59	0.0169492
NODE_24847_length_602_cov_10.447316	148	207	15	8	59	0.1355932
NODE_24847_length_602_cov_10.447316	148	207	18	14	59	0.2372881
NODE_24847_length_602_cov_10.447316	148	207	19	12	59	0.2033898
NODE_24847_length_602_cov_10.447316	148	207	20	1	59	0.0169492
NODE_24847_length_602_cov_10.447316	148	207	21	8	59	0.1355932
NODE_24847_length_602_cov_10.447316	148	207	23	4	59	0.0677966
NODE_24847_length_602_cov_10.447316	148	207	25	2	59	0.0338983
NODE_24847_length_602_cov_10.447316	181	207	18	14	26	0.5384616
NODE_24847_length_602_cov_10.447316	181	207	19	5	26	0.1923077
NODE_24847_length_602_cov_10.447316	181	207	20	1	26	0.0384615
NODE_24847_length_602_cov_10.447316	181	207	23	4	26	0.1538462
NODE_24847_length_602_cov_10.447316	181	207	25	2	26	0.0769231
NODE_24847_length_602_cov_10.447316	259	291	26	1	32	0.0312500
NODE_24847_length_602_cov_10.447316	259	291	28	6	32	0.1875000
NODE_24847_length_602_cov_10.447316	259	291	30	24	32	0.7500000
NODE_24847_length_602_cov_10.447316	259	291	34	1	32	0.0312500
NODE_24851_length_602_cov_7.787276	544	565	0	21	21	1.0000000
NODE_24875_length_602_cov_3.332008	157	239	10	24	82	0.2926829
NODE_24875_length_602_cov_3.332008	157	239	12	58	82	0.7073171
NODE_24957_length_601_cov_14.952191	183	263	0	80	80	1.0000000
NODE_24957_length_601_cov_14.952191	236	316	0	80	80	1.0000000
NODE_24958_length_601_cov_14.747012	324	404	0	58	80	0.7250000
NODE_24958_length_601_cov_14.747012	324	404	2	22	80	0.2750000
NODE_24958_length_601_cov_14.747012	377	457	0	5	80	0.0625000
NODE_24958_length_601_cov_14.747012	377	457	2	75	80	0.9375000
NODE_24959_length_601_cov_11.561753	226	306	0	80	80	1.0000000
NODE_24959_length_601_cov_11.561753	279	359	0	80	80	1.0000000
NODE_24960_length_601_cov_10.826693	320	388	0	68	68	1.0000000
NODE_24961_length_601_cov_10.392430	243	323	0	80	80	1.0000000
NODE_24961_length_601_cov_10.392430	296	375	0	79	79	1.0000000
NODE_24965_length_601_cov_7.037849	236	316	0	80	80	1.0000000
NODE_24965_length_601_cov_7.037849	289	369	0	29	80	0.3625000
NODE_24965_length_601_cov_7.037849	289	369	2	51	80	0.6375000
NODE_24969_length_601_cov_5.798805	290	361	0	71	71	1.0000000
NODE_24970_length_601_cov_5.657371	228	308	14	8	80	0.1000000
NODE_24970_length_601_cov_5.657371	228	308	16	72	80	0.9000000
NODE_24973_length_601_cov_5.039841	395	462	0	4	67	0.0597015
NODE_24973_length_601_cov_5.039841	395	462	2	16	67	0.2388060
NODE_24973_length_601_cov_5.039841	395	462	4	47	67	0.7014925
NODE_24975_length_601_cov_4.735060	184	247	0	63	63	1.0000000
NODE_24995_length_601_cov_2.599602	371	430	0	59	59	1.0000000
NODE_24995_length_601_cov_2.599602	441	494	0	53	53	1.0000000
NODE_25090_length_600_cov_6.341317	125	147	0	22	22	1.0000000
NODE_25103_length_600_cov_3.754491	142	222	6	2	80	0.0250000
NODE_25103_length_600_cov_3.754491	142	222	8	1	80	0.0125000
NODE_25103_length_600_cov_3.754491	142	222	10	77	80	0.9625000
NODE_25126_length_600_cov_2.081836	282	328	0	46	46	1.0000000
NODE_25141_length_600_cov_1.728543	381	423	0	42	42	1.0000000
NODE_25190_length_599_cov_36.488000	25	105	26	8	80	0.1000000
NODE_25190_length_599_cov_36.488000	25	105	28	72	80	0.9000000
NODE_25191_length_599_cov_27.870000	255	335	2	80	80	1.0000000
NODE_25191_length_599_cov_27.870000	308	388	0	50	80	0.6250000
NODE_25191_length_599_cov_27.870000	308	388	2	30	80	0.3750000
NODE_25192_length_599_cov_22.640000	229	309	0	80	80	1.0000000
NODE_25192_length_599_cov_22.640000	229	309	0	80	80	1.0000000
NODE_25192_length_599_cov_22.640000	229	309	0	80	80	1.0000000
NODE_25192_length_599_cov_22.640000	229	309	0	80	80	1.0000000
NODE_25192_length_599_cov_22.640000	229	309	0	80	80	1.0000000
NODE_25192_length_599_cov_22.640000	282	362	0	80	80	1.0000000
NODE_25192_length_599_cov_22.640000	282	362	0	80	80	1.0000000
NODE_25192_length_599_cov_22.640000	282	353	0	71	71	1.0000000
NODE_25192_length_599_cov_22.640000	285	355	0	70	70	1.0000000
NODE_25192_length_599_cov_22.640000	287	362	0	75	75	1.0000000
NODE_25193_length_599_cov_14.618000	279	359	0	65	80	0.8125000
NODE_25193_length_599_cov_14.618000	279	359	2	15	80	0.1875000
NODE_25193_length_599_cov_14.618000	332	412	0	80	80	1.0000000
NODE_25195_length_599_cov_10.308000	245	325	0	80	80	1.0000000
NODE_25195_length_599_cov_10.308000	298	378	0	80	80	1.0000000
NODE_25196_length_599_cov_9.224000	160	240	0	18	80	0.2250000
NODE_25196_length_599_cov_9.224000	160	240	2	62	80	0.7750000
NODE_25196_length_599_cov_9.224000	213	297	0	42	84	0.5000000
NODE_25196_length_599_cov_9.224000	213	297	2	42	84	0.5000000
NODE_25201_length_599_cov_5.536000	58	112	0	54	54	1.0000000
NODE_25208_length_599_cov_3.810000	271	334	2	63	63	1.0000000
NODE_25208_length_599_cov_3.810000	324	390	0	46	66	0.6969697
NODE_25208_length_599_cov_3.810000	324	390	2	20	66	0.3030303
NODE_25211_length_599_cov_3.598000	238	318	0	80	80	1.0000000
NODE_25211_length_599_cov_3.598000	291	371	0	80	80	1.0000000
NODE_25308_length_598_cov_54.450902	264	344	1	2	80	0.0250000
NODE_25308_length_598_cov_54.450902	264	344	2	67	80	0.8375000
NODE_25308_length_598_cov_54.450902	264	344	3	2	80	0.0250000
NODE_25308_length_598_cov_54.450902	264	344	4	9	80	0.1125000
NODE_25308_length_598_cov_54.450902	317	397	2	16	80	0.2000000
NODE_25308_length_598_cov_54.450902	317	397	3	55	80	0.6875000
NODE_25308_length_598_cov_54.450902	317	397	4	9	80	0.1125000
NODE_25309_length_598_cov_8.326653	204	284	0	80	80	1.0000000
NODE_25309_length_598_cov_8.326653	257	337	0	80	80	1.0000000
NODE_25316_length_598_cov_5.623246	169	240	0	49	71	0.6901408
NODE_25316_length_598_cov_5.623246	169	240	4	22	71	0.3098592
NODE_25320_length_598_cov_4.929860	73	153	0	80	80	1.0000000
NODE_25320_length_598_cov_4.929860	126	206	0	80	80	1.0000000
NODE_25421_length_597_cov_15.142570	197	277	0	80	80	1.0000000
NODE_25421_length_597_cov_15.142570	250	330	0	80	80	1.0000000
NODE_25422_length_597_cov_12.387550	118	198	2	80	80	1.0000000
NODE_25422_length_597_cov_12.387550	171	251	0	44	80	0.5500000
NODE_25422_length_597_cov_12.387550	171	251	2	36	80	0.4500000
NODE_25423_length_597_cov_7.016064	213	293	0	80	80	1.0000000
NODE_25423_length_597_cov_7.016064	266	346	0	80	80	1.0000000
NODE_25426_length_597_cov_6.212851	374	449	0	15	75	0.2000000
NODE_25426_length_597_cov_6.212851	374	449	1	60	75	0.8000000
NODE_25434_length_597_cov_4.273092	368	448	0	80	80	1.0000000
NODE_25434_length_597_cov_4.273092	421	507	0	86	86	1.0000000
NODE_25464_length_597_cov_2.162651	92	172	0	80	80	1.0000000
NODE_25464_length_597_cov_2.162651	145	225	0	80	80	1.0000000
NODE_25467_length_597_cov_2.096386	440	509	0	69	69	1.0000000
NODE_25469_length_597_cov_1.977912	392	472	4	30	80	0.3750000
NODE_25469_length_597_cov_1.977912	392	472	7	38	80	0.4750000
NODE_25469_length_597_cov_1.977912	392	472	8	12	80	0.1500000
NODE_25469_length_597_cov_1.977912	437	494	4	17	57	0.2982456
NODE_25469_length_597_cov_1.977912	437	494	7	40	57	0.7017544
NODE_25469_length_597_cov_1.977912	445	525	0	15	80	0.1875000
NODE_25469_length_597_cov_1.977912	445	525	4	33	80	0.4125000
NODE_25469_length_597_cov_1.977912	445	525	7	32	80	0.4000000
NODE_25552_length_596_cov_32.293763	221	301	0	31	80	0.3875000
NODE_25552_length_596_cov_32.293763	221	301	2	49	80	0.6125000
NODE_25552_length_596_cov_32.293763	274	354	0	27	80	0.3375000
NODE_25552_length_596_cov_32.293763	274	354	2	53	80	0.6625000
NODE_25552_length_596_cov_32.293763	351	406	0	55	55	1.0000000
NODE_25552_length_596_cov_32.293763	381	459	0	78	78	1.0000000
NODE_25553_length_596_cov_26.891348	199	279	0	44	80	0.5500000
NODE_25553_length_596_cov_26.891348	199	279	2	36	80	0.4500000
NODE_25553_length_596_cov_26.891348	252	332	2	49	80	0.6125000
NODE_25553_length_596_cov_26.891348	252	332	4	31	80	0.3875000
NODE_25554_length_596_cov_17.082495	179	259	0	80	80	1.0000000
NODE_25554_length_596_cov_17.082495	232	312	0	80	80	1.0000000
NODE_25555_length_596_cov_10.372233	354	434	0	80	80	1.0000000
NODE_25555_length_596_cov_10.372233	407	487	0	80	80	1.0000000
NODE_25557_length_596_cov_6.955734	142	222	0	80	80	1.0000000
NODE_25558_length_596_cov_6.225352	242	322	0	47	80	0.5875000
NODE_25558_length_596_cov_6.225352	242	322	2	33	80	0.4125000
NODE_25558_length_596_cov_6.225352	308	375	2	67	67	1.0000000
NODE_25567_length_596_cov_4.197183	369	444	0	52	75	0.6933333
NODE_25567_length_596_cov_4.197183	369	444	6	23	75	0.3066667
NODE_25593_length_596_cov_2.066398	534	583	0	49	49	1.0000000
NODE_25666_length_595_cov_52.532258	248	328	0	80	80	1.0000000
NODE_25666_length_595_cov_52.532258	301	381	0	80	80	1.0000000
NODE_25667_length_595_cov_38.584677	122	202	0	80	80	1.0000000
NODE_25667_length_595_cov_38.584677	175	255	0	80	80	1.0000000
NODE_25669_length_595_cov_10.576613	323	403	0	51	80	0.6375000
NODE_25669_length_595_cov_10.576613	323	403	1	18	80	0.2250000
NODE_25669_length_595_cov_10.576613	323	403	2	11	80	0.1375000
NODE_25669_length_595_cov_10.576613	376	456	1	16	80	0.2000000
NODE_25669_length_595_cov_10.576613	376	456	2	64	80	0.8000000
NODE_25672_length_595_cov_7.917339	342	415	0	18	73	0.2465753
NODE_25672_length_595_cov_7.917339	342	415	4	55	73	0.7534246
NODE_25672_length_595_cov_7.917339	388	438	0	9	50	0.1800000
NODE_25672_length_595_cov_7.917339	388	438	4	41	50	0.8200000
NODE_25702_length_595_cov_2.792339	178	258	0	49	80	0.6125000
NODE_25702_length_595_cov_2.792339	178	258	4	31	80	0.3875000
NODE_25702_length_595_cov_2.792339	231	311	4	58	80	0.7250000
NODE_25702_length_595_cov_2.792339	231	311	6	22	80	0.2750000
NODE_25807_length_594_cov_34.157576	283	363	0	34	80	0.4250000
NODE_25807_length_594_cov_34.157576	283	363	4	46	80	0.5750000
NODE_25807_length_594_cov_34.157576	336	416	0	80	80	1.0000000
NODE_25811_length_594_cov_8.933333	258	338	0	80	80	1.0000000
NODE_25811_length_594_cov_8.933333	311	389	0	78	78	1.0000000
NODE_25815_length_594_cov_5.759596	82	118	0	27	36	0.7500000
NODE_25815_length_594_cov_5.759596	82	118	6	9	36	0.2500000
NODE_25815_length_594_cov_5.759596	114	194	6	80	80	1.0000000
NODE_25815_length_594_cov_5.759596	167	242	0	39	75	0.5200000
NODE_25815_length_594_cov_5.759596	167	242	6	36	75	0.4800000
NODE_25825_length_594_cov_3.913131	275	355	2	1	80	0.0125000
NODE_25825_length_594_cov_3.913131	275	355	3	13	80	0.1625000
NODE_25825_length_594_cov_3.913131	275	355	4	9	80	0.1125000
NODE_25825_length_594_cov_3.913131	275	355	6	23	80	0.2875000
NODE_25825_length_594_cov_3.913131	275	355	8	34	80	0.4250000
NODE_25844_length_594_cov_2.470707	209	247	0	38	38	1.0000000
NODE_25919_length_594_cov_0.698990	33	73	0	40	40	1.0000000
NODE_25928_length_593_cov_124.985830	247	285	34	9	38	0.2368421
NODE_25928_length_593_cov_124.985830	247	285	38	2	38	0.0526316
NODE_25928_length_593_cov_124.985830	247	285	40	1	38	0.0263158
NODE_25928_length_593_cov_124.985830	247	285	42	3	38	0.0789474
NODE_25928_length_593_cov_124.985830	247	285	44	1	38	0.0263158
NODE_25928_length_593_cov_124.985830	247	285	48	2	38	0.0526316
NODE_25928_length_593_cov_124.985830	247	285	58	1	38	0.0263158
NODE_25928_length_593_cov_124.985830	247	285	61	2	38	0.0526316
NODE_25928_length_593_cov_124.985830	247	285	62	1	38	0.0263158
NODE_25928_length_593_cov_124.985830	247	285	66	3	38	0.0789474
NODE_25928_length_593_cov_124.985830	247	285	68	1	38	0.0263158
NODE_25928_length_593_cov_124.985830	247	285	72	3	38	0.0789474
NODE_25928_length_593_cov_124.985830	247	285	80	1	38	0.0263158
NODE_25928_length_593_cov_124.985830	247	285	81	7	38	0.1842105
NODE_25928_length_593_cov_124.985830	247	285	83	1	38	0.0263158
NODE_25929_length_593_cov_36.161943	150	230	4	2	80	0.0250000
NODE_25929_length_593_cov_36.161943	150	230	6	35	80	0.4375000
NODE_25929_length_593_cov_36.161943	150	230	8	43	80	0.5375000
NODE_25929_length_593_cov_36.161943	203	283	0	16	80	0.2000000
NODE_25929_length_593_cov_36.161943	203	283	4	39	80	0.4875000
NODE_25929_length_593_cov_36.161943	203	283	6	25	80	0.3125000
NODE_25930_length_593_cov_14.979757	219	299	0	80	80	1.0000000
NODE_25930_length_593_cov_14.979757	272	352	0	80	80	1.0000000
NODE_25931_length_593_cov_11.018219	324	404	0	80	80	1.0000000
NODE_25931_length_593_cov_11.018219	377	457	0	80	80	1.0000000
NODE_25946_length_593_cov_3.232794	210	273	0	63	63	1.0000000
NODE_25946_length_593_cov_3.232794	263	326	0	63	63	1.0000000
NODE_25996_length_593_cov_1.261134	227	249	0	22	22	1.0000000
NODE_26033_length_592_cov_18.908722	163	243	0	62	80	0.7750000
NODE_26033_length_592_cov_18.908722	163	243	2	18	80	0.2250000
NODE_26033_length_592_cov_18.908722	230	296	0	4	66	0.0606061
NODE_26033_length_592_cov_18.908722	230	296	2	62	66	0.9393939
NODE_26034_length_592_cov_7.531440	232	312	0	17	80	0.2125000
NODE_26034_length_592_cov_7.531440	232	312	2	63	80	0.7875000
NODE_26034_length_592_cov_7.531440	285	361	0	31	76	0.4078947
NODE_26034_length_592_cov_7.531440	285	361	2	45	76	0.5921053
NODE_26035_length_592_cov_7.000000	77	157	0	3	80	0.0375000
NODE_26035_length_592_cov_7.000000	77	157	2	40	80	0.5000000
NODE_26035_length_592_cov_7.000000	77	157	6	37	80	0.4625000
NODE_26035_length_592_cov_7.000000	130	210	0	13	80	0.1625000
NODE_26035_length_592_cov_7.000000	130	210	4	31	80	0.3875000
NODE_26035_length_592_cov_7.000000	130	210	6	36	80	0.4500000
NODE_26040_length_592_cov_5.036511	270	349	0	11	79	0.1392405
NODE_26040_length_592_cov_5.036511	270	349	1	1	79	0.0126582
NODE_26040_length_592_cov_5.036511	270	349	2	67	79	0.8481013
NODE_26041_length_592_cov_5.024341	205	285	0	11	80	0.1375000
NODE_26041_length_592_cov_5.024341	205	285	2	7	80	0.0875000
NODE_26041_length_592_cov_5.024341	205	285	4	36	80	0.4500000
NODE_26041_length_592_cov_5.024341	205	285	6	26	80	0.3250000
NODE_26041_length_592_cov_5.024341	258	309	4	6	51	0.1176471
NODE_26041_length_592_cov_5.024341	258	309	6	45	51	0.8823529
NODE_26062_length_592_cov_2.866126	61	127	0	66	66	1.0000000
NODE_26069_length_592_cov_2.361055	476	526	0	9	50	0.1800000
NODE_26069_length_592_cov_2.361055	476	526	2	11	50	0.2200000
NODE_26069_length_592_cov_2.361055	476	526	4	30	50	0.6000000
NODE_26142_length_591_cov_11.286585	245	325	0	1	80	0.0125000
NODE_26142_length_591_cov_11.286585	245	325	2	33	80	0.4125000
NODE_26142_length_591_cov_11.286585	245	325	4	46	80	0.5750000
NODE_26142_length_591_cov_11.286585	298	378	0	16	80	0.2000000
NODE_26142_length_591_cov_11.286585	298	378	2	16	80	0.2000000
NODE_26142_length_591_cov_11.286585	298	378	4	48	80	0.6000000
NODE_26143_length_591_cov_9.432927	241	321	0	80	80	1.0000000
NODE_26143_length_591_cov_9.432927	294	374	0	80	80	1.0000000
NODE_26184_length_591_cov_2.365854	396	476	0	80	80	1.0000000
NODE_26184_length_591_cov_2.365854	449	529	0	80	80	1.0000000
NODE_26272_length_590_cov_29.661914	26	106	0	80	80	1.0000000
NODE_26272_length_590_cov_29.661914	79	159	0	80	80	1.0000000
NODE_26272_length_590_cov_29.661914	155	235	0	80	80	1.0000000
NODE_26272_length_590_cov_29.661914	208	288	0	80	80	1.0000000
NODE_26273_length_590_cov_21.360489	178	258	0	80	80	1.0000000
NODE_26273_length_590_cov_21.360489	231	311	0	80	80	1.0000000
NODE_26274_length_590_cov_18.395112	161	241	0	34	80	0.4250000
NODE_26274_length_590_cov_18.395112	161	241	2	16	80	0.2000000
NODE_26274_length_590_cov_18.395112	161	241	8	30	80	0.3750000
NODE_26274_length_590_cov_18.395112	214	294	8	80	80	1.0000000
NODE_26275_length_590_cov_17.376782	238	318	0	20	80	0.2500000
NODE_26275_length_590_cov_17.376782	238	318	2	60	80	0.7500000
NODE_26275_length_590_cov_17.376782	291	371	0	35	80	0.4375000
NODE_26275_length_590_cov_17.376782	291	371	2	45	80	0.5625000
NODE_26279_length_590_cov_6.205703	262	333	0	37	71	0.5211267
NODE_26279_length_590_cov_6.205703	262	333	2	34	71	0.4788733
NODE_26283_length_590_cov_5.319756	224	304	0	80	80	1.0000000
NODE_26283_length_590_cov_5.319756	277	357	0	80	80	1.0000000
NODE_26366_length_590_cov_0.971487	0	32	0	32	32	1.0000000
NODE_26390_length_589_cov_15.810204	384	464	2	80	80	1.0000000
NODE_26390_length_589_cov_15.810204	437	517	0	50	80	0.6250000
NODE_26390_length_589_cov_15.810204	437	517	2	30	80	0.3750000
NODE_26391_length_589_cov_13.855102	320	400	0	5	80	0.0625000
NODE_26391_length_589_cov_13.855102	320	400	2	75	80	0.9375000
NODE_26391_length_589_cov_13.855102	373	453	0	58	80	0.7250000
NODE_26391_length_589_cov_13.855102	373	453	2	22	80	0.2750000
NODE_26395_length_589_cov_6.297959	186	266	0	80	80	1.0000000
NODE_26395_length_589_cov_6.297959	239	319	0	80	80	1.0000000
NODE_26430_length_589_cov_2.320408	431	511	0	9	80	0.1125000
NODE_26430_length_589_cov_2.320408	431	511	2	68	80	0.8500000
NODE_26430_length_589_cov_2.320408	431	511	4	3	80	0.0375000
NODE_26515_length_588_cov_49.936605	264	341	0	77	77	1.0000000
NODE_26515_length_588_cov_49.936605	314	394	0	80	80	1.0000000
NODE_26516_length_588_cov_33.691207	273	353	0	28	80	0.3500000
NODE_26516_length_588_cov_33.691207	273	353	2	32	80	0.4000000
NODE_26516_length_588_cov_33.691207	273	353	4	20	80	0.2500000
NODE_26516_length_588_cov_33.691207	326	406	2	15	80	0.1875000
NODE_26516_length_588_cov_33.691207	326	406	4	65	80	0.8125000
NODE_26517_length_588_cov_16.564417	245	325	0	80	80	1.0000000
NODE_26517_length_588_cov_16.564417	298	378	0	80	80	1.0000000
NODE_26518_length_588_cov_14.595092	266	346	2	65	80	0.8125000
NODE_26518_length_588_cov_14.595092	266	346	4	15	80	0.1875000
NODE_26518_length_588_cov_14.595092	319	399	0	53	80	0.6625000
NODE_26518_length_588_cov_14.595092	319	399	2	27	80	0.3375000
NODE_26522_length_588_cov_7.439673	155	235	2	80	80	1.0000000
NODE_26522_length_588_cov_7.439673	208	288	0	47	80	0.5875000
NODE_26522_length_588_cov_7.439673	208	288	2	33	80	0.4125000
NODE_26523_length_588_cov_7.094070	191	263	2	19	72	0.2638889
NODE_26523_length_588_cov_7.094070	191	263	6	33	72	0.4583333
NODE_26523_length_588_cov_7.094070	191	263	8	7	72	0.0972222
NODE_26523_length_588_cov_7.094070	191	263	10	4	72	0.0555556
NODE_26523_length_588_cov_7.094070	191	263	12	9	72	0.1250000
NODE_26523_length_588_cov_7.094070	244	310	0	44	66	0.6666667
NODE_26523_length_588_cov_7.094070	244	310	2	22	66	0.3333333
NODE_26523_length_588_cov_7.094070	439	519	0	80	80	1.0000000
NODE_26523_length_588_cov_7.094070	492	572	0	80	80	1.0000000
NODE_26534_length_588_cov_4.167689	65	122	0	2	57	0.0350877
NODE_26534_length_588_cov_4.167689	65	122	2	4	57	0.0701754
NODE_26534_length_588_cov_4.167689	65	122	4	51	57	0.8947368
NODE_26634_length_587_cov_39.782787	123	203	0	80	80	1.0000000
NODE_26634_length_587_cov_39.782787	176	256	0	80	80	1.0000000
NODE_26634_length_587_cov_39.782787	252	332	0	66	80	0.8250000
NODE_26634_length_587_cov_39.782787	252	332	2	14	80	0.1750000
NODE_26634_length_587_cov_39.782787	305	385	0	13	80	0.1625000
NODE_26634_length_587_cov_39.782787	305	385	2	67	80	0.8375000
NODE_26635_length_587_cov_31.807377	141	221	0	80	80	1.0000000
NODE_26635_length_587_cov_31.807377	194	274	0	80	80	1.0000000
NODE_26636_length_587_cov_12.629098	219	299	0	25	80	0.3125000
NODE_26636_length_587_cov_12.629098	219	299	4	55	80	0.6875000
NODE_26636_length_587_cov_12.629098	272	352	0	58	80	0.7250000
NODE_26636_length_587_cov_12.629098	272	352	2	20	80	0.2500000
NODE_26636_length_587_cov_12.629098	272	352	4	2	80	0.0250000
NODE_26639_length_587_cov_9.067623	203	283	0	7	80	0.0875000
NODE_26639_length_587_cov_9.067623	203	283	2	73	80	0.9125000
NODE_26639_length_587_cov_9.067623	256	336	0	4	80	0.0500000
NODE_26639_length_587_cov_9.067623	256	336	2	76	80	0.9500000
NODE_26640_length_587_cov_8.411885	253	311	0	58	58	1.0000000
NODE_26656_length_587_cov_3.231557	201	256	4	7	55	0.1272727
NODE_26656_length_587_cov_3.231557	201	256	5	9	55	0.1636364
NODE_26656_length_587_cov_3.231557	201	256	7	10	55	0.1818182
NODE_26656_length_587_cov_3.231557	201	256	9	25	55	0.4545455
NODE_26656_length_587_cov_3.231557	201	256	10	4	55	0.0727273
NODE_26665_length_587_cov_2.850410	255	288	6	33	33	1.0000000
NODE_26749_length_586_cov_37.843943	268	348	0	80	80	1.0000000
NODE_26749_length_586_cov_37.843943	321	401	0	80	80	1.0000000
NODE_26749_length_586_cov_37.843943	397	477	0	80	80	1.0000000
NODE_26749_length_586_cov_37.843943	450	531	0	81	81	1.0000000
NODE_26750_length_586_cov_12.831622	186	266	0	80	80	1.0000000
NODE_26750_length_586_cov_12.831622	239	319	0	80	80	1.0000000
NODE_26752_length_586_cov_11.264887	108	188	0	15	80	0.1875000
NODE_26752_length_586_cov_11.264887	108	188	8	65	80	0.8125000
NODE_26752_length_586_cov_11.264887	161	241	0	33	80	0.4125000
NODE_26752_length_586_cov_11.264887	161	241	8	47	80	0.5875000
NODE_26754_length_586_cov_9.624230	299	360	0	61	61	1.0000000
NODE_26754_length_586_cov_9.624230	299	360	0	61	61	1.0000000
NODE_26754_length_586_cov_9.624230	299	360	0	61	61	1.0000000
NODE_26754_length_586_cov_9.624230	301	360	0	59	59	1.0000000
NODE_26756_length_586_cov_8.591376	273	353	0	80	80	1.0000000
NODE_26756_length_586_cov_8.591376	326	406	0	80	80	1.0000000
NODE_26758_length_586_cov_6.135524	334	375	2	8	41	0.1951219
NODE_26758_length_586_cov_6.135524	334	375	4	33	41	0.8048781
NODE_26758_length_586_cov_6.135524	334	375	2	8	41	0.1951219
NODE_26758_length_586_cov_6.135524	334	375	4	33	41	0.8048781
NODE_26760_length_586_cov_5.634497	150	230	0	80	80	1.0000000
NODE_26760_length_586_cov_5.634497	203	283	0	80	80	1.0000000
NODE_26765_length_586_cov_4.626283	296	362	0	65	66	0.9848485
NODE_26765_length_586_cov_4.626283	296	362	2	1	66	0.0151515
NODE_26765_length_586_cov_4.626283	453	533	0	10	80	0.1250000
NODE_26765_length_586_cov_4.626283	453	533	2	70	80	0.8750000
NODE_26885_length_585_cov_112.094650	456	536	161	4	80	0.0500000
NODE_26885_length_585_cov_112.094650	456	536	163	1	80	0.0125000
NODE_26885_length_585_cov_112.094650	456	536	167	2	80	0.0250000
NODE_26885_length_585_cov_112.094650	456	536	179	2	80	0.0250000
NODE_26885_length_585_cov_112.094650	456	536	180	5	80	0.0625000
NODE_26885_length_585_cov_112.094650	456	536	182	1	80	0.0125000
NODE_26885_length_585_cov_112.094650	456	536	185	6	80	0.0750000
NODE_26885_length_585_cov_112.094650	456	536	186	4	80	0.0500000
NODE_26885_length_585_cov_112.094650	456	536	194	3	80	0.0375000
NODE_26885_length_585_cov_112.094650	456	536	195	1	80	0.0125000
NODE_26885_length_585_cov_112.094650	456	536	196	5	80	0.0625000
NODE_26885_length_585_cov_112.094650	456	536	197	4	80	0.0500000
NODE_26885_length_585_cov_112.094650	456	536	198	2	80	0.0250000
NODE_26885_length_585_cov_112.094650	456	536	199	9	80	0.1125000
NODE_26885_length_585_cov_112.094650	456	536	200	3	80	0.0375000
NODE_26885_length_585_cov_112.094650	456	536	201	11	80	0.1375000
NODE_26885_length_585_cov_112.094650	456	536	202	2	80	0.0250000
NODE_26885_length_585_cov_112.094650	456	536	203	6	80	0.0750000
NODE_26885_length_585_cov_112.094650	456	536	204	1	80	0.0125000
NODE_26885_length_585_cov_112.094650	456	536	205	8	80	0.1000000
NODE_26885_length_585_cov_112.094650	509	585	12	3	76	0.0394737
NODE_26885_length_585_cov_112.094650	509	585	14	3	76	0.0394737
NODE_26885_length_585_cov_112.094650	509	585	17	3	76	0.0394737
NODE_26885_length_585_cov_112.094650	509	585	26	1	76	0.0131579
NODE_26885_length_585_cov_112.094650	509	585	35	1	76	0.0131579
NODE_26885_length_585_cov_112.094650	509	585	45	1	76	0.0131579
NODE_26885_length_585_cov_112.094650	509	585	51	1	76	0.0131579
NODE_26885_length_585_cov_112.094650	509	585	61	1	76	0.0131579
NODE_26885_length_585_cov_112.094650	509	585	63	1	76	0.0131579
NODE_26885_length_585_cov_112.094650	509	585	65	2	76	0.0263158
NODE_26885_length_585_cov_112.094650	509	585	69	1	76	0.0131579
NODE_26885_length_585_cov_112.094650	509	585	75	1	76	0.0131579
NODE_26885_length_585_cov_112.094650	509	585	83	1	76	0.0131579
NODE_26885_length_585_cov_112.094650	509	585	96	2	76	0.0263158
NODE_26885_length_585_cov_112.094650	509	585	98	4	76	0.0526316
NODE_26885_length_585_cov_112.094650	509	585	100	2	76	0.0263158
NODE_26885_length_585_cov_112.094650	509	585	106	1	76	0.0131579
NODE_26885_length_585_cov_112.094650	509	585	114	3	76	0.0394737
NODE_26885_length_585_cov_112.094650	509	585	132	1	76	0.0131579
NODE_26885_length_585_cov_112.094650	509	585	140	2	76	0.0263158
NODE_26885_length_585_cov_112.094650	509	585	150	5	76	0.0657895
NODE_26885_length_585_cov_112.094650	509	585	158	2	76	0.0263158
NODE_26885_length_585_cov_112.094650	509	585	160	2	76	0.0263158
NODE_26885_length_585_cov_112.094650	509	585	168	1	76	0.0131579
NODE_26885_length_585_cov_112.094650	509	585	171	1	76	0.0131579
NODE_26885_length_585_cov_112.094650	509	585	176	3	76	0.0394737
NODE_26885_length_585_cov_112.094650	509	585	180	5	76	0.0657895
NODE_26885_length_585_cov_112.094650	509	585	186	2	76	0.0263158
NODE_26885_length_585_cov_112.094650	509	585	196	3	76	0.0394737
NODE_26885_length_585_cov_112.094650	509	585	197	1	76	0.0131579
NODE_26885_length_585_cov_112.094650	509	585	198	2	76	0.0263158
NODE_26885_length_585_cov_112.094650	509	585	199	5	76	0.0657895
NODE_26885_length_585_cov_112.094650	509	585	201	7	76	0.0921053
NODE_26885_length_585_cov_112.094650	509	585	202	2	76	0.0263158
NODE_26886_length_585_cov_23.872428	168	248	0	39	80	0.4875000
NODE_26886_length_585_cov_23.872428	168	248	6	41	80	0.5125000
NODE_26886_length_585_cov_23.872428	222	301	6	79	79	1.0000000
NODE_26887_length_585_cov_18.981481	360	440	0	80	80	1.0000000
NODE_26887_length_585_cov_18.981481	413	493	0	42	80	0.5250000
NODE_26887_length_585_cov_18.981481	413	493	4	38	80	0.4750000
NODE_26888_length_585_cov_13.967078	323	387	0	64	64	1.0000000
NODE_26889_length_585_cov_10.555556	229	309	0	59	80	0.7375000
NODE_26889_length_585_cov_10.555556	229	309	2	8	80	0.1000000
NODE_26889_length_585_cov_10.555556	229	309	4	13	80	0.1625000
NODE_26889_length_585_cov_10.555556	282	362	0	12	80	0.1500000
NODE_26889_length_585_cov_10.555556	282	362	2	17	80	0.2125000
NODE_26889_length_585_cov_10.555556	282	362	4	51	80	0.6375000
NODE_26891_length_585_cov_9.216049	233	313	0	80	80	1.0000000
NODE_26891_length_585_cov_9.216049	286	366	0	80	80	1.0000000
NODE_26894_length_585_cov_8.090535	292	372	0	80	80	1.0000000
NODE_26894_length_585_cov_8.090535	345	425	0	80	80	1.0000000
NODE_26895_length_585_cov_8.018519	339	381	0	42	42	1.0000000
NODE_26895_length_585_cov_8.018519	354	419	0	65	65	1.0000000
NODE_26900_length_585_cov_4.954733	147	227	0	80	80	1.0000000
NODE_26912_length_585_cov_3.751029	288	368	0	80	80	1.0000000
NODE_26912_length_585_cov_3.751029	341	421	0	80	80	1.0000000
NODE_27019_length_584_cov_21.657732	57	137	0	29	80	0.3625000
NODE_27019_length_584_cov_21.657732	57	137	4	51	80	0.6375000
NODE_27019_length_584_cov_21.657732	110	190	0	9	80	0.1125000
NODE_27019_length_584_cov_21.657732	110	190	4	71	80	0.8875000
NODE_27020_length_584_cov_11.915464	280	360	0	80	80	1.0000000
NODE_27020_length_584_cov_11.915464	333	413	0	70	80	0.8750000
NODE_27020_length_584_cov_11.915464	333	413	2	10	80	0.1250000
NODE_27021_length_584_cov_11.197938	217	297	12	1	80	0.0125000
NODE_27021_length_584_cov_11.197938	217	297	13	37	80	0.4625000
NODE_27021_length_584_cov_11.197938	217	297	15	30	80	0.3750000
NODE_27021_length_584_cov_11.197938	217	297	16	12	80	0.1500000
NODE_27021_length_584_cov_11.197938	270	350	4	14	80	0.1750000
NODE_27021_length_584_cov_11.197938	270	350	5	1	80	0.0125000
NODE_27021_length_584_cov_11.197938	270	350	6	13	80	0.1625000
NODE_27021_length_584_cov_11.197938	270	350	10	14	80	0.1750000
NODE_27021_length_584_cov_11.197938	270	350	12	1	80	0.0125000
NODE_27021_length_584_cov_11.197938	270	350	13	18	80	0.2250000
NODE_27021_length_584_cov_11.197938	270	350	15	7	80	0.0875000
NODE_27021_length_584_cov_11.197938	270	350	16	12	80	0.1500000
NODE_27022_length_584_cov_9.824742	375	441	0	66	66	1.0000000
NODE_27022_length_584_cov_9.824742	375	441	0	66	66	1.0000000
NODE_27023_length_584_cov_9.160825	369	449	0	80	80	1.0000000
NODE_27023_length_584_cov_9.160825	422	502	0	80	80	1.0000000
NODE_27023_length_584_cov_9.160825	422	502	0	80	80	1.0000000
NODE_27026_length_584_cov_7.736082	51	131	2	80	80	1.0000000
NODE_27026_length_584_cov_7.736082	104	184	0	46	80	0.5750000
NODE_27026_length_584_cov_7.736082	104	184	2	34	80	0.4250000
NODE_27031_length_584_cov_7.113402	213	293	0	80	80	1.0000000
NODE_27031_length_584_cov_7.113402	266	346	0	80	80	1.0000000
NODE_27035_length_584_cov_5.843299	281	341	0	2	60	0.0333333
NODE_27035_length_584_cov_5.843299	281	341	4	3	60	0.0500000
NODE_27035_length_584_cov_5.843299	281	341	8	16	60	0.2666667
NODE_27035_length_584_cov_5.843299	281	341	10	39	60	0.6500000
NODE_27039_length_584_cov_5.032990	240	320	3	57	80	0.7125000
NODE_27039_length_584_cov_5.032990	240	320	5	23	80	0.2875000
NODE_27039_length_584_cov_5.032990	293	373	3	4	80	0.0500000
NODE_27039_length_584_cov_5.032990	293	373	4	11	80	0.1375000
NODE_27039_length_584_cov_5.032990	293	373	5	34	80	0.4250000
NODE_27039_length_584_cov_5.032990	293	373	6	31	80	0.3875000
NODE_27061_length_584_cov_2.707216	186	257	0	71	71	1.0000000
NODE_27147_length_583_cov_7.973140	232	312	0	80	80	1.0000000
NODE_27147_length_583_cov_7.973140	285	365	0	80	80	1.0000000
NODE_27148_length_583_cov_6.731405	328	408	0	6	80	0.0750000
NODE_27148_length_583_cov_6.731405	328	408	2	74	80	0.9250000
NODE_27148_length_583_cov_6.731405	381	461	0	50	80	0.6250000
NODE_27148_length_583_cov_6.731405	381	461	2	30	80	0.3750000
NODE_27149_length_583_cov_6.363636	161	231	0	70	70	1.0000000
NODE_27152_length_583_cov_5.766529	132	186	0	54	54	1.0000000
NODE_27263_length_583_cov_0.762397	9	50	0	40	41	0.9756098
NODE_27263_length_583_cov_0.762397	9	50	4	1	41	0.0243902
NODE_27278_length_582_cov_74.269151	295	375	0	37	80	0.4625000
NODE_27278_length_582_cov_74.269151	295	375	4	43	80	0.5375000
NODE_27278_length_582_cov_74.269151	348	428	4	80	80	1.0000000
NODE_27279_length_582_cov_53.093168	11	91	0	3	80	0.0375000
NODE_27279_length_582_cov_53.093168	11	91	2	77	80	0.9625000
NODE_27279_length_582_cov_53.093168	64	144	0	4	80	0.0500000
NODE_27279_length_582_cov_53.093168	64	144	2	76	80	0.9500000
NODE_27279_length_582_cov_53.093168	140	220	0	80	80	1.0000000
NODE_27279_length_582_cov_53.093168	193	273	0	80	80	1.0000000
NODE_27280_length_582_cov_47.393375	345	425	2	61	80	0.7625000
NODE_27280_length_582_cov_47.393375	345	425	4	19	80	0.2375000
NODE_27280_length_582_cov_47.393375	398	478	0	13	80	0.1625000
NODE_27280_length_582_cov_47.393375	398	478	2	54	80	0.6750000
NODE_27280_length_582_cov_47.393375	398	478	4	13	80	0.1625000
NODE_27281_length_582_cov_16.358178	297	377	0	80	80	1.0000000
NODE_27281_length_582_cov_16.358178	350	431	0	81	81	1.0000000
NODE_27282_length_582_cov_14.107660	128	208	0	80	80	1.0000000
NODE_27282_length_582_cov_14.107660	181	261	0	80	80	1.0000000
NODE_27283_length_582_cov_7.923395	208	287	10	79	79	1.0000000
NODE_27283_length_582_cov_7.923395	262	340	0	16	78	0.2051282
NODE_27283_length_582_cov_7.923395	262	340	5	21	78	0.2692308
NODE_27283_length_582_cov_7.923395	262	340	9	2	78	0.0256410
NODE_27283_length_582_cov_7.923395	262	340	10	39	78	0.5000000
NODE_27284_length_582_cov_7.722567	216	296	0	1	80	0.0125000
NODE_27284_length_582_cov_7.722567	216	296	4	79	80	0.9875000
NODE_27284_length_582_cov_7.722567	269	349	0	54	80	0.6750000
NODE_27284_length_582_cov_7.722567	269	349	4	26	80	0.3250000
NODE_27289_length_582_cov_4.956522	294	325	0	31	31	1.0000000
NODE_27295_length_582_cov_4.308489	151	192	9	28	41	0.6829268
NODE_27295_length_582_cov_4.308489	151	192	11	13	41	0.3170732
NODE_27297_length_582_cov_3.838509	223	299	4	7	76	0.0921053
NODE_27297_length_582_cov_3.838509	223	299	6	31	76	0.4078947
NODE_27297_length_582_cov_3.838509	223	299	8	38	76	0.5000000
NODE_27297_length_582_cov_3.838509	272	354	0	3	82	0.0365854
NODE_27297_length_582_cov_3.838509	272	354	2	8	82	0.0975610
NODE_27297_length_582_cov_3.838509	272	354	4	10	82	0.1219512
NODE_27297_length_582_cov_3.838509	272	354	8	61	82	0.7439024
NODE_27350_length_582_cov_1.650104	375	450	0	75	75	1.0000000
NODE_27405_length_581_cov_16.890041	244	316	0	72	72	1.0000000
NODE_27413_length_581_cov_6.340249	262	342	0	80	80	1.0000000
NODE_27413_length_581_cov_6.340249	315	395	0	80	80	1.0000000
NODE_27416_length_581_cov_5.827801	122	192	0	36	70	0.5142857
NODE_27416_length_581_cov_5.827801	122	192	4	14	70	0.2000000
NODE_27416_length_581_cov_5.827801	122	192	6	7	70	0.1000000
NODE_27416_length_581_cov_5.827801	122	192	8	13	70	0.1857143
NODE_27420_length_581_cov_5.072614	392	466	0	74	74	1.0000000
NODE_27420_length_581_cov_5.072614	424	444	0	20	20	1.0000000
NODE_27464_length_581_cov_1.881743	474	538	0	64	64	1.0000000
NODE_27541_length_580_cov_39.353430	358	438	0	80	80	1.0000000
NODE_27541_length_580_cov_39.353430	411	491	0	80	80	1.0000000
NODE_27541_length_580_cov_39.353430	487	567	0	80	80	1.0000000
NODE_27541_length_580_cov_39.353430	487	567	0	80	80	1.0000000
NODE_27541_length_580_cov_39.353430	487	567	0	80	80	1.0000000
NODE_27541_length_580_cov_39.353430	487	567	0	80	80	1.0000000
NODE_27541_length_580_cov_39.353430	487	567	0	80	80	1.0000000
NODE_27541_length_580_cov_39.353430	487	567	0	80	80	1.0000000
NODE_27544_length_580_cov_8.925156	198	238	0	40	40	1.0000000
NODE_27544_length_580_cov_8.925156	258	338	0	11	80	0.1375000
NODE_27544_length_580_cov_8.925156	258	338	10	69	80	0.8625000
NODE_27545_length_580_cov_8.634096	197	277	0	80	80	1.0000000
NODE_27545_length_580_cov_8.634096	250	330	0	80	80	1.0000000
NODE_27551_length_580_cov_6.291060	356	398	0	42	42	1.0000000
NODE_27554_length_580_cov_5.494802	110	190	0	80	80	1.0000000
NODE_27554_length_580_cov_5.494802	163	243	0	80	80	1.0000000
NODE_27559_length_580_cov_4.563410	231	292	4	52	61	0.8524590
NODE_27559_length_580_cov_4.563410	231	292	6	9	61	0.1475410
NODE_27559_length_580_cov_4.563410	322	357	4	6	35	0.1714286
NODE_27559_length_580_cov_4.563410	322	357	5	26	35	0.7428572
NODE_27559_length_580_cov_4.563410	322	357	6	3	35	0.0857143
NODE_27590_length_580_cov_2.264033	215	277	0	62	62	1.0000000
NODE_27597_length_580_cov_2.116424	265	345	0	80	80	1.0000000
NODE_27659_length_579_cov_24.231250	159	239	0	49	80	0.6125000
NODE_27659_length_579_cov_24.231250	159	239	2	31	80	0.3875000
NODE_27659_length_579_cov_24.231250	212	287	0	75	75	1.0000000
NODE_27660_length_579_cov_12.602083	246	326	0	24	80	0.3000000
NODE_27660_length_579_cov_12.602083	246	326	1	21	80	0.2625000
NODE_27660_length_579_cov_12.602083	246	326	2	35	80	0.4375000
NODE_27660_length_579_cov_12.602083	299	377	2	78	78	1.0000000
NODE_27663_length_579_cov_9.195833	254	334	0	30	80	0.3750000
NODE_27663_length_579_cov_9.195833	254	334	6	13	80	0.1625000
NODE_27663_length_579_cov_9.195833	254	334	8	37	80	0.4625000
NODE_27663_length_579_cov_9.195833	307	387	8	80	80	1.0000000
NODE_27663_length_579_cov_9.195833	383	463	0	41	80	0.5125000
NODE_27663_length_579_cov_9.195833	383	463	6	27	80	0.3375000
NODE_27663_length_579_cov_9.195833	383	463	8	12	80	0.1500000
NODE_27664_length_579_cov_6.600000	169	249	0	80	80	1.0000000
NODE_27664_length_579_cov_6.600000	222	302	0	80	80	1.0000000
NODE_27667_length_579_cov_5.956250	225	295	18	1	70	0.0142857
NODE_27667_length_579_cov_5.956250	225	295	24	4	70	0.0571429
NODE_27667_length_579_cov_5.956250	225	295	26	23	70	0.3285714
NODE_27667_length_579_cov_5.956250	225	295	28	42	70	0.6000000
NODE_27667_length_579_cov_5.956250	279	316	18	22	37	0.5945946
NODE_27667_length_579_cov_5.956250	279	316	24	4	37	0.1081081
NODE_27667_length_579_cov_5.956250	279	316	26	6	37	0.1621622
NODE_27667_length_579_cov_5.956250	279	316	28	5	37	0.1351351
NODE_27674_length_579_cov_4.850000	105	185	0	17	80	0.2125000
NODE_27674_length_579_cov_4.850000	105	185	2	63	80	0.7875000
NODE_27674_length_579_cov_4.850000	158	238	0	28	80	0.3500000
NODE_27674_length_579_cov_4.850000	158	238	2	52	80	0.6500000
NODE_27688_length_579_cov_3.291667	290	343	0	53	53	1.0000000
NODE_27695_length_579_cov_2.420833	251	331	0	80	80	1.0000000
NODE_27695_length_579_cov_2.420833	304	384	0	70	80	0.8750000
NODE_27695_length_579_cov_2.420833	304	384	2	10	80	0.1250000
NODE_27724_length_579_cov_1.435417	463	497	0	34	34	1.0000000
NODE_27781_length_578_cov_70.192067	100	180	2	63	80	0.7875000
NODE_27781_length_578_cov_70.192067	100	180	4	17	80	0.2125000
NODE_27781_length_578_cov_70.192067	153	233	2	67	80	0.8375000
NODE_27781_length_578_cov_70.192067	153	233	4	13	80	0.1625000
NODE_27782_length_578_cov_51.676409	129	209	0	80	80	1.0000000
NODE_27782_length_578_cov_51.676409	182	262	0	80	80	1.0000000
NODE_27783_length_578_cov_32.152401	310	390	0	80	80	1.0000000
NODE_27783_length_578_cov_32.152401	363	443	0	80	80	1.0000000
NODE_27784_length_578_cov_30.484342	215	295	0	80	80	1.0000000
NODE_27784_length_578_cov_30.484342	268	348	0	80	80	1.0000000
NODE_27785_length_578_cov_15.983299	213	265	0	52	52	1.0000000
NODE_27786_length_578_cov_14.968685	147	227	0	80	80	1.0000000
NODE_27786_length_578_cov_14.968685	200	280	0	80	80	1.0000000
NODE_27787_length_578_cov_9.567850	273	328	0	1	55	0.0181818
NODE_27787_length_578_cov_9.567850	273	328	2	54	55	0.9818182
NODE_27792_length_578_cov_6.670146	273	353	0	49	80	0.6125000
NODE_27792_length_578_cov_6.670146	273	353	1	9	80	0.1125000
NODE_27792_length_578_cov_6.670146	273	353	2	22	80	0.2750000
NODE_27792_length_578_cov_6.670146	326	406	0	15	80	0.1875000
NODE_27792_length_578_cov_6.670146	326	406	1	5	80	0.0625000
NODE_27792_length_578_cov_6.670146	326	406	2	60	80	0.7500000
NODE_27793_length_578_cov_6.465553	320	400	0	80	80	1.0000000
NODE_27793_length_578_cov_6.465553	373	453	0	80	80	1.0000000
NODE_27863_length_578_cov_1.480167	185	265	0	80	80	1.0000000
NODE_27863_length_578_cov_1.480167	238	318	0	80	80	1.0000000
NODE_27935_length_577_cov_11.638075	312	392	0	80	80	1.0000000
NODE_27942_length_577_cov_4.912134	218	249	4	31	31	1.0000000
NODE_27942_length_577_cov_4.912134	301	330	0	29	29	1.0000000
NODE_27961_length_577_cov_2.970711	78	126	10	48	48	1.0000000
NODE_27968_length_577_cov_2.631799	169	253	11	9	84	0.1071429
NODE_27968_length_577_cov_2.631799	169	253	12	3	84	0.0357143
NODE_27968_length_577_cov_2.631799	169	253	13	15	84	0.1785714
NODE_27968_length_577_cov_2.631799	169	253	14	5	84	0.0595238
NODE_27968_length_577_cov_2.631799	169	253	15	14	84	0.1666667
NODE_27968_length_577_cov_2.631799	169	253	16	1	84	0.0119048
NODE_27968_length_577_cov_2.631799	169	253	17	15	84	0.1785714
NODE_27968_length_577_cov_2.631799	169	253	18	16	84	0.1904762
NODE_27968_length_577_cov_2.631799	169	253	19	6	84	0.0714286
NODE_27968_length_577_cov_2.631799	226	269	13	10	43	0.2325581
NODE_27968_length_577_cov_2.631799	226	269	14	17	43	0.3953488
NODE_27968_length_577_cov_2.631799	226	269	15	7	43	0.1627907
NODE_27968_length_577_cov_2.631799	226	269	17	9	43	0.2093023
NODE_28003_length_577_cov_1.468619	71	146	0	75	75	1.0000000
NODE_28003_length_577_cov_1.468619	119	199	0	80	80	1.0000000
NODE_28058_length_576_cov_10.903564	194	274	0	80	80	1.0000000
NODE_28059_length_576_cov_9.039832	271	351	0	80	80	1.0000000
NODE_28059_length_576_cov_9.039832	324	404	0	80	80	1.0000000
NODE_28060_length_576_cov_8.490566	338	418	0	80	80	1.0000000
NODE_28060_length_576_cov_8.490566	391	471	0	80	80	1.0000000
NODE_28061_length_576_cov_7.002096	157	237	0	80	80	1.0000000
NODE_28061_length_576_cov_7.002096	210	290	0	80	80	1.0000000
NODE_28076_length_576_cov_3.322851	118	183	12	46	65	0.7076923
NODE_28076_length_576_cov_3.322851	118	183	14	19	65	0.2923077
NODE_28102_length_576_cov_1.964361	148	228	0	80	80	1.0000000
NODE_28102_length_576_cov_1.964361	201	281	0	80	80	1.0000000
NODE_28104_length_576_cov_1.951782	159	239	0	25	80	0.3125000
NODE_28104_length_576_cov_1.951782	159	239	2	55	80	0.6875000
NODE_28104_length_576_cov_1.951782	212	292	2	80	80	1.0000000
NODE_28116_length_576_cov_1.584906	381	455	0	13	74	0.1756757
NODE_28116_length_576_cov_1.584906	381	455	1	3	74	0.0405405
NODE_28116_length_576_cov_1.584906	381	455	2	52	74	0.7027027
NODE_28116_length_576_cov_1.584906	381	455	3	6	74	0.0810811
NODE_28179_length_575_cov_15.319328	319	399	0	4	80	0.0500000
NODE_28179_length_575_cov_15.319328	319	399	1	76	80	0.9500000
NODE_28179_length_575_cov_15.319328	372	452	1	80	80	1.0000000
NODE_28181_length_575_cov_8.254202	286	366	0	68	80	0.8500000
NODE_28181_length_575_cov_8.254202	286	366	1	11	80	0.1375000
NODE_28181_length_575_cov_8.254202	286	366	2	1	80	0.0125000
NODE_28181_length_575_cov_8.254202	339	419	0	15	80	0.1875000
NODE_28181_length_575_cov_8.254202	339	419	1	11	80	0.1375000
NODE_28181_length_575_cov_8.254202	339	419	2	54	80	0.6750000
NODE_28182_length_575_cov_7.558824	300	380	0	49	80	0.6125000
NODE_28182_length_575_cov_7.558824	300	380	2	31	80	0.3875000
NODE_28313_length_574_cov_6.282105	185	265	4	9	80	0.1125000
NODE_28313_length_574_cov_6.282105	185	265	6	1	80	0.0125000
NODE_28313_length_574_cov_6.282105	185	265	7	5	80	0.0625000
NODE_28313_length_574_cov_6.282105	185	265	8	29	80	0.3625000
NODE_28313_length_574_cov_6.282105	185	265	10	36	80	0.4500000
NODE_28313_length_574_cov_6.282105	238	318	2	38	80	0.4750000
NODE_28313_length_574_cov_6.282105	238	318	4	24	80	0.3000000
NODE_28313_length_574_cov_6.282105	238	318	6	1	80	0.0125000
NODE_28313_length_574_cov_6.282105	238	318	7	5	80	0.0625000
NODE_28313_length_574_cov_6.282105	238	318	10	12	80	0.1500000
NODE_28330_length_574_cov_2.993684	215	234	0	19	19	1.0000000
NODE_28438_length_573_cov_53.668776	393	473	0	80	80	1.0000000
NODE_28438_length_573_cov_53.668776	446	526	0	80	80	1.0000000
NODE_28439_length_573_cov_30.658228	451	531	0	52	80	0.6500000
NODE_28439_length_573_cov_30.658228	451	531	2	28	80	0.3500000
NODE_28440_length_573_cov_30.116034	435	515	42	5	80	0.0625000
NODE_28440_length_573_cov_30.116034	435	515	43	1	80	0.0125000
NODE_28440_length_573_cov_30.116034	435	515	44	21	80	0.2625000
NODE_28440_length_573_cov_30.116034	435	515	45	1	80	0.0125000
NODE_28440_length_573_cov_30.116034	435	515	46	1	80	0.0125000
NODE_28440_length_573_cov_30.116034	435	515	47	3	80	0.0375000
NODE_28440_length_573_cov_30.116034	435	515	48	19	80	0.2375000
NODE_28440_length_573_cov_30.116034	435	515	49	3	80	0.0375000
NODE_28440_length_573_cov_30.116034	435	515	50	5	80	0.0625000
NODE_28440_length_573_cov_30.116034	435	515	51	6	80	0.0750000
NODE_28440_length_573_cov_30.116034	435	515	52	6	80	0.0750000
NODE_28440_length_573_cov_30.116034	435	515	53	9	80	0.1125000
NODE_28440_length_573_cov_30.116034	488	568	4	2	80	0.0250000
NODE_28440_length_573_cov_30.116034	488	568	6	2	80	0.0250000
NODE_28440_length_573_cov_30.116034	488	568	8	1	80	0.0125000
NODE_28440_length_573_cov_30.116034	488	568	10	1	80	0.0125000
NODE_28440_length_573_cov_30.116034	488	568	16	7	80	0.0875000
NODE_28440_length_573_cov_30.116034	488	568	17	3	80	0.0375000
NODE_28440_length_573_cov_30.116034	488	568	19	1	80	0.0125000
NODE_28440_length_573_cov_30.116034	488	568	21	4	80	0.0500000
NODE_28440_length_573_cov_30.116034	488	568	23	3	80	0.0375000
NODE_28440_length_573_cov_30.116034	488	568	24	1	80	0.0125000
NODE_28440_length_573_cov_30.116034	488	568	26	1	80	0.0125000
NODE_28440_length_573_cov_30.116034	488	568	30	1	80	0.0125000
NODE_28440_length_573_cov_30.116034	488	568	32	1	80	0.0125000
NODE_28440_length_573_cov_30.116034	488	568	34	10	80	0.1250000
NODE_28440_length_573_cov_30.116034	488	568	38	4	80	0.0500000
NODE_28440_length_573_cov_30.116034	488	568	42	5	80	0.0625000
NODE_28440_length_573_cov_30.116034	488	568	44	25	80	0.3125000
NODE_28440_length_573_cov_30.116034	488	568	48	8	80	0.1000000
NODE_28441_length_573_cov_24.234177	210	290	0	27	80	0.3375000
NODE_28441_length_573_cov_24.234177	210	290	2	53	80	0.6625000
NODE_28441_length_573_cov_24.234177	263	343	2	80	80	1.0000000
NODE_28442_length_573_cov_13.464135	278	358	2	4	80	0.0500000
NODE_28442_length_573_cov_13.464135	278	358	10	76	80	0.9500000
NODE_28442_length_573_cov_13.464135	331	411	0	5	80	0.0625000
NODE_28442_length_573_cov_13.464135	331	411	2	52	80	0.6500000
NODE_28442_length_573_cov_13.464135	331	411	10	23	80	0.2875000
NODE_28443_length_573_cov_8.761603	124	204	0	80	80	1.0000000
NODE_28443_length_573_cov_8.761603	177	257	0	80	80	1.0000000
NODE_28456_length_573_cov_3.364979	365	398	18	22	33	0.6666667
NODE_28456_length_573_cov_3.364979	365	398	20	10	33	0.3030303
NODE_28456_length_573_cov_3.364979	365	398	22	1	33	0.0303030
NODE_28565_length_572_cov_17.530655	312	392	0	59	80	0.7375000
NODE_28565_length_572_cov_17.530655	312	392	2	21	80	0.2625000
NODE_28565_length_572_cov_17.530655	365	445	0	80	80	1.0000000
NODE_28567_length_572_cov_8.059197	250	321	2	48	71	0.6760563
NODE_28567_length_572_cov_8.059197	250	321	4	23	71	0.3239437
NODE_28568_length_572_cov_7.873150	134	214	0	80	80	1.0000000
NODE_28568_length_572_cov_7.873150	187	267	0	80	80	1.0000000
NODE_28570_length_572_cov_6.706131	365	445	0	80	80	1.0000000
NODE_28570_length_572_cov_6.706131	418	498	0	80	80	1.0000000
NODE_28573_length_572_cov_5.625793	137	217	0	56	80	0.7000000
NODE_28573_length_572_cov_5.625793	137	217	2	16	80	0.2000000
NODE_28573_length_572_cov_5.625793	137	217	3	8	80	0.1000000
NODE_28573_length_572_cov_5.625793	190	270	0	3	80	0.0375000
NODE_28573_length_572_cov_5.625793	190	270	2	16	80	0.2000000
NODE_28573_length_572_cov_5.625793	190	270	3	61	80	0.7625000
NODE_28574_length_572_cov_5.617336	331	401	0	9	70	0.1285714
NODE_28574_length_572_cov_5.617336	331	401	2	56	70	0.8000000
NODE_28574_length_572_cov_5.617336	331	401	4	5	70	0.0714286
NODE_28578_length_572_cov_4.596195	212	288	0	76	76	1.0000000
NODE_28578_length_572_cov_4.596195	261	341	0	80	80	1.0000000
NODE_28585_length_572_cov_3.843552	210	290	3	11	80	0.1375000
NODE_28585_length_572_cov_3.843552	210	290	4	20	80	0.2500000
NODE_28585_length_572_cov_3.843552	210	290	5	25	80	0.3125000
NODE_28585_length_572_cov_3.843552	210	290	7	2	80	0.0250000
NODE_28585_length_572_cov_3.843552	210	290	8	22	80	0.2750000
NODE_28585_length_572_cov_3.843552	263	343	3	3	80	0.0375000
NODE_28585_length_572_cov_3.843552	263	343	7	2	80	0.0250000
NODE_28585_length_572_cov_3.843552	263	343	8	50	80	0.6250000
NODE_28585_length_572_cov_3.843552	263	343	9	1	80	0.0125000
NODE_28585_length_572_cov_3.843552	263	343	10	2	80	0.0250000
NODE_28585_length_572_cov_3.843552	263	343	11	7	80	0.0875000
NODE_28585_length_572_cov_3.843552	263	343	12	10	80	0.1250000
NODE_28585_length_572_cov_3.843552	263	343	14	5	80	0.0625000
NODE_28621_length_572_cov_2.319239	357	431	0	20	74	0.2702703
NODE_28621_length_572_cov_2.319239	357	431	2	13	74	0.1756757
NODE_28621_length_572_cov_2.319239	357	431	4	7	74	0.0945946
NODE_28621_length_572_cov_2.319239	357	431	6	34	74	0.4594595
NODE_28621_length_572_cov_2.319239	410	478	2	4	68	0.0588235
NODE_28621_length_572_cov_2.319239	410	478	4	15	68	0.2205882
NODE_28621_length_572_cov_2.319239	410	478	6	49	68	0.7205882
NODE_28625_length_572_cov_2.107822	184	254	1	5	70	0.0714286
NODE_28625_length_572_cov_2.107822	184	254	2	11	70	0.1571429
NODE_28625_length_572_cov_2.107822	184	254	3	54	70	0.7714286
NODE_28625_length_572_cov_2.107822	415	493	0	78	78	1.0000000
NODE_28631_length_572_cov_1.947146	327	363	0	36	36	1.0000000
NODE_28631_length_572_cov_1.947146	328	354	0	26	26	1.0000000
NODE_28700_length_571_cov_14.262712	237	317	0	80	80	1.0000000
NODE_28700_length_571_cov_14.262712	290	370	0	80	80	1.0000000
NODE_28717_length_571_cov_4.033898	154	234	2	6	80	0.0750000
NODE_28717_length_571_cov_4.033898	154	234	10	1	80	0.0125000
NODE_28717_length_571_cov_4.033898	154	234	12	44	80	0.5500000
NODE_28717_length_571_cov_4.033898	154	234	14	29	80	0.3625000
NODE_28717_length_571_cov_4.033898	207	273	2	45	66	0.6818182
NODE_28717_length_571_cov_4.033898	207	273	10	1	66	0.0151515
NODE_28717_length_571_cov_4.033898	207	273	12	2	66	0.0303030
NODE_28717_length_571_cov_4.033898	207	273	14	18	66	0.2727273
NODE_28809_length_570_cov_28.269639	487	559	14	4	72	0.0555556
NODE_28809_length_570_cov_28.269639	487	559	16	1	72	0.0138889
NODE_28809_length_570_cov_28.269639	487	559	18	3	72	0.0416667
NODE_28809_length_570_cov_28.269639	487	559	24	6	72	0.0833333
NODE_28809_length_570_cov_28.269639	487	559	26	4	72	0.0555556
NODE_28809_length_570_cov_28.269639	487	559	28	3	72	0.0416667
NODE_28809_length_570_cov_28.269639	487	559	32	4	72	0.0555556
NODE_28809_length_570_cov_28.269639	487	559	36	1	72	0.0138889
NODE_28809_length_570_cov_28.269639	487	559	38	3	72	0.0416667
NODE_28809_length_570_cov_28.269639	487	559	40	1	72	0.0138889
NODE_28809_length_570_cov_28.269639	487	559	46	42	72	0.5833333
NODE_28812_length_570_cov_10.161359	167	247	0	21	80	0.2625000
NODE_28812_length_570_cov_10.161359	167	247	2	8	80	0.1000000
NODE_28812_length_570_cov_10.161359	167	247	4	51	80	0.6375000
NODE_28812_length_570_cov_10.161359	220	256	0	19	36	0.5277778
NODE_28812_length_570_cov_10.161359	220	256	2	17	36	0.4722222
NODE_28819_length_570_cov_5.010616	179	216	0	4	37	0.1081081
NODE_28819_length_570_cov_5.010616	179	216	2	5	37	0.1351351
NODE_28819_length_570_cov_5.010616	179	216	4	28	37	0.7567568
NODE_28819_length_570_cov_5.010616	189	269	4	80	80	1.0000000
NODE_28828_length_570_cov_3.898089	236	316	0	59	80	0.7375000
NODE_28828_length_570_cov_3.898089	236	316	4	21	80	0.2625000
NODE_28828_length_570_cov_3.898089	289	369	0	80	80	1.0000000
NODE_28840_length_570_cov_2.938429	202	280	0	43	78	0.5512820
NODE_28840_length_570_cov_2.938429	202	280	2	5	78	0.0641026
NODE_28840_length_570_cov_2.938429	202	280	6	25	78	0.3205128
NODE_28840_length_570_cov_2.938429	202	280	7	1	78	0.0128205
NODE_28840_length_570_cov_2.938429	202	280	8	4	78	0.0512821
NODE_28840_length_570_cov_2.938429	262	333	0	71	71	1.0000000
NODE_28842_length_570_cov_2.891720	204	260	0	56	56	1.0000000
NODE_28950_length_569_cov_20.559574	275	355	0	66	80	0.8250000
NODE_28950_length_569_cov_20.559574	275	355	2	14	80	0.1750000
NODE_28950_length_569_cov_20.559574	328	408	0	80	80	1.0000000
NODE_28951_length_569_cov_15.282979	272	352	0	80	80	1.0000000
NODE_28951_length_569_cov_15.282979	325	405	0	80	80	1.0000000
NODE_28952_length_569_cov_11.023404	280	360	0	80	80	1.0000000
NODE_28952_length_569_cov_11.023404	333	413	0	80	80	1.0000000
NODE_28953_length_569_cov_9.310638	231	277	10	46	46	1.0000000
NODE_28956_length_569_cov_6.989362	258	338	11	1	80	0.0125000
NODE_28956_length_569_cov_6.989362	258	338	13	14	80	0.1750000
NODE_28956_length_569_cov_6.989362	258	338	15	53	80	0.6625000
NODE_28956_length_569_cov_6.989362	258	338	17	12	80	0.1500000
NODE_28956_length_569_cov_6.989362	294	329	15	23	35	0.6571429
NODE_28956_length_569_cov_6.989362	294	329	17	12	35	0.3428572
NODE_28956_length_569_cov_6.989362	296	338	15	30	42	0.7142857
NODE_28956_length_569_cov_6.989362	296	338	17	12	42	0.2857143
NODE_28957_length_569_cov_6.978723	264	344	0	70	80	0.8750000
NODE_28957_length_569_cov_6.978723	264	344	2	10	80	0.1250000
NODE_28957_length_569_cov_6.978723	317	397	0	17	80	0.2125000
NODE_28957_length_569_cov_6.978723	317	397	2	63	80	0.7875000
NODE_28960_length_569_cov_6.434043	228	308	0	80	80	1.0000000
NODE_28973_length_569_cov_3.353191	340	419	0	79	79	1.0000000
NODE_28981_length_569_cov_3.027660	277	348	0	71	71	1.0000000
NODE_29072_length_568_cov_59.729211	124	204	0	80	80	1.0000000
NODE_29072_length_568_cov_59.729211	177	257	0	80	80	1.0000000
NODE_29075_length_568_cov_7.763326	215	294	0	79	79	1.0000000
NODE_29075_length_568_cov_7.763326	267	347	0	80	80	1.0000000
NODE_29078_length_568_cov_6.257996	397	471	0	74	74	1.0000000
NODE_29091_length_568_cov_3.748401	170	236	0	66	66	1.0000000
NODE_29091_length_568_cov_3.748401	262	311	0	49	49	1.0000000
NODE_29133_length_568_cov_1.769723	192	233	0	41	41	1.0000000
NODE_29160_length_568_cov_1.358209	355	432	4	4	77	0.0519481
NODE_29160_length_568_cov_1.358209	355	432	6	8	77	0.1038961
NODE_29160_length_568_cov_1.358209	355	432	8	11	77	0.1428571
NODE_29160_length_568_cov_1.358209	355	432	9	21	77	0.2727273
NODE_29160_length_568_cov_1.358209	355	432	11	24	77	0.3116883
NODE_29160_length_568_cov_1.358209	355	432	13	9	77	0.1168831
NODE_29182_length_568_cov_1.038380	195	275	0	80	80	1.0000000
NODE_29216_length_567_cov_21.155983	347	427	0	80	80	1.0000000
NODE_29216_length_567_cov_21.155983	400	480	0	80	80	1.0000000
NODE_29217_length_567_cov_18.292735	367	447	0	80	80	1.0000000
NODE_29217_length_567_cov_18.292735	420	500	0	80	80	1.0000000
NODE_29218_length_567_cov_17.579060	259	339	4	80	80	1.0000000
NODE_29218_length_567_cov_17.579060	312	392	0	35	80	0.4375000
NODE_29218_length_567_cov_17.579060	312	392	4	45	80	0.5625000
NODE_29220_length_567_cov_15.457265	276	356	0	80	80	1.0000000
NODE_29220_length_567_cov_15.457265	329	409	0	80	80	1.0000000
NODE_29221_length_567_cov_14.393162	270	350	0	80	80	1.0000000
NODE_29221_length_567_cov_14.393162	323	403	0	80	80	1.0000000
NODE_29225_length_567_cov_6.611111	356	436	0	80	80	1.0000000
NODE_29225_length_567_cov_6.611111	409	489	0	80	80	1.0000000
NODE_29245_length_567_cov_2.884615	204	284	0	80	80	1.0000000
NODE_29245_length_567_cov_2.884615	204	254	0	50	50	1.0000000
NODE_29245_length_567_cov_2.884615	266	297	0	31	31	1.0000000
NODE_29363_length_566_cov_47.747323	157	237	1	80	80	1.0000000
NODE_29363_length_566_cov_47.747323	210	290	1	39	80	0.4875000
NODE_29363_length_566_cov_47.747323	210	290	2	15	80	0.1875000
NODE_29363_length_566_cov_47.747323	210	290	3	13	80	0.1625000
NODE_29363_length_566_cov_47.747323	210	290	4	13	80	0.1625000
NODE_29364_length_566_cov_44.824411	14	94	22	2	80	0.0250000
NODE_29364_length_566_cov_44.824411	14	94	24	5	80	0.0625000
NODE_29364_length_566_cov_44.824411	14	94	26	2	80	0.0250000
NODE_29364_length_566_cov_44.824411	14	94	28	3	80	0.0375000
NODE_29364_length_566_cov_44.824411	14	94	30	1	80	0.0125000
NODE_29364_length_566_cov_44.824411	14	94	32	2	80	0.0250000
NODE_29364_length_566_cov_44.824411	14	94	37	1	80	0.0125000
NODE_29364_length_566_cov_44.824411	14	94	50	1	80	0.0125000
NODE_29364_length_566_cov_44.824411	14	94	52	1	80	0.0125000
NODE_29364_length_566_cov_44.824411	14	94	53	2	80	0.0250000
NODE_29364_length_566_cov_44.824411	14	94	63	1	80	0.0125000
NODE_29364_length_566_cov_44.824411	14	94	66	9	80	0.1125000
NODE_29364_length_566_cov_44.824411	14	94	70	1	80	0.0125000
NODE_29364_length_566_cov_44.824411	14	94	72	2	80	0.0250000
NODE_29364_length_566_cov_44.824411	14	94	74	2	80	0.0250000
NODE_29364_length_566_cov_44.824411	14	94	80	5	80	0.0625000
NODE_29364_length_566_cov_44.824411	14	94	82	1	80	0.0125000
NODE_29364_length_566_cov_44.824411	14	94	84	39	80	0.4875000
NODE_29364_length_566_cov_44.824411	15	94	22	1	79	0.0126582
NODE_29364_length_566_cov_44.824411	15	94	24	5	79	0.0632911
NODE_29364_length_566_cov_44.824411	15	94	26	2	79	0.0253165
NODE_29364_length_566_cov_44.824411	15	94	28	3	79	0.0379747
NODE_29364_length_566_cov_44.824411	15	94	30	1	79	0.0126582
NODE_29364_length_566_cov_44.824411	15	94	32	2	79	0.0253165
NODE_29364_length_566_cov_44.824411	15	94	37	1	79	0.0126582
NODE_29364_length_566_cov_44.824411	15	94	50	1	79	0.0126582
NODE_29364_length_566_cov_44.824411	15	94	52	1	79	0.0126582
NODE_29364_length_566_cov_44.824411	15	94	53	2	79	0.0253165
NODE_29364_length_566_cov_44.824411	15	94	63	1	79	0.0126582
NODE_29364_length_566_cov_44.824411	15	94	66	9	79	0.1139240
NODE_29364_length_566_cov_44.824411	15	94	70	1	79	0.0126582
NODE_29364_length_566_cov_44.824411	15	94	72	2	79	0.0253165
NODE_29364_length_566_cov_44.824411	15	94	74	2	79	0.0253165
NODE_29364_length_566_cov_44.824411	15	94	80	5	79	0.0632911
NODE_29364_length_566_cov_44.824411	15	94	82	1	79	0.0126582
NODE_29364_length_566_cov_44.824411	15	94	84	39	79	0.4936709
NODE_29364_length_566_cov_44.824411	67	147	36	3	80	0.0375000
NODE_29364_length_566_cov_44.824411	67	147	37	1	80	0.0125000
NODE_29364_length_566_cov_44.824411	67	147	40	3	80	0.0375000
NODE_29364_length_566_cov_44.824411	67	147	42	4	80	0.0500000
NODE_29364_length_566_cov_44.824411	67	147	44	2	80	0.0250000
NODE_29364_length_566_cov_44.824411	67	147	50	4	80	0.0500000
NODE_29364_length_566_cov_44.824411	67	147	52	1	80	0.0125000
NODE_29364_length_566_cov_44.824411	67	147	54	2	80	0.0250000
NODE_29364_length_566_cov_44.824411	67	147	60	1	80	0.0125000
NODE_29364_length_566_cov_44.824411	67	147	62	1	80	0.0125000
NODE_29364_length_566_cov_44.824411	67	147	64	1	80	0.0125000
NODE_29364_length_566_cov_44.824411	67	147	66	1	80	0.0125000
NODE_29364_length_566_cov_44.824411	67	147	70	4	80	0.0500000
NODE_29364_length_566_cov_44.824411	67	147	72	1	80	0.0125000
NODE_29364_length_566_cov_44.824411	67	147	74	1	80	0.0125000
NODE_29364_length_566_cov_44.824411	67	147	78	8	80	0.1000000
NODE_29364_length_566_cov_44.824411	67	147	80	3	80	0.0375000
NODE_29364_length_566_cov_44.824411	67	147	84	39	80	0.4875000
NODE_29364_length_566_cov_44.824411	67	147	36	3	80	0.0375000
NODE_29364_length_566_cov_44.824411	67	147	37	1	80	0.0125000
NODE_29364_length_566_cov_44.824411	67	147	40	3	80	0.0375000
NODE_29364_length_566_cov_44.824411	67	147	42	4	80	0.0500000
NODE_29364_length_566_cov_44.824411	67	147	44	2	80	0.0250000
NODE_29364_length_566_cov_44.824411	67	147	50	4	80	0.0500000
NODE_29364_length_566_cov_44.824411	67	147	52	1	80	0.0125000
NODE_29364_length_566_cov_44.824411	67	147	54	2	80	0.0250000
NODE_29364_length_566_cov_44.824411	67	147	60	1	80	0.0125000
NODE_29364_length_566_cov_44.824411	67	147	62	1	80	0.0125000
NODE_29364_length_566_cov_44.824411	67	147	64	1	80	0.0125000
NODE_29364_length_566_cov_44.824411	67	147	66	1	80	0.0125000
NODE_29364_length_566_cov_44.824411	67	147	70	4	80	0.0500000
NODE_29364_length_566_cov_44.824411	67	147	72	1	80	0.0125000
NODE_29364_length_566_cov_44.824411	67	147	74	1	80	0.0125000
NODE_29364_length_566_cov_44.824411	67	147	78	8	80	0.1000000
NODE_29364_length_566_cov_44.824411	67	147	80	3	80	0.0375000
NODE_29364_length_566_cov_44.824411	67	147	84	39	80	0.4875000
NODE_29364_length_566_cov_44.824411	77	147	36	3	70	0.0428571
NODE_29364_length_566_cov_44.824411	77	147	37	1	70	0.0142857
NODE_29364_length_566_cov_44.824411	77	147	40	3	70	0.0428571
NODE_29364_length_566_cov_44.824411	77	147	42	4	70	0.0571429
NODE_29364_length_566_cov_44.824411	77	147	44	2	70	0.0285714
NODE_29364_length_566_cov_44.824411	77	147	50	4	70	0.0571429
NODE_29364_length_566_cov_44.824411	77	147	52	1	70	0.0142857
NODE_29364_length_566_cov_44.824411	77	147	54	2	70	0.0285714
NODE_29364_length_566_cov_44.824411	77	147	60	1	70	0.0142857
NODE_29364_length_566_cov_44.824411	77	147	62	1	70	0.0142857
NODE_29364_length_566_cov_44.824411	77	147	64	1	70	0.0142857
NODE_29364_length_566_cov_44.824411	77	147	66	1	70	0.0142857
NODE_29364_length_566_cov_44.824411	77	147	70	4	70	0.0571429
NODE_29364_length_566_cov_44.824411	77	147	72	1	70	0.0142857
NODE_29364_length_566_cov_44.824411	77	147	74	1	70	0.0142857
NODE_29364_length_566_cov_44.824411	77	147	78	8	70	0.1142857
NODE_29364_length_566_cov_44.824411	77	147	80	3	70	0.0428571
NODE_29364_length_566_cov_44.824411	77	147	84	29	70	0.4142857
NODE_29364_length_566_cov_44.824411	143	223	0	63	80	0.7875000
NODE_29364_length_566_cov_44.824411	143	223	4	2	80	0.0250000
NODE_29364_length_566_cov_44.824411	143	223	6	1	80	0.0125000
NODE_29364_length_566_cov_44.824411	143	223	13	4	80	0.0500000
NODE_29364_length_566_cov_44.824411	143	223	21	3	80	0.0375000
NODE_29364_length_566_cov_44.824411	143	223	23	1	80	0.0125000
NODE_29364_length_566_cov_44.824411	143	223	25	1	80	0.0125000
NODE_29364_length_566_cov_44.824411	143	223	28	1	80	0.0125000
NODE_29364_length_566_cov_44.824411	143	223	36	3	80	0.0375000
NODE_29364_length_566_cov_44.824411	143	223	37	1	80	0.0125000
NODE_29364_length_566_cov_44.824411	196	276	0	80	80	1.0000000
NODE_29367_length_566_cov_18.494647	344	424	0	30	80	0.3750000
NODE_29367_length_566_cov_18.494647	344	424	2	50	80	0.6250000
NODE_29367_length_566_cov_18.494647	397	477	0	80	80	1.0000000
NODE_29368_length_566_cov_17.537473	324	404	0	80	80	1.0000000
NODE_29368_length_566_cov_17.537473	377	457	0	80	80	1.0000000
NODE_29369_length_566_cov_13.019272	157	237	0	80	80	1.0000000
NODE_29369_length_566_cov_13.019272	210	290	0	80	80	1.0000000
NODE_29371_length_566_cov_9.513919	191	279	0	88	88	1.0000000
NODE_29371_length_566_cov_9.513919	252	332	0	80	80	1.0000000
NODE_29397_length_566_cov_3.239829	292	334	0	42	42	1.0000000
NODE_29397_length_566_cov_3.239829	351	375	0	24	24	1.0000000
NODE_29437_length_566_cov_1.698073	432	481	1	12	49	0.2448980
NODE_29437_length_566_cov_1.698073	432	481	5	10	49	0.2040816
NODE_29437_length_566_cov_1.698073	432	481	6	27	49	0.5510204
NODE_29472_length_566_cov_0.957173	378	405	2	27	27	1.0000000
NODE_29503_length_565_cov_10.508584	202	280	0	78	78	1.0000000
NODE_29503_length_565_cov_10.508584	253	334	0	81	81	1.0000000
NODE_29509_length_565_cov_7.560086	170	246	8	25	76	0.3289474
NODE_29509_length_565_cov_7.560086	170	246	10	3	76	0.0394737
NODE_29509_length_565_cov_7.560086	170	246	12	9	76	0.1184211
NODE_29509_length_565_cov_7.560086	170	246	14	9	76	0.1184211
NODE_29509_length_565_cov_7.560086	170	246	16	17	76	0.2236842
NODE_29509_length_565_cov_7.560086	170	246	18	8	76	0.1052632
NODE_29509_length_565_cov_7.560086	170	246	20	4	76	0.0526316
NODE_29509_length_565_cov_7.560086	170	246	22	1	76	0.0131579
NODE_29520_length_565_cov_4.045064	231	311	0	80	80	1.0000000
NODE_29520_length_565_cov_4.045064	284	364	0	60	80	0.7500000
NODE_29520_length_565_cov_4.045064	284	364	2	20	80	0.2500000
NODE_29528_length_565_cov_3.399142	161	241	0	80	80	1.0000000
NODE_29528_length_565_cov_3.399142	214	294	0	80	80	1.0000000
NODE_29542_length_565_cov_2.542918	302	382	0	80	80	1.0000000
NODE_29542_length_565_cov_2.542918	355	435	0	80	80	1.0000000
NODE_29650_length_564_cov_46.901075	129	209	16	18	80	0.2250000
NODE_29650_length_564_cov_46.901075	129	209	30	62	80	0.7750000
NODE_29650_length_564_cov_46.901075	182	262	14	44	80	0.5500000
NODE_29650_length_564_cov_46.901075	182	262	27	1	80	0.0125000
NODE_29650_length_564_cov_46.901075	182	262	29	1	80	0.0125000
NODE_29650_length_564_cov_46.901075	182	262	30	34	80	0.4250000
NODE_29651_length_564_cov_13.520430	300	380	0	64	80	0.8000000
NODE_29651_length_564_cov_13.520430	300	380	2	16	80	0.2000000
NODE_29651_length_564_cov_13.520430	353	433	0	80	80	1.0000000
NODE_29653_length_564_cov_7.965591	291	332	11	41	41	1.0000000
NODE_29796_length_563_cov_24.487069	97	177	0	80	80	1.0000000
NODE_29796_length_563_cov_24.487069	150	230	0	80	80	1.0000000
NODE_29800_length_563_cov_6.758621	301	367	0	14	66	0.2121212
NODE_29800_length_563_cov_6.758621	301	367	2	7	66	0.1060606
NODE_29800_length_563_cov_6.758621	301	367	5	1	66	0.0151515
NODE_29800_length_563_cov_6.758621	301	367	6	23	66	0.3484848
NODE_29800_length_563_cov_6.758621	301	367	8	21	66	0.3181818
NODE_29800_length_563_cov_6.758621	378	422	0	44	44	1.0000000
NODE_29802_length_563_cov_5.762931	48	135	0	87	87	1.0000000
NODE_29802_length_563_cov_5.762931	108	188	0	80	80	1.0000000
NODE_29808_length_563_cov_4.176724	197	277	0	80	80	1.0000000
NODE_29808_length_563_cov_4.176724	250	330	0	63	80	0.7875000
NODE_29808_length_563_cov_4.176724	250	330	2	17	80	0.2125000
NODE_29809_length_563_cov_4.155172	273	315	0	42	42	1.0000000
NODE_29809_length_563_cov_4.155172	288	358	0	70	70	1.0000000
NODE_29925_length_562_cov_31.194384	47	127	0	80	80	1.0000000
NODE_29925_length_562_cov_31.194384	100	180	0	80	80	1.0000000
NODE_29926_length_562_cov_29.857451	33	113	0	48	80	0.6000000
NODE_29926_length_562_cov_29.857451	33	113	6	5	80	0.0625000
NODE_29926_length_562_cov_29.857451	33	113	10	27	80	0.3375000
NODE_29926_length_562_cov_29.857451	86	166	4	5	80	0.0625000
NODE_29926_length_562_cov_29.857451	86	166	10	75	80	0.9375000
NODE_29927_length_562_cov_23.194384	245	325	0	80	80	1.0000000
NODE_29927_length_562_cov_23.194384	298	378	0	80	80	1.0000000
NODE_29930_length_562_cov_10.304536	271	321	0	15	50	0.3000000
NODE_29930_length_562_cov_10.304536	271	321	2	3	50	0.0600000
NODE_29930_length_562_cov_10.304536	271	321	4	32	50	0.6400000
NODE_29931_length_562_cov_9.131749	265	346	0	81	81	1.0000000
NODE_29931_length_562_cov_9.131749	319	399	0	80	80	1.0000000
NODE_29960_length_562_cov_2.961123	350	398	0	48	48	1.0000000
NODE_30083_length_561_cov_18.049784	54	134	0	58	80	0.7250000
NODE_30083_length_561_cov_18.049784	54	134	2	22	80	0.2750000
NODE_30083_length_561_cov_18.049784	107	187	0	5	80	0.0625000
NODE_30083_length_561_cov_18.049784	107	187	2	75	80	0.9375000
NODE_30087_length_561_cov_5.348485	208	274	3	19	66	0.2878788
NODE_30087_length_561_cov_5.348485	208	274	4	40	66	0.6060606
NODE_30087_length_561_cov_5.348485	208	274	5	7	66	0.1060606
NODE_30105_length_561_cov_2.787879	216	285	0	69	69	1.0000000
NODE_30120_length_561_cov_2.233766	339	419	0	12	80	0.1500000
NODE_30120_length_561_cov_2.233766	339	419	2	68	80	0.8500000
NODE_30120_length_561_cov_2.233766	391	445	0	38	54	0.7037037
NODE_30120_length_561_cov_2.233766	391	445	2	16	54	0.2962963
NODE_30120_length_561_cov_2.233766	392	438	0	31	46	0.6739131
NODE_30120_length_561_cov_2.233766	392	438	2	15	46	0.3260870
NODE_30133_length_561_cov_1.803030	258	334	0	76	76	1.0000000
NODE_30224_length_560_cov_41.433839	67	147	0	80	80	1.0000000
NODE_30224_length_560_cov_41.433839	120	200	0	80	80	1.0000000
NODE_30225_length_560_cov_35.993492	366	446	0	80	80	1.0000000
NODE_30225_length_560_cov_35.993492	419	499	0	80	80	1.0000000
NODE_30226_length_560_cov_20.433839	342	422	0	80	80	1.0000000
NODE_30226_length_560_cov_20.433839	395	475	0	80	80	1.0000000
NODE_30227_length_560_cov_13.850325	274	327	0	53	53	1.0000000
NODE_30228_length_560_cov_12.075922	233	314	0	13	81	0.1604938
NODE_30228_length_560_cov_12.075922	233	314	8	68	81	0.8395061
NODE_30229_length_560_cov_8.594360	263	343	0	80	80	1.0000000
NODE_30229_length_560_cov_8.594360	316	396	0	80	80	1.0000000
NODE_30237_length_560_cov_5.227766	264	328	6	6	64	0.0937500
NODE_30237_length_560_cov_5.227766	264	328	8	5	64	0.0781250
NODE_30237_length_560_cov_5.227766	264	328	10	1	64	0.0156250
NODE_30237_length_560_cov_5.227766	264	328	14	2	64	0.0312500
NODE_30237_length_560_cov_5.227766	264	328	18	41	64	0.6406250
NODE_30237_length_560_cov_5.227766	264	328	20	7	64	0.1093750
NODE_30237_length_560_cov_5.227766	264	328	22	2	64	0.0312500
NODE_30238_length_560_cov_5.056399	299	379	0	80	80	1.0000000
NODE_30238_length_560_cov_5.056399	352	432	0	80	80	1.0000000
NODE_30244_length_560_cov_4.518438	156	236	4	3	80	0.0375000
NODE_30244_length_560_cov_4.518438	156	236	6	38	80	0.4750000
NODE_30244_length_560_cov_4.518438	156	236	8	23	80	0.2875000
NODE_30244_length_560_cov_4.518438	156	236	10	16	80	0.2000000
NODE_30281_length_560_cov_2.154013	204	275	0	71	71	1.0000000
NODE_30281_length_560_cov_2.154013	255	335	0	20	80	0.2500000
NODE_30281_length_560_cov_2.154013	255	335	2	60	80	0.7500000
NODE_30288_length_560_cov_2.017354	52	114	0	62	62	1.0000000
NODE_30363_length_559_cov_37.526087	289	370	0	81	81	1.0000000
NODE_30363_length_559_cov_37.526087	343	423	0	80	80	1.0000000
NODE_30363_length_559_cov_37.526087	419	500	0	81	81	1.0000000
NODE_30363_length_559_cov_37.526087	473	553	0	80	80	1.0000000
NODE_30365_length_559_cov_19.126087	388	468	0	80	80	1.0000000
NODE_30365_length_559_cov_19.126087	441	521	0	80	80	1.0000000
NODE_30366_length_559_cov_12.489130	262	341	0	63	79	0.7974684
NODE_30366_length_559_cov_12.489130	262	341	2	16	79	0.2025317
NODE_30366_length_559_cov_12.489130	316	394	0	78	78	1.0000000
NODE_30370_length_559_cov_6.530435	283	363	0	80	80	1.0000000
NODE_30377_length_559_cov_4.930435	112	192	0	80	80	1.0000000
NODE_30377_length_559_cov_4.930435	165	244	0	79	79	1.0000000
NODE_30419_length_559_cov_1.776087	395	433	79	2	38	0.0526316
NODE_30419_length_559_cov_1.776087	395	433	81	3	38	0.0789474
NODE_30419_length_559_cov_1.776087	395	433	83	3	38	0.0789474
NODE_30419_length_559_cov_1.776087	395	433	85	2	38	0.0526316
NODE_30419_length_559_cov_1.776087	395	433	87	3	38	0.0789474
NODE_30419_length_559_cov_1.776087	395	433	88	5	38	0.1315790
NODE_30419_length_559_cov_1.776087	395	433	90	2	38	0.0526316
NODE_30419_length_559_cov_1.776087	395	433	92	1	38	0.0263158
NODE_30419_length_559_cov_1.776087	395	433	94	3	38	0.0789474
NODE_30419_length_559_cov_1.776087	395	433	98	1	38	0.0263158
NODE_30419_length_559_cov_1.776087	395	433	100	6	38	0.1578947
NODE_30419_length_559_cov_1.776087	395	433	102	2	38	0.0526316
NODE_30419_length_559_cov_1.776087	395	433	106	2	38	0.0526316
NODE_30419_length_559_cov_1.776087	395	433	108	3	38	0.0789474
NODE_30480_length_558_cov_13.102397	297	364	0	63	67	0.9402985
NODE_30480_length_558_cov_13.102397	297	364	4	4	67	0.0597015
NODE_30482_length_558_cov_9.309368	369	449	0	29	80	0.3625000
NODE_30482_length_558_cov_9.309368	369	449	2	18	80	0.2250000
NODE_30482_length_558_cov_9.309368	369	449	6	33	80	0.4125000
NODE_30482_length_558_cov_9.309368	422	502	0	80	80	1.0000000
NODE_30489_length_558_cov_5.921569	304	361	0	57	57	1.0000000
NODE_30493_length_558_cov_4.801743	197	266	2	69	69	1.0000000
NODE_30493_length_558_cov_4.801743	197	277	2	80	80	1.0000000
NODE_30493_length_558_cov_4.801743	250	330	0	21	80	0.2625000
NODE_30493_length_558_cov_4.801743	250	330	2	59	80	0.7375000
NODE_30493_length_558_cov_4.801743	250	330	0	21	80	0.2625000
NODE_30493_length_558_cov_4.801743	250	330	2	59	80	0.7375000
NODE_30495_length_558_cov_4.570806	188	244	4	53	56	0.9464286
NODE_30495_length_558_cov_4.570806	188	244	6	3	56	0.0535714
NODE_30536_length_558_cov_2.259259	236	294	2	12	58	0.2068966
NODE_30536_length_558_cov_2.259259	236	294	4	16	58	0.2758621
NODE_30536_length_558_cov_2.259259	236	294	6	19	58	0.3275862
NODE_30536_length_558_cov_2.259259	236	294	8	11	58	0.1896552
NODE_30536_length_558_cov_2.259259	267	347	6	64	80	0.8000000
NODE_30536_length_558_cov_2.259259	267	347	8	16	80	0.2000000
NODE_30568_length_558_cov_1.544662	403	483	0	80	80	1.0000000
NODE_30568_length_558_cov_1.544662	456	536	0	80	80	1.0000000
NODE_30623_length_557_cov_9.141921	255	335	0	13	80	0.1625000
NODE_30623_length_557_cov_9.141921	255	335	2	67	80	0.8375000
NODE_30623_length_557_cov_9.141921	308	388	0	7	80	0.0875000
NODE_30623_length_557_cov_9.141921	308	388	2	73	80	0.9125000
NODE_30626_length_557_cov_7.316594	210	290	0	56	80	0.7000000
NODE_30626_length_557_cov_7.316594	210	290	4	24	80	0.3000000
NODE_30626_length_557_cov_7.316594	263	341	0	78	78	1.0000000
NODE_30636_length_557_cov_4.259825	185	267	0	6	82	0.0731707
NODE_30636_length_557_cov_4.259825	185	267	2	47	82	0.5731707
NODE_30636_length_557_cov_4.259825	185	267	4	19	82	0.2317073
NODE_30636_length_557_cov_4.259825	185	267	6	10	82	0.1219512
NODE_30646_length_557_cov_3.794760	131	188	0	57	57	1.0000000
NODE_30646_length_557_cov_3.794760	139	219	0	80	80	1.0000000
NODE_30650_length_557_cov_3.517467	246	325	0	79	79	1.0000000
NODE_30650_length_557_cov_3.517467	298	378	0	80	80	1.0000000
NODE_30652_length_557_cov_3.390830	366	395	36	6	29	0.2068966
NODE_30652_length_557_cov_3.390830	366	395	38	7	29	0.2413793
NODE_30652_length_557_cov_3.390830	366	395	40	8	29	0.2758621
NODE_30652_length_557_cov_3.390830	366	395	42	8	29	0.2758621
NODE_30792_length_556_cov_37.258206	122	202	0	80	80	1.0000000
NODE_30792_length_556_cov_37.258206	175	255	0	80	80	1.0000000
NODE_30793_length_556_cov_15.266958	360	440	0	80	80	1.0000000
NODE_30793_length_556_cov_15.266958	413	493	0	80	80	1.0000000
NODE_30794_length_556_cov_12.781182	341	421	0	3	80	0.0375000
NODE_30794_length_556_cov_12.781182	341	421	6	32	80	0.4000000
NODE_30794_length_556_cov_12.781182	341	421	8	45	80	0.5625000
NODE_30794_length_556_cov_12.781182	394	474	0	56	80	0.7000000
NODE_30794_length_556_cov_12.781182	394	474	6	24	80	0.3000000
NODE_30795_length_556_cov_11.131291	304	384	2	5	80	0.0625000
NODE_30795_length_556_cov_11.131291	304	384	3	48	80	0.6000000
NODE_30795_length_556_cov_11.131291	304	384	4	27	80	0.3375000
NODE_30795_length_556_cov_11.131291	357	437	0	46	80	0.5750000
NODE_30795_length_556_cov_11.131291	357	437	2	12	80	0.1500000
NODE_30795_length_556_cov_11.131291	357	437	3	22	80	0.2750000
NODE_30797_length_556_cov_7.168490	163	243	0	80	80	1.0000000
NODE_30797_length_556_cov_7.168490	216	296	0	80	80	1.0000000
NODE_30798_length_556_cov_7.089716	325	379	0	54	54	1.0000000
NODE_30801_length_556_cov_6.505470	232	312	0	34	80	0.4250000
NODE_30801_length_556_cov_6.505470	232	312	6	5	80	0.0625000
NODE_30801_length_556_cov_6.505470	232	312	8	12	80	0.1500000
NODE_30801_length_556_cov_6.505470	232	312	10	29	80	0.3625000
NODE_30801_length_556_cov_6.505470	285	365	9	4	80	0.0500000
NODE_30801_length_556_cov_6.505470	285	365	10	76	80	0.9500000
NODE_30802_length_556_cov_6.496718	140	179	0	39	39	1.0000000
NODE_30802_length_556_cov_6.496718	226	255	0	29	29	1.0000000
NODE_30809_length_556_cov_4.457330	197	277	47	4	80	0.0500000
NODE_30809_length_556_cov_4.457330	197	277	50	2	80	0.0250000
NODE_30809_length_556_cov_4.457330	197	277	52	13	80	0.1625000
NODE_30809_length_556_cov_4.457330	197	277	53	22	80	0.2750000
NODE_30809_length_556_cov_4.457330	197	277	54	7	80	0.0875000
NODE_30809_length_556_cov_4.457330	197	277	55	4	80	0.0500000
NODE_30809_length_556_cov_4.457330	197	277	60	1	80	0.0125000
NODE_30809_length_556_cov_4.457330	197	277	62	6	80	0.0750000
NODE_30809_length_556_cov_4.457330	197	277	64	21	80	0.2625000
NODE_30818_length_556_cov_3.761488	234	307	0	73	73	1.0000000
NODE_30930_length_555_cov_20.949561	322	402	0	28	80	0.3500000
NODE_30930_length_555_cov_20.949561	322	402	4	52	80	0.6500000
NODE_30930_length_555_cov_20.949561	375	455	0	80	80	1.0000000
NODE_30931_length_555_cov_16.822368	268	348	0	80	80	1.0000000
NODE_30931_length_555_cov_16.822368	321	401	0	80	80	1.0000000
NODE_30933_length_555_cov_9.912281	313	393	0	80	80	1.0000000
NODE_30935_length_555_cov_8.057018	277	357	0	52	80	0.6500000
NODE_30935_length_555_cov_8.057018	277	357	2	28	80	0.3500000
NODE_30935_length_555_cov_8.057018	330	410	2	78	80	0.9750000
NODE_30935_length_555_cov_8.057018	330	410	4	2	80	0.0250000
NODE_30938_length_555_cov_6.778509	62	92	0	30	30	1.0000000
NODE_30986_length_555_cov_2.177632	208	288	0	80	80	1.0000000
NODE_30986_length_555_cov_2.177632	261	329	0	68	68	1.0000000
NODE_31092_length_554_cov_11.942857	118	198	0	80	80	1.0000000
NODE_31092_length_554_cov_11.942857	171	251	0	80	80	1.0000000
NODE_31096_length_554_cov_8.426374	242	322	0	13	80	0.1625000
NODE_31096_length_554_cov_8.426374	242	322	2	67	80	0.8375000
NODE_31096_length_554_cov_8.426374	295	375	0	66	80	0.8250000
NODE_31096_length_554_cov_8.426374	295	375	2	14	80	0.1750000
NODE_31101_length_554_cov_6.116484	264	344	0	60	80	0.7500000
NODE_31101_length_554_cov_6.116484	264	344	2	20	80	0.2500000
NODE_31101_length_554_cov_6.116484	317	393	0	76	76	1.0000000
NODE_31115_length_554_cov_3.586813	207	286	2	79	79	1.0000000
NODE_31240_length_553_cov_42.017621	197	277	0	1	80	0.0125000
NODE_31240_length_553_cov_42.017621	197	277	1	10	80	0.1250000
NODE_31240_length_553_cov_42.017621	197	277	2	14	80	0.1750000
NODE_31240_length_553_cov_42.017621	197	277	4	55	80	0.6875000
NODE_31240_length_553_cov_42.017621	250	330	4	80	80	1.0000000
NODE_31241_length_553_cov_28.944934	333	413	0	80	80	1.0000000
NODE_31241_length_553_cov_28.944934	386	466	0	80	80	1.0000000
NODE_31242_length_553_cov_12.176211	242	322	0	26	80	0.3250000
NODE_31242_length_553_cov_12.176211	242	322	2	16	80	0.2000000
NODE_31242_length_553_cov_12.176211	242	322	4	38	80	0.4750000
NODE_31242_length_553_cov_12.176211	295	375	2	9	80	0.1125000
NODE_31242_length_553_cov_12.176211	295	375	4	71	80	0.8875000
NODE_31244_length_553_cov_9.876652	232	312	0	80	80	1.0000000
NODE_31244_length_553_cov_9.876652	285	365	0	80	80	1.0000000
NODE_31246_length_553_cov_9.306167	207	287	1	5	80	0.0625000
NODE_31246_length_553_cov_9.306167	207	287	2	11	80	0.1375000
NODE_31246_length_553_cov_9.306167	207	287	3	6	80	0.0750000
NODE_31246_length_553_cov_9.306167	207	287	4	2	80	0.0250000
NODE_31246_length_553_cov_9.306167	207	287	5	26	80	0.3250000
NODE_31246_length_553_cov_9.306167	207	287	6	30	80	0.3750000
NODE_31246_length_553_cov_9.306167	207	287	1	5	80	0.0625000
NODE_31246_length_553_cov_9.306167	207	287	2	11	80	0.1375000
NODE_31246_length_553_cov_9.306167	207	287	3	6	80	0.0750000
NODE_31246_length_553_cov_9.306167	207	287	4	2	80	0.0250000
NODE_31246_length_553_cov_9.306167	207	287	5	26	80	0.3250000
NODE_31246_length_553_cov_9.306167	207	287	6	30	80	0.3750000
NODE_31246_length_553_cov_9.306167	260	340	2	34	80	0.4250000
NODE_31246_length_553_cov_9.306167	260	340	4	32	80	0.4000000
NODE_31246_length_553_cov_9.306167	260	340	6	14	80	0.1750000
NODE_31259_length_553_cov_3.729075	36	93	19	1	57	0.0175439
NODE_31259_length_553_cov_3.729075	36	93	21	7	57	0.1228070
NODE_31259_length_553_cov_3.729075	36	93	23	49	57	0.8596491
NODE_31259_length_553_cov_3.729075	89	146	3	10	57	0.1754386
NODE_31259_length_553_cov_3.729075	89	146	5	9	57	0.1578947
NODE_31259_length_553_cov_3.729075	89	146	7	10	57	0.1754386
NODE_31259_length_553_cov_3.729075	89	146	9	1	57	0.0175439
NODE_31259_length_553_cov_3.729075	89	146	17	10	57	0.1754386
NODE_31259_length_553_cov_3.729075	89	146	19	8	57	0.1403509
NODE_31259_length_553_cov_3.729075	89	146	21	3	57	0.0526316
NODE_31259_length_553_cov_3.729075	89	146	23	6	57	0.1052632
NODE_31266_length_553_cov_3.310573	226	293	0	67	67	1.0000000
NODE_31279_length_553_cov_2.678414	102	180	0	78	78	1.0000000
NODE_31279_length_553_cov_2.678414	248	275	0	27	27	1.0000000
NODE_31295_length_553_cov_1.958150	416	462	7	12	46	0.2608696
NODE_31295_length_553_cov_1.958150	416	462	11	2	46	0.0434783
NODE_31295_length_553_cov_1.958150	416	462	15	1	46	0.0217391
NODE_31295_length_553_cov_1.958150	416	462	19	8	46	0.1739130
NODE_31295_length_553_cov_1.958150	416	462	21	14	46	0.3043478
NODE_31295_length_553_cov_1.958150	416	462	22	2	46	0.0434783
NODE_31295_length_553_cov_1.958150	416	462	24	7	46	0.1521739
NODE_31295_length_553_cov_1.958150	469	515	14	8	46	0.1739130
NODE_31295_length_553_cov_1.958150	469	515	16	3	46	0.0652174
NODE_31295_length_553_cov_1.958150	469	515	18	6	46	0.1304348
NODE_31295_length_553_cov_1.958150	469	515	20	3	46	0.0652174
NODE_31295_length_553_cov_1.958150	469	515	22	26	46	0.5652174
NODE_31377_length_552_cov_92.070640	298	378	0	80	80	1.0000000
NODE_31377_length_552_cov_92.070640	298	378	0	80	80	1.0000000
NODE_31377_length_552_cov_92.070640	374	454	0	80	80	1.0000000
NODE_31377_length_552_cov_92.070640	374	454	0	80	80	1.0000000
NODE_31377_length_552_cov_92.070640	374	454	0	80	80	1.0000000
NODE_31377_length_552_cov_92.070640	374	454	0	80	80	1.0000000
NODE_31377_length_552_cov_92.070640	374	450	0	76	76	1.0000000
NODE_31377_length_552_cov_92.070640	427	507	0	80	80	1.0000000
NODE_31377_length_552_cov_92.070640	427	507	0	80	80	1.0000000
NODE_31377_length_552_cov_92.070640	427	498	0	71	71	1.0000000
NODE_31377_length_552_cov_92.070640	430	500	0	70	70	1.0000000
NODE_31377_length_552_cov_92.070640	432	507	0	75	75	1.0000000
NODE_31378_length_552_cov_20.432671	151	231	2	80	80	1.0000000
NODE_31378_length_552_cov_20.432671	204	284	0	44	80	0.5500000
NODE_31378_length_552_cov_20.432671	204	284	2	36	80	0.4500000
NODE_31379_length_552_cov_18.075055	257	333	0	38	76	0.5000000
NODE_31379_length_552_cov_18.075055	257	333	2	28	76	0.3684210
NODE_31379_length_552_cov_18.075055	257	333	4	10	76	0.1315790
NODE_31380_length_552_cov_13.331126	214	294	0	44	80	0.5500000
NODE_31380_length_552_cov_13.331126	214	294	2	22	80	0.2750000
NODE_31380_length_552_cov_13.331126	214	294	4	2	80	0.0250000
NODE_31380_length_552_cov_13.331126	214	294	6	2	80	0.0250000
NODE_31380_length_552_cov_13.331126	214	294	8	2	80	0.0250000
NODE_31380_length_552_cov_13.331126	214	294	10	8	80	0.1000000
NODE_31380_length_552_cov_13.331126	267	347	0	80	80	1.0000000
NODE_31381_length_552_cov_12.774834	360	440	0	80	80	1.0000000
NODE_31381_length_552_cov_12.774834	413	493	0	80	80	1.0000000
NODE_31384_length_552_cov_8.883002	310	390	0	18	80	0.2250000
NODE_31384_length_552_cov_8.883002	310	390	6	18	80	0.2250000
NODE_31384_length_552_cov_8.883002	310	390	8	44	80	0.5500000
NODE_31384_length_552_cov_8.883002	363	443	0	71	80	0.8875000
NODE_31384_length_552_cov_8.883002	363	443	6	9	80	0.1125000
NODE_31385_length_552_cov_6.916115	206	281	0	75	75	1.0000000
NODE_31538_length_551_cov_34.070796	324	406	0	41	82	0.5000000
NODE_31538_length_551_cov_34.070796	324	406	2	41	82	0.5000000
NODE_31538_length_551_cov_34.070796	379	444	0	23	65	0.3538462
NODE_31538_length_551_cov_34.070796	379	444	2	42	65	0.6461539
NODE_31541_length_551_cov_10.252212	164	244	0	11	80	0.1375000
NODE_31541_length_551_cov_10.252212	164	244	3	4	80	0.0500000
NODE_31541_length_551_cov_10.252212	164	244	4	65	80	0.8125000
NODE_31541_length_551_cov_10.252212	217	297	0	43	80	0.5375000
NODE_31541_length_551_cov_10.252212	217	297	4	37	80	0.4625000
NODE_31543_length_551_cov_8.075221	363	406	2	18	43	0.4186046
NODE_31543_length_551_cov_8.075221	363	406	3	16	43	0.3720930
NODE_31543_length_551_cov_8.075221	363	406	5	8	43	0.1860465
NODE_31543_length_551_cov_8.075221	363	406	7	1	43	0.0232558
NODE_31547_length_551_cov_5.668142	213	293	4	3	80	0.0375000
NODE_31547_length_551_cov_5.668142	213	293	6	8	80	0.1000000
NODE_31547_length_551_cov_5.668142	213	293	10	57	80	0.7125000
NODE_31547_length_551_cov_5.668142	213	293	12	12	80	0.1500000
NODE_31547_length_551_cov_5.668142	266	346	2	14	80	0.1750000
NODE_31547_length_551_cov_5.668142	266	346	6	21	80	0.2625000
NODE_31547_length_551_cov_5.668142	266	346	8	11	80	0.1375000
NODE_31547_length_551_cov_5.668142	266	346	10	34	80	0.4250000
NODE_31552_length_551_cov_4.212389	171	242	6	19	71	0.2676056
NODE_31552_length_551_cov_4.212389	171	242	7	8	71	0.1126761
NODE_31552_length_551_cov_4.212389	171	242	8	44	71	0.6197183
NODE_31552_length_551_cov_4.212389	215	263	6	40	48	0.8333333
NODE_31552_length_551_cov_4.212389	215	263	8	8	48	0.1666667
NODE_31563_length_551_cov_3.307522	227	307	0	80	80	1.0000000
NODE_31563_length_551_cov_3.307522	280	360	0	80	80	1.0000000
NODE_31693_length_550_cov_17.308204	101	181	0	43	80	0.5375000
NODE_31693_length_550_cov_17.308204	101	181	2	37	80	0.4625000
NODE_31693_length_550_cov_17.308204	154	234	0	80	80	1.0000000
NODE_31700_length_550_cov_5.580931	286	329	0	43	43	1.0000000
NODE_31701_length_550_cov_5.490022	458	500	0	42	42	1.0000000
NODE_31701_length_550_cov_5.490022	459	523	0	64	64	1.0000000
NODE_31703_length_550_cov_5.243902	194	274	0	80	80	1.0000000
NODE_31703_length_550_cov_5.243902	247	327	0	80	80	1.0000000
NODE_31706_length_550_cov_4.815965	184	264	0	80	80	1.0000000
NODE_31726_length_550_cov_3.252772	308	388	14	21	80	0.2625000
NODE_31726_length_550_cov_3.252772	308	388	16	3	80	0.0375000
NODE_31726_length_550_cov_3.252772	308	388	18	56	80	0.7000000
NODE_31756_length_550_cov_1.864745	189	259	0	58	70	0.8285714
NODE_31756_length_550_cov_1.864745	189	259	2	12	70	0.1714286
NODE_31756_length_550_cov_1.864745	189	258	0	58	69	0.8405797
NODE_31756_length_550_cov_1.864745	189	258	2	11	69	0.1594203
NODE_31847_length_549_cov_31.826667	216	292	39	1	76	0.0131579
NODE_31847_length_549_cov_31.826667	216	292	43	1	76	0.0131579
NODE_31847_length_549_cov_31.826667	216	292	47	1	76	0.0131579
NODE_31847_length_549_cov_31.826667	216	292	50	10	76	0.1315790
NODE_31847_length_549_cov_31.826667	216	292	52	9	76	0.1184211
NODE_31847_length_549_cov_31.826667	216	292	54	1	76	0.0131579
NODE_31847_length_549_cov_31.826667	216	292	55	3	76	0.0394737
NODE_31847_length_549_cov_31.826667	216	292	58	24	76	0.3157895
NODE_31847_length_549_cov_31.826667	216	292	60	9	76	0.1184211
NODE_31847_length_549_cov_31.826667	216	292	62	8	76	0.1052632
NODE_31847_length_549_cov_31.826667	216	292	64	9	76	0.1184211
NODE_31847_length_549_cov_31.826667	267	331	27	3	64	0.0468750
NODE_31847_length_549_cov_31.826667	267	331	29	3	64	0.0468750
NODE_31847_length_549_cov_31.826667	267	331	32	5	64	0.0781250
NODE_31847_length_549_cov_31.826667	267	331	33	1	64	0.0156250
NODE_31847_length_549_cov_31.826667	267	331	35	1	64	0.0156250
NODE_31847_length_549_cov_31.826667	267	331	41	9	64	0.1406250
NODE_31847_length_549_cov_31.826667	267	331	43	2	64	0.0312500
NODE_31847_length_549_cov_31.826667	267	331	47	4	64	0.0625000
NODE_31847_length_549_cov_31.826667	267	331	49	3	64	0.0468750
NODE_31847_length_549_cov_31.826667	267	331	50	16	64	0.2500000
NODE_31847_length_549_cov_31.826667	267	331	51	1	64	0.0156250
NODE_31847_length_549_cov_31.826667	267	331	53	1	64	0.0156250
NODE_31847_length_549_cov_31.826667	267	331	58	3	64	0.0468750
NODE_31847_length_549_cov_31.826667	267	331	60	5	64	0.0781250
NODE_31847_length_549_cov_31.826667	267	331	62	5	64	0.0781250
NODE_31847_length_549_cov_31.826667	267	331	64	2	64	0.0312500
NODE_31848_length_549_cov_14.124444	174	263	0	29	89	0.3258427
NODE_31848_length_549_cov_14.124444	174	263	14	60	89	0.6741573
NODE_31848_length_549_cov_14.124444	242	315	14	73	73	1.0000000
NODE_31857_length_549_cov_5.375556	181	257	97	1	76	0.0131579
NODE_31857_length_549_cov_5.375556	181	257	102	1	76	0.0131579
NODE_31857_length_549_cov_5.375556	181	257	110	2	76	0.0263158
NODE_31857_length_549_cov_5.375556	181	257	114	1	76	0.0131579
NODE_31857_length_549_cov_5.375556	181	257	120	1	76	0.0131579
NODE_31857_length_549_cov_5.375556	181	257	122	2	76	0.0263158
NODE_31857_length_549_cov_5.375556	181	257	124	1	76	0.0131579
NODE_31857_length_549_cov_5.375556	181	257	130	1	76	0.0131579
NODE_31857_length_549_cov_5.375556	181	257	136	1	76	0.0131579
NODE_31857_length_549_cov_5.375556	181	257	137	1	76	0.0131579
NODE_31857_length_549_cov_5.375556	181	257	139	1	76	0.0131579
NODE_31857_length_549_cov_5.375556	181	257	143	1	76	0.0131579
NODE_31857_length_549_cov_5.375556	181	257	150	2	76	0.0263158
NODE_31857_length_549_cov_5.375556	181	257	152	3	76	0.0394737
NODE_31857_length_549_cov_5.375556	181	257	154	9	76	0.1184211
NODE_31857_length_549_cov_5.375556	181	257	155	2	76	0.0263158
NODE_31857_length_549_cov_5.375556	181	257	156	1	76	0.0131579
NODE_31857_length_549_cov_5.375556	181	257	157	2	76	0.0263158
NODE_31857_length_549_cov_5.375556	181	257	158	1	76	0.0131579
NODE_31857_length_549_cov_5.375556	181	257	164	3	76	0.0394737
NODE_31857_length_549_cov_5.375556	181	257	166	2	76	0.0263158
NODE_31857_length_549_cov_5.375556	181	257	168	4	76	0.0526316
NODE_31857_length_549_cov_5.375556	181	257	169	1	76	0.0131579
NODE_31857_length_549_cov_5.375556	181	257	170	1	76	0.0131579
NODE_31857_length_549_cov_5.375556	181	257	174	1	76	0.0131579
NODE_31857_length_549_cov_5.375556	181	257	178	1	76	0.0131579
NODE_31857_length_549_cov_5.375556	181	257	179	1	76	0.0131579
NODE_31857_length_549_cov_5.375556	181	257	181	4	76	0.0526316
NODE_31857_length_549_cov_5.375556	181	257	189	1	76	0.0131579
NODE_31857_length_549_cov_5.375556	181	257	191	5	76	0.0657895
NODE_31857_length_549_cov_5.375556	181	257	192	1	76	0.0131579
NODE_31857_length_549_cov_5.375556	181	257	195	2	76	0.0263158
NODE_31857_length_549_cov_5.375556	181	257	197	2	76	0.0263158
NODE_31857_length_549_cov_5.375556	181	257	198	1	76	0.0131579
NODE_31857_length_549_cov_5.375556	181	257	199	4	76	0.0526316
NODE_31857_length_549_cov_5.375556	181	257	205	1	76	0.0131579
NODE_31857_length_549_cov_5.375556	181	257	207	2	76	0.0263158
NODE_31857_length_549_cov_5.375556	181	257	208	1	76	0.0131579
NODE_31857_length_549_cov_5.375556	181	257	209	1	76	0.0131579
NODE_31857_length_549_cov_5.375556	181	257	211	3	76	0.0394737
NODE_31859_length_549_cov_4.933333	260	340	0	80	80	1.0000000
NODE_31864_length_549_cov_4.537778	345	430	0	66	85	0.7764706
NODE_31864_length_549_cov_4.537778	345	430	2	19	85	0.2235294
NODE_31864_length_549_cov_4.537778	403	483	0	11	80	0.1375000
NODE_31864_length_549_cov_4.537778	403	483	2	69	80	0.8625000
NODE_31865_length_549_cov_4.124444	406	486	13	20	80	0.2500000
NODE_31865_length_549_cov_4.124444	406	486	14	1	80	0.0125000
NODE_31865_length_549_cov_4.124444	406	486	17	20	80	0.2500000
NODE_31865_length_549_cov_4.124444	406	486	23	2	80	0.0250000
NODE_31865_length_549_cov_4.124444	406	486	24	19	80	0.2375000
NODE_31865_length_549_cov_4.124444	406	486	26	18	80	0.2250000
NODE_31866_length_549_cov_3.931111	182	219	0	37	37	1.0000000
NODE_31868_length_549_cov_3.893333	287	367	0	25	80	0.3125000
NODE_31868_length_549_cov_3.893333	287	367	1	35	80	0.4375000
NODE_31868_length_549_cov_3.893333	287	367	2	20	80	0.2500000
NODE_31868_length_549_cov_3.893333	340	420	0	78	80	0.9750000
NODE_31868_length_549_cov_3.893333	340	420	1	2	80	0.0250000
NODE_31887_length_549_cov_2.673333	282	343	0	8	61	0.1311475
NODE_31887_length_549_cov_2.673333	282	343	4	40	61	0.6557377
NODE_31887_length_549_cov_2.673333	282	343	6	13	61	0.2131148
NODE_31890_length_549_cov_2.622222	144	220	0	6	76	0.0789474
NODE_31890_length_549_cov_2.622222	144	220	2	70	76	0.9210526
NODE_32013_length_548_cov_13.962138	285	371	0	86	86	1.0000000
NODE_32013_length_548_cov_13.962138	344	424	0	80	80	1.0000000
NODE_32022_length_548_cov_4.683742	261	336	0	75	75	1.0000000
NODE_32023_length_548_cov_4.670379	140	182	0	42	42	1.0000000
NODE_32023_length_548_cov_4.670379	282	311	0	29	29	1.0000000
NODE_32023_length_548_cov_4.670379	410	455	0	34	45	0.7555556
NODE_32023_length_548_cov_4.670379	410	455	2	11	45	0.2444444
NODE_32029_length_548_cov_3.630290	111	177	0	27	66	0.4090909
NODE_32029_length_548_cov_3.630290	111	177	1	1	66	0.0151515
NODE_32029_length_548_cov_3.630290	111	177	2	38	66	0.5757576
NODE_32039_length_548_cov_3.080178	142	191	0	49	49	1.0000000
NODE_32180_length_547_cov_23.982143	243	323	8	9	80	0.1125000
NODE_32180_length_547_cov_23.982143	243	323	9	5	80	0.0625000
NODE_32180_length_547_cov_23.982143	243	323	11	12	80	0.1500000
NODE_32180_length_547_cov_23.982143	243	323	12	1	80	0.0125000
NODE_32180_length_547_cov_23.982143	243	323	13	14	80	0.1750000
NODE_32180_length_547_cov_23.982143	243	323	15	9	80	0.1125000
NODE_32180_length_547_cov_23.982143	243	323	16	5	80	0.0625000
NODE_32180_length_547_cov_23.982143	243	323	17	13	80	0.1625000
NODE_32180_length_547_cov_23.982143	243	323	18	12	80	0.1500000
NODE_32180_length_547_cov_23.982143	243	323	8	9	80	0.1125000
NODE_32180_length_547_cov_23.982143	243	323	9	5	80	0.0625000
NODE_32180_length_547_cov_23.982143	243	323	11	12	80	0.1500000
NODE_32180_length_547_cov_23.982143	243	323	12	1	80	0.0125000
NODE_32180_length_547_cov_23.982143	243	323	13	14	80	0.1750000
NODE_32180_length_547_cov_23.982143	243	323	15	9	80	0.1125000
NODE_32180_length_547_cov_23.982143	243	323	16	5	80	0.0625000
NODE_32180_length_547_cov_23.982143	243	323	17	13	80	0.1625000
NODE_32180_length_547_cov_23.982143	243	323	18	12	80	0.1500000
NODE_32180_length_547_cov_23.982143	252	323	9	5	71	0.0704225
NODE_32180_length_547_cov_23.982143	252	323	11	12	71	0.1690141
NODE_32180_length_547_cov_23.982143	252	323	12	1	71	0.0140845
NODE_32180_length_547_cov_23.982143	252	323	13	14	71	0.1971831
NODE_32180_length_547_cov_23.982143	252	323	15	9	71	0.1267606
NODE_32180_length_547_cov_23.982143	252	323	16	5	71	0.0704225
NODE_32180_length_547_cov_23.982143	252	323	17	13	71	0.1830986
NODE_32180_length_547_cov_23.982143	252	323	18	12	71	0.1690141
NODE_32181_length_547_cov_23.555804	42	122	0	11	80	0.1375000
NODE_32181_length_547_cov_23.555804	42	122	2	65	80	0.8125000
NODE_32181_length_547_cov_23.555804	42	122	4	4	80	0.0500000
NODE_32181_length_547_cov_23.555804	95	175	0	6	80	0.0750000
NODE_32181_length_547_cov_23.555804	95	175	2	17	80	0.2125000
NODE_32181_length_547_cov_23.555804	95	175	4	57	80	0.7125000
NODE_32183_length_547_cov_12.819196	190	270	0	16	80	0.2000000
NODE_32183_length_547_cov_12.819196	190	270	1	15	80	0.1875000
NODE_32183_length_547_cov_12.819196	190	270	2	41	80	0.5125000
NODE_32183_length_547_cov_12.819196	190	270	4	8	80	0.1000000
NODE_32195_length_547_cov_5.207589	290	370	0	76	80	0.9500000
NODE_32195_length_547_cov_5.207589	290	370	2	4	80	0.0500000
NODE_32195_length_547_cov_5.207589	343	423	0	23	80	0.2875000
NODE_32195_length_547_cov_5.207589	343	423	2	6	80	0.0750000
NODE_32195_length_547_cov_5.207589	343	423	3	1	80	0.0125000
NODE_32195_length_547_cov_5.207589	343	423	4	20	80	0.2500000
NODE_32195_length_547_cov_5.207589	343	423	5	1	80	0.0125000
NODE_32195_length_547_cov_5.207589	343	423	6	19	80	0.2375000
NODE_32195_length_547_cov_5.207589	343	423	8	10	80	0.1250000
NODE_32197_length_547_cov_4.975446	411	488	0	27	77	0.3506494
NODE_32197_length_547_cov_4.975446	411	488	2	21	77	0.2727273
NODE_32197_length_547_cov_4.975446	411	488	4	29	77	0.3766234
NODE_32197_length_547_cov_4.975446	461	542	2	26	81	0.3209876
NODE_32197_length_547_cov_4.975446	461	542	4	55	81	0.6790124
NODE_32199_length_547_cov_4.683036	451	492	0	41	41	1.0000000
NODE_32204_length_547_cov_4.138393	97	175	6	21	78	0.2692308
NODE_32204_length_547_cov_4.138393	97	175	8	20	78	0.2564103
NODE_32204_length_547_cov_4.138393	97	175	10	37	78	0.4743590
NODE_32204_length_547_cov_4.138393	151	228	4	19	77	0.2467532
NODE_32204_length_547_cov_4.138393	151	228	5	3	77	0.0389610
NODE_32204_length_547_cov_4.138393	151	228	6	15	77	0.1948052
NODE_32204_length_547_cov_4.138393	151	228	8	34	77	0.4415585
NODE_32204_length_547_cov_4.138393	151	228	10	6	77	0.0779221
NODE_32206_length_547_cov_4.026786	136	216	0	80	80	1.0000000
NODE_32206_length_547_cov_4.026786	189	269	0	80	80	1.0000000
NODE_32215_length_547_cov_3.468750	219	299	0	80	80	1.0000000
NODE_32222_length_547_cov_2.901786	304	384	0	80	80	1.0000000
NODE_32347_length_546_cov_17.733781	159	239	1	28	80	0.3500000
NODE_32347_length_546_cov_17.733781	159	239	2	34	80	0.4250000
NODE_32347_length_546_cov_17.733781	159	239	3	18	80	0.2250000
NODE_32347_length_546_cov_17.733781	212	293	1	9	81	0.1111111
NODE_32347_length_546_cov_17.733781	212	293	2	44	81	0.5432099
NODE_32347_length_546_cov_17.733781	212	293	3	28	81	0.3456790
NODE_32348_length_546_cov_16.275168	272	352	0	80	80	1.0000000
NODE_32348_length_546_cov_16.275168	325	405	0	80	80	1.0000000
NODE_32349_length_546_cov_8.201342	179	259	2	5	80	0.0625000
NODE_32349_length_546_cov_8.201342	179	259	4	9	80	0.1125000
NODE_32349_length_546_cov_8.201342	179	259	6	17	80	0.2125000
NODE_32349_length_546_cov_8.201342	179	259	8	49	80	0.6125000
NODE_32351_length_546_cov_7.454139	241	321	0	80	80	1.0000000
NODE_32351_length_546_cov_7.454139	294	374	0	80	80	1.0000000
NODE_32380_length_546_cov_3.192394	171	251	0	62	80	0.7750000
NODE_32380_length_546_cov_3.192394	171	251	2	18	80	0.2250000
NODE_32510_length_545_cov_31.524664	38	118	0	68	80	0.8500000
NODE_32510_length_545_cov_31.524664	38	118	2	12	80	0.1500000
NODE_32510_length_545_cov_31.524664	91	171	0	15	80	0.1875000
NODE_32510_length_545_cov_31.524664	91	171	2	20	80	0.2500000
NODE_32510_length_545_cov_31.524664	91	171	4	34	80	0.4250000
NODE_32510_length_545_cov_31.524664	91	171	6	11	80	0.1375000
NODE_32517_length_545_cov_5.524664	268	348	2	11	80	0.1375000
NODE_32517_length_545_cov_5.524664	268	348	3	23	80	0.2875000
NODE_32517_length_545_cov_5.524664	268	348	5	46	80	0.5750000
NODE_32525_length_545_cov_3.885650	137	217	4	17	80	0.2125000
NODE_32525_length_545_cov_3.885650	137	217	5	61	80	0.7625000
NODE_32525_length_545_cov_3.885650	137	217	6	2	80	0.0250000
NODE_32571_length_545_cov_2.013453	246	318	8	13	72	0.1805556
NODE_32571_length_545_cov_2.013453	246	318	10	20	72	0.2777778
NODE_32571_length_545_cov_2.013453	246	318	11	13	72	0.1805556
NODE_32571_length_545_cov_2.013453	246	318	12	26	72	0.3611111
NODE_32599_length_545_cov_1.450673	130	179	0	19	49	0.3877551
NODE_32599_length_545_cov_1.450673	130	179	2	30	49	0.6122449
NODE_32616_length_545_cov_1.179372	431	469	0	38	38	1.0000000
NODE_32673_length_544_cov_37.705618	258	338	0	80	80	1.0000000
NODE_32673_length_544_cov_37.705618	311	391	0	80	80	1.0000000
NODE_32674_length_544_cov_33.847191	189	269	0	80	80	1.0000000
NODE_32674_length_544_cov_33.847191	242	327	0	85	85	1.0000000
NODE_32675_length_544_cov_19.467416	251	331	0	80	80	1.0000000
NODE_32675_length_544_cov_19.467416	304	384	0	80	80	1.0000000
NODE_32676_length_544_cov_16.775281	163	243	0	80	80	1.0000000
NODE_32676_length_544_cov_16.775281	216	296	0	37	80	0.4625000
NODE_32676_length_544_cov_16.775281	216	296	2	43	80	0.5375000
NODE_32677_length_544_cov_8.943820	81	161	0	80	80	1.0000000
NODE_32677_length_544_cov_8.943820	134	214	0	80	80	1.0000000
NODE_32678_length_544_cov_8.537079	283	363	4	12	80	0.1500000
NODE_32678_length_544_cov_8.537079	283	363	6	39	80	0.4875000
NODE_32678_length_544_cov_8.537079	283	363	8	29	80	0.3625000
NODE_32678_length_544_cov_8.537079	336	416	0	28	80	0.3500000
NODE_32678_length_544_cov_8.537079	336	416	4	37	80	0.4625000
NODE_32678_length_544_cov_8.537079	336	416	6	15	80	0.1875000
NODE_32680_length_544_cov_8.440449	209	289	0	12	80	0.1500000
NODE_32680_length_544_cov_8.440449	209	289	2	68	80	0.8500000
NODE_32680_length_544_cov_8.440449	262	342	0	65	80	0.8125000
NODE_32680_length_544_cov_8.440449	262	342	2	15	80	0.1875000
NODE_32681_length_544_cov_7.604494	332	412	0	80	80	1.0000000
NODE_32681_length_544_cov_7.604494	385	465	0	80	80	1.0000000
NODE_32684_length_544_cov_6.000000	461	513	0	15	52	0.2884615
NODE_32684_length_544_cov_6.000000	461	513	2	9	52	0.1730769
NODE_32684_length_544_cov_6.000000	461	513	8	1	52	0.0192308
NODE_32684_length_544_cov_6.000000	461	513	11	5	52	0.0961538
NODE_32684_length_544_cov_6.000000	461	513	13	19	52	0.3653846
NODE_32684_length_544_cov_6.000000	461	513	15	3	52	0.0576923
NODE_32830_length_543_cov_38.790541	116	196	2	12	80	0.1500000
NODE_32830_length_543_cov_38.790541	116	196	4	14	80	0.1750000
NODE_32830_length_543_cov_38.790541	116	196	6	20	80	0.2500000
NODE_32830_length_543_cov_38.790541	116	196	16	10	80	0.1250000
NODE_32830_length_543_cov_38.790541	116	196	18	24	80	0.3000000
NODE_32830_length_543_cov_38.790541	169	249	10	13	80	0.1625000
NODE_32830_length_543_cov_38.790541	169	249	12	7	80	0.0875000
NODE_32830_length_543_cov_38.790541	169	249	14	13	80	0.1625000
NODE_32830_length_543_cov_38.790541	169	249	16	23	80	0.2875000
NODE_32830_length_543_cov_38.790541	169	249	18	24	80	0.3000000
NODE_32831_length_543_cov_31.713964	193	273	0	42	80	0.5250000
NODE_32831_length_543_cov_31.713964	193	273	2	38	80	0.4750000
NODE_32831_length_543_cov_31.713964	246	326	0	17	80	0.2125000
NODE_32831_length_543_cov_31.713964	246	326	2	63	80	0.7875000
NODE_32832_length_543_cov_13.689189	118	198	0	55	80	0.6875000
NODE_32832_length_543_cov_13.689189	118	198	4	3	80	0.0375000
NODE_32832_length_543_cov_13.689189	118	198	6	22	80	0.2750000
NODE_32832_length_543_cov_13.689189	171	251	0	2	80	0.0250000
NODE_32832_length_543_cov_13.689189	171	251	4	6	80	0.0750000
NODE_32832_length_543_cov_13.689189	171	251	6	72	80	0.9000000
NODE_32833_length_543_cov_10.601351	271	351	0	80	80	1.0000000
NODE_32833_length_543_cov_10.601351	324	404	0	80	80	1.0000000
NODE_32833_length_543_cov_10.601351	400	480	0	80	80	1.0000000
NODE_32833_length_543_cov_10.601351	453	533	0	80	80	1.0000000
NODE_32834_length_543_cov_9.202703	291	341	0	37	50	0.7400000
NODE_32834_length_543_cov_9.202703	291	341	2	13	50	0.2600000
NODE_32834_length_543_cov_9.202703	347	384	2	37	37	1.0000000
NODE_32835_length_543_cov_7.722973	300	378	0	78	78	1.0000000
NODE_32835_length_543_cov_7.722973	351	431	0	80	80	1.0000000
NODE_32836_length_543_cov_6.815315	181	260	0	79	79	1.0000000
NODE_32845_length_543_cov_4.704955	145	225	0	80	80	1.0000000
NODE_32845_length_543_cov_4.704955	198	275	0	77	77	1.0000000
NODE_32864_length_543_cov_3.301802	247	312	6	65	65	1.0000000
NODE_32875_length_543_cov_2.635135	253	316	0	9	63	0.1428571
NODE_32875_length_543_cov_2.635135	253	316	2	37	63	0.5873016
NODE_32875_length_543_cov_2.635135	253	316	8	4	63	0.0634921
NODE_32875_length_543_cov_2.635135	253	316	12	13	63	0.2063492
NODE_32875_length_543_cov_2.635135	293	373	2	6	80	0.0750000
NODE_32875_length_543_cov_2.635135	293	373	8	4	80	0.0500000
NODE_32875_length_543_cov_2.635135	293	373	12	13	80	0.1625000
NODE_32875_length_543_cov_2.635135	293	373	14	30	80	0.3750000
NODE_32875_length_543_cov_2.635135	293	373	16	24	80	0.3000000
NODE_32875_length_543_cov_2.635135	293	373	18	3	80	0.0375000
NODE_33002_length_543_cov_0.682432	98	178	0	48	80	0.6000000
NODE_33002_length_543_cov_0.682432	98	178	1	1	80	0.0125000
NODE_33002_length_543_cov_0.682432	98	178	2	31	80	0.3875000
NODE_33012_length_542_cov_57.370203	287	367	0	80	80	1.0000000
NODE_33012_length_542_cov_57.370203	340	378	0	38	38	1.0000000
NODE_33014_length_542_cov_11.616253	277	357	0	11	80	0.1375000
NODE_33014_length_542_cov_11.616253	277	357	6	69	80	0.8625000
NODE_33014_length_542_cov_11.616253	330	410	6	60	80	0.7500000
NODE_33014_length_542_cov_11.616253	330	410	8	20	80	0.2500000
NODE_33015_length_542_cov_9.988713	253	333	0	71	80	0.8875000
NODE_33015_length_542_cov_9.988713	253	333	2	9	80	0.1125000
NODE_33015_length_542_cov_9.988713	306	386	0	18	80	0.2250000
NODE_33015_length_542_cov_9.988713	306	386	2	62	80	0.7750000
NODE_33018_length_542_cov_7.934537	215	295	0	80	80	1.0000000
NODE_33018_length_542_cov_7.934537	268	348	0	80	80	1.0000000
NODE_33020_length_542_cov_7.266366	159	239	0	27	80	0.3375000
NODE_33020_length_542_cov_7.266366	159	239	2	53	80	0.6625000
NODE_33021_length_542_cov_7.069977	230	304	0	74	74	1.0000000
NODE_33021_length_542_cov_7.069977	284	362	0	78	78	1.0000000
NODE_33025_length_542_cov_4.783296	237	267	12	30	30	1.0000000
NODE_33035_length_542_cov_3.882619	275	303	0	28	28	1.0000000
NODE_33040_length_542_cov_3.600451	82	131	0	42	49	0.8571429
NODE_33040_length_542_cov_3.600451	82	131	2	1	49	0.0204082
NODE_33040_length_542_cov_3.600451	82	131	9	6	49	0.1224490
NODE_33188_length_541_cov_22.463801	247	327	0	80	80	1.0000000
NODE_33188_length_541_cov_22.463801	300	380	0	80	80	1.0000000
NODE_33190_length_541_cov_11.070136	60	140	0	80	80	1.0000000
NODE_33190_length_541_cov_11.070136	113	193	0	80	80	1.0000000
NODE_33204_length_541_cov_3.690045	179	250	0	71	71	1.0000000
NODE_33300_length_541_cov_1.187783	352	400	6	6	48	0.1250000
NODE_33300_length_541_cov_1.187783	352	400	8	42	48	0.8750000
NODE_33359_length_540_cov_78.353741	219	299	2	80	80	1.0000000
NODE_33359_length_540_cov_78.353741	272	352	0	53	80	0.6625000
NODE_33359_length_540_cov_78.353741	272	352	2	27	80	0.3375000
NODE_33360_length_540_cov_33.473923	59	139	0	80	80	1.0000000
NODE_33360_length_540_cov_33.473923	112	192	0	80	80	1.0000000
NODE_33361_length_540_cov_20.380952	97	177	0	76	80	0.9500000
NODE_33361_length_540_cov_20.380952	97	177	4	4	80	0.0500000
NODE_33361_length_540_cov_20.380952	150	230	0	23	80	0.2875000
NODE_33361_length_540_cov_20.380952	150	230	4	57	80	0.7125000
NODE_33362_length_540_cov_12.657596	248	328	0	80	80	1.0000000
NODE_33362_length_540_cov_12.657596	301	381	0	80	80	1.0000000
NODE_33363_length_540_cov_11.111111	180	260	0	80	80	1.0000000
NODE_33363_length_540_cov_11.111111	233	313	0	80	80	1.0000000
NODE_33365_length_540_cov_6.328798	260	340	0	80	80	1.0000000
NODE_33365_length_540_cov_6.328798	313	393	0	80	80	1.0000000
NODE_33382_length_540_cov_3.587302	351	411	0	60	60	1.0000000
NODE_33503_length_539_cov_1023.604545	264	344	528	1	80	0.0125000
NODE_33503_length_539_cov_1023.604545	264	344	530	1	80	0.0125000
NODE_33503_length_539_cov_1023.604545	264	344	572	1	80	0.0125000
NODE_33503_length_539_cov_1023.604545	264	344	593	1	80	0.0125000
NODE_33503_length_539_cov_1023.604545	264	344	609	1	80	0.0125000
NODE_33503_length_539_cov_1023.604545	264	344	627	1	80	0.0125000
NODE_33503_length_539_cov_1023.604545	264	344	641	1	80	0.0125000
NODE_33503_length_539_cov_1023.604545	264	344	684	1	80	0.0125000
NODE_33503_length_539_cov_1023.604545	264	344	697	1	80	0.0125000
NODE_33503_length_539_cov_1023.604545	264	344	699	1	80	0.0125000
NODE_33503_length_539_cov_1023.604545	264	344	703	1	80	0.0125000
NODE_33503_length_539_cov_1023.604545	264	344	748	1	80	0.0125000
NODE_33503_length_539_cov_1023.604545	264	344	761	1	80	0.0125000
NODE_33503_length_539_cov_1023.604545	264	344	775	1	80	0.0125000
NODE_33503_length_539_cov_1023.604545	264	344	793	1	80	0.0125000
NODE_33503_length_539_cov_1023.604545	264	344	814	1	80	0.0125000
NODE_33503_length_539_cov_1023.604545	264	344	837	1	80	0.0125000
NODE_33503_length_539_cov_1023.604545	264	344	857	1	80	0.0125000
NODE_33503_length_539_cov_1023.604545	264	344	866	1	80	0.0125000
NODE_33503_length_539_cov_1023.604545	264	344	885	1	80	0.0125000
NODE_33503_length_539_cov_1023.604545	264	344	904	1	80	0.0125000
NODE_33503_length_539_cov_1023.604545	264	344	920	1	80	0.0125000
NODE_33503_length_539_cov_1023.604545	264	344	954	1	80	0.0125000
NODE_33503_length_539_cov_1023.604545	264	344	978	1	80	0.0125000
NODE_33503_length_539_cov_1023.604545	264	344	1023	1	80	0.0125000
NODE_33503_length_539_cov_1023.604545	264	344	1063	1	80	0.0125000
NODE_33503_length_539_cov_1023.604545	264	344	1101	1	80	0.0125000
NODE_33503_length_539_cov_1023.604545	264	344	1130	1	80	0.0125000
NODE_33503_length_539_cov_1023.604545	264	344	1157	1	80	0.0125000
NODE_33503_length_539_cov_1023.604545	264	344	1223	1	80	0.0125000
NODE_33503_length_539_cov_1023.604545	264	344	1248	1	80	0.0125000
NODE_33503_length_539_cov_1023.604545	264	344	1257	1	80	0.0125000
NODE_33503_length_539_cov_1023.604545	264	344	1288	1	80	0.0125000
NODE_33503_length_539_cov_1023.604545	264	344	1308	1	80	0.0125000
NODE_33503_length_539_cov_1023.604545	264	344	1317	1	80	0.0125000
NODE_33503_length_539_cov_1023.604545	264	344	1336	1	80	0.0125000
NODE_33503_length_539_cov_1023.604545	264	344	1375	1	80	0.0125000
NODE_33503_length_539_cov_1023.604545	264	344	1435	1	80	0.0125000
NODE_33503_length_539_cov_1023.604545	264	344	1453	1	80	0.0125000
NODE_33503_length_539_cov_1023.604545	264	344	1483	1	80	0.0125000
NODE_33503_length_539_cov_1023.604545	264	344	1515	1	80	0.0125000
NODE_33503_length_539_cov_1023.604545	264	344	1530	1	80	0.0125000
NODE_33503_length_539_cov_1023.604545	264	344	1545	1	80	0.0125000
NODE_33503_length_539_cov_1023.604545	264	344	1570	1	80	0.0125000
NODE_33503_length_539_cov_1023.604545	264	344	1588	1	80	0.0125000
NODE_33503_length_539_cov_1023.604545	264	344	1591	1	80	0.0125000
NODE_33503_length_539_cov_1023.604545	264	344	1597	1	80	0.0125000
NODE_33503_length_539_cov_1023.604545	264	344	1612	1	80	0.0125000
NODE_33503_length_539_cov_1023.604545	264	344	1632	1	80	0.0125000
NODE_33503_length_539_cov_1023.604545	264	344	1642	1	80	0.0125000
NODE_33503_length_539_cov_1023.604545	264	344	1659	1	80	0.0125000
NODE_33503_length_539_cov_1023.604545	264	344	1694	1	80	0.0125000
NODE_33503_length_539_cov_1023.604545	264	344	1735	1	80	0.0125000
NODE_33503_length_539_cov_1023.604545	264	344	1743	1	80	0.0125000
NODE_33503_length_539_cov_1023.604545	264	344	1748	1	80	0.0125000
NODE_33503_length_539_cov_1023.604545	264	344	1775	1	80	0.0125000
NODE_33503_length_539_cov_1023.604545	264	344	1782	1	80	0.0125000
NODE_33503_length_539_cov_1023.604545	264	344	1796	1	80	0.0125000
NODE_33503_length_539_cov_1023.604545	264	344	1841	1	80	0.0125000
NODE_33503_length_539_cov_1023.604545	264	344	1848	1	80	0.0125000
NODE_33503_length_539_cov_1023.604545	264	344	1853	1	80	0.0125000
NODE_33503_length_539_cov_1023.604545	264	344	1881	1	80	0.0125000
NODE_33503_length_539_cov_1023.604545	264	344	1888	1	80	0.0125000
NODE_33503_length_539_cov_1023.604545	264	344	1936	1	80	0.0125000
NODE_33503_length_539_cov_1023.604545	264	344	1939	1	80	0.0125000
NODE_33503_length_539_cov_1023.604545	264	344	1949	1	80	0.0125000
NODE_33503_length_539_cov_1023.604545	264	344	1979	1	80	0.0125000
NODE_33503_length_539_cov_1023.604545	264	344	2038	1	80	0.0125000
NODE_33503_length_539_cov_1023.604545	264	344	2053	1	80	0.0125000
NODE_33503_length_539_cov_1023.604545	264	344	2068	1	80	0.0125000
NODE_33503_length_539_cov_1023.604545	264	344	2079	1	80	0.0125000
NODE_33503_length_539_cov_1023.604545	264	344	2089	1	80	0.0125000
NODE_33503_length_539_cov_1023.604545	264	344	2113	1	80	0.0125000
NODE_33503_length_539_cov_1023.604545	264	344	2114	1	80	0.0125000
NODE_33503_length_539_cov_1023.604545	264	344	2120	1	80	0.0125000
NODE_33503_length_539_cov_1023.604545	264	344	2137	2	80	0.0250000
NODE_33503_length_539_cov_1023.604545	264	344	2138	1	80	0.0125000
NODE_33503_length_539_cov_1023.604545	264	344	2145	1	80	0.0125000
NODE_33503_length_539_cov_1023.604545	264	344	2146	1	80	0.0125000
NODE_33503_length_539_cov_1023.604545	317	397	1743	1	80	0.0125000
NODE_33503_length_539_cov_1023.604545	317	397	1748	1	80	0.0125000
NODE_33503_length_539_cov_1023.604545	317	397	1775	1	80	0.0125000
NODE_33503_length_539_cov_1023.604545	317	397	1782	1	80	0.0125000
NODE_33503_length_539_cov_1023.604545	317	397	1796	1	80	0.0125000
NODE_33503_length_539_cov_1023.604545	317	397	1841	1	80	0.0125000
NODE_33503_length_539_cov_1023.604545	317	397	1848	1	80	0.0125000
NODE_33503_length_539_cov_1023.604545	317	397	1853	1	80	0.0125000
NODE_33503_length_539_cov_1023.604545	317	397	1881	1	80	0.0125000
NODE_33503_length_539_cov_1023.604545	317	397	1888	1	80	0.0125000
NODE_33503_length_539_cov_1023.604545	317	397	1936	1	80	0.0125000
NODE_33503_length_539_cov_1023.604545	317	397	1939	1	80	0.0125000
NODE_33503_length_539_cov_1023.604545	317	397	1949	1	80	0.0125000
NODE_33503_length_539_cov_1023.604545	317	397	1979	1	80	0.0125000
NODE_33503_length_539_cov_1023.604545	317	397	2029	1	80	0.0125000
NODE_33503_length_539_cov_1023.604545	317	397	2036	1	80	0.0125000
NODE_33503_length_539_cov_1023.604545	317	397	2038	1	80	0.0125000
NODE_33503_length_539_cov_1023.604545	317	397	2048	1	80	0.0125000
NODE_33503_length_539_cov_1023.604545	317	397	2052	1	80	0.0125000
NODE_33503_length_539_cov_1023.604545	317	397	2053	1	80	0.0125000
NODE_33503_length_539_cov_1023.604545	317	397	2064	1	80	0.0125000
NODE_33503_length_539_cov_1023.604545	317	397	2068	1	80	0.0125000
NODE_33503_length_539_cov_1023.604545	317	397	2077	1	80	0.0125000
NODE_33503_length_539_cov_1023.604545	317	397	2079	1	80	0.0125000
NODE_33503_length_539_cov_1023.604545	317	397	2089	1	80	0.0125000
NODE_33503_length_539_cov_1023.604545	317	397	2092	1	80	0.0125000
NODE_33503_length_539_cov_1023.604545	317	397	2096	1	80	0.0125000
NODE_33503_length_539_cov_1023.604545	317	397	2098	1	80	0.0125000
NODE_33503_length_539_cov_1023.604545	317	397	2107	1	80	0.0125000
NODE_33503_length_539_cov_1023.604545	317	397	2113	1	80	0.0125000
NODE_33503_length_539_cov_1023.604545	317	397	2114	1	80	0.0125000
NODE_33503_length_539_cov_1023.604545	317	397	2120	2	80	0.0250000
NODE_33503_length_539_cov_1023.604545	317	397	2131	1	80	0.0125000
NODE_33503_length_539_cov_1023.604545	317	397	2133	1	80	0.0125000
NODE_33503_length_539_cov_1023.604545	317	397	2134	1	80	0.0125000
NODE_33503_length_539_cov_1023.604545	317	397	2135	1	80	0.0125000
NODE_33503_length_539_cov_1023.604545	317	397	2137	4	80	0.0500000
NODE_33503_length_539_cov_1023.604545	317	397	2138	1	80	0.0125000
NODE_33503_length_539_cov_1023.604545	317	397	2140	1	80	0.0125000
NODE_33503_length_539_cov_1023.604545	317	397	2141	2	80	0.0250000
NODE_33503_length_539_cov_1023.604545	317	397	2143	1	80	0.0125000
NODE_33503_length_539_cov_1023.604545	317	397	2145	1	80	0.0125000
NODE_33503_length_539_cov_1023.604545	317	397	2146	1	80	0.0125000
NODE_33503_length_539_cov_1023.604545	317	397	2147	2	80	0.0250000
NODE_33503_length_539_cov_1023.604545	317	397	2151	1	80	0.0125000
NODE_33503_length_539_cov_1023.604545	317	397	2154	1	80	0.0125000
NODE_33503_length_539_cov_1023.604545	317	397	2157	2	80	0.0250000
NODE_33503_length_539_cov_1023.604545	317	397	2158	1	80	0.0125000
NODE_33503_length_539_cov_1023.604545	317	397	2161	2	80	0.0250000
NODE_33503_length_539_cov_1023.604545	317	397	2171	1	80	0.0125000
NODE_33503_length_539_cov_1023.604545	317	397	2172	1	80	0.0125000
NODE_33503_length_539_cov_1023.604545	317	397	2173	1	80	0.0125000
NODE_33503_length_539_cov_1023.604545	317	397	2174	1	80	0.0125000
NODE_33503_length_539_cov_1023.604545	317	397	2176	1	80	0.0125000
NODE_33503_length_539_cov_1023.604545	317	397	2186	1	80	0.0125000
NODE_33503_length_539_cov_1023.604545	317	397	2189	1	80	0.0125000
NODE_33503_length_539_cov_1023.604545	317	397	2200	2	80	0.0250000
NODE_33503_length_539_cov_1023.604545	317	397	2204	1	80	0.0125000
NODE_33503_length_539_cov_1023.604545	317	397	2212	1	80	0.0125000
NODE_33503_length_539_cov_1023.604545	317	397	2213	1	80	0.0125000
NODE_33503_length_539_cov_1023.604545	317	397	2216	1	80	0.0125000
NODE_33503_length_539_cov_1023.604545	317	397	2217	1	80	0.0125000
NODE_33503_length_539_cov_1023.604545	317	397	2224	1	80	0.0125000
NODE_33503_length_539_cov_1023.604545	317	397	2225	1	80	0.0125000
NODE_33503_length_539_cov_1023.604545	317	397	2233	1	80	0.0125000
NODE_33503_length_539_cov_1023.604545	317	397	2236	1	80	0.0125000
NODE_33503_length_539_cov_1023.604545	317	397	2239	1	80	0.0125000
NODE_33503_length_539_cov_1023.604545	317	397	2242	1	80	0.0125000
NODE_33503_length_539_cov_1023.604545	317	397	2244	1	80	0.0125000
NODE_33503_length_539_cov_1023.604545	317	397	2246	1	80	0.0125000
NODE_33503_length_539_cov_1023.604545	317	397	2254	1	80	0.0125000
NODE_33504_length_539_cov_99.579545	478	539	0	61	61	1.0000000
NODE_33505_length_539_cov_15.247727	217	297	0	80	80	1.0000000
NODE_33505_length_539_cov_15.247727	270	350	0	80	80	1.0000000
NODE_33506_length_539_cov_14.172727	278	350	0	72	72	1.0000000
NODE_33507_length_539_cov_13.154545	118	198	0	13	80	0.1625000
NODE_33507_length_539_cov_13.154545	118	198	4	55	80	0.6875000
NODE_33507_length_539_cov_13.154545	118	198	6	12	80	0.1500000
NODE_33507_length_539_cov_13.154545	171	251	0	4	80	0.0500000
NODE_33507_length_539_cov_13.154545	171	251	2	36	80	0.4500000
NODE_33507_length_539_cov_13.154545	171	251	4	15	80	0.1875000
NODE_33507_length_539_cov_13.154545	171	251	6	25	80	0.3125000
NODE_33508_length_539_cov_10.811364	48	128	0	80	80	1.0000000
NODE_33508_length_539_cov_10.811364	101	181	0	80	80	1.0000000
NODE_33509_length_539_cov_9.563636	201	277	4	8	76	0.1052632
NODE_33509_length_539_cov_9.563636	201	277	6	9	76	0.1184211
NODE_33509_length_539_cov_9.563636	201	277	8	59	76	0.7763158
NODE_33510_length_539_cov_7.934091	311	369	6	23	58	0.3965517
NODE_33510_length_539_cov_7.934091	311	369	8	35	58	0.6034483
NODE_33510_length_539_cov_7.934091	342	422	4	20	80	0.2500000
NODE_33510_length_539_cov_7.934091	342	422	6	9	80	0.1125000
NODE_33510_length_539_cov_7.934091	342	422	8	51	80	0.6375000
NODE_33517_length_539_cov_5.740909	251	319	0	68	68	1.0000000
NODE_33517_length_539_cov_5.740909	301	372	0	71	71	1.0000000
NODE_33533_length_539_cov_3.627273	80	157	0	29	77	0.3766234
NODE_33533_length_539_cov_3.627273	80	157	2	48	77	0.6233766
NODE_33533_length_539_cov_3.627273	130	175	2	45	45	1.0000000
NODE_33569_length_539_cov_2.143182	325	371	0	46	46	1.0000000
NODE_33595_length_539_cov_1.618182	408	456	10	29	48	0.6041667
NODE_33595_length_539_cov_1.618182	408	456	12	19	48	0.3958333
NODE_33623_length_539_cov_1.129545	97	134	0	37	37	1.0000000
NODE_33669_length_538_cov_23.193622	171	256	0	85	85	1.0000000
NODE_33669_length_538_cov_23.193622	225	305	0	80	80	1.0000000
NODE_33672_length_538_cov_7.378132	145	225	0	72	80	0.9000000
NODE_33672_length_538_cov_7.378132	145	225	4	8	80	0.1000000
NODE_33672_length_538_cov_7.378132	198	278	0	19	80	0.2375000
NODE_33672_length_538_cov_7.378132	198	278	4	61	80	0.7625000
NODE_33683_length_538_cov_4.496583	277	357	4	43	80	0.5375000
NODE_33683_length_538_cov_4.496583	277	357	8	37	80	0.4625000
NODE_33683_length_538_cov_4.496583	330	410	0	28	80	0.3500000
NODE_33683_length_538_cov_4.496583	330	410	4	5	80	0.0625000
NODE_33683_length_538_cov_4.496583	330	410	6	11	80	0.1375000
NODE_33683_length_538_cov_4.496583	330	410	8	36	80	0.4500000
NODE_33687_length_538_cov_3.753986	251	309	2	58	58	1.0000000
NODE_33713_length_538_cov_2.239180	256	338	0	14	82	0.1707317
NODE_33713_length_538_cov_2.239180	256	338	1	1	82	0.0121951
NODE_33713_length_538_cov_2.239180	256	338	2	39	82	0.4756097
NODE_33713_length_538_cov_2.239180	256	338	4	2	82	0.0243902
NODE_33713_length_538_cov_2.239180	256	338	6	26	82	0.3170732
NODE_33814_length_538_cov_0.822323	397	477	1	3	80	0.0375000
NODE_33814_length_538_cov_0.822323	397	477	2	77	80	0.9625000
NODE_33852_length_537_cov_13.031963	258	309	2	44	51	0.8627451
NODE_33852_length_537_cov_13.031963	258	309	4	7	51	0.1372549
NODE_33854_length_537_cov_9.552511	198	278	0	11	80	0.1375000
NODE_33854_length_537_cov_9.552511	198	278	2	55	80	0.6875000
NODE_33854_length_537_cov_9.552511	198	278	4	14	80	0.1750000
NODE_33854_length_537_cov_9.552511	251	332	2	13	81	0.1604938
NODE_33854_length_537_cov_9.552511	251	332	4	68	81	0.8395061
NODE_33960_length_537_cov_1.244292	107	187	2	2	80	0.0250000
NODE_33960_length_537_cov_1.244292	107	187	5	2	80	0.0250000
NODE_33960_length_537_cov_1.244292	107	187	6	7	80	0.0875000
NODE_33960_length_537_cov_1.244292	107	187	7	1	80	0.0125000
NODE_33960_length_537_cov_1.244292	107	187	12	3	80	0.0375000
NODE_33960_length_537_cov_1.244292	107	187	14	6	80	0.0750000
NODE_33960_length_537_cov_1.244292	107	187	16	3	80	0.0375000
NODE_33960_length_537_cov_1.244292	107	187	18	3	80	0.0375000
NODE_33960_length_537_cov_1.244292	107	187	21	1	80	0.0125000
NODE_33960_length_537_cov_1.244292	107	187	23	1	80	0.0125000
NODE_33960_length_537_cov_1.244292	107	187	25	1	80	0.0125000
NODE_33960_length_537_cov_1.244292	107	187	27	2	80	0.0250000
NODE_33960_length_537_cov_1.244292	107	187	29	1	80	0.0125000
NODE_33960_length_537_cov_1.244292	107	187	31	2	80	0.0250000
NODE_33960_length_537_cov_1.244292	107	187	33	1	80	0.0125000
NODE_33960_length_537_cov_1.244292	107	187	37	2	80	0.0250000
NODE_33960_length_537_cov_1.244292	107	187	40	1	80	0.0125000
NODE_33960_length_537_cov_1.244292	107	187	42	1	80	0.0125000
NODE_33960_length_537_cov_1.244292	107	187	44	2	80	0.0250000
NODE_33960_length_537_cov_1.244292	107	187	46	3	80	0.0375000
NODE_33960_length_537_cov_1.244292	107	187	50	4	80	0.0500000
NODE_33960_length_537_cov_1.244292	107	187	52	3	80	0.0375000
NODE_33960_length_537_cov_1.244292	107	187	54	3	80	0.0375000
NODE_33960_length_537_cov_1.244292	107	187	56	1	80	0.0125000
NODE_33960_length_537_cov_1.244292	107	187	60	1	80	0.0125000
NODE_33960_length_537_cov_1.244292	107	187	63	1	80	0.0125000
NODE_33960_length_537_cov_1.244292	107	187	65	1	80	0.0125000
NODE_33960_length_537_cov_1.244292	107	187	66	2	80	0.0250000
NODE_33960_length_537_cov_1.244292	107	187	68	10	80	0.1250000
NODE_33960_length_537_cov_1.244292	107	187	71	1	80	0.0125000
NODE_33960_length_537_cov_1.244292	107	187	73	5	80	0.0625000
NODE_33960_length_537_cov_1.244292	107	187	75	3	80	0.0375000
NODE_34029_length_536_cov_87.622426	430	462	84	1	32	0.0312500
NODE_34029_length_536_cov_87.622426	430	462	86	1	32	0.0312500
NODE_34029_length_536_cov_87.622426	430	462	90	3	32	0.0937500
NODE_34029_length_536_cov_87.622426	430	462	92	7	32	0.2187500
NODE_34029_length_536_cov_87.622426	430	462	93	2	32	0.0625000
NODE_34029_length_536_cov_87.622426	430	462	97	1	32	0.0312500
NODE_34029_length_536_cov_87.622426	430	462	101	3	32	0.0937500
NODE_34029_length_536_cov_87.622426	430	462	103	3	32	0.0937500
NODE_34029_length_536_cov_87.622426	430	462	105	6	32	0.1875000
NODE_34029_length_536_cov_87.622426	430	462	107	2	32	0.0625000
NODE_34029_length_536_cov_87.622426	430	462	109	3	32	0.0937500
NODE_34030_length_536_cov_11.629291	119	199	0	80	80	1.0000000
NODE_34030_length_536_cov_11.629291	172	252	0	80	80	1.0000000
NODE_34032_length_536_cov_6.613272	286	372	0	29	86	0.3372093
NODE_34032_length_536_cov_6.613272	286	372	2	8	86	0.0930233
NODE_34032_length_536_cov_6.613272	286	372	4	49	86	0.5697674
NODE_34035_length_536_cov_5.810069	191	271	0	32	80	0.4000000
NODE_34035_length_536_cov_5.810069	191	271	2	48	80	0.6000000
NODE_34035_length_536_cov_5.810069	244	324	0	80	80	1.0000000
NODE_34035_length_536_cov_5.810069	374	404	0	30	30	1.0000000
NODE_34039_length_536_cov_4.729977	202	245	0	17	43	0.3953488
NODE_34039_length_536_cov_4.729977	202	245	2	26	43	0.6046512
NODE_34057_length_536_cov_3.297483	86	126	0	40	40	1.0000000
NODE_34068_length_536_cov_2.796339	223	280	0	57	57	1.0000000
NODE_34094_length_536_cov_1.956522	181	230	14	3	49	0.0612245
NODE_34094_length_536_cov_1.956522	181	230	16	5	49	0.1020408
NODE_34094_length_536_cov_1.956522	181	230	20	30	49	0.6122449
NODE_34094_length_536_cov_1.956522	181	230	22	3	49	0.0612245
NODE_34094_length_536_cov_1.956522	181	230	24	8	49	0.1632653
NODE_34095_length_536_cov_1.951945	203	284	4	8	81	0.0987654
NODE_34095_length_536_cov_1.951945	203	284	6	10	81	0.1234568
NODE_34095_length_536_cov_1.951945	203	284	8	24	81	0.2962963
NODE_34095_length_536_cov_1.951945	203	284	10	18	81	0.2222222
NODE_34095_length_536_cov_1.951945	203	284	12	21	81	0.2592593
NODE_34095_length_536_cov_1.951945	306	368	0	36	62	0.5806451
NODE_34095_length_536_cov_1.951945	306	368	2	26	62	0.4193548
NODE_34209_length_535_cov_32.277523	158	238	0	80	80	1.0000000
NODE_34209_length_535_cov_32.277523	211	291	0	80	80	1.0000000
NODE_34215_length_535_cov_5.910550	110	162	0	44	52	0.8461539
NODE_34215_length_535_cov_5.910550	110	162	2	8	52	0.1538462
NODE_34229_length_535_cov_3.795872	217	297	6	10	80	0.1250000
NODE_34229_length_535_cov_3.795872	217	297	11	3	80	0.0375000
NODE_34229_length_535_cov_3.795872	217	297	13	28	80	0.3500000
NODE_34229_length_535_cov_3.795872	217	297	14	7	80	0.0875000
NODE_34229_length_535_cov_3.795872	217	297	15	32	80	0.4000000
NODE_34375_length_534_cov_54.331034	435	498	0	55	63	0.8730159
NODE_34375_length_534_cov_54.331034	435	498	2	3	63	0.0476190
NODE_34375_length_534_cov_54.331034	435	498	6	1	63	0.0158730
NODE_34375_length_534_cov_54.331034	435	498	65	3	63	0.0476190
NODE_34375_length_534_cov_54.331034	435	498	69	1	63	0.0158730
NODE_34375_length_534_cov_54.331034	471	534	0	63	63	1.0000000
NODE_34377_length_534_cov_15.462069	460	534	0	6	74	0.0810811
NODE_34377_length_534_cov_15.462069	460	534	6	68	74	0.9189189
NODE_34377_length_534_cov_15.462069	512	534	0	5	22	0.2272727
NODE_34377_length_534_cov_15.462069	512	534	6	17	22	0.7727273
NODE_34378_length_534_cov_10.308046	268	348	0	80	80	1.0000000
NODE_34378_length_534_cov_10.308046	321	401	0	80	80	1.0000000
NODE_34380_length_534_cov_9.041379	204	284	0	80	80	1.0000000
NODE_34380_length_534_cov_9.041379	257	332	0	75	75	1.0000000
NODE_34383_length_534_cov_6.958621	273	303	0	30	30	1.0000000
NODE_34392_length_534_cov_5.022989	291	371	0	12	80	0.1500000
NODE_34392_length_534_cov_5.022989	291	371	1	1	80	0.0125000
NODE_34392_length_534_cov_5.022989	291	371	3	1	80	0.0125000
NODE_34392_length_534_cov_5.022989	291	371	5	3	80	0.0375000
NODE_34392_length_534_cov_5.022989	291	371	6	8	80	0.1000000
NODE_34392_length_534_cov_5.022989	291	371	10	9	80	0.1125000
NODE_34392_length_534_cov_5.022989	291	371	18	20	80	0.2500000
NODE_34392_length_534_cov_5.022989	291	371	20	18	80	0.2250000
NODE_34392_length_534_cov_5.022989	291	371	21	1	80	0.0125000
NODE_34392_length_534_cov_5.022989	291	371	22	7	80	0.0875000
NODE_34402_length_534_cov_3.873563	110	190	2	62	80	0.7750000
NODE_34402_length_534_cov_3.873563	110	190	4	18	80	0.2250000
NODE_34409_length_534_cov_3.202299	221	301	0	13	80	0.1625000
NODE_34409_length_534_cov_3.202299	221	301	2	41	80	0.5125000
NODE_34409_length_534_cov_3.202299	221	301	6	26	80	0.3250000
NODE_34411_length_534_cov_3.158621	171	200	2	21	29	0.7241379
NODE_34411_length_534_cov_3.158621	171	200	4	8	29	0.2758621
NODE_34418_length_534_cov_3.002299	175	219	0	44	44	1.0000000
NODE_34489_length_534_cov_1.344828	475	518	0	43	43	1.0000000
NODE_34494_length_534_cov_1.291954	273	336	6	47	63	0.7460318
NODE_34494_length_534_cov_1.291954	273	336	8	16	63	0.2539683
NODE_34511_length_534_cov_1.160920	227	264	2	37	37	1.0000000
NODE_34570_length_533_cov_13.956221	216	296	0	78	80	0.9750000
NODE_34570_length_533_cov_13.956221	216	296	1	2	80	0.0250000
NODE_34570_length_533_cov_13.956221	269	349	0	25	80	0.3125000
NODE_34570_length_533_cov_13.956221	269	349	1	3	80	0.0375000
NODE_34570_length_533_cov_13.956221	269	349	2	52	80	0.6500000
NODE_34575_length_533_cov_8.207373	244	322	0	13	78	0.1666667
NODE_34575_length_533_cov_8.207373	244	322	2	65	78	0.8333333
NODE_34576_length_533_cov_8.023041	230	310	0	47	80	0.5875000
NODE_34576_length_533_cov_8.023041	230	310	2	33	80	0.4125000
NODE_34576_length_533_cov_8.023041	283	364	0	81	81	1.0000000
NODE_34585_length_533_cov_5.170507	308	369	0	21	61	0.3442623
NODE_34585_length_533_cov_5.170507	308	369	1	1	61	0.0163934
NODE_34585_length_533_cov_5.170507	308	369	2	3	61	0.0491803
NODE_34585_length_533_cov_5.170507	308	369	3	2	61	0.0327869
NODE_34585_length_533_cov_5.170507	308	369	4	34	61	0.5573770
NODE_34588_length_533_cov_4.988479	229	309	0	80	80	1.0000000
NODE_34588_length_533_cov_4.988479	282	362	0	80	80	1.0000000
NODE_34600_length_533_cov_3.638249	201	265	0	64	64	1.0000000
NODE_34603_length_533_cov_3.511521	138	218	2	30	80	0.3750000
NODE_34603_length_533_cov_3.511521	138	218	4	50	80	0.6250000
NODE_34615_length_533_cov_3.073733	294	340	0	46	46	1.0000000
NODE_34617_length_533_cov_3.052995	256	304	4	7	48	0.1458333
NODE_34617_length_533_cov_3.052995	256	304	6	41	48	0.8541667
NODE_34631_length_533_cov_2.366359	229	311	0	49	82	0.5975610
NODE_34631_length_533_cov_2.366359	229	311	2	26	82	0.3170732
NODE_34631_length_533_cov_2.366359	229	311	4	7	82	0.0853659
NODE_34635_length_533_cov_2.288018	468	490	0	22	22	1.0000000
NODE_34767_length_532_cov_73.279446	0	64	12	3	64	0.0468750
NODE_34767_length_532_cov_73.279446	0	64	18	1	64	0.0156250
NODE_34767_length_532_cov_73.279446	0	64	20	6	64	0.0937500
NODE_34767_length_532_cov_73.279446	0	64	26	1	64	0.0156250
NODE_34767_length_532_cov_73.279446	0	64	36	6	64	0.0937500
NODE_34767_length_532_cov_73.279446	0	64	38	2	64	0.0312500
NODE_34767_length_532_cov_73.279446	0	64	40	1	64	0.0156250
NODE_34767_length_532_cov_73.279446	0	64	42	6	64	0.0937500
NODE_34767_length_532_cov_73.279446	0	64	44	2	64	0.0312500
NODE_34767_length_532_cov_73.279446	0	64	48	1	64	0.0156250
NODE_34767_length_532_cov_73.279446	0	64	52	35	64	0.5468750
NODE_34768_length_532_cov_23.055427	168	248	0	36	80	0.4500000
NODE_34768_length_532_cov_23.055427	168	248	1	1	80	0.0125000
NODE_34768_length_532_cov_23.055427	168	248	2	43	80	0.5375000
NODE_34768_length_532_cov_23.055427	221	301	0	28	80	0.3500000
NODE_34768_length_532_cov_23.055427	221	301	2	52	80	0.6500000
NODE_34769_length_532_cov_22.778291	256	336	14	7	80	0.0875000
NODE_34769_length_532_cov_22.778291	256	336	16	6	80	0.0750000
NODE_34769_length_532_cov_22.778291	256	336	24	30	80	0.3750000
NODE_34769_length_532_cov_22.778291	256	336	26	37	80	0.4625000
NODE_34769_length_532_cov_22.778291	309	389	0	12	80	0.1500000
NODE_34769_length_532_cov_22.778291	309	389	10	12	80	0.1500000
NODE_34769_length_532_cov_22.778291	309	389	12	5	80	0.0625000
NODE_34769_length_532_cov_22.778291	309	389	16	30	80	0.3750000
NODE_34769_length_532_cov_22.778291	309	389	24	18	80	0.2250000
NODE_34769_length_532_cov_22.778291	309	389	26	3	80	0.0375000
NODE_34770_length_532_cov_13.279446	85	165	0	80	80	1.0000000
NODE_34770_length_532_cov_13.279446	138	218	0	80	80	1.0000000
NODE_34774_length_532_cov_7.591224	171	235	0	64	64	1.0000000
NODE_34774_length_532_cov_7.591224	172	235	0	63	63	1.0000000
NODE_34774_length_532_cov_7.591224	173	226	0	53	53	1.0000000
NODE_34774_length_532_cov_7.591224	173	228	0	55	55	1.0000000
NODE_34774_length_532_cov_7.591224	208	282	0	60	74	0.8108108
NODE_34774_length_532_cov_7.591224	208	282	2	14	74	0.1891892
NODE_34774_length_532_cov_7.591224	208	282	0	60	74	0.8108108
NODE_34774_length_532_cov_7.591224	208	282	2	14	74	0.1891892
NODE_34774_length_532_cov_7.591224	208	282	0	60	74	0.8108108
NODE_34774_length_532_cov_7.591224	208	282	2	14	74	0.1891892
NODE_34774_length_532_cov_7.591224	208	282	0	60	74	0.8108108
NODE_34774_length_532_cov_7.591224	208	282	2	14	74	0.1891892
NODE_34788_length_532_cov_4.524249	84	151	0	67	67	1.0000000
NODE_34788_length_532_cov_4.524249	137	218	0	81	81	1.0000000
NODE_34838_length_532_cov_1.866051	263	309	0	46	46	1.0000000
NODE_34845_length_532_cov_1.757506	126	146	0	20	20	1.0000000
NODE_34948_length_531_cov_35.539352	7	45	0	38	38	1.0000000
NODE_34948_length_531_cov_35.539352	18	98	0	80	80	1.0000000
NODE_34949_length_531_cov_13.162037	129	209	0	29	80	0.3625000
NODE_34949_length_531_cov_13.162037	129	209	8	26	80	0.3250000
NODE_34949_length_531_cov_13.162037	129	209	18	25	80	0.3125000
NODE_34949_length_531_cov_13.162037	182	251	8	2	69	0.0289855
NODE_34949_length_531_cov_13.162037	182	251	18	67	69	0.9710145
NODE_34953_length_531_cov_6.821759	242	322	0	80	80	1.0000000
NODE_34953_length_531_cov_6.821759	295	375	0	80	80	1.0000000
NODE_34958_length_531_cov_5.261574	261	336	8	3	75	0.0400000
NODE_34958_length_531_cov_5.261574	261	336	10	9	75	0.1200000
NODE_34958_length_531_cov_5.261574	261	336	12	14	75	0.1866667
NODE_34958_length_531_cov_5.261574	261	336	14	16	75	0.2133333
NODE_34958_length_531_cov_5.261574	261	336	16	33	75	0.4400000
NODE_34958_length_531_cov_5.261574	309	362	8	13	53	0.2452830
NODE_34958_length_531_cov_5.261574	309	362	10	6	53	0.1132075
NODE_34958_length_531_cov_5.261574	309	362	12	8	53	0.1509434
NODE_34958_length_531_cov_5.261574	309	362	14	10	53	0.1886792
NODE_34958_length_531_cov_5.261574	309	362	16	16	53	0.3018868
NODE_34963_length_531_cov_4.527778	177	255	0	78	78	1.0000000
NODE_34965_length_531_cov_4.319444	283	363	0	66	80	0.8250000
NODE_34965_length_531_cov_4.319444	283	363	2	14	80	0.1750000
NODE_34965_length_531_cov_4.319444	336	416	0	80	80	1.0000000
NODE_34979_length_531_cov_3.488426	238	318	0	80	80	1.0000000
NODE_34979_length_531_cov_3.488426	291	371	0	80	80	1.0000000
NODE_34980_length_531_cov_3.375000	153	207	0	11	54	0.2037037
NODE_34980_length_531_cov_3.375000	153	207	2	2	54	0.0370370
NODE_34980_length_531_cov_3.375000	153	207	4	2	54	0.0370370
NODE_34980_length_531_cov_3.375000	153	207	6	3	54	0.0555556
NODE_34980_length_531_cov_3.375000	153	207	10	19	54	0.3518519
NODE_34980_length_531_cov_3.375000	153	207	11	2	54	0.0370370
NODE_34980_length_531_cov_3.375000	153	207	13	4	54	0.0740741
NODE_34980_length_531_cov_3.375000	153	207	15	1	54	0.0185185
NODE_34980_length_531_cov_3.375000	153	207	18	6	54	0.1111111
NODE_34980_length_531_cov_3.375000	153	207	19	4	54	0.0740741
NODE_34980_length_531_cov_3.375000	180	260	10	10	80	0.1250000
NODE_34980_length_531_cov_3.375000	180	260	11	2	80	0.0250000
NODE_34980_length_531_cov_3.375000	180	260	13	4	80	0.0500000
NODE_34980_length_531_cov_3.375000	180	260	15	1	80	0.0125000
NODE_34980_length_531_cov_3.375000	180	260	17	2	80	0.0250000
NODE_34980_length_531_cov_3.375000	180	260	18	6	80	0.0750000
NODE_34980_length_531_cov_3.375000	180	260	19	19	80	0.2375000
NODE_34980_length_531_cov_3.375000	180	260	21	1	80	0.0125000
NODE_34980_length_531_cov_3.375000	180	260	23	12	80	0.1500000
NODE_34980_length_531_cov_3.375000	180	260	24	21	80	0.2625000
NODE_34980_length_531_cov_3.375000	180	260	25	2	80	0.0250000
NODE_34986_length_531_cov_3.111111	243	323	0	80	80	1.0000000
NODE_34986_length_531_cov_3.111111	296	376	0	80	80	1.0000000
NODE_35008_length_531_cov_2.201389	302	373	0	1	71	0.0140845
NODE_35008_length_531_cov_2.201389	302	373	4	2	71	0.0281690
NODE_35008_length_531_cov_2.201389	302	373	6	28	71	0.3943662
NODE_35008_length_531_cov_2.201389	302	373	8	40	71	0.5633803
NODE_35008_length_531_cov_2.201389	350	426	2	4	76	0.0526316
NODE_35008_length_531_cov_2.201389	350	426	4	8	76	0.1052632
NODE_35008_length_531_cov_2.201389	350	426	8	64	76	0.8421053
NODE_35141_length_530_cov_30.605568	250	330	0	80	80	1.0000000
NODE_35141_length_530_cov_30.605568	303	383	0	80	80	1.0000000
NODE_35142_length_530_cov_16.937355	404	484	3	5	80	0.0625000
NODE_35142_length_530_cov_16.937355	404	484	10	1	80	0.0125000
NODE_35142_length_530_cov_16.937355	404	484	11	1	80	0.0125000
NODE_35142_length_530_cov_16.937355	404	484	27	2	80	0.0250000
NODE_35142_length_530_cov_16.937355	404	484	28	3	80	0.0375000
NODE_35142_length_530_cov_16.937355	404	484	30	68	80	0.8500000
NODE_35142_length_530_cov_16.937355	457	530	0	3	73	0.0410959
NODE_35142_length_530_cov_16.937355	457	530	4	13	73	0.1780822
NODE_35142_length_530_cov_16.937355	457	530	10	2	73	0.0273973
NODE_35142_length_530_cov_16.937355	457	530	20	6	73	0.0821918
NODE_35142_length_530_cov_16.937355	457	530	22	2	73	0.0273973
NODE_35142_length_530_cov_16.937355	457	530	30	47	73	0.6438356
NODE_35143_length_530_cov_9.902552	273	353	0	15	80	0.1875000
NODE_35143_length_530_cov_9.902552	273	353	4	65	80	0.8125000
NODE_35143_length_530_cov_9.902552	326	406	0	34	80	0.4250000
NODE_35143_length_530_cov_9.902552	326	406	4	46	80	0.5750000
NODE_35144_length_530_cov_7.928074	46	126	0	11	80	0.1375000
NODE_35144_length_530_cov_7.928074	46	126	2	69	80	0.8625000
NODE_35144_length_530_cov_7.928074	99	179	0	2	80	0.0250000
NODE_35144_length_530_cov_7.928074	99	179	2	78	80	0.9750000
NODE_35150_length_530_cov_4.647332	188	268	0	42	80	0.5250000
NODE_35150_length_530_cov_4.647332	188	268	2	38	80	0.4750000
NODE_35150_length_530_cov_4.647332	241	321	2	80	80	1.0000000
NODE_35154_length_530_cov_4.389791	162	242	0	30	80	0.3750000
NODE_35154_length_530_cov_4.389791	162	242	2	50	80	0.6250000
NODE_35159_length_530_cov_4.046404	76	111	0	35	35	1.0000000
NODE_35319_length_529_cov_38.983721	140	220	4	2	80	0.0250000
NODE_35319_length_529_cov_38.983721	140	220	6	50	80	0.6250000
NODE_35319_length_529_cov_38.983721	140	220	8	28	80	0.3500000
NODE_35320_length_529_cov_18.223256	189	269	0	80	80	1.0000000
NODE_35320_length_529_cov_18.223256	242	322	0	80	80	1.0000000
NODE_35321_length_529_cov_17.009302	358	438	0	80	80	1.0000000
NODE_35321_length_529_cov_17.009302	411	491	0	80	80	1.0000000
NODE_35331_length_529_cov_6.195349	211	291	0	59	80	0.7375000
NODE_35331_length_529_cov_6.195349	211	291	1	3	80	0.0375000
NODE_35331_length_529_cov_6.195349	211	291	2	18	80	0.2250000
NODE_35331_length_529_cov_6.195349	264	322	0	58	58	1.0000000
NODE_35336_length_529_cov_5.176744	139	207	0	35	68	0.5147059
NODE_35336_length_529_cov_5.176744	139	207	2	11	68	0.1617647
NODE_35336_length_529_cov_5.176744	139	207	4	18	68	0.2647059
NODE_35336_length_529_cov_5.176744	139	207	6	4	68	0.0588235
NODE_35336_length_529_cov_5.176744	185	260	4	18	75	0.2400000
NODE_35336_length_529_cov_5.176744	185	260	6	57	75	0.7600000
NODE_35364_length_529_cov_2.883721	223	281	0	2	58	0.0344828
NODE_35364_length_529_cov_2.883721	223	281	2	56	58	0.9655172
NODE_35374_length_529_cov_2.660465	89	168	0	79	79	1.0000000
NODE_35375_length_529_cov_2.595349	278	321	0	43	43	1.0000000
NODE_35384_length_529_cov_2.272093	247	313	0	66	66	1.0000000
NODE_35427_length_529_cov_1.597674	289	332	0	43	43	1.0000000
NODE_35521_length_528_cov_25.808858	233	313	0	80	80	1.0000000
NODE_35521_length_528_cov_25.808858	286	366	0	80	80	1.0000000
NODE_35522_length_528_cov_17.331002	219	299	0	36	80	0.4500000
NODE_35522_length_528_cov_17.331002	219	299	2	44	80	0.5500000
NODE_35522_length_528_cov_17.331002	272	352	0	26	80	0.3250000
NODE_35522_length_528_cov_17.331002	272	352	2	54	80	0.6750000
NODE_35523_length_528_cov_16.165501	262	342	0	80	80	1.0000000
NODE_35523_length_528_cov_16.165501	315	395	0	80	80	1.0000000
NODE_35529_length_528_cov_5.776224	204	284	0	80	80	1.0000000
NODE_35529_length_528_cov_5.776224	257	337	0	80	80	1.0000000
NODE_35542_length_528_cov_4.016317	235	315	0	80	80	1.0000000
NODE_35542_length_528_cov_4.016317	288	368	0	80	80	1.0000000
NODE_35545_length_528_cov_3.799534	144	192	0	48	48	1.0000000
NODE_35561_length_528_cov_2.902098	252	305	2	17	53	0.3207547
NODE_35561_length_528_cov_2.902098	252	305	4	36	53	0.6792453
NODE_35575_length_528_cov_2.324009	137	188	0	31	51	0.6078432
NODE_35575_length_528_cov_2.324009	137	188	2	20	51	0.3921569
NODE_35575_length_528_cov_2.324009	161	241	0	17	80	0.2125000
NODE_35575_length_528_cov_2.324009	161	241	2	63	80	0.7875000
NODE_35597_length_528_cov_1.755245	268	348	2	32	80	0.4000000
NODE_35597_length_528_cov_1.755245	268	348	4	48	80	0.6000000
NODE_35597_length_528_cov_1.755245	321	401	2	44	80	0.5500000
NODE_35597_length_528_cov_1.755245	321	401	4	36	80	0.4500000
NODE_35687_length_527_cov_19.247664	306	386	0	80	80	1.0000000
NODE_35687_length_527_cov_19.247664	359	439	0	80	80	1.0000000
NODE_35688_length_527_cov_15.974299	250	349	0	9	99	0.0909091
NODE_35688_length_527_cov_15.974299	250	349	2	90	99	0.9090909
NODE_35688_length_527_cov_15.974299	322	402	2	80	80	1.0000000
NODE_35691_length_527_cov_8.221963	235	315	4	69	80	0.8625000
NODE_35691_length_527_cov_8.221963	235	315	6	1	80	0.0125000
NODE_35691_length_527_cov_8.221963	235	315	12	4	80	0.0500000
NODE_35691_length_527_cov_8.221963	235	315	14	6	80	0.0750000
NODE_35691_length_527_cov_8.221963	288	368	4	16	80	0.2000000
NODE_35691_length_527_cov_8.221963	288	368	6	1	80	0.0125000
NODE_35691_length_527_cov_8.221963	288	368	12	4	80	0.0500000
NODE_35691_length_527_cov_8.221963	288	368	14	7	80	0.0875000
NODE_35691_length_527_cov_8.221963	288	368	16	1	80	0.0125000
NODE_35691_length_527_cov_8.221963	288	368	18	1	80	0.0125000
NODE_35691_length_527_cov_8.221963	288	368	20	50	80	0.6250000
NODE_35693_length_527_cov_7.200935	190	270	0	80	80	1.0000000
NODE_35693_length_527_cov_7.200935	243	346	0	103	103	1.0000000
NODE_35693_length_527_cov_7.200935	342	422	0	80	80	1.0000000
NODE_35693_length_527_cov_7.200935	395	475	0	80	80	1.0000000
NODE_35696_length_527_cov_6.862150	279	359	0	80	80	1.0000000
NODE_35697_length_527_cov_6.046729	155	235	0	80	80	1.0000000
NODE_35697_length_527_cov_6.046729	208	288	0	80	80	1.0000000
NODE_35736_length_527_cov_2.238318	226	306	0	80	80	1.0000000
NODE_35858_length_526_cov_50.866511	169	242	0	24	73	0.3287671
NODE_35858_length_526_cov_50.866511	169	242	2	1	73	0.0136986
NODE_35858_length_526_cov_50.866511	169	242	4	36	73	0.4931507
NODE_35858_length_526_cov_50.866511	169	242	6	12	73	0.1643836
NODE_35858_length_526_cov_50.866511	215	295	4	50	80	0.6250000
NODE_35858_length_526_cov_50.866511	215	295	6	30	80	0.3750000
NODE_35858_length_526_cov_50.866511	291	371	0	60	80	0.7500000
NODE_35858_length_526_cov_50.866511	291	371	2	2	80	0.0250000
NODE_35858_length_526_cov_50.866511	291	371	4	18	80	0.2250000
NODE_35858_length_526_cov_50.866511	344	424	0	80	80	1.0000000
NODE_35860_length_526_cov_26.395785	315	395	0	31	80	0.3875000
NODE_35860_length_526_cov_26.395785	315	395	2	49	80	0.6125000
NODE_35860_length_526_cov_26.395785	368	448	0	2	80	0.0250000
NODE_35860_length_526_cov_26.395785	368	448	2	78	80	0.9750000
NODE_35861_length_526_cov_16.611241	305	385	0	80	80	1.0000000
NODE_35861_length_526_cov_16.611241	358	438	0	80	80	1.0000000
NODE_35866_length_526_cov_6.215457	303	351	10	2	48	0.0416667
NODE_35866_length_526_cov_6.215457	303	351	11	1	48	0.0208333
NODE_35866_length_526_cov_6.215457	303	351	18	2	48	0.0416667
NODE_35866_length_526_cov_6.215457	303	351	23	1	48	0.0208333
NODE_35866_length_526_cov_6.215457	303	351	26	1	48	0.0208333
NODE_35866_length_526_cov_6.215457	303	351	28	5	48	0.1041667
NODE_35866_length_526_cov_6.215457	303	351	30	5	48	0.1041667
NODE_35866_length_526_cov_6.215457	303	351	31	1	48	0.0208333
NODE_35866_length_526_cov_6.215457	303	351	32	3	48	0.0625000
NODE_35866_length_526_cov_6.215457	303	351	33	6	48	0.1250000
NODE_35866_length_526_cov_6.215457	303	351	35	1	48	0.0208333
NODE_35866_length_526_cov_6.215457	303	351	36	1	48	0.0208333
NODE_35866_length_526_cov_6.215457	303	351	39	2	48	0.0416667
NODE_35866_length_526_cov_6.215457	303	351	43	1	48	0.0208333
NODE_35866_length_526_cov_6.215457	303	351	46	1	48	0.0208333
NODE_35866_length_526_cov_6.215457	303	351	47	1	48	0.0208333
NODE_35866_length_526_cov_6.215457	303	351	49	3	48	0.0625000
NODE_35866_length_526_cov_6.215457	303	351	53	3	48	0.0625000
NODE_35866_length_526_cov_6.215457	303	351	54	2	48	0.0416667
NODE_35866_length_526_cov_6.215457	303	351	58	2	48	0.0416667
NODE_35866_length_526_cov_6.215457	303	351	60	2	48	0.0416667
NODE_35866_length_526_cov_6.215457	303	351	63	1	48	0.0208333
NODE_35866_length_526_cov_6.215457	303	351	64	1	48	0.0208333
NODE_35877_length_526_cov_3.936768	118	142	0	4	24	0.1666667
NODE_35877_length_526_cov_3.936768	118	142	4	20	24	0.8333333
NODE_35877_length_526_cov_3.936768	118	163	0	4	45	0.0888889
NODE_35877_length_526_cov_3.936768	118	163	4	29	45	0.6444445
NODE_35877_length_526_cov_3.936768	118	163	8	12	45	0.2666667
NODE_35901_length_526_cov_2.466042	138	184	0	38	46	0.8260869
NODE_35901_length_526_cov_2.466042	138	184	2	8	46	0.1739130
NODE_36055_length_525_cov_33.910798	98	178	6	26	80	0.3250000
NODE_36055_length_525_cov_33.910798	98	178	8	1	80	0.0125000
NODE_36055_length_525_cov_33.910798	98	178	9	1	80	0.0125000
NODE_36055_length_525_cov_33.910798	98	178	10	3	80	0.0375000
NODE_36055_length_525_cov_33.910798	98	178	14	4	80	0.0500000
NODE_36055_length_525_cov_33.910798	98	178	16	1	80	0.0125000
NODE_36055_length_525_cov_33.910798	98	178	17	2	80	0.0250000
NODE_36055_length_525_cov_33.910798	98	178	18	2	80	0.0250000
NODE_36055_length_525_cov_33.910798	98	178	20	1	80	0.0125000
NODE_36055_length_525_cov_33.910798	98	178	21	1	80	0.0125000
NODE_36055_length_525_cov_33.910798	98	178	22	6	80	0.0750000
NODE_36055_length_525_cov_33.910798	98	178	24	19	80	0.2375000
NODE_36055_length_525_cov_33.910798	98	178	26	13	80	0.1625000
NODE_36055_length_525_cov_33.910798	151	231	0	16	80	0.2000000
NODE_36055_length_525_cov_33.910798	151	231	6	63	80	0.7875000
NODE_36055_length_525_cov_33.910798	151	231	8	1	80	0.0125000
NODE_36055_length_525_cov_33.910798	159	231	0	16	72	0.2222222
NODE_36055_length_525_cov_33.910798	159	231	6	56	72	0.7777778
NODE_36058_length_525_cov_8.788732	175	255	0	80	80	1.0000000
NODE_36058_length_525_cov_8.788732	228	308	0	80	80	1.0000000
NODE_36059_length_525_cov_7.880282	242	285	0	43	43	1.0000000
NODE_36098_length_525_cov_2.417840	229	306	2	77	77	1.0000000
NODE_36230_length_524_cov_21.649412	262	342	0	80	80	1.0000000
NODE_36230_length_524_cov_21.649412	315	395	0	80	80	1.0000000
NODE_36231_length_524_cov_14.131765	136	201	0	65	65	1.0000000
NODE_36232_length_524_cov_10.392941	237	317	0	31	80	0.3875000
NODE_36232_length_524_cov_10.392941	237	317	4	26	80	0.3250000
NODE_36232_length_524_cov_10.392941	237	317	8	23	80	0.2875000
NODE_36232_length_524_cov_10.392941	290	370	0	2	80	0.0250000
NODE_36232_length_524_cov_10.392941	290	370	4	14	80	0.1750000
NODE_36232_length_524_cov_10.392941	290	370	8	64	80	0.8000000
NODE_36262_length_524_cov_3.221176	195	272	0	77	77	1.0000000
NODE_36262_length_524_cov_3.221176	253	324	0	71	71	1.0000000
NODE_36264_length_524_cov_3.148235	317	397	0	80	80	1.0000000
NODE_36410_length_523_cov_113.438679	0	48	0	8	48	0.1666667
NODE_36410_length_523_cov_113.438679	0	48	2	3	48	0.0625000
NODE_36410_length_523_cov_113.438679	0	48	4	34	48	0.7083333
NODE_36410_length_523_cov_113.438679	0	48	6	3	48	0.0625000
NODE_36410_length_523_cov_113.438679	14	69	4	31	55	0.5636364
NODE_36410_length_523_cov_113.438679	14	69	6	7	55	0.1272727
NODE_36410_length_523_cov_113.438679	14	69	7	1	55	0.0181818
NODE_36410_length_523_cov_113.438679	14	69	8	16	55	0.2909091
NODE_36410_length_523_cov_113.438679	25	101	4	20	76	0.2631579
NODE_36410_length_523_cov_113.438679	25	101	6	7	76	0.0921053
NODE_36410_length_523_cov_113.438679	25	101	7	1	76	0.0131579
NODE_36410_length_523_cov_113.438679	25	101	8	48	76	0.6315789
NODE_36410_length_523_cov_113.438679	105	181	4	4	76	0.0526316
NODE_36410_length_523_cov_113.438679	105	181	6	5	76	0.0657895
NODE_36410_length_523_cov_113.438679	105	181	8	16	76	0.2105263
NODE_36410_length_523_cov_113.438679	105	181	10	1	76	0.0131579
NODE_36410_length_523_cov_113.438679	105	181	12	4	76	0.0526316
NODE_36410_length_523_cov_113.438679	105	181	14	2	76	0.0263158
NODE_36410_length_523_cov_113.438679	105	181	16	3	76	0.0394737
NODE_36410_length_523_cov_113.438679	105	181	18	4	76	0.0526316
NODE_36410_length_523_cov_113.438679	105	181	20	2	76	0.0263158
NODE_36410_length_523_cov_113.438679	105	181	22	3	76	0.0394737
NODE_36410_length_523_cov_113.438679	105	181	24	5	76	0.0657895
NODE_36410_length_523_cov_113.438679	105	181	26	1	76	0.0131579
NODE_36410_length_523_cov_113.438679	105	181	28	1	76	0.0131579
NODE_36410_length_523_cov_113.438679	105	181	30	7	76	0.0921053
NODE_36410_length_523_cov_113.438679	105	181	32	5	76	0.0657895
NODE_36410_length_523_cov_113.438679	105	181	34	2	76	0.0263158
NODE_36410_length_523_cov_113.438679	105	181	35	10	76	0.1315790
NODE_36410_length_523_cov_113.438679	105	181	37	1	76	0.0131579
NODE_36410_length_523_cov_113.438679	154	234	26	1	80	0.0125000
NODE_36410_length_523_cov_113.438679	154	234	28	1	80	0.0125000
NODE_36410_length_523_cov_113.438679	154	234	30	7	80	0.0875000
NODE_36410_length_523_cov_113.438679	154	234	31	3	80	0.0375000
NODE_36410_length_523_cov_113.438679	154	234	32	5	80	0.0625000
NODE_36410_length_523_cov_113.438679	154	234	34	2	80	0.0250000
NODE_36410_length_523_cov_113.438679	154	234	35	13	80	0.1625000
NODE_36410_length_523_cov_113.438679	154	234	37	9	80	0.1125000
NODE_36410_length_523_cov_113.438679	154	234	39	7	80	0.0875000
NODE_36410_length_523_cov_113.438679	154	234	41	12	80	0.1500000
NODE_36410_length_523_cov_113.438679	154	234	43	12	80	0.1500000
NODE_36410_length_523_cov_113.438679	154	234	44	1	80	0.0125000
NODE_36410_length_523_cov_113.438679	154	234	45	7	80	0.0875000
NODE_36410_length_523_cov_113.438679	312	355	24	9	43	0.2093023
NODE_36410_length_523_cov_113.438679	312	355	26	10	43	0.2325581
NODE_36410_length_523_cov_113.438679	312	355	27	7	43	0.1627907
NODE_36410_length_523_cov_113.438679	312	355	28	6	43	0.1395349
NODE_36410_length_523_cov_113.438679	312	355	29	3	43	0.0697674
NODE_36410_length_523_cov_113.438679	312	355	30	8	43	0.1860465
NODE_36412_length_523_cov_64.695755	35	115	0	80	80	1.0000000
NODE_36412_length_523_cov_64.695755	88	168	0	80	80	1.0000000
NODE_36414_length_523_cov_20.724057	235	315	2	80	80	1.0000000
NODE_36414_length_523_cov_20.724057	288	368	0	50	80	0.6250000
NODE_36414_length_523_cov_20.724057	288	368	2	30	80	0.3750000
NODE_36415_length_523_cov_18.500000	164	244	0	6	80	0.0750000
NODE_36415_length_523_cov_18.500000	164	244	2	74	80	0.9250000
NODE_36415_length_523_cov_18.500000	217	297	0	32	80	0.4000000
NODE_36415_length_523_cov_18.500000	217	297	2	48	80	0.6000000
NODE_36416_length_523_cov_15.216981	62	142	0	80	80	1.0000000
NODE_36416_length_523_cov_15.216981	115	195	0	80	80	1.0000000
NODE_36417_length_523_cov_10.575472	157	183	2	17	26	0.6538461
NODE_36417_length_523_cov_10.575472	157	183	4	9	26	0.3461539
NODE_36418_length_523_cov_9.962264	212	292	0	33	80	0.4125000
NODE_36418_length_523_cov_9.962264	212	292	2	47	80	0.5875000
NODE_36418_length_523_cov_9.962264	265	345	0	14	80	0.1750000
NODE_36418_length_523_cov_9.962264	265	345	2	66	80	0.8250000
NODE_36427_length_523_cov_4.943396	108	188	8	17	80	0.2125000
NODE_36427_length_523_cov_4.943396	108	188	12	6	80	0.0750000
NODE_36427_length_523_cov_4.943396	108	188	14	30	80	0.3750000
NODE_36427_length_523_cov_4.943396	108	188	16	1	80	0.0125000
NODE_36427_length_523_cov_4.943396	108	188	20	16	80	0.2000000
NODE_36427_length_523_cov_4.943396	108	188	22	5	80	0.0625000
NODE_36427_length_523_cov_4.943396	108	188	24	5	80	0.0625000
NODE_36427_length_523_cov_4.943396	161	241	16	1	80	0.0125000
NODE_36427_length_523_cov_4.943396	161	241	20	16	80	0.2000000
NODE_36427_length_523_cov_4.943396	161	241	22	10	80	0.1250000
NODE_36427_length_523_cov_4.943396	161	241	24	6	80	0.0750000
NODE_36427_length_523_cov_4.943396	161	241	25	1	80	0.0125000
NODE_36427_length_523_cov_4.943396	161	241	26	9	80	0.1125000
NODE_36427_length_523_cov_4.943396	161	241	28	15	80	0.1875000
NODE_36427_length_523_cov_4.943396	161	241	30	18	80	0.2250000
NODE_36427_length_523_cov_4.943396	161	241	32	4	80	0.0500000
NODE_36429_length_523_cov_4.787736	110	141	12	5	31	0.1612903
NODE_36429_length_523_cov_4.787736	110	141	14	26	31	0.8387097
NODE_36429_length_523_cov_4.787736	131	194	6	7	63	0.1111111
NODE_36429_length_523_cov_4.787736	131	194	8	12	63	0.1904762
NODE_36429_length_523_cov_4.787736	131	194	10	2	63	0.0317460
NODE_36429_length_523_cov_4.787736	131	194	12	11	63	0.1746032
NODE_36429_length_523_cov_4.787736	131	194	14	16	63	0.2539683
NODE_36429_length_523_cov_4.787736	131	194	16	15	63	0.2380952
NODE_36439_length_523_cov_3.792453	139	219	0	48	80	0.6000000
NODE_36439_length_523_cov_3.792453	139	219	2	32	80	0.4000000
NODE_36439_length_523_cov_3.792453	192	272	0	13	80	0.1625000
NODE_36439_length_523_cov_3.792453	192	272	2	67	80	0.8375000
NODE_36481_length_523_cov_2.259434	337	372	0	35	35	1.0000000
NODE_36490_length_523_cov_2.096698	307	351	2	10	44	0.2272727
NODE_36490_length_523_cov_2.096698	307	351	4	3	44	0.0681818
NODE_36490_length_523_cov_2.096698	307	351	8	7	44	0.1590909
NODE_36490_length_523_cov_2.096698	307	351	12	2	44	0.0454545
NODE_36490_length_523_cov_2.096698	307	351	13	1	44	0.0227273
NODE_36490_length_523_cov_2.096698	307	351	14	5	44	0.1136364
NODE_36490_length_523_cov_2.096698	307	351	16	6	44	0.1363636
NODE_36490_length_523_cov_2.096698	307	351	17	5	44	0.1136364
NODE_36490_length_523_cov_2.096698	307	351	21	5	44	0.1136364
NODE_36518_length_523_cov_1.700472	176	195	0	19	19	1.0000000
NODE_36632_length_522_cov_33.579196	55	135	0	80	80	1.0000000
NODE_36632_length_522_cov_33.579196	108	188	0	80	80	1.0000000
NODE_36634_length_522_cov_12.851064	266	342	0	76	76	1.0000000
NODE_36634_length_522_cov_12.851064	319	395	0	76	76	1.0000000
NODE_36637_length_522_cov_7.349882	212	283	0	12	71	0.1690141
NODE_36637_length_522_cov_7.349882	212	283	2	59	71	0.8309859
NODE_36637_length_522_cov_7.349882	400	469	0	69	69	1.0000000
NODE_36670_length_522_cov_2.933806	178	258	0	80	80	1.0000000
NODE_36670_length_522_cov_2.933806	231	311	0	80	80	1.0000000
NODE_36676_length_522_cov_2.661939	187	241	0	54	54	1.0000000
NODE_36820_length_521_cov_9.303318	106	186	0	80	80	1.0000000
NODE_36820_length_521_cov_9.303318	159	239	0	80	80	1.0000000
NODE_36832_length_521_cov_4.971564	218	298	0	80	80	1.0000000
NODE_36832_length_521_cov_4.971564	271	351	0	80	80	1.0000000
NODE_36845_length_521_cov_3.504739	113	191	0	43	78	0.5512820
NODE_36845_length_521_cov_3.504739	113	191	2	35	78	0.4487180
NODE_36845_length_521_cov_3.504739	164	205	0	41	41	1.0000000
NODE_36848_length_521_cov_3.324645	158	244	0	27	86	0.3139535
NODE_36848_length_521_cov_3.324645	158	244	2	11	86	0.1279070
NODE_36848_length_521_cov_3.324645	158	244	4	4	86	0.0465116
NODE_36848_length_521_cov_3.324645	158	244	6	5	86	0.0581395
NODE_36848_length_521_cov_3.324645	158	244	8	36	86	0.4186046
NODE_36848_length_521_cov_3.324645	158	244	10	3	86	0.0348837
NODE_36848_length_521_cov_3.324645	217	280	8	24	63	0.3809524
NODE_36848_length_521_cov_3.324645	217	280	10	34	63	0.5396826
NODE_36848_length_521_cov_3.324645	217	280	12	5	63	0.0793651
NODE_36916_length_521_cov_1.613744	165	227	6	62	62	1.0000000
NODE_37036_length_520_cov_50.676960	0	75	0	75	75	1.0000000
NODE_37036_length_520_cov_50.676960	48	128	0	80	80	1.0000000
NODE_37036_length_520_cov_50.676960	124	204	0	47	80	0.5875000
NODE_37036_length_520_cov_50.676960	124	204	4	33	80	0.4125000
NODE_37036_length_520_cov_50.676960	177	257	0	17	80	0.2125000
NODE_37036_length_520_cov_50.676960	177	257	4	63	80	0.7875000
NODE_37037_length_520_cov_43.294537	10	90	0	16	80	0.2000000
NODE_37037_length_520_cov_43.294537	10	90	12	64	80	0.8000000
NODE_37037_length_520_cov_43.294537	10	90	0	16	80	0.2000000
NODE_37037_length_520_cov_43.294537	10	90	12	64	80	0.8000000
NODE_37037_length_520_cov_43.294537	10	90	0	16	80	0.2000000
NODE_37037_length_520_cov_43.294537	10	90	12	64	80	0.8000000
NODE_37037_length_520_cov_43.294537	10	90	0	16	80	0.2000000
NODE_37037_length_520_cov_43.294537	10	90	12	64	80	0.8000000
NODE_37037_length_520_cov_43.294537	10	90	0	16	80	0.2000000
NODE_37037_length_520_cov_43.294537	10	90	12	64	80	0.8000000
NODE_37037_length_520_cov_43.294537	10	90	0	16	80	0.2000000
NODE_37037_length_520_cov_43.294537	10	90	12	64	80	0.8000000
NODE_37037_length_520_cov_43.294537	63	129	12	66	66	1.0000000
NODE_37037_length_520_cov_43.294537	63	142	12	79	79	1.0000000
NODE_37037_length_520_cov_43.294537	63	143	12	80	80	1.0000000
NODE_37037_length_520_cov_43.294537	63	133	12	70	70	1.0000000
NODE_37037_length_520_cov_43.294537	66	133	12	67	67	1.0000000
NODE_37037_length_520_cov_43.294537	68	143	12	75	75	1.0000000
NODE_37038_length_520_cov_29.427553	224	304	0	80	80	1.0000000
NODE_37038_length_520_cov_29.427553	277	357	0	80	80	1.0000000
NODE_37038_length_520_cov_29.427553	353	433	0	80	80	1.0000000
NODE_37038_length_520_cov_29.427553	406	486	0	80	80	1.0000000
NODE_37039_length_520_cov_14.365796	103	183	0	9	80	0.1125000
NODE_37039_length_520_cov_14.365796	103	183	1	4	80	0.0500000
NODE_37039_length_520_cov_14.365796	103	183	2	67	80	0.8375000
NODE_37039_length_520_cov_14.365796	156	237	0	63	81	0.7777778
NODE_37039_length_520_cov_14.365796	156	237	1	4	81	0.0493827
NODE_37039_length_520_cov_14.365796	156	237	2	14	81	0.1728395
NODE_37059_length_520_cov_4.121140	79	159	0	80	80	1.0000000
NODE_37059_length_520_cov_4.121140	132	212	0	80	80	1.0000000
NODE_37063_length_520_cov_3.900238	203	233	0	30	30	1.0000000
NODE_37235_length_519_cov_42.842857	8	88	0	11	80	0.1375000
NODE_37235_length_519_cov_42.842857	8	88	4	8	80	0.1000000
NODE_37235_length_519_cov_42.842857	8	88	12	3	80	0.0375000
NODE_37235_length_519_cov_42.842857	8	88	19	6	80	0.0750000
NODE_37235_length_519_cov_42.842857	8	88	21	2	80	0.0250000
NODE_37235_length_519_cov_42.842857	8	88	23	11	80	0.1375000
NODE_37235_length_519_cov_42.842857	8	88	27	1	80	0.0125000
NODE_37235_length_519_cov_42.842857	8	88	28	5	80	0.0625000
NODE_37235_length_519_cov_42.842857	8	88	30	1	80	0.0125000
NODE_37235_length_519_cov_42.842857	8	88	34	3	80	0.0375000
NODE_37235_length_519_cov_42.842857	8	88	35	1	80	0.0125000
NODE_37235_length_519_cov_42.842857	8	88	37	28	80	0.3500000
NODE_37235_length_519_cov_42.842857	61	139	24	10	78	0.1282051
NODE_37235_length_519_cov_42.842857	61	139	32	1	78	0.0128205
NODE_37235_length_519_cov_42.842857	61	139	37	43	78	0.5512820
NODE_37235_length_519_cov_42.842857	61	139	39	24	78	0.3076923
NODE_37236_length_519_cov_19.269048	284	363	0	79	79	1.0000000
NODE_37236_length_519_cov_19.269048	336	416	0	80	80	1.0000000
NODE_37237_length_519_cov_8.500000	195	267	1	28	72	0.3888889
NODE_37237_length_519_cov_8.500000	195	267	2	42	72	0.5833333
NODE_37237_length_519_cov_8.500000	195	267	3	2	72	0.0277778
NODE_37245_length_519_cov_5.169048	282	346	0	64	64	1.0000000
NODE_37290_length_519_cov_2.783333	174	235	0	61	61	1.0000000
NODE_37349_length_519_cov_1.538095	147	213	0	66	66	1.0000000
NODE_37447_length_518_cov_40.026253	385	465	28	2	80	0.0250000
NODE_37447_length_518_cov_40.026253	385	465	29	21	80	0.2625000
NODE_37447_length_518_cov_40.026253	385	465	32	3	80	0.0375000
NODE_37447_length_518_cov_40.026253	385	465	33	54	80	0.6750000
NODE_37447_length_518_cov_40.026253	438	518	0	13	80	0.1625000
NODE_37447_length_518_cov_40.026253	438	518	27	1	80	0.0125000
NODE_37447_length_518_cov_40.026253	438	518	28	37	80	0.4625000
NODE_37447_length_518_cov_40.026253	438	518	29	25	80	0.3125000
NODE_37447_length_518_cov_40.026253	438	518	32	3	80	0.0375000
NODE_37447_length_518_cov_40.026253	438	518	33	1	80	0.0125000
NODE_37449_length_518_cov_12.083532	144	224	2	25	80	0.3125000
NODE_37449_length_518_cov_12.083532	144	224	6	18	80	0.2250000
NODE_37449_length_518_cov_12.083532	144	224	8	37	80	0.4625000
NODE_37449_length_518_cov_12.083532	197	277	6	71	80	0.8875000
NODE_37449_length_518_cov_12.083532	197	277	8	9	80	0.1125000
NODE_37449_length_518_cov_12.083532	407	481	0	74	74	1.0000000
NODE_37449_length_518_cov_12.083532	454	518	0	64	64	1.0000000
NODE_37450_length_518_cov_11.467780	171	200	0	16	29	0.5517241
NODE_37450_length_518_cov_11.467780	171	200	2	13	29	0.4482759
NODE_37450_length_518_cov_11.467780	253	320	2	67	67	1.0000000
NODE_37450_length_518_cov_11.467780	253	282	2	29	29	1.0000000
NODE_37454_length_518_cov_7.441527	188	273	0	35	85	0.4117647
NODE_37454_length_518_cov_7.441527	188	273	1	50	85	0.5882353
NODE_37461_length_518_cov_5.563246	315	366	0	51	51	1.0000000
NODE_37461_length_518_cov_5.563246	339	383	0	44	44	1.0000000
NODE_37465_length_518_cov_4.732697	214	276	4	4	62	0.0645161
NODE_37465_length_518_cov_4.732697	214	276	6	58	62	0.9354839
NODE_37465_length_518_cov_4.732697	350	430	0	61	80	0.7625000
NODE_37465_length_518_cov_4.732697	350	430	2	19	80	0.2375000
NODE_37479_length_518_cov_3.503580	291	333	4	2	42	0.0476190
NODE_37479_length_518_cov_3.503580	291	333	6	1	42	0.0238095
NODE_37479_length_518_cov_3.503580	291	333	7	27	42	0.6428571
NODE_37479_length_518_cov_3.503580	291	333	8	12	42	0.2857143
NODE_37479_length_518_cov_3.503580	306	363	7	15	57	0.2631579
NODE_37479_length_518_cov_3.503580	306	363	8	13	57	0.2280702
NODE_37479_length_518_cov_3.503580	306	363	10	29	57	0.5087720
NODE_37483_length_518_cov_3.136038	269	338	0	7	69	0.1014493
NODE_37483_length_518_cov_3.136038	269	338	2	7	69	0.1014493
NODE_37483_length_518_cov_3.136038	269	338	8	23	69	0.3333333
NODE_37483_length_518_cov_3.136038	269	338	13	1	69	0.0144928
NODE_37483_length_518_cov_3.136038	269	338	14	31	69	0.4492754
NODE_37483_length_518_cov_3.136038	269	348	0	7	79	0.0886076
NODE_37483_length_518_cov_3.136038	269	348	2	7	79	0.0886076
NODE_37483_length_518_cov_3.136038	269	348	8	23	79	0.2911392
NODE_37483_length_518_cov_3.136038	269	348	13	1	79	0.0126582
NODE_37483_length_518_cov_3.136038	269	348	14	41	79	0.5189874
NODE_37483_length_518_cov_3.136038	269	349	0	7	80	0.0875000
NODE_37483_length_518_cov_3.136038	269	349	2	7	80	0.0875000
NODE_37483_length_518_cov_3.136038	269	349	8	23	80	0.2875000
NODE_37483_length_518_cov_3.136038	269	349	13	1	80	0.0125000
NODE_37483_length_518_cov_3.136038	269	349	14	42	80	0.5250000
NODE_37483_length_518_cov_3.136038	322	402	6	29	80	0.3625000
NODE_37483_length_518_cov_3.136038	322	402	9	2	80	0.0250000
NODE_37483_length_518_cov_3.136038	322	402	11	1	80	0.0125000
NODE_37483_length_518_cov_3.136038	322	402	14	48	80	0.6000000
NODE_37483_length_518_cov_3.136038	322	364	14	42	42	1.0000000
NODE_37483_length_518_cov_3.136038	322	368	14	46	46	1.0000000
NODE_37483_length_518_cov_3.136038	331	366	14	35	35	1.0000000
NODE_37637_length_517_cov_55.267943	177	257	0	10	80	0.1250000
NODE_37637_length_517_cov_55.267943	177	257	2	70	80	0.8750000
NODE_37637_length_517_cov_55.267943	230	310	0	59	80	0.7375000
NODE_37637_length_517_cov_55.267943	230	310	2	21	80	0.2625000
NODE_37639_length_517_cov_30.863636	0	72	0	38	72	0.5277778
NODE_37639_length_517_cov_30.863636	0	72	9	1	72	0.0138889
NODE_37639_length_517_cov_30.863636	0	72	10	1	72	0.0138889
NODE_37639_length_517_cov_30.863636	0	72	13	12	72	0.1666667
NODE_37639_length_517_cov_30.863636	0	72	20	1	72	0.0138889
NODE_37639_length_517_cov_30.863636	0	72	21	4	72	0.0555556
NODE_37639_length_517_cov_30.863636	0	72	22	3	72	0.0416667
NODE_37639_length_517_cov_30.863636	0	72	24	12	72	0.1666667
NODE_37639_length_517_cov_30.863636	0	72	0	38	72	0.5277778
NODE_37639_length_517_cov_30.863636	0	72	9	1	72	0.0138889
NODE_37639_length_517_cov_30.863636	0	72	10	1	72	0.0138889
NODE_37639_length_517_cov_30.863636	0	72	13	12	72	0.1666667
NODE_37639_length_517_cov_30.863636	0	72	20	1	72	0.0138889
NODE_37639_length_517_cov_30.863636	0	72	21	4	72	0.0555556
NODE_37639_length_517_cov_30.863636	0	72	22	3	72	0.0416667
NODE_37639_length_517_cov_30.863636	0	72	24	12	72	0.1666667
NODE_37639_length_517_cov_30.863636	45	125	13	7	80	0.0875000
NODE_37639_length_517_cov_30.863636	45	125	20	1	80	0.0125000
NODE_37639_length_517_cov_30.863636	45	125	21	4	80	0.0500000
NODE_37639_length_517_cov_30.863636	45	125	22	21	80	0.2625000
NODE_37639_length_517_cov_30.863636	45	125	24	47	80	0.5875000
NODE_37639_length_517_cov_30.863636	45	99	13	7	54	0.1296296
NODE_37639_length_517_cov_30.863636	45	99	20	1	54	0.0185185
NODE_37639_length_517_cov_30.863636	45	99	21	4	54	0.0740741
NODE_37639_length_517_cov_30.863636	45	99	22	3	54	0.0555556
NODE_37639_length_517_cov_30.863636	45	99	24	39	54	0.7222222
NODE_37641_length_517_cov_12.258373	305	385	0	80	80	1.0000000
NODE_37641_length_517_cov_12.258373	358	438	0	80	80	1.0000000
NODE_37643_length_517_cov_7.131579	100	152	0	52	52	1.0000000
NODE_37662_length_517_cov_4.492823	140	220	0	80	80	1.0000000
NODE_37662_length_517_cov_4.492823	193	273	0	40	80	0.5000000
NODE_37662_length_517_cov_4.492823	193	273	2	40	80	0.5000000
NODE_37697_length_517_cov_2.437799	331	388	4	14	57	0.2456140
NODE_37697_length_517_cov_2.437799	331	388	6	16	57	0.2807018
NODE_37697_length_517_cov_2.437799	331	388	8	27	57	0.4736842
NODE_37850_length_516_cov_17.570743	147	227	0	49	80	0.6125000
NODE_37850_length_516_cov_17.570743	147	227	4	31	80	0.3875000
NODE_37850_length_516_cov_17.570743	200	280	4	80	80	1.0000000
NODE_37861_length_516_cov_5.268585	402	448	6	46	46	1.0000000
NODE_37862_length_516_cov_5.067146	114	194	0	80	80	1.0000000
NODE_37862_length_516_cov_5.067146	167	247	0	80	80	1.0000000
NODE_37864_length_516_cov_4.788969	156	236	0	80	80	1.0000000
NODE_37864_length_516_cov_4.788969	209	277	0	68	68	1.0000000
NODE_37881_length_516_cov_3.167866	48	93	0	45	45	1.0000000
NODE_37881_length_516_cov_3.167866	103	177	2	74	74	1.0000000
NODE_38044_length_515_cov_69.442308	177	257	6	80	80	1.0000000
NODE_38044_length_515_cov_69.442308	177	257	6	80	80	1.0000000
NODE_38044_length_515_cov_69.442308	177	257	6	80	80	1.0000000
NODE_38044_length_515_cov_69.442308	230	291	0	20	61	0.3278688
NODE_38044_length_515_cov_69.442308	230	291	6	41	61	0.6721311
NODE_38044_length_515_cov_69.442308	230	308	0	37	78	0.4743590
NODE_38044_length_515_cov_69.442308	230	308	6	41	78	0.5256410
NODE_38044_length_515_cov_69.442308	235	308	0	37	73	0.5068493
NODE_38044_length_515_cov_69.442308	235	308	6	36	73	0.4931507
NODE_38045_length_515_cov_13.271635	168	248	0	80	80	1.0000000
NODE_38045_length_515_cov_13.271635	221	301	0	80	80	1.0000000
NODE_38048_length_515_cov_8.314904	213	290	0	75	77	0.9740260
NODE_38048_length_515_cov_8.314904	213	290	2	2	77	0.0259740
NODE_38054_length_515_cov_5.487981	317	402	0	6	85	0.0705882
NODE_38054_length_515_cov_5.487981	317	402	2	25	85	0.2941177
NODE_38054_length_515_cov_5.487981	317	402	8	1	85	0.0117647
NODE_38054_length_515_cov_5.487981	317	402	9	10	85	0.1176471
NODE_38054_length_515_cov_5.487981	317	402	15	1	85	0.0117647
NODE_38054_length_515_cov_5.487981	317	402	16	42	85	0.4941176
NODE_38242_length_514_cov_26.910843	170	250	0	80	80	1.0000000
NODE_38242_length_514_cov_26.910843	223	303	0	80	80	1.0000000
NODE_38243_length_514_cov_12.775904	85	149	2	64	64	1.0000000
NODE_38243_length_514_cov_12.775904	123	202	0	44	79	0.5569620
NODE_38243_length_514_cov_12.775904	123	202	2	35	79	0.4430380
NODE_38244_length_514_cov_11.156627	124	204	0	80	80	1.0000000
NODE_38244_length_514_cov_11.156627	177	257	0	80	80	1.0000000
NODE_38253_length_514_cov_5.802410	165	217	0	41	52	0.7884616
NODE_38253_length_514_cov_5.802410	165	217	2	11	52	0.2115385
NODE_38253_length_514_cov_5.802410	190	270	0	16	80	0.2000000
NODE_38253_length_514_cov_5.802410	190	270	2	64	80	0.8000000
NODE_38254_length_514_cov_5.554217	192	272	0	71	80	0.8875000
NODE_38254_length_514_cov_5.554217	192	272	2	9	80	0.1125000
NODE_38254_length_514_cov_5.554217	294	340	2	46	46	1.0000000
NODE_38257_length_514_cov_5.322892	230	260	6	30	30	1.0000000
NODE_38262_length_514_cov_4.337349	220	300	0	11	80	0.1375000
NODE_38262_length_514_cov_4.337349	220	300	2	69	80	0.8625000
NODE_38286_length_514_cov_3.012048	264	328	2	46	64	0.7187500
NODE_38286_length_514_cov_3.012048	264	328	3	2	64	0.0312500
NODE_38286_length_514_cov_3.012048	264	328	4	5	64	0.0781250
NODE_38286_length_514_cov_3.012048	264	328	5	9	64	0.1406250
NODE_38286_length_514_cov_3.012048	264	328	6	2	64	0.0312500
NODE_38432_length_513_cov_14.613527	118	198	0	80	80	1.0000000
NODE_38432_length_513_cov_14.613527	171	251	0	80	80	1.0000000
NODE_38433_length_513_cov_9.898551	253	333	0	80	80	1.0000000
NODE_38433_length_513_cov_9.898551	306	386	0	80	80	1.0000000
NODE_38434_length_513_cov_9.164251	185	265	0	80	80	1.0000000
NODE_38434_length_513_cov_9.164251	238	318	0	80	80	1.0000000
NODE_38441_length_513_cov_6.123188	284	364	0	80	80	1.0000000
NODE_38441_length_513_cov_6.123188	337	417	0	80	80	1.0000000
NODE_38460_length_513_cov_3.456522	283	350	4	2	67	0.0298507
NODE_38460_length_513_cov_3.456522	283	350	6	5	67	0.0746269
NODE_38460_length_513_cov_3.456522	283	350	8	60	67	0.8955224
NODE_38460_length_513_cov_3.456522	336	398	4	1	62	0.0161290
NODE_38460_length_513_cov_3.456522	336	398	6	11	62	0.1774193
NODE_38460_length_513_cov_3.456522	336	398	8	50	62	0.8064516
NODE_38482_length_513_cov_2.309179	134	174	0	12	40	0.3000000
NODE_38482_length_513_cov_2.309179	134	174	2	13	40	0.3250000
NODE_38482_length_513_cov_2.309179	134	174	6	4	40	0.1000000
NODE_38482_length_513_cov_2.309179	134	174	7	1	40	0.0250000
NODE_38482_length_513_cov_2.309179	134	174	9	1	40	0.0250000
NODE_38482_length_513_cov_2.309179	134	174	10	9	40	0.2250000
NODE_38482_length_513_cov_2.309179	170	223	0	53	53	1.0000000
NODE_38482_length_513_cov_2.309179	238	285	0	47	47	1.0000000
NODE_38515_length_513_cov_1.671498	427	476	0	49	49	1.0000000
NODE_38646_length_512_cov_45.070218	34	114	0	80	80	1.0000000
NODE_38646_length_512_cov_45.070218	87	167	0	80	80	1.0000000
NODE_38647_length_512_cov_39.639225	323	404	0	81	81	1.0000000
NODE_38647_length_512_cov_39.639225	377	457	0	80	80	1.0000000
NODE_38648_length_512_cov_8.581114	192	256	16	4	64	0.0625000
NODE_38648_length_512_cov_8.581114	192	256	18	2	64	0.0312500
NODE_38648_length_512_cov_8.581114	192	256	19	14	64	0.2187500
NODE_38648_length_512_cov_8.581114	192	256	20	3	64	0.0468750
NODE_38648_length_512_cov_8.581114	192	256	22	35	64	0.5468750
NODE_38648_length_512_cov_8.581114	192	256	24	6	64	0.0937500
NODE_38661_length_512_cov_4.869249	327	407	0	80	80	1.0000000
NODE_38661_length_512_cov_4.869249	380	460	0	80	80	1.0000000
NODE_38668_length_512_cov_4.157385	161	204	0	43	43	1.0000000
NODE_38668_length_512_cov_4.157385	178	257	0	79	79	1.0000000
NODE_38677_length_512_cov_3.435835	138	218	0	80	80	1.0000000
NODE_38677_length_512_cov_3.435835	191	271	0	80	80	1.0000000
NODE_38693_length_512_cov_2.888620	320	400	0	60	80	0.7500000
NODE_38693_length_512_cov_2.888620	320	400	1	20	80	0.2500000
NODE_38768_length_512_cov_1.341404	198	269	0	1	71	0.0140845
NODE_38768_length_512_cov_1.341404	198	269	2	1	71	0.0140845
NODE_38768_length_512_cov_1.341404	198	269	6	4	71	0.0563380
NODE_38768_length_512_cov_1.341404	198	269	7	1	71	0.0140845
NODE_38768_length_512_cov_1.341404	198	269	9	3	71	0.0422535
NODE_38768_length_512_cov_1.341404	198	269	11	5	71	0.0704225
NODE_38768_length_512_cov_1.341404	198	269	12	9	71	0.1267606
NODE_38768_length_512_cov_1.341404	198	269	13	11	71	0.1549296
NODE_38768_length_512_cov_1.341404	198	269	14	7	71	0.0985916
NODE_38768_length_512_cov_1.341404	198	269	16	14	71	0.1971831
NODE_38768_length_512_cov_1.341404	198	269	17	11	71	0.1549296
NODE_38768_length_512_cov_1.341404	198	269	18	4	71	0.0563380
NODE_38866_length_511_cov_9.796117	251	331	0	80	80	1.0000000
NODE_38866_length_511_cov_9.796117	304	370	0	66	66	1.0000000
NODE_38869_length_511_cov_8.873786	239	319	6	29	80	0.3625000
NODE_38869_length_511_cov_8.873786	239	319	8	51	80	0.6375000
NODE_38869_length_511_cov_8.873786	292	356	0	1	64	0.0156250
NODE_38869_length_511_cov_8.873786	292	356	2	1	64	0.0156250
NODE_38869_length_511_cov_8.873786	292	356	4	14	64	0.2187500
NODE_38869_length_511_cov_8.873786	292	356	6	48	64	0.7500000
NODE_38870_length_511_cov_8.434466	232	312	0	80	80	1.0000000
NODE_38870_length_511_cov_8.434466	285	366	0	81	81	1.0000000
NODE_38872_length_511_cov_7.519417	157	237	0	29	80	0.3625000
NODE_38872_length_511_cov_7.519417	157	237	2	51	80	0.6375000
NODE_38872_length_511_cov_7.519417	210	290	0	63	80	0.7875000
NODE_38872_length_511_cov_7.519417	210	290	2	17	80	0.2125000
NODE_38877_length_511_cov_5.762136	102	179	2	3	77	0.0389610
NODE_38877_length_511_cov_5.762136	102	179	8	36	77	0.4675325
NODE_38877_length_511_cov_5.762136	102	179	10	35	77	0.4545455
NODE_38877_length_511_cov_5.762136	102	179	12	3	77	0.0389610
NODE_38877_length_511_cov_5.762136	155	230	4	2	75	0.0266667
NODE_38877_length_511_cov_5.762136	155	230	10	41	75	0.5466667
NODE_38877_length_511_cov_5.762136	155	230	12	32	75	0.4266667
NODE_38878_length_511_cov_5.655340	133	213	0	80	80	1.0000000
NODE_38878_length_511_cov_5.655340	186	266	0	80	80	1.0000000
NODE_38911_length_511_cov_2.978155	219	255	0	36	36	1.0000000
NODE_39013_length_511_cov_1.225728	99	127	0	28	28	1.0000000
NODE_39092_length_511_cov_0.708738	98	146	0	48	48	1.0000000
NODE_39105_length_510_cov_18.206813	334	414	0	80	80	1.0000000
NODE_39105_length_510_cov_18.206813	387	467	0	80	80	1.0000000
NODE_39110_length_510_cov_8.017032	211	291	0	80	80	1.0000000
NODE_39110_length_510_cov_8.017032	264	344	0	80	80	1.0000000
NODE_39110_length_510_cov_8.017032	391	413	0	22	22	1.0000000
NODE_39112_length_510_cov_6.476886	208	251	0	17	43	0.3953488
NODE_39112_length_510_cov_6.476886	208	251	3	26	43	0.6046512
NODE_39115_length_510_cov_6.133820	149	200	0	51	51	1.0000000
NODE_39122_length_510_cov_4.313869	32	106	0	74	74	1.0000000
NODE_39131_length_510_cov_3.435523	149	213	0	7	64	0.1093750
NODE_39131_length_510_cov_3.435523	149	213	2	57	64	0.8906250
NODE_39131_length_510_cov_3.435523	191	249	0	9	58	0.1551724
NODE_39131_length_510_cov_3.435523	191	249	2	19	58	0.3275862
NODE_39131_length_510_cov_3.435523	191	249	6	30	58	0.5172414
NODE_39293_length_509_cov_13.378049	160	240	0	80	80	1.0000000
NODE_39293_length_509_cov_13.378049	213	294	0	81	81	1.0000000
NODE_39302_length_509_cov_5.190244	203	283	13	7	80	0.0875000
NODE_39302_length_509_cov_5.190244	203	283	15	3	80	0.0375000
NODE_39302_length_509_cov_5.190244	203	283	17	5	80	0.0625000
NODE_39302_length_509_cov_5.190244	203	283	19	9	80	0.1125000
NODE_39302_length_509_cov_5.190244	203	283	21	56	80	0.7000000
NODE_39302_length_509_cov_5.190244	256	336	0	22	80	0.2750000
NODE_39302_length_509_cov_5.190244	256	336	2	2	80	0.0250000
NODE_39302_length_509_cov_5.190244	256	336	4	10	80	0.1250000
NODE_39302_length_509_cov_5.190244	256	336	8	8	80	0.1000000
NODE_39302_length_509_cov_5.190244	256	336	10	2	80	0.0250000
NODE_39302_length_509_cov_5.190244	256	336	12	1	80	0.0125000
NODE_39302_length_509_cov_5.190244	256	336	13	2	80	0.0250000
NODE_39302_length_509_cov_5.190244	256	336	19	15	80	0.1875000
NODE_39302_length_509_cov_5.190244	256	336	21	18	80	0.2250000
NODE_39309_length_509_cov_4.478049	221	301	0	80	80	1.0000000
NODE_39309_length_509_cov_4.478049	274	354	0	80	80	1.0000000
NODE_39311_length_509_cov_4.451220	203	283	12	80	80	1.0000000
NODE_39322_length_509_cov_3.443902	133	185	0	51	52	0.9807692
NODE_39322_length_509_cov_3.443902	133	185	2	1	52	0.0192308
NODE_39326_length_509_cov_3.207317	367	445	4	8	78	0.1025641
NODE_39326_length_509_cov_3.207317	367	445	6	70	78	0.8974359
NODE_39337_length_509_cov_2.853659	194	274	0	80	80	1.0000000
NODE_39480_length_509_cov_0.809756	229	272	2	43	43	1.0000000
NODE_39506_length_508_cov_22.009780	440	508	0	68	68	1.0000000
NODE_39512_length_508_cov_5.158924	248	284	0	36	36	1.0000000
NODE_39539_length_508_cov_2.662592	165	244	8	5	79	0.0632911
NODE_39539_length_508_cov_2.662592	165	244	10	19	79	0.2405063
NODE_39539_length_508_cov_2.662592	165	244	12	17	79	0.2151899
NODE_39539_length_508_cov_2.662592	165	244	14	1	79	0.0126582
NODE_39539_length_508_cov_2.662592	165	244	16	22	79	0.2784810
NODE_39539_length_508_cov_2.662592	165	244	18	2	79	0.0253165
NODE_39539_length_508_cov_2.662592	165	244	20	5	79	0.0632911
NODE_39539_length_508_cov_2.662592	165	244	22	8	79	0.1012658
NODE_39698_length_507_cov_32.286765	0	61	4	1	61	0.0163934
NODE_39698_length_507_cov_32.286765	0	61	7	2	61	0.0327869
NODE_39698_length_507_cov_32.286765	0	61	15	2	61	0.0327869
NODE_39698_length_507_cov_32.286765	0	61	20	1	61	0.0163934
NODE_39698_length_507_cov_32.286765	0	61	22	2	61	0.0327869
NODE_39698_length_507_cov_32.286765	0	61	30	5	61	0.0819672
NODE_39698_length_507_cov_32.286765	0	61	36	1	61	0.0163934
NODE_39698_length_507_cov_32.286765	0	61	39	1	61	0.0163934
NODE_39698_length_507_cov_32.286765	0	61	45	2	61	0.0327869
NODE_39698_length_507_cov_32.286765	0	61	51	1	61	0.0163934
NODE_39698_length_507_cov_32.286765	0	61	58	1	61	0.0163934
NODE_39698_length_507_cov_32.286765	0	61	64	1	61	0.0163934
NODE_39698_length_507_cov_32.286765	0	61	67	1	61	0.0163934
NODE_39698_length_507_cov_32.286765	0	61	68	1	61	0.0163934
NODE_39698_length_507_cov_32.286765	0	61	69	1	61	0.0163934
NODE_39698_length_507_cov_32.286765	0	61	71	2	61	0.0327869
NODE_39698_length_507_cov_32.286765	0	61	72	1	61	0.0163934
NODE_39698_length_507_cov_32.286765	0	61	76	1	61	0.0163934
NODE_39698_length_507_cov_32.286765	0	61	77	1	61	0.0163934
NODE_39698_length_507_cov_32.286765	0	61	85	1	61	0.0163934
NODE_39698_length_507_cov_32.286765	0	61	89	3	61	0.0491803
NODE_39698_length_507_cov_32.286765	0	61	92	1	61	0.0163934
NODE_39698_length_507_cov_32.286765	0	61	93	1	61	0.0163934
NODE_39698_length_507_cov_32.286765	0	61	96	1	61	0.0163934
NODE_39698_length_507_cov_32.286765	0	61	97	1	61	0.0163934
NODE_39698_length_507_cov_32.286765	0	61	105	12	61	0.1967213
NODE_39698_length_507_cov_32.286765	0	61	111	2	61	0.0327869
NODE_39698_length_507_cov_32.286765	0	61	113	3	61	0.0491803
NODE_39698_length_507_cov_32.286765	0	61	117	1	61	0.0163934
NODE_39698_length_507_cov_32.286765	0	61	121	2	61	0.0327869
NODE_39698_length_507_cov_32.286765	0	61	124	1	61	0.0163934
NODE_39698_length_507_cov_32.286765	0	61	125	1	61	0.0163934
NODE_39698_length_507_cov_32.286765	0	61	126	1	61	0.0163934
NODE_39698_length_507_cov_32.286765	0	61	132	2	61	0.0327869
NODE_39698_length_507_cov_32.286765	53	97	117	1	44	0.0227273
NODE_39698_length_507_cov_32.286765	53	97	121	2	44	0.0454545
NODE_39698_length_507_cov_32.286765	53	97	124	1	44	0.0227273
NODE_39698_length_507_cov_32.286765	53	97	125	1	44	0.0227273
NODE_39698_length_507_cov_32.286765	53	97	126	1	44	0.0227273
NODE_39698_length_507_cov_32.286765	53	97	132	2	44	0.0454545
NODE_39698_length_507_cov_32.286765	53	97	138	1	44	0.0227273
NODE_39698_length_507_cov_32.286765	53	97	144	1	44	0.0227273
NODE_39698_length_507_cov_32.286765	53	97	146	1	44	0.0227273
NODE_39698_length_507_cov_32.286765	53	97	151	2	44	0.0454545
NODE_39698_length_507_cov_32.286765	53	97	153	1	44	0.0227273
NODE_39698_length_507_cov_32.286765	53	97	161	1	44	0.0227273
NODE_39698_length_507_cov_32.286765	53	97	166	1	44	0.0227273
NODE_39698_length_507_cov_32.286765	53	97	168	1	44	0.0227273
NODE_39698_length_507_cov_32.286765	53	97	170	1	44	0.0227273
NODE_39698_length_507_cov_32.286765	53	97	172	1	44	0.0227273
NODE_39698_length_507_cov_32.286765	53	97	173	1	44	0.0227273
NODE_39698_length_507_cov_32.286765	53	97	175	1	44	0.0227273
NODE_39698_length_507_cov_32.286765	53	97	187	1	44	0.0227273
NODE_39698_length_507_cov_32.286765	53	97	188	1	44	0.0227273
NODE_39698_length_507_cov_32.286765	53	97	190	1	44	0.0227273
NODE_39698_length_507_cov_32.286765	53	97	192	1	44	0.0227273
NODE_39698_length_507_cov_32.286765	53	97	197	3	44	0.0681818
NODE_39698_length_507_cov_32.286765	53	97	199	1	44	0.0227273
NODE_39698_length_507_cov_32.286765	53	97	201	1	44	0.0227273
NODE_39698_length_507_cov_32.286765	53	97	213	1	44	0.0227273
NODE_39698_length_507_cov_32.286765	53	97	217	1	44	0.0227273
NODE_39698_length_507_cov_32.286765	53	97	219	1	44	0.0227273
NODE_39698_length_507_cov_32.286765	53	97	221	2	44	0.0454545
NODE_39698_length_507_cov_32.286765	53	97	225	1	44	0.0227273
NODE_39698_length_507_cov_32.286765	53	97	227	1	44	0.0227273
NODE_39698_length_507_cov_32.286765	53	97	231	1	44	0.0227273
NODE_39698_length_507_cov_32.286765	53	97	237	1	44	0.0227273
NODE_39698_length_507_cov_32.286765	53	97	239	5	44	0.1136364
NODE_39701_length_507_cov_7.553922	203	283	0	11	80	0.1375000
NODE_39701_length_507_cov_7.553922	203	283	2	69	80	0.8625000
NODE_39709_length_507_cov_5.154412	296	362	0	66	66	1.0000000
NODE_39714_length_507_cov_4.710784	248	328	6	31	80	0.3875000
NODE_39714_length_507_cov_4.710784	248	328	9	4	80	0.0500000
NODE_39714_length_507_cov_4.710784	248	328	12	45	80	0.5625000
NODE_39714_length_507_cov_4.710784	308	379	0	13	71	0.1830986
NODE_39714_length_507_cov_4.710784	308	379	6	49	71	0.6901408
NODE_39714_length_507_cov_4.710784	308	379	9	4	71	0.0563380
NODE_39714_length_507_cov_4.710784	308	379	12	5	71	0.0704225
NODE_39728_length_507_cov_3.649510	80	109	2	15	29	0.5172414
NODE_39728_length_507_cov_3.649510	80	109	4	14	29	0.4827586
NODE_39728_length_507_cov_3.649510	184	266	18	2	82	0.0243902
NODE_39728_length_507_cov_3.649510	184	266	20	17	82	0.2073171
NODE_39728_length_507_cov_3.649510	184	266	22	16	82	0.1951219
NODE_39728_length_507_cov_3.649510	184	266	23	1	82	0.0121951
NODE_39728_length_507_cov_3.649510	184	266	24	14	82	0.1707317
NODE_39728_length_507_cov_3.649510	184	266	26	32	82	0.3902439
NODE_39728_length_507_cov_3.649510	189	273	18	9	84	0.1071429
NODE_39728_length_507_cov_3.649510	189	273	20	17	84	0.2023810
NODE_39728_length_507_cov_3.649510	189	273	22	11	84	0.1309524
NODE_39728_length_507_cov_3.649510	189	273	23	1	84	0.0119048
NODE_39728_length_507_cov_3.649510	189	273	24	14	84	0.1666667
NODE_39728_length_507_cov_3.649510	189	273	26	32	84	0.3809524
NODE_39728_length_507_cov_3.649510	207	266	18	2	59	0.0338983
NODE_39728_length_507_cov_3.649510	207	266	20	17	59	0.2881356
NODE_39728_length_507_cov_3.649510	207	266	22	4	59	0.0677966
NODE_39728_length_507_cov_3.649510	207	266	24	11	59	0.1864407
NODE_39728_length_507_cov_3.649510	207	266	26	25	59	0.4237288
NODE_39747_length_507_cov_2.754902	345	425	0	80	80	1.0000000
NODE_39747_length_507_cov_2.754902	428	463	0	35	35	1.0000000
NODE_39918_length_506_cov_31.987715	71	156	18	10	85	0.1176471
NODE_39918_length_506_cov_31.987715	71	156	20	15	85	0.1764706
NODE_39918_length_506_cov_31.987715	71	156	26	4	85	0.0470588
NODE_39918_length_506_cov_31.987715	71	156	28	4	85	0.0470588
NODE_39918_length_506_cov_31.987715	71	156	30	32	85	0.3764706
NODE_39918_length_506_cov_31.987715	71	156	31	16	85	0.1882353
NODE_39918_length_506_cov_31.987715	71	156	33	4	85	0.0470588
NODE_39918_length_506_cov_31.987715	71	156	18	10	85	0.1176471
NODE_39918_length_506_cov_31.987715	71	156	20	15	85	0.1764706
NODE_39918_length_506_cov_31.987715	71	156	26	4	85	0.0470588
NODE_39918_length_506_cov_31.987715	71	156	28	4	85	0.0470588
NODE_39918_length_506_cov_31.987715	71	156	30	32	85	0.3764706
NODE_39918_length_506_cov_31.987715	71	156	31	16	85	0.1882353
NODE_39918_length_506_cov_31.987715	71	156	33	4	85	0.0470588
NODE_39918_length_506_cov_31.987715	71	156	18	10	85	0.1176471
NODE_39918_length_506_cov_31.987715	71	156	20	15	85	0.1764706
NODE_39918_length_506_cov_31.987715	71	156	26	4	85	0.0470588
NODE_39918_length_506_cov_31.987715	71	156	28	4	85	0.0470588
NODE_39918_length_506_cov_31.987715	71	156	30	32	85	0.3764706
NODE_39918_length_506_cov_31.987715	71	156	31	16	85	0.1882353
NODE_39918_length_506_cov_31.987715	71	156	33	4	85	0.0470588
NODE_39918_length_506_cov_31.987715	129	209	6	4	80	0.0500000
NODE_39918_length_506_cov_31.987715	129	209	15	1	80	0.0125000
NODE_39918_length_506_cov_31.987715	129	209	16	27	80	0.3375000
NODE_39918_length_506_cov_31.987715	129	209	20	1	80	0.0125000
NODE_39918_length_506_cov_31.987715	129	209	21	9	80	0.1125000
NODE_39918_length_506_cov_31.987715	129	209	23	1	80	0.0125000
NODE_39918_length_506_cov_31.987715	129	209	26	10	80	0.1250000
NODE_39918_length_506_cov_31.987715	129	209	27	4	80	0.0500000
NODE_39918_length_506_cov_31.987715	129	209	28	3	80	0.0375000
NODE_39918_length_506_cov_31.987715	129	209	31	16	80	0.2000000
NODE_39918_length_506_cov_31.987715	129	209	33	4	80	0.0500000
NODE_39919_length_506_cov_15.877150	210	279	0	6	69	0.0869565
NODE_39919_length_506_cov_15.877150	210	279	10	3	69	0.0434783
NODE_39919_length_506_cov_15.877150	210	279	11	7	69	0.1014493
NODE_39919_length_506_cov_15.877150	210	279	12	14	69	0.2028985
NODE_39919_length_506_cov_15.877150	210	279	13	1	69	0.0144928
NODE_39919_length_506_cov_15.877150	210	279	14	38	69	0.5507246
NODE_39920_length_506_cov_15.461916	334	414	0	80	80	1.0000000
NODE_39920_length_506_cov_15.461916	387	467	0	80	80	1.0000000
NODE_39921_length_506_cov_9.749386	197	276	0	79	79	1.0000000
NODE_39921_length_506_cov_9.749386	249	329	0	80	80	1.0000000
NODE_39947_length_506_cov_3.122850	218	298	0	80	80	1.0000000
NODE_39947_length_506_cov_3.122850	271	351	0	80	80	1.0000000
NODE_39951_length_506_cov_2.894349	190	270	0	80	80	1.0000000
NODE_40133_length_505_cov_35.541872	373	453	0	80	80	1.0000000
NODE_40135_length_505_cov_10.339901	30	110	0	80	80	1.0000000
NODE_40135_length_505_cov_10.339901	83	163	0	80	80	1.0000000
NODE_40158_length_505_cov_3.554187	225	305	4	44	80	0.5500000
NODE_40158_length_505_cov_3.554187	225	305	6	8	80	0.1000000
NODE_40158_length_505_cov_3.554187	225	305	7	8	80	0.1000000
NODE_40158_length_505_cov_3.554187	225	305	8	20	80	0.2500000
NODE_40158_length_505_cov_3.554187	278	358	2	7	80	0.0875000
NODE_40158_length_505_cov_3.554187	278	358	4	4	80	0.0500000
NODE_40158_length_505_cov_3.554187	278	358	6	4	80	0.0500000
NODE_40158_length_505_cov_3.554187	278	358	7	7	80	0.0875000
NODE_40158_length_505_cov_3.554187	278	358	8	58	80	0.7250000
NODE_40160_length_505_cov_3.403941	207	287	0	27	80	0.3375000
NODE_40160_length_505_cov_3.403941	207	287	2	53	80	0.6625000
NODE_40175_length_505_cov_2.975369	162	227	0	65	65	1.0000000
NODE_40222_length_505_cov_1.864532	55	126	0	71	71	1.0000000
NODE_40368_length_504_cov_115.891358	122	202	131	2	80	0.0250000
NODE_40368_length_504_cov_115.891358	122	202	133	2	80	0.0250000
NODE_40368_length_504_cov_115.891358	122	202	135	2	80	0.0250000
NODE_40368_length_504_cov_115.891358	122	202	137	3	80	0.0375000
NODE_40368_length_504_cov_115.891358	122	202	139	2	80	0.0250000
NODE_40368_length_504_cov_115.891358	122	202	147	3	80	0.0375000
NODE_40368_length_504_cov_115.891358	122	202	148	1	80	0.0125000
NODE_40368_length_504_cov_115.891358	122	202	149	1	80	0.0125000
NODE_40368_length_504_cov_115.891358	122	202	151	4	80	0.0500000
NODE_40368_length_504_cov_115.891358	122	202	155	1	80	0.0125000
NODE_40368_length_504_cov_115.891358	122	202	159	1	80	0.0125000
NODE_40368_length_504_cov_115.891358	122	202	163	4	80	0.0500000
NODE_40368_length_504_cov_115.891358	122	202	164	1	80	0.0125000
NODE_40368_length_504_cov_115.891358	122	202	169	1	80	0.0125000
NODE_40368_length_504_cov_115.891358	122	202	174	2	80	0.0250000
NODE_40368_length_504_cov_115.891358	122	202	180	1	80	0.0125000
NODE_40368_length_504_cov_115.891358	122	202	182	1	80	0.0125000
NODE_40368_length_504_cov_115.891358	122	202	194	5	80	0.0625000
NODE_40368_length_504_cov_115.891358	122	202	195	4	80	0.0500000
NODE_40368_length_504_cov_115.891358	122	202	197	6	80	0.0750000
NODE_40368_length_504_cov_115.891358	122	202	198	4	80	0.0500000
NODE_40368_length_504_cov_115.891358	122	202	199	5	80	0.0625000
NODE_40368_length_504_cov_115.891358	122	202	201	1	80	0.0125000
NODE_40368_length_504_cov_115.891358	122	202	213	1	80	0.0125000
NODE_40368_length_504_cov_115.891358	122	202	215	1	80	0.0125000
NODE_40368_length_504_cov_115.891358	122	202	219	1	80	0.0125000
NODE_40368_length_504_cov_115.891358	122	202	220	3	80	0.0375000
NODE_40368_length_504_cov_115.891358	122	202	221	2	80	0.0250000
NODE_40368_length_504_cov_115.891358	122	202	222	2	80	0.0250000
NODE_40368_length_504_cov_115.891358	122	202	223	2	80	0.0250000
NODE_40368_length_504_cov_115.891358	122	202	225	1	80	0.0125000
NODE_40368_length_504_cov_115.891358	122	202	226	3	80	0.0375000
NODE_40368_length_504_cov_115.891358	122	202	227	2	80	0.0250000
NODE_40368_length_504_cov_115.891358	122	202	228	5	80	0.0625000
NODE_40368_length_504_cov_115.891358	175	255	134	2	80	0.0250000
NODE_40368_length_504_cov_115.891358	175	255	135	1	80	0.0125000
NODE_40368_length_504_cov_115.891358	175	255	137	1	80	0.0125000
NODE_40368_length_504_cov_115.891358	175	255	143	1	80	0.0125000
NODE_40368_length_504_cov_115.891358	175	255	147	1	80	0.0125000
NODE_40368_length_504_cov_115.891358	175	255	152	1	80	0.0125000
NODE_40368_length_504_cov_115.891358	175	255	154	1	80	0.0125000
NODE_40368_length_504_cov_115.891358	175	255	160	1	80	0.0125000
NODE_40368_length_504_cov_115.891358	175	255	162	1	80	0.0125000
NODE_40368_length_504_cov_115.891358	175	255	166	2	80	0.0250000
NODE_40368_length_504_cov_115.891358	175	255	170	1	80	0.0125000
NODE_40368_length_504_cov_115.891358	175	255	174	1	80	0.0125000
NODE_40368_length_504_cov_115.891358	175	255	177	1	80	0.0125000
NODE_40368_length_504_cov_115.891358	175	255	181	1	80	0.0125000
NODE_40368_length_504_cov_115.891358	175	255	182	1	80	0.0125000
NODE_40368_length_504_cov_115.891358	175	255	184	3	80	0.0375000
NODE_40368_length_504_cov_115.891358	175	255	188	1	80	0.0125000
NODE_40368_length_504_cov_115.891358	175	255	190	1	80	0.0125000
NODE_40368_length_504_cov_115.891358	175	255	192	1	80	0.0125000
NODE_40368_length_504_cov_115.891358	175	255	194	1	80	0.0125000
NODE_40368_length_504_cov_115.891358	175	255	196	1	80	0.0125000
NODE_40368_length_504_cov_115.891358	175	255	198	2	80	0.0250000
NODE_40368_length_504_cov_115.891358	175	255	199	2	80	0.0250000
NODE_40368_length_504_cov_115.891358	175	255	203	2	80	0.0250000
NODE_40368_length_504_cov_115.891358	175	255	207	1	80	0.0125000
NODE_40368_length_504_cov_115.891358	175	255	209	2	80	0.0250000
NODE_40368_length_504_cov_115.891358	175	255	211	1	80	0.0125000
NODE_40368_length_504_cov_115.891358	175	255	212	3	80	0.0375000
NODE_40368_length_504_cov_115.891358	175	255	213	2	80	0.0250000
NODE_40368_length_504_cov_115.891358	175	255	214	4	80	0.0500000
NODE_40368_length_504_cov_115.891358	175	255	215	5	80	0.0625000
NODE_40368_length_504_cov_115.891358	175	255	216	1	80	0.0125000
NODE_40368_length_504_cov_115.891358	175	255	217	8	80	0.1000000
NODE_40368_length_504_cov_115.891358	175	255	219	1	80	0.0125000
NODE_40368_length_504_cov_115.891358	175	255	220	3	80	0.0375000
NODE_40368_length_504_cov_115.891358	175	255	221	2	80	0.0250000
NODE_40368_length_504_cov_115.891358	175	255	222	3	80	0.0375000
NODE_40368_length_504_cov_115.891358	175	255	223	2	80	0.0250000
NODE_40368_length_504_cov_115.891358	175	255	225	1	80	0.0125000
NODE_40368_length_504_cov_115.891358	175	255	226	3	80	0.0375000
NODE_40368_length_504_cov_115.891358	175	255	227	2	80	0.0250000
NODE_40368_length_504_cov_115.891358	175	255	228	5	80	0.0625000
NODE_40369_length_504_cov_33.360494	28	108	9	58	80	0.7250000
NODE_40369_length_504_cov_33.360494	28	108	10	22	80	0.2750000
NODE_40369_length_504_cov_33.360494	81	161	0	29	80	0.3625000
NODE_40369_length_504_cov_33.360494	81	161	8	1	80	0.0125000
NODE_40369_length_504_cov_33.360494	81	161	9	50	80	0.6250000
NODE_40370_length_504_cov_15.669136	176	256	12	80	80	1.0000000
NODE_40370_length_504_cov_15.669136	229	309	6	1	80	0.0125000
NODE_40370_length_504_cov_15.669136	229	309	7	1	80	0.0125000
NODE_40370_length_504_cov_15.669136	229	309	12	78	80	0.9750000
NODE_40371_length_504_cov_13.202469	134	215	0	42	81	0.5185185
NODE_40371_length_504_cov_13.202469	134	215	1	39	81	0.4814815
NODE_40371_length_504_cov_13.202469	188	268	1	80	80	1.0000000
NODE_40377_length_504_cov_6.770370	55	135	0	80	80	1.0000000
NODE_40377_length_504_cov_6.770370	108	188	0	80	80	1.0000000
NODE_40427_length_504_cov_2.234568	359	407	0	23	48	0.4791667
NODE_40427_length_504_cov_2.234568	359	407	2	25	48	0.5208333
NODE_40428_length_504_cov_2.227160	307	370	0	8	63	0.1269841
NODE_40428_length_504_cov_2.227160	307	370	2	21	63	0.3333333
NODE_40428_length_504_cov_2.227160	307	370	4	5	63	0.0793651
NODE_40428_length_504_cov_2.227160	307	370	6	29	63	0.4603175
NODE_40434_length_504_cov_2.116049	245	325	0	80	80	1.0000000
NODE_40434_length_504_cov_2.116049	298	378	0	80	80	1.0000000
NODE_40446_length_504_cov_1.925926	196	262	2	66	66	1.0000000
NODE_40601_length_503_cov_11.356436	268	348	0	6	80	0.0750000
NODE_40601_length_503_cov_11.356436	268	348	2	74	80	0.9250000
NODE_40601_length_503_cov_11.356436	321	401	0	43	80	0.5375000
NODE_40601_length_503_cov_11.356436	321	401	2	37	80	0.4625000
NODE_40615_length_503_cov_5.537129	314	381	6	2	67	0.0298507
NODE_40615_length_503_cov_5.537129	314	381	8	65	67	0.9701493
NODE_40645_length_503_cov_3.012376	264	285	0	21	21	1.0000000
NODE_40652_length_503_cov_2.757426	266	334	0	6	68	0.0882353
NODE_40652_length_503_cov_2.757426	266	334	2	20	68	0.2941177
NODE_40652_length_503_cov_2.757426	266	334	6	29	68	0.4264706
NODE_40652_length_503_cov_2.757426	266	334	7	13	68	0.1911765
NODE_40652_length_503_cov_2.757426	307	387	6	14	80	0.1750000
NODE_40652_length_503_cov_2.757426	307	387	7	16	80	0.2000000
NODE_40652_length_503_cov_2.757426	307	387	8	48	80	0.6000000
NODE_40652_length_503_cov_2.757426	307	387	10	2	80	0.0250000
NODE_40655_length_503_cov_2.705446	158	237	0	67	79	0.8481013
NODE_40655_length_503_cov_2.705446	158	237	4	12	79	0.1518987
NODE_40655_length_503_cov_2.705446	211	291	0	14	80	0.1750000
NODE_40655_length_503_cov_2.705446	211	291	4	66	80	0.8250000
NODE_40656_length_503_cov_2.705446	251	331	0	49	80	0.6125000
NODE_40656_length_503_cov_2.705446	251	331	2	3	80	0.0375000
NODE_40656_length_503_cov_2.705446	251	331	4	9	80	0.1125000
NODE_40656_length_503_cov_2.705446	251	331	6	19	80	0.2375000
NODE_40656_length_503_cov_2.705446	251	321	0	39	70	0.5571429
NODE_40656_length_503_cov_2.705446	251	321	2	3	70	0.0428571
NODE_40656_length_503_cov_2.705446	251	321	4	9	70	0.1285714
NODE_40656_length_503_cov_2.705446	251	321	6	19	70	0.2714286
NODE_40656_length_503_cov_2.705446	330	384	0	38	54	0.7037037
NODE_40656_length_503_cov_2.705446	330	384	2	16	54	0.2962963
NODE_40656_length_503_cov_2.705446	338	384	0	30	46	0.6521739
NODE_40656_length_503_cov_2.705446	338	384	2	16	46	0.3478261
NODE_40664_length_503_cov_2.584158	95	163	0	68	68	1.0000000
NODE_40857_length_502_cov_45.292804	353	433	44	3	80	0.0375000
NODE_40857_length_502_cov_45.292804	353	433	51	1	80	0.0125000
NODE_40857_length_502_cov_45.292804	353	433	64	1	80	0.0125000
NODE_40857_length_502_cov_45.292804	353	433	65	9	80	0.1125000
NODE_40857_length_502_cov_45.292804	353	433	66	1	80	0.0125000
NODE_40857_length_502_cov_45.292804	353	433	67	5	80	0.0625000
NODE_40857_length_502_cov_45.292804	353	433	69	4	80	0.0500000
NODE_40857_length_502_cov_45.292804	353	433	70	2	80	0.0250000
NODE_40857_length_502_cov_45.292804	353	433	80	1	80	0.0125000
NODE_40857_length_502_cov_45.292804	353	433	81	1	80	0.0125000
NODE_40857_length_502_cov_45.292804	353	433	86	1	80	0.0125000
NODE_40857_length_502_cov_45.292804	353	433	87	3	80	0.0375000
NODE_40857_length_502_cov_45.292804	353	433	89	1	80	0.0125000
NODE_40857_length_502_cov_45.292804	353	433	91	5	80	0.0625000
NODE_40857_length_502_cov_45.292804	353	433	93	2	80	0.0250000
NODE_40857_length_502_cov_45.292804	353	433	94	4	80	0.0500000
NODE_40857_length_502_cov_45.292804	353	433	95	19	80	0.2375000
NODE_40857_length_502_cov_45.292804	353	433	96	3	80	0.0375000
NODE_40857_length_502_cov_45.292804	353	433	97	14	80	0.1750000
NODE_40864_length_502_cov_5.980149	305	381	16	14	76	0.1842105
NODE_40864_length_502_cov_5.980149	305	381	18	7	76	0.0921053
NODE_40864_length_502_cov_5.980149	305	381	20	55	76	0.7236842
NODE_41070_length_501_cov_208.708955	288	350	10	25	62	0.4032258
NODE_41070_length_501_cov_208.708955	288	350	12	37	62	0.5967742
NODE_41070_length_501_cov_208.708955	327	413	0	21	86	0.2441860
NODE_41070_length_501_cov_208.708955	327	413	2	2	86	0.0232558
NODE_41070_length_501_cov_208.708955	327	413	4	33	86	0.3837209
NODE_41070_length_501_cov_208.708955	327	413	6	3	86	0.0348837
NODE_41070_length_501_cov_208.708955	327	413	10	25	86	0.2906977
NODE_41070_length_501_cov_208.708955	327	413	12	2	86	0.0232558
NODE_41071_length_501_cov_29.126866	23	103	0	22	80	0.2750000
NODE_41071_length_501_cov_29.126866	23	103	1	10	80	0.1250000
NODE_41071_length_501_cov_29.126866	23	103	2	48	80	0.6000000
NODE_41071_length_501_cov_29.126866	76	156	2	80	80	1.0000000
NODE_41072_length_501_cov_23.736318	85	165	0	7	80	0.0875000
NODE_41072_length_501_cov_23.736318	85	165	3	1	80	0.0125000
NODE_41072_length_501_cov_23.736318	85	165	4	72	80	0.9000000
NODE_41072_length_501_cov_23.736318	138	218	0	60	80	0.7500000
NODE_41072_length_501_cov_23.736318	138	218	3	1	80	0.0125000
NODE_41072_length_501_cov_23.736318	138	218	4	19	80	0.2375000
NODE_41075_length_501_cov_7.820896	270	350	0	9	80	0.1125000
NODE_41075_length_501_cov_7.820896	270	350	1	3	80	0.0375000
NODE_41075_length_501_cov_7.820896	270	350	2	68	80	0.8500000
NODE_41075_length_501_cov_7.820896	323	403	2	63	80	0.7875000
NODE_41075_length_501_cov_7.820896	323	403	4	17	80	0.2125000
NODE_41080_length_501_cov_6.437811	309	389	0	80	80	1.0000000
NODE_41097_length_501_cov_3.656716	289	312	4	23	23	1.0000000
NODE_41097_length_501_cov_3.656716	355	420	2	23	65	0.3538462
NODE_41097_length_501_cov_3.656716	355	420	4	22	65	0.3384615
NODE_41097_length_501_cov_3.656716	355	420	6	20	65	0.3076923
NODE_41103_length_501_cov_3.477612	329	409	0	79	80	0.9875000
NODE_41103_length_501_cov_3.477612	329	409	2	1	80	0.0125000
NODE_41109_length_501_cov_3.134328	266	345	0	79	79	1.0000000
NODE_41308_length_500_cov_77.895262	456	500	14	2	44	0.0454545
NODE_41308_length_500_cov_77.895262	456	500	16	1	44	0.0227273
NODE_41308_length_500_cov_77.895262	456	500	23	8	44	0.1818182
NODE_41308_length_500_cov_77.895262	456	500	25	6	44	0.1363636
NODE_41308_length_500_cov_77.895262	456	500	27	3	44	0.0681818
NODE_41308_length_500_cov_77.895262	456	500	28	1	44	0.0227273
NODE_41308_length_500_cov_77.895262	456	500	30	3	44	0.0681818
NODE_41308_length_500_cov_77.895262	456	500	33	3	44	0.0681818
NODE_41308_length_500_cov_77.895262	456	500	35	17	44	0.3863636
NODE_41309_length_500_cov_35.805486	326	406	0	80	80	1.0000000
NODE_41309_length_500_cov_35.805486	379	459	0	80	80	1.0000000
NODE_41310_length_500_cov_13.084788	160	221	0	59	61	0.9672131
NODE_41310_length_500_cov_13.084788	160	221	2	2	61	0.0327869
NODE_41311_length_500_cov_12.650873	215	295	0	80	80	1.0000000
NODE_41311_length_500_cov_12.650873	268	348	0	80	80	1.0000000
NODE_41312_length_500_cov_12.009975	203	268	2	10	65	0.1538462
NODE_41312_length_500_cov_12.009975	203	268	4	3	65	0.0461538
NODE_41312_length_500_cov_12.009975	203	268	6	52	65	0.8000000
NODE_41312_length_500_cov_12.009975	241	321	0	53	80	0.6625000
NODE_41312_length_500_cov_12.009975	241	321	2	10	80	0.1250000
NODE_41312_length_500_cov_12.009975	241	321	4	3	80	0.0375000
NODE_41312_length_500_cov_12.009975	241	321	6	14	80	0.1750000
NODE_41325_length_500_cov_4.653367	224	295	0	71	71	1.0000000
NODE_41415_length_500_cov_1.650873	355	435	0	80	80	1.0000000
NODE_41415_length_500_cov_1.650873	408	488	0	80	80	1.0000000
NODE_41462_length_500_cov_1.231920	169	212	0	43	43	1.0000000
NODE_41542_length_499_cov_358.730000	425	492	19	1	67	0.0149254
NODE_41542_length_499_cov_358.730000	425	492	21	1	67	0.0149254
NODE_41542_length_499_cov_358.730000	425	492	26	1	67	0.0149254
NODE_41542_length_499_cov_358.730000	425	492	30	2	67	0.0298507
NODE_41542_length_499_cov_358.730000	425	492	35	1	67	0.0149254
NODE_41542_length_499_cov_358.730000	425	492	40	1	67	0.0149254
NODE_41542_length_499_cov_358.730000	425	492	44	3	67	0.0447761
NODE_41542_length_499_cov_358.730000	425	492	46	1	67	0.0149254
NODE_41542_length_499_cov_358.730000	425	492	50	2	67	0.0298507
NODE_41542_length_499_cov_358.730000	425	492	56	4	67	0.0597015
NODE_41542_length_499_cov_358.730000	425	492	58	1	67	0.0149254
NODE_41542_length_499_cov_358.730000	425	492	60	1	67	0.0149254
NODE_41542_length_499_cov_358.730000	425	492	62	2	67	0.0298507
NODE_41542_length_499_cov_358.730000	425	492	66	4	67	0.0597015
NODE_41542_length_499_cov_358.730000	425	492	68	2	67	0.0298507
NODE_41542_length_499_cov_358.730000	425	492	70	1	67	0.0149254
NODE_41542_length_499_cov_358.730000	425	492	72	5	67	0.0746269
NODE_41542_length_499_cov_358.730000	425	492	74	2	67	0.0298507
NODE_41542_length_499_cov_358.730000	425	492	76	3	67	0.0447761
NODE_41542_length_499_cov_358.730000	425	492	80	2	67	0.0298507
NODE_41542_length_499_cov_358.730000	425	492	88	1	67	0.0149254
NODE_41542_length_499_cov_358.730000	425	492	92	3	67	0.0447761
NODE_41542_length_499_cov_358.730000	425	492	94	1	67	0.0149254
NODE_41542_length_499_cov_358.730000	425	492	96	2	67	0.0298507
NODE_41542_length_499_cov_358.730000	425	492	98	1	67	0.0149254
NODE_41542_length_499_cov_358.730000	425	492	100	1	67	0.0149254
NODE_41542_length_499_cov_358.730000	425	492	102	1	67	0.0149254
NODE_41542_length_499_cov_358.730000	425	492	104	1	67	0.0149254
NODE_41542_length_499_cov_358.730000	425	492	105	3	67	0.0447761
NODE_41542_length_499_cov_358.730000	425	492	106	7	67	0.1044776
NODE_41542_length_499_cov_358.730000	425	492	108	1	67	0.0149254
NODE_41542_length_499_cov_358.730000	425	492	109	2	67	0.0298507
NODE_41542_length_499_cov_358.730000	425	492	110	1	67	0.0149254
NODE_41542_length_499_cov_358.730000	425	492	114	1	67	0.0149254
NODE_41542_length_499_cov_358.730000	425	492	115	1	67	0.0149254
NODE_41543_length_499_cov_21.135000	52	132	0	80	80	1.0000000
NODE_41543_length_499_cov_21.135000	105	185	0	80	80	1.0000000
NODE_41544_length_499_cov_11.917500	50	130	0	80	80	1.0000000
NODE_41544_length_499_cov_11.917500	103	183	0	80	80	1.0000000
NODE_41549_length_499_cov_5.007500	0	54	0	54	54	1.0000000
NODE_41563_length_499_cov_3.482500	307	336	16	6	29	0.2068966
NODE_41563_length_499_cov_3.482500	307	336	18	2	29	0.0689655
NODE_41563_length_499_cov_3.482500	307	336	20	2	29	0.0689655
NODE_41563_length_499_cov_3.482500	307	336	26	5	29	0.1724138
NODE_41563_length_499_cov_3.482500	307	336	28	2	29	0.0689655
NODE_41563_length_499_cov_3.482500	307	336	30	8	29	0.2758621
NODE_41563_length_499_cov_3.482500	307	336	32	3	29	0.1034483
NODE_41563_length_499_cov_3.482500	307	336	34	1	29	0.0344828
NODE_41594_length_499_cov_2.420000	198	247	0	49	49	1.0000000
NODE_41662_length_499_cov_1.445000	311	372	0	61	61	1.0000000
NODE_41770_length_498_cov_31.704261	12	92	0	80	80	1.0000000
NODE_41770_length_498_cov_31.704261	65	145	0	80	80	1.0000000
NODE_41775_length_498_cov_7.002506	256	336	0	80	80	1.0000000
NODE_41780_length_498_cov_5.759398	217	247	0	30	30	1.0000000
NODE_41814_length_498_cov_3.075188	225	262	8	19	37	0.5135135
NODE_41814_length_498_cov_3.075188	225	262	10	3	37	0.0810811
NODE_41814_length_498_cov_3.075188	225	262	14	4	37	0.1081081
NODE_41814_length_498_cov_3.075188	225	262	18	1	37	0.0270270
NODE_41814_length_498_cov_3.075188	225	262	20	10	37	0.2702703
NODE_41814_length_498_cov_3.075188	246	324	10	1	78	0.0128205
NODE_41814_length_498_cov_3.075188	246	324	14	4	78	0.0512821
NODE_41814_length_498_cov_3.075188	246	324	18	1	78	0.0128205
NODE_41814_length_498_cov_3.075188	246	324	20	10	78	0.1282051
NODE_41814_length_498_cov_3.075188	246	324	26	1	78	0.0128205
NODE_41814_length_498_cov_3.075188	246	324	30	3	78	0.0384615
NODE_41814_length_498_cov_3.075188	246	324	32	4	78	0.0512821
NODE_41814_length_498_cov_3.075188	246	324	33	7	78	0.0897436
NODE_41814_length_498_cov_3.075188	246	324	34	5	78	0.0641026
NODE_41814_length_498_cov_3.075188	246	324	36	11	78	0.1410256
NODE_41814_length_498_cov_3.075188	246	324	38	6	78	0.0769231
NODE_41814_length_498_cov_3.075188	246	324	40	14	78	0.1794872
NODE_41814_length_498_cov_3.075188	246	324	41	3	78	0.0384615
NODE_41814_length_498_cov_3.075188	246	324	42	8	78	0.1025641
NODE_42016_length_497_cov_44.105528	169	249	0	80	80	1.0000000
NODE_42016_length_497_cov_44.105528	222	302	0	80	80	1.0000000
NODE_42017_length_497_cov_10.145729	85	165	2	26	80	0.3250000
NODE_42017_length_497_cov_10.145729	85	165	4	37	80	0.4625000
NODE_42017_length_497_cov_10.145729	85	165	6	17	80	0.2125000
NODE_42017_length_497_cov_10.145729	138	226	0	47	88	0.5340909
NODE_42017_length_497_cov_10.145729	138	226	2	40	88	0.4545455
NODE_42017_length_497_cov_10.145729	138	226	4	1	88	0.0113636
NODE_42024_length_497_cov_6.618090	231	304	0	73	73	1.0000000
NODE_42024_length_497_cov_6.618090	284	364	0	80	80	1.0000000
NODE_42065_length_497_cov_2.889447	109	189	0	38	80	0.4750000
NODE_42065_length_497_cov_2.889447	109	189	2	42	80	0.5250000
NODE_42065_length_497_cov_2.889447	162	242	0	22	80	0.2750000
NODE_42065_length_497_cov_2.889447	162	242	2	58	80	0.7250000
NODE_42071_length_497_cov_2.623116	302	368	4	59	66	0.8939394
NODE_42071_length_497_cov_2.623116	302	368	6	7	66	0.1060606
NODE_42071_length_497_cov_2.623116	355	406	2	12	51	0.2352941
NODE_42071_length_497_cov_2.623116	355	406	4	39	51	0.7647059
NODE_42100_length_497_cov_1.909548	106	186	6	4	80	0.0500000
NODE_42100_length_497_cov_1.909548	106	186	8	4	80	0.0500000
NODE_42100_length_497_cov_1.909548	106	186	10	1	80	0.0125000
NODE_42100_length_497_cov_1.909548	106	186	12	1	80	0.0125000
NODE_42100_length_497_cov_1.909548	106	186	14	2	80	0.0250000
NODE_42100_length_497_cov_1.909548	106	186	16	13	80	0.1625000
NODE_42100_length_497_cov_1.909548	106	186	18	3	80	0.0375000
NODE_42100_length_497_cov_1.909548	106	186	22	7	80	0.0875000
NODE_42100_length_497_cov_1.909548	106	186	24	4	80	0.0500000
NODE_42100_length_497_cov_1.909548	106	186	25	8	80	0.1000000
NODE_42100_length_497_cov_1.909548	106	186	26	14	80	0.1750000
NODE_42100_length_497_cov_1.909548	106	186	28	19	80	0.2375000
NODE_42100_length_497_cov_1.909548	159	240	14	1	81	0.0123457
NODE_42100_length_497_cov_1.909548	159	240	16	2	81	0.0246914
NODE_42100_length_497_cov_1.909548	159	240	18	7	81	0.0864198
NODE_42100_length_497_cov_1.909548	159	240	24	5	81	0.0617284
NODE_42100_length_497_cov_1.909548	159	240	26	12	81	0.1481481
NODE_42100_length_497_cov_1.909548	159	240	28	23	81	0.2839506
NODE_42100_length_497_cov_1.909548	159	240	30	1	81	0.0123457
NODE_42100_length_497_cov_1.909548	159	240	34	2	81	0.0246914
NODE_42100_length_497_cov_1.909548	159	240	36	1	81	0.0123457
NODE_42100_length_497_cov_1.909548	159	240	40	3	81	0.0370370
NODE_42100_length_497_cov_1.909548	159	240	46	3	81	0.0370370
NODE_42100_length_497_cov_1.909548	159	240	48	4	81	0.0493827
NODE_42100_length_497_cov_1.909548	159	240	50	3	81	0.0370370
NODE_42100_length_497_cov_1.909548	159	240	52	6	81	0.0740741
NODE_42100_length_497_cov_1.909548	159	240	54	8	81	0.0987654
NODE_42100_length_497_cov_1.909548	262	324	16	2	62	0.0322581
NODE_42100_length_497_cov_1.909548	262	324	18	5	62	0.0806452
NODE_42100_length_497_cov_1.909548	262	324	22	2	62	0.0322581
NODE_42100_length_497_cov_1.909548	262	324	23	1	62	0.0161290
NODE_42100_length_497_cov_1.909548	262	324	25	1	62	0.0161290
NODE_42100_length_497_cov_1.909548	262	324	29	2	62	0.0322581
NODE_42100_length_497_cov_1.909548	262	324	31	1	62	0.0161290
NODE_42100_length_497_cov_1.909548	262	324	33	1	62	0.0161290
NODE_42100_length_497_cov_1.909548	262	324	35	2	62	0.0322581
NODE_42100_length_497_cov_1.909548	262	324	36	1	62	0.0161290
NODE_42100_length_497_cov_1.909548	262	324	38	1	62	0.0161290
NODE_42100_length_497_cov_1.909548	262	324	40	4	62	0.0645161
NODE_42100_length_497_cov_1.909548	262	324	44	2	62	0.0322581
NODE_42100_length_497_cov_1.909548	262	324	46	8	62	0.1290323
NODE_42100_length_497_cov_1.909548	262	324	48	2	62	0.0322581
NODE_42100_length_497_cov_1.909548	262	324	50	27	62	0.4354839
NODE_42131_length_497_cov_1.500000	259	339	0	80	80	1.0000000
NODE_42136_length_497_cov_1.404523	211	263	0	52	52	1.0000000
NODE_42279_length_496_cov_5.619647	239	269	0	30	30	1.0000000
NODE_42281_length_496_cov_5.392947	103	168	0	65	65	1.0000000
NODE_42281_length_496_cov_5.392947	141	221	0	80	80	1.0000000
NODE_42281_length_496_cov_5.392947	217	295	0	78	78	1.0000000
NODE_42281_length_496_cov_5.392947	270	295	0	25	25	1.0000000
NODE_42287_length_496_cov_4.397985	388	467	0	27	79	0.3417721
NODE_42287_length_496_cov_4.397985	388	467	4	52	79	0.6582279
NODE_42288_length_496_cov_4.193955	235	315	0	12	80	0.1500000
NODE_42288_length_496_cov_4.193955	235	315	2	68	80	0.8500000
NODE_42297_length_496_cov_3.531486	192	273	2	8	81	0.0987654
NODE_42297_length_496_cov_3.531486	192	273	4	6	81	0.0740741
NODE_42297_length_496_cov_3.531486	192	273	5	9	81	0.1111111
NODE_42297_length_496_cov_3.531486	192	273	7	30	81	0.3703704
NODE_42297_length_496_cov_3.531486	192	273	8	24	81	0.2962963
NODE_42297_length_496_cov_3.531486	192	273	9	1	81	0.0123457
NODE_42297_length_496_cov_3.531486	192	273	10	3	81	0.0370370
NODE_42297_length_496_cov_3.531486	245	325	2	60	80	0.7500000
NODE_42297_length_496_cov_3.531486	245	325	4	6	80	0.0750000
NODE_42297_length_496_cov_3.531486	245	325	5	9	80	0.1125000
NODE_42297_length_496_cov_3.531486	245	325	7	5	80	0.0625000
NODE_42298_length_496_cov_3.377834	252	332	0	80	80	1.0000000
NODE_42298_length_496_cov_3.377834	305	383	0	78	78	1.0000000
NODE_42316_length_496_cov_2.659950	203	251	4	48	48	1.0000000
NODE_42328_length_496_cov_2.445844	95	165	0	14	70	0.2000000
NODE_42328_length_496_cov_2.445844	95	165	2	1	70	0.0142857
NODE_42328_length_496_cov_2.445844	95	165	4	55	70	0.7857143
NODE_42328_length_496_cov_2.445844	148	228	0	22	80	0.2750000
NODE_42328_length_496_cov_2.445844	148	228	2	22	80	0.2750000
NODE_42328_length_496_cov_2.445844	148	228	4	36	80	0.4500000
NODE_42333_length_496_cov_2.214106	299	359	0	4	60	0.0666667
NODE_42333_length_496_cov_2.214106	299	359	4	10	60	0.1666667
NODE_42333_length_496_cov_2.214106	299	359	6	46	60	0.7666667
NODE_42415_length_496_cov_1.395466	273	317	2	2	44	0.0454545
NODE_42415_length_496_cov_1.395466	273	317	4	42	44	0.9545454
NODE_42461_length_496_cov_0.979849	214	294	0	8	80	0.1000000
NODE_42461_length_496_cov_0.979849	214	294	2	26	80	0.3250000
NODE_42461_length_496_cov_0.979849	214	294	4	46	80	0.5750000
NODE_42525_length_495_cov_34.888889	209	264	0	55	55	1.0000000
NODE_42526_length_495_cov_12.800505	268	348	2	74	80	0.9250000
NODE_42526_length_495_cov_12.800505	268	348	3	1	80	0.0125000
NODE_42526_length_495_cov_12.800505	268	348	4	5	80	0.0625000
NODE_42526_length_495_cov_12.800505	321	401	2	74	80	0.9250000
NODE_42526_length_495_cov_12.800505	321	401	3	1	80	0.0125000
NODE_42526_length_495_cov_12.800505	321	401	4	5	80	0.0625000
NODE_42529_length_495_cov_7.080808	386	416	0	30	30	1.0000000
NODE_42548_length_495_cov_3.868687	218	298	0	14	80	0.1750000
NODE_42548_length_495_cov_3.868687	218	298	2	66	80	0.8250000
NODE_42736_length_495_cov_0.792929	274	309	6	24	35	0.6857143
NODE_42736_length_495_cov_0.792929	274	309	8	1	35	0.0285714
NODE_42736_length_495_cov_0.792929	274	309	10	10	35	0.2857143
NODE_42773_length_494_cov_20.096203	182	262	0	40	80	0.5000000
NODE_42773_length_494_cov_20.096203	182	262	8	40	80	0.5000000
NODE_42773_length_494_cov_20.096203	235	315	8	80	80	1.0000000
NODE_42778_length_494_cov_7.498734	187	240	0	21	53	0.3962264
NODE_42778_length_494_cov_7.498734	187	240	2	32	53	0.6037736
NODE_42788_length_494_cov_4.283544	255	332	0	36	77	0.4675325
NODE_42788_length_494_cov_4.283544	255	332	2	41	77	0.5324675
NODE_42804_length_494_cov_3.496203	209	276	0	52	67	0.7761194
NODE_42804_length_494_cov_3.496203	209	276	2	15	67	0.2238806
NODE_42812_length_494_cov_3.032911	385	432	2	5	47	0.1063830
NODE_42812_length_494_cov_3.032911	385	432	3	10	47	0.2127660
NODE_42812_length_494_cov_3.032911	385	432	4	3	47	0.0638298
NODE_42812_length_494_cov_3.032911	385	432	6	1	47	0.0212766
NODE_42812_length_494_cov_3.032911	385	432	8	6	47	0.1276596
NODE_42812_length_494_cov_3.032911	385	432	12	1	47	0.0212766
NODE_42812_length_494_cov_3.032911	385	432	16	1	47	0.0212766
NODE_42812_length_494_cov_3.032911	385	432	17	18	47	0.3829787
NODE_42812_length_494_cov_3.032911	385	432	19	2	47	0.0425532
NODE_42816_length_494_cov_2.908861	189	269	6	10	80	0.1250000
NODE_42816_length_494_cov_2.908861	189	269	10	1	80	0.0125000
NODE_42816_length_494_cov_2.908861	189	269	12	69	80	0.8625000
NODE_42822_length_494_cov_2.777215	145	188	0	43	43	1.0000000
NODE_42834_length_494_cov_2.531646	371	430	0	59	59	1.0000000
NODE_42834_length_494_cov_2.531646	428	494	0	66	66	1.0000000
NODE_43021_length_493_cov_34.946701	140	220	0	8	80	0.1000000
NODE_43021_length_493_cov_34.946701	140	220	2	72	80	0.9000000
NODE_43021_length_493_cov_34.946701	193	265	0	48	72	0.6666667
NODE_43021_length_493_cov_34.946701	193	265	2	24	72	0.3333333
NODE_43022_length_493_cov_12.451777	173	253	0	35	80	0.4375000
NODE_43022_length_493_cov_12.451777	173	253	2	45	80	0.5625000
NODE_43022_length_493_cov_12.451777	226	306	2	80	80	1.0000000
NODE_43025_length_493_cov_8.540609	116	146	23	2	30	0.0666667
NODE_43025_length_493_cov_8.540609	116	146	29	8	30	0.2666667
NODE_43025_length_493_cov_8.540609	116	146	31	1	30	0.0333333
NODE_43025_length_493_cov_8.540609	116	146	33	1	30	0.0333333
NODE_43025_length_493_cov_8.540609	116	146	35	1	30	0.0333333
NODE_43025_length_493_cov_8.540609	116	146	39	3	30	0.1000000
NODE_43025_length_493_cov_8.540609	116	146	40	1	30	0.0333333
NODE_43025_length_493_cov_8.540609	116	146	42	1	30	0.0333333
NODE_43025_length_493_cov_8.540609	116	146	44	4	30	0.1333333
NODE_43025_length_493_cov_8.540609	116	146	46	1	30	0.0333333
NODE_43025_length_493_cov_8.540609	116	146	47	5	30	0.1666667
NODE_43025_length_493_cov_8.540609	116	146	50	2	30	0.0666667
NODE_43025_length_493_cov_8.540609	119	199	29	7	80	0.0875000
NODE_43025_length_493_cov_8.540609	119	199	31	1	80	0.0125000
NODE_43025_length_493_cov_8.540609	119	199	33	1	80	0.0125000
NODE_43025_length_493_cov_8.540609	119	199	35	1	80	0.0125000
NODE_43025_length_493_cov_8.540609	119	199	39	3	80	0.0375000
NODE_43025_length_493_cov_8.540609	119	199	40	1	80	0.0125000
NODE_43025_length_493_cov_8.540609	119	199	42	1	80	0.0125000
NODE_43025_length_493_cov_8.540609	119	199	44	4	80	0.0500000
NODE_43025_length_493_cov_8.540609	119	199	46	1	80	0.0125000
NODE_43025_length_493_cov_8.540609	119	199	47	5	80	0.0625000
NODE_43025_length_493_cov_8.540609	119	199	50	2	80	0.0250000
NODE_43025_length_493_cov_8.540609	119	199	51	2	80	0.0250000
NODE_43025_length_493_cov_8.540609	119	199	52	1	80	0.0125000
NODE_43025_length_493_cov_8.540609	119	199	54	3	80	0.0375000
NODE_43025_length_493_cov_8.540609	119	199	55	2	80	0.0250000
NODE_43025_length_493_cov_8.540609	119	199	57	2	80	0.0250000
NODE_43025_length_493_cov_8.540609	119	199	59	1	80	0.0125000
NODE_43025_length_493_cov_8.540609	119	199	61	1	80	0.0125000
NODE_43025_length_493_cov_8.540609	119	199	63	1	80	0.0125000
NODE_43025_length_493_cov_8.540609	119	199	65	5	80	0.0625000
NODE_43025_length_493_cov_8.540609	119	199	67	4	80	0.0500000
NODE_43025_length_493_cov_8.540609	119	199	69	1	80	0.0125000
NODE_43025_length_493_cov_8.540609	119	199	73	2	80	0.0250000
NODE_43025_length_493_cov_8.540609	119	199	77	3	80	0.0375000
NODE_43025_length_493_cov_8.540609	119	199	79	2	80	0.0250000
NODE_43025_length_493_cov_8.540609	119	199	81	1	80	0.0125000
NODE_43025_length_493_cov_8.540609	119	199	82	1	80	0.0125000
NODE_43025_length_493_cov_8.540609	119	199	84	5	80	0.0625000
NODE_43025_length_493_cov_8.540609	119	199	86	5	80	0.0625000
NODE_43025_length_493_cov_8.540609	119	199	90	1	80	0.0125000
NODE_43025_length_493_cov_8.540609	119	199	96	1	80	0.0125000
NODE_43025_length_493_cov_8.540609	119	199	102	6	80	0.0750000
NODE_43025_length_493_cov_8.540609	119	199	106	1	80	0.0125000
NODE_43025_length_493_cov_8.540609	119	199	108	2	80	0.0250000
NODE_43031_length_493_cov_6.144670	300	380	0	8	80	0.1000000
NODE_43031_length_493_cov_6.144670	300	380	2	72	80	0.9000000
NODE_43031_length_493_cov_6.144670	353	433	0	47	80	0.5875000
NODE_43031_length_493_cov_6.144670	353	433	2	33	80	0.4125000
NODE_43046_length_493_cov_3.840102	178	258	0	80	80	1.0000000
NODE_43046_length_493_cov_3.840102	231	311	0	80	80	1.0000000
NODE_43125_length_493_cov_1.588832	126	206	0	80	80	1.0000000
NODE_43125_length_493_cov_1.588832	179	259	0	80	80	1.0000000
NODE_43261_length_492_cov_5.488550	117	197	0	80	80	1.0000000
NODE_43261_length_492_cov_5.488550	170	250	0	80	80	1.0000000
NODE_43270_length_492_cov_4.445293	158	234	0	14	76	0.1842105
NODE_43270_length_492_cov_4.445293	158	234	2	62	76	0.8157895
NODE_43270_length_492_cov_4.445293	207	285	0	65	78	0.8333333
NODE_43270_length_492_cov_4.445293	207	285	2	13	78	0.1666667
NODE_43273_length_492_cov_4.244275	272	315	0	43	43	1.0000000
NODE_43293_length_492_cov_3.297710	113	193	0	80	80	1.0000000
NODE_43528_length_491_cov_17.196429	138	218	0	8	80	0.1000000
NODE_43528_length_491_cov_17.196429	138	218	2	72	80	0.9000000
NODE_43528_length_491_cov_17.196429	191	271	0	39	80	0.4875000
NODE_43528_length_491_cov_17.196429	191	271	2	41	80	0.5125000
NODE_43529_length_491_cov_17.193878	77	157	0	80	80	1.0000000
NODE_43529_length_491_cov_17.193878	130	210	0	80	80	1.0000000
NODE_43535_length_491_cov_5.505102	215	284	0	32	69	0.4637681
NODE_43535_length_491_cov_5.505102	215	284	2	13	69	0.1884058
NODE_43535_length_491_cov_5.505102	215	284	6	24	69	0.3478261
NODE_43535_length_491_cov_5.505102	215	295	0	32	80	0.4000000
NODE_43535_length_491_cov_5.505102	215	295	2	13	80	0.1625000
NODE_43535_length_491_cov_5.505102	215	295	6	35	80	0.4375000
NODE_43535_length_491_cov_5.505102	268	348	4	18	80	0.2250000
NODE_43535_length_491_cov_5.505102	268	348	6	62	80	0.7750000
NODE_43536_length_491_cov_5.477041	169	222	0	44	53	0.8301887
NODE_43536_length_491_cov_5.477041	169	222	4	9	53	0.1698113
NODE_43546_length_491_cov_4.176020	383	449	8	1	66	0.0151515
NODE_43546_length_491_cov_4.176020	383	449	14	1	66	0.0151515
NODE_43546_length_491_cov_4.176020	383	449	18	64	66	0.9696970
NODE_43546_length_491_cov_4.176020	422	476	10	3	54	0.0555556
NODE_43546_length_491_cov_4.176020	422	476	12	2	54	0.0370370
NODE_43546_length_491_cov_4.176020	422	476	14	2	54	0.0370370
NODE_43546_length_491_cov_4.176020	422	476	16	14	54	0.2592593
NODE_43546_length_491_cov_4.176020	422	476	18	33	54	0.6111111
NODE_43570_length_491_cov_2.887755	348	428	0	18	80	0.2250000
NODE_43570_length_491_cov_2.887755	348	428	2	62	80	0.7750000
NODE_43570_length_491_cov_2.887755	401	472	0	53	71	0.7464789
NODE_43570_length_491_cov_2.887755	401	472	2	18	71	0.2535211
NODE_43575_length_491_cov_2.693878	239	316	2	34	77	0.4415585
NODE_43575_length_491_cov_2.693878	239	316	4	41	77	0.5324675
NODE_43575_length_491_cov_2.693878	239	316	5	2	77	0.0259740
NODE_43744_length_490_cov_10.058824	192	272	0	80	80	1.0000000
NODE_43744_length_490_cov_10.058824	245	325	0	80	80	1.0000000
NODE_43748_length_490_cov_6.652174	304	363	0	59	59	1.0000000
NODE_43816_length_490_cov_2.212276	241	300	2	10	59	0.1694915
NODE_43816_length_490_cov_2.212276	241	300	4	49	59	0.8305085
NODE_43816_length_490_cov_2.212276	280	358	0	26	78	0.3333333
NODE_43816_length_490_cov_2.212276	280	358	2	36	78	0.4615385
NODE_43816_length_490_cov_2.212276	280	358	4	16	78	0.2051282
NODE_43886_length_490_cov_1.360614	97	159	2	20	62	0.3225806
NODE_43886_length_490_cov_1.360614	97	159	4	42	62	0.6774194
NODE_43886_length_490_cov_1.360614	132	212	0	10	80	0.1250000
NODE_43886_length_490_cov_1.360614	132	212	2	19	80	0.2375000
NODE_43886_length_490_cov_1.360614	132	212	4	51	80	0.6375000
NODE_43993_length_489_cov_55.992308	50	130	0	8	80	0.1000000
NODE_43993_length_489_cov_55.992308	50	130	4	24	80	0.3000000
NODE_43993_length_489_cov_55.992308	50	130	10	48	80	0.6000000
NODE_43993_length_489_cov_55.992308	103	183	6	1	80	0.0125000
NODE_43993_length_489_cov_55.992308	103	183	10	79	80	0.9875000
NODE_43993_length_489_cov_55.992308	179	259	0	73	80	0.9125000
NODE_43993_length_489_cov_55.992308	179	259	6	4	80	0.0500000
NODE_43993_length_489_cov_55.992308	179	259	10	3	80	0.0375000
NODE_43993_length_489_cov_55.992308	232	312	0	80	80	1.0000000
NODE_43994_length_489_cov_31.707692	299	384	8	3	85	0.0352941
NODE_43994_length_489_cov_31.707692	299	384	12	2	85	0.0235294
NODE_43994_length_489_cov_31.707692	299	384	24	69	85	0.8117647
NODE_43994_length_489_cov_31.707692	299	384	26	2	85	0.0235294
NODE_43994_length_489_cov_31.707692	299	384	27	1	85	0.0117647
NODE_43994_length_489_cov_31.707692	299	384	28	8	85	0.0941176
NODE_43994_length_489_cov_31.707692	299	384	8	3	85	0.0352941
NODE_43994_length_489_cov_31.707692	299	384	12	2	85	0.0235294
NODE_43994_length_489_cov_31.707692	299	384	24	69	85	0.8117647
NODE_43994_length_489_cov_31.707692	299	384	26	2	85	0.0235294
NODE_43994_length_489_cov_31.707692	299	384	27	1	85	0.0117647
NODE_43994_length_489_cov_31.707692	299	384	28	8	85	0.0941176
NODE_43996_length_489_cov_13.661538	227	307	4	77	80	0.9625000
NODE_43996_length_489_cov_13.661538	227	307	6	3	80	0.0375000
NODE_43996_length_489_cov_13.661538	280	358	4	24	78	0.3076923
NODE_43996_length_489_cov_13.661538	280	358	6	54	78	0.6923077
NODE_43997_length_489_cov_12.017949	214	294	0	20	80	0.2500000
NODE_43997_length_489_cov_12.017949	214	294	2	60	80	0.7500000
NODE_43997_length_489_cov_12.017949	267	347	0	17	80	0.2125000
NODE_43997_length_489_cov_12.017949	267	347	2	63	80	0.7875000
NODE_43998_length_489_cov_10.774359	262	304	2	6	42	0.1428571
NODE_43998_length_489_cov_10.774359	262	304	7	10	42	0.2380952
NODE_43998_length_489_cov_10.774359	262	304	8	26	42	0.6190476
NODE_44001_length_489_cov_8.094872	141	221	1	5	80	0.0625000
NODE_44001_length_489_cov_8.094872	141	221	2	56	80	0.7000000
NODE_44001_length_489_cov_8.094872	141	221	3	19	80	0.2375000
NODE_44001_length_489_cov_8.094872	194	247	2	49	53	0.9245283
NODE_44001_length_489_cov_8.094872	194	247	4	3	53	0.0566038
NODE_44001_length_489_cov_8.094872	194	247	8	1	53	0.0188679
NODE_44007_length_489_cov_5.284615	176	256	0	80	80	1.0000000
NODE_44007_length_489_cov_5.284615	229	309	0	80	80	1.0000000
NODE_44096_length_489_cov_1.646154	234	278	0	44	44	1.0000000
NODE_44105_length_489_cov_1.574359	351	391	2	26	40	0.6500000
NODE_44105_length_489_cov_1.574359	351	391	4	14	40	0.3500000
NODE_44105_length_489_cov_1.574359	351	383	2	26	32	0.8125000
NODE_44105_length_489_cov_1.574359	351	383	4	6	32	0.1875000
NODE_44105_length_489_cov_1.574359	365	445	0	12	80	0.1500000
NODE_44105_length_489_cov_1.574359	365	445	2	54	80	0.6750000
NODE_44105_length_489_cov_1.574359	365	445	4	14	80	0.1750000
NODE_44105_length_489_cov_1.574359	365	445	0	12	80	0.1500000
NODE_44105_length_489_cov_1.574359	365	445	2	54	80	0.6750000
NODE_44105_length_489_cov_1.574359	365	445	4	14	80	0.1750000
NODE_44105_length_489_cov_1.574359	366	445	0	12	79	0.1518987
NODE_44105_length_489_cov_1.574359	366	445	2	53	79	0.6708861
NODE_44105_length_489_cov_1.574359	366	445	4	14	79	0.1772152
NODE_44231_length_488_cov_15.406170	235	313	0	38	78	0.4871795
NODE_44231_length_488_cov_15.406170	235	313	4	40	78	0.5128205
NODE_44231_length_488_cov_15.406170	286	367	0	15	81	0.1851852
NODE_44231_length_488_cov_15.406170	286	367	4	66	81	0.8148148
NODE_44234_length_488_cov_8.416452	210	290	0	80	80	1.0000000
NODE_44234_length_488_cov_8.416452	263	343	0	80	80	1.0000000
NODE_44240_length_488_cov_6.084833	254	302	6	48	48	1.0000000
NODE_44243_length_488_cov_5.434447	210	279	0	31	69	0.4492754
NODE_44243_length_488_cov_5.434447	210	279	2	38	69	0.5507246
NODE_44243_length_488_cov_5.434447	265	300	2	35	35	1.0000000
NODE_44263_length_488_cov_3.431877	212	248	0	12	36	0.3333333
NODE_44263_length_488_cov_3.431877	212	248	2	24	36	0.6666667
NODE_44264_length_488_cov_3.424165	320	367	0	47	47	1.0000000
NODE_44264_length_488_cov_3.424165	320	378	0	58	58	1.0000000
NODE_44264_length_488_cov_3.424165	351	393	0	36	42	0.8571429
NODE_44264_length_488_cov_3.424165	351	393	2	6	42	0.1428571
NODE_44264_length_488_cov_3.424165	360	395	0	27	35	0.7714286
NODE_44264_length_488_cov_3.424165	360	395	2	8	35	0.2285714
NODE_44274_length_488_cov_2.850900	276	356	0	49	80	0.6125000
NODE_44274_length_488_cov_2.850900	276	356	2	31	80	0.3875000
NODE_44376_length_488_cov_1.562982	31	67	0	36	36	1.0000000
NODE_44496_length_487_cov_7.028351	278	358	12	1	80	0.0125000
NODE_44496_length_487_cov_7.028351	278	358	14	5	80	0.0625000
NODE_44496_length_487_cov_7.028351	278	358	16	10	80	0.1250000
NODE_44496_length_487_cov_7.028351	278	358	18	8	80	0.1000000
NODE_44496_length_487_cov_7.028351	278	358	20	56	80	0.7000000
NODE_44498_length_487_cov_6.804124	242	313	0	18	71	0.2535211
NODE_44498_length_487_cov_6.804124	242	313	2	17	71	0.2394366
NODE_44498_length_487_cov_6.804124	242	313	4	36	71	0.5070422
NODE_44498_length_487_cov_6.804124	286	366	0	71	80	0.8875000
NODE_44498_length_487_cov_6.804124	286	366	2	9	80	0.1125000
NODE_44500_length_487_cov_5.917526	140	220	0	80	80	1.0000000
NODE_44500_length_487_cov_5.917526	193	273	0	57	80	0.7125000
NODE_44500_length_487_cov_5.917526	193	273	2	23	80	0.2875000
NODE_44520_length_487_cov_3.296392	235	315	0	38	80	0.4750000
NODE_44520_length_487_cov_3.296392	235	315	2	4	80	0.0500000
NODE_44520_length_487_cov_3.296392	235	315	4	3	80	0.0375000
NODE_44520_length_487_cov_3.296392	235	315	8	3	80	0.0375000
NODE_44520_length_487_cov_3.296392	235	315	10	2	80	0.0250000
NODE_44520_length_487_cov_3.296392	235	315	12	3	80	0.0375000
NODE_44520_length_487_cov_3.296392	235	315	14	2	80	0.0250000
NODE_44520_length_487_cov_3.296392	235	315	16	8	80	0.1000000
NODE_44520_length_487_cov_3.296392	235	315	18	17	80	0.2125000
NODE_44521_length_487_cov_3.237113	301	363	2	46	62	0.7419355
NODE_44521_length_487_cov_3.237113	301	363	4	16	62	0.2580645
NODE_44525_length_487_cov_3.074742	214	294	4	21	80	0.2625000
NODE_44525_length_487_cov_3.074742	214	294	8	36	80	0.4500000
NODE_44525_length_487_cov_3.074742	214	294	14	4	80	0.0500000
NODE_44525_length_487_cov_3.074742	214	294	16	4	80	0.0500000
NODE_44525_length_487_cov_3.074742	214	294	20	15	80	0.1875000
NODE_44723_length_486_cov_6.609819	206	286	0	61	80	0.7625000
NODE_44723_length_486_cov_6.609819	206	286	4	19	80	0.2375000
NODE_44728_length_486_cov_5.428941	147	227	0	6	80	0.0750000
NODE_44728_length_486_cov_5.428941	147	227	2	44	80	0.5500000
NODE_44728_length_486_cov_5.428941	147	227	4	30	80	0.3750000
NODE_44754_length_486_cov_3.072351	131	211	0	25	80	0.3125000
NODE_44754_length_486_cov_3.072351	131	211	2	55	80	0.6875000
NODE_44754_length_486_cov_3.072351	190	235	0	45	45	1.0000000
NODE_44769_length_486_cov_2.581395	156	236	0	80	80	1.0000000
NODE_44769_length_486_cov_2.581395	209	289	0	80	80	1.0000000
NODE_44781_length_486_cov_2.343669	189	230	2	41	41	1.0000000
NODE_44781_length_486_cov_2.343669	242	306	0	58	64	0.9062500
NODE_44781_length_486_cov_2.343669	242	306	2	6	64	0.0937500
NODE_44959_length_485_cov_29.505181	270	350	0	80	80	1.0000000
NODE_44959_length_485_cov_29.505181	323	403	0	52	80	0.6500000
NODE_44959_length_485_cov_29.505181	323	403	2	28	80	0.3500000
NODE_44959_length_485_cov_29.505181	399	479	0	16	80	0.2000000
NODE_44959_length_485_cov_29.505181	399	479	2	64	80	0.8000000
NODE_44960_length_485_cov_10.450777	67	153	0	86	86	1.0000000
NODE_44960_length_485_cov_10.450777	133	206	0	73	73	1.0000000
NODE_44965_length_485_cov_5.922280	196	273	0	30	77	0.3896104
NODE_44965_length_485_cov_5.922280	196	273	2	47	77	0.6103896
NODE_44965_length_485_cov_5.922280	246	326	2	80	80	1.0000000
NODE_44966_length_485_cov_5.818653	279	359	0	80	80	1.0000000
NODE_44966_length_485_cov_5.818653	332	412	0	80	80	1.0000000
NODE_44968_length_485_cov_5.670984	321	396	0	70	75	0.9333333
NODE_44968_length_485_cov_5.670984	321	396	2	5	75	0.0666667
NODE_44992_length_485_cov_3.518135	162	210	0	48	48	1.0000000
NODE_45005_length_485_cov_2.790155	193	253	0	60	60	1.0000000
NODE_45021_length_485_cov_2.427461	170	249	0	79	79	1.0000000
NODE_45100_length_485_cov_1.264249	232	251	2	14	19	0.7368421
NODE_45100_length_485_cov_1.264249	232	251	3	5	19	0.2631579
NODE_45193_length_484_cov_33.384416	92	172	0	80	80	1.0000000
NODE_45193_length_484_cov_33.384416	145	225	0	80	80	1.0000000
NODE_45195_length_484_cov_9.111688	136	216	0	80	80	1.0000000
NODE_45195_length_484_cov_9.111688	189	270	0	69	81	0.8518519
NODE_45195_length_484_cov_9.111688	189	270	2	7	81	0.0864198
NODE_45195_length_484_cov_9.111688	189	270	4	5	81	0.0617284
NODE_45196_length_484_cov_8.353247	165	244	0	79	79	1.0000000
NODE_45196_length_484_cov_8.353247	217	297	0	80	80	1.0000000
NODE_45197_length_484_cov_8.119481	108	188	0	80	80	1.0000000
NODE_45197_length_484_cov_8.119481	161	241	0	36	80	0.4500000
NODE_45197_length_484_cov_8.119481	161	241	2	44	80	0.5500000
NODE_45200_length_484_cov_7.703896	208	288	0	32	80	0.4000000
NODE_45200_length_484_cov_7.703896	208	288	4	48	80	0.6000000
NODE_45200_length_484_cov_7.703896	261	341	0	53	80	0.6625000
NODE_45200_length_484_cov_7.703896	261	341	2	27	80	0.3375000
NODE_45202_length_484_cov_7.153247	230	292	0	62	62	1.0000000
NODE_45204_length_484_cov_6.594805	221	301	0	80	80	1.0000000
NODE_45204_length_484_cov_6.594805	274	354	0	80	80	1.0000000
NODE_45218_length_484_cov_4.044156	267	347	6	30	80	0.3750000
NODE_45218_length_484_cov_4.044156	267	347	7	26	80	0.3250000
NODE_45218_length_484_cov_4.044156	267	347	8	24	80	0.3000000
NODE_45218_length_484_cov_4.044156	342	396	0	16	54	0.2962963
NODE_45218_length_484_cov_4.044156	342	396	2	18	54	0.3333333
NODE_45218_length_484_cov_4.044156	342	396	5	2	54	0.0370370
NODE_45218_length_484_cov_4.044156	342	396	7	18	54	0.3333333
NODE_45225_length_484_cov_3.787013	287	331	0	44	44	1.0000000
NODE_45225_length_484_cov_3.787013	307	386	0	42	79	0.5316456
NODE_45225_length_484_cov_3.787013	307	386	2	37	79	0.4683544
NODE_45225_length_484_cov_3.787013	317	386	0	32	69	0.4637681
NODE_45225_length_484_cov_3.787013	317	386	2	37	69	0.5362319
NODE_45276_length_484_cov_2.254545	79	132	2	23	53	0.4339623
NODE_45276_length_484_cov_2.254545	79	132	4	30	53	0.5660377
NODE_45352_length_484_cov_1.322078	429	477	0	48	48	1.0000000
NODE_45353_length_484_cov_1.314286	431	472	0	41	41	1.0000000
NODE_45459_length_483_cov_40.815104	396	473	0	77	77	1.0000000
NODE_45459_length_483_cov_40.815104	396	473	0	77	77	1.0000000
NODE_45473_length_483_cov_5.289062	124	185	0	61	61	1.0000000
NODE_45494_length_483_cov_4.114583	226	306	0	2	80	0.0250000
NODE_45494_length_483_cov_4.114583	226	306	1	9	80	0.1125000
NODE_45494_length_483_cov_4.114583	226	306	3	2	80	0.0250000
NODE_45494_length_483_cov_4.114583	226	306	4	67	80	0.8375000
NODE_45494_length_483_cov_4.114583	226	305	0	2	79	0.0253165
NODE_45494_length_483_cov_4.114583	226	305	1	8	79	0.1012658
NODE_45494_length_483_cov_4.114583	226	305	3	2	79	0.0253165
NODE_45494_length_483_cov_4.114583	226	305	4	67	79	0.8481013
NODE_45494_length_483_cov_4.114583	226	306	0	2	80	0.0250000
NODE_45494_length_483_cov_4.114583	226	306	1	9	80	0.1125000
NODE_45494_length_483_cov_4.114583	226	306	3	2	80	0.0250000
NODE_45494_length_483_cov_4.114583	226	306	4	67	80	0.8375000
NODE_45494_length_483_cov_4.114583	226	306	0	2	80	0.0250000
NODE_45494_length_483_cov_4.114583	226	306	1	9	80	0.1125000
NODE_45494_length_483_cov_4.114583	226	306	3	2	80	0.0250000
NODE_45494_length_483_cov_4.114583	226	306	4	67	80	0.8375000
NODE_45494_length_483_cov_4.114583	279	359	0	2	80	0.0250000
NODE_45494_length_483_cov_4.114583	279	359	1	9	80	0.1125000
NODE_45494_length_483_cov_4.114583	279	359	2	53	80	0.6625000
NODE_45494_length_483_cov_4.114583	279	359	4	16	80	0.2000000
NODE_45494_length_483_cov_4.114583	279	325	0	2	46	0.0434783
NODE_45494_length_483_cov_4.114583	279	325	1	9	46	0.1956522
NODE_45494_length_483_cov_4.114583	279	325	2	19	46	0.4130435
NODE_45494_length_483_cov_4.114583	279	325	4	16	46	0.3478261
NODE_45494_length_483_cov_4.114583	297	323	1	9	26	0.3461539
NODE_45494_length_483_cov_4.114583	297	323	2	17	26	0.6538461
NODE_45495_length_483_cov_4.046875	68	117	0	49	49	1.0000000
NODE_45495_length_483_cov_4.046875	184	250	0	44	66	0.6666667
NODE_45495_length_483_cov_4.046875	184	250	1	22	66	0.3333333
NODE_45635_length_483_cov_1.205729	249	291	0	2	42	0.0476190
NODE_45635_length_483_cov_1.205729	249	291	2	40	42	0.9523810
NODE_45725_length_482_cov_37.900783	72	152	0	19	80	0.2375000
NODE_45725_length_482_cov_37.900783	72	152	2	61	80	0.7625000
NODE_45725_length_482_cov_37.900783	125	205	0	25	80	0.3125000
NODE_45725_length_482_cov_37.900783	125	205	2	55	80	0.6875000
NODE_45728_length_482_cov_10.545692	233	297	0	64	64	1.0000000
NODE_45729_length_482_cov_9.342037	281	333	0	52	52	1.0000000
NODE_45730_length_482_cov_8.190601	247	311	7	4	64	0.0625000
NODE_45730_length_482_cov_8.190601	247	311	8	2	64	0.0312500
NODE_45730_length_482_cov_8.190601	247	311	10	2	64	0.0312500
NODE_45730_length_482_cov_8.190601	247	311	12	4	64	0.0625000
NODE_45730_length_482_cov_8.190601	247	311	14	5	64	0.0781250
NODE_45730_length_482_cov_8.190601	247	311	16	20	64	0.3125000
NODE_45730_length_482_cov_8.190601	247	311	17	25	64	0.3906250
NODE_45730_length_482_cov_8.190601	247	311	18	2	64	0.0312500
NODE_45730_length_482_cov_8.190601	284	355	4	27	71	0.3802817
NODE_45730_length_482_cov_8.190601	284	355	6	7	71	0.0985916
NODE_45730_length_482_cov_8.190601	284	355	7	14	71	0.1971831
NODE_45730_length_482_cov_8.190601	284	355	8	2	71	0.0281690
NODE_45730_length_482_cov_8.190601	284	355	10	2	71	0.0281690
NODE_45730_length_482_cov_8.190601	284	355	12	4	71	0.0563380
NODE_45730_length_482_cov_8.190601	284	355	14	5	71	0.0704225
NODE_45730_length_482_cov_8.190601	284	355	16	8	71	0.1126761
NODE_45730_length_482_cov_8.190601	284	355	18	2	71	0.0281690
NODE_45734_length_482_cov_6.002611	112	192	0	80	80	1.0000000
NODE_45734_length_482_cov_6.002611	165	245	0	80	80	1.0000000
NODE_45735_length_482_cov_5.953003	315	395	0	80	80	1.0000000
NODE_45735_length_482_cov_5.953003	368	441	0	73	73	1.0000000
NODE_45748_length_482_cov_4.530026	20	85	0	65	65	1.0000000
NODE_45759_length_482_cov_3.791123	278	358	0	80	80	1.0000000
NODE_45759_length_482_cov_3.791123	331	411	0	59	80	0.7375000
NODE_45759_length_482_cov_3.791123	331	411	2	21	80	0.2625000
NODE_45842_length_482_cov_1.647520	382	446	0	64	64	1.0000000
NODE_45842_length_482_cov_1.647520	435	482	0	47	47	1.0000000
NODE_45994_length_481_cov_50.623037	154	234	0	80	80	1.0000000
NODE_45994_length_481_cov_50.623037	207	287	0	80	80	1.0000000
NODE_45995_length_481_cov_30.939791	149	198	4	4	49	0.0816327
NODE_45995_length_481_cov_30.939791	149	198	5	4	49	0.0816327
NODE_45995_length_481_cov_30.939791	149	198	7	21	49	0.4285714
NODE_45995_length_481_cov_30.939791	149	198	8	20	49	0.4081633
NODE_45995_length_481_cov_30.939791	171	235	4	22	64	0.3437500
NODE_45995_length_481_cov_30.939791	171	235	7	12	64	0.1875000
NODE_45995_length_481_cov_30.939791	171	235	8	30	64	0.4687500
NODE_45995_length_481_cov_30.939791	171	235	4	22	64	0.3437500
NODE_45995_length_481_cov_30.939791	171	235	7	12	64	0.1875000
NODE_45995_length_481_cov_30.939791	171	235	8	30	64	0.4687500
NODE_45996_length_481_cov_30.183246	0	41	0	36	41	0.8780488
NODE_45996_length_481_cov_30.183246	0	41	4	4	41	0.0975610
NODE_45996_length_481_cov_30.183246	0	41	7	1	41	0.0243902
NODE_45996_length_481_cov_30.183246	0	39	0	36	39	0.9230769
NODE_45996_length_481_cov_30.183246	0	39	4	3	39	0.0769231
NODE_45996_length_481_cov_30.183246	0	44	0	36	44	0.8181818
NODE_45996_length_481_cov_30.183246	0	44	4	4	44	0.0909091
NODE_45996_length_481_cov_30.183246	0	44	7	1	44	0.0227273
NODE_45996_length_481_cov_30.183246	0	44	8	3	44	0.0681818
NODE_45996_length_481_cov_30.183246	0	44	0	36	44	0.8181818
NODE_45996_length_481_cov_30.183246	0	44	4	4	44	0.0909091
NODE_45996_length_481_cov_30.183246	0	44	7	1	44	0.0227273
NODE_45996_length_481_cov_30.183246	0	44	8	3	44	0.0681818
NODE_45996_length_481_cov_30.183246	0	44	0	36	44	0.8181818
NODE_45996_length_481_cov_30.183246	0	44	4	4	44	0.0909091
NODE_45996_length_481_cov_30.183246	0	44	7	1	44	0.0227273
NODE_45996_length_481_cov_30.183246	0	44	8	3	44	0.0681818
NODE_45996_length_481_cov_30.183246	0	44	0	36	44	0.8181818
NODE_45996_length_481_cov_30.183246	0	44	4	4	44	0.0909091
NODE_45996_length_481_cov_30.183246	0	44	7	1	44	0.0227273
NODE_45996_length_481_cov_30.183246	0	44	8	3	44	0.0681818
NODE_45996_length_481_cov_30.183246	17	97	0	19	80	0.2375000
NODE_45996_length_481_cov_30.183246	17	97	4	4	80	0.0500000
NODE_45996_length_481_cov_30.183246	17	97	7	1	80	0.0125000
NODE_45996_length_481_cov_30.183246	17	97	8	56	80	0.7000000
NODE_45996_length_481_cov_30.183246	17	97	0	19	80	0.2375000
NODE_45996_length_481_cov_30.183246	17	97	4	4	80	0.0500000
NODE_45996_length_481_cov_30.183246	17	97	7	1	80	0.0125000
NODE_45996_length_481_cov_30.183246	17	97	8	56	80	0.7000000
NODE_45996_length_481_cov_30.183246	17	97	0	19	80	0.2375000
NODE_45996_length_481_cov_30.183246	17	97	4	4	80	0.0500000
NODE_45996_length_481_cov_30.183246	17	97	7	1	80	0.0125000
NODE_45996_length_481_cov_30.183246	17	97	8	56	80	0.7000000
NODE_45996_length_481_cov_30.183246	17	97	0	19	80	0.2375000
NODE_45996_length_481_cov_30.183246	17	97	4	4	80	0.0500000
NODE_45996_length_481_cov_30.183246	17	97	7	1	80	0.0125000
NODE_45996_length_481_cov_30.183246	17	97	8	56	80	0.7000000
NODE_45996_length_481_cov_30.183246	17	97	0	19	80	0.2375000
NODE_45996_length_481_cov_30.183246	17	97	4	4	80	0.0500000
NODE_45996_length_481_cov_30.183246	17	97	7	1	80	0.0125000
NODE_45996_length_481_cov_30.183246	17	97	8	56	80	0.7000000
NODE_45996_length_481_cov_30.183246	17	97	0	19	80	0.2375000
NODE_45996_length_481_cov_30.183246	17	97	4	4	80	0.0500000
NODE_45996_length_481_cov_30.183246	17	97	7	1	80	0.0125000
NODE_45996_length_481_cov_30.183246	17	97	8	56	80	0.7000000
NODE_45997_length_481_cov_12.709424	250	330	14	14	80	0.1750000
NODE_45997_length_481_cov_12.709424	250	330	16	4	80	0.0500000
NODE_45997_length_481_cov_12.709424	250	330	22	7	80	0.0875000
NODE_45997_length_481_cov_12.709424	250	330	26	26	80	0.3250000
NODE_45997_length_481_cov_12.709424	250	330	27	29	80	0.3625000
NODE_45997_length_481_cov_12.709424	303	383	14	11	80	0.1375000
NODE_45997_length_481_cov_12.709424	303	383	16	2	80	0.0250000
NODE_45997_length_481_cov_12.709424	303	383	23	6	80	0.0750000
NODE_45997_length_481_cov_12.709424	303	383	24	6	80	0.0750000
NODE_45997_length_481_cov_12.709424	303	383	25	5	80	0.0625000
NODE_45997_length_481_cov_12.709424	303	383	26	2	80	0.0250000
NODE_45997_length_481_cov_12.709424	303	383	27	30	80	0.3750000
NODE_45997_length_481_cov_12.709424	303	383	28	7	80	0.0875000
NODE_45997_length_481_cov_12.709424	303	383	29	2	80	0.0250000
NODE_45997_length_481_cov_12.709424	303	383	30	9	80	0.1125000
NODE_46037_length_481_cov_3.002618	197	277	0	80	80	1.0000000
NODE_46064_length_481_cov_2.261780	271	351	2	18	80	0.2250000
NODE_46064_length_481_cov_2.261780	271	351	4	24	80	0.3000000
NODE_46064_length_481_cov_2.261780	271	351	6	38	80	0.4750000
NODE_46256_length_480_cov_22.346457	318	398	6	55	80	0.6875000
NODE_46256_length_480_cov_22.346457	318	398	8	25	80	0.3125000
NODE_46256_length_480_cov_22.346457	371	451	0	45	80	0.5625000
NODE_46256_length_480_cov_22.346457	371	451	6	35	80	0.4375000
NODE_46257_length_480_cov_16.488189	252	332	2	80	80	1.0000000
NODE_46257_length_480_cov_16.488189	305	385	0	50	80	0.6250000
NODE_46257_length_480_cov_16.488189	305	385	2	30	80	0.3750000
NODE_46258_length_480_cov_12.874016	164	234	5	17	70	0.2428571
NODE_46258_length_480_cov_12.874016	164	234	6	47	70	0.6714286
NODE_46258_length_480_cov_12.874016	164	234	8	6	70	0.0857143
NODE_46258_length_480_cov_12.874016	207	273	3	20	66	0.3030303
NODE_46258_length_480_cov_12.874016	207	273	5	36	66	0.5454546
NODE_46258_length_480_cov_12.874016	207	273	6	6	66	0.0909091
NODE_46258_length_480_cov_12.874016	207	273	8	4	66	0.0606061
NODE_46260_length_480_cov_11.879265	170	250	0	74	80	0.9250000
NODE_46260_length_480_cov_11.879265	170	250	2	6	80	0.0750000
NODE_46260_length_480_cov_11.879265	223	303	0	80	80	1.0000000
NODE_46261_length_480_cov_8.774278	114	143	0	29	29	1.0000000
NODE_46261_length_480_cov_8.774278	165	245	4	80	80	1.0000000
NODE_46261_length_480_cov_8.774278	218	298	0	50	80	0.6250000
NODE_46261_length_480_cov_8.774278	218	298	4	30	80	0.3750000
NODE_46261_length_480_cov_8.774278	385	428	2	43	43	1.0000000
NODE_46271_length_480_cov_5.671916	231	302	0	71	71	1.0000000
NODE_46283_length_480_cov_4.354331	126	187	4	6	61	0.0983607
NODE_46283_length_480_cov_4.354331	126	187	6	55	61	0.9016393
NODE_46283_length_480_cov_4.354331	218	298	0	18	80	0.2250000
NODE_46283_length_480_cov_4.354331	218	298	2	62	80	0.7750000
NODE_46445_length_480_cov_1.152231	142	216	0	63	74	0.8513514
NODE_46445_length_480_cov_1.152231	142	216	2	11	74	0.1486486
NODE_46470_length_480_cov_0.973753	31	71	0	34	40	0.8500000
NODE_46470_length_480_cov_0.973753	31	71	2	6	40	0.1500000
NODE_46533_length_479_cov_28.205263	308	388	0	80	80	1.0000000
NODE_46533_length_479_cov_28.205263	361	441	0	80	80	1.0000000
NODE_46534_length_479_cov_23.944737	189	269	8	4	80	0.0500000
NODE_46534_length_479_cov_23.944737	189	269	10	44	80	0.5500000
NODE_46534_length_479_cov_23.944737	189	269	12	32	80	0.4000000
NODE_46534_length_479_cov_23.944737	242	322	0	20	80	0.2500000
NODE_46534_length_479_cov_23.944737	242	322	4	8	80	0.1000000
NODE_46534_length_479_cov_23.944737	242	322	6	9	80	0.1125000
NODE_46534_length_479_cov_23.944737	242	322	10	32	80	0.4000000
NODE_46534_length_479_cov_23.944737	242	322	12	11	80	0.1375000
NODE_46554_length_479_cov_4.942105	283	363	0	80	80	1.0000000
NODE_46554_length_479_cov_4.942105	336	416	0	80	80	1.0000000
NODE_46574_length_479_cov_3.494737	217	279	0	62	62	1.0000000
NODE_46574_length_479_cov_3.494737	272	332	0	60	60	1.0000000
NODE_46611_length_479_cov_2.281579	219	265	14	8	46	0.1739130
NODE_46611_length_479_cov_2.281579	219	265	16	2	46	0.0434783
NODE_46611_length_479_cov_2.281579	219	265	18	2	46	0.0434783
NODE_46611_length_479_cov_2.281579	219	265	22	12	46	0.2608696
NODE_46611_length_479_cov_2.281579	219	265	24	2	46	0.0434783
NODE_46611_length_479_cov_2.281579	219	265	26	2	46	0.0434783
NODE_46611_length_479_cov_2.281579	219	265	28	1	46	0.0217391
NODE_46611_length_479_cov_2.281579	219	265	29	2	46	0.0434783
NODE_46611_length_479_cov_2.281579	219	265	33	15	46	0.3260870
NODE_46638_length_479_cov_1.839474	376	431	4	55	55	1.0000000
NODE_46654_length_479_cov_1.710526	203	265	0	5	62	0.0806452
NODE_46654_length_479_cov_1.710526	203	265	1	1	62	0.0161290
NODE_46654_length_479_cov_1.710526	203	265	2	56	62	0.9032258
NODE_46654_length_479_cov_1.710526	248	318	2	70	70	1.0000000
NODE_46828_length_478_cov_336.139842	153	233	205	2	80	0.0250000
NODE_46828_length_478_cov_336.139842	153	233	210	1	80	0.0125000
NODE_46828_length_478_cov_336.139842	153	233	211	1	80	0.0125000
NODE_46828_length_478_cov_336.139842	153	233	217	1	80	0.0125000
NODE_46828_length_478_cov_336.139842	153	233	218	2	80	0.0250000
NODE_46828_length_478_cov_336.139842	153	233	224	2	80	0.0250000
NODE_46828_length_478_cov_336.139842	153	233	230	1	80	0.0125000
NODE_46828_length_478_cov_336.139842	153	233	236	1	80	0.0125000
NODE_46828_length_478_cov_336.139842	153	233	255	1	80	0.0125000
NODE_46828_length_478_cov_336.139842	153	233	267	1	80	0.0125000
NODE_46828_length_478_cov_336.139842	153	233	270	1	80	0.0125000
NODE_46828_length_478_cov_336.139842	153	233	272	1	80	0.0125000
NODE_46828_length_478_cov_336.139842	153	233	274	4	80	0.0500000
NODE_46828_length_478_cov_336.139842	153	233	275	1	80	0.0125000
NODE_46828_length_478_cov_336.139842	153	233	278	7	80	0.0875000
NODE_46828_length_478_cov_336.139842	153	233	279	1	80	0.0125000
NODE_46828_length_478_cov_336.139842	153	233	280	1	80	0.0125000
NODE_46828_length_478_cov_336.139842	153	233	283	1	80	0.0125000
NODE_46828_length_478_cov_336.139842	153	233	285	2	80	0.0250000
NODE_46828_length_478_cov_336.139842	153	233	288	5	80	0.0625000
NODE_46828_length_478_cov_336.139842	153	233	289	1	80	0.0125000
NODE_46828_length_478_cov_336.139842	153	233	290	2	80	0.0250000
NODE_46828_length_478_cov_336.139842	153	233	292	2	80	0.0250000
NODE_46828_length_478_cov_336.139842	153	233	293	1	80	0.0125000
NODE_46828_length_478_cov_336.139842	153	233	299	1	80	0.0125000
NODE_46828_length_478_cov_336.139842	153	233	307	1	80	0.0125000
NODE_46828_length_478_cov_336.139842	153	233	313	2	80	0.0250000
NODE_46828_length_478_cov_336.139842	153	233	316	1	80	0.0125000
NODE_46828_length_478_cov_336.139842	153	233	319	1	80	0.0125000
NODE_46828_length_478_cov_336.139842	153	233	330	1	80	0.0125000
NODE_46828_length_478_cov_336.139842	153	233	333	1	80	0.0125000
NODE_46828_length_478_cov_336.139842	153	233	337	1	80	0.0125000
NODE_46828_length_478_cov_336.139842	153	233	347	1	80	0.0125000
NODE_46828_length_478_cov_336.139842	153	233	354	1	80	0.0125000
NODE_46828_length_478_cov_336.139842	153	233	362	1	80	0.0125000
NODE_46828_length_478_cov_336.139842	153	233	364	2	80	0.0250000
NODE_46828_length_478_cov_336.139842	153	233	372	1	80	0.0125000
NODE_46828_length_478_cov_336.139842	153	233	380	5	80	0.0625000
NODE_46828_length_478_cov_336.139842	153	233	381	1	80	0.0125000
NODE_46828_length_478_cov_336.139842	153	233	385	2	80	0.0250000
NODE_46828_length_478_cov_336.139842	153	233	386	3	80	0.0375000
NODE_46828_length_478_cov_336.139842	153	233	388	3	80	0.0375000
NODE_46828_length_478_cov_336.139842	153	233	389	4	80	0.0500000
NODE_46828_length_478_cov_336.139842	153	233	390	3	80	0.0375000
NODE_46828_length_478_cov_336.139842	153	233	391	1	80	0.0125000
NODE_46828_length_478_cov_336.139842	206	286	274	2	80	0.0250000
NODE_46828_length_478_cov_336.139842	206	286	280	2	80	0.0250000
NODE_46828_length_478_cov_336.139842	206	286	289	1	80	0.0125000
NODE_46828_length_478_cov_336.139842	206	286	296	1	80	0.0125000
NODE_46828_length_478_cov_336.139842	206	286	301	1	80	0.0125000
NODE_46828_length_478_cov_336.139842	206	286	305	1	80	0.0125000
NODE_46828_length_478_cov_336.139842	206	286	307	1	80	0.0125000
NODE_46828_length_478_cov_336.139842	206	286	309	2	80	0.0250000
NODE_46828_length_478_cov_336.139842	206	286	312	1	80	0.0125000
NODE_46828_length_478_cov_336.139842	206	286	314	1	80	0.0125000
NODE_46828_length_478_cov_336.139842	206	286	316	2	80	0.0250000
NODE_46828_length_478_cov_336.139842	206	286	318	2	80	0.0250000
NODE_46828_length_478_cov_336.139842	206	286	319	1	80	0.0125000
NODE_46828_length_478_cov_336.139842	206	286	320	3	80	0.0375000
NODE_46828_length_478_cov_336.139842	206	286	331	1	80	0.0125000
NODE_46828_length_478_cov_336.139842	206	286	332	1	80	0.0125000
NODE_46828_length_478_cov_336.139842	206	286	344	1	80	0.0125000
NODE_46828_length_478_cov_336.139842	206	286	354	1	80	0.0125000
NODE_46828_length_478_cov_336.139842	206	286	362	2	80	0.0250000
NODE_46828_length_478_cov_336.139842	206	286	363	1	80	0.0125000
NODE_46828_length_478_cov_336.139842	206	286	364	3	80	0.0375000
NODE_46828_length_478_cov_336.139842	206	286	366	1	80	0.0125000
NODE_46828_length_478_cov_336.139842	206	286	372	3	80	0.0375000
NODE_46828_length_478_cov_336.139842	206	286	373	2	80	0.0250000
NODE_46828_length_478_cov_336.139842	206	286	374	2	80	0.0250000
NODE_46828_length_478_cov_336.139842	206	286	375	5	80	0.0625000
NODE_46828_length_478_cov_336.139842	206	286	376	2	80	0.0250000
NODE_46828_length_478_cov_336.139842	206	286	377	3	80	0.0375000
NODE_46828_length_478_cov_336.139842	206	286	378	2	80	0.0250000
NODE_46828_length_478_cov_336.139842	206	286	379	2	80	0.0250000
NODE_46828_length_478_cov_336.139842	206	286	380	10	80	0.1250000
NODE_46828_length_478_cov_336.139842	206	286	381	1	80	0.0125000
NODE_46828_length_478_cov_336.139842	206	286	385	2	80	0.0250000
NODE_46828_length_478_cov_336.139842	206	286	386	3	80	0.0375000
NODE_46828_length_478_cov_336.139842	206	286	388	3	80	0.0375000
NODE_46828_length_478_cov_336.139842	206	286	389	4	80	0.0500000
NODE_46828_length_478_cov_336.139842	206	286	390	3	80	0.0375000
NODE_46828_length_478_cov_336.139842	206	286	391	1	80	0.0125000
NODE_46846_length_478_cov_4.448549	150	230	0	80	80	1.0000000
NODE_46846_length_478_cov_4.448549	203	284	0	81	81	1.0000000
NODE_46874_length_478_cov_2.627968	228	278	0	50	50	1.0000000
NODE_47128_length_477_cov_36.230159	225	305	0	80	80	1.0000000
NODE_47128_length_477_cov_36.230159	278	358	0	80	80	1.0000000
NODE_47129_length_477_cov_33.111111	307	387	4	31	80	0.3875000
NODE_47129_length_477_cov_33.111111	307	387	6	49	80	0.6125000
NODE_47129_length_477_cov_33.111111	360	440	0	40	80	0.5000000
NODE_47129_length_477_cov_33.111111	360	440	4	40	80	0.5000000
NODE_47133_length_477_cov_11.235450	119	199	0	80	80	1.0000000
NODE_47133_length_477_cov_11.235450	172	247	0	75	75	1.0000000
NODE_47135_length_477_cov_9.359788	221	301	0	80	80	1.0000000
NODE_47135_length_477_cov_9.359788	274	354	0	80	80	1.0000000
NODE_47139_length_477_cov_7.436508	230	304	8	2	74	0.0270270
NODE_47139_length_477_cov_7.436508	230	304	14	2	74	0.0270270
NODE_47139_length_477_cov_7.436508	230	304	18	12	74	0.1621622
NODE_47139_length_477_cov_7.436508	230	304	19	16	74	0.2162162
NODE_47139_length_477_cov_7.436508	230	304	21	9	74	0.1216216
NODE_47139_length_477_cov_7.436508	230	304	23	33	74	0.4459459
NODE_47140_length_477_cov_7.433862	43	123	0	2	80	0.0250000
NODE_47140_length_477_cov_7.433862	43	123	2	78	80	0.9750000
NODE_47140_length_477_cov_7.433862	96	176	0	44	80	0.5500000
NODE_47140_length_477_cov_7.433862	96	176	2	36	80	0.4500000
NODE_47143_length_477_cov_6.846561	163	243	0	80	80	1.0000000
NODE_47143_length_477_cov_6.846561	216	296	0	80	80	1.0000000
NODE_47147_length_477_cov_5.677249	150	228	0	9	78	0.1153846
NODE_47147_length_477_cov_5.677249	150	228	2	6	78	0.0769231
NODE_47147_length_477_cov_5.677249	150	228	4	63	78	0.8076923
NODE_47148_length_477_cov_5.084656	227	288	0	52	61	0.8524590
NODE_47148_length_477_cov_5.084656	227	288	2	9	61	0.1475410
NODE_47253_length_477_cov_1.629630	115	171	0	36	56	0.6428571
NODE_47253_length_477_cov_1.629630	115	171	2	20	56	0.3571429
NODE_47253_length_477_cov_1.629630	167	224	2	57	57	1.0000000
NODE_47375_length_477_cov_0.859788	445	477	0	32	32	1.0000000
NODE_47427_length_476_cov_7.533156	221	301	0	80	80	1.0000000
NODE_47427_length_476_cov_7.533156	274	354	0	80	80	1.0000000
NODE_47529_length_476_cov_1.618037	385	444	0	10	59	0.1694915
NODE_47529_length_476_cov_1.618037	385	444	2	49	59	0.8305085
NODE_47601_length_476_cov_1.129973	15	34	0	19	19	1.0000000
NODE_47620_length_476_cov_1.037135	180	243	2	63	63	1.0000000
NODE_47620_length_476_cov_1.037135	237	296	2	59	59	1.0000000
NODE_47693_length_475_cov_34.460106	270	350	0	80	80	1.0000000
NODE_47693_length_475_cov_34.460106	323	403	0	80	80	1.0000000
NODE_47694_length_475_cov_30.087766	273	353	0	54	80	0.6750000
NODE_47694_length_475_cov_30.087766	273	353	2	26	80	0.3250000
NODE_47694_length_475_cov_30.087766	326	406	0	1	80	0.0125000
NODE_47694_length_475_cov_30.087766	326	406	2	79	80	0.9875000
NODE_47695_length_475_cov_10.247340	42	122	0	80	80	1.0000000
NODE_47701_length_475_cov_8.393617	9	89	0	46	80	0.5750000
NODE_47701_length_475_cov_8.393617	9	89	2	34	80	0.4250000
NODE_47701_length_475_cov_8.393617	62	142	0	28	80	0.3500000
NODE_47701_length_475_cov_8.393617	62	142	2	52	80	0.6500000
NODE_47828_length_475_cov_1.531915	272	352	0	74	80	0.9250000
NODE_47828_length_475_cov_1.531915	272	352	2	6	80	0.0750000
NODE_47839_length_475_cov_1.457447	50	93	0	43	43	1.0000000
NODE_47979_length_474_cov_49.453333	392	472	44	3	80	0.0375000
NODE_47979_length_474_cov_49.453333	392	472	47	2	80	0.0250000
NODE_47979_length_474_cov_49.453333	392	472	55	1	80	0.0125000
NODE_47979_length_474_cov_49.453333	392	472	57	1	80	0.0125000
NODE_47979_length_474_cov_49.453333	392	472	59	2	80	0.0250000
NODE_47979_length_474_cov_49.453333	392	472	63	1	80	0.0125000
NODE_47979_length_474_cov_49.453333	392	472	65	1	80	0.0125000
NODE_47979_length_474_cov_49.453333	392	472	68	1	80	0.0125000
NODE_47979_length_474_cov_49.453333	392	472	70	1	80	0.0125000
NODE_47979_length_474_cov_49.453333	392	472	73	1	80	0.0125000
NODE_47979_length_474_cov_49.453333	392	472	78	1	80	0.0125000
NODE_47979_length_474_cov_49.453333	392	472	85	1	80	0.0125000
NODE_47979_length_474_cov_49.453333	392	472	88	1	80	0.0125000
NODE_47979_length_474_cov_49.453333	392	472	96	2	80	0.0250000
NODE_47979_length_474_cov_49.453333	392	472	98	2	80	0.0250000
NODE_47979_length_474_cov_49.453333	392	472	99	1	80	0.0125000
NODE_47979_length_474_cov_49.453333	392	472	104	2	80	0.0250000
NODE_47979_length_474_cov_49.453333	392	472	107	1	80	0.0125000
NODE_47979_length_474_cov_49.453333	392	472	109	1	80	0.0125000
NODE_47979_length_474_cov_49.453333	392	472	111	2	80	0.0250000
NODE_47979_length_474_cov_49.453333	392	472	123	1	80	0.0125000
NODE_47979_length_474_cov_49.453333	392	472	125	1	80	0.0125000
NODE_47979_length_474_cov_49.453333	392	472	128	1	80	0.0125000
NODE_47979_length_474_cov_49.453333	392	472	130	2	80	0.0250000
NODE_47979_length_474_cov_49.453333	392	472	133	1	80	0.0125000
NODE_47979_length_474_cov_49.453333	392	472	138	1	80	0.0125000
NODE_47979_length_474_cov_49.453333	392	472	143	1	80	0.0125000
NODE_47979_length_474_cov_49.453333	392	472	145	1	80	0.0125000
NODE_47979_length_474_cov_49.453333	392	472	146	1	80	0.0125000
NODE_47979_length_474_cov_49.453333	392	472	156	1	80	0.0125000
NODE_47979_length_474_cov_49.453333	392	472	158	1	80	0.0125000
NODE_47979_length_474_cov_49.453333	392	472	163	1	80	0.0125000
NODE_47979_length_474_cov_49.453333	392	472	171	1	80	0.0125000
NODE_47979_length_474_cov_49.453333	392	472	175	1	80	0.0125000
NODE_47979_length_474_cov_49.453333	392	472	176	2	80	0.0250000
NODE_47979_length_474_cov_49.453333	392	472	178	2	80	0.0250000
NODE_47979_length_474_cov_49.453333	392	472	179	1	80	0.0125000
NODE_47979_length_474_cov_49.453333	392	472	180	1	80	0.0125000
NODE_47979_length_474_cov_49.453333	392	472	184	1	80	0.0125000
NODE_47979_length_474_cov_49.453333	392	472	190	1	80	0.0125000
NODE_47979_length_474_cov_49.453333	392	472	195	1	80	0.0125000
NODE_47979_length_474_cov_49.453333	392	472	204	1	80	0.0125000
NODE_47979_length_474_cov_49.453333	392	472	206	1	80	0.0125000
NODE_47979_length_474_cov_49.453333	392	472	209	1	80	0.0125000
NODE_47979_length_474_cov_49.453333	392	472	221	2	80	0.0250000
NODE_47979_length_474_cov_49.453333	392	472	223	1	80	0.0125000
NODE_47979_length_474_cov_49.453333	392	472	228	2	80	0.0250000
NODE_47979_length_474_cov_49.453333	392	472	231	1	80	0.0125000
NODE_47979_length_474_cov_49.453333	392	472	235	1	80	0.0125000
NODE_47979_length_474_cov_49.453333	392	472	241	1	80	0.0125000
NODE_47979_length_474_cov_49.453333	392	472	243	1	80	0.0125000
NODE_47979_length_474_cov_49.453333	392	472	252	2	80	0.0250000
NODE_47979_length_474_cov_49.453333	392	472	257	3	80	0.0375000
NODE_47979_length_474_cov_49.453333	392	472	265	1	80	0.0125000
NODE_47979_length_474_cov_49.453333	392	472	275	1	80	0.0125000
NODE_47979_length_474_cov_49.453333	392	472	277	1	80	0.0125000
NODE_47979_length_474_cov_49.453333	392	472	286	1	80	0.0125000
NODE_47979_length_474_cov_49.453333	392	472	287	2	80	0.0250000
NODE_47979_length_474_cov_49.453333	392	472	291	1	80	0.0125000
NODE_47979_length_474_cov_49.453333	392	472	293	2	80	0.0250000
NODE_47979_length_474_cov_49.453333	392	472	297	1	80	0.0125000
NODE_47979_length_474_cov_49.453333	392	472	303	1	80	0.0125000
NODE_47979_length_474_cov_49.453333	445	474	34	1	29	0.0344828
NODE_47979_length_474_cov_49.453333	445	474	36	1	29	0.0344828
NODE_47979_length_474_cov_49.453333	445	474	44	3	29	0.1034483
NODE_47979_length_474_cov_49.453333	445	474	47	2	29	0.0689655
NODE_47979_length_474_cov_49.453333	445	474	55	1	29	0.0344828
NODE_47979_length_474_cov_49.453333	445	474	57	1	29	0.0344828
NODE_47979_length_474_cov_49.453333	445	474	59	2	29	0.0689655
NODE_47979_length_474_cov_49.453333	445	474	63	1	29	0.0344828
NODE_47979_length_474_cov_49.453333	445	474	65	1	29	0.0344828
NODE_47979_length_474_cov_49.453333	445	474	68	1	29	0.0344828
NODE_47979_length_474_cov_49.453333	445	474	70	1	29	0.0344828
NODE_47979_length_474_cov_49.453333	445	474	73	1	29	0.0344828
NODE_47979_length_474_cov_49.453333	445	474	78	1	29	0.0344828
NODE_47979_length_474_cov_49.453333	445	474	85	1	29	0.0344828
NODE_47979_length_474_cov_49.453333	445	474	88	1	29	0.0344828
NODE_47979_length_474_cov_49.453333	445	474	96	2	29	0.0689655
NODE_47979_length_474_cov_49.453333	445	474	98	2	29	0.0689655
NODE_47979_length_474_cov_49.453333	445	474	99	1	29	0.0344828
NODE_47979_length_474_cov_49.453333	445	474	104	2	29	0.0689655
NODE_47979_length_474_cov_49.453333	445	474	107	1	29	0.0344828
NODE_47979_length_474_cov_49.453333	445	474	109	1	29	0.0344828
NODE_47979_length_474_cov_49.453333	445	474	111	1	29	0.0344828
NODE_47981_length_474_cov_24.930667	287	367	0	80	80	1.0000000
NODE_47981_length_474_cov_24.930667	340	420	0	80	80	1.0000000
NODE_47982_length_474_cov_15.952000	258	338	0	80	80	1.0000000
NODE_47982_length_474_cov_15.952000	311	391	0	80	80	1.0000000
NODE_48003_length_474_cov_3.986667	172	252	7	8	80	0.1000000
NODE_48003_length_474_cov_3.986667	172	252	13	1	80	0.0125000
NODE_48003_length_474_cov_3.986667	172	252	17	2	80	0.0250000
NODE_48003_length_474_cov_3.986667	172	252	20	2	80	0.0250000
NODE_48003_length_474_cov_3.986667	172	252	22	6	80	0.0750000
NODE_48003_length_474_cov_3.986667	172	252	28	16	80	0.2000000
NODE_48003_length_474_cov_3.986667	172	252	30	2	80	0.0250000
NODE_48003_length_474_cov_3.986667	172	252	32	5	80	0.0625000
NODE_48003_length_474_cov_3.986667	172	252	34	8	80	0.1000000
NODE_48003_length_474_cov_3.986667	172	252	36	30	80	0.3750000
NODE_48015_length_474_cov_3.496000	163	243	7	5	80	0.0625000
NODE_48015_length_474_cov_3.496000	163	243	8	23	80	0.2875000
NODE_48015_length_474_cov_3.496000	163	243	9	10	80	0.1250000
NODE_48015_length_474_cov_3.496000	163	243	10	42	80	0.5250000
NODE_48038_length_474_cov_2.784000	259	300	2	5	41	0.1219512
NODE_48038_length_474_cov_2.784000	259	300	4	36	41	0.8780488
NODE_48116_length_474_cov_1.538667	41	62	0	21	21	1.0000000
NODE_48181_length_474_cov_1.085333	0	50	0	50	50	1.0000000
NODE_48184_length_474_cov_1.056000	95	133	0	38	38	1.0000000
NODE_48266_length_473_cov_82.374332	123	203	0	22	80	0.2750000
NODE_48266_length_473_cov_82.374332	123	203	8	58	80	0.7250000
NODE_48266_length_473_cov_82.374332	176	256	8	80	80	1.0000000
NODE_48267_length_473_cov_54.882353	199	279	0	80	80	1.0000000
NODE_48267_length_473_cov_54.882353	252	332	0	80	80	1.0000000
NODE_48268_length_473_cov_48.997326	119	194	8	30	75	0.4000000
NODE_48268_length_473_cov_48.997326	119	194	10	39	75	0.5200000
NODE_48268_length_473_cov_48.997326	119	194	12	5	75	0.0666667
NODE_48268_length_473_cov_48.997326	119	194	13	1	75	0.0133333
NODE_48268_length_473_cov_48.997326	119	194	8	30	75	0.4000000
NODE_48268_length_473_cov_48.997326	119	194	10	39	75	0.5200000
NODE_48268_length_473_cov_48.997326	119	194	12	5	75	0.0666667
NODE_48268_length_473_cov_48.997326	119	194	13	1	75	0.0133333
NODE_48268_length_473_cov_48.997326	167	247	4	23	80	0.2875000
NODE_48268_length_473_cov_48.997326	167	247	10	21	80	0.2625000
NODE_48268_length_473_cov_48.997326	167	247	12	35	80	0.4375000
NODE_48268_length_473_cov_48.997326	167	247	13	1	80	0.0125000
NODE_48269_length_473_cov_30.679144	174	254	0	7	80	0.0875000
NODE_48269_length_473_cov_30.679144	174	254	2	3	80	0.0375000
NODE_48269_length_473_cov_30.679144	174	254	4	24	80	0.3000000
NODE_48269_length_473_cov_30.679144	174	254	8	1	80	0.0125000
NODE_48269_length_473_cov_30.679144	174	254	10	1	80	0.0125000
NODE_48269_length_473_cov_30.679144	174	254	11	1	80	0.0125000
NODE_48269_length_473_cov_30.679144	174	254	12	2	80	0.0250000
NODE_48269_length_473_cov_30.679144	174	254	14	2	80	0.0250000
NODE_48269_length_473_cov_30.679144	174	254	16	2	80	0.0250000
NODE_48269_length_473_cov_30.679144	174	254	18	4	80	0.0500000
NODE_48269_length_473_cov_30.679144	174	254	19	1	80	0.0125000
NODE_48269_length_473_cov_30.679144	174	254	21	4	80	0.0500000
NODE_48269_length_473_cov_30.679144	174	254	22	9	80	0.1125000
NODE_48269_length_473_cov_30.679144	174	254	24	2	80	0.0250000
NODE_48269_length_473_cov_30.679144	174	254	26	6	80	0.0750000
NODE_48269_length_473_cov_30.679144	174	254	32	11	80	0.1375000
NODE_48269_length_473_cov_30.679144	226	307	0	2	81	0.0246914
NODE_48269_length_473_cov_30.679144	226	307	2	2	81	0.0246914
NODE_48269_length_473_cov_30.679144	226	307	4	62	81	0.7654321
NODE_48269_length_473_cov_30.679144	226	307	6	15	81	0.1851852
NODE_48269_length_473_cov_30.679144	227	307	0	1	80	0.0125000
NODE_48269_length_473_cov_30.679144	227	307	2	2	80	0.0250000
NODE_48269_length_473_cov_30.679144	227	307	4	62	80	0.7750000
NODE_48269_length_473_cov_30.679144	227	307	6	15	80	0.1875000
NODE_48270_length_473_cov_24.967914	295	370	0	75	75	1.0000000
NODE_48270_length_473_cov_24.967914	343	423	0	80	80	1.0000000
NODE_48271_length_473_cov_18.540107	168	248	2	2	80	0.0250000
NODE_48271_length_473_cov_18.540107	168	248	6	6	80	0.0750000
NODE_48271_length_473_cov_18.540107	168	248	8	72	80	0.9000000
NODE_48271_length_473_cov_18.540107	221	301	0	43	80	0.5375000
NODE_48271_length_473_cov_18.540107	221	301	2	3	80	0.0375000
NODE_48271_length_473_cov_18.540107	221	301	3	1	80	0.0125000
NODE_48271_length_473_cov_18.540107	221	301	4	3	80	0.0375000
NODE_48271_length_473_cov_18.540107	221	301	8	30	80	0.3750000
NODE_48272_length_473_cov_15.871658	143	223	0	80	80	1.0000000
NODE_48272_length_473_cov_15.871658	196	276	0	80	80	1.0000000
NODE_48291_length_473_cov_4.363636	160	240	3	51	80	0.6375000
NODE_48291_length_473_cov_4.363636	160	240	4	29	80	0.3625000
NODE_48291_length_473_cov_4.363636	213	293	0	53	80	0.6625000
NODE_48291_length_473_cov_4.363636	213	293	3	27	80	0.3375000
NODE_48320_length_473_cov_2.959893	199	267	0	68	68	1.0000000
NODE_48325_length_473_cov_2.804813	207	269	0	49	62	0.7903226
NODE_48325_length_473_cov_2.804813	207	269	9	13	62	0.2096774
NODE_48350_length_473_cov_2.251337	48	128	4	18	80	0.2250000
NODE_48350_length_473_cov_2.251337	48	128	6	62	80	0.7750000
NODE_48350_length_473_cov_2.251337	101	181	3	22	80	0.2750000
NODE_48350_length_473_cov_2.251337	101	181	4	13	80	0.1625000
NODE_48350_length_473_cov_2.251337	101	181	6	45	80	0.5625000
NODE_48568_length_472_cov_50.077748	1	81	0	3	80	0.0375000
NODE_48568_length_472_cov_50.077748	1	81	2	1	80	0.0125000
NODE_48568_length_472_cov_50.077748	1	81	4	16	80	0.2000000
NODE_48568_length_472_cov_50.077748	1	81	12	18	80	0.2250000
NODE_48568_length_472_cov_50.077748	1	81	14	32	80	0.4000000
NODE_48568_length_472_cov_50.077748	1	81	16	10	80	0.1250000
NODE_48568_length_472_cov_50.077748	1	81	0	3	80	0.0375000
NODE_48568_length_472_cov_50.077748	1	81	2	1	80	0.0125000
NODE_48568_length_472_cov_50.077748	1	81	4	16	80	0.2000000
NODE_48568_length_472_cov_50.077748	1	81	12	18	80	0.2250000
NODE_48568_length_472_cov_50.077748	1	81	14	32	80	0.4000000
NODE_48568_length_472_cov_50.077748	1	81	16	10	80	0.1250000
NODE_48568_length_472_cov_50.077748	1	81	0	3	80	0.0375000
NODE_48568_length_472_cov_50.077748	1	81	2	1	80	0.0125000
NODE_48568_length_472_cov_50.077748	1	81	4	16	80	0.2000000
NODE_48568_length_472_cov_50.077748	1	81	12	18	80	0.2250000
NODE_48568_length_472_cov_50.077748	1	81	14	32	80	0.4000000
NODE_48568_length_472_cov_50.077748	1	81	16	10	80	0.1250000
NODE_48568_length_472_cov_50.077748	1	81	0	3	80	0.0375000
NODE_48568_length_472_cov_50.077748	1	81	2	1	80	0.0125000
NODE_48568_length_472_cov_50.077748	1	81	4	16	80	0.2000000
NODE_48568_length_472_cov_50.077748	1	81	12	18	80	0.2250000
NODE_48568_length_472_cov_50.077748	1	81	14	32	80	0.4000000
NODE_48568_length_472_cov_50.077748	1	81	16	10	80	0.1250000
NODE_48568_length_472_cov_50.077748	1	81	0	3	80	0.0375000
NODE_48568_length_472_cov_50.077748	1	81	2	1	80	0.0125000
NODE_48568_length_472_cov_50.077748	1	81	4	16	80	0.2000000
NODE_48568_length_472_cov_50.077748	1	81	12	18	80	0.2250000
NODE_48568_length_472_cov_50.077748	1	81	14	32	80	0.4000000
NODE_48568_length_472_cov_50.077748	1	81	16	10	80	0.1250000
NODE_48568_length_472_cov_50.077748	10	81	4	11	71	0.1549296
NODE_48568_length_472_cov_50.077748	10	81	12	18	71	0.2535211
NODE_48568_length_472_cov_50.077748	10	81	14	32	71	0.4507042
NODE_48568_length_472_cov_50.077748	10	81	16	10	71	0.1408451
NODE_48568_length_472_cov_50.077748	54	131	4	13	77	0.1688312
NODE_48568_length_472_cov_50.077748	54	131	6	2	77	0.0259740
NODE_48568_length_472_cov_50.077748	54	131	14	18	77	0.2337662
NODE_48568_length_472_cov_50.077748	54	131	16	44	77	0.5714286
NODE_48568_length_472_cov_50.077748	54	131	4	13	77	0.1688312
NODE_48568_length_472_cov_50.077748	54	131	6	2	77	0.0259740
NODE_48568_length_472_cov_50.077748	54	131	14	18	77	0.2337662
NODE_48568_length_472_cov_50.077748	54	131	16	44	77	0.5714286
NODE_48568_length_472_cov_50.077748	54	131	4	13	77	0.1688312
NODE_48568_length_472_cov_50.077748	54	131	6	2	77	0.0259740
NODE_48568_length_472_cov_50.077748	54	131	14	18	77	0.2337662
NODE_48568_length_472_cov_50.077748	54	131	16	44	77	0.5714286
NODE_48568_length_472_cov_50.077748	130	204	2	10	74	0.1351351
NODE_48568_length_472_cov_50.077748	130	204	4	64	74	0.8648649
NODE_48569_length_472_cov_10.469169	294	374	0	80	80	1.0000000
NODE_48569_length_472_cov_10.469169	347	427	0	80	80	1.0000000
NODE_48570_length_472_cov_10.195710	143	223	0	80	80	1.0000000
NODE_48570_length_472_cov_10.195710	196	276	0	80	80	1.0000000
NODE_48593_length_472_cov_4.375335	165	245	0	80	80	1.0000000
NODE_48593_length_472_cov_4.375335	218	251	0	33	33	1.0000000
NODE_48614_length_472_cov_3.495979	305	349	0	44	44	1.0000000
NODE_48620_length_472_cov_3.093834	220	295	0	75	75	1.0000000
NODE_48638_length_472_cov_2.592493	431	471	0	40	40	1.0000000
NODE_48745_length_472_cov_1.294906	43	98	0	55	55	1.0000000
NODE_48745_length_472_cov_1.294906	71	151	0	80	80	1.0000000
NODE_48768_length_472_cov_1.211796	106	126	0	20	20	1.0000000
NODE_48873_length_471_cov_39.319892	119	193	0	68	74	0.9189189
NODE_48873_length_471_cov_39.319892	119	193	2	2	74	0.0270270
NODE_48873_length_471_cov_39.319892	119	193	4	1	74	0.0135135
NODE_48873_length_471_cov_39.319892	119	193	7	1	74	0.0135135
NODE_48873_length_471_cov_39.319892	119	193	9	1	74	0.0135135
NODE_48873_length_471_cov_39.319892	119	193	33	1	74	0.0135135
NODE_48874_length_471_cov_24.279570	185	265	0	80	80	1.0000000
NODE_48874_length_471_cov_24.279570	238	318	0	80	80	1.0000000
NODE_48875_length_471_cov_19.669355	83	163	0	12	80	0.1500000
NODE_48875_length_471_cov_19.669355	83	163	2	10	80	0.1250000
NODE_48875_length_471_cov_19.669355	83	163	7	4	80	0.0500000
NODE_48875_length_471_cov_19.669355	83	163	9	8	80	0.1000000
NODE_48875_length_471_cov_19.669355	83	163	10	46	80	0.5750000
NODE_48875_length_471_cov_19.669355	136	216	7	57	80	0.7125000
NODE_48875_length_471_cov_19.669355	136	216	9	7	80	0.0875000
NODE_48875_length_471_cov_19.669355	136	216	10	16	80	0.2000000
NODE_48876_length_471_cov_14.387097	198	278	0	80	80	1.0000000
NODE_48876_length_471_cov_14.387097	251	331	0	80	80	1.0000000
NODE_48881_length_471_cov_6.948925	186	213	0	27	27	1.0000000
NODE_48881_length_471_cov_6.948925	204	284	0	80	80	1.0000000
NODE_48881_length_471_cov_6.948925	244	275	0	31	31	1.0000000
NODE_48881_length_471_cov_6.948925	257	337	0	80	80	1.0000000
NODE_48881_length_471_cov_6.948925	268	337	0	69	69	1.0000000
NODE_48902_length_471_cov_3.803763	83	162	0	79	79	1.0000000
NODE_48902_length_471_cov_3.803763	135	215	0	80	80	1.0000000
NODE_48924_length_471_cov_2.954301	284	315	17	1	31	0.0322581
NODE_48924_length_471_cov_2.954301	284	315	19	2	31	0.0645161
NODE_48924_length_471_cov_2.954301	284	315	23	8	31	0.2580645
NODE_48924_length_471_cov_2.954301	284	315	25	12	31	0.3870968
NODE_48924_length_471_cov_2.954301	284	315	27	8	31	0.2580645
NODE_48957_length_471_cov_2.287634	133	200	2	1	67	0.0149254
NODE_48957_length_471_cov_2.287634	133	200	3	5	67	0.0746269
NODE_48957_length_471_cov_2.287634	133	200	5	1	67	0.0149254
NODE_48957_length_471_cov_2.287634	133	200	7	2	67	0.0298507
NODE_48957_length_471_cov_2.287634	133	200	9	9	67	0.1343284
NODE_48957_length_471_cov_2.287634	133	200	11	2	67	0.0298507
NODE_48957_length_471_cov_2.287634	133	200	17	2	67	0.0298507
NODE_48957_length_471_cov_2.287634	133	200	18	6	67	0.0895522
NODE_48957_length_471_cov_2.287634	133	200	20	2	67	0.0298507
NODE_48957_length_471_cov_2.287634	133	200	23	7	67	0.1044776
NODE_48957_length_471_cov_2.287634	133	200	27	6	67	0.0895522
NODE_48957_length_471_cov_2.287634	133	200	29	24	67	0.3582090
NODE_49186_length_470_cov_57.078167	184	264	2	5	80	0.0625000
NODE_49186_length_470_cov_57.078167	184	264	4	58	80	0.7250000
NODE_49186_length_470_cov_57.078167	184	264	5	1	80	0.0125000
NODE_49186_length_470_cov_57.078167	184	264	6	16	80	0.2000000
NODE_49186_length_470_cov_57.078167	237	317	4	11	80	0.1375000
NODE_49186_length_470_cov_57.078167	237	317	5	1	80	0.0125000
NODE_49186_length_470_cov_57.078167	237	317	6	34	80	0.4250000
NODE_49186_length_470_cov_57.078167	237	317	7	1	80	0.0125000
NODE_49186_length_470_cov_57.078167	237	317	9	33	80	0.4125000
NODE_49186_length_470_cov_57.078167	313	393	5	1	80	0.0125000
NODE_49186_length_470_cov_57.078167	313	393	7	20	80	0.2500000
NODE_49186_length_470_cov_57.078167	313	393	8	51	80	0.6375000
NODE_49186_length_470_cov_57.078167	313	393	9	8	80	0.1000000
NODE_49186_length_470_cov_57.078167	366	446	1	12	80	0.1500000
NODE_49186_length_470_cov_57.078167	366	446	3	1	80	0.0125000
NODE_49186_length_470_cov_57.078167	366	446	4	25	80	0.3125000
NODE_49186_length_470_cov_57.078167	366	446	6	10	80	0.1250000
NODE_49186_length_470_cov_57.078167	366	446	8	32	80	0.4000000
NODE_49187_length_470_cov_34.035040	228	308	0	24	80	0.3000000
NODE_49187_length_470_cov_34.035040	228	308	2	56	80	0.7000000
NODE_49187_length_470_cov_34.035040	281	361	0	17	80	0.2125000
NODE_49187_length_470_cov_34.035040	281	361	2	63	80	0.7875000
NODE_49187_length_470_cov_34.035040	357	437	0	80	80	1.0000000
NODE_49187_length_470_cov_34.035040	410	470	0	60	60	1.0000000
NODE_49188_length_470_cov_15.539084	142	222	0	80	80	1.0000000
NODE_49188_length_470_cov_15.539084	195	275	0	80	80	1.0000000
NODE_49193_length_470_cov_6.070081	272	330	41	5	58	0.0862069
NODE_49193_length_470_cov_6.070081	272	330	43	1	58	0.0172414
NODE_49193_length_470_cov_6.070081	272	330	46	2	58	0.0344828
NODE_49193_length_470_cov_6.070081	272	330	49	1	58	0.0172414
NODE_49193_length_470_cov_6.070081	272	330	51	3	58	0.0517241
NODE_49193_length_470_cov_6.070081	272	330	55	9	58	0.1551724
NODE_49193_length_470_cov_6.070081	272	330	57	2	58	0.0344828
NODE_49193_length_470_cov_6.070081	272	330	58	2	58	0.0344828
NODE_49193_length_470_cov_6.070081	272	330	60	3	58	0.0517241
NODE_49193_length_470_cov_6.070081	272	330	64	1	58	0.0172414
NODE_49193_length_470_cov_6.070081	272	330	66	1	58	0.0172414
NODE_49193_length_470_cov_6.070081	272	330	70	1	58	0.0172414
NODE_49193_length_470_cov_6.070081	272	330	72	1	58	0.0172414
NODE_49193_length_470_cov_6.070081	272	330	76	3	58	0.0517241
NODE_49193_length_470_cov_6.070081	272	330	78	2	58	0.0344828
NODE_49193_length_470_cov_6.070081	272	330	84	14	58	0.2413793
NODE_49193_length_470_cov_6.070081	272	330	86	7	58	0.1206897
NODE_49193_length_470_cov_6.070081	325	383	7	1	58	0.0172414
NODE_49193_length_470_cov_6.070081	325	383	10	1	58	0.0172414
NODE_49193_length_470_cov_6.070081	325	383	12	4	58	0.0689655
NODE_49193_length_470_cov_6.070081	325	383	14	12	58	0.2068966
NODE_49193_length_470_cov_6.070081	325	383	16	1	58	0.0172414
NODE_49193_length_470_cov_6.070081	325	383	18	3	58	0.0517241
NODE_49193_length_470_cov_6.070081	325	383	19	3	58	0.0517241
NODE_49193_length_470_cov_6.070081	325	383	20	1	58	0.0172414
NODE_49193_length_470_cov_6.070081	325	383	21	6	58	0.1034483
NODE_49193_length_470_cov_6.070081	325	383	28	1	58	0.0172414
NODE_49193_length_470_cov_6.070081	325	383	30	3	58	0.0517241
NODE_49193_length_470_cov_6.070081	325	383	31	1	58	0.0172414
NODE_49193_length_470_cov_6.070081	325	383	34	5	58	0.0862069
NODE_49193_length_470_cov_6.070081	325	383	36	5	58	0.0862069
NODE_49193_length_470_cov_6.070081	325	383	38	2	58	0.0344828
NODE_49193_length_470_cov_6.070081	325	383	40	2	58	0.0344828
NODE_49193_length_470_cov_6.070081	325	383	41	7	58	0.1206897
NODE_49215_length_470_cov_3.735849	194	251	0	57	57	1.0000000
NODE_49260_length_470_cov_2.363881	403	422	15	14	19	0.7368421
NODE_49260_length_470_cov_2.363881	403	422	17	1	19	0.0526316
NODE_49260_length_470_cov_2.363881	403	422	19	4	19	0.2105263
NODE_49260_length_470_cov_2.363881	403	422	15	14	19	0.7368421
NODE_49260_length_470_cov_2.363881	403	422	17	1	19	0.0526316
NODE_49260_length_470_cov_2.363881	403	422	19	4	19	0.2105263
NODE_49389_length_470_cov_1.142857	414	470	0	4	56	0.0714286
NODE_49389_length_470_cov_1.142857	414	470	2	9	56	0.1607143
NODE_49389_length_470_cov_1.142857	414	470	10	11	56	0.1964286
NODE_49389_length_470_cov_1.142857	414	470	12	18	56	0.3214286
NODE_49389_length_470_cov_1.142857	414	470	14	14	56	0.2500000
NODE_49502_length_469_cov_221.024324	150	228	195	2	78	0.0256410
NODE_49502_length_469_cov_221.024324	150	228	198	2	78	0.0256410
NODE_49502_length_469_cov_221.024324	150	228	202	1	78	0.0128205
NODE_49502_length_469_cov_221.024324	150	228	217	1	78	0.0128205
NODE_49502_length_469_cov_221.024324	150	228	223	1	78	0.0128205
NODE_49502_length_469_cov_221.024324	150	228	225	1	78	0.0128205
NODE_49502_length_469_cov_221.024324	150	228	226	1	78	0.0128205
NODE_49502_length_469_cov_221.024324	150	228	229	1	78	0.0128205
NODE_49502_length_469_cov_221.024324	150	228	232	1	78	0.0128205
NODE_49502_length_469_cov_221.024324	150	228	233	1	78	0.0128205
NODE_49502_length_469_cov_221.024324	150	228	234	1	78	0.0128205
NODE_49502_length_469_cov_221.024324	150	228	239	1	78	0.0128205
NODE_49502_length_469_cov_221.024324	150	228	248	4	78	0.0512821
NODE_49502_length_469_cov_221.024324	150	228	255	1	78	0.0128205
NODE_49502_length_469_cov_221.024324	150	228	256	3	78	0.0384615
NODE_49502_length_469_cov_221.024324	150	228	257	1	78	0.0128205
NODE_49502_length_469_cov_221.024324	150	228	258	1	78	0.0128205
NODE_49502_length_469_cov_221.024324	150	228	260	5	78	0.0641026
NODE_49502_length_469_cov_221.024324	150	228	261	4	78	0.0512821
NODE_49502_length_469_cov_221.024324	150	228	262	10	78	0.1282051
NODE_49502_length_469_cov_221.024324	150	228	263	1	78	0.0128205
NODE_49502_length_469_cov_221.024324	150	228	264	4	78	0.0512821
NODE_49502_length_469_cov_221.024324	150	228	265	5	78	0.0641026
NODE_49502_length_469_cov_221.024324	150	228	266	2	78	0.0256410
NODE_49502_length_469_cov_221.024324	150	228	267	2	78	0.0256410
NODE_49502_length_469_cov_221.024324	150	228	268	4	78	0.0512821
NODE_49502_length_469_cov_221.024324	150	228	269	3	78	0.0384615
NODE_49502_length_469_cov_221.024324	150	228	270	3	78	0.0384615
NODE_49502_length_469_cov_221.024324	150	228	272	6	78	0.0769231
NODE_49502_length_469_cov_221.024324	150	228	274	3	78	0.0384615
NODE_49502_length_469_cov_221.024324	150	228	276	2	78	0.0256410
NODE_49502_length_469_cov_221.024324	150	228	195	2	78	0.0256410
NODE_49502_length_469_cov_221.024324	150	228	198	2	78	0.0256410
NODE_49502_length_469_cov_221.024324	150	228	202	1	78	0.0128205
NODE_49502_length_469_cov_221.024324	150	228	217	1	78	0.0128205
NODE_49502_length_469_cov_221.024324	150	228	223	1	78	0.0128205
NODE_49502_length_469_cov_221.024324	150	228	225	1	78	0.0128205
NODE_49502_length_469_cov_221.024324	150	228	226	1	78	0.0128205
NODE_49502_length_469_cov_221.024324	150	228	229	1	78	0.0128205
NODE_49502_length_469_cov_221.024324	150	228	232	1	78	0.0128205
NODE_49502_length_469_cov_221.024324	150	228	233	1	78	0.0128205
NODE_49502_length_469_cov_221.024324	150	228	234	1	78	0.0128205
NODE_49502_length_469_cov_221.024324	150	228	239	1	78	0.0128205
NODE_49502_length_469_cov_221.024324	150	228	248	4	78	0.0512821
NODE_49502_length_469_cov_221.024324	150	228	255	1	78	0.0128205
NODE_49502_length_469_cov_221.024324	150	228	256	3	78	0.0384615
NODE_49502_length_469_cov_221.024324	150	228	257	1	78	0.0128205
NODE_49502_length_469_cov_221.024324	150	228	258	1	78	0.0128205
NODE_49502_length_469_cov_221.024324	150	228	260	5	78	0.0641026
NODE_49502_length_469_cov_221.024324	150	228	261	4	78	0.0512821
NODE_49502_length_469_cov_221.024324	150	228	262	10	78	0.1282051
NODE_49502_length_469_cov_221.024324	150	228	263	1	78	0.0128205
NODE_49502_length_469_cov_221.024324	150	228	264	4	78	0.0512821
NODE_49502_length_469_cov_221.024324	150	228	265	5	78	0.0641026
NODE_49502_length_469_cov_221.024324	150	228	266	2	78	0.0256410
NODE_49502_length_469_cov_221.024324	150	228	267	2	78	0.0256410
NODE_49502_length_469_cov_221.024324	150	228	268	4	78	0.0512821
NODE_49502_length_469_cov_221.024324	150	228	269	3	78	0.0384615
NODE_49502_length_469_cov_221.024324	150	228	270	3	78	0.0384615
NODE_49502_length_469_cov_221.024324	150	228	272	6	78	0.0769231
NODE_49502_length_469_cov_221.024324	150	228	274	3	78	0.0384615
NODE_49502_length_469_cov_221.024324	150	228	276	2	78	0.0256410
NODE_49502_length_469_cov_221.024324	150	219	229	1	69	0.0144928
NODE_49502_length_469_cov_221.024324	150	219	232	1	69	0.0144928
NODE_49502_length_469_cov_221.024324	150	219	233	1	69	0.0144928
NODE_49502_length_469_cov_221.024324	150	219	234	1	69	0.0144928
NODE_49502_length_469_cov_221.024324	150	219	239	1	69	0.0144928
NODE_49502_length_469_cov_221.024324	150	219	248	4	69	0.0579710
NODE_49502_length_469_cov_221.024324	150	219	255	1	69	0.0144928
NODE_49502_length_469_cov_221.024324	150	219	256	3	69	0.0434783
NODE_49502_length_469_cov_221.024324	150	219	257	1	69	0.0144928
NODE_49502_length_469_cov_221.024324	150	219	258	1	69	0.0144928
NODE_49502_length_469_cov_221.024324	150	219	260	5	69	0.0724638
NODE_49502_length_469_cov_221.024324	150	219	261	4	69	0.0579710
NODE_49502_length_469_cov_221.024324	150	219	262	10	69	0.1449275
NODE_49502_length_469_cov_221.024324	150	219	263	1	69	0.0144928
NODE_49502_length_469_cov_221.024324	150	219	264	4	69	0.0579710
NODE_49502_length_469_cov_221.024324	150	219	265	5	69	0.0724638
NODE_49502_length_469_cov_221.024324	150	219	266	2	69	0.0289855
NODE_49502_length_469_cov_221.024324	150	219	267	2	69	0.0289855
NODE_49502_length_469_cov_221.024324	150	219	268	4	69	0.0579710
NODE_49502_length_469_cov_221.024324	150	219	269	3	69	0.0434783
NODE_49502_length_469_cov_221.024324	150	219	270	3	69	0.0434783
NODE_49502_length_469_cov_221.024324	150	219	272	6	69	0.0869565
NODE_49502_length_469_cov_221.024324	150	219	274	3	69	0.0434783
NODE_49502_length_469_cov_221.024324	150	219	276	2	69	0.0289855
NODE_49557_length_469_cov_2.686486	263	343	0	2	80	0.0250000
NODE_49557_length_469_cov_2.686486	263	343	2	78	80	0.9750000
NODE_49561_length_469_cov_2.521622	237	289	0	51	52	0.9807692
NODE_49561_length_469_cov_2.521622	237	289	2	1	52	0.0192308
NODE_49579_length_469_cov_2.224324	279	331	2	52	52	1.0000000
NODE_49796_length_468_cov_8.043360	190	250	0	60	60	1.0000000
NODE_49796_length_468_cov_8.043360	223	303	0	80	80	1.0000000
NODE_49800_length_468_cov_6.046070	152	232	0	80	80	1.0000000
NODE_49800_length_468_cov_6.046070	205	285	0	80	80	1.0000000
NODE_49801_length_468_cov_5.997290	81	161	0	35	80	0.4375000
NODE_49801_length_468_cov_5.997290	81	161	2	45	80	0.5625000
NODE_49801_length_468_cov_5.997290	134	214	2	41	80	0.5125000
NODE_49801_length_468_cov_5.997290	134	214	4	39	80	0.4875000
NODE_49801_length_468_cov_5.997290	210	270	4	21	60	0.3500000
NODE_49801_length_468_cov_5.997290	210	270	6	39	60	0.6500000
NODE_49803_length_468_cov_5.872629	133	201	6	6	68	0.0882353
NODE_49803_length_468_cov_5.872629	133	201	7	18	68	0.2647059
NODE_49803_length_468_cov_5.872629	133	201	8	26	68	0.3823529
NODE_49803_length_468_cov_5.872629	133	201	10	3	68	0.0441176
NODE_49803_length_468_cov_5.872629	133	201	12	13	68	0.1911765
NODE_49803_length_468_cov_5.872629	133	201	14	2	68	0.0294118
NODE_49807_length_468_cov_5.384824	305	356	3	8	51	0.1568628
NODE_49807_length_468_cov_5.384824	305	356	4	43	51	0.8431373
NODE_49894_length_468_cov_2.067751	45	96	2	51	51	1.0000000
NODE_49913_length_468_cov_1.891599	4	63	0	59	59	1.0000000
NODE_49928_length_468_cov_1.758808	140	218	0	78	78	1.0000000
NODE_49928_length_468_cov_1.758808	191	257	0	66	66	1.0000000
NODE_49974_length_468_cov_1.390244	291	310	2	19	19	1.0000000
NODE_49974_length_468_cov_1.390244	369	405	0	28	36	0.7777778
NODE_49974_length_468_cov_1.390244	369	405	2	8	36	0.2222222
NODE_50133_length_467_cov_14.100543	176	256	0	80	80	1.0000000
NODE_50134_length_467_cov_11.902174	193	236	0	43	43	1.0000000
NODE_50135_length_467_cov_10.875000	226	306	0	80	80	1.0000000
NODE_50135_length_467_cov_10.875000	279	359	0	80	80	1.0000000
NODE_50144_length_467_cov_6.625000	206	275	0	24	69	0.3478261
NODE_50144_length_467_cov_6.625000	206	275	2	27	69	0.3913043
NODE_50144_length_467_cov_6.625000	206	275	4	18	69	0.2608696
NODE_50144_length_467_cov_6.625000	257	328	2	10	71	0.1408451
NODE_50144_length_467_cov_6.625000	257	328	4	61	71	0.8591549
NODE_50197_length_467_cov_2.709239	247	327	0	80	80	1.0000000
NODE_50215_length_467_cov_2.296196	284	329	0	45	45	1.0000000
NODE_50238_length_467_cov_2.027174	218	269	0	49	51	0.9607843
NODE_50238_length_467_cov_2.027174	218	269	2	2	51	0.0392157
NODE_50252_length_467_cov_1.836957	55	118	0	63	63	1.0000000
NODE_50267_length_467_cov_1.603261	92	141	0	1	49	0.0204082
NODE_50267_length_467_cov_1.603261	92	141	6	3	49	0.0612245
NODE_50267_length_467_cov_1.603261	92	141	8	45	49	0.9183673
NODE_50283_length_467_cov_1.426630	135	183	0	48	48	1.0000000
NODE_50447_length_466_cov_42.839237	0	47	0	47	47	1.0000000
NODE_50447_length_466_cov_42.839237	20	100	0	80	80	1.0000000
NODE_50447_length_466_cov_42.839237	96	176	0	28	80	0.3500000
NODE_50447_length_466_cov_42.839237	96	176	2	30	80	0.3750000
NODE_50447_length_466_cov_42.839237	96	176	4	22	80	0.2750000
NODE_50447_length_466_cov_42.839237	149	229	2	5	80	0.0625000
NODE_50447_length_466_cov_42.839237	149	229	4	75	80	0.9375000
NODE_50448_length_466_cov_36.901907	85	165	0	80	80	1.0000000
NODE_50448_length_466_cov_36.901907	138	218	0	80	80	1.0000000
NODE_50448_length_466_cov_36.901907	214	294	0	28	80	0.3500000
NODE_50448_length_466_cov_36.901907	214	294	2	52	80	0.6500000
NODE_50448_length_466_cov_36.901907	267	347	0	9	80	0.1125000
NODE_50448_length_466_cov_36.901907	267	347	2	71	80	0.8875000
NODE_50457_length_466_cov_5.122616	275	316	5	10	41	0.2439024
NODE_50457_length_466_cov_5.122616	275	316	6	4	41	0.0975610
NODE_50457_length_466_cov_5.122616	275	316	8	27	41	0.6585366
NODE_50457_length_466_cov_5.122616	276	316	5	10	40	0.2500000
NODE_50457_length_466_cov_5.122616	276	316	6	4	40	0.1000000
NODE_50457_length_466_cov_5.122616	276	316	8	26	40	0.6500000
NODE_50457_length_466_cov_5.122616	289	338	2	8	49	0.1632653
NODE_50457_length_466_cov_5.122616	289	338	3	14	49	0.2857143
NODE_50457_length_466_cov_5.122616	289	338	5	10	49	0.2040816
NODE_50457_length_466_cov_5.122616	289	338	6	4	49	0.0816327
NODE_50457_length_466_cov_5.122616	289	338	8	13	49	0.2653061
NODE_50515_length_466_cov_2.602180	9	90	2	2	81	0.0246914
NODE_50515_length_466_cov_2.602180	9	90	4	23	81	0.2839506
NODE_50515_length_466_cov_2.602180	9	90	6	1	81	0.0123457
NODE_50515_length_466_cov_2.602180	9	90	8	55	81	0.6790124
NODE_50515_length_466_cov_2.602180	312	341	2	13	29	0.4482759
NODE_50515_length_466_cov_2.602180	312	341	4	1	29	0.0344828
NODE_50515_length_466_cov_2.602180	312	341	6	15	29	0.5172414
NODE_50549_length_466_cov_2.108992	130	182	4	52	52	1.0000000
NODE_50562_length_466_cov_1.980926	183	265	0	82	82	1.0000000
NODE_50787_length_465_cov_13.019126	170	250	0	19	80	0.2375000
NODE_50787_length_465_cov_13.019126	170	250	1	31	80	0.3875000
NODE_50787_length_465_cov_13.019126	170	250	3	30	80	0.3750000
NODE_50787_length_465_cov_13.019126	223	301	3	34	78	0.4358974
NODE_50787_length_465_cov_13.019126	223	301	5	9	78	0.1153846
NODE_50787_length_465_cov_13.019126	223	301	6	35	78	0.4487180
NODE_50799_length_465_cov_5.363388	316	393	0	6	77	0.0779221
NODE_50799_length_465_cov_5.363388	316	393	1	29	77	0.3766234
NODE_50799_length_465_cov_5.363388	316	393	2	42	77	0.5454546
NODE_50800_length_465_cov_4.898907	376	406	0	30	30	1.0000000
NODE_50869_length_465_cov_2.366120	147	227	0	80	80	1.0000000
NODE_50869_length_465_cov_2.366120	200	271	0	71	71	1.0000000
NODE_50911_length_465_cov_1.737705	338	383	6	8	45	0.1777778
NODE_50911_length_465_cov_1.737705	338	383	8	37	45	0.8222222
NODE_51100_length_464_cov_8.473973	209	289	0	40	80	0.5000000
NODE_51100_length_464_cov_8.473973	209	289	2	40	80	0.5000000
NODE_51100_length_464_cov_8.473973	262	342	0	80	80	1.0000000
NODE_51148_length_464_cov_2.528767	136	199	2	7	63	0.1111111
NODE_51148_length_464_cov_2.528767	136	199	4	35	63	0.5555556
NODE_51148_length_464_cov_2.528767	136	199	6	21	63	0.3333333
NODE_51167_length_464_cov_2.134247	130	203	0	52	73	0.7123288
NODE_51167_length_464_cov_2.134247	130	203	2	21	73	0.2876712
NODE_51186_length_464_cov_1.901370	58	138	0	16	80	0.2000000
NODE_51186_length_464_cov_1.901370	58	138	2	18	80	0.2250000
NODE_51186_length_464_cov_1.901370	58	138	3	46	80	0.5750000
NODE_51203_length_464_cov_1.706849	186	265	0	79	79	1.0000000
NODE_51377_length_463_cov_64.420330	375	455	2	33	80	0.4125000
NODE_51377_length_463_cov_64.420330	375	455	4	47	80	0.5875000
NODE_51377_length_463_cov_64.420330	375	455	2	33	80	0.4125000
NODE_51377_length_463_cov_64.420330	375	455	4	47	80	0.5875000
NODE_51377_length_463_cov_64.420330	375	455	2	33	80	0.4125000
NODE_51377_length_463_cov_64.420330	375	455	4	47	80	0.5875000
NODE_51377_length_463_cov_64.420330	375	455	2	33	80	0.4125000
NODE_51377_length_463_cov_64.420330	375	455	4	47	80	0.5875000
NODE_51377_length_463_cov_64.420330	375	455	2	33	80	0.4125000
NODE_51377_length_463_cov_64.420330	375	455	4	47	80	0.5875000
NODE_51378_length_463_cov_49.673077	0	71	1	4	71	0.0563380
NODE_51378_length_463_cov_49.673077	0	71	6	1	71	0.0140845
NODE_51378_length_463_cov_49.673077	0	71	7	7	71	0.0985916
NODE_51378_length_463_cov_49.673077	0	71	11	11	71	0.1549296
NODE_51378_length_463_cov_49.673077	0	71	12	12	71	0.1690141
NODE_51378_length_463_cov_49.673077	0	71	25	2	71	0.0281690
NODE_51378_length_463_cov_49.673077	0	71	26	3	71	0.0422535
NODE_51378_length_463_cov_49.673077	0	71	28	9	71	0.1267606
NODE_51378_length_463_cov_49.673077	0	71	32	21	71	0.2957746
NODE_51378_length_463_cov_49.673077	0	71	36	1	71	0.0140845
NODE_51378_length_463_cov_49.673077	44	121	28	5	77	0.0649351
NODE_51378_length_463_cov_49.673077	44	121	32	21	77	0.2727273
NODE_51378_length_463_cov_49.673077	44	121	36	8	77	0.1038961
NODE_51378_length_463_cov_49.673077	44	121	37	15	77	0.1948052
NODE_51378_length_463_cov_49.673077	44	121	40	7	77	0.0909091
NODE_51378_length_463_cov_49.673077	44	121	42	21	77	0.2727273
NODE_51379_length_463_cov_41.005495	8	88	0	80	80	1.0000000
NODE_51379_length_463_cov_41.005495	61	141	0	80	80	1.0000000
NODE_51380_length_463_cov_30.626374	318	398	0	80	80	1.0000000
NODE_51380_length_463_cov_30.626374	371	451	0	80	80	1.0000000
NODE_51381_length_463_cov_27.475275	211	291	0	42	80	0.5250000
NODE_51381_length_463_cov_27.475275	211	291	2	38	80	0.4750000
NODE_51381_length_463_cov_27.475275	264	344	0	33	80	0.4125000
NODE_51381_length_463_cov_27.475275	264	344	2	47	80	0.5875000
NODE_51383_length_463_cov_11.211538	304	377	0	9	73	0.1232877
NODE_51383_length_463_cov_11.211538	304	377	2	44	73	0.6027398
NODE_51383_length_463_cov_11.211538	304	377	4	20	73	0.2739726
NODE_51383_length_463_cov_11.211538	350	430	2	30	80	0.3750000
NODE_51383_length_463_cov_11.211538	350	430	4	50	80	0.6250000
NODE_51391_length_463_cov_5.711538	181	261	0	80	80	1.0000000
NODE_51391_length_463_cov_5.711538	234	314	0	80	80	1.0000000
NODE_51399_length_463_cov_4.398352	119	169	0	50	50	1.0000000
NODE_51402_length_463_cov_4.186813	175	233	6	2	58	0.0344828
NODE_51402_length_463_cov_4.186813	175	233	8	7	58	0.1206897
NODE_51402_length_463_cov_4.186813	175	233	14	6	58	0.1034483
NODE_51402_length_463_cov_4.186813	175	233	16	43	58	0.7413793
NODE_51402_length_463_cov_4.186813	206	251	10	8	45	0.1777778
NODE_51402_length_463_cov_4.186813	206	251	16	37	45	0.8222222
NODE_51408_length_463_cov_3.846154	235	268	0	6	33	0.1818182
NODE_51408_length_463_cov_3.846154	235	268	2	27	33	0.8181818
NODE_51421_length_463_cov_3.063187	193	248	0	55	55	1.0000000
NODE_51421_length_463_cov_3.063187	222	301	0	79	79	1.0000000
NODE_51680_length_462_cov_21.876033	93	173	0	80	80	1.0000000
NODE_51680_length_462_cov_21.876033	146	226	0	80	80	1.0000000
NODE_51687_length_462_cov_5.033058	93	154	0	61	61	1.0000000
NODE_51687_length_462_cov_5.033058	159	209	0	50	50	1.0000000
NODE_51699_length_462_cov_4.101928	168	246	0	78	78	1.0000000
NODE_51699_length_462_cov_4.101928	184	208	0	24	24	1.0000000
NODE_51699_length_462_cov_4.101928	219	299	0	80	80	1.0000000
NODE_51708_length_462_cov_3.630854	149	194	0	23	45	0.5111111
NODE_51708_length_462_cov_3.630854	149	194	2	18	45	0.4000000
NODE_51708_length_462_cov_3.630854	149	194	3	4	45	0.0888889
NODE_51720_length_462_cov_3.079890	103	147	2	44	44	1.0000000
NODE_51735_length_462_cov_2.677686	78	118	0	40	40	1.0000000
NODE_51763_length_462_cov_2.209366	18	58	0	40	40	1.0000000
NODE_51817_length_462_cov_1.570248	68	113	0	45	45	1.0000000
NODE_51995_length_461_cov_35.116022	0	79	0	79	79	1.0000000
NODE_51995_length_461_cov_35.116022	52	132	0	80	80	1.0000000
NODE_51996_length_461_cov_11.124309	77	157	0	80	80	1.0000000
NODE_51996_length_461_cov_11.124309	130	210	0	80	80	1.0000000
NODE_52010_length_461_cov_5.361878	246	322	4	31	76	0.4078947
NODE_52010_length_461_cov_5.361878	246	322	6	12	76	0.1578947
NODE_52010_length_461_cov_5.361878	246	322	8	7	76	0.0921053
NODE_52010_length_461_cov_5.361878	246	322	10	24	76	0.3157895
NODE_52010_length_461_cov_5.361878	246	322	12	2	76	0.0263158
NODE_52018_length_461_cov_4.472376	268	333	0	65	65	1.0000000
NODE_52021_length_461_cov_4.168508	159	234	0	75	75	1.0000000
NODE_52047_length_461_cov_2.892265	233	312	4	72	79	0.9113924
NODE_52047_length_461_cov_2.892265	233	312	8	7	79	0.0886076
NODE_52073_length_461_cov_2.392265	186	223	4	37	37	1.0000000
NODE_52154_length_461_cov_1.389503	283	349	4	66	66	1.0000000
NODE_52292_length_460_cov_172.986150	0	68	25	1	68	0.0147059
NODE_52292_length_460_cov_172.986150	0	68	31	1	68	0.0147059
NODE_52292_length_460_cov_172.986150	0	68	37	1	68	0.0147059
NODE_52292_length_460_cov_172.986150	0	68	48	1	68	0.0147059
NODE_52292_length_460_cov_172.986150	0	68	52	1	68	0.0147059
NODE_52292_length_460_cov_172.986150	0	68	57	1	68	0.0147059
NODE_52292_length_460_cov_172.986150	0	68	72	1	68	0.0147059
NODE_52292_length_460_cov_172.986150	0	68	73	1	68	0.0147059
NODE_52292_length_460_cov_172.986150	0	68	98	1	68	0.0147059
NODE_52292_length_460_cov_172.986150	0	68	112	1	68	0.0147059
NODE_52292_length_460_cov_172.986150	0	68	119	1	68	0.0147059
NODE_52292_length_460_cov_172.986150	0	68	134	1	68	0.0147059
NODE_52292_length_460_cov_172.986150	0	68	150	1	68	0.0147059
NODE_52292_length_460_cov_172.986150	0	68	164	1	68	0.0147059
NODE_52292_length_460_cov_172.986150	0	68	174	1	68	0.0147059
NODE_52292_length_460_cov_172.986150	0	68	176	1	68	0.0147059
NODE_52292_length_460_cov_172.986150	0	68	185	1	68	0.0147059
NODE_52292_length_460_cov_172.986150	0	68	227	1	68	0.0147059
NODE_52292_length_460_cov_172.986150	0	68	239	1	68	0.0147059
NODE_52292_length_460_cov_172.986150	0	68	241	1	68	0.0147059
NODE_52292_length_460_cov_172.986150	0	68	259	1	68	0.0147059
NODE_52292_length_460_cov_172.986150	0	68	267	1	68	0.0147059
NODE_52292_length_460_cov_172.986150	0	68	275	1	68	0.0147059
NODE_52292_length_460_cov_172.986150	0	68	293	1	68	0.0147059
NODE_52292_length_460_cov_172.986150	0	68	330	1	68	0.0147059
NODE_52292_length_460_cov_172.986150	0	68	336	1	68	0.0147059
NODE_52292_length_460_cov_172.986150	0	68	346	1	68	0.0147059
NODE_52292_length_460_cov_172.986150	0	68	367	1	68	0.0147059
NODE_52292_length_460_cov_172.986150	0	68	374	1	68	0.0147059
NODE_52292_length_460_cov_172.986150	0	68	390	1	68	0.0147059
NODE_52292_length_460_cov_172.986150	0	68	395	1	68	0.0147059
NODE_52292_length_460_cov_172.986150	0	68	406	1	68	0.0147059
NODE_52292_length_460_cov_172.986150	0	68	414	1	68	0.0147059
NODE_52292_length_460_cov_172.986150	0	68	422	1	68	0.0147059
NODE_52292_length_460_cov_172.986150	0	68	425	1	68	0.0147059
NODE_52292_length_460_cov_172.986150	0	68	431	1	68	0.0147059
NODE_52292_length_460_cov_172.986150	0	68	433	1	68	0.0147059
NODE_52292_length_460_cov_172.986150	0	68	456	1	68	0.0147059
NODE_52292_length_460_cov_172.986150	0	68	462	2	68	0.0294118
NODE_52292_length_460_cov_172.986150	0	68	477	1	68	0.0147059
NODE_52292_length_460_cov_172.986150	0	68	481	1	68	0.0147059
NODE_52292_length_460_cov_172.986150	0	68	490	1	68	0.0147059
NODE_52292_length_460_cov_172.986150	0	68	493	1	68	0.0147059
NODE_52292_length_460_cov_172.986150	0	68	495	1	68	0.0147059
NODE_52292_length_460_cov_172.986150	0	68	500	1	68	0.0147059
NODE_52292_length_460_cov_172.986150	0	68	511	2	68	0.0294118
NODE_52292_length_460_cov_172.986150	0	68	521	1	68	0.0147059
NODE_52292_length_460_cov_172.986150	0	68	534	1	68	0.0147059
NODE_52292_length_460_cov_172.986150	0	68	545	1	68	0.0147059
NODE_52292_length_460_cov_172.986150	0	68	547	1	68	0.0147059
NODE_52292_length_460_cov_172.986150	0	68	575	1	68	0.0147059
NODE_52292_length_460_cov_172.986150	0	68	577	1	68	0.0147059
NODE_52292_length_460_cov_172.986150	0	68	594	1	68	0.0147059
NODE_52292_length_460_cov_172.986150	0	68	598	1	68	0.0147059
NODE_52292_length_460_cov_172.986150	0	68	602	1	68	0.0147059
NODE_52292_length_460_cov_172.986150	0	68	603	1	68	0.0147059
NODE_52292_length_460_cov_172.986150	0	68	609	1	68	0.0147059
NODE_52292_length_460_cov_172.986150	0	68	615	1	68	0.0147059
NODE_52292_length_460_cov_172.986150	0	68	621	1	68	0.0147059
NODE_52292_length_460_cov_172.986150	0	68	627	1	68	0.0147059
NODE_52292_length_460_cov_172.986150	0	68	636	2	68	0.0294118
NODE_52292_length_460_cov_172.986150	0	68	638	1	68	0.0147059
NODE_52292_length_460_cov_172.986150	0	68	639	1	68	0.0147059
NODE_52292_length_460_cov_172.986150	0	68	649	1	68	0.0147059
NODE_52292_length_460_cov_172.986150	0	68	656	1	68	0.0147059
NODE_52292_length_460_cov_172.986150	41	121	481	1	80	0.0125000
NODE_52292_length_460_cov_172.986150	41	121	490	1	80	0.0125000
NODE_52292_length_460_cov_172.986150	41	121	493	1	80	0.0125000
NODE_52292_length_460_cov_172.986150	41	121	495	1	80	0.0125000
NODE_52292_length_460_cov_172.986150	41	121	500	1	80	0.0125000
NODE_52292_length_460_cov_172.986150	41	121	511	2	80	0.0250000
NODE_52292_length_460_cov_172.986150	41	121	521	1	80	0.0125000
NODE_52292_length_460_cov_172.986150	41	121	534	1	80	0.0125000
NODE_52292_length_460_cov_172.986150	41	121	545	1	80	0.0125000
NODE_52292_length_460_cov_172.986150	41	121	547	1	80	0.0125000
NODE_52292_length_460_cov_172.986150	41	121	575	1	80	0.0125000
NODE_52292_length_460_cov_172.986150	41	121	577	1	80	0.0125000
NODE_52292_length_460_cov_172.986150	41	121	594	1	80	0.0125000
NODE_52292_length_460_cov_172.986150	41	121	598	1	80	0.0125000
NODE_52292_length_460_cov_172.986150	41	121	602	1	80	0.0125000
NODE_52292_length_460_cov_172.986150	41	121	603	1	80	0.0125000
NODE_52292_length_460_cov_172.986150	41	121	609	1	80	0.0125000
NODE_52292_length_460_cov_172.986150	41	121	615	1	80	0.0125000
NODE_52292_length_460_cov_172.986150	41	121	621	1	80	0.0125000
NODE_52292_length_460_cov_172.986150	41	121	627	1	80	0.0125000
NODE_52292_length_460_cov_172.986150	41	121	636	2	80	0.0250000
NODE_52292_length_460_cov_172.986150	41	121	638	1	80	0.0125000
NODE_52292_length_460_cov_172.986150	41	121	639	1	80	0.0125000
NODE_52292_length_460_cov_172.986150	41	121	649	1	80	0.0125000
NODE_52292_length_460_cov_172.986150	41	121	656	1	80	0.0125000
NODE_52292_length_460_cov_172.986150	41	121	665	1	80	0.0125000
NODE_52292_length_460_cov_172.986150	41	121	673	1	80	0.0125000
NODE_52292_length_460_cov_172.986150	41	121	682	4	80	0.0500000
NODE_52292_length_460_cov_172.986150	41	121	684	1	80	0.0125000
NODE_52292_length_460_cov_172.986150	41	121	686	1	80	0.0125000
NODE_52292_length_460_cov_172.986150	41	121	687	1	80	0.0125000
NODE_52292_length_460_cov_172.986150	41	121	691	1	80	0.0125000
NODE_52292_length_460_cov_172.986150	41	121	694	1	80	0.0125000
NODE_52292_length_460_cov_172.986150	41	121	698	1	80	0.0125000
NODE_52292_length_460_cov_172.986150	41	121	699	1	80	0.0125000
NODE_52292_length_460_cov_172.986150	41	121	708	3	80	0.0375000
NODE_52292_length_460_cov_172.986150	41	121	714	1	80	0.0125000
NODE_52292_length_460_cov_172.986150	41	121	715	2	80	0.0250000
NODE_52292_length_460_cov_172.986150	41	121	717	1	80	0.0125000
NODE_52292_length_460_cov_172.986150	41	121	725	1	80	0.0125000
NODE_52292_length_460_cov_172.986150	41	121	735	1	80	0.0125000
NODE_52292_length_460_cov_172.986150	41	121	737	1	80	0.0125000
NODE_52292_length_460_cov_172.986150	41	121	747	1	80	0.0125000
NODE_52292_length_460_cov_172.986150	41	121	749	1	80	0.0125000
NODE_52292_length_460_cov_172.986150	41	121	762	2	80	0.0250000
NODE_52292_length_460_cov_172.986150	41	121	764	1	80	0.0125000
NODE_52292_length_460_cov_172.986150	41	121	768	1	80	0.0125000
NODE_52292_length_460_cov_172.986150	41	121	773	1	80	0.0125000
NODE_52292_length_460_cov_172.986150	41	121	776	2	80	0.0250000
NODE_52292_length_460_cov_172.986150	41	121	781	2	80	0.0250000
NODE_52292_length_460_cov_172.986150	41	121	782	1	80	0.0125000
NODE_52292_length_460_cov_172.986150	41	121	783	2	80	0.0250000
NODE_52292_length_460_cov_172.986150	41	121	784	1	80	0.0125000
NODE_52292_length_460_cov_172.986150	41	121	785	4	80	0.0500000
NODE_52292_length_460_cov_172.986150	41	121	787	1	80	0.0125000
NODE_52292_length_460_cov_172.986150	41	121	792	1	80	0.0125000
NODE_52292_length_460_cov_172.986150	41	121	793	2	80	0.0250000
NODE_52292_length_460_cov_172.986150	41	121	794	1	80	0.0125000
NODE_52292_length_460_cov_172.986150	41	121	795	2	80	0.0250000
NODE_52292_length_460_cov_172.986150	41	121	796	3	80	0.0375000
NODE_52292_length_460_cov_172.986150	41	121	797	1	80	0.0125000
NODE_52293_length_460_cov_62.512465	9	48	6	4	39	0.1025641
NODE_52293_length_460_cov_62.512465	9	48	10	13	39	0.3333333
NODE_52293_length_460_cov_62.512465	9	48	12	1	39	0.0256410
NODE_52293_length_460_cov_62.512465	9	48	14	17	39	0.4358974
NODE_52293_length_460_cov_62.512465	9	48	18	1	39	0.0256410
NODE_52293_length_460_cov_62.512465	9	48	20	3	39	0.0769231
NODE_52294_length_460_cov_33.146814	0	47	0	47	47	1.0000000
NODE_52294_length_460_cov_33.146814	43	115	0	72	72	1.0000000
NODE_52294_length_460_cov_33.146814	96	165	0	69	69	1.0000000
NODE_52295_length_460_cov_26.049861	0	63	4	9	63	0.1428571
NODE_52295_length_460_cov_26.049861	0	63	6	5	63	0.0793651
NODE_52295_length_460_cov_26.049861	0	63	10	14	63	0.2222222
NODE_52295_length_460_cov_26.049861	0	63	12	2	63	0.0317460
NODE_52295_length_460_cov_26.049861	0	63	20	18	63	0.2857143
NODE_52295_length_460_cov_26.049861	0	63	26	15	63	0.2380952
NODE_52296_length_460_cov_25.709141	246	326	0	80	80	1.0000000
NODE_52296_length_460_cov_25.709141	299	379	0	80	80	1.0000000
NODE_52297_length_460_cov_11.063712	273	353	0	80	80	1.0000000
NODE_52297_length_460_cov_11.063712	326	406	0	80	80	1.0000000
NODE_52303_length_460_cov_7.285319	172	250	4	55	78	0.7051282
NODE_52303_length_460_cov_7.285319	172	250	6	23	78	0.2948718
NODE_52312_length_460_cov_5.163435	120	200	13	7	80	0.0875000
NODE_52312_length_460_cov_5.163435	120	200	15	7	80	0.0875000
NODE_52312_length_460_cov_5.163435	120	200	16	5	80	0.0625000
NODE_52312_length_460_cov_5.163435	120	200	17	6	80	0.0750000
NODE_52312_length_460_cov_5.163435	120	200	18	2	80	0.0250000
NODE_52312_length_460_cov_5.163435	120	200	19	6	80	0.0750000
NODE_52312_length_460_cov_5.163435	120	200	21	9	80	0.1125000
NODE_52312_length_460_cov_5.163435	120	200	22	7	80	0.0875000
NODE_52312_length_460_cov_5.163435	120	200	23	19	80	0.2375000
NODE_52312_length_460_cov_5.163435	120	200	25	12	80	0.1500000
NODE_52312_length_460_cov_5.163435	173	253	8	8	80	0.1000000
NODE_52312_length_460_cov_5.163435	173	253	10	5	80	0.0625000
NODE_52312_length_460_cov_5.163435	173	253	12	13	80	0.1625000
NODE_52312_length_460_cov_5.163435	173	253	14	2	80	0.0250000
NODE_52312_length_460_cov_5.163435	173	253	16	30	80	0.3750000
NODE_52312_length_460_cov_5.163435	173	253	18	2	80	0.0250000
NODE_52312_length_460_cov_5.163435	173	253	22	7	80	0.0875000
NODE_52312_length_460_cov_5.163435	173	253	23	1	80	0.0125000
NODE_52312_length_460_cov_5.163435	173	253	25	12	80	0.1500000
NODE_52333_length_460_cov_3.457064	150	230	0	80	80	1.0000000
NODE_52333_length_460_cov_3.457064	203	246	0	43	43	1.0000000
NODE_52339_length_460_cov_3.027701	167	230	0	63	63	1.0000000
NODE_52347_length_460_cov_2.819945	195	266	0	35	71	0.4929577
NODE_52347_length_460_cov_2.819945	195	266	4	4	71	0.0563380
NODE_52347_length_460_cov_2.819945	195	266	8	6	71	0.0845070
NODE_52347_length_460_cov_2.819945	195	266	10	26	71	0.3661972
NODE_52358_length_460_cov_2.626039	223	277	0	54	54	1.0000000
NODE_52612_length_459_cov_34.927778	165	239	0	1	74	0.0135135
NODE_52612_length_459_cov_34.927778	165	239	2	73	74	0.9864865
NODE_52612_length_459_cov_34.927778	212	292	0	23	80	0.2875000
NODE_52612_length_459_cov_34.927778	212	292	2	57	80	0.7125000
NODE_52617_length_459_cov_7.261111	143	189	0	1	46	0.0217391
NODE_52617_length_459_cov_7.261111	143	189	2	45	46	0.9782609
NODE_52617_length_459_cov_7.261111	162	242	2	50	80	0.6250000
NODE_52617_length_459_cov_7.261111	162	242	4	30	80	0.3750000
NODE_52635_length_459_cov_4.127778	153	233	0	63	80	0.7875000
NODE_52635_length_459_cov_4.127778	153	233	2	17	80	0.2125000
NODE_52685_length_459_cov_2.158333	219	285	0	66	66	1.0000000
NODE_52685_length_459_cov_2.158333	283	342	0	59	59	1.0000000
NODE_52704_length_459_cov_1.722222	280	353	0	73	73	1.0000000
NODE_52920_length_458_cov_71.047354	0	51	0	51	51	1.0000000
NODE_52920_length_458_cov_71.047354	24	104	0	80	80	1.0000000
NODE_52920_length_458_cov_71.047354	100	180	0	39	80	0.4875000
NODE_52920_length_458_cov_71.047354	100	180	2	9	80	0.1125000
NODE_52920_length_458_cov_71.047354	100	180	6	5	80	0.0625000
NODE_52920_length_458_cov_71.047354	100	180	8	27	80	0.3375000
NODE_52920_length_458_cov_71.047354	153	233	8	28	80	0.3500000
NODE_52920_length_458_cov_71.047354	153	233	10	26	80	0.3250000
NODE_52920_length_458_cov_71.047354	153	233	14	22	80	0.2750000
NODE_52920_length_458_cov_71.047354	153	233	17	4	80	0.0500000
NODE_52921_length_458_cov_47.966574	151	231	0	80	80	1.0000000
NODE_52921_length_458_cov_47.966574	204	284	0	80	80	1.0000000
NODE_52921_length_458_cov_47.966574	280	360	0	80	80	1.0000000
NODE_52921_length_458_cov_47.966574	333	413	0	80	80	1.0000000
NODE_52924_length_458_cov_9.935933	267	347	4	80	80	1.0000000
NODE_52924_length_458_cov_9.935933	320	400	0	38	80	0.4750000
NODE_52924_length_458_cov_9.935933	320	400	4	42	80	0.5250000
NODE_52929_length_458_cov_7.598886	87	167	0	80	80	1.0000000
NODE_52967_length_458_cov_3.061281	62	91	0	29	29	1.0000000
NODE_52967_length_458_cov_3.061281	185	224	0	39	39	1.0000000
NODE_52992_length_458_cov_2.454039	210	251	2	41	41	1.0000000
NODE_53107_length_458_cov_1.139276	242	289	4	29	47	0.6170213
NODE_53107_length_458_cov_1.139276	242	289	6	17	47	0.3617021
NODE_53107_length_458_cov_1.139276	242	289	8	1	47	0.0212766
NODE_53107_length_458_cov_1.139276	262	328	4	22	66	0.3333333
NODE_53107_length_458_cov_1.139276	262	328	6	43	66	0.6515151
NODE_53107_length_458_cov_1.139276	262	328	8	1	66	0.0151515
NODE_53205_length_457_cov_20.754190	123	203	3	19	80	0.2375000
NODE_53205_length_457_cov_20.754190	123	203	4	61	80	0.7625000
NODE_53205_length_457_cov_20.754190	176	256	0	51	80	0.6375000
NODE_53205_length_457_cov_20.754190	176	256	2	1	80	0.0125000
NODE_53205_length_457_cov_20.754190	176	256	3	20	80	0.2500000
NODE_53205_length_457_cov_20.754190	176	256	4	8	80	0.1000000
NODE_53207_length_457_cov_13.918994	218	298	0	80	80	1.0000000
NODE_53207_length_457_cov_13.918994	218	298	0	80	80	1.0000000
NODE_53207_length_457_cov_13.918994	218	298	0	80	80	1.0000000
NODE_53207_length_457_cov_13.918994	218	298	0	80	80	1.0000000
NODE_53207_length_457_cov_13.918994	271	320	0	49	49	1.0000000
NODE_53207_length_457_cov_13.918994	271	320	0	49	49	1.0000000
NODE_53207_length_457_cov_13.918994	271	320	0	49	49	1.0000000
NODE_53216_length_457_cov_6.050279	264	326	0	1	62	0.0161290
NODE_53216_length_457_cov_6.050279	264	326	1	30	62	0.4838710
NODE_53216_length_457_cov_6.050279	264	326	2	31	62	0.5000000
NODE_53220_length_457_cov_5.078212	71	149	0	78	78	1.0000000
NODE_53220_length_457_cov_5.078212	122	202	0	80	80	1.0000000
NODE_53225_length_457_cov_4.530726	193	273	0	20	80	0.2500000
NODE_53225_length_457_cov_4.530726	193	273	2	60	80	0.7500000
NODE_53225_length_457_cov_4.530726	246	315	2	69	69	1.0000000
NODE_53230_length_457_cov_3.986034	192	272	0	80	80	1.0000000
NODE_53267_length_457_cov_2.636872	117	197	0	80	80	1.0000000
NODE_53462_length_457_cov_0.916201	108	188	0	80	80	1.0000000
NODE_53462_length_457_cov_0.916201	108	188	0	80	80	1.0000000
NODE_53462_length_457_cov_0.916201	161	241	0	80	80	1.0000000
NODE_53462_length_457_cov_0.916201	161	241	0	80	80	1.0000000
NODE_53512_length_456_cov_34.731092	0	63	0	51	63	0.8095238
NODE_53512_length_456_cov_34.731092	0	63	1	12	63	0.1904762
NODE_53512_length_456_cov_34.731092	36	116	0	15	80	0.1875000
NODE_53512_length_456_cov_34.731092	36	116	1	65	80	0.8125000
NODE_53512_length_456_cov_34.731092	112	194	1	55	82	0.6707317
NODE_53512_length_456_cov_34.731092	112	194	2	27	82	0.3292683
NODE_53532_length_456_cov_4.582633	269	349	0	80	80	1.0000000
NODE_53533_length_456_cov_4.554622	124	206	0	13	82	0.1585366
NODE_53533_length_456_cov_4.554622	124	206	2	69	82	0.8414634
NODE_53533_length_456_cov_4.554622	179	263	0	70	84	0.8333333
NODE_53533_length_456_cov_4.554622	179	263	2	14	84	0.1666667
NODE_53546_length_456_cov_3.669468	123	186	12	63	63	1.0000000
NODE_53566_length_456_cov_2.921569	302	362	0	60	60	1.0000000
NODE_53859_length_455_cov_113.589888	137	220	2	3	83	0.0361446
NODE_53859_length_455_cov_113.589888	137	220	4	79	83	0.9518072
NODE_53859_length_455_cov_113.589888	137	220	6	1	83	0.0120482
NODE_53859_length_455_cov_113.589888	198	268	0	42	70	0.6000000
NODE_53859_length_455_cov_113.589888	198	268	2	9	70	0.1285714
NODE_53859_length_455_cov_113.589888	198	268	4	19	70	0.2714286
NODE_53859_length_455_cov_113.589888	269	348	0	79	79	1.0000000
NODE_53859_length_455_cov_113.589888	321	401	0	80	80	1.0000000
NODE_53860_length_455_cov_52.941011	260	340	0	80	80	1.0000000
NODE_53860_length_455_cov_52.941011	313	393	0	80	80	1.0000000
NODE_53863_length_455_cov_8.584270	250	302	0	52	52	1.0000000
NODE_53863_length_455_cov_8.584270	275	355	0	80	80	1.0000000
NODE_53864_length_455_cov_8.084270	146	226	0	33	80	0.4125000
NODE_53864_length_455_cov_8.084270	146	226	2	6	80	0.0750000
NODE_53864_length_455_cov_8.084270	146	226	4	41	80	0.5125000
NODE_53864_length_455_cov_8.084270	199	279	0	80	80	1.0000000
NODE_53870_length_455_cov_6.022472	122	203	0	43	81	0.5308642
NODE_53870_length_455_cov_6.022472	122	203	2	38	81	0.4691358
NODE_53872_length_455_cov_5.140449	181	232	0	35	51	0.6862745
NODE_53872_length_455_cov_5.140449	181	232	8	16	51	0.3137255
NODE_54512_length_453_cov_29.528249	44	124	0	80	80	1.0000000
NODE_54512_length_453_cov_29.528249	97	177	0	80	80	1.0000000
NODE_54512_length_453_cov_29.528249	173	253	0	80	80	1.0000000
NODE_54512_length_453_cov_29.528249	226	301	0	75	75	1.0000000
NODE_54513_length_453_cov_11.146893	95	140	0	45	45	1.0000000
NODE_54513_length_453_cov_11.146893	146	220	0	74	74	1.0000000
NODE_54517_length_453_cov_7.709040	194	252	4	2	58	0.0344828
NODE_54517_length_453_cov_7.709040	194	252	5	7	58	0.1206897
NODE_54517_length_453_cov_7.709040	194	252	6	15	58	0.2586207
NODE_54517_length_453_cov_7.709040	194	252	7	34	58	0.5862069
NODE_54518_length_453_cov_7.440678	250	319	12	69	69	1.0000000
NODE_54533_length_453_cov_4.282486	190	270	0	80	80	1.0000000
NODE_54533_length_453_cov_4.282486	243	283	0	40	40	1.0000000
NODE_54566_length_453_cov_2.836158	186	266	0	80	80	1.0000000
NODE_54566_length_453_cov_2.836158	239	319	0	80	80	1.0000000
NODE_54592_length_453_cov_2.048023	139	174	6	11	35	0.3142857
NODE_54592_length_453_cov_2.048023	139	174	8	15	35	0.4285714
NODE_54592_length_453_cov_2.048023	139	174	10	9	35	0.2571429
NODE_54600_length_453_cov_2.002825	78	98	0	20	20	1.0000000
NODE_54767_length_453_cov_0.774011	174	195	0	21	21	1.0000000
NODE_54822_length_452_cov_36.028329	0	72	0	72	72	1.0000000
NODE_54822_length_452_cov_36.028329	0	72	0	72	72	1.0000000
NODE_54822_length_452_cov_36.028329	45	99	0	54	54	1.0000000
NODE_54822_length_452_cov_36.028329	45	125	0	80	80	1.0000000
NODE_54823_length_452_cov_17.424929	29	109	0	80	80	1.0000000
NODE_54823_length_452_cov_17.424929	82	162	0	80	80	1.0000000
NODE_54844_length_452_cov_4.317280	141	200	0	4	59	0.0677966
NODE_54844_length_452_cov_4.317280	141	200	1	24	59	0.4067796
NODE_54844_length_452_cov_4.317280	141	200	2	22	59	0.3728814
NODE_54844_length_452_cov_4.317280	141	200	4	9	59	0.1525424
NODE_54886_length_452_cov_2.634561	262	338	0	76	76	1.0000000
NODE_55146_length_451_cov_37.090909	230	310	0	80	80	1.0000000
NODE_55146_length_451_cov_37.090909	283	363	0	80	80	1.0000000
NODE_55147_length_451_cov_16.517045	205	286	2	81	81	1.0000000
NODE_55147_length_451_cov_16.517045	259	339	0	37	80	0.4625000
NODE_55147_length_451_cov_16.517045	259	339	2	43	80	0.5375000
NODE_55148_length_451_cov_13.153409	182	262	0	18	80	0.2250000
NODE_55148_length_451_cov_13.153409	182	262	5	21	80	0.2625000
NODE_55148_length_451_cov_13.153409	182	262	9	1	80	0.0125000
NODE_55148_length_451_cov_13.153409	182	262	10	40	80	0.5000000
NODE_55148_length_451_cov_13.153409	235	315	10	80	80	1.0000000
NODE_55149_length_451_cov_11.926136	141	221	10	1	80	0.0125000
NODE_55149_length_451_cov_11.926136	141	221	16	7	80	0.0875000
NODE_55149_length_451_cov_11.926136	141	221	18	6	80	0.0750000
NODE_55149_length_451_cov_11.926136	141	221	20	29	80	0.3625000
NODE_55149_length_451_cov_11.926136	141	221	24	37	80	0.4625000
NODE_55149_length_451_cov_11.926136	331	411	0	80	80	1.0000000
NODE_55154_length_451_cov_7.102273	81	143	0	44	62	0.7096774
NODE_55154_length_451_cov_7.102273	81	143	3	1	62	0.0161290
NODE_55154_length_451_cov_7.102273	81	143	4	1	62	0.0161290
NODE_55154_length_451_cov_7.102273	81	143	7	16	62	0.2580645
NODE_55161_length_451_cov_5.610795	1	31	0	30	30	1.0000000
NODE_55161_length_451_cov_5.610795	60	90	0	30	30	1.0000000
NODE_55166_length_451_cov_5.065341	219	285	0	66	66	1.0000000
NODE_55166_length_451_cov_5.065341	272	322	0	50	50	1.0000000
NODE_55184_length_451_cov_3.696023	253	332	6	2	79	0.0253165
NODE_55184_length_451_cov_3.696023	253	332	8	45	79	0.5696203
NODE_55184_length_451_cov_3.696023	253	332	10	24	79	0.3037975
NODE_55184_length_451_cov_3.696023	253	332	12	8	79	0.1012658
NODE_55188_length_451_cov_3.406250	176	247	17	2	71	0.0281690
NODE_55188_length_451_cov_3.406250	176	247	19	11	71	0.1549296
NODE_55188_length_451_cov_3.406250	176	247	21	6	71	0.0845070
NODE_55188_length_451_cov_3.406250	176	247	24	1	71	0.0140845
NODE_55188_length_451_cov_3.406250	176	247	25	49	71	0.6901408
NODE_55188_length_451_cov_3.406250	176	247	26	2	71	0.0281690
NODE_55188_length_451_cov_3.406250	220	300	14	10	80	0.1250000
NODE_55188_length_451_cov_3.406250	220	300	15	2	80	0.0250000
NODE_55188_length_451_cov_3.406250	220	300	16	7	80	0.0875000
NODE_55188_length_451_cov_3.406250	220	300	17	1	80	0.0125000
NODE_55188_length_451_cov_3.406250	220	300	19	9	80	0.1125000
NODE_55188_length_451_cov_3.406250	220	300	21	1	80	0.0125000
NODE_55188_length_451_cov_3.406250	220	300	23	6	80	0.0750000
NODE_55188_length_451_cov_3.406250	220	300	25	42	80	0.5250000
NODE_55188_length_451_cov_3.406250	220	300	26	2	80	0.0250000
NODE_55198_length_451_cov_3.025568	72	148	2	18	76	0.2368421
NODE_55198_length_451_cov_3.025568	72	148	4	53	76	0.6973684
NODE_55198_length_451_cov_3.025568	72	148	6	5	76	0.0657895
NODE_55213_length_451_cov_2.607955	84	143	0	43	59	0.7288136
NODE_55213_length_451_cov_2.607955	84	143	2	12	59	0.2033898
NODE_55213_length_451_cov_2.607955	84	143	4	4	59	0.0677966
NODE_55213_length_451_cov_2.607955	257	326	0	1	69	0.0144928
NODE_55213_length_451_cov_2.607955	257	326	2	14	69	0.2028985
NODE_55213_length_451_cov_2.607955	257	326	4	54	69	0.7826087
NODE_55234_length_451_cov_2.125000	156	224	0	18	68	0.2647059
NODE_55234_length_451_cov_2.125000	156	224	2	50	68	0.7352941
NODE_55436_length_450_cov_105.723647	317	386	0	69	69	1.0000000
NODE_55438_length_450_cov_27.982906	98	120	0	22	22	1.0000000
NODE_55438_length_450_cov_27.982906	225	305	0	80	80	1.0000000
NODE_55438_length_450_cov_27.982906	278	358	0	80	80	1.0000000
NODE_55459_length_450_cov_3.991453	220	290	0	70	70	1.0000000
NODE_55459_length_450_cov_3.991453	223	290	0	67	67	1.0000000
NODE_55459_length_450_cov_3.991453	268	348	0	80	80	1.0000000
NODE_55459_length_450_cov_3.991453	268	348	0	80	80	1.0000000
NODE_55459_length_450_cov_3.991453	278	348	0	70	70	1.0000000
NODE_55459_length_450_cov_3.991453	344	363	0	19	19	1.0000000
NODE_55466_length_450_cov_3.717949	107	177	0	70	70	1.0000000
NODE_55483_length_450_cov_3.162393	99	157	0	9	58	0.1551724
NODE_55483_length_450_cov_3.162393	99	157	2	49	58	0.8448276
NODE_55550_length_450_cov_1.857550	114	172	4	1	58	0.0172414
NODE_55550_length_450_cov_1.857550	114	172	6	18	58	0.3103448
NODE_55550_length_450_cov_1.857550	114	172	8	2	58	0.0344828
NODE_55550_length_450_cov_1.857550	114	172	10	19	58	0.3275862
NODE_55550_length_450_cov_1.857550	114	172	12	18	58	0.3103448
NODE_55560_length_450_cov_1.749288	321	376	0	55	55	1.0000000
NODE_55565_length_450_cov_1.723647	101	161	28	1	60	0.0166667
NODE_55565_length_450_cov_1.723647	101	161	34	1	60	0.0166667
NODE_55565_length_450_cov_1.723647	101	161	41	1	60	0.0166667
NODE_55565_length_450_cov_1.723647	101	161	42	1	60	0.0166667
NODE_55565_length_450_cov_1.723647	101	161	44	3	60	0.0500000
NODE_55565_length_450_cov_1.723647	101	161	46	13	60	0.2166667
NODE_55565_length_450_cov_1.723647	101	161	48	9	60	0.1500000
NODE_55565_length_450_cov_1.723647	101	161	50	16	60	0.2666667
NODE_55565_length_450_cov_1.723647	101	161	52	15	60	0.2500000
NODE_55685_length_450_cov_1.017094	116	196	0	80	80	1.0000000
NODE_55761_length_449_cov_46.882857	237	317	0	80	80	1.0000000
NODE_55761_length_449_cov_46.882857	290	370	0	80	80	1.0000000
NODE_55762_length_449_cov_36.031429	238	318	0	46	80	0.5750000
NODE_55762_length_449_cov_36.031429	238	318	2	2	80	0.0250000
NODE_55762_length_449_cov_36.031429	238	318	10	32	80	0.4000000
NODE_55762_length_449_cov_36.031429	291	371	9	37	80	0.4625000
NODE_55762_length_449_cov_36.031429	291	371	10	43	80	0.5375000
NODE_55783_length_449_cov_4.594286	137	184	8	47	47	1.0000000
NODE_55794_length_449_cov_3.797143	204	284	0	80	80	1.0000000
NODE_55844_length_449_cov_2.445714	346	376	0	30	30	1.0000000
NODE_56144_length_448_cov_44.664756	126	206	0	80	80	1.0000000
NODE_56144_length_448_cov_44.664756	179	259	0	80	80	1.0000000
NODE_56145_length_448_cov_36.148997	195	275	0	62	80	0.7750000
NODE_56145_length_448_cov_36.148997	195	275	2	18	80	0.2250000
NODE_56145_length_448_cov_36.148997	248	328	0	80	80	1.0000000
NODE_56145_length_448_cov_36.148997	324	404	0	80	80	1.0000000
NODE_56145_length_448_cov_36.148997	377	448	0	71	71	1.0000000
NODE_56146_length_448_cov_31.816619	43	123	0	80	80	1.0000000
NODE_56151_length_448_cov_6.779370	197	277	0	80	80	1.0000000
NODE_56151_length_448_cov_6.779370	250	313	0	63	63	1.0000000
NODE_56180_length_448_cov_3.664756	148	189	0	41	41	1.0000000
NODE_56189_length_448_cov_3.108883	242	324	2	1	82	0.0121951
NODE_56189_length_448_cov_3.108883	242	324	4	5	82	0.0609756
NODE_56189_length_448_cov_3.108883	242	324	6	15	82	0.1829268
NODE_56189_length_448_cov_3.108883	242	324	10	61	82	0.7439024
NODE_56233_length_448_cov_2.263610	292	360	0	68	68	1.0000000
NODE_56518_length_447_cov_10.505747	205	234	0	29	29	1.0000000
NODE_56518_length_447_cov_10.505747	267	326	0	59	59	1.0000000
NODE_56518_length_447_cov_10.505747	299	379	0	80	80	1.0000000
NODE_56527_length_447_cov_5.767241	176	256	0	18	80	0.2250000
NODE_56527_length_447_cov_5.767241	176	256	1	17	80	0.2125000
NODE_56527_length_447_cov_5.767241	176	256	3	9	80	0.1125000
NODE_56527_length_447_cov_5.767241	176	256	5	36	80	0.4500000
NODE_56527_length_447_cov_5.767241	229	309	0	71	80	0.8875000
NODE_56527_length_447_cov_5.767241	229	309	1	9	80	0.1125000
NODE_56539_length_447_cov_4.583333	265	289	0	24	24	1.0000000
NODE_56545_length_447_cov_4.037356	58	138	0	80	80	1.0000000
NODE_56545_length_447_cov_4.037356	111	191	0	34	80	0.4250000
NODE_56545_length_447_cov_4.037356	111	191	1	46	80	0.5750000
NODE_56890_length_446_cov_42.527378	239	310	2	43	71	0.6056338
NODE_56890_length_446_cov_42.527378	239	310	4	14	71	0.1971831
NODE_56890_length_446_cov_42.527378	239	310	6	6	71	0.0845070
NODE_56890_length_446_cov_42.527378	239	310	7	3	71	0.0422535
NODE_56890_length_446_cov_42.527378	239	310	8	3	71	0.0422535
NODE_56890_length_446_cov_42.527378	239	310	9	2	71	0.0281690
NODE_56890_length_446_cov_42.527378	359	433	1	21	74	0.2837838
NODE_56890_length_446_cov_42.527378	359	433	7	9	74	0.1216216
NODE_56890_length_446_cov_42.527378	359	433	9	41	74	0.5540541
NODE_56890_length_446_cov_42.527378	359	433	10	3	74	0.0405405
NODE_56891_length_446_cov_12.749280	92	172	2	21	80	0.2625000
NODE_56891_length_446_cov_12.749280	92	172	3	5	80	0.0625000
NODE_56891_length_446_cov_12.749280	92	172	4	1	80	0.0125000
NODE_56891_length_446_cov_12.749280	92	172	8	53	80	0.6625000
NODE_56891_length_446_cov_12.749280	145	225	0	14	80	0.1750000
NODE_56891_length_446_cov_12.749280	145	225	2	4	80	0.0500000
NODE_56891_length_446_cov_12.749280	145	225	6	10	80	0.1250000
NODE_56891_length_446_cov_12.749280	145	225	8	52	80	0.6500000
NODE_56896_length_446_cov_6.902017	175	217	0	42	42	1.0000000
NODE_56902_length_446_cov_5.930836	165	245	0	62	80	0.7750000
NODE_56902_length_446_cov_5.930836	165	245	2	18	80	0.2250000
NODE_56902_length_446_cov_5.930836	165	245	0	62	80	0.7750000
NODE_56902_length_446_cov_5.930836	165	245	2	18	80	0.2250000
NODE_56902_length_446_cov_5.930836	165	235	0	52	70	0.7428572
NODE_56902_length_446_cov_5.930836	165	235	2	18	70	0.2571429
NODE_56902_length_446_cov_5.930836	218	298	0	80	80	1.0000000
NODE_56902_length_446_cov_5.930836	218	297	0	79	79	1.0000000
NODE_56919_length_446_cov_3.896254	215	274	2	13	59	0.2203390
NODE_56919_length_446_cov_3.896254	215	274	4	46	59	0.7796610
NODE_56934_length_446_cov_3.282421	130	168	0	38	38	1.0000000
NODE_56952_length_446_cov_2.775216	337	417	0	80	80	1.0000000
NODE_56995_length_446_cov_2.161383	17	97	0	80	80	1.0000000
NODE_57022_length_446_cov_1.907781	196	225	6	9	29	0.3103448
NODE_57022_length_446_cov_1.907781	196	225	8	6	29	0.2068966
NODE_57022_length_446_cov_1.907781	196	225	10	14	29	0.4827586
NODE_57277_length_445_cov_75.572254	108	188	0	56	80	0.7000000
NODE_57277_length_445_cov_75.572254	108	188	4	24	80	0.3000000
NODE_57277_length_445_cov_75.572254	161	241	0	3	80	0.0375000
NODE_57277_length_445_cov_75.572254	161	241	4	77	80	0.9625000
NODE_57277_length_445_cov_75.572254	237	317	0	72	80	0.9000000
NODE_57277_length_445_cov_75.572254	237	317	4	8	80	0.1000000
NODE_57277_length_445_cov_75.572254	290	370	0	80	80	1.0000000
NODE_57278_length_445_cov_33.973988	83	163	0	80	80	1.0000000
NODE_57278_length_445_cov_33.973988	136	216	0	80	80	1.0000000
NODE_57280_length_445_cov_9.323699	78	148	0	70	70	1.0000000
NODE_57280_length_445_cov_9.323699	121	201	0	80	80	1.0000000
NODE_57284_length_445_cov_6.439306	210	282	0	59	72	0.8194444
NODE_57284_length_445_cov_6.439306	210	282	1	1	72	0.0138889
NODE_57284_length_445_cov_6.439306	210	282	2	2	72	0.0277778
NODE_57284_length_445_cov_6.439306	210	282	4	10	72	0.1388889
NODE_57286_length_445_cov_5.479769	115	184	0	51	69	0.7391304
NODE_57286_length_445_cov_5.479769	115	184	2	18	69	0.2608696
NODE_57286_length_445_cov_5.479769	157	237	0	9	80	0.1125000
NODE_57286_length_445_cov_5.479769	157	237	2	50	80	0.6250000
NODE_57286_length_445_cov_5.479769	157	237	4	4	80	0.0500000
NODE_57286_length_445_cov_5.479769	157	237	6	17	80	0.2125000
NODE_57286_length_445_cov_5.479769	233	309	2	7	76	0.0921053
NODE_57286_length_445_cov_5.479769	233	309	4	69	76	0.9078947
NODE_57286_length_445_cov_5.479769	286	309	2	7	23	0.3043478
NODE_57286_length_445_cov_5.479769	286	309	4	16	23	0.6956522
NODE_57345_length_445_cov_2.843931	124	199	0	75	75	1.0000000
NODE_57352_length_445_cov_2.682081	202	248	4	31	46	0.6739131
NODE_57352_length_445_cov_2.682081	202	248	6	15	46	0.3260870
NODE_57400_length_445_cov_1.884393	252	332	2	62	80	0.7750000
NODE_57400_length_445_cov_1.884393	252	332	4	18	80	0.2250000
NODE_57409_length_445_cov_1.783237	132	203	4	17	71	0.2394366
NODE_57409_length_445_cov_1.783237	132	203	6	54	71	0.7605634
NODE_57409_length_445_cov_1.783237	256	331	0	39	75	0.5200000
NODE_57409_length_445_cov_1.783237	256	331	1	4	75	0.0533333
NODE_57409_length_445_cov_1.783237	256	331	2	32	75	0.4266667
NODE_57409_length_445_cov_1.783237	256	278	0	18	22	0.8181818
NODE_57409_length_445_cov_1.783237	256	278	1	4	22	0.1818182
NODE_57644_length_444_cov_34.075362	243	323	0	66	80	0.8250000
NODE_57644_length_444_cov_34.075362	243	323	2	14	80	0.1750000
NODE_57644_length_444_cov_34.075362	296	376	0	13	80	0.1625000
NODE_57644_length_444_cov_34.075362	296	376	2	67	80	0.8375000
NODE_57645_length_444_cov_22.524638	98	178	0	80	80	1.0000000
NODE_57645_length_444_cov_22.524638	151	231	0	80	80	1.0000000
NODE_57646_length_444_cov_16.544928	263	343	1	52	80	0.6500000
NODE_57646_length_444_cov_16.544928	263	343	2	28	80	0.3500000
NODE_57646_length_444_cov_16.544928	316	396	0	40	80	0.5000000
NODE_57646_length_444_cov_16.544928	316	396	1	40	80	0.5000000
NODE_57647_length_444_cov_12.684058	293	373	0	80	80	1.0000000
NODE_57647_length_444_cov_12.684058	346	426	0	32	80	0.4000000
NODE_57647_length_444_cov_12.684058	346	426	2	48	80	0.6000000
NODE_57649_length_444_cov_9.284058	176	256	0	80	80	1.0000000
NODE_57649_length_444_cov_9.284058	229	309	0	80	80	1.0000000
NODE_57666_length_444_cov_5.159420	170	241	0	71	71	1.0000000
NODE_57668_length_444_cov_5.060870	201	245	0	4	44	0.0909091
NODE_57668_length_444_cov_5.060870	201	245	2	14	44	0.3181818
NODE_57668_length_444_cov_5.060870	201	245	6	6	44	0.1363636
NODE_57668_length_444_cov_5.060870	201	245	7	20	44	0.4545455
NODE_57668_length_444_cov_5.060870	218	298	2	1	80	0.0125000
NODE_57668_length_444_cov_5.060870	218	298	6	6	80	0.0750000
NODE_57668_length_444_cov_5.060870	218	298	7	56	80	0.7000000
NODE_57668_length_444_cov_5.060870	218	298	9	17	80	0.2125000
NODE_57717_length_444_cov_2.744928	73	136	0	63	63	1.0000000
NODE_57770_length_444_cov_2.028986	46	113	29	1	67	0.0149254
NODE_57770_length_444_cov_2.028986	46	113	33	6	67	0.0895522
NODE_57770_length_444_cov_2.028986	46	113	37	1	67	0.0149254
NODE_57770_length_444_cov_2.028986	46	113	38	1	67	0.0149254
NODE_57770_length_444_cov_2.028986	46	113	40	2	67	0.0298507
NODE_57770_length_444_cov_2.028986	46	113	44	1	67	0.0149254
NODE_57770_length_444_cov_2.028986	46	113	46	2	67	0.0298507
NODE_57770_length_444_cov_2.028986	46	113	48	1	67	0.0149254
NODE_57770_length_444_cov_2.028986	46	113	52	2	67	0.0298507
NODE_57770_length_444_cov_2.028986	46	113	53	8	67	0.1194030
NODE_57770_length_444_cov_2.028986	46	113	55	2	67	0.0298507
NODE_57770_length_444_cov_2.028986	46	113	59	2	67	0.0298507
NODE_57770_length_444_cov_2.028986	46	113	65	1	67	0.0149254
NODE_57770_length_444_cov_2.028986	46	113	67	2	67	0.0298507
NODE_57770_length_444_cov_2.028986	46	113	71	2	67	0.0298507
NODE_57770_length_444_cov_2.028986	46	113	72	1	67	0.0149254
NODE_57770_length_444_cov_2.028986	46	113	73	2	67	0.0298507
NODE_57770_length_444_cov_2.028986	46	113	75	1	67	0.0149254
NODE_57770_length_444_cov_2.028986	46	113	77	2	67	0.0298507
NODE_57770_length_444_cov_2.028986	46	113	79	1	67	0.0149254
NODE_57770_length_444_cov_2.028986	46	113	83	1	67	0.0149254
NODE_57770_length_444_cov_2.028986	46	113	85	2	67	0.0298507
NODE_57770_length_444_cov_2.028986	46	113	86	2	67	0.0298507
NODE_57770_length_444_cov_2.028986	46	113	88	5	67	0.0746269
NODE_57770_length_444_cov_2.028986	46	113	90	5	67	0.0746269
NODE_57770_length_444_cov_2.028986	46	113	91	1	67	0.0149254
NODE_57770_length_444_cov_2.028986	46	113	92	3	67	0.0447761
NODE_57770_length_444_cov_2.028986	46	113	94	7	67	0.1044776
NODE_57770_length_444_cov_2.028986	86	166	40	1	80	0.0125000
NODE_57770_length_444_cov_2.028986	86	166	42	3	80	0.0375000
NODE_57770_length_444_cov_2.028986	86	166	48	1	80	0.0125000
NODE_57770_length_444_cov_2.028986	86	166	52	2	80	0.0250000
NODE_57770_length_444_cov_2.028986	86	166	58	1	80	0.0125000
NODE_57770_length_444_cov_2.028986	86	166	62	4	80	0.0500000
NODE_57770_length_444_cov_2.028986	86	166	64	2	80	0.0250000
NODE_57770_length_444_cov_2.028986	86	166	66	4	80	0.0500000
NODE_57770_length_444_cov_2.028986	86	166	68	1	80	0.0125000
NODE_57770_length_444_cov_2.028986	86	166	70	2	80	0.0250000
NODE_57770_length_444_cov_2.028986	86	166	73	3	80	0.0375000
NODE_57770_length_444_cov_2.028986	86	166	75	4	80	0.0500000
NODE_57770_length_444_cov_2.028986	86	166	79	2	80	0.0250000
NODE_57770_length_444_cov_2.028986	86	166	83	1	80	0.0125000
NODE_57770_length_444_cov_2.028986	86	166	84	8	80	0.1000000
NODE_57770_length_444_cov_2.028986	86	166	85	2	80	0.0250000
NODE_57770_length_444_cov_2.028986	86	166	86	5	80	0.0625000
NODE_57770_length_444_cov_2.028986	86	166	88	7	80	0.0875000
NODE_57770_length_444_cov_2.028986	86	166	90	8	80	0.1000000
NODE_57770_length_444_cov_2.028986	86	166	91	4	80	0.0500000
NODE_57770_length_444_cov_2.028986	86	166	92	3	80	0.0375000
NODE_57770_length_444_cov_2.028986	86	166	93	4	80	0.0500000
NODE_57770_length_444_cov_2.028986	86	166	94	8	80	0.1000000
NODE_57873_length_444_cov_1.234783	335	407	0	72	72	1.0000000
NODE_57892_length_444_cov_1.173913	7	87	2	1	80	0.0125000
NODE_57892_length_444_cov_1.173913	7	87	8	79	80	0.9875000
NODE_58026_length_443_cov_71.284884	209	289	6	2	80	0.0250000
NODE_58026_length_443_cov_71.284884	209	289	7	12	80	0.1500000
NODE_58026_length_443_cov_71.284884	209	289	8	1	80	0.0125000
NODE_58026_length_443_cov_71.284884	209	289	11	1	80	0.0125000
NODE_58026_length_443_cov_71.284884	209	289	12	63	80	0.7875000
NODE_58026_length_443_cov_71.284884	209	289	14	1	80	0.0125000
NODE_58026_length_443_cov_71.284884	262	342	6	22	80	0.2750000
NODE_58026_length_443_cov_71.284884	262	342	8	4	80	0.0500000
NODE_58026_length_443_cov_71.284884	262	342	10	4	80	0.0500000
NODE_58026_length_443_cov_71.284884	262	342	11	1	80	0.0125000
NODE_58026_length_443_cov_71.284884	262	342	12	48	80	0.6000000
NODE_58026_length_443_cov_71.284884	262	342	14	1	80	0.0125000
NODE_58026_length_443_cov_71.284884	338	418	4	22	80	0.2750000
NODE_58026_length_443_cov_71.284884	338	418	6	58	80	0.7250000
NODE_58026_length_443_cov_71.284884	391	443	0	4	52	0.0769231
NODE_58026_length_443_cov_71.284884	391	443	4	43	52	0.8269231
NODE_58026_length_443_cov_71.284884	391	443	6	5	52	0.0961538
NODE_58027_length_443_cov_68.973837	314	394	4	6	80	0.0750000
NODE_58027_length_443_cov_68.973837	314	394	6	74	80	0.9250000
NODE_58027_length_443_cov_68.973837	367	443	0	17	76	0.2236842
NODE_58027_length_443_cov_68.973837	367	443	4	38	76	0.5000000
NODE_58027_length_443_cov_68.973837	367	443	6	21	76	0.2763158
NODE_58028_length_443_cov_61.116279	34	114	0	4	80	0.0500000
NODE_58028_length_443_cov_61.116279	34	114	8	36	80	0.4500000
NODE_58028_length_443_cov_61.116279	34	114	10	40	80	0.5000000
NODE_58028_length_443_cov_61.116279	87	167	10	80	80	1.0000000
NODE_58041_length_443_cov_4.895349	127	207	0	80	80	1.0000000
NODE_58086_length_443_cov_2.581395	121	195	0	74	74	1.0000000
NODE_58088_length_443_cov_2.508721	297	347	0	5	50	0.1000000
NODE_58088_length_443_cov_2.508721	297	347	2	27	50	0.5400000
NODE_58088_length_443_cov_2.508721	297	347	4	1	50	0.0200000
NODE_58088_length_443_cov_2.508721	297	347	5	9	50	0.1800000
NODE_58088_length_443_cov_2.508721	297	347	6	8	50	0.1600000
NODE_58088_length_443_cov_2.508721	320	395	0	53	75	0.7066666
NODE_58088_length_443_cov_2.508721	320	395	2	22	75	0.2933333
NODE_58091_length_443_cov_2.456395	114	192	0	78	78	1.0000000
NODE_58091_length_443_cov_2.456395	118	141	0	23	23	1.0000000
NODE_58237_length_443_cov_1.151163	144	224	2	9	80	0.1125000
NODE_58237_length_443_cov_1.151163	144	224	4	71	80	0.8875000
NODE_58321_length_443_cov_0.715116	52	104	0	52	52	1.0000000
NODE_58321_length_443_cov_0.715116	105	146	0	21	41	0.5121951
NODE_58321_length_443_cov_0.715116	105	146	2	20	41	0.4878049
NODE_58346_length_442_cov_42.956268	290	375	8	10	85	0.1176471
NODE_58346_length_442_cov_42.956268	290	375	10	9	85	0.1058824
NODE_58346_length_442_cov_42.956268	290	375	14	4	85	0.0470588
NODE_58346_length_442_cov_42.956268	290	375	18	4	85	0.0470588
NODE_58346_length_442_cov_42.956268	290	375	22	11	85	0.1294118
NODE_58346_length_442_cov_42.956268	290	375	24	2	85	0.0235294
NODE_58346_length_442_cov_42.956268	290	375	26	10	85	0.1176471
NODE_58346_length_442_cov_42.956268	290	375	29	1	85	0.0117647
NODE_58346_length_442_cov_42.956268	290	375	30	4	85	0.0470588
NODE_58346_length_442_cov_42.956268	290	375	32	30	85	0.3529412
NODE_58346_length_442_cov_42.956268	290	375	8	10	85	0.1176471
NODE_58346_length_442_cov_42.956268	290	375	10	9	85	0.1058824
NODE_58346_length_442_cov_42.956268	290	375	14	4	85	0.0470588
NODE_58346_length_442_cov_42.956268	290	375	18	4	85	0.0470588
NODE_58346_length_442_cov_42.956268	290	375	22	11	85	0.1294118
NODE_58346_length_442_cov_42.956268	290	375	24	2	85	0.0235294
NODE_58346_length_442_cov_42.956268	290	375	26	10	85	0.1176471
NODE_58346_length_442_cov_42.956268	290	375	29	1	85	0.0117647
NODE_58346_length_442_cov_42.956268	290	375	30	4	85	0.0470588
NODE_58346_length_442_cov_42.956268	290	375	32	30	85	0.3529412
NODE_58347_length_442_cov_24.093294	225	305	0	80	80	1.0000000
NODE_58347_length_442_cov_24.093294	278	358	0	80	80	1.0000000
NODE_58348_length_442_cov_8.956268	173	192	0	19	19	1.0000000
NODE_58361_length_442_cov_5.052478	213	293	0	80	80	1.0000000
NODE_58361_length_442_cov_5.052478	266	346	0	80	80	1.0000000
NODE_58376_length_442_cov_3.871720	297	372	0	5	75	0.0666667
NODE_58376_length_442_cov_3.871720	297	372	2	3	75	0.0400000
NODE_58376_length_442_cov_3.871720	297	372	8	1	75	0.0133333
NODE_58376_length_442_cov_3.871720	297	372	10	7	75	0.0933333
NODE_58376_length_442_cov_3.871720	297	372	12	59	75	0.7866667
NODE_58376_length_442_cov_3.871720	360	413	0	7	53	0.1320755
NODE_58376_length_442_cov_3.871720	360	413	2	1	53	0.0188679
NODE_58376_length_442_cov_3.871720	360	413	4	22	53	0.4150943
NODE_58376_length_442_cov_3.871720	360	413	8	4	53	0.0754717
NODE_58376_length_442_cov_3.871720	360	413	10	13	53	0.2452830
NODE_58376_length_442_cov_3.871720	360	413	12	6	53	0.1132075
NODE_58378_length_442_cov_3.804665	211	244	0	30	33	0.9090909
NODE_58378_length_442_cov_3.804665	211	244	4	2	33	0.0606061
NODE_58378_length_442_cov_3.804665	211	244	12	1	33	0.0303030
NODE_58405_length_442_cov_3.206997	149	217	0	2	68	0.0294118
NODE_58405_length_442_cov_3.206997	149	217	2	2	68	0.0294118
NODE_58405_length_442_cov_3.206997	149	217	8	1	68	0.0147059
NODE_58405_length_442_cov_3.206997	149	217	10	63	68	0.9264706
NODE_58438_length_442_cov_2.434402	203	274	8	16	71	0.2253521
NODE_58438_length_442_cov_2.434402	203	274	10	28	71	0.3943662
NODE_58438_length_442_cov_2.434402	203	274	12	27	71	0.3802817
NODE_58438_length_442_cov_2.434402	247	327	8	11	80	0.1375000
NODE_58438_length_442_cov_2.434402	247	327	9	2	80	0.0250000
NODE_58438_length_442_cov_2.434402	247	327	10	10	80	0.1250000
NODE_58438_length_442_cov_2.434402	247	327	12	57	80	0.7125000
NODE_58503_length_442_cov_1.746356	95	161	0	35	66	0.5303030
NODE_58503_length_442_cov_1.746356	95	161	2	31	66	0.4696970
NODE_58503_length_442_cov_1.746356	95	122	0	27	27	1.0000000
NODE_58759_length_441_cov_21.877193	28	108	0	80	80	1.0000000
NODE_58759_length_441_cov_21.877193	81	161	0	80	80	1.0000000
NODE_58760_length_441_cov_13.546784	152	232	0	10	80	0.1250000
NODE_58760_length_441_cov_13.546784	152	232	2	48	80	0.6000000
NODE_58760_length_441_cov_13.546784	152	232	4	22	80	0.2750000
NODE_58760_length_441_cov_13.546784	205	285	2	38	80	0.4750000
NODE_58760_length_441_cov_13.546784	205	285	4	42	80	0.5250000
NODE_58771_length_441_cov_5.710526	200	280	0	80	80	1.0000000
NODE_58771_length_441_cov_5.710526	253	333	0	80	80	1.0000000
NODE_58817_length_441_cov_3.096491	240	324	0	16	84	0.1904762
NODE_58817_length_441_cov_3.096491	240	324	2	25	84	0.2976190
NODE_58817_length_441_cov_3.096491	240	324	4	43	84	0.5119048
NODE_58820_length_441_cov_3.023392	105	163	4	7	58	0.1206897
NODE_58820_length_441_cov_3.023392	105	163	8	36	58	0.6206896
NODE_58820_length_441_cov_3.023392	105	163	11	6	58	0.1034483
NODE_58820_length_441_cov_3.023392	105	163	13	4	58	0.0689655
NODE_58820_length_441_cov_3.023392	105	163	14	5	58	0.0862069
NODE_58852_length_441_cov_2.438596	19	99	0	22	80	0.2750000
NODE_58852_length_441_cov_2.438596	19	99	6	1	80	0.0125000
NODE_58852_length_441_cov_2.438596	19	99	10	16	80	0.2000000
NODE_58852_length_441_cov_2.438596	19	99	12	41	80	0.5125000
NODE_58852_length_441_cov_2.438596	72	126	12	54	54	1.0000000
NODE_58970_length_441_cov_1.435673	105	156	0	51	51	1.0000000
NODE_59142_length_440_cov_43.131965	122	202	0	80	80	1.0000000
NODE_59142_length_440_cov_43.131965	175	255	0	78	80	0.9750000
NODE_59142_length_440_cov_43.131965	175	255	2	2	80	0.0250000
NODE_59142_length_440_cov_43.131965	251	331	0	2	80	0.0250000
NODE_59142_length_440_cov_43.131965	251	331	2	75	80	0.9375000
NODE_59142_length_440_cov_43.131965	251	331	4	3	80	0.0375000
NODE_59142_length_440_cov_43.131965	304	384	2	56	80	0.7000000
NODE_59142_length_440_cov_43.131965	304	384	4	24	80	0.3000000
NODE_59143_length_440_cov_42.929619	116	196	1	68	80	0.8500000
NODE_59143_length_440_cov_42.929619	116	196	2	12	80	0.1500000
NODE_59143_length_440_cov_42.929619	169	249	1	15	80	0.1875000
NODE_59143_length_440_cov_42.929619	169	249	2	65	80	0.8125000
NODE_59147_length_440_cov_8.164223	45	125	0	80	80	1.0000000
NODE_59147_length_440_cov_8.164223	98	178	0	80	80	1.0000000
NODE_59157_length_440_cov_5.193548	146	210	0	41	64	0.6406250
NODE_59157_length_440_cov_5.193548	146	210	2	4	64	0.0625000
NODE_59157_length_440_cov_5.193548	146	210	4	19	64	0.2968750
NODE_59157_length_440_cov_5.193548	146	210	0	41	64	0.6406250
NODE_59157_length_440_cov_5.193548	146	210	2	4	64	0.0625000
NODE_59157_length_440_cov_5.193548	146	210	4	19	64	0.2968750
NODE_59157_length_440_cov_5.193548	146	210	0	41	64	0.6406250
NODE_59157_length_440_cov_5.193548	146	210	2	4	64	0.0625000
NODE_59157_length_440_cov_5.193548	146	210	4	19	64	0.2968750
NODE_59164_length_440_cov_4.595308	153	233	0	80	80	1.0000000
NODE_59164_length_440_cov_4.595308	153	180	0	27	27	1.0000000
NODE_59188_length_440_cov_3.431085	84	150	2	30	66	0.4545455
NODE_59188_length_440_cov_3.431085	84	150	4	15	66	0.2272727
NODE_59188_length_440_cov_3.431085	84	150	6	21	66	0.3181818
NODE_59191_length_440_cov_3.331378	139	195	4	56	56	1.0000000
NODE_59517_length_439_cov_76.552941	0	68	0	68	68	1.0000000
NODE_59517_length_439_cov_76.552941	0	68	0	68	68	1.0000000
NODE_59517_length_439_cov_76.552941	0	68	0	68	68	1.0000000
NODE_59517_length_439_cov_76.552941	1	68	0	67	67	1.0000000
NODE_59517_length_439_cov_76.552941	64	144	0	80	80	1.0000000
NODE_59517_length_439_cov_76.552941	64	144	0	80	80	1.0000000
NODE_59517_length_439_cov_76.552941	117	197	0	80	80	1.0000000
NODE_59517_length_439_cov_76.552941	117	195	0	78	78	1.0000000
NODE_59533_length_439_cov_4.408824	174	238	0	64	64	1.0000000
NODE_59536_length_439_cov_4.255882	258	318	6	3	60	0.0500000
NODE_59536_length_439_cov_4.255882	258	318	10	8	60	0.1333333
NODE_59536_length_439_cov_4.255882	258	318	12	49	60	0.8166667
NODE_59560_length_439_cov_3.011765	57	128	30	16	71	0.2253521
NODE_59560_length_439_cov_3.011765	57	128	32	1	71	0.0140845
NODE_59560_length_439_cov_3.011765	57	128	34	8	71	0.1126761
NODE_59560_length_439_cov_3.011765	57	128	36	27	71	0.3802817
NODE_59560_length_439_cov_3.011765	57	128	37	1	71	0.0140845
NODE_59560_length_439_cov_3.011765	57	128	38	18	71	0.2535211
NODE_59560_length_439_cov_3.011765	101	140	35	3	39	0.0769231
NODE_59560_length_439_cov_3.011765	101	140	36	10	39	0.2564103
NODE_59560_length_439_cov_3.011765	101	140	37	4	39	0.1025641
NODE_59560_length_439_cov_3.011765	101	140	38	22	39	0.5641026
NODE_59592_length_439_cov_2.252941	227	269	2	42	42	1.0000000
NODE_59599_length_439_cov_2.135294	116	179	2	9	63	0.1428571
NODE_59599_length_439_cov_2.135294	116	179	4	33	63	0.5238096
NODE_59599_length_439_cov_2.135294	116	179	6	21	63	0.3333333
NODE_59617_length_439_cov_1.929412	388	439	0	51	51	1.0000000
NODE_59897_length_438_cov_29.952802	196	276	0	80	80	1.0000000
NODE_59897_length_438_cov_29.952802	249	329	0	80	80	1.0000000
NODE_59898_length_438_cov_16.330383	225	305	0	80	80	1.0000000
NODE_59898_length_438_cov_16.330383	278	358	0	80	80	1.0000000
NODE_59899_length_438_cov_15.436578	74	154	0	80	80	1.0000000
NODE_59899_length_438_cov_15.436578	127	207	0	80	80	1.0000000
NODE_59901_length_438_cov_9.306785	256	309	0	43	53	0.8113208
NODE_59901_length_438_cov_9.306785	256	309	2	10	53	0.1886792
NODE_59901_length_438_cov_9.306785	282	327	0	17	45	0.3777778
NODE_59901_length_438_cov_9.306785	282	327	2	28	45	0.6222222
NODE_59916_length_438_cov_4.808260	46	133	0	40	87	0.4597701
NODE_59916_length_438_cov_4.808260	46	133	6	1	87	0.0114943
NODE_59916_length_438_cov_4.808260	46	133	7	3	87	0.0344828
NODE_59916_length_438_cov_4.808260	46	133	9	26	87	0.2988506
NODE_59916_length_438_cov_4.808260	46	133	11	3	87	0.0344828
NODE_59916_length_438_cov_4.808260	46	133	13	14	87	0.1609195
NODE_59916_length_438_cov_4.808260	106	186	9	10	80	0.1250000
NODE_59916_length_438_cov_4.808260	106	186	11	3	80	0.0375000
NODE_59916_length_438_cov_4.808260	106	186	13	63	80	0.7875000
NODE_59916_length_438_cov_4.808260	106	186	14	4	80	0.0500000
NODE_59920_length_438_cov_4.622419	135	184	2	1	49	0.0204082
NODE_59920_length_438_cov_4.622419	135	184	3	10	49	0.2040816
NODE_59920_length_438_cov_4.622419	135	184	4	38	49	0.7755102
NODE_59936_length_438_cov_3.651917	86	166	0	80	80	1.0000000
NODE_59936_length_438_cov_3.651917	139	219	0	80	80	1.0000000
NODE_59952_length_438_cov_3.109145	215	273	0	1	58	0.0172414
NODE_59952_length_438_cov_3.109145	215	273	2	57	58	0.9827586
NODE_59957_length_438_cov_3.005900	175	258	0	58	83	0.6987952
NODE_59957_length_438_cov_3.005900	175	258	4	25	83	0.3012048
NODE_60317_length_437_cov_57.260355	272	352	0	80	80	1.0000000
NODE_60317_length_437_cov_57.260355	325	405	0	80	80	1.0000000
NODE_60318_length_437_cov_40.964497	0	73	0	73	73	1.0000000
NODE_60318_length_437_cov_40.964497	46	126	0	80	80	1.0000000
NODE_60319_length_437_cov_30.843195	140	220	0	80	80	1.0000000
NODE_60319_length_437_cov_30.843195	193	273	0	80	80	1.0000000
NODE_60320_length_437_cov_14.736686	164	244	0	32	80	0.4000000
NODE_60320_length_437_cov_14.736686	164	244	2	48	80	0.6000000
NODE_60320_length_437_cov_14.736686	217	297	0	19	80	0.2375000
NODE_60320_length_437_cov_14.736686	217	297	2	61	80	0.7625000
NODE_60331_length_437_cov_6.032544	249	320	0	71	71	1.0000000
NODE_60332_length_437_cov_6.020710	272	352	2	63	80	0.7875000
NODE_60332_length_437_cov_6.020710	272	352	4	17	80	0.2125000
NODE_60332_length_437_cov_6.020710	325	405	0	25	80	0.3125000
NODE_60332_length_437_cov_6.020710	325	405	2	55	80	0.6875000
NODE_60336_length_437_cov_5.526627	129	209	0	32	80	0.4000000
NODE_60336_length_437_cov_5.526627	129	209	2	48	80	0.6000000
NODE_60336_length_437_cov_5.526627	182	262	0	80	80	1.0000000
NODE_60348_length_437_cov_4.505917	247	327	0	19	80	0.2375000
NODE_60348_length_437_cov_4.505917	247	327	4	61	80	0.7625000
NODE_60361_length_437_cov_3.470414	204	259	0	55	55	1.0000000
NODE_60369_length_437_cov_3.301775	95	149	0	28	54	0.5185185
NODE_60369_length_437_cov_3.301775	95	149	2	26	54	0.4814815
NODE_60381_length_437_cov_2.911243	91	171	0	4	80	0.0500000
NODE_60381_length_437_cov_2.911243	91	171	4	17	80	0.2125000
NODE_60381_length_437_cov_2.911243	91	171	7	8	80	0.1000000
NODE_60381_length_437_cov_2.911243	91	171	8	8	80	0.1000000
NODE_60381_length_437_cov_2.911243	91	171	18	5	80	0.0625000
NODE_60381_length_437_cov_2.911243	91	171	22	2	80	0.0250000
NODE_60381_length_437_cov_2.911243	91	171	26	3	80	0.0375000
NODE_60381_length_437_cov_2.911243	91	171	28	2	80	0.0250000
NODE_60381_length_437_cov_2.911243	91	171	38	31	80	0.3875000
NODE_60400_length_437_cov_2.650888	190	239	0	49	49	1.0000000
NODE_60400_length_437_cov_2.650888	212	292	0	70	80	0.8750000
NODE_60400_length_437_cov_2.650888	212	292	2	7	80	0.0875000
NODE_60400_length_437_cov_2.650888	212	292	4	3	80	0.0375000
NODE_60411_length_437_cov_2.514793	292	333	0	41	41	1.0000000
NODE_60509_length_437_cov_1.473373	252	324	2	72	72	1.0000000
NODE_60709_length_436_cov_125.940653	204	284	0	29	80	0.3625000
NODE_60709_length_436_cov_125.940653	204	284	2	17	80	0.2125000
NODE_60709_length_436_cov_125.940653	204	284	4	3	80	0.0375000
NODE_60709_length_436_cov_125.940653	204	284	6	8	80	0.1000000
NODE_60709_length_436_cov_125.940653	204	284	8	2	80	0.0250000
NODE_60709_length_436_cov_125.940653	204	284	10	12	80	0.1500000
NODE_60709_length_436_cov_125.940653	204	284	12	6	80	0.0750000
NODE_60709_length_436_cov_125.940653	204	284	15	1	80	0.0125000
NODE_60709_length_436_cov_125.940653	204	284	16	2	80	0.0250000
NODE_60709_length_436_cov_125.940653	255	301	0	46	46	1.0000000
NODE_60709_length_436_cov_125.940653	257	337	0	80	80	1.0000000
NODE_60709_length_436_cov_125.940653	333	413	0	80	80	1.0000000
NODE_60709_length_436_cov_125.940653	386	436	0	50	50	1.0000000
NODE_60712_length_436_cov_45.459941	166	246	0	80	80	1.0000000
NODE_60712_length_436_cov_45.459941	219	299	0	80	80	1.0000000
NODE_60712_length_436_cov_45.459941	295	375	0	80	80	1.0000000
NODE_60712_length_436_cov_45.459941	348	428	0	80	80	1.0000000
NODE_60713_length_436_cov_10.560831	74	154	0	80	80	1.0000000
NODE_60713_length_436_cov_10.560831	127	207	0	80	80	1.0000000
NODE_60716_length_436_cov_8.317507	51	127	0	76	76	1.0000000
NODE_60716_length_436_cov_8.317507	104	182	0	78	78	1.0000000
NODE_60760_length_436_cov_3.109792	153	205	0	52	52	1.0000000
NODE_60786_length_436_cov_2.551929	182	258	0	25	76	0.3289474
NODE_60786_length_436_cov_2.551929	182	258	2	6	76	0.0789474
NODE_60786_length_436_cov_2.551929	182	258	3	1	76	0.0131579
NODE_60786_length_436_cov_2.551929	182	258	4	44	76	0.5789474
NODE_60786_length_436_cov_2.551929	235	315	0	1	80	0.0125000
NODE_60786_length_436_cov_2.551929	235	315	3	1	80	0.0125000
NODE_60786_length_436_cov_2.551929	235	315	4	40	80	0.5000000
NODE_60786_length_436_cov_2.551929	235	315	6	38	80	0.4750000
NODE_60934_length_436_cov_1.207715	105	181	0	76	76	1.0000000
NODE_61088_length_435_cov_17.401786	55	135	0	80	80	1.0000000
NODE_61088_length_435_cov_17.401786	108	188	0	80	80	1.0000000
NODE_61094_length_435_cov_6.910714	113	193	3	6	80	0.0750000
NODE_61094_length_435_cov_6.910714	113	193	4	74	80	0.9250000
NODE_61094_length_435_cov_6.910714	147	194	3	7	47	0.1489362
NODE_61094_length_435_cov_6.910714	147	194	4	40	47	0.8510638
NODE_61094_length_435_cov_6.910714	149	184	4	35	35	1.0000000
NODE_61094_length_435_cov_6.910714	151	193	3	6	42	0.1428571
NODE_61094_length_435_cov_6.910714	151	193	4	36	42	0.8571429
NODE_61094_length_435_cov_6.910714	166	251	0	55	85	0.6470588
NODE_61094_length_435_cov_6.910714	166	251	3	9	85	0.1058824
NODE_61094_length_435_cov_6.910714	166	251	4	21	85	0.2470588
NODE_61094_length_435_cov_6.910714	167	251	0	55	84	0.6547619
NODE_61094_length_435_cov_6.910714	167	251	3	9	84	0.1071429
NODE_61094_length_435_cov_6.910714	167	251	4	20	84	0.2380952
NODE_61102_length_435_cov_5.630952	159	217	0	58	58	1.0000000
NODE_61102_length_435_cov_5.630952	190	270	0	80	80	1.0000000
NODE_61112_length_435_cov_4.601190	271	309	4	35	38	0.9210526
NODE_61112_length_435_cov_4.601190	271	309	6	3	38	0.0789474
NODE_61112_length_435_cov_4.601190	282	344	4	25	62	0.4032258
NODE_61112_length_435_cov_4.601190	282	344	6	37	62	0.5967742
NODE_61122_length_435_cov_3.770833	209	240	0	31	31	1.0000000
NODE_61137_length_435_cov_2.836310	113	194	10	2	81	0.0246914
NODE_61137_length_435_cov_2.836310	113	194	13	1	81	0.0123457
NODE_61137_length_435_cov_2.836310	113	194	14	5	81	0.0617284
NODE_61137_length_435_cov_2.836310	113	194	15	18	81	0.2222222
NODE_61137_length_435_cov_2.836310	113	194	16	31	81	0.3827161
NODE_61137_length_435_cov_2.836310	113	194	18	24	81	0.2962963
NODE_61357_length_435_cov_0.988095	286	322	0	36	36	1.0000000
NODE_61451_length_434_cov_136.483582	0	58	16	1	58	0.0172414
NODE_61451_length_434_cov_136.483582	0	58	22	2	58	0.0344828
NODE_61451_length_434_cov_136.483582	0	58	29	2	58	0.0344828
NODE_61451_length_434_cov_136.483582	0	58	32	1	58	0.0172414
NODE_61451_length_434_cov_136.483582	0	58	55	1	58	0.0172414
NODE_61451_length_434_cov_136.483582	0	58	64	1	58	0.0172414
NODE_61451_length_434_cov_136.483582	0	58	94	1	58	0.0172414
NODE_61451_length_434_cov_136.483582	0	58	100	2	58	0.0344828
NODE_61451_length_434_cov_136.483582	0	58	116	1	58	0.0172414
NODE_61451_length_434_cov_136.483582	0	58	124	1	58	0.0172414
NODE_61451_length_434_cov_136.483582	0	58	132	1	58	0.0172414
NODE_61451_length_434_cov_136.483582	0	58	148	1	58	0.0172414
NODE_61451_length_434_cov_136.483582	0	58	149	1	58	0.0172414
NODE_61451_length_434_cov_136.483582	0	58	158	1	58	0.0172414
NODE_61451_length_434_cov_136.483582	0	58	160	1	58	0.0172414
NODE_61451_length_434_cov_136.483582	0	58	167	1	58	0.0172414
NODE_61451_length_434_cov_136.483582	0	58	171	1	58	0.0172414
NODE_61451_length_434_cov_136.483582	0	58	173	1	58	0.0172414
NODE_61451_length_434_cov_136.483582	0	58	188	1	58	0.0172414
NODE_61451_length_434_cov_136.483582	0	58	192	1	58	0.0172414
NODE_61451_length_434_cov_136.483582	0	58	203	1	58	0.0172414
NODE_61451_length_434_cov_136.483582	0	58	207	1	58	0.0172414
NODE_61451_length_434_cov_136.483582	0	58	209	1	58	0.0172414
NODE_61451_length_434_cov_136.483582	0	58	217	1	58	0.0172414
NODE_61451_length_434_cov_136.483582	0	58	222	1	58	0.0172414
NODE_61451_length_434_cov_136.483582	0	58	231	1	58	0.0172414
NODE_61451_length_434_cov_136.483582	0	58	247	1	58	0.0172414
NODE_61451_length_434_cov_136.483582	0	58	253	1	58	0.0172414
NODE_61451_length_434_cov_136.483582	0	58	255	1	58	0.0172414
NODE_61451_length_434_cov_136.483582	0	58	256	1	58	0.0172414
NODE_61451_length_434_cov_136.483582	0	58	257	1	58	0.0172414
NODE_61451_length_434_cov_136.483582	0	58	267	2	58	0.0344828
NODE_61451_length_434_cov_136.483582	0	58	273	1	58	0.0172414
NODE_61451_length_434_cov_136.483582	0	58	275	1	58	0.0172414
NODE_61451_length_434_cov_136.483582	0	58	277	1	58	0.0172414
NODE_61451_length_434_cov_136.483582	0	58	279	2	58	0.0344828
NODE_61451_length_434_cov_136.483582	0	58	281	5	58	0.0862069
NODE_61451_length_434_cov_136.483582	0	58	282	3	58	0.0517241
NODE_61451_length_434_cov_136.483582	0	58	283	4	58	0.0689655
NODE_61451_length_434_cov_136.483582	0	58	285	4	58	0.0689655
NODE_61451_length_434_cov_136.483582	0	58	294	1	58	0.0172414
NODE_61451_length_434_cov_136.483582	31	111	255	1	80	0.0125000
NODE_61451_length_434_cov_136.483582	31	111	256	1	80	0.0125000
NODE_61451_length_434_cov_136.483582	31	111	257	1	80	0.0125000
NODE_61451_length_434_cov_136.483582	31	111	267	2	80	0.0250000
NODE_61451_length_434_cov_136.483582	31	111	273	1	80	0.0125000
NODE_61451_length_434_cov_136.483582	31	111	275	1	80	0.0125000
NODE_61451_length_434_cov_136.483582	31	111	277	1	80	0.0125000
NODE_61451_length_434_cov_136.483582	31	111	279	2	80	0.0250000
NODE_61451_length_434_cov_136.483582	31	111	281	5	80	0.0625000
NODE_61451_length_434_cov_136.483582	31	111	282	3	80	0.0375000
NODE_61451_length_434_cov_136.483582	31	111	283	4	80	0.0500000
NODE_61451_length_434_cov_136.483582	31	111	285	4	80	0.0500000
NODE_61451_length_434_cov_136.483582	31	111	294	1	80	0.0125000
NODE_61451_length_434_cov_136.483582	31	111	300	1	80	0.0125000
NODE_61451_length_434_cov_136.483582	31	111	305	1	80	0.0125000
NODE_61451_length_434_cov_136.483582	31	111	316	1	80	0.0125000
NODE_61451_length_434_cov_136.483582	31	111	324	3	80	0.0375000
NODE_61451_length_434_cov_136.483582	31	111	325	2	80	0.0250000
NODE_61451_length_434_cov_136.483582	31	111	327	2	80	0.0250000
NODE_61451_length_434_cov_136.483582	31	111	328	4	80	0.0500000
NODE_61451_length_434_cov_136.483582	31	111	330	1	80	0.0125000
NODE_61451_length_434_cov_136.483582	31	111	337	1	80	0.0125000
NODE_61451_length_434_cov_136.483582	31	111	341	1	80	0.0125000
NODE_61451_length_434_cov_136.483582	31	111	345	3	80	0.0375000
NODE_61451_length_434_cov_136.483582	31	111	352	1	80	0.0125000
NODE_61451_length_434_cov_136.483582	31	111	354	1	80	0.0125000
NODE_61451_length_434_cov_136.483582	31	111	360	2	80	0.0250000
NODE_61451_length_434_cov_136.483582	31	111	365	5	80	0.0625000
NODE_61451_length_434_cov_136.483582	31	111	374	1	80	0.0125000
NODE_61451_length_434_cov_136.483582	31	111	375	1	80	0.0125000
NODE_61451_length_434_cov_136.483582	31	111	377	2	80	0.0250000
NODE_61451_length_434_cov_136.483582	31	111	378	2	80	0.0250000
NODE_61451_length_434_cov_136.483582	31	111	380	1	80	0.0125000
NODE_61451_length_434_cov_136.483582	31	111	381	4	80	0.0500000
NODE_61451_length_434_cov_136.483582	31	111	382	1	80	0.0125000
NODE_61451_length_434_cov_136.483582	31	111	383	1	80	0.0125000
NODE_61451_length_434_cov_136.483582	31	111	386	1	80	0.0125000
NODE_61451_length_434_cov_136.483582	31	111	387	1	80	0.0125000
NODE_61451_length_434_cov_136.483582	31	111	389	2	80	0.0250000
NODE_61451_length_434_cov_136.483582	31	111	391	2	80	0.0250000
NODE_61451_length_434_cov_136.483582	31	111	393	3	80	0.0375000
NODE_61451_length_434_cov_136.483582	31	111	397	2	80	0.0250000
NODE_61452_length_434_cov_43.214925	291	366	0	75	75	1.0000000
NODE_61452_length_434_cov_43.214925	344	424	0	80	80	1.0000000
NODE_61452_length_434_cov_43.214925	344	424	0	80	80	1.0000000
NODE_61453_length_434_cov_22.373134	80	160	0	80	80	1.0000000
NODE_61453_length_434_cov_22.373134	133	213	0	80	80	1.0000000
NODE_61455_length_434_cov_11.549254	74	145	0	71	71	1.0000000
NODE_61455_length_434_cov_11.549254	118	198	0	80	80	1.0000000
NODE_61477_length_434_cov_4.125373	191	233	4	20	42	0.4761905
NODE_61477_length_434_cov_4.125373	191	233	5	4	42	0.0952381
NODE_61477_length_434_cov_4.125373	191	233	6	2	42	0.0476190
NODE_61477_length_434_cov_4.125373	191	233	8	16	42	0.3809524
NODE_61477_length_434_cov_4.125373	200	235	4	22	35	0.6285715
NODE_61477_length_434_cov_4.125373	200	235	5	4	35	0.1142857
NODE_61477_length_434_cov_4.125373	200	235	6	2	35	0.0571429
NODE_61477_length_434_cov_4.125373	200	235	8	7	35	0.2000000
NODE_61497_length_434_cov_3.104478	191	263	0	35	72	0.4861111
NODE_61497_length_434_cov_3.104478	191	263	1	37	72	0.5138889
NODE_61528_length_434_cov_2.197015	129	168	0	39	39	1.0000000
NODE_61563_length_434_cov_1.883582	88	133	2	17	45	0.3777778
NODE_61563_length_434_cov_1.883582	88	133	4	28	45	0.6222222
NODE_61563_length_434_cov_1.883582	141	182	0	27	41	0.6585366
NODE_61563_length_434_cov_1.883582	141	182	2	4	41	0.0975610
NODE_61563_length_434_cov_1.883582	141	182	4	10	41	0.2439024
NODE_61603_length_434_cov_1.626866	163	243	0	2	80	0.0250000
NODE_61603_length_434_cov_1.626866	163	243	2	8	80	0.1000000
NODE_61603_length_434_cov_1.626866	163	243	10	18	80	0.2250000
NODE_61603_length_434_cov_1.626866	163	243	12	52	80	0.6500000
NODE_61676_length_434_cov_1.220896	118	198	205	3	80	0.0375000
NODE_61676_length_434_cov_1.220896	118	198	209	1	80	0.0125000
NODE_61676_length_434_cov_1.220896	118	198	212	1	80	0.0125000
NODE_61676_length_434_cov_1.220896	118	198	213	1	80	0.0125000
NODE_61676_length_434_cov_1.220896	118	198	216	1	80	0.0125000
NODE_61676_length_434_cov_1.220896	118	198	217	1	80	0.0125000
NODE_61676_length_434_cov_1.220896	118	198	225	1	80	0.0125000
NODE_61676_length_434_cov_1.220896	118	198	227	1	80	0.0125000
NODE_61676_length_434_cov_1.220896	118	198	229	1	80	0.0125000
NODE_61676_length_434_cov_1.220896	118	198	230	1	80	0.0125000
NODE_61676_length_434_cov_1.220896	118	198	231	1	80	0.0125000
NODE_61676_length_434_cov_1.220896	118	198	234	1	80	0.0125000
NODE_61676_length_434_cov_1.220896	118	198	238	2	80	0.0250000
NODE_61676_length_434_cov_1.220896	118	198	240	1	80	0.0125000
NODE_61676_length_434_cov_1.220896	118	198	241	1	80	0.0125000
NODE_61676_length_434_cov_1.220896	118	198	242	1	80	0.0125000
NODE_61676_length_434_cov_1.220896	118	198	244	2	80	0.0250000
NODE_61676_length_434_cov_1.220896	118	198	250	3	80	0.0375000
NODE_61676_length_434_cov_1.220896	118	198	251	2	80	0.0250000
NODE_61676_length_434_cov_1.220896	118	198	252	1	80	0.0125000
NODE_61676_length_434_cov_1.220896	118	198	255	1	80	0.0125000
NODE_61676_length_434_cov_1.220896	118	198	256	4	80	0.0500000
NODE_61676_length_434_cov_1.220896	118	198	257	2	80	0.0250000
NODE_61676_length_434_cov_1.220896	118	198	261	1	80	0.0125000
NODE_61676_length_434_cov_1.220896	118	198	265	1	80	0.0125000
NODE_61676_length_434_cov_1.220896	118	198	267	1	80	0.0125000
NODE_61676_length_434_cov_1.220896	118	198	269	3	80	0.0375000
NODE_61676_length_434_cov_1.220896	118	198	271	5	80	0.0625000
NODE_61676_length_434_cov_1.220896	118	198	273	1	80	0.0125000
NODE_61676_length_434_cov_1.220896	118	198	274	1	80	0.0125000
NODE_61676_length_434_cov_1.220896	118	198	275	2	80	0.0250000
NODE_61676_length_434_cov_1.220896	118	198	276	8	80	0.1000000
NODE_61676_length_434_cov_1.220896	118	198	277	3	80	0.0375000
NODE_61676_length_434_cov_1.220896	118	198	278	7	80	0.0875000
NODE_61676_length_434_cov_1.220896	118	198	279	8	80	0.1000000
NODE_61676_length_434_cov_1.220896	118	198	280	4	80	0.0500000
NODE_61676_length_434_cov_1.220896	118	198	284	1	80	0.0125000
NODE_61727_length_434_cov_1.002985	245	286	2	5	41	0.1219512
NODE_61727_length_434_cov_1.002985	245	286	3	2	41	0.0487805
NODE_61727_length_434_cov_1.002985	245	286	4	34	41	0.8292683
NODE_61727_length_434_cov_1.002985	258	339	2	7	81	0.0864198
NODE_61727_length_434_cov_1.002985	258	339	4	74	81	0.9135802
NODE_61826_length_433_cov_51.392216	2	82	0	80	80	1.0000000
NODE_61826_length_433_cov_51.392216	55	135	0	80	80	1.0000000
NODE_61826_length_433_cov_51.392216	131	213	0	82	82	1.0000000
NODE_61826_length_433_cov_51.392216	189	266	0	77	77	1.0000000
NODE_61827_length_433_cov_46.344311	248	328	0	80	80	1.0000000
NODE_61827_length_433_cov_46.344311	301	381	0	80	80	1.0000000
NODE_61828_length_433_cov_41.808383	92	172	0	80	80	1.0000000
NODE_61828_length_433_cov_41.808383	145	225	0	80	80	1.0000000
NODE_61835_length_433_cov_6.227545	157	237	0	80	80	1.0000000
NODE_61836_length_433_cov_6.080838	164	244	0	12	80	0.1500000
NODE_61836_length_433_cov_6.080838	164	244	2	68	80	0.8500000
NODE_61838_length_433_cov_5.547904	10	80	10	15	70	0.2142857
NODE_61838_length_433_cov_5.547904	10	80	12	7	70	0.1000000
NODE_61838_length_433_cov_5.547904	10	80	14	48	70	0.6857143
NODE_61838_length_433_cov_5.547904	51	133	4	4	82	0.0487805
NODE_61838_length_433_cov_5.547904	51	133	6	3	82	0.0365854
NODE_61838_length_433_cov_5.547904	51	133	8	34	82	0.4146341
NODE_61838_length_433_cov_5.547904	51	133	10	8	82	0.0975610
NODE_61838_length_433_cov_5.547904	51	133	14	33	82	0.4024390
NODE_61839_length_433_cov_5.476048	81	141	0	60	60	1.0000000
NODE_61855_length_433_cov_3.907186	77	107	0	30	30	1.0000000
NODE_61862_length_433_cov_3.595808	231	316	0	61	85	0.7176471
NODE_61862_length_433_cov_3.595808	231	316	2	24	85	0.2823530
NODE_61864_length_433_cov_3.526946	107	178	0	71	71	1.0000000
NODE_61931_length_433_cov_2.137725	123	203	0	80	80	1.0000000
NODE_62258_length_432_cov_17.540541	150	230	0	80	80	1.0000000
NODE_62258_length_432_cov_17.540541	203	288	0	85	85	1.0000000
NODE_62264_length_432_cov_6.555556	52	82	0	30	30	1.0000000
NODE_62268_length_432_cov_5.720721	77	157	0	64	80	0.8000000
NODE_62268_length_432_cov_5.720721	77	157	1	16	80	0.2000000
NODE_62268_length_432_cov_5.720721	130	202	0	11	72	0.1527778
NODE_62268_length_432_cov_5.720721	130	202	1	49	72	0.6805556
NODE_62268_length_432_cov_5.720721	130	202	2	12	72	0.1666667
NODE_62269_length_432_cov_5.387387	65	95	0	30	30	1.0000000
NODE_62270_length_432_cov_5.345345	271	324	4	1	53	0.0188679
NODE_62270_length_432_cov_5.345345	271	324	6	52	53	0.9811321
NODE_62293_length_432_cov_3.678679	78	121	2	43	43	1.0000000
NODE_62304_length_432_cov_3.246246	87	128	2	15	41	0.3658537
NODE_62304_length_432_cov_3.246246	87	128	4	2	41	0.0487805
NODE_62304_length_432_cov_3.246246	87	128	6	6	41	0.1463415
NODE_62304_length_432_cov_3.246246	87	128	8	3	41	0.0731707
NODE_62304_length_432_cov_3.246246	87	128	10	3	41	0.0731707
NODE_62304_length_432_cov_3.246246	87	128	16	6	41	0.1463415
NODE_62304_length_432_cov_3.246246	87	128	18	4	41	0.0975610
NODE_62304_length_432_cov_3.246246	87	128	20	2	41	0.0487805
NODE_62304_length_432_cov_3.246246	101	167	2	1	66	0.0151515
NODE_62304_length_432_cov_3.246246	101	167	4	2	66	0.0303030
NODE_62304_length_432_cov_3.246246	101	167	6	6	66	0.0909091
NODE_62304_length_432_cov_3.246246	101	167	8	3	66	0.0454545
NODE_62304_length_432_cov_3.246246	101	167	10	3	66	0.0454545
NODE_62304_length_432_cov_3.246246	101	167	16	6	66	0.0909091
NODE_62304_length_432_cov_3.246246	101	167	18	4	66	0.0606061
NODE_62304_length_432_cov_3.246246	101	167	20	5	66	0.0757576
NODE_62304_length_432_cov_3.246246	101	167	24	4	66	0.0606061
NODE_62304_length_432_cov_3.246246	101	167	26	5	66	0.0757576
NODE_62304_length_432_cov_3.246246	101	167	28	2	66	0.0303030
NODE_62304_length_432_cov_3.246246	101	167	30	19	66	0.2878788
NODE_62304_length_432_cov_3.246246	101	167	32	6	66	0.0909091
NODE_62396_length_432_cov_1.762763	4	71	0	18	67	0.2686567
NODE_62396_length_432_cov_1.762763	4	71	2	8	67	0.1194030
NODE_62396_length_432_cov_1.762763	4	71	4	8	67	0.1194030
NODE_62396_length_432_cov_1.762763	4	71	8	33	67	0.4925373
NODE_62544_length_432_cov_1.027027	44	68	0	24	24	1.0000000
NODE_62650_length_431_cov_35.355422	202	284	0	82	82	1.0000000
NODE_62650_length_431_cov_35.355422	257	333	0	76	76	1.0000000
NODE_62652_length_431_cov_11.207831	185	265	0	80	80	1.0000000
NODE_62652_length_431_cov_11.207831	238	318	0	71	80	0.8875000
NODE_62652_length_431_cov_11.207831	238	318	2	9	80	0.1125000
NODE_62657_length_431_cov_7.018072	110	190	2	39	80	0.4875000
NODE_62657_length_431_cov_7.018072	110	190	4	41	80	0.5125000
NODE_62657_length_431_cov_7.018072	163	243	2	20	80	0.2500000
NODE_62657_length_431_cov_7.018072	163	243	4	60	80	0.7500000
NODE_62661_length_431_cov_6.292169	123	203	0	56	80	0.7000000
NODE_62661_length_431_cov_6.292169	123	203	2	24	80	0.3000000
NODE_62668_length_431_cov_5.608434	170	241	0	71	71	1.0000000
NODE_62681_length_431_cov_4.250000	146	216	0	6	70	0.0857143
NODE_62681_length_431_cov_4.250000	146	216	4	35	70	0.5000000
NODE_62681_length_431_cov_4.250000	146	216	8	29	70	0.4142857
NODE_62684_length_431_cov_3.993976	210	290	2	31	80	0.3875000
NODE_62684_length_431_cov_3.993976	210	290	4	49	80	0.6125000
NODE_62794_length_431_cov_1.695783	76	156	3	7	80	0.0875000
NODE_62794_length_431_cov_1.695783	76	156	4	5	80	0.0625000
NODE_62794_length_431_cov_1.695783	76	156	6	13	80	0.1625000
NODE_62794_length_431_cov_1.695783	76	156	8	5	80	0.0625000
NODE_62794_length_431_cov_1.695783	76	156	10	50	80	0.6250000
NODE_62794_length_431_cov_1.695783	129	199	8	2	70	0.0285714
NODE_62794_length_431_cov_1.695783	129	199	9	3	70	0.0428571
NODE_62794_length_431_cov_1.695783	129	199	10	39	70	0.5571429
NODE_62794_length_431_cov_1.695783	129	199	11	5	70	0.0714286
NODE_62794_length_431_cov_1.695783	129	199	13	4	70	0.0571429
NODE_62794_length_431_cov_1.695783	129	199	16	6	70	0.0857143
NODE_62794_length_431_cov_1.695783	129	199	18	11	70	0.1571429
NODE_63043_length_430_cov_49.791541	319	399	157	1	80	0.0125000
NODE_63043_length_430_cov_49.791541	319	399	159	1	80	0.0125000
NODE_63043_length_430_cov_49.791541	319	399	160	1	80	0.0125000
NODE_63043_length_430_cov_49.791541	319	399	165	2	80	0.0250000
NODE_63043_length_430_cov_49.791541	319	399	166	1	80	0.0125000
NODE_63043_length_430_cov_49.791541	319	399	170	1	80	0.0125000
NODE_63043_length_430_cov_49.791541	319	399	173	1	80	0.0125000
NODE_63043_length_430_cov_49.791541	319	399	177	1	80	0.0125000
NODE_63043_length_430_cov_49.791541	319	399	187	1	80	0.0125000
NODE_63043_length_430_cov_49.791541	319	399	188	1	80	0.0125000
NODE_63043_length_430_cov_49.791541	319	399	196	1	80	0.0125000
NODE_63043_length_430_cov_49.791541	319	399	198	1	80	0.0125000
NODE_63043_length_430_cov_49.791541	319	399	200	1	80	0.0125000
NODE_63043_length_430_cov_49.791541	319	399	210	2	80	0.0250000
NODE_63043_length_430_cov_49.791541	319	399	215	2	80	0.0250000
NODE_63043_length_430_cov_49.791541	319	399	223	1	80	0.0125000
NODE_63043_length_430_cov_49.791541	319	399	225	1	80	0.0125000
NODE_63043_length_430_cov_49.791541	319	399	227	2	80	0.0250000
NODE_63043_length_430_cov_49.791541	319	399	229	2	80	0.0250000
NODE_63043_length_430_cov_49.791541	319	399	232	1	80	0.0125000
NODE_63043_length_430_cov_49.791541	319	399	237	1	80	0.0125000
NODE_63043_length_430_cov_49.791541	319	399	243	1	80	0.0125000
NODE_63043_length_430_cov_49.791541	319	399	244	1	80	0.0125000
NODE_63043_length_430_cov_49.791541	319	399	248	1	80	0.0125000
NODE_63043_length_430_cov_49.791541	319	399	256	1	80	0.0125000
NODE_63043_length_430_cov_49.791541	319	399	258	1	80	0.0125000
NODE_63043_length_430_cov_49.791541	319	399	263	2	80	0.0250000
NODE_63043_length_430_cov_49.791541	319	399	264	2	80	0.0250000
NODE_63043_length_430_cov_49.791541	319	399	266	1	80	0.0125000
NODE_63043_length_430_cov_49.791541	319	399	268	2	80	0.0250000
NODE_63043_length_430_cov_49.791541	319	399	270	1	80	0.0125000
NODE_63043_length_430_cov_49.791541	319	399	274	1	80	0.0125000
NODE_63043_length_430_cov_49.791541	319	399	277	1	80	0.0125000
NODE_63043_length_430_cov_49.791541	319	399	281	1	80	0.0125000
NODE_63043_length_430_cov_49.791541	319	399	290	1	80	0.0125000
NODE_63043_length_430_cov_49.791541	319	399	297	3	80	0.0375000
NODE_63043_length_430_cov_49.791541	319	399	303	1	80	0.0125000
NODE_63043_length_430_cov_49.791541	319	399	305	1	80	0.0125000
NODE_63043_length_430_cov_49.791541	319	399	308	1	80	0.0125000
NODE_63043_length_430_cov_49.791541	319	399	309	4	80	0.0500000
NODE_63043_length_430_cov_49.791541	319	399	310	1	80	0.0125000
NODE_63043_length_430_cov_49.791541	319	399	312	1	80	0.0125000
NODE_63043_length_430_cov_49.791541	319	399	318	1	80	0.0125000
NODE_63043_length_430_cov_49.791541	319	399	320	1	80	0.0125000
NODE_63043_length_430_cov_49.791541	319	399	326	2	80	0.0250000
NODE_63043_length_430_cov_49.791541	319	399	330	3	80	0.0375000
NODE_63043_length_430_cov_49.791541	319	399	352	2	80	0.0250000
NODE_63043_length_430_cov_49.791541	319	399	358	1	80	0.0125000
NODE_63043_length_430_cov_49.791541	319	399	362	1	80	0.0125000
NODE_63043_length_430_cov_49.791541	319	399	363	2	80	0.0250000
NODE_63043_length_430_cov_49.791541	319	399	365	2	80	0.0250000
NODE_63043_length_430_cov_49.791541	319	399	369	3	80	0.0375000
NODE_63043_length_430_cov_49.791541	319	399	371	1	80	0.0125000
NODE_63043_length_430_cov_49.791541	319	399	373	1	80	0.0125000
NODE_63043_length_430_cov_49.791541	319	399	376	2	80	0.0250000
NODE_63043_length_430_cov_49.791541	319	399	378	1	80	0.0125000
NODE_63043_length_430_cov_49.791541	319	399	379	2	80	0.0250000
NODE_63043_length_430_cov_49.791541	372	430	24	2	58	0.0344828
NODE_63043_length_430_cov_49.791541	372	430	28	1	58	0.0172414
NODE_63043_length_430_cov_49.791541	372	430	34	1	58	0.0172414
NODE_63043_length_430_cov_49.791541	372	430	38	1	58	0.0172414
NODE_63043_length_430_cov_49.791541	372	430	40	1	58	0.0172414
NODE_63043_length_430_cov_49.791541	372	430	46	1	58	0.0172414
NODE_63043_length_430_cov_49.791541	372	430	56	1	58	0.0172414
NODE_63043_length_430_cov_49.791541	372	430	79	1	58	0.0172414
NODE_63043_length_430_cov_49.791541	372	430	81	1	58	0.0172414
NODE_63043_length_430_cov_49.791541	372	430	87	1	58	0.0172414
NODE_63043_length_430_cov_49.791541	372	430	96	2	58	0.0344828
NODE_63043_length_430_cov_49.791541	372	430	100	4	58	0.0689655
NODE_63043_length_430_cov_49.791541	372	430	103	1	58	0.0172414
NODE_63043_length_430_cov_49.791541	372	430	107	1	58	0.0172414
NODE_63043_length_430_cov_49.791541	372	430	109	1	58	0.0172414
NODE_63043_length_430_cov_49.791541	372	430	113	1	58	0.0172414
NODE_63043_length_430_cov_49.791541	372	430	114	1	58	0.0172414
NODE_63043_length_430_cov_49.791541	372	430	120	1	58	0.0172414
NODE_63043_length_430_cov_49.791541	372	430	131	1	58	0.0172414
NODE_63043_length_430_cov_49.791541	372	430	132	1	58	0.0172414
NODE_63043_length_430_cov_49.791541	372	430	136	1	58	0.0172414
NODE_63043_length_430_cov_49.791541	372	430	143	2	58	0.0344828
NODE_63043_length_430_cov_49.791541	372	430	148	1	58	0.0172414
NODE_63043_length_430_cov_49.791541	372	430	153	2	58	0.0344828
NODE_63043_length_430_cov_49.791541	372	430	157	1	58	0.0172414
NODE_63043_length_430_cov_49.791541	372	430	159	1	58	0.0172414
NODE_63043_length_430_cov_49.791541	372	430	160	1	58	0.0172414
NODE_63043_length_430_cov_49.791541	372	430	165	2	58	0.0344828
NODE_63043_length_430_cov_49.791541	372	430	166	1	58	0.0172414
NODE_63043_length_430_cov_49.791541	372	430	170	1	58	0.0172414
NODE_63043_length_430_cov_49.791541	372	430	173	1	58	0.0172414
NODE_63043_length_430_cov_49.791541	372	430	177	1	58	0.0172414
NODE_63043_length_430_cov_49.791541	372	430	187	1	58	0.0172414
NODE_63043_length_430_cov_49.791541	372	430	188	1	58	0.0172414
NODE_63043_length_430_cov_49.791541	372	430	196	1	58	0.0172414
NODE_63043_length_430_cov_49.791541	372	430	198	1	58	0.0172414
NODE_63043_length_430_cov_49.791541	372	430	200	1	58	0.0172414
NODE_63043_length_430_cov_49.791541	372	430	210	2	58	0.0344828
NODE_63043_length_430_cov_49.791541	372	430	215	2	58	0.0344828
NODE_63043_length_430_cov_49.791541	372	430	223	1	58	0.0172414
NODE_63043_length_430_cov_49.791541	372	430	225	1	58	0.0172414
NODE_63043_length_430_cov_49.791541	372	430	227	2	58	0.0344828
NODE_63043_length_430_cov_49.791541	372	430	229	2	58	0.0344828
NODE_63043_length_430_cov_49.791541	372	430	232	1	58	0.0172414
NODE_63043_length_430_cov_49.791541	372	430	237	1	58	0.0172414
NODE_63043_length_430_cov_49.791541	372	430	243	1	58	0.0172414
NODE_63044_length_430_cov_44.365559	109	189	0	47	80	0.5875000
NODE_63044_length_430_cov_44.365559	109	189	1	20	80	0.2500000
NODE_63044_length_430_cov_44.365559	109	189	2	13	80	0.1625000
NODE_63044_length_430_cov_44.365559	162	242	1	14	80	0.1750000
NODE_63044_length_430_cov_44.365559	162	242	2	15	80	0.1875000
NODE_63044_length_430_cov_44.365559	162	242	4	51	80	0.6375000
NODE_63045_length_430_cov_16.746224	92	172	4	65	80	0.8125000
NODE_63045_length_430_cov_16.746224	92	172	6	15	80	0.1875000
NODE_63045_length_430_cov_16.746224	145	225	2	34	80	0.4250000
NODE_63045_length_430_cov_16.746224	145	225	4	46	80	0.5750000
NODE_63048_length_430_cov_7.737160	180	263	0	21	83	0.2530121
NODE_63048_length_430_cov_7.737160	180	263	4	62	83	0.7469879
NODE_63050_length_430_cov_6.163142	135	197	0	62	62	1.0000000
NODE_63051_length_430_cov_5.873112	7	90	0	69	83	0.8313253
NODE_63051_length_430_cov_5.873112	7	90	2	14	83	0.1686747
NODE_63051_length_430_cov_5.873112	60	126	0	16	66	0.2424242
NODE_63051_length_430_cov_5.873112	60	126	2	50	66	0.7575758
NODE_63066_length_430_cov_4.323263	18	90	3	72	72	1.0000000
NODE_63161_length_430_cov_1.945619	153	233	2	80	80	1.0000000
NODE_63401_length_430_cov_0.664653	391	430	0	39	39	1.0000000
NODE_63437_length_429_cov_10.424242	78	158	0	27	80	0.3375000
NODE_63437_length_429_cov_10.424242	78	158	2	10	80	0.1250000
NODE_63437_length_429_cov_10.424242	78	158	4	3	80	0.0375000
NODE_63437_length_429_cov_10.424242	78	158	6	40	80	0.5000000
NODE_63437_length_429_cov_10.424242	207	287	0	36	80	0.4500000
NODE_63437_length_429_cov_10.424242	207	287	6	44	80	0.5500000
NODE_63437_length_429_cov_10.424242	260	340	6	80	80	1.0000000
NODE_63439_length_429_cov_8.957576	213	293	0	80	80	1.0000000
NODE_63439_length_429_cov_8.957576	266	346	0	80	80	1.0000000
NODE_63441_length_429_cov_6.772727	337	366	0	29	29	1.0000000
NODE_63485_length_429_cov_3.003030	173	251	11	1	78	0.0128205
NODE_63485_length_429_cov_3.003030	173	251	13	21	78	0.2692308
NODE_63485_length_429_cov_3.003030	173	251	14	56	78	0.7179487
NODE_63516_length_429_cov_2.433333	220	300	2	80	80	1.0000000
NODE_63519_length_429_cov_2.360606	24	85	0	61	61	1.0000000
NODE_63527_length_429_cov_2.224242	115	195	0	80	80	1.0000000
NODE_63547_length_429_cov_2.051515	114	143	0	29	29	1.0000000
NODE_63547_length_429_cov_2.051515	286	348	0	62	62	1.0000000
NODE_63864_length_428_cov_40.449848	217	297	0	80	80	1.0000000
NODE_63864_length_428_cov_40.449848	270	350	0	80	80	1.0000000
NODE_63864_length_428_cov_40.449848	346	426	0	80	80	1.0000000
NODE_63865_length_428_cov_31.066869	249	325	0	29	76	0.3815790
NODE_63865_length_428_cov_31.066869	249	325	2	23	76	0.3026316
NODE_63865_length_428_cov_31.066869	249	325	4	24	76	0.3157895
NODE_63865_length_428_cov_31.066869	297	378	0	81	81	1.0000000
NODE_63866_length_428_cov_11.799392	62	142	0	80	80	1.0000000
NODE_63866_length_428_cov_11.799392	115	195	0	80	80	1.0000000
NODE_63867_length_428_cov_10.595745	227	307	0	80	80	1.0000000
NODE_63870_length_428_cov_6.784195	344	374	2	30	30	1.0000000
NODE_63871_length_428_cov_6.768997	131	194	0	5	63	0.0793651
NODE_63871_length_428_cov_6.768997	131	194	2	2	63	0.0317460
NODE_63871_length_428_cov_6.768997	131	194	4	16	63	0.2539683
NODE_63871_length_428_cov_6.768997	131	194	6	40	63	0.6349207
NODE_63895_length_428_cov_4.206687	224	304	0	33	80	0.4125000
NODE_63895_length_428_cov_4.206687	224	304	2	35	80	0.4375000
NODE_63895_length_428_cov_4.206687	224	304	4	12	80	0.1500000
NODE_63905_length_428_cov_3.525836	168	236	2	68	68	1.0000000
NODE_63905_length_428_cov_3.525836	209	244	2	35	35	1.0000000
NODE_63959_length_428_cov_2.322188	1	42	0	41	41	1.0000000
NODE_63977_length_428_cov_2.124620	228	308	0	65	80	0.8125000
NODE_63977_length_428_cov_2.124620	228	308	2	15	80	0.1875000
NODE_64011_length_428_cov_1.848024	178	260	0	82	82	1.0000000
NODE_64027_length_428_cov_1.772036	187	255	4	24	68	0.3529412
NODE_64027_length_428_cov_1.772036	187	255	10	44	68	0.6470588
NODE_64245_length_428_cov_0.790274	275	308	0	33	33	1.0000000
NODE_64245_length_428_cov_0.790274	276	302	0	26	26	1.0000000
NODE_64310_length_427_cov_29.628049	312	392	0	10	80	0.1250000
NODE_64310_length_427_cov_29.628049	312	392	4	16	80	0.2000000
NODE_64310_length_427_cov_29.628049	312	392	10	9	80	0.1125000
NODE_64310_length_427_cov_29.628049	312	392	12	45	80	0.5625000
NODE_64310_length_427_cov_29.628049	365	427	0	45	62	0.7258065
NODE_64310_length_427_cov_29.628049	365	427	4	16	62	0.2580645
NODE_64310_length_427_cov_29.628049	365	427	10	1	62	0.0161290
NODE_64310_length_427_cov_29.628049	365	427	0	45	62	0.7258065
NODE_64310_length_427_cov_29.628049	365	427	4	16	62	0.2580645
NODE_64310_length_427_cov_29.628049	365	427	10	1	62	0.0161290
NODE_64312_length_427_cov_9.371951	184	239	14	4	55	0.0727273
NODE_64312_length_427_cov_9.371951	184	239	16	2	55	0.0363636
NODE_64312_length_427_cov_9.371951	184	239	20	3	55	0.0545455
NODE_64312_length_427_cov_9.371951	184	239	24	2	55	0.0363636
NODE_64312_length_427_cov_9.371951	184	239	28	5	55	0.0909091
NODE_64312_length_427_cov_9.371951	184	239	30	37	55	0.6727273
NODE_64312_length_427_cov_9.371951	184	239	32	2	55	0.0363636
NODE_64313_length_427_cov_9.359756	11	82	0	71	71	1.0000000
NODE_64313_length_427_cov_9.359756	70	149	0	79	79	1.0000000
NODE_64313_length_427_cov_9.359756	145	225	0	80	80	1.0000000
NODE_64313_length_427_cov_9.359756	198	278	0	80	80	1.0000000
NODE_64321_length_427_cov_5.929878	405	424	0	19	19	1.0000000
NODE_64324_length_427_cov_5.088415	257	332	0	26	75	0.3466667
NODE_64324_length_427_cov_5.088415	257	332	2	24	75	0.3200000
NODE_64324_length_427_cov_5.088415	257	332	6	25	75	0.3333333
NODE_64345_length_427_cov_3.884146	212	260	6	48	48	1.0000000
NODE_64383_length_427_cov_2.765244	312	363	0	51	51	1.0000000
NODE_64409_length_427_cov_2.362805	142	177	0	10	35	0.2857143
NODE_64409_length_427_cov_2.362805	142	177	2	25	35	0.7142857
NODE_64537_length_427_cov_1.359756	56	139	0	83	83	1.0000000
NODE_64728_length_426_cov_21.837920	178	258	2	80	80	1.0000000
NODE_64729_length_426_cov_16.850153	76	156	0	41	80	0.5125000
NODE_64729_length_426_cov_16.850153	76	156	2	39	80	0.4875000
NODE_64729_length_426_cov_16.850153	129	209	0	6	80	0.0750000
NODE_64729_length_426_cov_16.850153	129	209	2	74	80	0.9250000
NODE_64731_length_426_cov_9.033639	152	232	0	43	80	0.5375000
NODE_64731_length_426_cov_9.033639	152	232	2	37	80	0.4625000
NODE_64731_length_426_cov_9.033639	205	285	0	76	80	0.9500000
NODE_64731_length_426_cov_9.033639	205	285	2	4	80	0.0500000
NODE_64734_length_426_cov_8.314985	133	213	4	80	80	1.0000000
NODE_64734_length_426_cov_8.314985	186	266	4	80	80	1.0000000
NODE_64735_length_426_cov_8.278287	132	212	0	9	80	0.1125000
NODE_64735_length_426_cov_8.278287	132	212	4	71	80	0.8875000
NODE_64735_length_426_cov_8.278287	185	265	0	60	80	0.7500000
NODE_64735_length_426_cov_8.278287	185	265	2	2	80	0.0250000
NODE_64735_length_426_cov_8.278287	185	265	4	18	80	0.2250000
NODE_64752_length_426_cov_4.926606	116	196	0	61	80	0.7625000
NODE_64752_length_426_cov_4.926606	116	196	2	19	80	0.2375000
NODE_64754_length_426_cov_4.743119	119	199	0	9	80	0.1125000
NODE_64754_length_426_cov_4.743119	119	199	2	71	80	0.8875000
NODE_64754_length_426_cov_4.743119	172	252	0	42	80	0.5250000
NODE_64754_length_426_cov_4.743119	172	252	2	38	80	0.4750000
NODE_64833_length_426_cov_2.278287	92	132	0	40	40	1.0000000
NODE_64833_length_426_cov_2.278287	139	205	0	66	66	1.0000000
NODE_64865_length_426_cov_1.896024	80	154	0	74	74	1.0000000
NODE_64948_length_426_cov_1.397554	240	290	0	4	50	0.0800000
NODE_64948_length_426_cov_1.397554	240	290	1	33	50	0.6600000
NODE_64948_length_426_cov_1.397554	240	290	2	13	50	0.2600000
NODE_65135_length_426_cov_0.602446	127	158	0	31	31	1.0000000
NODE_65152_length_425_cov_63.938650	0	61	0	61	61	1.0000000
NODE_65152_length_425_cov_63.938650	34	114	0	80	80	1.0000000
NODE_65164_length_425_cov_4.877301	171	229	31	2	58	0.0344828
NODE_65164_length_425_cov_4.877301	171	229	33	4	58	0.0689655
NODE_65164_length_425_cov_4.877301	171	229	44	1	58	0.0172414
NODE_65164_length_425_cov_4.877301	171	229	46	5	58	0.0862069
NODE_65164_length_425_cov_4.877301	171	229	48	16	58	0.2758621
NODE_65164_length_425_cov_4.877301	171	229	52	2	58	0.0344828
NODE_65164_length_425_cov_4.877301	171	229	54	14	58	0.2413793
NODE_65164_length_425_cov_4.877301	171	229	56	14	58	0.2413793
NODE_65165_length_425_cov_4.822086	295	377	4	35	82	0.4268293
NODE_65165_length_425_cov_4.822086	295	377	6	43	82	0.5243902
NODE_65165_length_425_cov_4.822086	295	377	8	4	82	0.0487805
NODE_65218_length_425_cov_2.809816	38	118	2	36	80	0.4500000
NODE_65218_length_425_cov_2.809816	38	118	4	44	80	0.5500000
NODE_65278_length_425_cov_1.935583	93	138	0	45	45	1.0000000
NODE_65278_length_425_cov_1.935583	170	225	0	55	55	1.0000000
NODE_65278_length_425_cov_1.935583	312	355	2	24	43	0.5581396
NODE_65278_length_425_cov_1.935583	312	355	4	19	43	0.4418605
NODE_65565_length_425_cov_0.628834	104	131	0	27	27	1.0000000
NODE_65602_length_424_cov_5.295385	224	270	2	19	46	0.4130435
NODE_65602_length_424_cov_5.295385	224	270	4	27	46	0.5869565
NODE_65634_length_424_cov_3.255385	266	329	0	63	63	1.0000000
NODE_65669_length_424_cov_2.578462	403	422	2	19	19	1.0000000
NODE_65670_length_424_cov_2.578462	122	144	0	22	22	1.0000000
NODE_66111_length_423_cov_2.728395	150	229	0	24	79	0.3037975
NODE_66111_length_423_cov_2.728395	150	229	2	55	79	0.6962025
NODE_66181_length_423_cov_1.879630	94	142	0	48	48	1.0000000
NODE_66222_length_423_cov_1.580247	128	208	0	10	80	0.1250000
NODE_66222_length_423_cov_1.580247	128	208	2	12	80	0.1500000
NODE_66222_length_423_cov_1.580247	128	208	4	58	80	0.7250000
NODE_66258_length_423_cov_1.410494	206	286	0	80	80	1.0000000
NODE_66459_length_422_cov_12.021672	201	236	0	35	35	1.0000000
NODE_66459_length_422_cov_12.021672	247	289	0	42	42	1.0000000
NODE_66460_length_422_cov_10.712074	62	140	0	78	78	1.0000000
NODE_66460_length_422_cov_10.712074	115	195	0	80	80	1.0000000
NODE_66468_length_422_cov_6.281734	37	117	0	26	80	0.3250000
NODE_66468_length_422_cov_6.281734	37	117	2	22	80	0.2750000
NODE_66468_length_422_cov_6.281734	37	117	4	32	80	0.4000000
NODE_66468_length_422_cov_6.281734	90	170	2	15	80	0.1875000
NODE_66468_length_422_cov_6.281734	90	170	4	65	80	0.8125000
NODE_66474_length_422_cov_5.266254	176	256	2	80	80	1.0000000
NODE_66485_length_422_cov_4.148607	159	224	0	65	65	1.0000000
NODE_66485_length_422_cov_4.148607	197	277	0	80	80	1.0000000
NODE_66488_length_422_cov_4.003096	146	226	0	80	80	1.0000000
NODE_66488_length_422_cov_4.003096	199	279	0	42	80	0.5250000
NODE_66488_length_422_cov_4.003096	199	279	3	7	80	0.0875000
NODE_66488_length_422_cov_4.003096	199	279	4	8	80	0.1000000
NODE_66488_length_422_cov_4.003096	199	279	9	23	80	0.2875000
NODE_66512_length_422_cov_3.130031	93	173	2	80	80	1.0000000
NODE_66512_length_422_cov_3.130031	146	226	0	42	80	0.5250000
NODE_66512_length_422_cov_3.130031	146	226	2	38	80	0.4750000
NODE_66515_length_422_cov_3.077399	291	359	6	3	68	0.0441176
NODE_66515_length_422_cov_3.077399	291	359	8	3	68	0.0441176
NODE_66515_length_422_cov_3.077399	291	359	11	1	68	0.0147059
NODE_66515_length_422_cov_3.077399	291	359	12	4	68	0.0588235
NODE_66515_length_422_cov_3.077399	291	359	14	1	68	0.0147059
NODE_66515_length_422_cov_3.077399	291	359	16	3	68	0.0441176
NODE_66515_length_422_cov_3.077399	291	359	18	4	68	0.0588235
NODE_66515_length_422_cov_3.077399	291	359	20	37	68	0.5441176
NODE_66515_length_422_cov_3.077399	291	359	22	7	68	0.1029412
NODE_66515_length_422_cov_3.077399	291	359	24	5	68	0.0735294
NODE_66550_length_422_cov_2.191950	5	24	0	19	19	1.0000000
NODE_66560_length_422_cov_2.108359	97	177	0	53	80	0.6625000
NODE_66560_length_422_cov_2.108359	97	177	2	9	80	0.1125000
NODE_66560_length_422_cov_2.108359	97	177	4	5	80	0.0625000
NODE_66560_length_422_cov_2.108359	97	177	6	7	80	0.0875000
NODE_66560_length_422_cov_2.108359	97	177	10	6	80	0.0750000
NODE_66560_length_422_cov_2.108359	150	189	0	30	39	0.7692308
NODE_66560_length_422_cov_2.108359	150	189	2	9	39	0.2307692
NODE_66560_length_422_cov_2.108359	249	289	16	4	40	0.1000000
NODE_66560_length_422_cov_2.108359	249	289	17	11	40	0.2750000
NODE_66560_length_422_cov_2.108359	249	289	18	1	40	0.0250000
NODE_66560_length_422_cov_2.108359	249	289	19	3	40	0.0750000
NODE_66560_length_422_cov_2.108359	249	289	21	1	40	0.0250000
NODE_66560_length_422_cov_2.108359	249	289	25	1	40	0.0250000
NODE_66560_length_422_cov_2.108359	249	289	30	3	40	0.0750000
NODE_66560_length_422_cov_2.108359	249	289	34	1	40	0.0250000
NODE_66560_length_422_cov_2.108359	249	289	36	8	40	0.2000000
NODE_66560_length_422_cov_2.108359	249	289	41	7	40	0.1750000
NODE_66806_length_422_cov_0.845201	2	76	0	74	74	1.0000000
NODE_66869_length_421_cov_10.664596	178	256	0	78	78	1.0000000
NODE_66869_length_421_cov_10.664596	229	309	0	80	80	1.0000000
NODE_66874_length_421_cov_7.552795	325	407	0	80	82	0.9756098
NODE_66874_length_421_cov_7.552795	325	407	12	2	82	0.0243902
NODE_66874_length_421_cov_7.552795	380	421	0	41	41	1.0000000
NODE_66875_length_421_cov_7.431677	96	118	0	22	22	1.0000000
NODE_66883_length_421_cov_5.279503	245	310	0	65	65	1.0000000
NODE_66884_length_421_cov_5.158385	68	145	6	77	77	1.0000000
NODE_66897_length_421_cov_4.114907	221	287	2	66	66	1.0000000
NODE_66898_length_421_cov_4.102484	202	277	0	75	75	1.0000000
NODE_66899_length_421_cov_4.040373	192	272	0	80	80	1.0000000
NODE_66899_length_421_cov_4.040373	245	314	0	68	69	0.9855072
NODE_66899_length_421_cov_4.040373	245	314	2	1	69	0.0144928
NODE_66923_length_421_cov_3.319876	0	57	0	57	57	1.0000000
NODE_66955_length_421_cov_2.708075	95	118	0	23	23	1.0000000
NODE_66955_length_421_cov_2.708075	109	189	0	80	80	1.0000000
NODE_66955_length_421_cov_2.708075	248	300	0	52	52	1.0000000
NODE_67073_length_421_cov_1.559006	240	309	4	69	69	1.0000000
NODE_67073_length_421_cov_1.559006	240	310	4	70	70	1.0000000
NODE_67077_length_421_cov_1.537267	305	383	0	78	78	1.0000000
NODE_67098_length_421_cov_1.413043	254	303	2	44	49	0.8979592
NODE_67098_length_421_cov_1.413043	254	303	4	5	49	0.1020408
NODE_67283_length_421_cov_0.633540	132	156	0	9	24	0.3750000
NODE_67283_length_421_cov_0.633540	132	156	2	15	24	0.6250000
NODE_67317_length_420_cov_80.766355	90	170	0	80	80	1.0000000
NODE_67317_length_420_cov_80.766355	143	223	0	46	80	0.5750000
NODE_67317_length_420_cov_80.766355	143	223	2	34	80	0.4250000
NODE_67319_length_420_cov_51.473520	171	250	0	79	79	1.0000000
NODE_67319_length_420_cov_51.473520	223	307	0	84	84	1.0000000
NODE_67319_length_420_cov_51.473520	303	383	0	80	80	1.0000000
NODE_67319_length_420_cov_51.473520	356	420	0	64	64	1.0000000
NODE_67330_length_420_cov_5.071651	230	310	2	6	80	0.0750000
NODE_67330_length_420_cov_5.071651	230	310	3	1	80	0.0125000
NODE_67330_length_420_cov_5.071651	230	310	4	1	80	0.0125000
NODE_67330_length_420_cov_5.071651	230	310	6	12	80	0.1500000
NODE_67330_length_420_cov_5.071651	230	310	7	8	80	0.1000000
NODE_67330_length_420_cov_5.071651	230	310	8	9	80	0.1125000
NODE_67330_length_420_cov_5.071651	230	310	10	43	80	0.5375000
NODE_67334_length_420_cov_4.775701	177	221	0	44	44	1.0000000
NODE_67345_length_420_cov_4.037383	161	240	7	13	79	0.1645570
NODE_67345_length_420_cov_4.037383	161	240	8	8	79	0.1012658
NODE_67345_length_420_cov_4.037383	161	240	10	1	79	0.0126582
NODE_67345_length_420_cov_4.037383	161	240	11	2	79	0.0253165
NODE_67345_length_420_cov_4.037383	161	240	13	6	79	0.0759494
NODE_67345_length_420_cov_4.037383	161	240	14	36	79	0.4556962
NODE_67345_length_420_cov_4.037383	161	240	15	13	79	0.1645570
NODE_67358_length_420_cov_3.657321	291	373	0	82	82	1.0000000
NODE_67398_length_420_cov_2.542056	96	176	0	80	80	1.0000000
NODE_67398_length_420_cov_2.542056	148	202	0	54	54	1.0000000
NODE_67398_length_420_cov_2.542056	149	195	0	46	46	1.0000000
NODE_67414_length_420_cov_2.323988	89	108	0	19	19	1.0000000
NODE_67506_length_420_cov_1.641745	277	312	2	35	35	1.0000000
NODE_67547_length_420_cov_1.429907	15	68	0	6	53	0.1132075
NODE_67547_length_420_cov_1.429907	15	68	2	16	53	0.3018868
NODE_67547_length_420_cov_1.429907	15	68	4	12	53	0.2264151
NODE_67547_length_420_cov_1.429907	15	68	6	19	53	0.3584906
NODE_67547_length_420_cov_1.429907	69	111	6	19	42	0.4523810
NODE_67547_length_420_cov_1.429907	69	111	8	23	42	0.5476190
NODE_67770_length_419_cov_491.015625	0	67	7	1	67	0.0149254
NODE_67770_length_419_cov_491.015625	0	67	13	2	67	0.0298507
NODE_67770_length_419_cov_491.015625	0	67	15	7	67	0.1044776
NODE_67770_length_419_cov_491.015625	0	67	39	1	67	0.0149254
NODE_67770_length_419_cov_491.015625	0	67	43	4	67	0.0597015
NODE_67770_length_419_cov_491.015625	0	67	52	11	67	0.1641791
NODE_67770_length_419_cov_491.015625	0	67	53	1	67	0.0149254
NODE_67770_length_419_cov_491.015625	0	67	57	13	67	0.1940299
NODE_67770_length_419_cov_491.015625	0	67	62	3	67	0.0447761
NODE_67770_length_419_cov_491.015625	0	67	63	1	67	0.0149254
NODE_67770_length_419_cov_491.015625	0	67	64	3	67	0.0447761
NODE_67770_length_419_cov_491.015625	0	67	66	2	67	0.0298507
NODE_67770_length_419_cov_491.015625	0	67	68	2	67	0.0298507
NODE_67770_length_419_cov_491.015625	0	67	76	2	67	0.0298507
NODE_67770_length_419_cov_491.015625	0	67	77	3	67	0.0447761
NODE_67770_length_419_cov_491.015625	0	67	83	6	67	0.0895522
NODE_67770_length_419_cov_491.015625	0	67	87	5	67	0.0746269
NODE_67770_length_419_cov_491.015625	0	67	7	1	67	0.0149254
NODE_67770_length_419_cov_491.015625	0	67	13	2	67	0.0298507
NODE_67770_length_419_cov_491.015625	0	67	15	7	67	0.1044776
NODE_67770_length_419_cov_491.015625	0	67	39	1	67	0.0149254
NODE_67770_length_419_cov_491.015625	0	67	43	4	67	0.0597015
NODE_67770_length_419_cov_491.015625	0	67	52	11	67	0.1641791
NODE_67770_length_419_cov_491.015625	0	67	53	1	67	0.0149254
NODE_67770_length_419_cov_491.015625	0	67	57	13	67	0.1940299
NODE_67770_length_419_cov_491.015625	0	67	62	3	67	0.0447761
NODE_67770_length_419_cov_491.015625	0	67	63	1	67	0.0149254
NODE_67770_length_419_cov_491.015625	0	67	64	3	67	0.0447761
NODE_67770_length_419_cov_491.015625	0	67	66	2	67	0.0298507
NODE_67770_length_419_cov_491.015625	0	67	68	2	67	0.0298507
NODE_67770_length_419_cov_491.015625	0	67	76	2	67	0.0298507
NODE_67770_length_419_cov_491.015625	0	67	77	3	67	0.0447761
NODE_67770_length_419_cov_491.015625	0	67	83	6	67	0.0895522
NODE_67770_length_419_cov_491.015625	0	67	87	5	67	0.0746269
NODE_67770_length_419_cov_491.015625	0	67	7	1	67	0.0149254
NODE_67770_length_419_cov_491.015625	0	67	13	2	67	0.0298507
NODE_67770_length_419_cov_491.015625	0	67	15	7	67	0.1044776
NODE_67770_length_419_cov_491.015625	0	67	39	1	67	0.0149254
NODE_67770_length_419_cov_491.015625	0	67	43	4	67	0.0597015
NODE_67770_length_419_cov_491.015625	0	67	52	11	67	0.1641791
NODE_67770_length_419_cov_491.015625	0	67	53	1	67	0.0149254
NODE_67770_length_419_cov_491.015625	0	67	57	13	67	0.1940299
NODE_67770_length_419_cov_491.015625	0	67	62	3	67	0.0447761
NODE_67770_length_419_cov_491.015625	0	67	63	1	67	0.0149254
NODE_67770_length_419_cov_491.015625	0	67	64	3	67	0.0447761
NODE_67770_length_419_cov_491.015625	0	67	66	2	67	0.0298507
NODE_67770_length_419_cov_491.015625	0	67	68	2	67	0.0298507
NODE_67770_length_419_cov_491.015625	0	67	76	2	67	0.0298507
NODE_67770_length_419_cov_491.015625	0	67	77	3	67	0.0447761
NODE_67770_length_419_cov_491.015625	0	67	83	6	67	0.0895522
NODE_67770_length_419_cov_491.015625	0	67	87	5	67	0.0746269
NODE_67770_length_419_cov_491.015625	0	67	7	1	67	0.0149254
NODE_67770_length_419_cov_491.015625	0	67	13	2	67	0.0298507
NODE_67770_length_419_cov_491.015625	0	67	15	7	67	0.1044776
NODE_67770_length_419_cov_491.015625	0	67	39	1	67	0.0149254
NODE_67770_length_419_cov_491.015625	0	67	43	4	67	0.0597015
NODE_67770_length_419_cov_491.015625	0	67	52	11	67	0.1641791
NODE_67770_length_419_cov_491.015625	0	67	53	1	67	0.0149254
NODE_67770_length_419_cov_491.015625	0	67	57	13	67	0.1940299
NODE_67770_length_419_cov_491.015625	0	67	62	3	67	0.0447761
NODE_67770_length_419_cov_491.015625	0	67	63	1	67	0.0149254
NODE_67770_length_419_cov_491.015625	0	67	64	3	67	0.0447761
NODE_67770_length_419_cov_491.015625	0	67	66	2	67	0.0298507
NODE_67770_length_419_cov_491.015625	0	67	68	2	67	0.0298507
NODE_67770_length_419_cov_491.015625	0	67	76	2	67	0.0298507
NODE_67770_length_419_cov_491.015625	0	67	77	3	67	0.0447761
NODE_67770_length_419_cov_491.015625	0	67	83	6	67	0.0895522
NODE_67770_length_419_cov_491.015625	0	67	87	5	67	0.0746269
NODE_67770_length_419_cov_491.015625	63	143	76	1	80	0.0125000
NODE_67770_length_419_cov_491.015625	63	143	78	1	80	0.0125000
NODE_67770_length_419_cov_491.015625	63	143	87	10	80	0.1250000
NODE_67770_length_419_cov_491.015625	63	143	88	16	80	0.2000000
NODE_67770_length_419_cov_491.015625	63	143	89	3	80	0.0375000
NODE_67770_length_419_cov_491.015625	63	143	95	2	80	0.0250000
NODE_67770_length_419_cov_491.015625	63	143	98	2	80	0.0250000
NODE_67770_length_419_cov_491.015625	63	143	100	4	80	0.0500000
NODE_67770_length_419_cov_491.015625	63	143	102	1	80	0.0125000
NODE_67770_length_419_cov_491.015625	63	143	104	14	80	0.1750000
NODE_67770_length_419_cov_491.015625	63	143	107	2	80	0.0250000
NODE_67770_length_419_cov_491.015625	63	143	108	1	80	0.0125000
NODE_67770_length_419_cov_491.015625	63	143	109	16	80	0.2000000
NODE_67770_length_419_cov_491.015625	63	143	111	3	80	0.0375000
NODE_67770_length_419_cov_491.015625	63	143	113	1	80	0.0125000
NODE_67770_length_419_cov_491.015625	63	143	115	3	80	0.0375000
NODE_67770_length_419_cov_491.015625	63	143	76	1	80	0.0125000
NODE_67770_length_419_cov_491.015625	63	143	78	1	80	0.0125000
NODE_67770_length_419_cov_491.015625	63	143	87	10	80	0.1250000
NODE_67770_length_419_cov_491.015625	63	143	88	16	80	0.2000000
NODE_67770_length_419_cov_491.015625	63	143	89	3	80	0.0375000
NODE_67770_length_419_cov_491.015625	63	143	95	2	80	0.0250000
NODE_67770_length_419_cov_491.015625	63	143	98	2	80	0.0250000
NODE_67770_length_419_cov_491.015625	63	143	100	4	80	0.0500000
NODE_67770_length_419_cov_491.015625	63	143	102	1	80	0.0125000
NODE_67770_length_419_cov_491.015625	63	143	104	14	80	0.1750000
NODE_67770_length_419_cov_491.015625	63	143	107	2	80	0.0250000
NODE_67770_length_419_cov_491.015625	63	143	108	1	80	0.0125000
NODE_67770_length_419_cov_491.015625	63	143	109	16	80	0.2000000
NODE_67770_length_419_cov_491.015625	63	143	111	3	80	0.0375000
NODE_67770_length_419_cov_491.015625	63	143	113	1	80	0.0125000
NODE_67770_length_419_cov_491.015625	63	143	115	3	80	0.0375000
NODE_67770_length_419_cov_491.015625	63	143	76	1	80	0.0125000
NODE_67770_length_419_cov_491.015625	63	143	78	1	80	0.0125000
NODE_67770_length_419_cov_491.015625	63	143	87	10	80	0.1250000
NODE_67770_length_419_cov_491.015625	63	143	88	16	80	0.2000000
NODE_67770_length_419_cov_491.015625	63	143	89	3	80	0.0375000
NODE_67770_length_419_cov_491.015625	63	143	95	2	80	0.0250000
NODE_67770_length_419_cov_491.015625	63	143	98	2	80	0.0250000
NODE_67770_length_419_cov_491.015625	63	143	100	4	80	0.0500000
NODE_67770_length_419_cov_491.015625	63	143	102	1	80	0.0125000
NODE_67770_length_419_cov_491.015625	63	143	104	14	80	0.1750000
NODE_67770_length_419_cov_491.015625	63	143	107	2	80	0.0250000
NODE_67770_length_419_cov_491.015625	63	143	108	1	80	0.0125000
NODE_67770_length_419_cov_491.015625	63	143	109	16	80	0.2000000
NODE_67770_length_419_cov_491.015625	63	143	111	3	80	0.0375000
NODE_67770_length_419_cov_491.015625	63	143	113	1	80	0.0125000
NODE_67770_length_419_cov_491.015625	63	143	115	3	80	0.0375000
NODE_67770_length_419_cov_491.015625	116	196	59	3	80	0.0375000
NODE_67770_length_419_cov_491.015625	116	196	60	5	80	0.0625000
NODE_67770_length_419_cov_491.015625	116	196	62	1	80	0.0125000
NODE_67770_length_419_cov_491.015625	116	196	63	8	80	0.1000000
NODE_67770_length_419_cov_491.015625	116	196	64	6	80	0.0750000
NODE_67770_length_419_cov_491.015625	116	196	66	4	80	0.0500000
NODE_67770_length_419_cov_491.015625	116	196	67	3	80	0.0375000
NODE_67770_length_419_cov_491.015625	116	196	68	1	80	0.0125000
NODE_67770_length_419_cov_491.015625	116	196	75	2	80	0.0250000
NODE_67770_length_419_cov_491.015625	116	196	76	1	80	0.0125000
NODE_67770_length_419_cov_491.015625	116	196	78	11	80	0.1375000
NODE_67770_length_419_cov_491.015625	116	196	79	10	80	0.1250000
NODE_67770_length_419_cov_491.015625	116	196	98	2	80	0.0250000
NODE_67770_length_419_cov_491.015625	116	196	100	4	80	0.0500000
NODE_67770_length_419_cov_491.015625	116	196	102	1	80	0.0125000
NODE_67770_length_419_cov_491.015625	116	196	104	14	80	0.1750000
NODE_67770_length_419_cov_491.015625	116	196	107	2	80	0.0250000
NODE_67770_length_419_cov_491.015625	116	196	109	1	80	0.0125000
NODE_67770_length_419_cov_491.015625	116	196	113	1	80	0.0125000
NODE_67770_length_419_cov_491.015625	116	196	59	3	80	0.0375000
NODE_67770_length_419_cov_491.015625	116	196	60	5	80	0.0625000
NODE_67770_length_419_cov_491.015625	116	196	62	1	80	0.0125000
NODE_67770_length_419_cov_491.015625	116	196	63	8	80	0.1000000
NODE_67770_length_419_cov_491.015625	116	196	64	6	80	0.0750000
NODE_67770_length_419_cov_491.015625	116	196	66	4	80	0.0500000
NODE_67770_length_419_cov_491.015625	116	196	67	3	80	0.0375000
NODE_67770_length_419_cov_491.015625	116	196	68	1	80	0.0125000
NODE_67770_length_419_cov_491.015625	116	196	75	2	80	0.0250000
NODE_67770_length_419_cov_491.015625	116	196	76	1	80	0.0125000
NODE_67770_length_419_cov_491.015625	116	196	78	11	80	0.1375000
NODE_67770_length_419_cov_491.015625	116	196	79	10	80	0.1250000
NODE_67770_length_419_cov_491.015625	116	196	98	2	80	0.0250000
NODE_67770_length_419_cov_491.015625	116	196	100	4	80	0.0500000
NODE_67770_length_419_cov_491.015625	116	196	102	1	80	0.0125000
NODE_67770_length_419_cov_491.015625	116	196	104	14	80	0.1750000
NODE_67770_length_419_cov_491.015625	116	196	107	2	80	0.0250000
NODE_67770_length_419_cov_491.015625	116	196	109	1	80	0.0125000
NODE_67770_length_419_cov_491.015625	116	196	113	1	80	0.0125000
NODE_67770_length_419_cov_491.015625	116	196	59	3	80	0.0375000
NODE_67770_length_419_cov_491.015625	116	196	60	5	80	0.0625000
NODE_67770_length_419_cov_491.015625	116	196	62	1	80	0.0125000
NODE_67770_length_419_cov_491.015625	116	196	63	8	80	0.1000000
NODE_67770_length_419_cov_491.015625	116	196	64	6	80	0.0750000
NODE_67770_length_419_cov_491.015625	116	196	66	4	80	0.0500000
NODE_67770_length_419_cov_491.015625	116	196	67	3	80	0.0375000
NODE_67770_length_419_cov_491.015625	116	196	68	1	80	0.0125000
NODE_67770_length_419_cov_491.015625	116	196	75	2	80	0.0250000
NODE_67770_length_419_cov_491.015625	116	196	76	1	80	0.0125000
NODE_67770_length_419_cov_491.015625	116	196	78	11	80	0.1375000
NODE_67770_length_419_cov_491.015625	116	196	79	10	80	0.1250000
NODE_67770_length_419_cov_491.015625	116	196	98	2	80	0.0250000
NODE_67770_length_419_cov_491.015625	116	196	100	4	80	0.0500000
NODE_67770_length_419_cov_491.015625	116	196	102	1	80	0.0125000
NODE_67770_length_419_cov_491.015625	116	196	104	14	80	0.1750000
NODE_67770_length_419_cov_491.015625	116	196	107	2	80	0.0250000
NODE_67770_length_419_cov_491.015625	116	196	109	1	80	0.0125000
NODE_67770_length_419_cov_491.015625	116	196	113	1	80	0.0125000
NODE_67770_length_419_cov_491.015625	116	196	59	3	80	0.0375000
NODE_67770_length_419_cov_491.015625	116	196	60	5	80	0.0625000
NODE_67770_length_419_cov_491.015625	116	196	62	1	80	0.0125000
NODE_67770_length_419_cov_491.015625	116	196	63	8	80	0.1000000
NODE_67770_length_419_cov_491.015625	116	196	64	6	80	0.0750000
NODE_67770_length_419_cov_491.015625	116	196	66	4	80	0.0500000
NODE_67770_length_419_cov_491.015625	116	196	67	3	80	0.0375000
NODE_67770_length_419_cov_491.015625	116	196	68	1	80	0.0125000
NODE_67770_length_419_cov_491.015625	116	196	75	2	80	0.0250000
NODE_67770_length_419_cov_491.015625	116	196	76	1	80	0.0125000
NODE_67770_length_419_cov_491.015625	116	196	78	11	80	0.1375000
NODE_67770_length_419_cov_491.015625	116	196	79	10	80	0.1250000
NODE_67770_length_419_cov_491.015625	116	196	98	2	80	0.0250000
NODE_67770_length_419_cov_491.015625	116	196	100	4	80	0.0500000
NODE_67770_length_419_cov_491.015625	116	196	102	1	80	0.0125000
NODE_67770_length_419_cov_491.015625	116	196	104	14	80	0.1750000
NODE_67770_length_419_cov_491.015625	116	196	107	2	80	0.0250000
NODE_67770_length_419_cov_491.015625	116	196	109	1	80	0.0125000
NODE_67770_length_419_cov_491.015625	116	196	113	1	80	0.0125000
NODE_67770_length_419_cov_491.015625	116	196	59	3	80	0.0375000
NODE_67770_length_419_cov_491.015625	116	196	60	5	80	0.0625000
NODE_67770_length_419_cov_491.015625	116	196	62	1	80	0.0125000
NODE_67770_length_419_cov_491.015625	116	196	63	8	80	0.1000000
NODE_67770_length_419_cov_491.015625	116	196	64	6	80	0.0750000
NODE_67770_length_419_cov_491.015625	116	196	66	4	80	0.0500000
NODE_67770_length_419_cov_491.015625	116	196	67	3	80	0.0375000
NODE_67770_length_419_cov_491.015625	116	196	68	1	80	0.0125000
NODE_67770_length_419_cov_491.015625	116	196	75	2	80	0.0250000
NODE_67770_length_419_cov_491.015625	116	196	76	1	80	0.0125000
NODE_67770_length_419_cov_491.015625	116	196	78	11	80	0.1375000
NODE_67770_length_419_cov_491.015625	116	196	79	10	80	0.1250000
NODE_67770_length_419_cov_491.015625	116	196	98	2	80	0.0250000
NODE_67770_length_419_cov_491.015625	116	196	100	4	80	0.0500000
NODE_67770_length_419_cov_491.015625	116	196	102	1	80	0.0125000
NODE_67770_length_419_cov_491.015625	116	196	104	14	80	0.1750000
NODE_67770_length_419_cov_491.015625	116	196	107	2	80	0.0250000
NODE_67770_length_419_cov_491.015625	116	196	109	1	80	0.0125000
NODE_67770_length_419_cov_491.015625	116	196	113	1	80	0.0125000
NODE_67772_length_419_cov_31.725000	12	92	0	80	80	1.0000000
NODE_67772_length_419_cov_31.725000	65	145	0	80	80	1.0000000
NODE_67789_length_419_cov_4.862500	47	103	0	56	56	1.0000000
NODE_67789_length_419_cov_4.862500	258	327	0	7	69	0.1014493
NODE_67789_length_419_cov_4.862500	258	327	2	62	69	0.8985507
NODE_67789_length_419_cov_4.862500	284	328	2	44	44	1.0000000
NODE_67803_length_419_cov_4.193750	215	262	0	12	47	0.2553191
NODE_67803_length_419_cov_4.193750	215	262	4	5	47	0.1063830
NODE_67803_length_419_cov_4.193750	215	262	6	5	47	0.1063830
NODE_67803_length_419_cov_4.193750	215	262	7	10	47	0.2127660
NODE_67803_length_419_cov_4.193750	215	262	8	6	47	0.1276596
NODE_67803_length_419_cov_4.193750	215	262	10	9	47	0.1914894
NODE_67803_length_419_cov_4.193750	235	275	6	2	40	0.0500000
NODE_67803_length_419_cov_4.193750	235	275	7	10	40	0.2500000
NODE_67803_length_419_cov_4.193750	235	275	8	6	40	0.1500000
NODE_67803_length_419_cov_4.193750	235	275	10	22	40	0.5500000
NODE_67817_length_419_cov_3.696875	165	215	0	50	50	1.0000000
NODE_67854_length_419_cov_2.628125	234	314	0	80	80	1.0000000
NODE_67856_length_419_cov_2.603125	154	196	0	42	42	1.0000000
NODE_67878_length_419_cov_2.350000	156	220	6	10	64	0.1562500
NODE_67878_length_419_cov_2.350000	156	220	8	25	64	0.3906250
NODE_67878_length_419_cov_2.350000	156	220	10	26	64	0.4062500
NODE_67878_length_419_cov_2.350000	156	220	12	3	64	0.0468750
NODE_67961_length_419_cov_1.593750	339	358	0	19	19	1.0000000
NODE_68250_length_418_cov_63.059561	105	186	0	30	81	0.3703704
NODE_68250_length_418_cov_63.059561	105	186	1	8	81	0.0987654
NODE_68250_length_418_cov_63.059561	105	186	2	1	81	0.0123457
NODE_68250_length_418_cov_63.059561	105	186	4	16	81	0.1975309
NODE_68250_length_418_cov_63.059561	105	186	6	26	81	0.3209876
NODE_68250_length_418_cov_63.059561	159	239	2	13	80	0.1625000
NODE_68250_length_418_cov_63.059561	159	239	4	20	80	0.2500000
NODE_68250_length_418_cov_63.059561	159	239	6	47	80	0.5875000
NODE_68251_length_418_cov_49.796238	325	405	14	15	80	0.1875000
NODE_68251_length_418_cov_49.796238	325	405	16	1	80	0.0125000
NODE_68251_length_418_cov_49.796238	325	405	22	4	80	0.0500000
NODE_68251_length_418_cov_49.796238	325	405	24	3	80	0.0375000
NODE_68251_length_418_cov_49.796238	325	405	25	2	80	0.0250000
NODE_68251_length_418_cov_49.796238	325	405	27	6	80	0.0750000
NODE_68251_length_418_cov_49.796238	325	405	29	1	80	0.0125000
NODE_68251_length_418_cov_49.796238	325	405	31	3	80	0.0375000
NODE_68251_length_418_cov_49.796238	325	405	33	4	80	0.0500000
NODE_68251_length_418_cov_49.796238	325	405	41	1	80	0.0125000
NODE_68251_length_418_cov_49.796238	325	405	43	7	80	0.0875000
NODE_68251_length_418_cov_49.796238	325	405	47	3	80	0.0375000
NODE_68251_length_418_cov_49.796238	325	405	50	1	80	0.0125000
NODE_68251_length_418_cov_49.796238	325	405	53	1	80	0.0125000
NODE_68251_length_418_cov_49.796238	325	405	58	1	80	0.0125000
NODE_68251_length_418_cov_49.796238	325	405	60	2	80	0.0250000
NODE_68251_length_418_cov_49.796238	325	405	61	1	80	0.0125000
NODE_68251_length_418_cov_49.796238	325	405	64	2	80	0.0250000
NODE_68251_length_418_cov_49.796238	325	405	66	1	80	0.0125000
NODE_68251_length_418_cov_49.796238	325	405	70	2	80	0.0250000
NODE_68251_length_418_cov_49.796238	325	405	72	3	80	0.0375000
NODE_68251_length_418_cov_49.796238	325	405	74	1	80	0.0125000
NODE_68251_length_418_cov_49.796238	325	405	76	1	80	0.0125000
NODE_68251_length_418_cov_49.796238	325	405	78	3	80	0.0375000
NODE_68251_length_418_cov_49.796238	325	405	84	1	80	0.0125000
NODE_68251_length_418_cov_49.796238	325	405	88	8	80	0.1000000
NODE_68251_length_418_cov_49.796238	325	405	92	2	80	0.0250000
NODE_68251_length_418_cov_49.796238	378	415	8	1	37	0.0270270
NODE_68251_length_418_cov_49.796238	378	415	12	4	37	0.1081081
NODE_68251_length_418_cov_49.796238	378	415	14	20	37	0.5405405
NODE_68251_length_418_cov_49.796238	378	415	16	1	37	0.0270270
NODE_68251_length_418_cov_49.796238	378	415	22	4	37	0.1081081
NODE_68251_length_418_cov_49.796238	378	415	24	3	37	0.0810811
NODE_68251_length_418_cov_49.796238	378	415	25	2	37	0.0540541
NODE_68251_length_418_cov_49.796238	378	415	27	2	37	0.0540541
NODE_68252_length_418_cov_42.764890	119	196	0	77	77	1.0000000
NODE_68252_length_418_cov_42.764890	172	250	0	78	78	1.0000000
NODE_68253_length_418_cov_23.830721	73	153	0	80	80	1.0000000
NODE_68253_length_418_cov_23.830721	126	200	0	74	74	1.0000000
NODE_68255_length_418_cov_7.216301	211	291	12	33	80	0.4125000
NODE_68255_length_418_cov_7.216301	211	291	13	2	80	0.0250000
NODE_68255_length_418_cov_7.216301	211	291	14	45	80	0.5625000
NODE_68265_length_418_cov_5.382445	134	215	0	81	81	1.0000000
NODE_68265_length_418_cov_5.382445	187	268	0	81	81	1.0000000
NODE_68275_length_418_cov_4.463950	191	272	0	69	81	0.8518519
NODE_68275_length_418_cov_4.463950	191	272	2	12	81	0.1481481
NODE_68280_length_418_cov_4.216301	148	230	2	82	82	1.0000000
NODE_68281_length_418_cov_4.065831	211	280	0	69	69	1.0000000
NODE_68284_length_418_cov_3.909091	95	175	11	2	80	0.0250000
NODE_68284_length_418_cov_3.909091	95	175	13	2	80	0.0250000
NODE_68284_length_418_cov_3.909091	95	175	14	9	80	0.1125000
NODE_68284_length_418_cov_3.909091	95	175	15	1	80	0.0125000
NODE_68284_length_418_cov_3.909091	95	175	16	14	80	0.1750000
NODE_68284_length_418_cov_3.909091	95	175	18	2	80	0.0250000
NODE_68284_length_418_cov_3.909091	95	175	20	3	80	0.0375000
NODE_68284_length_418_cov_3.909091	95	175	26	1	80	0.0125000
NODE_68284_length_418_cov_3.909091	95	175	27	6	80	0.0750000
NODE_68284_length_418_cov_3.909091	95	175	28	4	80	0.0500000
NODE_68284_length_418_cov_3.909091	95	175	29	3	80	0.0375000
NODE_68284_length_418_cov_3.909091	95	175	30	2	80	0.0250000
NODE_68284_length_418_cov_3.909091	95	175	32	2	80	0.0250000
NODE_68284_length_418_cov_3.909091	95	175	39	2	80	0.0250000
NODE_68284_length_418_cov_3.909091	95	175	41	8	80	0.1000000
NODE_68284_length_418_cov_3.909091	95	175	43	1	80	0.0125000
NODE_68284_length_418_cov_3.909091	95	175	46	1	80	0.0125000
NODE_68284_length_418_cov_3.909091	95	175	47	1	80	0.0125000
NODE_68284_length_418_cov_3.909091	95	175	49	5	80	0.0625000
NODE_68284_length_418_cov_3.909091	95	175	51	11	80	0.1375000
NODE_68284_length_418_cov_3.909091	148	224	11	8	76	0.1052632
NODE_68284_length_418_cov_3.909091	148	224	13	32	76	0.4210526
NODE_68284_length_418_cov_3.909091	148	224	14	9	76	0.1184211
NODE_68284_length_418_cov_3.909091	148	224	15	7	76	0.0921053
NODE_68284_length_418_cov_3.909091	148	224	16	18	76	0.2368421
NODE_68284_length_418_cov_3.909091	148	224	18	2	76	0.0263158
NODE_68288_length_418_cov_3.749216	181	247	4	66	66	1.0000000
NODE_68289_length_418_cov_3.711599	249	313	4	14	64	0.2187500
NODE_68289_length_418_cov_3.711599	249	313	6	25	64	0.3906250
NODE_68289_length_418_cov_3.711599	249	313	7	1	64	0.0156250
NODE_68289_length_418_cov_3.711599	249	313	8	24	64	0.3750000
NODE_68307_length_418_cov_3.012539	101	181	2	16	80	0.2000000
NODE_68307_length_418_cov_3.012539	101	181	6	15	80	0.1875000
NODE_68307_length_418_cov_3.012539	101	181	8	10	80	0.1250000
NODE_68307_length_418_cov_3.012539	101	181	10	2	80	0.0250000
NODE_68307_length_418_cov_3.012539	101	181	12	17	80	0.2125000
NODE_68307_length_418_cov_3.012539	101	181	14	20	80	0.2500000
NODE_68354_length_418_cov_2.376176	95	115	0	20	20	1.0000000
NODE_68436_length_418_cov_1.623824	47	128	0	17	81	0.2098765
NODE_68436_length_418_cov_1.623824	47	128	2	64	81	0.7901235
NODE_68436_length_418_cov_1.623824	239	268	22	22	29	0.7586207
NODE_68436_length_418_cov_1.623824	239	268	24	2	29	0.0689655
NODE_68436_length_418_cov_1.623824	239	268	26	5	29	0.1724138
NODE_68682_length_418_cov_0.626959	255	299	0	44	44	1.0000000
NODE_68708_length_417_cov_45.267296	212	292	0	80	80	1.0000000
NODE_68708_length_417_cov_45.267296	265	345	0	80	80	1.0000000
NODE_68708_length_417_cov_45.267296	341	417	0	76	76	1.0000000
NODE_68709_length_417_cov_36.006289	159	239	0	31	80	0.3875000
NODE_68709_length_417_cov_36.006289	159	239	2	49	80	0.6125000
NODE_68711_length_417_cov_12.886792	193	273	0	80	80	1.0000000
NODE_68711_length_417_cov_12.886792	246	326	0	80	80	1.0000000
NODE_68717_length_417_cov_7.056604	210	271	0	61	61	1.0000000
NODE_68717_length_417_cov_7.056604	263	315	0	52	52	1.0000000
NODE_68718_length_417_cov_6.669811	194	264	4	19	70	0.2714286
NODE_68718_length_417_cov_6.669811	194	264	6	1	70	0.0142857
NODE_68718_length_417_cov_6.669811	194	264	10	50	70	0.7142857
NODE_68779_length_417_cov_2.795597	20	91	0	71	71	1.0000000
NODE_69163_length_416_cov_115.782334	174	259	16	18	85	0.2117647
NODE_69163_length_416_cov_115.782334	174	259	18	4	85	0.0470588
NODE_69163_length_416_cov_115.782334	174	259	20	6	85	0.0705882
NODE_69163_length_416_cov_115.782334	174	259	25	1	85	0.0117647
NODE_69163_length_416_cov_115.782334	174	259	26	3	85	0.0352941
NODE_69163_length_416_cov_115.782334	174	259	30	2	85	0.0235294
NODE_69163_length_416_cov_115.782334	174	259	32	5	85	0.0588235
NODE_69163_length_416_cov_115.782334	174	259	34	1	85	0.0117647
NODE_69163_length_416_cov_115.782334	174	259	43	2	85	0.0235294
NODE_69163_length_416_cov_115.782334	174	259	44	2	85	0.0235294
NODE_69163_length_416_cov_115.782334	174	259	45	4	85	0.0470588
NODE_69163_length_416_cov_115.782334	174	259	46	1	85	0.0117647
NODE_69163_length_416_cov_115.782334	174	259	47	2	85	0.0235294
NODE_69163_length_416_cov_115.782334	174	259	49	4	85	0.0470588
NODE_69163_length_416_cov_115.782334	174	259	53	2	85	0.0235294
NODE_69163_length_416_cov_115.782334	174	259	54	4	85	0.0470588
NODE_69163_length_416_cov_115.782334	174	259	56	8	85	0.0941176
NODE_69163_length_416_cov_115.782334	174	259	58	1	85	0.0117647
NODE_69163_length_416_cov_115.782334	174	259	60	2	85	0.0235294
NODE_69163_length_416_cov_115.782334	174	259	61	2	85	0.0235294
NODE_69163_length_416_cov_115.782334	174	259	62	1	85	0.0117647
NODE_69163_length_416_cov_115.782334	174	259	64	2	85	0.0235294
NODE_69163_length_416_cov_115.782334	174	259	65	2	85	0.0235294
NODE_69163_length_416_cov_115.782334	174	259	66	6	85	0.0705882
NODE_69164_length_416_cov_70.678233	180	244	2	5	64	0.0781250
NODE_69164_length_416_cov_70.678233	180	244	4	39	64	0.6093750
NODE_69164_length_416_cov_70.678233	180	244	6	7	64	0.1093750
NODE_69164_length_416_cov_70.678233	180	244	8	13	64	0.2031250
NODE_69166_length_416_cov_39.933754	288	368	4	30	80	0.3750000
NODE_69166_length_416_cov_39.933754	288	368	8	50	80	0.6250000
NODE_69166_length_416_cov_39.933754	341	416	0	17	75	0.2266667
NODE_69166_length_416_cov_39.933754	341	416	4	45	75	0.6000000
NODE_69166_length_416_cov_39.933754	341	416	8	13	75	0.1733333
NODE_69167_length_416_cov_37.334385	158	238	0	80	80	1.0000000
NODE_69167_length_416_cov_37.334385	211	291	0	80	80	1.0000000
NODE_69167_length_416_cov_37.334385	287	367	0	80	80	1.0000000
NODE_69167_length_416_cov_37.334385	340	416	0	76	76	1.0000000
NODE_69179_length_416_cov_5.242902	89	169	0	80	80	1.0000000
NODE_69179_length_416_cov_5.242902	142	222	0	80	80	1.0000000
NODE_69184_length_416_cov_4.892744	79	145	0	49	66	0.7424242
NODE_69184_length_416_cov_4.892744	79	145	2	3	66	0.0454545
NODE_69184_length_416_cov_4.892744	79	145	4	14	66	0.2121212
NODE_69184_length_416_cov_4.892744	194	272	0	14	78	0.1794872
NODE_69184_length_416_cov_4.892744	194	272	2	41	78	0.5256410
NODE_69184_length_416_cov_4.892744	194	272	4	23	78	0.2948718
NODE_69184_length_416_cov_4.892744	247	272	0	14	25	0.5600000
NODE_69184_length_416_cov_4.892744	247	272	2	11	25	0.4400000
NODE_69204_length_416_cov_3.886435	79	136	0	57	57	1.0000000
NODE_69279_length_416_cov_2.230284	10	90	0	10	80	0.1250000
NODE_69279_length_416_cov_2.230284	10	90	2	70	80	0.8750000
NODE_69399_length_416_cov_1.520505	198	244	0	20	46	0.4347826
NODE_69399_length_416_cov_1.520505	198	244	2	7	46	0.1521739
NODE_69399_length_416_cov_1.520505	198	244	4	1	46	0.0217391
NODE_69399_length_416_cov_1.520505	198	244	5	5	46	0.1086956
NODE_69399_length_416_cov_1.520505	198	244	9	3	46	0.0652174
NODE_69399_length_416_cov_1.520505	198	244	10	1	46	0.0217391
NODE_69399_length_416_cov_1.520505	198	244	12	7	46	0.1521739
NODE_69399_length_416_cov_1.520505	198	244	14	2	46	0.0434783
NODE_69399_length_416_cov_1.520505	261	328	17	6	67	0.0895522
NODE_69399_length_416_cov_1.520505	261	328	18	8	67	0.1194030
NODE_69399_length_416_cov_1.520505	261	328	20	28	67	0.4179105
NODE_69399_length_416_cov_1.520505	261	328	22	8	67	0.1194030
NODE_69399_length_416_cov_1.520505	261	328	24	17	67	0.2537313
NODE_69673_length_415_cov_35.924051	260	339	0	79	79	1.0000000
NODE_69673_length_415_cov_35.924051	316	392	0	76	76	1.0000000
NODE_69679_length_415_cov_6.376582	117	197	0	46	80	0.5750000
NODE_69679_length_415_cov_6.376582	117	197	2	34	80	0.4250000
NODE_69679_length_415_cov_6.376582	254	334	0	11	80	0.1375000
NODE_69679_length_415_cov_6.376582	254	334	2	28	80	0.3500000
NODE_69679_length_415_cov_6.376582	254	334	4	41	80	0.5125000
NODE_69774_length_415_cov_2.224684	144	224	0	2	80	0.0250000
NODE_69774_length_415_cov_2.224684	144	224	2	18	80	0.2250000
NODE_69774_length_415_cov_2.224684	144	224	4	1	80	0.0125000
NODE_69774_length_415_cov_2.224684	144	224	8	25	80	0.3125000
NODE_69774_length_415_cov_2.224684	144	224	10	34	80	0.4250000
NODE_69795_length_415_cov_2.069620	207	273	0	6	66	0.0909091
NODE_69795_length_415_cov_2.069620	207	273	2	51	66	0.7727273
NODE_69795_length_415_cov_2.069620	207	273	3	9	66	0.1363636
NODE_69817_length_415_cov_1.832278	225	283	2	2	58	0.0344828
NODE_69817_length_415_cov_1.832278	225	283	4	4	58	0.0689655
NODE_69817_length_415_cov_1.832278	225	283	6	8	58	0.1379310
NODE_69817_length_415_cov_1.832278	225	283	8	14	58	0.2413793
NODE_69817_length_415_cov_1.832278	225	283	9	8	58	0.1379310
NODE_69817_length_415_cov_1.832278	225	283	11	22	58	0.3793103
NODE_69845_length_415_cov_1.610759	90	170	8	3	80	0.0375000
NODE_69845_length_415_cov_1.610759	90	170	12	8	80	0.1000000
NODE_69845_length_415_cov_1.610759	90	170	14	5	80	0.0625000
NODE_69845_length_415_cov_1.610759	90	170	16	2	80	0.0250000
NODE_69845_length_415_cov_1.610759	90	170	20	3	80	0.0375000
NODE_69845_length_415_cov_1.610759	90	170	24	2	80	0.0250000
NODE_69845_length_415_cov_1.610759	90	170	28	4	80	0.0500000
NODE_69845_length_415_cov_1.610759	90	170	30	1	80	0.0125000
NODE_69845_length_415_cov_1.610759	90	170	32	6	80	0.0750000
NODE_69845_length_415_cov_1.610759	90	170	34	7	80	0.0875000
NODE_69845_length_415_cov_1.610759	90	170	36	39	80	0.4875000
NODE_69845_length_415_cov_1.610759	335	376	0	41	41	1.0000000
NODE_70175_length_414_cov_46.263492	0	49	0	49	49	1.0000000
NODE_70175_length_414_cov_46.263492	22	102	0	80	80	1.0000000
NODE_70183_length_414_cov_7.460317	167	247	0	80	80	1.0000000
NODE_70183_length_414_cov_7.460317	220	300	0	80	80	1.0000000
NODE_70192_length_414_cov_5.676190	54	134	0	80	80	1.0000000
NODE_70192_length_414_cov_5.676190	107	187	0	80	80	1.0000000
NODE_70222_length_414_cov_4.130159	257	303	4	46	46	1.0000000
NODE_70222_length_414_cov_4.130159	276	356	0	14	80	0.1750000
NODE_70222_length_414_cov_4.130159	276	356	2	4	80	0.0500000
NODE_70222_length_414_cov_4.130159	276	356	4	62	80	0.7750000
NODE_70254_length_414_cov_2.996825	75	135	18	2	60	0.0333333
NODE_70254_length_414_cov_2.996825	75	135	22	7	60	0.1166667
NODE_70254_length_414_cov_2.996825	75	135	24	1	60	0.0166667
NODE_70254_length_414_cov_2.996825	75	135	26	10	60	0.1666667
NODE_70254_length_414_cov_2.996825	75	135	27	20	60	0.3333333
NODE_70254_length_414_cov_2.996825	75	135	28	18	60	0.3000000
NODE_70254_length_414_cov_2.996825	75	135	29	2	60	0.0333333
NODE_70271_length_414_cov_2.631746	68	145	0	12	77	0.1558442
NODE_70271_length_414_cov_2.631746	68	145	4	65	77	0.8441558
NODE_70284_length_414_cov_2.473016	164	197	0	18	33	0.5454546
NODE_70284_length_414_cov_2.473016	164	197	2	15	33	0.4545455
NODE_70284_length_414_cov_2.473016	170	255	0	29	85	0.3411765
NODE_70284_length_414_cov_2.473016	170	255	2	56	85	0.6588235
NODE_70305_length_414_cov_2.222222	185	260	8	15	75	0.2000000
NODE_70305_length_414_cov_2.222222	185	260	12	60	75	0.8000000
NODE_70305_length_414_cov_2.222222	233	304	12	69	71	0.9718310
NODE_70305_length_414_cov_2.222222	233	304	16	2	71	0.0281690
NODE_70307_length_414_cov_2.206349	88	163	4	37	75	0.4933333
NODE_70307_length_414_cov_2.206349	88	163	6	38	75	0.5066667
NODE_70326_length_414_cov_2.047619	298	349	0	51	51	1.0000000
NODE_70486_length_414_cov_1.177778	106	190	0	84	84	1.0000000
NODE_70494_length_414_cov_1.155556	0	23	0	23	23	1.0000000
NODE_70690_length_413_cov_41.471338	35	115	0	80	80	1.0000000
NODE_70690_length_413_cov_41.471338	35	115	0	80	80	1.0000000
NODE_70690_length_413_cov_41.471338	88	168	0	80	80	1.0000000
NODE_70690_length_413_cov_41.471338	88	168	0	80	80	1.0000000
NODE_70691_length_413_cov_16.687898	222	302	0	80	80	1.0000000
NODE_70691_length_413_cov_16.687898	275	355	0	80	80	1.0000000
NODE_70699_length_413_cov_7.057325	170	250	0	17	80	0.2125000
NODE_70699_length_413_cov_7.057325	170	250	2	33	80	0.4125000
NODE_70699_length_413_cov_7.057325	170	250	6	30	80	0.3750000
NODE_70699_length_413_cov_7.057325	223	300	6	54	77	0.7012987
NODE_70699_length_413_cov_7.057325	223	300	7	1	77	0.0129870
NODE_70699_length_413_cov_7.057325	223	300	8	22	77	0.2857143
NODE_70703_length_413_cov_5.665605	125	182	5	3	57	0.0526316
NODE_70703_length_413_cov_5.665605	125	182	6	4	57	0.0701754
NODE_70703_length_413_cov_5.665605	125	182	8	8	57	0.1403509
NODE_70703_length_413_cov_5.665605	125	182	9	42	57	0.7368421
NODE_70712_length_413_cov_4.754777	140	184	0	44	44	1.0000000
NODE_70743_length_413_cov_3.506369	113	193	4	8	80	0.1000000
NODE_70743_length_413_cov_3.506369	113	193	6	5	80	0.0625000
NODE_70743_length_413_cov_3.506369	113	193	7	1	80	0.0125000
NODE_70743_length_413_cov_3.506369	113	193	8	7	80	0.0875000
NODE_70743_length_413_cov_3.506369	113	193	10	59	80	0.7375000
NODE_70749_length_413_cov_3.235669	251	331	0	80	80	1.0000000
NODE_70749_length_413_cov_3.235669	304	356	0	52	52	1.0000000
NODE_70792_length_413_cov_2.484076	209	257	2	48	48	1.0000000
NODE_70835_length_413_cov_1.949045	224	296	0	72	72	1.0000000
NODE_71196_length_412_cov_9.996805	172	244	0	72	72	1.0000000
NODE_71218_length_412_cov_4.686901	112	167	0	55	55	1.0000000
NODE_71253_length_412_cov_3.204473	44	124	10	12	80	0.1500000
NODE_71253_length_412_cov_3.204473	44	124	12	68	80	0.8500000
NODE_71276_length_412_cov_2.824281	225	305	0	80	80	1.0000000
NODE_71371_length_412_cov_1.782748	262	342	2	29	80	0.3625000
NODE_71371_length_412_cov_1.782748	262	342	4	18	80	0.2250000
NODE_71371_length_412_cov_1.782748	262	342	6	33	80	0.4125000
NODE_71398_length_412_cov_1.603834	143	182	4	7	39	0.1794872
NODE_71398_length_412_cov_1.603834	143	182	6	1	39	0.0256410
NODE_71398_length_412_cov_1.603834	143	182	8	6	39	0.1538462
NODE_71398_length_412_cov_1.603834	143	182	10	1	39	0.0256410
NODE_71398_length_412_cov_1.603834	143	182	11	1	39	0.0256410
NODE_71398_length_412_cov_1.603834	143	182	16	1	39	0.0256410
NODE_71398_length_412_cov_1.603834	143	182	17	1	39	0.0256410
NODE_71398_length_412_cov_1.603834	143	182	19	2	39	0.0512821
NODE_71398_length_412_cov_1.603834	143	182	23	1	39	0.0256410
NODE_71398_length_412_cov_1.603834	143	182	27	1	39	0.0256410
NODE_71398_length_412_cov_1.603834	143	182	29	2	39	0.0512821
NODE_71398_length_412_cov_1.603834	143	182	31	4	39	0.1025641
NODE_71398_length_412_cov_1.603834	143	182	33	1	39	0.0256410
NODE_71398_length_412_cov_1.603834	143	182	35	5	39	0.1282051
NODE_71398_length_412_cov_1.603834	143	182	37	1	39	0.0256410
NODE_71398_length_412_cov_1.603834	143	182	38	1	39	0.0256410
NODE_71398_length_412_cov_1.603834	143	182	39	3	39	0.0769231
NODE_71665_length_411_cov_44.701923	4	72	0	68	68	1.0000000
NODE_71665_length_411_cov_44.701923	35	116	0	81	81	1.0000000
NODE_71665_length_411_cov_44.701923	161	242	0	81	81	1.0000000
NODE_71665_length_411_cov_44.701923	293	374	0	81	81	1.0000000
NODE_71665_length_411_cov_44.701923	337	411	0	74	74	1.0000000
NODE_71666_length_411_cov_43.144231	102	183	0	44	81	0.5432099
NODE_71666_length_411_cov_43.144231	102	183	2	17	81	0.2098765
NODE_71666_length_411_cov_43.144231	102	183	4	20	81	0.2469136
NODE_71666_length_411_cov_43.144231	156	236	0	38	80	0.4750000
NODE_71666_length_411_cov_43.144231	156	236	2	42	80	0.5250000
NODE_71666_length_411_cov_43.144231	232	312	0	80	80	1.0000000
NODE_71666_length_411_cov_43.144231	285	365	0	80	80	1.0000000
NODE_71672_length_411_cov_8.471154	133	213	0	80	80	1.0000000
NODE_71672_length_411_cov_8.471154	186	266	0	80	80	1.0000000
NODE_71673_length_411_cov_8.407051	133	220	6	6	87	0.0689655
NODE_71673_length_411_cov_8.407051	133	220	8	40	87	0.4597701
NODE_71673_length_411_cov_8.407051	133	220	9	4	87	0.0459770
NODE_71673_length_411_cov_8.407051	133	220	10	6	87	0.0689655
NODE_71673_length_411_cov_8.407051	133	220	14	31	87	0.3563218
NODE_71675_length_411_cov_6.455128	249	316	0	38	67	0.5671642
NODE_71675_length_411_cov_6.455128	249	316	2	29	67	0.4328358
NODE_71675_length_411_cov_6.455128	292	344	0	12	52	0.2307692
NODE_71675_length_411_cov_6.455128	292	344	2	40	52	0.7692308
NODE_71687_length_411_cov_4.782051	98	178	4	29	80	0.3625000
NODE_71687_length_411_cov_4.782051	98	178	6	33	80	0.4125000
NODE_71687_length_411_cov_4.782051	98	178	8	7	80	0.0875000
NODE_71687_length_411_cov_4.782051	98	178	10	11	80	0.1375000
NODE_71687_length_411_cov_4.782051	151	228	6	37	77	0.4805195
NODE_71687_length_411_cov_4.782051	151	228	8	30	77	0.3896104
NODE_71687_length_411_cov_4.782051	151	228	10	10	77	0.1298701
NODE_71705_length_411_cov_3.698718	282	347	0	65	65	1.0000000
NODE_71713_length_411_cov_3.378205	88	148	6	12	60	0.2000000
NODE_71713_length_411_cov_3.378205	88	148	8	20	60	0.3333333
NODE_71713_length_411_cov_3.378205	88	148	9	14	60	0.2333333
NODE_71713_length_411_cov_3.378205	88	148	10	14	60	0.2333333
NODE_71714_length_411_cov_3.371795	145	225	4	46	80	0.5750000
NODE_71714_length_411_cov_3.371795	145	225	6	23	80	0.2875000
NODE_71714_length_411_cov_3.371795	145	225	8	11	80	0.1375000
NODE_71714_length_411_cov_3.371795	198	274	4	64	76	0.8421053
NODE_71714_length_411_cov_3.371795	198	274	6	7	76	0.0921053
NODE_71714_length_411_cov_3.371795	198	274	8	5	76	0.0657895
NODE_72163_length_410_cov_49.331190	320	400	0	74	80	0.9250000
NODE_72163_length_410_cov_49.331190	320	400	6	6	80	0.0750000
NODE_72163_length_410_cov_49.331190	320	400	0	74	80	0.9250000
NODE_72163_length_410_cov_49.331190	320	400	6	6	80	0.0750000
NODE_72163_length_410_cov_49.331190	320	400	0	74	80	0.9250000
NODE_72163_length_410_cov_49.331190	320	400	6	6	80	0.0750000
NODE_72163_length_410_cov_49.331190	320	400	0	74	80	0.9250000
NODE_72163_length_410_cov_49.331190	320	400	6	6	80	0.0750000
NODE_72163_length_410_cov_49.331190	320	400	0	74	80	0.9250000
NODE_72163_length_410_cov_49.331190	320	400	6	6	80	0.0750000
NODE_72163_length_410_cov_49.331190	329	400	0	71	71	1.0000000
NODE_72169_length_410_cov_6.797428	179	259	0	80	80	1.0000000
NODE_72169_length_410_cov_6.797428	232	312	0	80	80	1.0000000
NODE_72184_length_410_cov_5.102894	153	222	0	69	69	1.0000000
NODE_72186_length_410_cov_4.884244	101	179	0	78	78	1.0000000
NODE_72187_length_410_cov_4.787781	287	344	0	57	57	1.0000000
NODE_72187_length_410_cov_4.787781	340	397	0	57	57	1.0000000
NODE_72194_length_410_cov_4.591640	245	303	17	1	58	0.0172414
NODE_72194_length_410_cov_4.591640	245	303	32	1	58	0.0172414
NODE_72194_length_410_cov_4.591640	245	303	33	1	58	0.0172414
NODE_72194_length_410_cov_4.591640	245	303	35	1	58	0.0172414
NODE_72194_length_410_cov_4.591640	245	303	39	4	58	0.0689655
NODE_72194_length_410_cov_4.591640	245	303	45	3	58	0.0517241
NODE_72194_length_410_cov_4.591640	245	303	47	1	58	0.0172414
NODE_72194_length_410_cov_4.591640	245	303	49	2	58	0.0344828
NODE_72194_length_410_cov_4.591640	245	303	50	5	58	0.0862069
NODE_72194_length_410_cov_4.591640	245	303	54	1	58	0.0172414
NODE_72194_length_410_cov_4.591640	245	303	60	1	58	0.0172414
NODE_72194_length_410_cov_4.591640	245	303	67	4	58	0.0689655
NODE_72194_length_410_cov_4.591640	245	303	75	1	58	0.0172414
NODE_72194_length_410_cov_4.591640	245	303	77	2	58	0.0344828
NODE_72194_length_410_cov_4.591640	245	303	81	1	58	0.0172414
NODE_72194_length_410_cov_4.591640	245	303	88	2	58	0.0344828
NODE_72194_length_410_cov_4.591640	245	303	103	8	58	0.1379310
NODE_72194_length_410_cov_4.591640	245	303	107	4	58	0.0689655
NODE_72194_length_410_cov_4.591640	245	303	109	1	58	0.0172414
NODE_72194_length_410_cov_4.591640	245	303	111	14	58	0.2413793
NODE_72194_length_410_cov_4.591640	298	356	98	3	58	0.0517241
NODE_72194_length_410_cov_4.591640	298	356	100	1	58	0.0172414
NODE_72194_length_410_cov_4.591640	298	356	104	2	58	0.0344828
NODE_72194_length_410_cov_4.591640	298	356	105	3	58	0.0517241
NODE_72194_length_410_cov_4.591640	298	356	107	6	58	0.1034483
NODE_72194_length_410_cov_4.591640	298	356	111	15	58	0.2586207
NODE_72194_length_410_cov_4.591640	298	356	113	8	58	0.1379310
NODE_72194_length_410_cov_4.591640	298	356	115	5	58	0.0862069
NODE_72194_length_410_cov_4.591640	298	356	117	15	58	0.2586207
NODE_72230_length_410_cov_3.215434	32	112	0	80	80	1.0000000
NODE_72230_length_410_cov_3.215434	85	165	0	80	80	1.0000000
NODE_72327_length_410_cov_1.913183	227	285	0	27	58	0.4655173
NODE_72327_length_410_cov_1.913183	227	285	2	31	58	0.5344828
NODE_72526_length_410_cov_1.038585	272	316	0	1	44	0.0227273
NODE_72526_length_410_cov_1.038585	272	316	4	42	44	0.9545454
NODE_72526_length_410_cov_1.038585	272	316	6	1	44	0.0227273
NODE_72688_length_409_cov_11.506452	56	136	10	35	80	0.4375000
NODE_72688_length_409_cov_11.506452	56	136	12	45	80	0.5625000
NODE_72688_length_409_cov_11.506452	109	189	2	43	80	0.5375000
NODE_72688_length_409_cov_11.506452	109	189	11	1	80	0.0125000
NODE_72688_length_409_cov_11.506452	109	189	12	36	80	0.4500000
NODE_72689_length_409_cov_10.329032	131	186	4	55	55	1.0000000
NODE_72690_length_409_cov_9.625806	62	142	0	80	80	1.0000000
NODE_72690_length_409_cov_9.625806	115	195	0	80	80	1.0000000
NODE_72697_length_409_cov_6.867742	41	71	0	30	30	1.0000000
NODE_72730_length_409_cov_3.822581	103	158	4	10	55	0.1818182
NODE_72730_length_409_cov_3.822581	103	158	6	45	55	0.8181818
NODE_72730_length_409_cov_3.822581	151	232	2	31	81	0.3827161
NODE_72730_length_409_cov_3.822581	151	232	4	14	81	0.1728395
NODE_72730_length_409_cov_3.822581	151	232	5	9	81	0.1111111
NODE_72730_length_409_cov_3.822581	151	232	6	27	81	0.3333333
NODE_72754_length_409_cov_2.987097	240	287	0	38	47	0.8085107
NODE_72754_length_409_cov_2.987097	240	287	2	9	47	0.1914894
NODE_72951_length_409_cov_1.319355	49	131	2	82	82	1.0000000
NODE_72951_length_409_cov_1.319355	104	161	2	57	57	1.0000000
NODE_73196_length_408_cov_8.585761	57	137	0	80	80	1.0000000
NODE_73196_length_408_cov_8.585761	110	190	0	80	80	1.0000000
NODE_73198_length_408_cov_6.948220	71	151	0	80	80	1.0000000
NODE_73198_length_408_cov_6.948220	124	204	0	58	80	0.7250000
NODE_73198_length_408_cov_6.948220	124	204	2	22	80	0.2750000
NODE_73219_length_408_cov_3.957929	83	132	0	40	49	0.8163266
NODE_73219_length_408_cov_3.957929	83	132	1	4	49	0.0816327
NODE_73219_length_408_cov_3.957929	83	132	2	5	49	0.1020408
NODE_73226_length_408_cov_3.511327	40	97	2	57	57	1.0000000
NODE_73226_length_408_cov_3.511327	357	398	0	41	41	1.0000000
NODE_73262_length_408_cov_2.724919	128	180	0	52	52	1.0000000
NODE_73269_length_408_cov_2.563107	164	241	6	40	77	0.5194805
NODE_73269_length_408_cov_2.563107	164	241	8	27	77	0.3506494
NODE_73269_length_408_cov_2.563107	164	241	10	3	77	0.0389610
NODE_73269_length_408_cov_2.563107	164	241	12	2	77	0.0259740
NODE_73269_length_408_cov_2.563107	164	241	15	1	77	0.0129870
NODE_73269_length_408_cov_2.563107	164	241	25	2	77	0.0259740
NODE_73269_length_408_cov_2.563107	164	241	26	1	77	0.0129870
NODE_73269_length_408_cov_2.563107	164	241	27	1	77	0.0129870
NODE_73271_length_408_cov_2.456311	314	379	0	65	65	1.0000000
NODE_73271_length_408_cov_2.456311	352	408	0	56	56	1.0000000
NODE_73690_length_407_cov_6.191558	144	208	0	64	64	1.0000000
NODE_73698_length_407_cov_4.961039	212	291	0	47	79	0.5949367
NODE_73698_length_407_cov_4.961039	212	291	2	32	79	0.4050633
NODE_73719_length_407_cov_3.681818	314	375	0	61	61	1.0000000
NODE_73732_length_407_cov_3.344156	199	247	0	48	48	1.0000000
NODE_73736_length_407_cov_3.250000	142	223	7	1	81	0.0123457
NODE_73736_length_407_cov_3.250000	142	223	8	2	81	0.0246914
NODE_73736_length_407_cov_3.250000	142	223	13	1	81	0.0123457
NODE_73736_length_407_cov_3.250000	142	223	15	1	81	0.0123457
NODE_73736_length_407_cov_3.250000	142	223	19	3	81	0.0370370
NODE_73736_length_407_cov_3.250000	142	223	21	1	81	0.0123457
NODE_73736_length_407_cov_3.250000	142	223	23	72	81	0.8888889
NODE_73762_length_407_cov_2.594156	194	257	0	63	63	1.0000000
NODE_73769_length_407_cov_2.538961	34	114	2	80	80	1.0000000
NODE_73853_length_407_cov_1.737013	208	264	0	56	56	1.0000000
NODE_74200_length_406_cov_176.856678	200	271	134	1	71	0.0140845
NODE_74200_length_406_cov_176.856678	200	271	136	1	71	0.0140845
NODE_74200_length_406_cov_176.856678	200	271	138	3	71	0.0422535
NODE_74200_length_406_cov_176.856678	200	271	140	5	71	0.0704225
NODE_74200_length_406_cov_176.856678	200	271	148	1	71	0.0140845
NODE_74200_length_406_cov_176.856678	200	271	151	1	71	0.0140845
NODE_74200_length_406_cov_176.856678	200	271	155	1	71	0.0140845
NODE_74200_length_406_cov_176.856678	200	271	156	2	71	0.0281690
NODE_74200_length_406_cov_176.856678	200	271	159	2	71	0.0281690
NODE_74200_length_406_cov_176.856678	200	271	160	2	71	0.0281690
NODE_74200_length_406_cov_176.856678	200	271	161	6	71	0.0845070
NODE_74200_length_406_cov_176.856678	200	271	162	2	71	0.0281690
NODE_74200_length_406_cov_176.856678	200	271	164	1	71	0.0140845
NODE_74200_length_406_cov_176.856678	200	271	166	2	71	0.0281690
NODE_74200_length_406_cov_176.856678	200	271	168	1	71	0.0140845
NODE_74200_length_406_cov_176.856678	200	271	170	7	71	0.0985916
NODE_74200_length_406_cov_176.856678	200	271	172	5	71	0.0704225
NODE_74200_length_406_cov_176.856678	200	271	174	5	71	0.0704225
NODE_74200_length_406_cov_176.856678	200	271	175	6	71	0.0845070
NODE_74200_length_406_cov_176.856678	200	271	176	6	71	0.0845070
NODE_74200_length_406_cov_176.856678	200	271	178	2	71	0.0281690
NODE_74200_length_406_cov_176.856678	200	271	180	3	71	0.0422535
NODE_74200_length_406_cov_176.856678	200	271	182	2	71	0.0281690
NODE_74200_length_406_cov_176.856678	200	271	184	4	71	0.0563380
NODE_74200_length_406_cov_176.856678	244	321	75	3	77	0.0389610
NODE_74200_length_406_cov_176.856678	244	321	76	1	77	0.0129870
NODE_74200_length_406_cov_176.856678	244	321	78	1	77	0.0129870
NODE_74200_length_406_cov_176.856678	244	321	79	1	77	0.0129870
NODE_74200_length_406_cov_176.856678	244	321	83	1	77	0.0129870
NODE_74200_length_406_cov_176.856678	244	321	85	2	77	0.0259740
NODE_74200_length_406_cov_176.856678	244	321	89	2	77	0.0259740
NODE_74200_length_406_cov_176.856678	244	321	90	1	77	0.0129870
NODE_74200_length_406_cov_176.856678	244	321	98	1	77	0.0129870
NODE_74200_length_406_cov_176.856678	244	321	101	1	77	0.0129870
NODE_74200_length_406_cov_176.856678	244	321	102	1	77	0.0129870
NODE_74200_length_406_cov_176.856678	244	321	104	3	77	0.0389610
NODE_74200_length_406_cov_176.856678	244	321	105	1	77	0.0129870
NODE_74200_length_406_cov_176.856678	244	321	106	2	77	0.0259740
NODE_74200_length_406_cov_176.856678	244	321	108	5	77	0.0649351
NODE_74200_length_406_cov_176.856678	244	321	110	3	77	0.0389610
NODE_74200_length_406_cov_176.856678	244	321	111	1	77	0.0129870
NODE_74200_length_406_cov_176.856678	244	321	112	1	77	0.0129870
NODE_74200_length_406_cov_176.856678	244	321	114	2	77	0.0259740
NODE_74200_length_406_cov_176.856678	244	321	117	1	77	0.0129870
NODE_74200_length_406_cov_176.856678	244	321	121	1	77	0.0129870
NODE_74200_length_406_cov_176.856678	244	321	127	2	77	0.0259740
NODE_74200_length_406_cov_176.856678	244	321	130	4	77	0.0519481
NODE_74200_length_406_cov_176.856678	244	321	131	4	77	0.0519481
NODE_74200_length_406_cov_176.856678	244	321	132	3	77	0.0389610
NODE_74200_length_406_cov_176.856678	244	321	134	1	77	0.0129870
NODE_74200_length_406_cov_176.856678	244	321	136	3	77	0.0389610
NODE_74200_length_406_cov_176.856678	244	321	138	3	77	0.0389610
NODE_74200_length_406_cov_176.856678	244	321	140	5	77	0.0649351
NODE_74200_length_406_cov_176.856678	244	321	148	1	77	0.0129870
NODE_74200_length_406_cov_176.856678	244	321	156	1	77	0.0129870
NODE_74200_length_406_cov_176.856678	244	321	162	1	77	0.0129870
NODE_74200_length_406_cov_176.856678	244	321	168	1	77	0.0129870
NODE_74200_length_406_cov_176.856678	244	321	174	2	77	0.0259740
NODE_74200_length_406_cov_176.856678	244	321	178	2	77	0.0259740
NODE_74200_length_406_cov_176.856678	244	321	180	3	77	0.0389610
NODE_74200_length_406_cov_176.856678	244	321	182	2	77	0.0259740
NODE_74200_length_406_cov_176.856678	244	321	184	4	77	0.0519481
NODE_74203_length_406_cov_37.723127	15	95	16	3	80	0.0375000
NODE_74203_length_406_cov_37.723127	15	95	35	16	80	0.2000000
NODE_74203_length_406_cov_37.723127	15	95	36	35	80	0.4375000
NODE_74203_length_406_cov_37.723127	15	95	37	22	80	0.2750000
NODE_74203_length_406_cov_37.723127	15	95	43	1	80	0.0125000
NODE_74203_length_406_cov_37.723127	15	95	50	1	80	0.0125000
NODE_74203_length_406_cov_37.723127	15	95	52	1	80	0.0125000
NODE_74203_length_406_cov_37.723127	15	95	82	1	80	0.0125000
NODE_74219_length_406_cov_4.960912	268	327	0	59	59	1.0000000
NODE_74253_length_406_cov_3.087948	261	302	0	41	41	1.0000000
NODE_74284_length_406_cov_2.475570	220	270	0	50	50	1.0000000
NODE_74332_length_406_cov_1.986971	238	276	0	2	38	0.0526316
NODE_74332_length_406_cov_1.986971	238	276	2	36	38	0.9473684
NODE_74368_length_406_cov_1.778502	159	195	10	11	36	0.3055556
NODE_74368_length_406_cov_1.778502	159	195	12	4	36	0.1111111
NODE_74368_length_406_cov_1.778502	159	195	14	21	36	0.5833333
NODE_74368_length_406_cov_1.778502	234	294	12	10	60	0.1666667
NODE_74368_length_406_cov_1.778502	234	294	14	31	60	0.5166667
NODE_74368_length_406_cov_1.778502	234	294	16	3	60	0.0500000
NODE_74368_length_406_cov_1.778502	234	294	20	1	60	0.0166667
NODE_74368_length_406_cov_1.778502	234	294	22	15	60	0.2500000
NODE_74368_length_406_cov_1.778502	267	347	2	13	80	0.1625000
NODE_74368_length_406_cov_1.778502	267	347	4	10	80	0.1250000
NODE_74368_length_406_cov_1.778502	267	347	6	9	80	0.1125000
NODE_74368_length_406_cov_1.778502	267	347	8	2	80	0.0250000
NODE_74368_length_406_cov_1.778502	267	347	10	6	80	0.0750000
NODE_74368_length_406_cov_1.778502	267	347	12	17	80	0.2125000
NODE_74368_length_406_cov_1.778502	267	347	14	20	80	0.2500000
NODE_74368_length_406_cov_1.778502	267	347	16	2	80	0.0250000
NODE_74368_length_406_cov_1.778502	267	347	20	1	80	0.0125000
NODE_74427_length_406_cov_1.495114	173	212	0	18	39	0.4615385
NODE_74427_length_406_cov_1.495114	173	212	2	21	39	0.5384616
NODE_74476_length_406_cov_1.325733	367	398	0	31	31	1.0000000
NODE_74588_length_406_cov_0.934853	1	32	0	31	31	1.0000000
NODE_74588_length_406_cov_0.934853	5	85	0	80	80	1.0000000
NODE_74696_length_405_cov_5.107843	332	380	0	42	48	0.8750000
NODE_74696_length_405_cov_5.107843	332	380	1	6	48	0.1250000
NODE_74697_length_405_cov_4.915033	15	46	0	17	31	0.5483871
NODE_74697_length_405_cov_4.915033	15	46	2	4	31	0.1290323
NODE_74697_length_405_cov_4.915033	15	46	4	10	31	0.3225806
NODE_74727_length_405_cov_3.346405	195	240	6	37	45	0.8222222
NODE_74727_length_405_cov_3.346405	195	240	8	8	45	0.1777778
NODE_74727_length_405_cov_3.346405	274	329	2	10	55	0.1818182
NODE_74727_length_405_cov_3.346405	274	329	4	35	55	0.6363636
NODE_74727_length_405_cov_3.346405	274	329	6	10	55	0.1818182
NODE_74737_length_405_cov_3.124183	210	260	0	50	50	1.0000000
NODE_74737_length_405_cov_3.124183	240	286	0	20	46	0.4347826
NODE_74737_length_405_cov_3.124183	240	286	2	26	46	0.5652174
NODE_74737_length_405_cov_3.124183	260	339	2	79	79	1.0000000
NODE_74737_length_405_cov_3.124183	272	339	2	67	67	1.0000000
NODE_74780_length_405_cov_2.503268	352	399	0	47	47	1.0000000
NODE_74787_length_405_cov_2.460784	0	73	0	22	73	0.3013699
NODE_74787_length_405_cov_2.460784	0	73	2	51	73	0.6986302
NODE_75145_length_405_cov_0.666667	207	268	0	61	61	1.0000000
NODE_75196_length_404_cov_40.937705	40	120	0	80	80	1.0000000
NODE_75196_length_404_cov_40.937705	93	173	0	80	80	1.0000000
NODE_75197_length_404_cov_32.940984	46	126	0	80	80	1.0000000
NODE_75197_length_404_cov_32.940984	99	179	0	71	80	0.8875000
NODE_75197_length_404_cov_32.940984	99	179	12	9	80	0.1125000
NODE_75197_length_404_cov_32.940984	175	255	12	80	80	1.0000000
NODE_75197_length_404_cov_32.940984	228	308	0	40	80	0.5000000
NODE_75197_length_404_cov_32.940984	228	308	12	40	80	0.5000000
NODE_75198_length_404_cov_11.731148	130	210	0	80	80	1.0000000
NODE_75198_length_404_cov_11.731148	183	263	0	80	80	1.0000000
NODE_75200_length_404_cov_9.170492	201	257	0	38	56	0.6785714
NODE_75200_length_404_cov_9.170492	201	257	2	18	56	0.3214286
NODE_75236_length_404_cov_3.613115	323	385	0	62	62	1.0000000
NODE_75259_length_404_cov_2.914754	181	261	0	80	80	1.0000000
NODE_75345_length_404_cov_2.085246	245	325	0	80	80	1.0000000
NODE_75357_length_404_cov_1.993443	95	148	0	53	53	1.0000000
NODE_75399_length_404_cov_1.672131	32	106	0	74	74	1.0000000
NODE_75440_length_404_cov_1.498361	94	174	12	70	80	0.8750000
NODE_75440_length_404_cov_1.498361	94	174	16	10	80	0.1250000
NODE_75446_length_404_cov_1.485246	234	282	4	48	48	1.0000000
NODE_75545_length_404_cov_1.121311	114	194	5	1	80	0.0125000
NODE_75545_length_404_cov_1.121311	114	194	6	4	80	0.0500000
NODE_75545_length_404_cov_1.121311	114	194	7	11	80	0.1375000
NODE_75545_length_404_cov_1.121311	114	194	8	5	80	0.0625000
NODE_75545_length_404_cov_1.121311	114	194	9	10	80	0.1250000
NODE_75545_length_404_cov_1.121311	114	194	10	49	80	0.6125000
NODE_75750_length_403_cov_7.325658	80	146	0	66	66	1.0000000
NODE_75750_length_403_cov_7.325658	165	234	0	69	69	1.0000000
NODE_75750_length_403_cov_7.325658	215	255	0	40	40	1.0000000
NODE_75751_length_403_cov_7.217105	207	284	0	77	77	1.0000000
NODE_75751_length_403_cov_7.217105	257	334	0	77	77	1.0000000
NODE_75752_length_403_cov_6.776316	192	250	2	3	58	0.0517241
NODE_75752_length_403_cov_6.776316	192	250	6	4	58	0.0689655
NODE_75752_length_403_cov_6.776316	192	250	8	51	58	0.8793104
NODE_75788_length_403_cov_3.710526	327	373	0	46	46	1.0000000
NODE_75788_length_403_cov_3.710526	346	403	0	57	57	1.0000000
NODE_75793_length_403_cov_3.611842	283	363	8	30	80	0.3750000
NODE_75793_length_403_cov_3.611842	283	363	11	20	80	0.2500000
NODE_75793_length_403_cov_3.611842	283	363	13	2	80	0.0250000
NODE_75793_length_403_cov_3.611842	283	363	15	28	80	0.3500000
NODE_75824_length_403_cov_2.822368	201	282	0	1	81	0.0123457
NODE_75824_length_403_cov_2.822368	201	282	2	4	81	0.0493827
NODE_75824_length_403_cov_2.822368	201	282	4	6	81	0.0740741
NODE_75824_length_403_cov_2.822368	201	282	8	2	81	0.0246914
NODE_75824_length_403_cov_2.822368	201	282	10	7	81	0.0864198
NODE_75824_length_403_cov_2.822368	201	282	12	61	81	0.7530864
NODE_75871_length_403_cov_2.082237	102	145	0	43	43	1.0000000
NODE_75908_length_403_cov_1.871711	130	166	0	36	36	1.0000000
NODE_75993_length_403_cov_1.398026	79	116	0	37	37	1.0000000
NODE_76029_length_403_cov_1.269737	82	111	0	29	29	1.0000000
NODE_76239_length_402_cov_6.293729	217	297	0	16	80	0.2000000
NODE_76239_length_402_cov_6.293729	217	297	2	64	80	0.8000000
NODE_76239_length_402_cov_6.293729	270	350	0	59	80	0.7375000
NODE_76239_length_402_cov_6.293729	270	350	2	21	80	0.2625000
NODE_76246_length_402_cov_5.227723	176	236	6	34	60	0.5666667
NODE_76246_length_402_cov_5.227723	176	236	8	26	60	0.4333333
NODE_76261_length_402_cov_4.356436	44	123	0	79	79	1.0000000
NODE_76261_length_402_cov_4.356436	119	199	0	43	80	0.5375000
NODE_76261_length_402_cov_4.356436	119	199	2	4	80	0.0500000
NODE_76261_length_402_cov_4.356436	119	199	4	33	80	0.4125000
NODE_76261_length_402_cov_4.356436	172	252	4	33	80	0.4125000
NODE_76261_length_402_cov_4.356436	172	252	6	9	80	0.1125000
NODE_76261_length_402_cov_4.356436	172	252	8	32	80	0.4000000
NODE_76261_length_402_cov_4.356436	172	252	10	6	80	0.0750000
NODE_76276_length_402_cov_3.564356	197	257	4	11	60	0.1833333
NODE_76276_length_402_cov_3.564356	197	257	6	12	60	0.2000000
NODE_76276_length_402_cov_3.564356	197	257	8	37	60	0.6166667
NODE_76276_length_402_cov_3.564356	230	310	8	28	80	0.3500000
NODE_76276_length_402_cov_3.564356	230	310	10	17	80	0.2125000
NODE_76276_length_402_cov_3.564356	230	310	12	35	80	0.4375000
NODE_76328_length_402_cov_2.633663	335	402	0	67	67	1.0000000
NODE_76336_length_402_cov_2.514851	82	162	2	28	80	0.3500000
NODE_76336_length_402_cov_2.514851	82	162	4	1	80	0.0125000
NODE_76336_length_402_cov_2.514851	82	162	6	2	80	0.0250000
NODE_76336_length_402_cov_2.514851	82	162	8	4	80	0.0500000
NODE_76336_length_402_cov_2.514851	82	162	10	5	80	0.0625000
NODE_76336_length_402_cov_2.514851	82	162	12	2	80	0.0250000
NODE_76336_length_402_cov_2.514851	82	162	14	1	80	0.0125000
NODE_76336_length_402_cov_2.514851	82	162	16	37	80	0.4625000
NODE_76336_length_402_cov_2.514851	135	200	0	13	65	0.2000000
NODE_76336_length_402_cov_2.514851	135	200	2	52	65	0.8000000
NODE_76380_length_402_cov_2.102310	114	165	0	51	51	1.0000000
NODE_76380_length_402_cov_2.102310	138	195	0	57	57	1.0000000
NODE_76560_length_402_cov_1.214521	0	33	0	33	33	1.0000000
NODE_76646_length_402_cov_1.000000	119	188	0	69	69	1.0000000
NODE_76752_length_402_cov_0.663366	0	46	0	25	46	0.5434783
NODE_76752_length_402_cov_0.663366	0	46	2	21	46	0.4565217
NODE_76780_length_401_cov_43.675497	285	343	2	58	58	1.0000000
NODE_76801_length_401_cov_4.377483	309	389	0	80	80	1.0000000
NODE_76804_length_401_cov_4.241722	125	180	0	55	55	1.0000000
NODE_76808_length_401_cov_4.132450	195	275	0	80	80	1.0000000
NODE_76811_length_401_cov_3.973510	138	181	0	10	43	0.2325581
NODE_76811_length_401_cov_3.973510	138	181	2	22	43	0.5116279
NODE_76811_length_401_cov_3.973510	138	181	4	11	43	0.2558140
NODE_76828_length_401_cov_3.370861	141	221	0	64	80	0.8000000
NODE_76828_length_401_cov_3.370861	141	221	2	16	80	0.2000000
NODE_76828_length_401_cov_3.370861	194	273	0	11	79	0.1392405
NODE_76828_length_401_cov_3.370861	194	273	2	68	79	0.8607595
NODE_76830_length_401_cov_3.317881	67	147	0	80	80	1.0000000
NODE_76918_length_401_cov_1.937086	160	239	2	9	79	0.1139240
NODE_76918_length_401_cov_1.937086	160	239	4	17	79	0.2151899
NODE_76918_length_401_cov_1.937086	160	239	6	4	79	0.0506329
NODE_76918_length_401_cov_1.937086	160	239	8	21	79	0.2658228
NODE_76918_length_401_cov_1.937086	160	239	10	12	79	0.1518987
NODE_76918_length_401_cov_1.937086	160	239	12	16	79	0.2025317
NODE_76978_length_401_cov_1.615894	205	269	2	4	64	0.0625000
NODE_76978_length_401_cov_1.615894	205	269	4	1	64	0.0156250
NODE_76978_length_401_cov_1.615894	205	269	6	6	64	0.0937500
NODE_76978_length_401_cov_1.615894	205	269	8	1	64	0.0156250
NODE_76978_length_401_cov_1.615894	205	269	9	2	64	0.0312500
NODE_76978_length_401_cov_1.615894	205	269	17	2	64	0.0312500
NODE_76978_length_401_cov_1.615894	205	269	19	1	64	0.0156250
NODE_76978_length_401_cov_1.615894	205	269	21	2	64	0.0312500
NODE_76978_length_401_cov_1.615894	205	269	26	1	64	0.0156250
NODE_76978_length_401_cov_1.615894	205	269	31	1	64	0.0156250
NODE_76978_length_401_cov_1.615894	205	269	36	1	64	0.0156250
NODE_76978_length_401_cov_1.615894	205	269	46	2	64	0.0312500
NODE_76978_length_401_cov_1.615894	205	269	48	1	64	0.0156250
NODE_76978_length_401_cov_1.615894	205	269	50	1	64	0.0156250
NODE_76978_length_401_cov_1.615894	205	269	53	1	64	0.0156250
NODE_76978_length_401_cov_1.615894	205	269	55	2	64	0.0312500
NODE_76978_length_401_cov_1.615894	205	269	59	2	64	0.0312500
NODE_76978_length_401_cov_1.615894	205	269	61	1	64	0.0156250
NODE_76978_length_401_cov_1.615894	205	269	70	1	64	0.0156250
NODE_76978_length_401_cov_1.615894	205	269	72	1	64	0.0156250
NODE_76978_length_401_cov_1.615894	205	269	74	1	64	0.0156250
NODE_76978_length_401_cov_1.615894	205	269	76	1	64	0.0156250
NODE_76978_length_401_cov_1.615894	205	269	80	9	64	0.1406250
NODE_76978_length_401_cov_1.615894	205	269	81	1	64	0.0156250
NODE_76978_length_401_cov_1.615894	205	269	82	2	64	0.0312500
NODE_76978_length_401_cov_1.615894	205	269	88	2	64	0.0312500
NODE_76978_length_401_cov_1.615894	205	269	90	4	64	0.0625000
NODE_76978_length_401_cov_1.615894	205	269	92	1	64	0.0156250
NODE_76978_length_401_cov_1.615894	205	269	96	1	64	0.0156250
NODE_76978_length_401_cov_1.615894	205	269	98	2	64	0.0312500
NODE_76978_length_401_cov_1.615894	205	269	100	2	64	0.0312500
NODE_76978_length_401_cov_1.615894	205	269	104	3	64	0.0468750
NODE_76978_length_401_cov_1.615894	205	269	106	1	64	0.0156250
NODE_77017_length_401_cov_1.407285	23	92	0	69	69	1.0000000
NODE_77017_length_401_cov_1.407285	76	122	0	46	46	1.0000000
NODE_77236_length_401_cov_0.675497	292	372	2	80	80	1.0000000
NODE_77236_length_401_cov_0.675497	345	401	0	16	56	0.2857143
NODE_77236_length_401_cov_0.675497	345	401	2	40	56	0.7142857
NODE_77284_length_400_cov_40.584718	205	281	0	76	76	1.0000000
NODE_77284_length_400_cov_40.584718	254	334	0	80	80	1.0000000
NODE_77289_length_400_cov_8.631229	307	372	0	65	65	1.0000000
NODE_77292_length_400_cov_6.850498	281	329	0	48	48	1.0000000
NODE_77322_length_400_cov_4.000000	82	140	12	2	58	0.0344828
NODE_77322_length_400_cov_4.000000	82	140	14	42	58	0.7241379
NODE_77322_length_400_cov_4.000000	82	140	16	14	58	0.2413793
NODE_77358_length_400_cov_3.029900	204	284	0	80	80	1.0000000
NODE_77358_length_400_cov_3.029900	205	231	0	26	26	1.0000000
NODE_77362_length_400_cov_3.009967	146	220	6	2	74	0.0270270
NODE_77362_length_400_cov_3.009967	146	220	8	25	74	0.3378378
NODE_77362_length_400_cov_3.009967	146	220	10	22	74	0.2972973
NODE_77362_length_400_cov_3.009967	146	220	11	3	74	0.0405405
NODE_77362_length_400_cov_3.009967	146	220	12	1	74	0.0135135
NODE_77362_length_400_cov_3.009967	146	220	13	14	74	0.1891892
NODE_77362_length_400_cov_3.009967	146	220	17	2	74	0.0270270
NODE_77362_length_400_cov_3.009967	146	220	21	5	74	0.0675676
NODE_77362_length_400_cov_3.009967	195	261	11	3	66	0.0454545
NODE_77362_length_400_cov_3.009967	195	261	12	1	66	0.0151515
NODE_77362_length_400_cov_3.009967	195	261	13	14	66	0.2121212
NODE_77362_length_400_cov_3.009967	195	261	16	2	66	0.0303030
NODE_77362_length_400_cov_3.009967	195	261	17	4	66	0.0606061
NODE_77362_length_400_cov_3.009967	195	261	18	4	66	0.0606061
NODE_77362_length_400_cov_3.009967	195	261	19	3	66	0.0454545
NODE_77362_length_400_cov_3.009967	195	261	21	35	66	0.5303030
NODE_77363_length_400_cov_2.990033	253	332	44	2	79	0.0253165
NODE_77363_length_400_cov_2.990033	253	332	46	10	79	0.1265823
NODE_77363_length_400_cov_2.990033	253	332	47	2	79	0.0253165
NODE_77363_length_400_cov_2.990033	253	332	48	13	79	0.1645570
NODE_77363_length_400_cov_2.990033	253	332	49	1	79	0.0126582
NODE_77363_length_400_cov_2.990033	253	332	50	2	79	0.0253165
NODE_77363_length_400_cov_2.990033	253	332	52	5	79	0.0632911
NODE_77363_length_400_cov_2.990033	253	332	54	6	79	0.0759494
NODE_77363_length_400_cov_2.990033	253	332	56	4	79	0.0506329
NODE_77363_length_400_cov_2.990033	253	332	58	10	79	0.1265823
NODE_77363_length_400_cov_2.990033	253	332	60	2	79	0.0253165
NODE_77363_length_400_cov_2.990033	253	332	62	5	79	0.0632911
NODE_77363_length_400_cov_2.990033	253	332	66	1	79	0.0126582
NODE_77363_length_400_cov_2.990033	253	332	68	4	79	0.0506329
NODE_77363_length_400_cov_2.990033	253	332	70	1	79	0.0126582
NODE_77363_length_400_cov_2.990033	253	332	72	2	79	0.0253165
NODE_77363_length_400_cov_2.990033	253	332	76	1	79	0.0126582
NODE_77363_length_400_cov_2.990033	253	332	78	8	79	0.1012658
NODE_77363_length_400_cov_2.990033	306	385	52	2	79	0.0253165
NODE_77363_length_400_cov_2.990033	306	385	54	1	79	0.0126582
NODE_77363_length_400_cov_2.990033	306	385	58	5	79	0.0632911
NODE_77363_length_400_cov_2.990033	306	385	60	17	79	0.2151899
NODE_77363_length_400_cov_2.990033	306	385	61	2	79	0.0253165
NODE_77363_length_400_cov_2.990033	306	385	62	1	79	0.0126582
NODE_77363_length_400_cov_2.990033	306	385	63	10	79	0.1265823
NODE_77363_length_400_cov_2.990033	306	385	66	1	79	0.0126582
NODE_77363_length_400_cov_2.990033	306	385	67	2	79	0.0253165
NODE_77363_length_400_cov_2.990033	306	385	68	4	79	0.0506329
NODE_77363_length_400_cov_2.990033	306	385	69	5	79	0.0632911
NODE_77363_length_400_cov_2.990033	306	385	70	1	79	0.0126582
NODE_77363_length_400_cov_2.990033	306	385	71	5	79	0.0632911
NODE_77363_length_400_cov_2.990033	306	385	72	2	79	0.0253165
NODE_77363_length_400_cov_2.990033	306	385	73	7	79	0.0886076
NODE_77363_length_400_cov_2.990033	306	385	74	2	79	0.0253165
NODE_77363_length_400_cov_2.990033	306	385	76	1	79	0.0126582
NODE_77363_length_400_cov_2.990033	306	385	78	9	79	0.1139240
NODE_77363_length_400_cov_2.990033	306	385	80	2	79	0.0253165
NODE_77368_length_400_cov_2.860465	365	400	0	35	35	1.0000000
NODE_77371_length_400_cov_2.797342	324	372	0	48	48	1.0000000
NODE_77380_length_400_cov_2.581395	192	254	0	62	62	1.0000000
NODE_77460_length_400_cov_1.940199	225	268	0	38	43	0.8837209
NODE_77460_length_400_cov_1.940199	225	268	2	5	43	0.1162791
NODE_77460_length_400_cov_1.940199	293	374	10	21	81	0.2592593
NODE_77460_length_400_cov_1.940199	293	374	12	60	81	0.7407407
NODE_77821_length_399_cov_71.493333	215	295	0	80	80	1.0000000
NODE_77821_length_399_cov_71.493333	268	348	0	80	80	1.0000000
NODE_77823_length_399_cov_7.510000	229	309	0	80	80	1.0000000
NODE_77823_length_399_cov_7.510000	282	362	0	80	80	1.0000000
NODE_77825_length_399_cov_7.310000	125	187	0	62	62	1.0000000
NODE_77854_length_399_cov_4.293333	86	164	4	14	78	0.1794872
NODE_77854_length_399_cov_4.293333	86	164	6	10	78	0.1282051
NODE_77854_length_399_cov_4.293333	86	164	8	1	78	0.0128205
NODE_77854_length_399_cov_4.293333	86	164	10	7	78	0.0897436
NODE_77854_length_399_cov_4.293333	86	164	12	4	78	0.0512821
NODE_77854_length_399_cov_4.293333	86	164	14	1	78	0.0128205
NODE_77854_length_399_cov_4.293333	86	164	16	41	78	0.5256410
NODE_77877_length_399_cov_3.406667	51	124	2	73	73	1.0000000
NODE_77933_length_399_cov_2.286667	310	390	2	80	80	1.0000000
NODE_77966_length_399_cov_1.916667	76	136	4	9	60	0.1500000
NODE_77966_length_399_cov_1.916667	76	136	8	6	60	0.1000000
NODE_77966_length_399_cov_1.916667	76	136	10	1	60	0.0166667
NODE_77966_length_399_cov_1.916667	76	136	16	2	60	0.0333333
NODE_77966_length_399_cov_1.916667	76	136	17	2	60	0.0333333
NODE_77966_length_399_cov_1.916667	76	136	19	7	60	0.1166667
NODE_77966_length_399_cov_1.916667	76	136	21	9	60	0.1500000
NODE_77966_length_399_cov_1.916667	76	136	25	3	60	0.0500000
NODE_77966_length_399_cov_1.916667	76	136	26	18	60	0.3000000
NODE_77966_length_399_cov_1.916667	76	136	28	3	60	0.0500000
NODE_77966_length_399_cov_1.916667	123	189	26	60	66	0.9090909
NODE_77966_length_399_cov_1.916667	123	189	28	6	66	0.0909091
NODE_78276_length_399_cov_0.710000	313	392	0	41	79	0.5189874
NODE_78276_length_399_cov_0.710000	313	392	2	38	79	0.4810127
NODE_78354_length_398_cov_9.688963	1	81	0	80	80	1.0000000
NODE_78354_length_398_cov_9.688963	247	327	0	80	80	1.0000000
NODE_78354_length_398_cov_9.688963	300	380	0	80	80	1.0000000
NODE_78360_length_398_cov_6.488294	130	210	0	80	80	1.0000000
NODE_78364_length_398_cov_5.765886	253	333	14	24	80	0.3000000
NODE_78364_length_398_cov_5.765886	253	333	16	18	80	0.2250000
NODE_78364_length_398_cov_5.765886	253	333	18	20	80	0.2500000
NODE_78364_length_398_cov_5.765886	253	333	20	18	80	0.2250000
NODE_78372_length_398_cov_5.244147	248	312	6	9	64	0.1406250
NODE_78372_length_398_cov_5.244147	248	312	7	2	64	0.0312500
NODE_78372_length_398_cov_5.244147	248	312	9	1	64	0.0156250
NODE_78372_length_398_cov_5.244147	248	312	13	7	64	0.1093750
NODE_78372_length_398_cov_5.244147	248	312	16	23	64	0.3593750
NODE_78372_length_398_cov_5.244147	248	312	18	8	64	0.1250000
NODE_78372_length_398_cov_5.244147	248	312	19	6	64	0.0937500
NODE_78372_length_398_cov_5.244147	248	312	20	8	64	0.1250000
NODE_78376_length_398_cov_5.006689	116	196	0	80	80	1.0000000
NODE_78376_length_398_cov_5.006689	169	251	0	82	82	1.0000000
NODE_78383_length_398_cov_4.284281	63	117	0	54	54	1.0000000
NODE_78383_length_398_cov_4.284281	135	160	0	25	25	1.0000000
NODE_78420_length_398_cov_2.993311	229	309	0	19	80	0.2375000
NODE_78420_length_398_cov_2.993311	229	309	2	58	80	0.7250000
NODE_78420_length_398_cov_2.993311	229	309	4	3	80	0.0375000
NODE_78429_length_398_cov_2.822742	236	271	0	35	35	1.0000000
NODE_78891_length_397_cov_52.855705	124	204	0	80	80	1.0000000
NODE_78891_length_397_cov_52.855705	177	257	0	80	80	1.0000000
NODE_78894_length_397_cov_35.036913	173	253	0	2	80	0.0250000
NODE_78894_length_397_cov_35.036913	173	253	3	1	80	0.0125000
NODE_78894_length_397_cov_35.036913	173	253	4	2	80	0.0250000
NODE_78894_length_397_cov_35.036913	173	253	6	5	80	0.0625000
NODE_78894_length_397_cov_35.036913	173	253	7	13	80	0.1625000
NODE_78894_length_397_cov_35.036913	173	253	9	2	80	0.0250000
NODE_78894_length_397_cov_35.036913	173	253	10	1	80	0.0125000
NODE_78894_length_397_cov_35.036913	173	253	11	54	80	0.6750000
NODE_78895_length_397_cov_13.667785	94	174	0	80	80	1.0000000
NODE_78895_length_397_cov_13.667785	147	227	0	80	80	1.0000000
NODE_78897_length_397_cov_7.496644	192	272	0	80	80	1.0000000
NODE_78897_length_397_cov_7.496644	245	325	0	80	80	1.0000000
NODE_78898_length_397_cov_6.828859	127	173	0	46	46	1.0000000
NODE_78913_length_397_cov_4.902685	293	364	1	4	71	0.0563380
NODE_78913_length_397_cov_4.902685	293	364	2	67	71	0.9436620
NODE_78933_length_397_cov_3.765101	164	244	2	53	80	0.6625000
NODE_78933_length_397_cov_3.765101	164	244	4	27	80	0.3375000
NODE_78951_length_397_cov_3.325503	107	187	0	20	80	0.2500000
NODE_78951_length_397_cov_3.325503	107	187	2	60	80	0.7500000
NODE_78951_length_397_cov_3.325503	163	236	2	38	73	0.5205479
NODE_78951_length_397_cov_3.325503	163	236	4	35	73	0.4794520
NODE_78999_length_397_cov_2.530201	269	312	6	43	43	1.0000000
NODE_79047_length_397_cov_1.959732	154	193	0	39	39	1.0000000
NODE_79072_length_397_cov_1.791946	218	283	2	9	65	0.1384615
NODE_79072_length_397_cov_1.791946	218	283	4	15	65	0.2307692
NODE_79072_length_397_cov_1.791946	218	283	6	10	65	0.1538462
NODE_79072_length_397_cov_1.791946	218	283	9	3	65	0.0461538
NODE_79072_length_397_cov_1.791946	218	283	11	15	65	0.2307692
NODE_79072_length_397_cov_1.791946	218	283	13	13	65	0.2000000
NODE_79127_length_397_cov_1.560403	183	240	0	57	57	1.0000000
NODE_79456_length_396_cov_11.632997	162	242	0	31	80	0.3875000
NODE_79456_length_396_cov_11.632997	162	242	4	49	80	0.6125000
NODE_79456_length_396_cov_11.632997	215	295	4	51	80	0.6375000
NODE_79456_length_396_cov_11.632997	215	295	6	5	80	0.0625000
NODE_79456_length_396_cov_11.632997	215	295	8	24	80	0.3000000
NODE_79460_length_396_cov_7.053872	71	101	0	30	30	1.0000000
NODE_79464_length_396_cov_6.097643	229	309	0	18	80	0.2250000
NODE_79464_length_396_cov_6.097643	229	309	4	62	80	0.7750000
NODE_79464_length_396_cov_6.097643	282	362	0	71	80	0.8875000
NODE_79464_length_396_cov_6.097643	282	362	4	9	80	0.1125000
NODE_79471_length_396_cov_5.484848	125	205	16	8	80	0.1000000
NODE_79471_length_396_cov_5.484848	125	205	18	40	80	0.5000000
NODE_79471_length_396_cov_5.484848	125	205	20	32	80	0.4000000
NODE_79471_length_396_cov_5.484848	178	259	14	37	81	0.4567901
NODE_79471_length_396_cov_5.484848	178	259	16	5	81	0.0617284
NODE_79471_length_396_cov_5.484848	178	259	18	13	81	0.1604938
NODE_79471_length_396_cov_5.484848	178	259	20	26	81	0.3209876
NODE_79473_length_396_cov_5.434343	224	275	0	38	51	0.7450981
NODE_79473_length_396_cov_5.434343	224	275	2	13	51	0.2549020
NODE_79473_length_396_cov_5.434343	272	331	2	59	59	1.0000000
NODE_79483_length_396_cov_4.414141	189	264	2	24	75	0.3200000
NODE_79483_length_396_cov_4.414141	189	264	3	6	75	0.0800000
NODE_79483_length_396_cov_4.414141	189	264	4	45	75	0.6000000
NODE_79483_length_396_cov_4.414141	241	317	0	36	76	0.4736842
NODE_79483_length_396_cov_4.414141	241	317	2	10	76	0.1315790
NODE_79483_length_396_cov_4.414141	241	317	3	13	76	0.1710526
NODE_79483_length_396_cov_4.414141	241	317	4	17	76	0.2236842
NODE_79493_length_396_cov_4.010101	163	205	2	16	42	0.3809524
NODE_79493_length_396_cov_4.010101	163	205	4	26	42	0.6190476
NODE_79522_length_396_cov_3.080808	95	161	0	66	66	1.0000000
NODE_79524_length_396_cov_3.067340	252	316	2	60	64	0.9375000
NODE_79524_length_396_cov_3.067340	252	316	4	4	64	0.0625000
NODE_79535_length_396_cov_2.892256	136	217	2	78	81	0.9629630
NODE_79535_length_396_cov_2.892256	136	217	4	3	81	0.0370370
NODE_79557_length_396_cov_2.710438	88	168	10	11	80	0.1375000
NODE_79557_length_396_cov_2.710438	88	168	12	5	80	0.0625000
NODE_79557_length_396_cov_2.710438	88	168	14	2	80	0.0250000
NODE_79557_length_396_cov_2.710438	88	168	20	2	80	0.0250000
NODE_79557_length_396_cov_2.710438	88	168	22	2	80	0.0250000
NODE_79557_length_396_cov_2.710438	88	168	24	1	80	0.0125000
NODE_79557_length_396_cov_2.710438	88	168	25	2	80	0.0250000
NODE_79557_length_396_cov_2.710438	88	168	27	6	80	0.0750000
NODE_79557_length_396_cov_2.710438	88	168	31	3	80	0.0375000
NODE_79557_length_396_cov_2.710438	88	168	35	1	80	0.0125000
NODE_79557_length_396_cov_2.710438	88	168	39	1	80	0.0125000
NODE_79557_length_396_cov_2.710438	88	168	41	2	80	0.0250000
NODE_79557_length_396_cov_2.710438	88	168	43	10	80	0.1250000
NODE_79557_length_396_cov_2.710438	88	168	45	9	80	0.1125000
NODE_79557_length_396_cov_2.710438	88	168	46	23	80	0.2875000
NODE_79561_length_396_cov_2.680135	297	335	2	38	38	1.0000000
NODE_79562_length_396_cov_2.659933	68	148	0	80	80	1.0000000
NODE_79562_length_396_cov_2.659933	121	168	0	47	47	1.0000000
NODE_79616_length_396_cov_2.060606	308	388	4	80	80	1.0000000
NODE_79643_length_396_cov_1.939394	63	142	4	9	79	0.1139240
NODE_79643_length_396_cov_1.939394	63	142	6	4	79	0.0506329
NODE_79643_length_396_cov_1.939394	63	142	8	12	79	0.1518987
NODE_79643_length_396_cov_1.939394	63	142	10	13	79	0.1645570
NODE_79643_length_396_cov_1.939394	63	142	12	13	79	0.1645570
NODE_79643_length_396_cov_1.939394	63	142	14	28	79	0.3544304
NODE_79643_length_396_cov_1.939394	115	164	8	4	49	0.0816327
NODE_79643_length_396_cov_1.939394	115	164	10	3	49	0.0612245
NODE_79643_length_396_cov_1.939394	115	164	12	19	49	0.3877551
NODE_79643_length_396_cov_1.939394	115	164	14	23	49	0.4693878
NODE_79683_length_396_cov_1.811448	82	162	0	80	80	1.0000000
NODE_79692_length_396_cov_1.734007	88	119	0	31	31	1.0000000
NODE_79930_length_396_cov_0.905724	101	151	4	16	50	0.3200000
NODE_79930_length_396_cov_0.905724	101	151	6	21	50	0.4200000
NODE_79930_length_396_cov_0.905724	101	151	8	9	50	0.1800000
NODE_79930_length_396_cov_0.905724	101	151	10	4	50	0.0800000
NODE_80057_length_395_cov_449.327703	0	79	26	1	79	0.0126582
NODE_80057_length_395_cov_449.327703	0	79	33	1	79	0.0126582
NODE_80057_length_395_cov_449.327703	0	79	38	1	79	0.0126582
NODE_80057_length_395_cov_449.327703	0	79	44	1	79	0.0126582
NODE_80057_length_395_cov_449.327703	0	79	52	1	79	0.0126582
NODE_80057_length_395_cov_449.327703	0	79	64	1	79	0.0126582
NODE_80057_length_395_cov_449.327703	0	79	71	2	79	0.0253165
NODE_80057_length_395_cov_449.327703	0	79	74	1	79	0.0126582
NODE_80057_length_395_cov_449.327703	0	79	81	1	79	0.0126582
NODE_80057_length_395_cov_449.327703	0	79	96	1	79	0.0126582
NODE_80057_length_395_cov_449.327703	0	79	102	1	79	0.0126582
NODE_80057_length_395_cov_449.327703	0	79	110	2	79	0.0253165
NODE_80057_length_395_cov_449.327703	0	79	117	1	79	0.0126582
NODE_80057_length_395_cov_449.327703	0	79	119	1	79	0.0126582
NODE_80057_length_395_cov_449.327703	0	79	123	2	79	0.0253165
NODE_80057_length_395_cov_449.327703	0	79	125	1	79	0.0126582
NODE_80057_length_395_cov_449.327703	0	79	129	1	79	0.0126582
NODE_80057_length_395_cov_449.327703	0	79	132	1	79	0.0126582
NODE_80057_length_395_cov_449.327703	0	79	143	1	79	0.0126582
NODE_80057_length_395_cov_449.327703	0	79	152	1	79	0.0126582
NODE_80057_length_395_cov_449.327703	0	79	154	2	79	0.0253165
NODE_80057_length_395_cov_449.327703	0	79	170	1	79	0.0126582
NODE_80057_length_395_cov_449.327703	0	79	172	1	79	0.0126582
NODE_80057_length_395_cov_449.327703	0	79	183	2	79	0.0253165
NODE_80057_length_395_cov_449.327703	0	79	185	1	79	0.0126582
NODE_80057_length_395_cov_449.327703	0	79	187	1	79	0.0126582
NODE_80057_length_395_cov_449.327703	0	79	191	1	79	0.0126582
NODE_80057_length_395_cov_449.327703	0	79	195	1	79	0.0126582
NODE_80057_length_395_cov_449.327703	0	79	204	1	79	0.0126582
NODE_80057_length_395_cov_449.327703	0	79	211	1	79	0.0126582
NODE_80057_length_395_cov_449.327703	0	79	214	3	79	0.0379747
NODE_80057_length_395_cov_449.327703	0	79	217	1	79	0.0126582
NODE_80057_length_395_cov_449.327703	0	79	222	2	79	0.0253165
NODE_80057_length_395_cov_449.327703	0	79	230	2	79	0.0253165
NODE_80057_length_395_cov_449.327703	0	79	238	1	79	0.0126582
NODE_80057_length_395_cov_449.327703	0	79	239	1	79	0.0126582
NODE_80057_length_395_cov_449.327703	0	79	243	2	79	0.0253165
NODE_80057_length_395_cov_449.327703	0	79	249	1	79	0.0126582
NODE_80057_length_395_cov_449.327703	0	79	254	1	79	0.0126582
NODE_80057_length_395_cov_449.327703	0	79	260	2	79	0.0253165
NODE_80057_length_395_cov_449.327703	0	79	262	2	79	0.0253165
NODE_80057_length_395_cov_449.327703	0	79	265	1	79	0.0126582
NODE_80057_length_395_cov_449.327703	0	79	268	2	79	0.0253165
NODE_80057_length_395_cov_449.327703	0	79	273	2	79	0.0253165
NODE_80057_length_395_cov_449.327703	0	79	275	2	79	0.0253165
NODE_80057_length_395_cov_449.327703	0	79	278	1	79	0.0126582
NODE_80057_length_395_cov_449.327703	0	79	280	1	79	0.0126582
NODE_80057_length_395_cov_449.327703	0	79	282	1	79	0.0126582
NODE_80057_length_395_cov_449.327703	0	79	284	4	79	0.0506329
NODE_80057_length_395_cov_449.327703	0	79	289	1	79	0.0126582
NODE_80057_length_395_cov_449.327703	0	79	290	1	79	0.0126582
NODE_80057_length_395_cov_449.327703	0	79	298	4	79	0.0506329
NODE_80057_length_395_cov_449.327703	0	79	303	2	79	0.0253165
NODE_80057_length_395_cov_449.327703	0	79	307	1	79	0.0126582
NODE_80057_length_395_cov_449.327703	0	79	309	2	79	0.0253165
NODE_80057_length_395_cov_449.327703	0	79	310	1	79	0.0126582
NODE_80058_length_395_cov_13.695946	113	193	0	80	80	1.0000000
NODE_80058_length_395_cov_13.695946	166	246	0	80	80	1.0000000
NODE_80086_length_395_cov_4.179054	152	232	0	80	80	1.0000000
NODE_80116_length_395_cov_2.962838	118	198	4	3	80	0.0375000
NODE_80116_length_395_cov_2.962838	118	198	6	5	80	0.0625000
NODE_80116_length_395_cov_2.962838	118	198	8	11	80	0.1375000
NODE_80116_length_395_cov_2.962838	118	198	10	61	80	0.7625000
NODE_80116_length_395_cov_2.962838	171	237	0	19	66	0.2878788
NODE_80116_length_395_cov_2.962838	171	237	2	9	66	0.1363636
NODE_80116_length_395_cov_2.962838	171	237	4	14	66	0.2121212
NODE_80116_length_395_cov_2.962838	171	237	6	5	66	0.0757576
NODE_80116_length_395_cov_2.962838	171	237	8	6	66	0.0909091
NODE_80116_length_395_cov_2.962838	171	237	10	13	66	0.1969697
NODE_80121_length_395_cov_2.878378	261	301	2	40	40	1.0000000
NODE_80139_length_395_cov_2.587838	111	188	0	32	77	0.4155844
NODE_80139_length_395_cov_2.587838	111	188	2	36	77	0.4675325
NODE_80139_length_395_cov_2.587838	111	188	4	9	77	0.1168831
NODE_80139_length_395_cov_2.587838	232	301	4	44	69	0.6376812
NODE_80139_length_395_cov_2.587838	232	301	5	11	69	0.1594203
NODE_80139_length_395_cov_2.587838	232	301	6	14	69	0.2028985
NODE_80139_length_395_cov_2.587838	258	302	4	44	44	1.0000000
NODE_80141_length_395_cov_2.560811	123	187	0	31	64	0.4843750
NODE_80141_length_395_cov_2.560811	123	187	2	33	64	0.5156250
NODE_80146_length_395_cov_2.527027	194	274	0	23	80	0.2875000
NODE_80146_length_395_cov_2.527027	194	274	2	57	80	0.7125000
NODE_80146_length_395_cov_2.527027	247	327	0	76	80	0.9500000
NODE_80146_length_395_cov_2.527027	247	327	2	4	80	0.0500000
NODE_80439_length_395_cov_1.033784	103	151	0	48	48	1.0000000
NODE_80448_length_395_cov_1.010135	85	105	0	20	20	1.0000000
NODE_80639_length_394_cov_9.464407	211	291	0	80	80	1.0000000
NODE_80639_length_394_cov_9.464407	264	344	0	80	80	1.0000000
NODE_80643_length_394_cov_7.437288	221	301	0	32	80	0.4000000
NODE_80643_length_394_cov_7.437288	221	301	2	48	80	0.6000000
NODE_80643_length_394_cov_7.437288	274	331	2	54	57	0.9473684
NODE_80643_length_394_cov_7.437288	274	331	4	3	57	0.0526316
NODE_80647_length_394_cov_6.444068	187	267	0	80	80	1.0000000
NODE_80647_length_394_cov_6.444068	240	320	0	80	80	1.0000000
NODE_80709_length_394_cov_2.932203	119	140	0	21	21	1.0000000
NODE_80710_length_394_cov_2.894915	79	135	0	56	56	1.0000000
NODE_80710_length_394_cov_2.894915	166	202	0	36	36	1.0000000
NODE_81216_length_393_cov_4.261905	201	267	0	66	66	1.0000000
NODE_81216_length_393_cov_4.261905	240	282	0	42	42	1.0000000
NODE_81240_length_393_cov_3.503401	121	201	0	80	80	1.0000000
NODE_81240_length_393_cov_3.503401	174	246	0	72	72	1.0000000
NODE_81277_length_393_cov_2.704082	198	271	0	73	73	1.0000000
NODE_81289_length_393_cov_2.493197	136	216	0	80	80	1.0000000
NODE_81289_length_393_cov_2.493197	189	269	0	80	80	1.0000000
NODE_81296_length_393_cov_2.360544	195	252	0	57	57	1.0000000
NODE_81416_length_393_cov_1.608844	207	270	0	63	63	1.0000000
NODE_81778_length_392_cov_7.873720	161	241	0	20	80	0.2500000
NODE_81778_length_392_cov_7.873720	161	241	2	60	80	0.7500000
NODE_81778_length_392_cov_7.873720	214	294	0	73	80	0.9125000
NODE_81778_length_392_cov_7.873720	214	294	2	7	80	0.0875000
NODE_81790_length_392_cov_5.262799	218	248	0	30	30	1.0000000
NODE_81805_length_392_cov_3.655290	109	157	4	48	48	1.0000000
NODE_81805_length_392_cov_3.655290	306	386	0	80	80	1.0000000
NODE_81823_length_392_cov_3.197952	102	171	0	12	69	0.1739130
NODE_81823_length_392_cov_3.197952	102	171	4	7	69	0.1014493
NODE_81823_length_392_cov_3.197952	102	171	8	5	69	0.0724638
NODE_81823_length_392_cov_3.197952	102	171	10	24	69	0.3478261
NODE_81823_length_392_cov_3.197952	102	171	12	21	69	0.3043478
NODE_81823_length_392_cov_3.197952	233	314	0	19	81	0.2345679
NODE_81823_length_392_cov_3.197952	233	314	2	62	81	0.7654321
NODE_81857_length_392_cov_2.511945	67	133	54	1	66	0.0151515
NODE_81857_length_392_cov_2.511945	67	133	56	1	66	0.0151515
NODE_81857_length_392_cov_2.511945	67	133	58	1	66	0.0151515
NODE_81857_length_392_cov_2.511945	67	133	60	1	66	0.0151515
NODE_81857_length_392_cov_2.511945	67	133	64	1	66	0.0151515
NODE_81857_length_392_cov_2.511945	67	133	65	1	66	0.0151515
NODE_81857_length_392_cov_2.511945	67	133	68	1	66	0.0151515
NODE_81857_length_392_cov_2.511945	67	133	69	7	66	0.1060606
NODE_81857_length_392_cov_2.511945	67	133	73	1	66	0.0151515
NODE_81857_length_392_cov_2.511945	67	133	77	3	66	0.0454545
NODE_81857_length_392_cov_2.511945	67	133	81	2	66	0.0303030
NODE_81857_length_392_cov_2.511945	67	133	82	1	66	0.0151515
NODE_81857_length_392_cov_2.511945	67	133	87	2	66	0.0303030
NODE_81857_length_392_cov_2.511945	67	133	89	1	66	0.0151515
NODE_81857_length_392_cov_2.511945	67	133	91	2	66	0.0303030
NODE_81857_length_392_cov_2.511945	67	133	93	3	66	0.0454545
NODE_81857_length_392_cov_2.511945	67	133	97	2	66	0.0303030
NODE_81857_length_392_cov_2.511945	67	133	99	1	66	0.0151515
NODE_81857_length_392_cov_2.511945	67	133	101	1	66	0.0151515
NODE_81857_length_392_cov_2.511945	67	133	103	1	66	0.0151515
NODE_81857_length_392_cov_2.511945	67	133	105	1	66	0.0151515
NODE_81857_length_392_cov_2.511945	67	133	107	1	66	0.0151515
NODE_81857_length_392_cov_2.511945	67	133	109	2	66	0.0303030
NODE_81857_length_392_cov_2.511945	67	133	111	3	66	0.0454545
NODE_81857_length_392_cov_2.511945	67	133	114	1	66	0.0151515
NODE_81857_length_392_cov_2.511945	67	133	117	2	66	0.0303030
NODE_81857_length_392_cov_2.511945	67	133	118	3	66	0.0454545
NODE_81857_length_392_cov_2.511945	67	133	124	2	66	0.0303030
NODE_81857_length_392_cov_2.511945	67	133	126	4	66	0.0606061
NODE_81857_length_392_cov_2.511945	67	133	130	3	66	0.0454545
NODE_81857_length_392_cov_2.511945	67	133	132	2	66	0.0303030
NODE_81857_length_392_cov_2.511945	67	133	134	1	66	0.0151515
NODE_81857_length_392_cov_2.511945	67	133	136	1	66	0.0151515
NODE_81857_length_392_cov_2.511945	67	133	140	1	66	0.0151515
NODE_81857_length_392_cov_2.511945	67	133	142	2	66	0.0303030
NODE_81857_length_392_cov_2.511945	67	133	144	3	66	0.0454545
NODE_81857_length_392_cov_2.511945	120	206	120	1	86	0.0116279
NODE_81857_length_392_cov_2.511945	120	206	123	4	86	0.0465116
NODE_81857_length_392_cov_2.511945	120	206	124	1	86	0.0116279
NODE_81857_length_392_cov_2.511945	120	206	125	1	86	0.0116279
NODE_81857_length_392_cov_2.511945	120	206	127	1	86	0.0116279
NODE_81857_length_392_cov_2.511945	120	206	130	3	86	0.0348837
NODE_81857_length_392_cov_2.511945	120	206	131	1	86	0.0116279
NODE_81857_length_392_cov_2.511945	120	206	132	2	86	0.0232558
NODE_81857_length_392_cov_2.511945	120	206	134	1	86	0.0116279
NODE_81857_length_392_cov_2.511945	120	206	135	3	86	0.0348837
NODE_81857_length_392_cov_2.511945	120	206	136	1	86	0.0116279
NODE_81857_length_392_cov_2.511945	120	206	139	1	86	0.0116279
NODE_81857_length_392_cov_2.511945	120	206	140	1	86	0.0116279
NODE_81857_length_392_cov_2.511945	120	206	142	3	86	0.0348837
NODE_81857_length_392_cov_2.511945	120	206	144	4	86	0.0465116
NODE_81857_length_392_cov_2.511945	120	206	146	1	86	0.0116279
NODE_81857_length_392_cov_2.511945	120	206	148	1	86	0.0116279
NODE_81857_length_392_cov_2.511945	120	206	150	1	86	0.0116279
NODE_81857_length_392_cov_2.511945	120	206	152	2	86	0.0232558
NODE_81857_length_392_cov_2.511945	120	206	158	3	86	0.0348837
NODE_81857_length_392_cov_2.511945	120	206	159	1	86	0.0116279
NODE_81857_length_392_cov_2.511945	120	206	160	3	86	0.0348837
NODE_81857_length_392_cov_2.511945	120	206	161	2	86	0.0232558
NODE_81857_length_392_cov_2.511945	120	206	162	2	86	0.0232558
NODE_81857_length_392_cov_2.511945	120	206	166	1	86	0.0116279
NODE_81857_length_392_cov_2.511945	120	206	167	1	86	0.0116279
NODE_81857_length_392_cov_2.511945	120	206	168	5	86	0.0581395
NODE_81857_length_392_cov_2.511945	120	206	170	1	86	0.0116279
NODE_81857_length_392_cov_2.511945	120	206	172	1	86	0.0116279
NODE_81857_length_392_cov_2.511945	120	206	174	2	86	0.0232558
NODE_81857_length_392_cov_2.511945	120	206	176	1	86	0.0116279
NODE_81857_length_392_cov_2.511945	120	206	178	1	86	0.0116279
NODE_81857_length_392_cov_2.511945	120	206	179	7	86	0.0813954
NODE_81857_length_392_cov_2.511945	120	206	180	11	86	0.1279070
NODE_81857_length_392_cov_2.511945	120	206	181	3	86	0.0348837
NODE_81857_length_392_cov_2.511945	120	206	183	5	86	0.0581395
NODE_81857_length_392_cov_2.511945	120	206	185	2	86	0.0232558
NODE_81857_length_392_cov_2.511945	120	206	189	1	86	0.0116279
NODE_81914_length_392_cov_2.075085	268	349	2	81	81	1.0000000
NODE_81914_length_392_cov_2.075085	322	387	2	65	65	1.0000000
NODE_81928_length_392_cov_1.955631	11	56	0	45	45	1.0000000
NODE_81929_length_392_cov_1.952218	40	59	0	19	19	1.0000000
NODE_81940_length_392_cov_1.911263	238	315	0	65	77	0.8441558
NODE_81940_length_392_cov_1.911263	238	315	2	12	77	0.1558442
NODE_81994_length_392_cov_1.631399	114	139	10	1	25	0.0400000
NODE_81994_length_392_cov_1.631399	114	139	12	3	25	0.1200000
NODE_81994_length_392_cov_1.631399	114	139	14	3	25	0.1200000
NODE_81994_length_392_cov_1.631399	114	139	18	4	25	0.1600000
NODE_81994_length_392_cov_1.631399	114	139	22	10	25	0.4000000
NODE_81994_length_392_cov_1.631399	114	139	24	4	25	0.1600000
NODE_82008_length_392_cov_1.559727	83	163	0	80	80	1.0000000
NODE_82015_length_392_cov_1.552901	32	52	0	20	20	1.0000000
NODE_82390_length_391_cov_69.510274	9	89	118	1	80	0.0125000
NODE_82390_length_391_cov_69.510274	9	89	133	1	80	0.0125000
NODE_82390_length_391_cov_69.510274	9	89	141	1	80	0.0125000
NODE_82390_length_391_cov_69.510274	9	89	151	1	80	0.0125000
NODE_82390_length_391_cov_69.510274	9	89	155	1	80	0.0125000
NODE_82390_length_391_cov_69.510274	9	89	159	1	80	0.0125000
NODE_82390_length_391_cov_69.510274	9	89	178	1	80	0.0125000
NODE_82390_length_391_cov_69.510274	9	89	180	2	80	0.0250000
NODE_82390_length_391_cov_69.510274	9	89	184	1	80	0.0125000
NODE_82390_length_391_cov_69.510274	9	89	198	1	80	0.0125000
NODE_82390_length_391_cov_69.510274	9	89	209	1	80	0.0125000
NODE_82390_length_391_cov_69.510274	9	89	216	1	80	0.0125000
NODE_82390_length_391_cov_69.510274	9	89	224	1	80	0.0125000
NODE_82390_length_391_cov_69.510274	9	89	226	1	80	0.0125000
NODE_82390_length_391_cov_69.510274	9	89	228	2	80	0.0250000
NODE_82390_length_391_cov_69.510274	9	89	233	1	80	0.0125000
NODE_82390_length_391_cov_69.510274	9	89	236	2	80	0.0250000
NODE_82390_length_391_cov_69.510274	9	89	240	1	80	0.0125000
NODE_82390_length_391_cov_69.510274	9	89	246	1	80	0.0125000
NODE_82390_length_391_cov_69.510274	9	89	254	1	80	0.0125000
NODE_82390_length_391_cov_69.510274	9	89	258	1	80	0.0125000
NODE_82390_length_391_cov_69.510274	9	89	264	1	80	0.0125000
NODE_82390_length_391_cov_69.510274	9	89	266	1	80	0.0125000
NODE_82390_length_391_cov_69.510274	9	89	273	1	80	0.0125000
NODE_82390_length_391_cov_69.510274	9	89	278	1	80	0.0125000
NODE_82390_length_391_cov_69.510274	9	89	290	1	80	0.0125000
NODE_82390_length_391_cov_69.510274	9	89	295	2	80	0.0250000
NODE_82390_length_391_cov_69.510274	9	89	299	1	80	0.0125000
NODE_82390_length_391_cov_69.510274	9	89	305	1	80	0.0125000
NODE_82390_length_391_cov_69.510274	9	89	307	1	80	0.0125000
NODE_82390_length_391_cov_69.510274	9	89	311	2	80	0.0250000
NODE_82390_length_391_cov_69.510274	9	89	315	2	80	0.0250000
NODE_82390_length_391_cov_69.510274	9	89	319	2	80	0.0250000
NODE_82390_length_391_cov_69.510274	9	89	321	2	80	0.0250000
NODE_82390_length_391_cov_69.510274	9	89	329	1	80	0.0125000
NODE_82390_length_391_cov_69.510274	9	89	335	1	80	0.0125000
NODE_82390_length_391_cov_69.510274	9	89	342	1	80	0.0125000
NODE_82390_length_391_cov_69.510274	9	89	344	1	80	0.0125000
NODE_82390_length_391_cov_69.510274	9	89	347	1	80	0.0125000
NODE_82390_length_391_cov_69.510274	9	89	351	1	80	0.0125000
NODE_82390_length_391_cov_69.510274	9	89	355	1	80	0.0125000
NODE_82390_length_391_cov_69.510274	9	89	357	1	80	0.0125000
NODE_82390_length_391_cov_69.510274	9	89	359	3	80	0.0375000
NODE_82390_length_391_cov_69.510274	9	89	361	1	80	0.0125000
NODE_82390_length_391_cov_69.510274	9	89	363	1	80	0.0125000
NODE_82390_length_391_cov_69.510274	9	89	365	1	80	0.0125000
NODE_82390_length_391_cov_69.510274	9	89	367	1	80	0.0125000
NODE_82390_length_391_cov_69.510274	9	89	369	4	80	0.0500000
NODE_82390_length_391_cov_69.510274	9	89	370	1	80	0.0125000
NODE_82390_length_391_cov_69.510274	9	89	378	2	80	0.0250000
NODE_82390_length_391_cov_69.510274	9	89	384	1	80	0.0125000
NODE_82390_length_391_cov_69.510274	9	89	391	1	80	0.0125000
NODE_82390_length_391_cov_69.510274	9	89	403	2	80	0.0250000
NODE_82390_length_391_cov_69.510274	9	89	409	1	80	0.0125000
NODE_82390_length_391_cov_69.510274	9	89	413	1	80	0.0125000
NODE_82390_length_391_cov_69.510274	9	89	419	2	80	0.0250000
NODE_82390_length_391_cov_69.510274	9	89	421	1	80	0.0125000
NODE_82390_length_391_cov_69.510274	9	89	427	1	80	0.0125000
NODE_82390_length_391_cov_69.510274	9	89	431	2	80	0.0250000
NODE_82390_length_391_cov_69.510274	9	89	439	2	80	0.0250000
NODE_82390_length_391_cov_69.510274	9	89	443	1	80	0.0125000
NODE_82390_length_391_cov_69.510274	9	89	445	1	80	0.0125000
NODE_82391_length_391_cov_39.414384	0	66	0	4	66	0.0606061
NODE_82391_length_391_cov_39.414384	0	66	4	5	66	0.0757576
NODE_82391_length_391_cov_39.414384	0	66	6	15	66	0.2272727
NODE_82391_length_391_cov_39.414384	0	66	8	5	66	0.0757576
NODE_82391_length_391_cov_39.414384	0	66	9	1	66	0.0151515
NODE_82391_length_391_cov_39.414384	0	66	16	36	66	0.5454546
NODE_82391_length_391_cov_39.414384	0	71	0	4	71	0.0563380
NODE_82391_length_391_cov_39.414384	0	71	4	5	71	0.0704225
NODE_82391_length_391_cov_39.414384	0	71	6	15	71	0.2112676
NODE_82391_length_391_cov_39.414384	0	71	8	5	71	0.0704225
NODE_82391_length_391_cov_39.414384	0	71	9	1	71	0.0140845
NODE_82391_length_391_cov_39.414384	0	71	16	41	71	0.5774648
NODE_82391_length_391_cov_39.414384	44	124	2	5	80	0.0625000
NODE_82391_length_391_cov_39.414384	44	124	8	5	80	0.0625000
NODE_82391_length_391_cov_39.414384	44	124	14	10	80	0.1250000
NODE_82391_length_391_cov_39.414384	44	124	16	60	80	0.7500000
NODE_82394_length_391_cov_10.352740	156	235	0	10	79	0.1265823
NODE_82394_length_391_cov_10.352740	156	235	2	69	79	0.8734177
NODE_82415_length_391_cov_5.030822	85	166	6	1	81	0.0123457
NODE_82415_length_391_cov_5.030822	85	166	8	2	81	0.0246914
NODE_82415_length_391_cov_5.030822	85	166	12	8	81	0.0987654
NODE_82415_length_391_cov_5.030822	85	166	16	32	81	0.3950617
NODE_82415_length_391_cov_5.030822	85	166	18	38	81	0.4691358
NODE_82498_length_391_cov_2.660959	267	343	8	6	76	0.0789474
NODE_82498_length_391_cov_2.660959	267	343	10	70	76	0.9210526
NODE_82552_length_391_cov_2.089041	176	256	4	8	80	0.1000000
NODE_82552_length_391_cov_2.089041	176	256	6	6	80	0.0750000
NODE_82552_length_391_cov_2.089041	176	256	7	6	80	0.0750000
NODE_82552_length_391_cov_2.089041	176	256	8	9	80	0.1125000
NODE_82552_length_391_cov_2.089041	176	256	12	2	80	0.0250000
NODE_82552_length_391_cov_2.089041	176	256	14	49	80	0.6125000
NODE_82552_length_391_cov_2.089041	229	280	0	1	51	0.0196078
NODE_82552_length_391_cov_2.089041	229	280	2	1	51	0.0196078
NODE_82552_length_391_cov_2.089041	229	280	3	2	51	0.0392157
NODE_82552_length_391_cov_2.089041	229	280	4	28	51	0.5490196
NODE_82552_length_391_cov_2.089041	229	280	6	6	51	0.1176471
NODE_82552_length_391_cov_2.089041	229	280	7	6	51	0.1176471
NODE_82552_length_391_cov_2.089041	229	280	8	7	51	0.1372549
NODE_82574_length_391_cov_1.907534	200	257	0	10	57	0.1754386
NODE_82574_length_391_cov_1.907534	200	257	2	47	57	0.8245614
NODE_82597_length_391_cov_1.773973	160	190	0	30	30	1.0000000
NODE_82632_length_391_cov_1.647260	298	378	2	80	80	1.0000000
NODE_82662_length_391_cov_1.561644	241	261	0	20	20	1.0000000
NODE_83015_length_390_cov_29.030928	86	166	0	80	80	1.0000000
NODE_83015_length_390_cov_29.030928	139	219	0	80	80	1.0000000
NODE_83016_length_390_cov_22.319588	118	198	0	80	80	1.0000000
NODE_83016_length_390_cov_22.319588	171	251	0	80	80	1.0000000
NODE_83044_length_390_cov_4.481100	208	277	0	67	69	0.9710145
NODE_83044_length_390_cov_4.481100	208	277	2	2	69	0.0289855
NODE_83044_length_390_cov_4.481100	286	327	0	41	41	1.0000000
NODE_83045_length_390_cov_4.481100	93	171	2	8	78	0.1025641
NODE_83045_length_390_cov_4.481100	93	171	4	7	78	0.0897436
NODE_83045_length_390_cov_4.481100	93	171	8	8	78	0.1025641
NODE_83045_length_390_cov_4.481100	93	171	13	1	78	0.0128205
NODE_83045_length_390_cov_4.481100	93	171	14	8	78	0.1025641
NODE_83045_length_390_cov_4.481100	93	171	16	11	78	0.1410256
NODE_83045_length_390_cov_4.481100	93	171	18	35	78	0.4487180
NODE_83045_length_390_cov_4.481100	144	210	14	2	66	0.0303030
NODE_83045_length_390_cov_4.481100	144	210	16	2	66	0.0303030
NODE_83045_length_390_cov_4.481100	144	210	18	62	66	0.9393939
NODE_83060_length_390_cov_3.814433	66	99	0	33	33	1.0000000
NODE_83061_length_390_cov_3.783505	188	268	0	80	80	1.0000000
NODE_83061_length_390_cov_3.783505	241	321	0	80	80	1.0000000
NODE_83066_length_390_cov_3.560137	304	367	2	63	63	1.0000000
NODE_83066_length_390_cov_3.560137	340	381	0	8	41	0.1951219
NODE_83066_length_390_cov_3.560137	340	381	2	33	41	0.8048781
NODE_83169_length_390_cov_2.127148	242	322	0	27	80	0.3375000
NODE_83169_length_390_cov_2.127148	242	322	2	53	80	0.6625000
NODE_83171_length_390_cov_2.123711	133	177	4	14	44	0.3181818
NODE_83171_length_390_cov_2.123711	133	177	6	14	44	0.3181818
NODE_83171_length_390_cov_2.123711	133	177	8	16	44	0.3636364
NODE_83171_length_390_cov_2.123711	157	237	6	4	80	0.0500000
NODE_83171_length_390_cov_2.123711	157	237	8	28	80	0.3500000
NODE_83171_length_390_cov_2.123711	157	237	10	43	80	0.5375000
NODE_83171_length_390_cov_2.123711	157	237	12	5	80	0.0625000
NODE_83288_length_390_cov_1.536082	223	276	0	53	53	1.0000000
NODE_83338_length_390_cov_1.398625	49	110	2	4	61	0.0655738
NODE_83338_length_390_cov_1.398625	49	110	4	9	61	0.1475410
NODE_83338_length_390_cov_1.398625	49	110	6	6	61	0.0983607
NODE_83338_length_390_cov_1.398625	49	110	8	10	61	0.1639344
NODE_83338_length_390_cov_1.398625	49	110	10	5	61	0.0819672
NODE_83338_length_390_cov_1.398625	49	110	12	27	61	0.4426230
NODE_83463_length_390_cov_1.034364	78	158	0	80	80	1.0000000
NODE_83633_length_389_cov_63.710345	32	112	0	80	80	1.0000000
NODE_83633_length_389_cov_63.710345	85	165	0	80	80	1.0000000
NODE_83633_length_389_cov_63.710345	161	241	0	80	80	1.0000000
NODE_83633_length_389_cov_63.710345	214	294	0	80	80	1.0000000
NODE_83650_length_389_cov_5.382759	154	234	0	80	80	1.0000000
NODE_83662_length_389_cov_4.468966	199	269	0	70	70	1.0000000
NODE_83663_length_389_cov_4.424138	68	148	50	1	80	0.0125000
NODE_83663_length_389_cov_4.424138	68	148	52	4	80	0.0500000
NODE_83663_length_389_cov_4.424138	68	148	56	2	80	0.0250000
NODE_83663_length_389_cov_4.424138	68	148	58	1	80	0.0125000
NODE_83663_length_389_cov_4.424138	68	148	60	3	80	0.0375000
NODE_83663_length_389_cov_4.424138	68	148	62	1	80	0.0125000
NODE_83663_length_389_cov_4.424138	68	148	64	1	80	0.0125000
NODE_83663_length_389_cov_4.424138	68	148	66	3	80	0.0375000
NODE_83663_length_389_cov_4.424138	68	148	70	15	80	0.1875000
NODE_83663_length_389_cov_4.424138	68	148	73	2	80	0.0250000
NODE_83663_length_389_cov_4.424138	68	148	74	3	80	0.0375000
NODE_83663_length_389_cov_4.424138	68	148	75	5	80	0.0625000
NODE_83663_length_389_cov_4.424138	68	148	76	5	80	0.0625000
NODE_83663_length_389_cov_4.424138	68	148	77	1	80	0.0125000
NODE_83663_length_389_cov_4.424138	68	148	78	6	80	0.0750000
NODE_83663_length_389_cov_4.424138	68	148	80	27	80	0.3375000
NODE_83685_length_389_cov_3.782759	194	225	4	31	31	1.0000000
NODE_83689_length_389_cov_3.555172	107	153	0	14	46	0.3043478
NODE_83689_length_389_cov_3.555172	107	153	2	32	46	0.6956522
NODE_83695_length_389_cov_3.251724	120	163	0	43	43	1.0000000
NODE_83695_length_389_cov_3.251724	136	206	0	70	70	1.0000000
NODE_83816_length_389_cov_1.951724	68	148	0	66	80	0.8250000
NODE_83816_length_389_cov_1.951724	68	148	2	9	80	0.1125000
NODE_83816_length_389_cov_1.951724	68	148	3	5	80	0.0625000
NODE_83819_length_389_cov_1.937931	53	82	0	29	29	1.0000000
NODE_83819_length_389_cov_1.937931	153	233	16	2	80	0.0250000
NODE_83819_length_389_cov_1.937931	153	233	18	29	80	0.3625000
NODE_83819_length_389_cov_1.937931	153	233	20	21	80	0.2625000
NODE_83819_length_389_cov_1.937931	153	233	22	28	80	0.3500000
NODE_83829_length_389_cov_1.920690	296	365	4	69	69	1.0000000
NODE_84182_length_389_cov_0.720690	294	374	0	4	80	0.0500000
NODE_84182_length_389_cov_0.720690	294	374	2	76	80	0.9500000
NODE_84267_length_388_cov_9.179931	47	127	0	80	80	1.0000000
NODE_84267_length_388_cov_9.179931	100	180	0	80	80	1.0000000
NODE_84270_length_388_cov_7.249135	171	251	0	8	80	0.1000000
NODE_84270_length_388_cov_7.249135	171	251	2	33	80	0.4125000
NODE_84270_length_388_cov_7.249135	171	251	4	1	80	0.0125000
NODE_84270_length_388_cov_7.249135	171	251	6	38	80	0.4750000
NODE_84270_length_388_cov_7.249135	224	304	4	54	80	0.6750000
NODE_84270_length_388_cov_7.249135	224	304	6	26	80	0.3250000
NODE_84305_length_388_cov_3.913495	151	231	0	77	80	0.9625000
NODE_84305_length_388_cov_3.913495	151	231	2	3	80	0.0375000
NODE_84308_length_388_cov_3.809689	233	277	0	4	44	0.0909091
NODE_84308_length_388_cov_3.809689	233	277	2	1	44	0.0227273
NODE_84308_length_388_cov_3.809689	233	277	4	18	44	0.4090909
NODE_84308_length_388_cov_3.809689	233	277	6	21	44	0.4772727
NODE_84332_length_388_cov_3.103806	101	166	0	30	65	0.4615385
NODE_84332_length_388_cov_3.103806	101	166	1	17	65	0.2615385
NODE_84332_length_388_cov_3.103806	101	166	2	18	65	0.2769231
NODE_84332_length_388_cov_3.103806	147	227	0	80	80	1.0000000
NODE_84334_length_388_cov_3.041522	48	128	0	80	80	1.0000000
NODE_84410_length_388_cov_2.114187	82	141	0	43	59	0.7288136
NODE_84410_length_388_cov_2.114187	82	141	2	1	59	0.0169492
NODE_84410_length_388_cov_2.114187	82	141	4	15	59	0.2542373
NODE_84410_length_388_cov_2.114187	135	194	0	59	59	1.0000000
NODE_84423_length_388_cov_2.017301	99	151	0	52	52	1.0000000
NODE_84427_length_388_cov_1.989619	0	76	0	11	76	0.1447368
NODE_84427_length_388_cov_1.989619	0	76	2	65	76	0.8552632
NODE_84427_length_388_cov_1.989619	49	114	0	37	65	0.5692308
NODE_84427_length_388_cov_1.989619	49	114	2	28	65	0.4307692
NODE_84587_length_388_cov_1.352941	172	247	0	73	75	0.9733334
NODE_84587_length_388_cov_1.352941	172	247	2	2	75	0.0266667
NODE_84631_length_388_cov_1.228374	308	339	0	31	31	1.0000000
NODE_84885_length_387_cov_33.052083	194	274	0	15	80	0.1875000
NODE_84885_length_387_cov_33.052083	194	274	4	65	80	0.8125000
NODE_84885_length_387_cov_33.052083	247	327	2	39	80	0.4875000
NODE_84885_length_387_cov_33.052083	247	327	4	41	80	0.5125000
NODE_84890_length_387_cov_6.871528	26	106	0	34	80	0.4250000
NODE_84890_length_387_cov_6.871528	26	106	2	46	80	0.5750000
NODE_84890_length_387_cov_6.871528	79	159	2	39	80	0.4875000
NODE_84890_length_387_cov_6.871528	79	159	4	41	80	0.5125000
NODE_84902_length_387_cov_5.420139	286	341	1	39	55	0.7090909
NODE_84902_length_387_cov_5.420139	286	341	2	16	55	0.2909091
NODE_84946_length_387_cov_3.364583	287	367	0	80	80	1.0000000
NODE_85007_length_387_cov_2.260417	140	210	9	66	70	0.9428571
NODE_85007_length_387_cov_2.260417	140	210	10	4	70	0.0571429
NODE_85019_length_387_cov_2.128472	220	286	0	66	66	1.0000000
NODE_85019_length_387_cov_2.128472	273	329	0	56	56	1.0000000
NODE_85032_length_387_cov_2.090278	318	352	0	1	34	0.0294118
NODE_85032_length_387_cov_2.090278	318	352	2	19	34	0.5588235
NODE_85032_length_387_cov_2.090278	318	352	4	14	34	0.4117647
NODE_85037_length_387_cov_2.055556	23	45	0	22	22	1.0000000
NODE_85047_length_387_cov_1.979167	259	316	0	57	57	1.0000000
NODE_85047_length_387_cov_1.979167	312	369	0	57	57	1.0000000
NODE_85091_length_387_cov_1.770833	315	361	0	18	46	0.3913043
NODE_85091_length_387_cov_1.770833	315	361	2	2	46	0.0434783
NODE_85091_length_387_cov_1.770833	315	361	4	3	46	0.0652174
NODE_85091_length_387_cov_1.770833	315	361	8	7	46	0.1521739
NODE_85091_length_387_cov_1.770833	315	361	13	1	46	0.0217391
NODE_85091_length_387_cov_1.770833	315	361	14	15	46	0.3260870
NODE_85528_length_386_cov_9.979094	38	118	0	80	80	1.0000000
NODE_85528_length_386_cov_9.979094	91	174	0	83	83	1.0000000
NODE_85546_length_386_cov_4.428571	197	249	0	52	52	1.0000000
NODE_85570_length_386_cov_3.355401	151	231	0	41	80	0.5125000
NODE_85570_length_386_cov_3.355401	151	231	2	39	80	0.4875000
NODE_85570_length_386_cov_3.355401	204	265	2	61	61	1.0000000
NODE_85602_length_386_cov_2.686411	293	325	2	32	32	1.0000000
NODE_85602_length_386_cov_2.686411	349	379	0	30	30	1.0000000
NODE_85629_length_386_cov_2.442509	55	135	0	80	80	1.0000000
NODE_85629_length_386_cov_2.442509	108	164	0	56	56	1.0000000
NODE_85793_length_386_cov_1.494774	79	121	0	42	42	1.0000000
NODE_85793_length_386_cov_1.494774	93	156	0	63	63	1.0000000
NODE_85816_length_386_cov_1.421603	160	236	0	76	76	1.0000000
NODE_85845_length_386_cov_1.372822	62	142	0	46	80	0.5750000
NODE_85845_length_386_cov_1.372822	62	142	1	14	80	0.1750000
NODE_85845_length_386_cov_1.372822	62	142	2	20	80	0.2500000
NODE_85845_length_386_cov_1.372822	115	195	1	7	80	0.0875000
NODE_85845_length_386_cov_1.372822	115	195	2	73	80	0.9125000
NODE_85858_length_386_cov_1.317073	124	161	14	8	37	0.2162162
NODE_85858_length_386_cov_1.317073	124	161	16	7	37	0.1891892
NODE_85858_length_386_cov_1.317073	124	161	18	8	37	0.2162162
NODE_85858_length_386_cov_1.317073	124	161	19	2	37	0.0540541
NODE_85858_length_386_cov_1.317073	124	161	20	12	37	0.3243243
NODE_85902_length_386_cov_1.170732	260	308	4	1	48	0.0208333
NODE_85902_length_386_cov_1.170732	260	308	7	1	48	0.0208333
NODE_85902_length_386_cov_1.170732	260	308	8	1	48	0.0208333
NODE_85902_length_386_cov_1.170732	260	308	10	12	48	0.2500000
NODE_85902_length_386_cov_1.170732	260	308	14	3	48	0.0625000
NODE_85902_length_386_cov_1.170732	260	308	18	3	48	0.0625000
NODE_85902_length_386_cov_1.170732	260	308	22	12	48	0.2500000
NODE_85902_length_386_cov_1.170732	260	308	24	5	48	0.1041667
NODE_85902_length_386_cov_1.170732	260	308	26	10	48	0.2083333
NODE_86143_length_385_cov_167.877622	103	164	401	1	61	0.0163934
NODE_86143_length_385_cov_167.877622	103	164	410	1	61	0.0163934
NODE_86143_length_385_cov_167.877622	103	164	416	1	61	0.0163934
NODE_86143_length_385_cov_167.877622	103	164	427	1	61	0.0163934
NODE_86143_length_385_cov_167.877622	103	164	431	1	61	0.0163934
NODE_86143_length_385_cov_167.877622	103	164	434	1	61	0.0163934
NODE_86143_length_385_cov_167.877622	103	164	438	2	61	0.0327869
NODE_86143_length_385_cov_167.877622	103	164	439	1	61	0.0163934
NODE_86143_length_385_cov_167.877622	103	164	441	1	61	0.0163934
NODE_86143_length_385_cov_167.877622	103	164	442	1	61	0.0163934
NODE_86143_length_385_cov_167.877622	103	164	444	1	61	0.0163934
NODE_86143_length_385_cov_167.877622	103	164	446	3	61	0.0491803
NODE_86143_length_385_cov_167.877622	103	164	447	4	61	0.0655738
NODE_86143_length_385_cov_167.877622	103	164	448	1	61	0.0163934
NODE_86143_length_385_cov_167.877622	103	164	452	1	61	0.0163934
NODE_86143_length_385_cov_167.877622	103	164	453	1	61	0.0163934
NODE_86143_length_385_cov_167.877622	103	164	463	1	61	0.0163934
NODE_86143_length_385_cov_167.877622	103	164	474	1	61	0.0163934
NODE_86143_length_385_cov_167.877622	103	164	475	2	61	0.0327869
NODE_86143_length_385_cov_167.877622	103	164	477	1	61	0.0163934
NODE_86143_length_385_cov_167.877622	103	164	479	1	61	0.0163934
NODE_86143_length_385_cov_167.877622	103	164	489	1	61	0.0163934
NODE_86143_length_385_cov_167.877622	103	164	491	1	61	0.0163934
NODE_86143_length_385_cov_167.877622	103	164	493	2	61	0.0327869
NODE_86143_length_385_cov_167.877622	103	164	495	2	61	0.0327869
NODE_86143_length_385_cov_167.877622	103	164	497	2	61	0.0327869
NODE_86143_length_385_cov_167.877622	103	164	498	3	61	0.0491803
NODE_86143_length_385_cov_167.877622	103	164	499	1	61	0.0163934
NODE_86143_length_385_cov_167.877622	103	164	512	1	61	0.0163934
NODE_86143_length_385_cov_167.877622	103	164	513	1	61	0.0163934
NODE_86143_length_385_cov_167.877622	103	164	520	1	61	0.0163934
NODE_86143_length_385_cov_167.877622	103	164	532	1	61	0.0163934
NODE_86143_length_385_cov_167.877622	103	164	548	2	61	0.0327869
NODE_86143_length_385_cov_167.877622	103	164	552	1	61	0.0163934
NODE_86143_length_385_cov_167.877622	103	164	553	1	61	0.0163934
NODE_86143_length_385_cov_167.877622	103	164	557	2	61	0.0327869
NODE_86143_length_385_cov_167.877622	103	164	559	5	61	0.0819672
NODE_86143_length_385_cov_167.877622	103	164	560	1	61	0.0163934
NODE_86143_length_385_cov_167.877622	103	164	562	1	61	0.0163934
NODE_86143_length_385_cov_167.877622	103	164	563	2	61	0.0327869
NODE_86143_length_385_cov_167.877622	103	164	567	1	61	0.0163934
NODE_86143_length_385_cov_167.877622	103	164	569	1	61	0.0163934
NODE_86144_length_385_cov_38.695804	164	244	0	80	80	1.0000000
NODE_86144_length_385_cov_38.695804	217	297	0	80	80	1.0000000
NODE_86169_length_385_cov_4.335664	173	250	0	60	77	0.7792208
NODE_86169_length_385_cov_4.335664	173	250	2	17	77	0.2207792
NODE_86185_length_385_cov_3.793706	215	297	0	63	82	0.7682927
NODE_86185_length_385_cov_3.793706	215	297	2	13	82	0.1585366
NODE_86185_length_385_cov_3.793706	215	297	4	6	82	0.0731707
NODE_86230_length_385_cov_2.786713	99	179	2	30	80	0.3750000
NODE_86230_length_385_cov_2.786713	99	179	4	17	80	0.2125000
NODE_86230_length_385_cov_2.786713	99	179	8	22	80	0.2750000
NODE_86230_length_385_cov_2.786713	99	179	10	11	80	0.1375000
NODE_86230_length_385_cov_2.786713	152	232	0	22	80	0.2750000
NODE_86230_length_385_cov_2.786713	152	232	2	58	80	0.7250000
NODE_86230_length_385_cov_2.786713	281	362	0	81	81	1.0000000
NODE_86448_length_385_cov_1.381119	71	145	0	25	74	0.3378378
NODE_86448_length_385_cov_1.381119	71	145	8	11	74	0.1486486
NODE_86448_length_385_cov_1.381119	71	145	10	5	74	0.0675676
NODE_86448_length_385_cov_1.381119	71	145	16	24	74	0.3243243
NODE_86448_length_385_cov_1.381119	71	145	18	9	74	0.1216216
NODE_86448_length_385_cov_1.381119	118	198	14	14	80	0.1750000
NODE_86448_length_385_cov_1.381119	118	198	16	19	80	0.2375000
NODE_86448_length_385_cov_1.381119	118	198	18	16	80	0.2000000
NODE_86448_length_385_cov_1.381119	118	198	20	9	80	0.1125000
NODE_86448_length_385_cov_1.381119	118	198	22	22	80	0.2750000
NODE_86798_length_384_cov_3.996491	135	217	0	82	82	1.0000000
NODE_86809_length_384_cov_3.729825	181	228	0	47	47	1.0000000
NODE_86812_length_384_cov_3.715789	145	221	0	68	76	0.8947368
NODE_86812_length_384_cov_3.715789	145	221	2	3	76	0.0394737
NODE_86812_length_384_cov_3.715789	145	221	4	5	76	0.0657895
NODE_86841_length_384_cov_2.996491	147	227	4	4	80	0.0500000
NODE_86841_length_384_cov_2.996491	147	227	6	33	80	0.4125000
NODE_86841_length_384_cov_2.996491	147	227	7	1	80	0.0125000
NODE_86841_length_384_cov_2.996491	147	227	8	14	80	0.1750000
NODE_86841_length_384_cov_2.996491	147	227	10	6	80	0.0750000
NODE_86841_length_384_cov_2.996491	147	227	12	20	80	0.2500000
NODE_86841_length_384_cov_2.996491	147	227	14	2	80	0.0250000
NODE_86847_length_384_cov_2.835088	65	145	18	3	80	0.0375000
NODE_86847_length_384_cov_2.835088	65	145	20	14	80	0.1750000
NODE_86847_length_384_cov_2.835088	65	145	21	1	80	0.0125000
NODE_86847_length_384_cov_2.835088	65	145	22	20	80	0.2500000
NODE_86847_length_384_cov_2.835088	65	145	24	4	80	0.0500000
NODE_86847_length_384_cov_2.835088	65	145	26	38	80	0.4750000
NODE_86866_length_384_cov_2.575439	151	224	30	5	73	0.0684932
NODE_86866_length_384_cov_2.575439	151	224	32	9	73	0.1232877
NODE_86866_length_384_cov_2.575439	151	224	34	6	73	0.0821918
NODE_86866_length_384_cov_2.575439	151	224	36	24	73	0.3287671
NODE_86866_length_384_cov_2.575439	151	224	38	29	73	0.3972603
NODE_86866_length_384_cov_2.575439	197	281	0	3	84	0.0357143
NODE_86866_length_384_cov_2.575439	197	281	2	9	84	0.1071429
NODE_86866_length_384_cov_2.575439	197	281	4	1	84	0.0119048
NODE_86866_length_384_cov_2.575439	197	281	8	18	84	0.2142857
NODE_86866_length_384_cov_2.575439	197	281	10	1	84	0.0119048
NODE_86866_length_384_cov_2.575439	197	281	12	12	84	0.1428571
NODE_86866_length_384_cov_2.575439	197	281	14	1	84	0.0119048
NODE_86866_length_384_cov_2.575439	197	281	16	1	84	0.0119048
NODE_86866_length_384_cov_2.575439	197	281	18	5	84	0.0595238
NODE_86866_length_384_cov_2.575439	197	281	20	4	84	0.0476190
NODE_86866_length_384_cov_2.575439	197	281	24	1	84	0.0119048
NODE_86866_length_384_cov_2.575439	197	281	30	6	84	0.0714286
NODE_86866_length_384_cov_2.575439	197	281	32	3	84	0.0357143
NODE_86866_length_384_cov_2.575439	197	281	34	4	84	0.0476190
NODE_86866_length_384_cov_2.575439	197	281	36	15	84	0.1785714
NODE_86907_length_384_cov_2.231579	78	153	0	75	75	1.0000000
NODE_86942_length_384_cov_1.940351	73	153	0	80	80	1.0000000
NODE_87431_length_383_cov_4.869718	117	197	0	80	80	1.0000000
NODE_87431_length_383_cov_4.869718	170	250	0	80	80	1.0000000
NODE_87432_length_383_cov_4.841549	121	180	0	59	59	1.0000000
NODE_87438_length_383_cov_4.559859	33	109	0	76	76	1.0000000
NODE_87487_length_383_cov_2.940141	185	265	0	42	80	0.5250000
NODE_87487_length_383_cov_2.940141	185	265	2	38	80	0.4750000
NODE_87495_length_383_cov_2.760563	123	203	126	2	80	0.0250000
NODE_87495_length_383_cov_2.760563	123	203	132	1	80	0.0125000
NODE_87495_length_383_cov_2.760563	123	203	134	1	80	0.0125000
NODE_87495_length_383_cov_2.760563	123	203	140	3	80	0.0375000
NODE_87495_length_383_cov_2.760563	123	203	151	2	80	0.0250000
NODE_87495_length_383_cov_2.760563	123	203	153	1	80	0.0125000
NODE_87495_length_383_cov_2.760563	123	203	154	4	80	0.0500000
NODE_87495_length_383_cov_2.760563	123	203	155	5	80	0.0625000
NODE_87495_length_383_cov_2.760563	123	203	156	7	80	0.0875000
NODE_87495_length_383_cov_2.760563	123	203	158	3	80	0.0375000
NODE_87495_length_383_cov_2.760563	123	203	160	1	80	0.0125000
NODE_87495_length_383_cov_2.760563	123	203	161	1	80	0.0125000
NODE_87495_length_383_cov_2.760563	123	203	162	1	80	0.0125000
NODE_87495_length_383_cov_2.760563	123	203	165	1	80	0.0125000
NODE_87495_length_383_cov_2.760563	123	203	166	3	80	0.0375000
NODE_87495_length_383_cov_2.760563	123	203	167	1	80	0.0125000
NODE_87495_length_383_cov_2.760563	123	203	168	4	80	0.0500000
NODE_87495_length_383_cov_2.760563	123	203	169	3	80	0.0375000
NODE_87495_length_383_cov_2.760563	123	203	170	1	80	0.0125000
NODE_87495_length_383_cov_2.760563	123	203	171	1	80	0.0125000
NODE_87495_length_383_cov_2.760563	123	203	173	1	80	0.0125000
NODE_87495_length_383_cov_2.760563	123	203	177	5	80	0.0625000
NODE_87495_length_383_cov_2.760563	123	203	178	2	80	0.0250000
NODE_87495_length_383_cov_2.760563	123	203	179	4	80	0.0500000
NODE_87495_length_383_cov_2.760563	123	203	180	2	80	0.0250000
NODE_87495_length_383_cov_2.760563	123	203	181	4	80	0.0500000
NODE_87495_length_383_cov_2.760563	123	203	183	1	80	0.0125000
NODE_87495_length_383_cov_2.760563	123	203	184	7	80	0.0875000
NODE_87495_length_383_cov_2.760563	123	203	189	7	80	0.0875000
NODE_87495_length_383_cov_2.760563	123	203	191	1	80	0.0125000
NODE_87495_length_383_cov_2.760563	169	249	36	2	80	0.0250000
NODE_87495_length_383_cov_2.760563	169	249	41	2	80	0.0250000
NODE_87495_length_383_cov_2.760563	169	249	46	1	80	0.0125000
NODE_87495_length_383_cov_2.760563	169	249	47	1	80	0.0125000
NODE_87495_length_383_cov_2.760563	169	249	49	1	80	0.0125000
NODE_87495_length_383_cov_2.760563	169	249	56	2	80	0.0250000
NODE_87495_length_383_cov_2.760563	169	249	62	5	80	0.0625000
NODE_87495_length_383_cov_2.760563	169	249	64	2	80	0.0250000
NODE_87495_length_383_cov_2.760563	169	249	66	2	80	0.0250000
NODE_87495_length_383_cov_2.760563	169	249	68	1	80	0.0125000
NODE_87495_length_383_cov_2.760563	169	249	71	1	80	0.0125000
NODE_87495_length_383_cov_2.760563	169	249	73	4	80	0.0500000
NODE_87495_length_383_cov_2.760563	169	249	75	1	80	0.0125000
NODE_87495_length_383_cov_2.760563	169	249	81	1	80	0.0125000
NODE_87495_length_383_cov_2.760563	169	249	89	4	80	0.0500000
NODE_87495_length_383_cov_2.760563	169	249	95	3	80	0.0375000
NODE_87495_length_383_cov_2.760563	169	249	100	3	80	0.0375000
NODE_87495_length_383_cov_2.760563	169	249	101	1	80	0.0125000
NODE_87495_length_383_cov_2.760563	169	249	103	2	80	0.0250000
NODE_87495_length_383_cov_2.760563	169	249	105	1	80	0.0125000
NODE_87495_length_383_cov_2.760563	169	249	107	2	80	0.0250000
NODE_87495_length_383_cov_2.760563	169	249	113	2	80	0.0250000
NODE_87495_length_383_cov_2.760563	169	249	116	1	80	0.0125000
NODE_87495_length_383_cov_2.760563	169	249	124	1	80	0.0125000
NODE_87495_length_383_cov_2.760563	169	249	126	2	80	0.0250000
NODE_87495_length_383_cov_2.760563	169	249	132	1	80	0.0125000
NODE_87495_length_383_cov_2.760563	169	249	134	1	80	0.0125000
NODE_87495_length_383_cov_2.760563	169	249	140	3	80	0.0375000
NODE_87495_length_383_cov_2.760563	169	249	151	2	80	0.0250000
NODE_87495_length_383_cov_2.760563	169	249	153	1	80	0.0125000
NODE_87495_length_383_cov_2.760563	169	249	155	5	80	0.0625000
NODE_87495_length_383_cov_2.760563	169	249	161	1	80	0.0125000
NODE_87495_length_383_cov_2.760563	169	249	165	1	80	0.0125000
NODE_87495_length_383_cov_2.760563	169	249	167	1	80	0.0125000
NODE_87495_length_383_cov_2.760563	169	249	169	3	80	0.0375000
NODE_87495_length_383_cov_2.760563	169	249	171	1	80	0.0125000
NODE_87495_length_383_cov_2.760563	169	249	173	1	80	0.0125000
NODE_87495_length_383_cov_2.760563	169	249	177	3	80	0.0375000
NODE_87495_length_383_cov_2.760563	169	249	179	2	80	0.0250000
NODE_87495_length_383_cov_2.760563	169	249	181	4	80	0.0500000
NODE_87495_length_383_cov_2.760563	169	249	189	2	80	0.0250000
NODE_87495_length_383_cov_2.760563	222	302	6	25	80	0.3125000
NODE_87495_length_383_cov_2.760563	222	302	8	5	80	0.0625000
NODE_87495_length_383_cov_2.760563	222	302	10	2	80	0.0250000
NODE_87495_length_383_cov_2.760563	222	302	11	4	80	0.0500000
NODE_87495_length_383_cov_2.760563	222	302	15	3	80	0.0375000
NODE_87495_length_383_cov_2.760563	222	302	17	1	80	0.0125000
NODE_87495_length_383_cov_2.760563	222	302	23	2	80	0.0250000
NODE_87495_length_383_cov_2.760563	222	302	25	3	80	0.0375000
NODE_87495_length_383_cov_2.760563	222	302	27	2	80	0.0250000
NODE_87495_length_383_cov_2.760563	222	302	30	3	80	0.0375000
NODE_87495_length_383_cov_2.760563	222	302	32	3	80	0.0375000
NODE_87495_length_383_cov_2.760563	222	302	36	2	80	0.0250000
NODE_87495_length_383_cov_2.760563	222	302	41	2	80	0.0250000
NODE_87495_length_383_cov_2.760563	222	302	46	1	80	0.0125000
NODE_87495_length_383_cov_2.760563	222	302	47	1	80	0.0125000
NODE_87495_length_383_cov_2.760563	222	302	49	1	80	0.0125000
NODE_87495_length_383_cov_2.760563	222	302	56	2	80	0.0250000
NODE_87495_length_383_cov_2.760563	222	302	62	5	80	0.0625000
NODE_87495_length_383_cov_2.760563	222	302	64	2	80	0.0250000
NODE_87495_length_383_cov_2.760563	222	302	66	2	80	0.0250000
NODE_87495_length_383_cov_2.760563	222	302	68	1	80	0.0125000
NODE_87495_length_383_cov_2.760563	222	302	71	1	80	0.0125000
NODE_87495_length_383_cov_2.760563	222	302	73	4	80	0.0500000
NODE_87495_length_383_cov_2.760563	222	302	75	1	80	0.0125000
NODE_87495_length_383_cov_2.760563	222	302	81	1	80	0.0125000
NODE_87495_length_383_cov_2.760563	222	302	89	1	80	0.0125000
NODE_87566_length_383_cov_2.123239	29	94	2	1	65	0.0153846
NODE_87566_length_383_cov_2.123239	29	94	4	64	65	0.9846154
NODE_87566_length_383_cov_2.123239	93	173	0	53	80	0.6625000
NODE_87566_length_383_cov_2.123239	93	173	2	27	80	0.3375000
NODE_87566_length_383_cov_2.123239	146	193	0	47	47	1.0000000
NODE_87634_length_383_cov_1.728873	196	257	13	2	61	0.0327869
NODE_87634_length_383_cov_1.728873	196	257	14	3	61	0.0491803
NODE_87634_length_383_cov_1.728873	196	257	19	1	61	0.0163934
NODE_87634_length_383_cov_1.728873	196	257	22	1	61	0.0163934
NODE_87634_length_383_cov_1.728873	196	257	29	1	61	0.0163934
NODE_87634_length_383_cov_1.728873	196	257	30	1	61	0.0163934
NODE_87634_length_383_cov_1.728873	196	257	32	4	61	0.0655738
NODE_87634_length_383_cov_1.728873	196	257	34	5	61	0.0819672
NODE_87634_length_383_cov_1.728873	196	257	36	4	61	0.0655738
NODE_87634_length_383_cov_1.728873	196	257	40	2	61	0.0327869
NODE_87634_length_383_cov_1.728873	196	257	44	12	61	0.1967213
NODE_87634_length_383_cov_1.728873	196	257	46	6	61	0.0983607
NODE_87634_length_383_cov_1.728873	196	257	48	14	61	0.2295082
NODE_87634_length_383_cov_1.728873	196	257	50	5	61	0.0819672
NODE_87634_length_383_cov_1.728873	239	310	27	7	71	0.0985916
NODE_87634_length_383_cov_1.728873	239	310	29	2	71	0.0281690
NODE_87634_length_383_cov_1.728873	239	310	31	11	71	0.1549296
NODE_87634_length_383_cov_1.728873	239	310	34	3	71	0.0422535
NODE_87634_length_383_cov_1.728873	239	310	36	6	71	0.0845070
NODE_87634_length_383_cov_1.728873	239	310	38	11	71	0.1549296
NODE_87634_length_383_cov_1.728873	239	310	42	2	71	0.0281690
NODE_87634_length_383_cov_1.728873	239	310	46	16	71	0.2253521
NODE_87634_length_383_cov_1.728873	239	310	48	12	71	0.1690141
NODE_87634_length_383_cov_1.728873	239	310	50	1	71	0.0140845
NODE_88039_length_382_cov_43.724382	245	325	0	44	80	0.5500000
NODE_88039_length_382_cov_43.724382	245	325	2	36	80	0.4500000
NODE_88039_length_382_cov_43.724382	298	378	0	80	80	1.0000000
NODE_88040_length_382_cov_35.908127	163	243	0	80	80	1.0000000
NODE_88040_length_382_cov_35.908127	216	296	0	80	80	1.0000000
NODE_88040_length_382_cov_35.908127	292	372	0	80	80	1.0000000
NODE_88041_length_382_cov_26.240283	57	137	0	17	80	0.2125000
NODE_88041_length_382_cov_26.240283	57	137	4	49	80	0.6125000
NODE_88041_length_382_cov_26.240283	57	137	6	14	80	0.1750000
NODE_88041_length_382_cov_26.240283	110	190	2	29	80	0.3625000
NODE_88041_length_382_cov_26.240283	110	190	4	13	80	0.1625000
NODE_88041_length_382_cov_26.240283	110	190	6	38	80	0.4750000
NODE_88054_length_382_cov_5.583039	63	143	0	80	80	1.0000000
NODE_88054_length_382_cov_5.583039	116	196	0	80	80	1.0000000
NODE_88063_length_382_cov_4.837456	19	78	0	59	59	1.0000000
NODE_88067_length_382_cov_4.618375	0	55	0	55	55	1.0000000
NODE_88067_length_382_cov_4.618375	104	184	2	17	80	0.2125000
NODE_88067_length_382_cov_4.618375	104	184	4	42	80	0.5250000
NODE_88067_length_382_cov_4.618375	104	184	6	8	80	0.1000000
NODE_88067_length_382_cov_4.618375	104	184	8	13	80	0.1625000
NODE_88067_length_382_cov_4.618375	157	237	2	2	80	0.0250000
NODE_88067_length_382_cov_4.618375	157	237	4	16	80	0.2000000
NODE_88067_length_382_cov_4.618375	157	237	6	28	80	0.3500000
NODE_88067_length_382_cov_4.618375	157	237	8	34	80	0.4250000
NODE_88075_length_382_cov_4.268551	71	152	0	54	81	0.6666667
NODE_88075_length_382_cov_4.268551	71	152	2	27	81	0.3333333
NODE_88075_length_382_cov_4.268551	124	205	0	1	81	0.0123457
NODE_88075_length_382_cov_4.268551	124	205	2	80	81	0.9876543
NODE_88080_length_382_cov_4.091873	30	92	0	62	62	1.0000000
NODE_88121_length_382_cov_3.031802	173	253	0	32	80	0.4000000
NODE_88121_length_382_cov_3.031802	173	253	2	17	80	0.2125000
NODE_88121_length_382_cov_3.031802	173	253	6	16	80	0.2000000
NODE_88121_length_382_cov_3.031802	173	253	8	15	80	0.1875000
NODE_88121_length_382_cov_3.031802	226	295	6	12	69	0.1739130
NODE_88121_length_382_cov_3.031802	226	295	8	57	69	0.8260869
NODE_88135_length_382_cov_2.798587	231	293	0	62	62	1.0000000
NODE_88136_length_382_cov_2.791519	195	244	0	43	49	0.8775510
NODE_88136_length_382_cov_2.791519	195	244	6	6	49	0.1224490
NODE_88136_length_382_cov_2.791519	217	297	0	21	80	0.2625000
NODE_88136_length_382_cov_2.791519	217	297	6	59	80	0.7375000
NODE_88164_length_382_cov_2.611307	301	368	0	12	67	0.1791045
NODE_88164_length_382_cov_2.611307	301	368	2	55	67	0.8208955
NODE_88276_length_382_cov_1.802120	0	60	0	60	60	1.0000000
NODE_88660_length_382_cov_0.738516	48	95	12	47	47	1.0000000
NODE_88660_length_382_cov_0.738516	68	148	12	80	80	1.0000000
NODE_88758_length_381_cov_12.010638	195	274	0	2	79	0.0253165
NODE_88758_length_381_cov_12.010638	195	274	2	29	79	0.3670886
NODE_88758_length_381_cov_12.010638	195	274	4	48	79	0.6075949
NODE_88865_length_381_cov_2.606383	68	98	0	30	30	1.0000000
NODE_88867_length_381_cov_2.570922	115	175	2	10	60	0.1666667
NODE_88867_length_381_cov_2.570922	115	175	4	50	60	0.8333333
NODE_88872_length_381_cov_2.514184	225	307	0	82	82	1.0000000
NODE_88900_length_381_cov_2.198582	193	276	4	33	83	0.3975904
NODE_88900_length_381_cov_2.198582	193	276	6	8	83	0.0963855
NODE_88900_length_381_cov_2.198582	193	276	8	2	83	0.0240964
NODE_88900_length_381_cov_2.198582	193	276	10	40	83	0.4819277
NODE_88935_length_381_cov_1.989362	279	325	2	46	46	1.0000000
NODE_89009_length_381_cov_1.663121	51	128	2	25	77	0.3246753
NODE_89009_length_381_cov_1.663121	51	128	4	14	77	0.1818182
NODE_89009_length_381_cov_1.663121	51	128	6	38	77	0.4935065
NODE_89009_length_381_cov_1.663121	101	181	6	42	80	0.5250000
NODE_89009_length_381_cov_1.663121	101	181	8	38	80	0.4750000
NODE_89090_length_381_cov_1.400709	254	334	2	2	80	0.0250000
NODE_89090_length_381_cov_1.400709	254	334	4	16	80	0.2000000
NODE_89090_length_381_cov_1.400709	254	334	6	62	80	0.7750000
NODE_89090_length_381_cov_1.400709	254	334	2	2	80	0.0250000
NODE_89090_length_381_cov_1.400709	254	334	4	16	80	0.2000000
NODE_89090_length_381_cov_1.400709	254	334	6	62	80	0.7750000
NODE_89090_length_381_cov_1.400709	309	373	0	4	64	0.0625000
NODE_89090_length_381_cov_1.400709	309	373	2	20	64	0.3125000
NODE_89090_length_381_cov_1.400709	309	373	4	8	64	0.1250000
NODE_89090_length_381_cov_1.400709	309	373	6	32	64	0.5000000
NODE_89482_length_380_cov_57.604982	196	276	0	80	80	1.0000000
NODE_89482_length_380_cov_57.604982	249	329	0	80	80	1.0000000
NODE_89482_length_380_cov_57.604982	325	359	0	34	34	1.0000000
NODE_89483_length_380_cov_11.185053	79	161	2	31	82	0.3780488
NODE_89483_length_380_cov_11.185053	79	161	4	44	82	0.5365854
NODE_89483_length_380_cov_11.185053	79	161	5	6	82	0.0731707
NODE_89483_length_380_cov_11.185053	79	161	6	1	82	0.0121951
NODE_89483_length_380_cov_11.185053	134	214	0	22	80	0.2750000
NODE_89483_length_380_cov_11.185053	134	214	4	58	80	0.7250000
NODE_89491_length_380_cov_5.811388	100	156	0	8	56	0.1428571
NODE_89491_length_380_cov_5.811388	100	156	2	48	56	0.8571429
NODE_89491_length_380_cov_5.811388	177	213	0	16	36	0.4444444
NODE_89491_length_380_cov_5.811388	177	213	2	20	36	0.5555556
NODE_89495_length_380_cov_5.377224	242	271	53	6	29	0.2068966
NODE_89495_length_380_cov_5.377224	242	271	55	4	29	0.1379310
NODE_89495_length_380_cov_5.377224	242	271	56	9	29	0.3103448
NODE_89495_length_380_cov_5.377224	242	271	57	2	29	0.0689655
NODE_89495_length_380_cov_5.377224	242	271	58	8	29	0.2758621
NODE_89508_length_380_cov_4.185053	158	230	2	5	72	0.0694444
NODE_89508_length_380_cov_4.185053	158	230	4	46	72	0.6388889
NODE_89508_length_380_cov_4.185053	158	230	6	21	72	0.2916667
NODE_89508_length_380_cov_4.185053	159	229	2	3	70	0.0428571
NODE_89508_length_380_cov_4.185053	159	229	4	46	70	0.6571429
NODE_89508_length_380_cov_4.185053	159	229	6	21	70	0.3000000
NODE_89508_length_380_cov_4.185053	203	283	0	17	80	0.2125000
NODE_89508_length_380_cov_4.185053	203	283	2	37	80	0.4625000
NODE_89508_length_380_cov_4.185053	203	283	4	16	80	0.2000000
NODE_89508_length_380_cov_4.185053	203	283	6	10	80	0.1250000
NODE_89508_length_380_cov_4.185053	203	283	0	17	80	0.2125000
NODE_89508_length_380_cov_4.185053	203	283	2	37	80	0.4625000
NODE_89508_length_380_cov_4.185053	203	283	4	16	80	0.2000000
NODE_89508_length_380_cov_4.185053	203	283	6	10	80	0.1250000
NODE_89527_length_380_cov_3.423488	164	233	0	69	69	1.0000000
NODE_89540_length_380_cov_3.153025	188	260	2	72	72	1.0000000
NODE_89568_length_380_cov_2.718861	51	131	0	8	80	0.1000000
NODE_89568_length_380_cov_2.718861	51	131	1	30	80	0.3750000
NODE_89568_length_380_cov_2.718861	51	131	2	1	80	0.0125000
NODE_89568_length_380_cov_2.718861	51	131	3	5	80	0.0625000
NODE_89568_length_380_cov_2.718861	51	131	4	36	80	0.4500000
NODE_89568_length_380_cov_2.718861	104	184	0	61	80	0.7625000
NODE_89568_length_380_cov_2.718861	104	184	1	19	80	0.2375000
NODE_89658_length_380_cov_1.943060	22	56	0	10	34	0.2941177
NODE_89658_length_380_cov_1.943060	22	56	2	24	34	0.7058824
NODE_89750_length_380_cov_1.601423	292	332	13	8	40	0.2000000
NODE_89750_length_380_cov_1.601423	292	332	17	1	40	0.0250000
NODE_89750_length_380_cov_1.601423	292	332	19	2	40	0.0500000
NODE_89750_length_380_cov_1.601423	292	332	20	1	40	0.0250000
NODE_89750_length_380_cov_1.601423	292	332	24	1	40	0.0250000
NODE_89750_length_380_cov_1.601423	292	332	28	1	40	0.0250000
NODE_89750_length_380_cov_1.601423	292	332	29	2	40	0.0500000
NODE_89750_length_380_cov_1.601423	292	332	30	3	40	0.0750000
NODE_89750_length_380_cov_1.601423	292	332	33	1	40	0.0250000
NODE_89750_length_380_cov_1.601423	292	332	37	4	40	0.1000000
NODE_89750_length_380_cov_1.601423	292	332	39	1	40	0.0250000
NODE_89750_length_380_cov_1.601423	292	332	41	1	40	0.0250000
NODE_89750_length_380_cov_1.601423	292	332	43	2	40	0.0500000
NODE_89750_length_380_cov_1.601423	292	332	46	4	40	0.1000000
NODE_89750_length_380_cov_1.601423	292	332	48	1	40	0.0250000
NODE_89750_length_380_cov_1.601423	292	332	50	1	40	0.0250000
NODE_89750_length_380_cov_1.601423	292	332	52	1	40	0.0250000
NODE_89750_length_380_cov_1.601423	292	332	53	4	40	0.1000000
NODE_89750_length_380_cov_1.601423	292	332	55	1	40	0.0250000
NODE_89911_length_380_cov_1.088968	312	353	2	13	41	0.3170732
NODE_89911_length_380_cov_1.088968	312	353	8	28	41	0.6829268
NODE_89911_length_380_cov_1.088968	326	380	0	24	54	0.4444444
NODE_89911_length_380_cov_1.088968	326	380	2	16	54	0.2962963
NODE_89911_length_380_cov_1.088968	326	380	8	14	54	0.2592593
NODE_90152_length_379_cov_42.339286	10	90	0	80	80	1.0000000
NODE_90152_length_379_cov_42.339286	86	166	0	80	80	1.0000000
NODE_90152_length_379_cov_42.339286	139	219	0	80	80	1.0000000
NODE_90153_length_379_cov_32.075000	0	62	0	62	62	1.0000000
NODE_90165_length_379_cov_5.607143	279	338	0	59	59	1.0000000
NODE_90180_length_379_cov_4.432143	219	243	0	24	24	1.0000000
NODE_90193_length_379_cov_3.778571	271	300	0	16	29	0.5517241
NODE_90193_length_379_cov_3.778571	271	300	2	13	29	0.4482759
NODE_90198_length_379_cov_3.585714	128	152	0	24	24	1.0000000
NODE_90198_length_379_cov_3.585714	169	249	0	68	80	0.8500000
NODE_90198_length_379_cov_3.585714	169	249	2	12	80	0.1500000
NODE_90203_length_379_cov_3.375000	19	43	0	24	24	1.0000000
NODE_90247_length_379_cov_2.692857	121	201	8	3	80	0.0375000
NODE_90247_length_379_cov_2.692857	121	201	10	77	80	0.9625000
NODE_90247_length_379_cov_2.692857	174	221	6	1	47	0.0212766
NODE_90247_length_379_cov_2.692857	174	221	8	12	47	0.2553191
NODE_90247_length_379_cov_2.692857	174	221	10	34	47	0.7234042
NODE_90789_length_378_cov_53.039427	147	227	0	80	80	1.0000000
NODE_90789_length_378_cov_53.039427	200	280	0	80	80	1.0000000
NODE_90789_length_378_cov_53.039427	276	356	0	80	80	1.0000000
NODE_90789_length_378_cov_53.039427	329	378	0	49	49	1.0000000
NODE_90794_length_378_cov_6.569892	223	304	8	14	81	0.1728395
NODE_90794_length_378_cov_6.569892	223	304	10	23	81	0.2839506
NODE_90794_length_378_cov_6.569892	223	304	12	28	81	0.3456790
NODE_90794_length_378_cov_6.569892	223	304	14	16	81	0.1975309
NODE_90795_length_378_cov_6.444444	217	297	0	80	80	1.0000000
NODE_90795_length_378_cov_6.444444	270	350	0	80	80	1.0000000
NODE_90808_length_378_cov_4.899642	135	191	7	8	56	0.1428571
NODE_90808_length_378_cov_4.899642	135	191	8	48	56	0.8571429
NODE_90855_length_378_cov_3.236559	143	212	14	2	69	0.0289855
NODE_90855_length_378_cov_3.236559	143	212	16	2	69	0.0289855
NODE_90855_length_378_cov_3.236559	143	212	18	65	69	0.9420290
NODE_90859_length_378_cov_3.132616	238	280	0	42	42	1.0000000
NODE_90898_length_378_cov_2.534050	203	243	0	40	40	1.0000000
NODE_90898_length_378_cov_2.534050	271	347	0	76	76	1.0000000
NODE_90898_length_378_cov_2.534050	331	360	0	29	29	1.0000000
NODE_90948_length_378_cov_2.093190	179	250	0	71	71	1.0000000
NODE_90948_length_378_cov_2.093190	183	219	0	36	36	1.0000000
NODE_91002_length_378_cov_1.813620	36	89	0	49	53	0.9245283
NODE_91002_length_378_cov_1.813620	36	89	2	4	53	0.0754717
NODE_91475_length_377_cov_71.723022	19	99	0	80	80	1.0000000
NODE_91475_length_377_cov_71.723022	72	152	0	80	80	1.0000000
NODE_91475_length_377_cov_71.723022	148	228	0	80	80	1.0000000
NODE_91475_length_377_cov_71.723022	201	281	0	80	80	1.0000000
NODE_91477_length_377_cov_41.787770	210	290	3	13	80	0.1625000
NODE_91477_length_377_cov_41.787770	210	290	5	13	80	0.1625000
NODE_91477_length_377_cov_41.787770	210	290	6	3	80	0.0375000
NODE_91477_length_377_cov_41.787770	210	290	10	51	80	0.6375000
NODE_91477_length_377_cov_41.787770	263	343	0	44	80	0.5500000
NODE_91477_length_377_cov_41.787770	263	343	1	2	80	0.0250000
NODE_91477_length_377_cov_41.787770	263	343	3	20	80	0.2500000
NODE_91477_length_377_cov_41.787770	263	343	5	13	80	0.1625000
NODE_91477_length_377_cov_41.787770	263	343	6	1	80	0.0125000
NODE_91478_length_377_cov_9.982014	32	83	4	18	51	0.3529412
NODE_91478_length_377_cov_9.982014	32	83	6	11	51	0.2156863
NODE_91478_length_377_cov_9.982014	32	83	8	22	51	0.4313726
NODE_91486_length_377_cov_6.244604	101	177	0	16	76	0.2105263
NODE_91486_length_377_cov_6.244604	101	177	2	60	76	0.7894737
NODE_91494_length_377_cov_5.183453	169	224	0	55	55	1.0000000
NODE_91499_length_377_cov_4.586331	186	266	0	80	80	1.0000000
NODE_91499_length_377_cov_4.586331	239	319	0	80	80	1.0000000
NODE_91500_length_377_cov_4.431655	139	216	0	77	77	1.0000000
NODE_91502_length_377_cov_4.330935	134	214	0	80	80	1.0000000
NODE_91502_length_377_cov_4.330935	187	267	0	28	80	0.3500000
NODE_91502_length_377_cov_4.330935	187	267	4	52	80	0.6500000
NODE_91506_length_377_cov_4.032374	124	181	0	57	57	1.0000000
NODE_91506_length_377_cov_4.032374	154	201	0	47	47	1.0000000
NODE_91526_length_377_cov_3.615108	82	140	0	58	58	1.0000000
NODE_91526_length_377_cov_3.615108	82	140	0	58	58	1.0000000
NODE_91526_length_377_cov_3.615108	113	193	0	80	80	1.0000000
NODE_91526_length_377_cov_3.615108	113	193	0	80	80	1.0000000
NODE_91526_length_377_cov_3.615108	189	258	0	67	69	0.9710145
NODE_91526_length_377_cov_3.615108	189	258	2	2	69	0.0289855
NODE_91526_length_377_cov_3.615108	243	313	0	13	70	0.1857143
NODE_91526_length_377_cov_3.615108	243	313	2	57	70	0.8142857
NODE_91553_length_377_cov_2.913669	38	61	4	23	23	1.0000000
NODE_91553_length_377_cov_2.913669	167	228	0	61	61	1.0000000
NODE_91619_length_377_cov_2.104317	137	188	0	51	51	1.0000000
NODE_91619_length_377_cov_2.104317	168	211	0	43	43	1.0000000
NODE_91619_length_377_cov_2.104317	190	241	0	51	51	1.0000000
NODE_91727_length_377_cov_1.622302	123	181	0	47	58	0.8103448
NODE_91727_length_377_cov_1.622302	123	181	2	11	58	0.1896552
NODE_91727_length_377_cov_1.622302	176	234	0	58	58	1.0000000
NODE_91749_length_377_cov_1.539568	230	310	0	80	80	1.0000000
NODE_91749_length_377_cov_1.539568	230	310	0	80	80	1.0000000
NODE_91749_length_377_cov_1.539568	306	377	0	71	71	1.0000000
NODE_91749_length_377_cov_1.539568	327	351	0	24	24	1.0000000
NODE_91765_length_377_cov_1.471223	118	198	20	4	80	0.0500000
NODE_91765_length_377_cov_1.471223	118	198	22	3	80	0.0375000
NODE_91765_length_377_cov_1.471223	118	198	27	5	80	0.0625000
NODE_91765_length_377_cov_1.471223	118	198	28	19	80	0.2375000
NODE_91765_length_377_cov_1.471223	118	198	30	16	80	0.2000000
NODE_91765_length_377_cov_1.471223	118	198	32	16	80	0.2000000
NODE_91765_length_377_cov_1.471223	118	198	34	15	80	0.1875000
NODE_91765_length_377_cov_1.471223	118	198	36	2	80	0.0250000
NODE_91790_length_377_cov_1.456835	177	257	0	64	80	0.8000000
NODE_91790_length_377_cov_1.456835	177	257	2	16	80	0.2000000
NODE_91790_length_377_cov_1.456835	230	310	0	11	80	0.1375000
NODE_91790_length_377_cov_1.456835	230	310	2	69	80	0.8625000
NODE_91817_length_377_cov_1.330935	0	44	0	6	44	0.1363636
NODE_91817_length_377_cov_1.330935	0	44	4	33	44	0.7500000
NODE_91817_length_377_cov_1.330935	0	44	6	5	44	0.1136364
NODE_91817_length_377_cov_1.330935	45	117	2	43	72	0.5972222
NODE_91817_length_377_cov_1.330935	45	117	4	1	72	0.0138889
NODE_91817_length_377_cov_1.330935	45	117	6	28	72	0.3888889
NODE_92046_length_377_cov_0.762590	299	330	0	31	31	1.0000000
NODE_92166_length_376_cov_6.938628	0	63	16	3	63	0.0476190
NODE_92166_length_376_cov_6.938628	0	63	21	4	63	0.0634921
NODE_92166_length_376_cov_6.938628	0	63	22	4	63	0.0634921
NODE_92166_length_376_cov_6.938628	0	63	23	6	63	0.0952381
NODE_92166_length_376_cov_6.938628	0	63	32	1	63	0.0158730
NODE_92166_length_376_cov_6.938628	0	63	37	3	63	0.0476190
NODE_92166_length_376_cov_6.938628	0	63	41	1	63	0.0158730
NODE_92166_length_376_cov_6.938628	0	63	43	2	63	0.0317460
NODE_92166_length_376_cov_6.938628	0	63	44	11	63	0.1746032
NODE_92166_length_376_cov_6.938628	0	63	46	1	63	0.0158730
NODE_92166_length_376_cov_6.938628	0	63	47	1	63	0.0158730
NODE_92166_length_376_cov_6.938628	0	63	49	3	63	0.0476190
NODE_92166_length_376_cov_6.938628	0	63	51	7	63	0.1111111
NODE_92166_length_376_cov_6.938628	0	63	54	1	63	0.0158730
NODE_92166_length_376_cov_6.938628	0	63	64	1	63	0.0158730
NODE_92166_length_376_cov_6.938628	0	63	66	3	63	0.0476190
NODE_92166_length_376_cov_6.938628	0	63	68	1	63	0.0158730
NODE_92166_length_376_cov_6.938628	0	63	72	1	63	0.0158730
NODE_92166_length_376_cov_6.938628	0	63	74	1	63	0.0158730
NODE_92166_length_376_cov_6.938628	0	63	76	1	63	0.0158730
NODE_92166_length_376_cov_6.938628	0	63	78	1	63	0.0158730
NODE_92166_length_376_cov_6.938628	0	63	80	3	63	0.0476190
NODE_92166_length_376_cov_6.938628	0	63	86	3	63	0.0476190
NODE_92166_length_376_cov_6.938628	269	340	17	47	71	0.6619718
NODE_92166_length_376_cov_6.938628	269	340	18	20	71	0.2816902
NODE_92166_length_376_cov_6.938628	269	340	20	4	71	0.0563380
NODE_92168_length_376_cov_6.415162	177	257	0	80	80	1.0000000
NODE_92168_length_376_cov_6.415162	230	310	0	80	80	1.0000000
NODE_92173_length_376_cov_5.722022	100	171	10	5	71	0.0704225
NODE_92173_length_376_cov_5.722022	100	171	12	3	71	0.0422535
NODE_92173_length_376_cov_5.722022	100	171	14	5	71	0.0704225
NODE_92173_length_376_cov_5.722022	100	171	16	28	71	0.3943662
NODE_92173_length_376_cov_5.722022	100	171	18	29	71	0.4084507
NODE_92173_length_376_cov_5.722022	100	171	20	1	71	0.0140845
NODE_92173_length_376_cov_5.722022	155	192	8	13	37	0.3513514
NODE_92173_length_376_cov_5.722022	155	192	10	13	37	0.3513514
NODE_92173_length_376_cov_5.722022	155	192	18	10	37	0.2702703
NODE_92173_length_376_cov_5.722022	155	192	20	1	37	0.0270270
NODE_92191_length_376_cov_4.148014	300	330	0	1	30	0.0333333
NODE_92191_length_376_cov_4.148014	300	330	2	29	30	0.9666666
NODE_92196_length_376_cov_3.859206	168	236	8	68	68	1.0000000
NODE_92219_length_376_cov_3.140794	122	188	0	66	66	1.0000000
NODE_92442_length_376_cov_1.516245	57	106	6	49	49	1.0000000
NODE_92879_length_375_cov_4.217391	321	350	0	29	29	1.0000000
NODE_92897_length_375_cov_3.699275	287	367	0	80	80	1.0000000
NODE_92911_length_375_cov_3.376812	70	136	0	66	66	1.0000000
NODE_93031_length_375_cov_2.032609	162	224	0	2	62	0.0322581
NODE_93031_length_375_cov_2.032609	162	224	4	4	62	0.0645161
NODE_93031_length_375_cov_2.032609	162	224	6	4	62	0.0645161
NODE_93031_length_375_cov_2.032609	162	224	7	18	62	0.2903226
NODE_93031_length_375_cov_2.032609	162	224	11	19	62	0.3064516
NODE_93031_length_375_cov_2.032609	162	224	12	15	62	0.2419355
NODE_93031_length_375_cov_2.032609	215	272	11	27	57	0.4736842
NODE_93031_length_375_cov_2.032609	215	272	12	21	57	0.3684210
NODE_93031_length_375_cov_2.032609	215	272	13	9	57	0.1578947
NODE_93050_length_375_cov_1.967391	131	190	2	6	59	0.1016949
NODE_93050_length_375_cov_1.967391	131	190	3	3	59	0.0508475
NODE_93050_length_375_cov_1.967391	131	190	4	50	59	0.8474576
NODE_93050_length_375_cov_1.967391	184	235	2	26	51	0.5098040
NODE_93050_length_375_cov_1.967391	184	235	4	25	51	0.4901961
NODE_93081_length_375_cov_1.840580	195	276	0	81	81	1.0000000
NODE_93386_length_375_cov_1.000000	320	375	0	55	55	1.0000000
NODE_93609_length_374_cov_4.563636	93	160	0	67	67	1.0000000
NODE_93609_length_374_cov_4.563636	146	213	0	21	67	0.3134328
NODE_93609_length_374_cov_4.563636	146	213	2	26	67	0.3880597
NODE_93609_length_374_cov_4.563636	146	213	4	13	67	0.1940299
NODE_93609_length_374_cov_4.563636	146	213	6	7	67	0.1044776
NODE_93612_length_374_cov_4.523636	23	101	0	78	78	1.0000000
NODE_93612_length_374_cov_4.523636	81	154	0	73	73	1.0000000
NODE_93628_length_374_cov_3.810909	130	189	2	2	59	0.0338983
NODE_93628_length_374_cov_3.810909	130	189	4	5	59	0.0847458
NODE_93628_length_374_cov_3.810909	130	189	6	1	59	0.0169492
NODE_93628_length_374_cov_3.810909	130	189	8	2	59	0.0338983
NODE_93628_length_374_cov_3.810909	130	189	10	1	59	0.0169492
NODE_93628_length_374_cov_3.810909	130	189	14	1	59	0.0169492
NODE_93628_length_374_cov_3.810909	130	189	19	3	59	0.0508475
NODE_93628_length_374_cov_3.810909	130	189	21	3	59	0.0508475
NODE_93628_length_374_cov_3.810909	130	189	23	3	59	0.0508475
NODE_93628_length_374_cov_3.810909	130	189	24	11	59	0.1864407
NODE_93628_length_374_cov_3.810909	130	189	28	16	59	0.2711864
NODE_93628_length_374_cov_3.810909	130	189	32	11	59	0.1864407
NODE_93628_length_374_cov_3.810909	162	242	16	8	80	0.1000000
NODE_93628_length_374_cov_3.810909	162	242	20	1	80	0.0125000
NODE_93628_length_374_cov_3.810909	162	242	24	9	80	0.1125000
NODE_93628_length_374_cov_3.810909	162	242	26	1	80	0.0125000
NODE_93628_length_374_cov_3.810909	162	242	28	23	80	0.2875000
NODE_93628_length_374_cov_3.810909	162	242	30	7	80	0.0875000
NODE_93628_length_374_cov_3.810909	162	242	32	31	80	0.3875000
NODE_93630_length_374_cov_3.789091	236	271	4	13	35	0.3714286
NODE_93630_length_374_cov_3.789091	236	271	5	1	35	0.0285714
NODE_93630_length_374_cov_3.789091	236	271	6	21	35	0.6000000
NODE_93630_length_374_cov_3.789091	238	280	4	22	42	0.5238096
NODE_93630_length_374_cov_3.789091	238	280	5	1	42	0.0238095
NODE_93630_length_374_cov_3.789091	238	280	6	19	42	0.4523810
NODE_93637_length_374_cov_3.458182	190	248	4	16	58	0.2758621
NODE_93637_length_374_cov_3.458182	190	248	6	42	58	0.7241379
NODE_93688_length_374_cov_2.600000	142	217	2	1	75	0.0133333
NODE_93688_length_374_cov_2.600000	142	217	8	9	75	0.1200000
NODE_93688_length_374_cov_2.600000	142	217	12	53	75	0.7066666
NODE_93688_length_374_cov_2.600000	142	217	14	12	75	0.1600000
NODE_93688_length_374_cov_2.600000	190	270	12	15	80	0.1875000
NODE_93688_length_374_cov_2.600000	190	270	13	11	80	0.1375000
NODE_93688_length_374_cov_2.600000	190	270	14	41	80	0.5125000
NODE_93688_length_374_cov_2.600000	190	270	16	13	80	0.1625000
NODE_93718_length_374_cov_2.330909	40	120	0	20	80	0.2500000
NODE_93718_length_374_cov_2.330909	40	120	2	60	80	0.7500000
NODE_93769_length_374_cov_2.010909	40	105	0	65	65	1.0000000
NODE_93821_length_374_cov_1.796364	254	288	0	34	34	1.0000000
NODE_93852_length_374_cov_1.661818	95	157	2	35	62	0.5645161
NODE_93852_length_374_cov_1.661818	95	157	8	19	62	0.3064516
NODE_93852_length_374_cov_1.661818	95	157	9	1	62	0.0161290
NODE_93852_length_374_cov_1.661818	95	157	10	7	62	0.1129032
NODE_93859_length_374_cov_1.621818	202	254	0	52	52	1.0000000
NODE_93936_length_374_cov_1.360000	211	291	6	27	80	0.3375000
NODE_93936_length_374_cov_1.360000	211	291	8	53	80	0.6625000
NODE_93981_length_374_cov_1.236364	263	336	0	73	73	1.0000000
NODE_94321_length_373_cov_31.302920	0	53	0	5	53	0.0943396
NODE_94321_length_373_cov_31.302920	0	53	18	12	53	0.2264151
NODE_94321_length_373_cov_31.302920	0	53	21	1	53	0.0188679
NODE_94321_length_373_cov_31.302920	0	53	22	5	53	0.0943396
NODE_94321_length_373_cov_31.302920	0	53	24	2	53	0.0377358
NODE_94321_length_373_cov_31.302920	0	53	26	4	53	0.0754717
NODE_94321_length_373_cov_31.302920	0	53	27	1	53	0.0188679
NODE_94321_length_373_cov_31.302920	0	53	31	11	53	0.2075472
NODE_94321_length_373_cov_31.302920	0	53	34	1	53	0.0188679
NODE_94321_length_373_cov_31.302920	0	53	38	1	53	0.0188679
NODE_94321_length_373_cov_31.302920	0	53	40	1	53	0.0188679
NODE_94321_length_373_cov_31.302920	0	53	42	1	53	0.0188679
NODE_94321_length_373_cov_31.302920	0	53	44	8	53	0.1509434
NODE_94321_length_373_cov_31.302920	0	53	0	5	53	0.0943396
NODE_94321_length_373_cov_31.302920	0	53	18	12	53	0.2264151
NODE_94321_length_373_cov_31.302920	0	53	21	1	53	0.0188679
NODE_94321_length_373_cov_31.302920	0	53	22	5	53	0.0943396
NODE_94321_length_373_cov_31.302920	0	53	24	2	53	0.0377358
NODE_94321_length_373_cov_31.302920	0	53	26	4	53	0.0754717
NODE_94321_length_373_cov_31.302920	0	53	27	1	53	0.0188679
NODE_94321_length_373_cov_31.302920	0	53	31	11	53	0.2075472
NODE_94321_length_373_cov_31.302920	0	53	34	1	53	0.0188679
NODE_94321_length_373_cov_31.302920	0	53	38	1	53	0.0188679
NODE_94321_length_373_cov_31.302920	0	53	40	1	53	0.0188679
NODE_94321_length_373_cov_31.302920	0	53	42	1	53	0.0188679
NODE_94321_length_373_cov_31.302920	0	53	44	8	53	0.1509434
NODE_94321_length_373_cov_31.302920	0	53	0	5	53	0.0943396
NODE_94321_length_373_cov_31.302920	0	53	18	12	53	0.2264151
NODE_94321_length_373_cov_31.302920	0	53	21	1	53	0.0188679
NODE_94321_length_373_cov_31.302920	0	53	22	5	53	0.0943396
NODE_94321_length_373_cov_31.302920	0	53	24	2	53	0.0377358
NODE_94321_length_373_cov_31.302920	0	53	26	4	53	0.0754717
NODE_94321_length_373_cov_31.302920	0	53	27	1	53	0.0188679
NODE_94321_length_373_cov_31.302920	0	53	31	11	53	0.2075472
NODE_94321_length_373_cov_31.302920	0	53	34	1	53	0.0188679
NODE_94321_length_373_cov_31.302920	0	53	38	1	53	0.0188679
NODE_94321_length_373_cov_31.302920	0	53	40	1	53	0.0188679
NODE_94321_length_373_cov_31.302920	0	53	42	1	53	0.0188679
NODE_94321_length_373_cov_31.302920	0	53	44	8	53	0.1509434
NODE_94321_length_373_cov_31.302920	26	106	26	3	80	0.0375000
NODE_94321_length_373_cov_31.302920	26	106	27	1	80	0.0125000
NODE_94321_length_373_cov_31.302920	26	106	31	11	80	0.1375000
NODE_94321_length_373_cov_31.302920	26	106	34	1	80	0.0125000
NODE_94321_length_373_cov_31.302920	26	106	38	1	80	0.0125000
NODE_94321_length_373_cov_31.302920	26	106	40	1	80	0.0125000
NODE_94321_length_373_cov_31.302920	26	106	42	1	80	0.0125000
NODE_94321_length_373_cov_31.302920	26	106	44	9	80	0.1125000
NODE_94321_length_373_cov_31.302920	26	106	46	1	80	0.0125000
NODE_94321_length_373_cov_31.302920	26	106	48	6	80	0.0750000
NODE_94321_length_373_cov_31.302920	26	106	50	1	80	0.0125000
NODE_94321_length_373_cov_31.302920	26	106	52	11	80	0.1375000
NODE_94321_length_373_cov_31.302920	26	106	54	33	80	0.4125000
NODE_94340_length_373_cov_4.671533	76	142	8	66	66	1.0000000
NODE_94340_length_373_cov_4.671533	115	195	0	16	80	0.2000000
NODE_94340_length_373_cov_4.671533	115	195	6	22	80	0.2750000
NODE_94340_length_373_cov_4.671533	115	195	8	42	80	0.5250000
NODE_94340_length_373_cov_4.671533	115	195	0	16	80	0.2000000
NODE_94340_length_373_cov_4.671533	115	195	6	22	80	0.2750000
NODE_94340_length_373_cov_4.671533	115	195	8	42	80	0.5250000
NODE_94340_length_373_cov_4.671533	288	368	0	22	80	0.2750000
NODE_94340_length_373_cov_4.671533	288	368	2	2	80	0.0250000
NODE_94340_length_373_cov_4.671533	288	368	4	56	80	0.7000000
NODE_94352_length_373_cov_4.080292	109	189	5	36	80	0.4500000
NODE_94352_length_373_cov_4.080292	109	189	6	22	80	0.2750000
NODE_94352_length_373_cov_4.080292	109	189	8	22	80	0.2750000
NODE_94352_length_373_cov_4.080292	162	220	6	53	58	0.9137931
NODE_94352_length_373_cov_4.080292	162	220	8	5	58	0.0862069
NODE_94380_length_373_cov_3.167883	131	210	0	48	79	0.6075949
NODE_94380_length_373_cov_3.167883	131	210	2	31	79	0.3924051
NODE_94414_length_373_cov_2.751825	80	151	0	65	71	0.9154930
NODE_94414_length_373_cov_2.751825	80	151	2	6	71	0.0845070
NODE_94414_length_373_cov_2.751825	124	162	0	21	38	0.5526316
NODE_94414_length_373_cov_2.751825	124	162	2	8	38	0.2105263
NODE_94414_length_373_cov_2.751825	124	162	4	7	38	0.1842105
NODE_94414_length_373_cov_2.751825	124	162	8	2	38	0.0526316
NODE_94493_length_373_cov_2.036496	248	326	1	41	78	0.5256410
NODE_94493_length_373_cov_2.036496	248	326	2	33	78	0.4230769
NODE_94493_length_373_cov_2.036496	248	326	3	4	78	0.0512821
NODE_94493_length_373_cov_2.036496	299	359	0	16	60	0.2666667
NODE_94493_length_373_cov_2.036496	299	359	2	44	60	0.7333333
NODE_94500_length_373_cov_2.003650	150	194	0	44	44	1.0000000
NODE_94937_length_373_cov_0.759124	62	114	10	52	52	1.0000000
NODE_95051_length_372_cov_30.135531	111	191	0	80	80	1.0000000
NODE_95051_length_372_cov_30.135531	159	222	0	63	63	1.0000000
NODE_95051_length_372_cov_30.135531	164	239	0	75	75	1.0000000
NODE_95051_length_372_cov_30.135531	182	253	0	71	71	1.0000000
NODE_95051_length_372_cov_30.135531	195	275	0	80	80	1.0000000
NODE_95051_length_372_cov_30.135531	213	276	0	63	63	1.0000000
NODE_95053_length_372_cov_9.091575	150	230	0	80	80	1.0000000
NODE_95053_length_372_cov_9.091575	203	283	0	80	80	1.0000000
NODE_95063_length_372_cov_5.706960	168	208	0	40	40	1.0000000
NODE_95067_length_372_cov_5.124542	146	211	0	40	65	0.6153846
NODE_95067_length_372_cov_5.124542	146	211	4	25	65	0.3846154
NODE_95067_length_372_cov_5.124542	189	264	0	75	75	1.0000000
NODE_95090_length_372_cov_3.761905	177	221	0	42	44	0.9545454
NODE_95090_length_372_cov_3.761905	177	221	2	2	44	0.0454545
NODE_95109_length_372_cov_3.186813	137	218	0	81	81	1.0000000
NODE_95159_length_372_cov_2.582418	167	239	16	2	72	0.0277778
NODE_95159_length_372_cov_2.582418	167	239	18	4	72	0.0555556
NODE_95159_length_372_cov_2.582418	167	239	22	1	72	0.0138889
NODE_95159_length_372_cov_2.582418	167	239	26	2	72	0.0277778
NODE_95159_length_372_cov_2.582418	167	239	28	10	72	0.1388889
NODE_95159_length_372_cov_2.582418	167	239	29	22	72	0.3055556
NODE_95159_length_372_cov_2.582418	167	239	30	26	72	0.3611111
NODE_95159_length_372_cov_2.582418	167	239	32	5	72	0.0694444
NODE_95159_length_372_cov_2.582418	212	292	0	11	80	0.1375000
NODE_95159_length_372_cov_2.582418	212	292	2	6	80	0.0750000
NODE_95159_length_372_cov_2.582418	212	292	4	3	80	0.0375000
NODE_95159_length_372_cov_2.582418	212	292	6	1	80	0.0125000
NODE_95159_length_372_cov_2.582418	212	292	8	7	80	0.0875000
NODE_95159_length_372_cov_2.582418	212	292	10	8	80	0.1000000
NODE_95159_length_372_cov_2.582418	212	292	14	5	80	0.0625000
NODE_95159_length_372_cov_2.582418	212	292	16	1	80	0.0125000
NODE_95159_length_372_cov_2.582418	212	292	18	1	80	0.0125000
NODE_95159_length_372_cov_2.582418	212	292	20	1	80	0.0125000
NODE_95159_length_372_cov_2.582418	212	292	28	12	80	0.1500000
NODE_95159_length_372_cov_2.582418	212	292	29	22	80	0.2750000
NODE_95159_length_372_cov_2.582418	212	292	30	2	80	0.0250000
NODE_95183_length_372_cov_2.347985	97	141	0	44	44	1.0000000
NODE_95183_length_372_cov_2.347985	98	133	0	35	35	1.0000000
NODE_95183_length_372_cov_2.347985	178	243	4	43	65	0.6615385
NODE_95183_length_372_cov_2.347985	178	243	6	22	65	0.3384615
NODE_95303_length_372_cov_1.699634	195	276	6	81	81	1.0000000
NODE_95453_length_372_cov_1.223443	264	334	0	20	70	0.2857143
NODE_95453_length_372_cov_1.223443	264	334	2	50	70	0.7142857
NODE_95784_length_371_cov_52.040441	104	184	0	76	80	0.9500000
NODE_95784_length_371_cov_52.040441	104	184	1	4	80	0.0500000
NODE_95784_length_371_cov_52.040441	157	237	0	23	80	0.2875000
NODE_95784_length_371_cov_52.040441	157	237	1	5	80	0.0625000
NODE_95784_length_371_cov_52.040441	157	237	3	7	80	0.0875000
NODE_95784_length_371_cov_52.040441	157	237	5	8	80	0.1000000
NODE_95784_length_371_cov_52.040441	157	237	7	1	80	0.0125000
NODE_95784_length_371_cov_52.040441	157	237	9	4	80	0.0500000
NODE_95784_length_371_cov_52.040441	157	237	11	1	80	0.0125000
NODE_95784_length_371_cov_52.040441	157	237	12	2	80	0.0250000
NODE_95784_length_371_cov_52.040441	157	237	14	2	80	0.0250000
NODE_95784_length_371_cov_52.040441	157	237	15	8	80	0.1000000
NODE_95784_length_371_cov_52.040441	157	237	17	7	80	0.0875000
NODE_95784_length_371_cov_52.040441	157	237	19	1	80	0.0125000
NODE_95784_length_371_cov_52.040441	157	237	21	3	80	0.0375000
NODE_95784_length_371_cov_52.040441	157	237	23	4	80	0.0500000
NODE_95784_length_371_cov_52.040441	157	237	25	3	80	0.0375000
NODE_95784_length_371_cov_52.040441	157	237	27	1	80	0.0125000
NODE_95784_length_371_cov_52.040441	180	232	1	5	52	0.0961538
NODE_95784_length_371_cov_52.040441	180	232	3	7	52	0.1346154
NODE_95784_length_371_cov_52.040441	180	232	5	8	52	0.1538462
NODE_95784_length_371_cov_52.040441	180	232	7	1	52	0.0192308
NODE_95784_length_371_cov_52.040441	180	232	9	4	52	0.0769231
NODE_95784_length_371_cov_52.040441	180	232	11	1	52	0.0192308
NODE_95784_length_371_cov_52.040441	180	232	12	2	52	0.0384615
NODE_95784_length_371_cov_52.040441	180	232	14	2	52	0.0384615
NODE_95784_length_371_cov_52.040441	180	232	15	8	52	0.1538462
NODE_95784_length_371_cov_52.040441	180	232	17	7	52	0.1346154
NODE_95784_length_371_cov_52.040441	180	232	19	1	52	0.0192308
NODE_95784_length_371_cov_52.040441	180	232	21	3	52	0.0576923
NODE_95784_length_371_cov_52.040441	180	232	23	3	52	0.0576923
NODE_95785_length_371_cov_24.878676	91	171	4	80	80	1.0000000
NODE_95785_length_371_cov_24.878676	144	224	0	36	80	0.4500000
NODE_95785_length_371_cov_24.878676	144	224	4	44	80	0.5500000
NODE_95797_length_371_cov_5.738971	170	245	1	21	75	0.2800000
NODE_95797_length_371_cov_5.738971	170	245	3	20	75	0.2666667
NODE_95797_length_371_cov_5.738971	170	245	4	2	75	0.0266667
NODE_95797_length_371_cov_5.738971	170	245	5	9	75	0.1200000
NODE_95797_length_371_cov_5.738971	170	245	6	23	75	0.3066667
NODE_95797_length_371_cov_5.738971	218	298	4	2	80	0.0250000
NODE_95797_length_371_cov_5.738971	218	298	5	3	80	0.0375000
NODE_95797_length_371_cov_5.738971	218	298	6	51	80	0.6375000
NODE_95797_length_371_cov_5.738971	218	298	8	24	80	0.3000000
NODE_95807_length_371_cov_4.452206	65	145	0	80	80	1.0000000
NODE_95807_length_371_cov_4.452206	118	198	0	80	80	1.0000000
NODE_95863_length_371_cov_2.841912	288	350	0	2	62	0.0322581
NODE_95863_length_371_cov_2.841912	288	350	2	1	62	0.0161290
NODE_95863_length_371_cov_2.841912	288	350	4	54	62	0.8709677
NODE_95863_length_371_cov_2.841912	288	350	6	2	62	0.0322581
NODE_95863_length_371_cov_2.841912	288	350	7	1	62	0.0161290
NODE_95863_length_371_cov_2.841912	288	350	29	2	62	0.0322581
NODE_96013_length_371_cov_1.790441	188	235	0	47	47	1.0000000
NODE_96105_length_371_cov_1.422794	199	287	0	86	88	0.9772727
NODE_96105_length_371_cov_1.422794	199	287	2	2	88	0.0227273
NODE_96500_length_370_cov_50.380074	144	224	0	80	80	1.0000000
NODE_96500_length_370_cov_50.380074	197	277	0	80	80	1.0000000
NODE_96504_length_370_cov_7.553506	105	162	2	4	57	0.0701754
NODE_96504_length_370_cov_7.553506	105	162	4	35	57	0.6140351
NODE_96504_length_370_cov_7.553506	105	162	6	18	57	0.3157895
NODE_96510_length_370_cov_5.811808	153	221	0	68	68	1.0000000
NODE_96510_length_370_cov_5.811808	206	286	0	80	80	1.0000000
NODE_96522_length_370_cov_4.915129	157	207	2	50	50	1.0000000
NODE_96528_length_370_cov_4.535055	141	221	2	37	80	0.4625000
NODE_96528_length_370_cov_4.535055	141	221	6	34	80	0.4250000
NODE_96528_length_370_cov_4.535055	141	221	8	9	80	0.1125000
NODE_96528_length_370_cov_4.535055	194	274	0	14	80	0.1750000
NODE_96528_length_370_cov_4.535055	194	274	2	12	80	0.1500000
NODE_96528_length_370_cov_4.535055	194	274	6	54	80	0.6750000
NODE_96532_length_370_cov_4.199262	230	275	2	10	45	0.2222222
NODE_96532_length_370_cov_4.199262	230	275	4	35	45	0.7777778
NODE_96533_length_370_cov_4.151292	142	209	0	14	67	0.2089552
NODE_96533_length_370_cov_4.151292	142	209	4	53	67	0.7910448
NODE_96542_length_370_cov_3.719557	214	251	28	36	37	0.9729730
NODE_96542_length_370_cov_3.719557	214	251	30	1	37	0.0270270
NODE_96581_length_370_cov_2.822878	126	173	2	37	47	0.7872341
NODE_96581_length_370_cov_2.822878	126	173	4	10	47	0.2127660
NODE_96668_length_370_cov_2.081181	0	52	2	3	52	0.0576923
NODE_96668_length_370_cov_2.081181	0	52	8	2	52	0.0384615
NODE_96668_length_370_cov_2.081181	0	52	12	2	52	0.0384615
NODE_96668_length_370_cov_2.081181	0	52	17	1	52	0.0192308
NODE_96668_length_370_cov_2.081181	0	52	20	2	52	0.0384615
NODE_96668_length_370_cov_2.081181	0	52	22	4	52	0.0769231
NODE_96668_length_370_cov_2.081181	0	52	24	1	52	0.0192308
NODE_96668_length_370_cov_2.081181	0	52	26	1	52	0.0192308
NODE_96668_length_370_cov_2.081181	0	52	28	3	52	0.0576923
NODE_96668_length_370_cov_2.081181	0	52	33	2	52	0.0384615
NODE_96668_length_370_cov_2.081181	0	52	37	3	52	0.0576923
NODE_96668_length_370_cov_2.081181	0	52	38	1	52	0.0192308
NODE_96668_length_370_cov_2.081181	0	52	39	4	52	0.0769231
NODE_96668_length_370_cov_2.081181	0	52	43	5	52	0.0961538
NODE_96668_length_370_cov_2.081181	0	52	45	1	52	0.0192308
NODE_96668_length_370_cov_2.081181	0	52	53	1	52	0.0192308
NODE_96668_length_370_cov_2.081181	0	52	57	1	52	0.0192308
NODE_96668_length_370_cov_2.081181	0	52	60	1	52	0.0192308
NODE_96668_length_370_cov_2.081181	0	52	62	1	52	0.0192308
NODE_96668_length_370_cov_2.081181	0	52	63	1	52	0.0192308
NODE_96668_length_370_cov_2.081181	0	52	65	1	52	0.0192308
NODE_96668_length_370_cov_2.081181	0	52	67	4	52	0.0769231
NODE_96668_length_370_cov_2.081181	0	52	69	6	52	0.1153846
NODE_96668_length_370_cov_2.081181	0	52	71	1	52	0.0192308
NODE_97207_length_369_cov_36.811111	273	358	0	19	85	0.2235294
NODE_97207_length_369_cov_36.811111	273	358	6	34	85	0.4000000
NODE_97207_length_369_cov_36.811111	273	358	8	32	85	0.3764706
NODE_97207_length_369_cov_36.811111	273	358	0	19	85	0.2235294
NODE_97207_length_369_cov_36.811111	273	358	6	34	85	0.4000000
NODE_97207_length_369_cov_36.811111	273	358	8	32	85	0.3764706
NODE_97207_length_369_cov_36.811111	273	358	0	19	85	0.2235294
NODE_97207_length_369_cov_36.811111	273	358	6	34	85	0.4000000
NODE_97207_length_369_cov_36.811111	273	358	8	32	85	0.3764706
NODE_97211_length_369_cov_8.751852	107	187	0	70	80	0.8750000
NODE_97211_length_369_cov_8.751852	107	187	2	10	80	0.1250000
NODE_97226_length_369_cov_6.677778	189	269	2	18	80	0.2250000
NODE_97226_length_369_cov_6.677778	189	269	4	62	80	0.7750000
NODE_97226_length_369_cov_6.677778	242	323	0	14	81	0.1728395
NODE_97226_length_369_cov_6.677778	242	323	2	32	81	0.3950617
NODE_97226_length_369_cov_6.677778	242	323	4	35	81	0.4320988
NODE_97236_length_369_cov_5.337037	199	264	4	4	65	0.0615385
NODE_97236_length_369_cov_5.337037	199	264	12	59	65	0.9076923
NODE_97236_length_369_cov_5.337037	199	264	16	2	65	0.0307692
NODE_97249_length_369_cov_4.459259	89	157	0	68	68	1.0000000
NODE_97249_length_369_cov_4.459259	130	210	0	80	80	1.0000000
NODE_97255_length_369_cov_4.111111	216	279	0	63	63	1.0000000
NODE_97265_length_369_cov_3.837037	205	238	0	33	33	1.0000000
NODE_97265_length_369_cov_3.837037	211	291	0	80	80	1.0000000
NODE_97265_length_369_cov_3.837037	287	316	0	29	29	1.0000000
NODE_97346_length_369_cov_2.355556	62	142	0	34	80	0.4250000
NODE_97346_length_369_cov_2.355556	62	142	2	9	80	0.1125000
NODE_97346_length_369_cov_2.355556	62	142	4	37	80	0.4625000
NODE_97346_length_369_cov_2.355556	114	195	4	67	81	0.8271605
NODE_97346_length_369_cov_2.355556	114	195	6	14	81	0.1728395
NODE_97440_length_369_cov_1.803704	170	235	0	65	65	1.0000000
NODE_97936_length_368_cov_42.208178	231	311	0	80	80	1.0000000
NODE_97936_length_368_cov_42.208178	284	364	0	80	80	1.0000000
NODE_97939_length_368_cov_11.988848	47	127	0	80	80	1.0000000
NODE_97939_length_368_cov_11.988848	100	180	0	80	80	1.0000000
NODE_97945_length_368_cov_6.267658	133	213	0	16	80	0.2000000
NODE_97945_length_368_cov_6.267658	133	213	2	64	80	0.8000000
NODE_97945_length_368_cov_6.267658	186	266	2	80	80	1.0000000
NODE_97997_length_368_cov_3.486989	127	207	8	4	80	0.0500000
NODE_97997_length_368_cov_3.486989	127	207	9	25	80	0.3125000
NODE_97997_length_368_cov_3.486989	127	207	10	13	80	0.1625000
NODE_97997_length_368_cov_3.486989	127	207	12	23	80	0.2875000
NODE_97997_length_368_cov_3.486989	127	207	13	15	80	0.1875000
NODE_98008_length_368_cov_3.282528	182	255	2	63	73	0.8630137
NODE_98008_length_368_cov_3.282528	182	255	4	7	73	0.0958904
NODE_98008_length_368_cov_3.282528	182	255	5	2	73	0.0273973
NODE_98008_length_368_cov_3.282528	182	255	7	1	73	0.0136986
NODE_98058_length_368_cov_2.605948	192	246	6	14	54	0.2592593
NODE_98058_length_368_cov_2.605948	192	246	10	3	54	0.0555556
NODE_98058_length_368_cov_2.605948	192	246	12	1	54	0.0185185
NODE_98058_length_368_cov_2.605948	192	246	14	36	54	0.6666667
NODE_98123_length_368_cov_2.182156	85	145	0	21	60	0.3500000
NODE_98123_length_368_cov_2.182156	85	145	2	39	60	0.6500000
NODE_98129_length_368_cov_2.137546	66	107	0	23	41	0.5609756
NODE_98129_length_368_cov_2.137546	66	107	2	14	41	0.3414634
NODE_98129_length_368_cov_2.137546	66	107	4	4	41	0.0975610
NODE_98157_length_368_cov_1.944238	192	272	0	6	80	0.0750000
NODE_98157_length_368_cov_1.944238	192	272	2	1	80	0.0125000
NODE_98157_length_368_cov_1.944238	192	272	4	19	80	0.2375000
NODE_98157_length_368_cov_1.944238	192	272	6	17	80	0.2125000
NODE_98157_length_368_cov_1.944238	192	272	8	37	80	0.4625000
NODE_98723_length_367_cov_7.156716	174	254	0	74	80	0.9250000
NODE_98723_length_367_cov_7.156716	174	254	2	6	80	0.0750000
NODE_98723_length_367_cov_7.156716	227	307	0	21	80	0.2625000
NODE_98723_length_367_cov_7.156716	227	307	2	59	80	0.7375000
NODE_98734_length_367_cov_5.313433	148	206	0	7	58	0.1206897
NODE_98734_length_367_cov_5.313433	148	206	2	21	58	0.3620690
NODE_98734_length_367_cov_5.313433	148	206	8	9	58	0.1551724
NODE_98734_length_367_cov_5.313433	148	206	10	5	58	0.0862069
NODE_98734_length_367_cov_5.313433	148	206	13	1	58	0.0172414
NODE_98734_length_367_cov_5.313433	148	206	14	15	58	0.2586207
NODE_98737_length_367_cov_5.138060	58	138	0	44	80	0.5500000
NODE_98737_length_367_cov_5.138060	58	138	2	36	80	0.4500000
NODE_98737_length_367_cov_5.138060	111	191	0	4	80	0.0500000
NODE_98737_length_367_cov_5.138060	111	191	2	76	80	0.9500000
NODE_98796_length_367_cov_3.059701	110	154	0	44	44	1.0000000
NODE_98796_length_367_cov_3.059701	111	146	0	35	35	1.0000000
NODE_98843_length_367_cov_2.384328	246	326	4	33	80	0.4125000
NODE_98843_length_367_cov_2.384328	246	326	6	47	80	0.5875000
NODE_98843_length_367_cov_2.384328	299	367	0	11	68	0.1617647
NODE_98843_length_367_cov_2.384328	299	367	2	4	68	0.0588235
NODE_98843_length_367_cov_2.384328	299	367	4	53	68	0.7794118
NODE_98849_length_367_cov_2.332090	127	207	0	19	80	0.2375000
NODE_98849_length_367_cov_2.332090	127	207	2	61	80	0.7625000
NODE_98909_length_367_cov_1.944030	91	156	0	65	65	1.0000000
NODE_98980_length_367_cov_1.679104	173	252	8	37	79	0.4683544
NODE_98980_length_367_cov_1.679104	173	252	9	1	79	0.0126582
NODE_98980_length_367_cov_1.679104	173	252	10	13	79	0.1645570
NODE_98980_length_367_cov_1.679104	173	252	11	13	79	0.1645570
NODE_98980_length_367_cov_1.679104	173	252	12	3	79	0.0379747
NODE_98980_length_367_cov_1.679104	173	252	14	4	79	0.0506329
NODE_98980_length_367_cov_1.679104	173	252	16	8	79	0.1012658
NODE_99005_length_367_cov_1.552239	148	200	2	52	52	1.0000000
NODE_99138_length_367_cov_1.201493	79	159	0	80	80	1.0000000
NODE_99138_length_367_cov_1.201493	136	179	0	43	43	1.0000000
NODE_99318_length_367_cov_0.761194	288	357	0	69	69	1.0000000
NODE_99451_length_366_cov_5.239700	193	253	0	60	60	1.0000000
NODE_99472_length_366_cov_4.168539	302	355	0	53	53	1.0000000
NODE_99478_length_366_cov_3.913858	183	229	0	46	46	1.0000000
NODE_99478_length_366_cov_3.913858	203	282	0	79	79	1.0000000
NODE_99496_length_366_cov_3.168539	88	160	0	30	72	0.4166667
NODE_99496_length_366_cov_3.168539	88	160	2	42	72	0.5833333
NODE_99496_length_366_cov_3.168539	133	193	2	60	60	1.0000000
NODE_100137_length_365_cov_140.101504	40	107	91	1	67	0.0149254
NODE_100137_length_365_cov_140.101504	40	107	99	1	67	0.0149254
NODE_100137_length_365_cov_140.101504	40	107	101	1	67	0.0149254
NODE_100137_length_365_cov_140.101504	40	107	105	1	67	0.0149254
NODE_100137_length_365_cov_140.101504	40	107	113	1	67	0.0149254
NODE_100137_length_365_cov_140.101504	40	107	117	2	67	0.0298507
NODE_100137_length_365_cov_140.101504	40	107	123	2	67	0.0298507
NODE_100137_length_365_cov_140.101504	40	107	125	2	67	0.0298507
NODE_100137_length_365_cov_140.101504	40	107	127	1	67	0.0149254
NODE_100137_length_365_cov_140.101504	40	107	130	1	67	0.0149254
NODE_100137_length_365_cov_140.101504	40	107	138	1	67	0.0149254
NODE_100137_length_365_cov_140.101504	40	107	142	2	67	0.0298507
NODE_100137_length_365_cov_140.101504	40	107	144	3	67	0.0447761
NODE_100137_length_365_cov_140.101504	40	107	146	2	67	0.0298507
NODE_100137_length_365_cov_140.101504	40	107	148	1	67	0.0149254
NODE_100137_length_365_cov_140.101504	40	107	150	1	67	0.0149254
NODE_100137_length_365_cov_140.101504	40	107	155	1	67	0.0149254
NODE_100137_length_365_cov_140.101504	40	107	157	1	67	0.0149254
NODE_100137_length_365_cov_140.101504	40	107	161	1	67	0.0149254
NODE_100137_length_365_cov_140.101504	40	107	163	1	67	0.0149254
NODE_100137_length_365_cov_140.101504	40	107	167	1	67	0.0149254
NODE_100137_length_365_cov_140.101504	40	107	169	1	67	0.0149254
NODE_100137_length_365_cov_140.101504	40	107	177	1	67	0.0149254
NODE_100137_length_365_cov_140.101504	40	107	178	2	67	0.0298507
NODE_100137_length_365_cov_140.101504	40	107	188	2	67	0.0298507
NODE_100137_length_365_cov_140.101504	40	107	190	1	67	0.0149254
NODE_100137_length_365_cov_140.101504	40	107	195	1	67	0.0149254
NODE_100137_length_365_cov_140.101504	40	107	197	2	67	0.0298507
NODE_100137_length_365_cov_140.101504	40	107	199	2	67	0.0298507
NODE_100137_length_365_cov_140.101504	40	107	200	2	67	0.0298507
NODE_100137_length_365_cov_140.101504	40	107	203	4	67	0.0597015
NODE_100137_length_365_cov_140.101504	40	107	205	4	67	0.0597015
NODE_100137_length_365_cov_140.101504	40	107	207	2	67	0.0298507
NODE_100137_length_365_cov_140.101504	40	107	212	1	67	0.0149254
NODE_100137_length_365_cov_140.101504	40	107	213	1	67	0.0149254
NODE_100137_length_365_cov_140.101504	40	107	215	4	67	0.0597015
NODE_100137_length_365_cov_140.101504	40	107	217	8	67	0.1194030
NODE_100137_length_365_cov_140.101504	40	107	219	1	67	0.0149254
NODE_100138_length_365_cov_45.815789	0	38	0	38	38	1.0000000
NODE_100138_length_365_cov_45.815789	11	91	0	80	80	1.0000000
NODE_100140_length_365_cov_8.169173	191	244	4	4	53	0.0754717
NODE_100140_length_365_cov_8.169173	191	244	6	4	53	0.0754717
NODE_100140_length_365_cov_8.169173	191	244	10	4	53	0.0754717
NODE_100140_length_365_cov_8.169173	191	244	12	41	53	0.7735849
NODE_100140_length_365_cov_8.169173	217	297	4	10	80	0.1250000
NODE_100140_length_365_cov_8.169173	217	297	6	6	80	0.0750000
NODE_100140_length_365_cov_8.169173	217	297	10	16	80	0.2000000
NODE_100140_length_365_cov_8.169173	217	297	12	48	80	0.6000000
NODE_100145_length_365_cov_5.954887	136	216	2	23	80	0.2875000
NODE_100145_length_365_cov_5.954887	136	216	4	57	80	0.7125000
NODE_100145_length_365_cov_5.954887	189	269	0	8	80	0.1000000
NODE_100145_length_365_cov_5.954887	189	269	2	28	80	0.3500000
NODE_100145_length_365_cov_5.954887	189	269	4	44	80	0.5500000
NODE_100147_length_365_cov_5.721805	37	78	0	41	41	1.0000000
NODE_100168_length_365_cov_4.195489	269	329	18	1	60	0.0166667
NODE_100168_length_365_cov_4.195489	269	329	20	1	60	0.0166667
NODE_100168_length_365_cov_4.195489	269	329	22	7	60	0.1166667
NODE_100168_length_365_cov_4.195489	269	329	24	5	60	0.0833333
NODE_100168_length_365_cov_4.195489	269	329	32	9	60	0.1500000
NODE_100168_length_365_cov_4.195489	269	329	34	37	60	0.6166667
NODE_100172_length_365_cov_4.071429	106	186	0	80	80	1.0000000
NODE_100172_length_365_cov_4.071429	159	239	0	80	80	1.0000000
NODE_100180_length_365_cov_3.879699	131	187	53	5	56	0.0892857
NODE_100180_length_365_cov_3.879699	131	187	54	3	56	0.0535714
NODE_100180_length_365_cov_3.879699	131	187	55	13	56	0.2321429
NODE_100180_length_365_cov_3.879699	131	187	57	3	56	0.0535714
NODE_100180_length_365_cov_3.879699	131	187	58	32	56	0.5714286
NODE_100206_length_365_cov_3.270677	211	280	0	69	69	1.0000000
NODE_100253_length_365_cov_2.601504	189	265	0	29	76	0.3815790
NODE_100253_length_365_cov_2.601504	189	265	2	47	76	0.6184211
NODE_100293_length_365_cov_2.289474	169	249	0	80	80	1.0000000
NODE_100407_length_365_cov_1.635338	156	235	6	6	79	0.0759494
NODE_100407_length_365_cov_1.635338	156	235	8	6	79	0.0759494
NODE_100407_length_365_cov_1.635338	156	235	10	1	79	0.0126582
NODE_100407_length_365_cov_1.635338	156	235	12	4	79	0.0506329
NODE_100407_length_365_cov_1.635338	156	235	16	2	79	0.0253165
NODE_100407_length_365_cov_1.635338	156	235	22	1	79	0.0126582
NODE_100407_length_365_cov_1.635338	156	235	26	1	79	0.0126582
NODE_100407_length_365_cov_1.635338	156	235	30	8	79	0.1012658
NODE_100407_length_365_cov_1.635338	156	235	32	1	79	0.0126582
NODE_100407_length_365_cov_1.635338	156	235	34	3	79	0.0379747
NODE_100407_length_365_cov_1.635338	156	235	40	9	79	0.1139240
NODE_100407_length_365_cov_1.635338	156	235	42	4	79	0.0506329
NODE_100407_length_365_cov_1.635338	156	235	44	2	79	0.0253165
NODE_100407_length_365_cov_1.635338	156	235	46	17	79	0.2151899
NODE_100407_length_365_cov_1.635338	156	235	48	14	79	0.1772152
NODE_100485_length_365_cov_1.421053	228	309	0	81	81	1.0000000
NODE_100570_length_365_cov_1.169173	57	137	0	80	80	1.0000000
NODE_100570_length_365_cov_1.169173	65	145	0	80	80	1.0000000
NODE_100570_length_365_cov_1.169173	194	274	4	23	80	0.2875000
NODE_100570_length_365_cov_1.169173	194	274	6	10	80	0.1250000
NODE_100570_length_365_cov_1.169173	194	274	13	1	80	0.0125000
NODE_100570_length_365_cov_1.169173	194	274	14	21	80	0.2625000
NODE_100570_length_365_cov_1.169173	194	274	16	13	80	0.1625000
NODE_100570_length_365_cov_1.169173	194	274	18	12	80	0.1500000
NODE_100893_length_364_cov_24.600000	101	181	0	80	80	1.0000000
NODE_100893_length_364_cov_24.600000	154	234	0	80	80	1.0000000
NODE_100896_length_364_cov_7.377358	0	50	0	50	50	1.0000000
NODE_100933_length_364_cov_3.988679	122	168	0	1	46	0.0217391
NODE_100933_length_364_cov_3.988679	122	168	2	45	46	0.9782609
NODE_100935_length_364_cov_3.913208	151	208	0	41	57	0.7192982
NODE_100935_length_364_cov_3.913208	151	208	2	13	57	0.2280702
NODE_100935_length_364_cov_3.913208	151	208	4	3	57	0.0526316
NODE_100959_length_364_cov_3.305660	296	358	0	62	62	1.0000000
NODE_100966_length_364_cov_3.181132	78	138	0	48	60	0.8000000
NODE_100966_length_364_cov_3.181132	78	138	2	12	60	0.2000000
NODE_100975_length_364_cov_3.041509	264	321	0	1	57	0.0175439
NODE_100975_length_364_cov_3.041509	264	321	2	56	57	0.9824561
NODE_100975_length_364_cov_3.041509	294	359	0	8	65	0.1230769
NODE_100975_length_364_cov_3.041509	294	359	2	57	65	0.8769231
NODE_100978_length_364_cov_3.015094	238	274	0	2	36	0.0555556
NODE_100978_length_364_cov_3.015094	238	274	2	34	36	0.9444444
NODE_101087_length_364_cov_1.977358	126	201	0	16	75	0.2133333
NODE_101087_length_364_cov_1.977358	126	201	2	22	75	0.2933333
NODE_101087_length_364_cov_1.977358	126	201	4	25	75	0.3333333
NODE_101087_length_364_cov_1.977358	126	201	6	12	75	0.1600000
NODE_101141_length_364_cov_1.811321	209	256	0	13	47	0.2765957
NODE_101141_length_364_cov_1.811321	209	256	2	34	47	0.7234042
NODE_101148_length_364_cov_1.781132	130	203	2	1	73	0.0136986
NODE_101148_length_364_cov_1.781132	130	203	3	4	73	0.0547945
NODE_101148_length_364_cov_1.781132	130	203	4	1	73	0.0136986
NODE_101148_length_364_cov_1.781132	130	203	6	2	73	0.0273973
NODE_101148_length_364_cov_1.781132	130	203	8	18	73	0.2465753
NODE_101148_length_364_cov_1.781132	130	203	10	4	73	0.0547945
NODE_101148_length_364_cov_1.781132	130	203	15	18	73	0.2465753
NODE_101148_length_364_cov_1.781132	130	203	18	10	73	0.1369863
NODE_101148_length_364_cov_1.781132	130	203	20	15	73	0.2054795
NODE_101148_length_364_cov_1.781132	183	203	2	1	20	0.0500000
NODE_101148_length_364_cov_1.781132	183	203	3	4	20	0.2000000
NODE_101148_length_364_cov_1.781132	183	203	4	1	20	0.0500000
NODE_101148_length_364_cov_1.781132	183	203	6	2	20	0.1000000
NODE_101148_length_364_cov_1.781132	183	203	8	12	20	0.6000000
NODE_101720_length_363_cov_7.791667	121	200	0	79	79	1.0000000
NODE_101725_length_363_cov_6.484848	33	90	0	5	57	0.0877193
NODE_101725_length_363_cov_6.484848	33	90	2	3	57	0.0526316
NODE_101725_length_363_cov_6.484848	33	90	6	10	57	0.1754386
NODE_101725_length_363_cov_6.484848	33	90	10	39	57	0.6842105
NODE_101725_length_363_cov_6.484848	93	146	6	11	53	0.2075472
NODE_101725_length_363_cov_6.484848	93	146	10	42	53	0.7924528
NODE_101734_length_363_cov_4.825758	154	215	4	22	61	0.3606557
NODE_101734_length_363_cov_4.825758	154	215	6	30	61	0.4918033
NODE_101734_length_363_cov_4.825758	154	215	8	9	61	0.1475410
NODE_101760_length_363_cov_3.950758	112	183	4	71	71	1.0000000
NODE_101760_length_363_cov_3.950758	156	236	0	21	80	0.2625000
NODE_101760_length_363_cov_3.950758	156	236	2	32	80	0.4000000
NODE_101760_length_363_cov_3.950758	156	236	4	27	80	0.3375000
NODE_101769_length_363_cov_3.617424	16	79	2	7	63	0.1111111
NODE_101769_length_363_cov_3.617424	16	79	4	56	63	0.8888889
NODE_101774_length_363_cov_3.409091	241	267	0	26	26	1.0000000
NODE_101791_length_363_cov_3.087121	228	308	11	7	80	0.0875000
NODE_101791_length_363_cov_3.087121	228	308	13	15	80	0.1875000
NODE_101791_length_363_cov_3.087121	228	308	15	8	80	0.1000000
NODE_101791_length_363_cov_3.087121	228	308	17	1	80	0.0125000
NODE_101791_length_363_cov_3.087121	228	308	19	6	80	0.0750000
NODE_101791_length_363_cov_3.087121	228	308	20	13	80	0.1625000
NODE_101791_length_363_cov_3.087121	228	308	22	30	80	0.3750000
NODE_101809_length_363_cov_2.795455	240	320	16	1	80	0.0125000
NODE_101809_length_363_cov_2.795455	240	320	18	12	80	0.1500000
NODE_101809_length_363_cov_2.795455	240	320	20	8	80	0.1000000
NODE_101809_length_363_cov_2.795455	240	320	22	2	80	0.0250000
NODE_101809_length_363_cov_2.795455	240	320	24	1	80	0.0125000
NODE_101809_length_363_cov_2.795455	240	320	26	14	80	0.1750000
NODE_101809_length_363_cov_2.795455	240	320	28	4	80	0.0500000
NODE_101809_length_363_cov_2.795455	240	320	29	1	80	0.0125000
NODE_101809_length_363_cov_2.795455	240	320	31	5	80	0.0625000
NODE_101809_length_363_cov_2.795455	240	320	33	11	80	0.1375000
NODE_101809_length_363_cov_2.795455	240	320	34	2	80	0.0250000
NODE_101809_length_363_cov_2.795455	240	320	35	9	80	0.1125000
NODE_101809_length_363_cov_2.795455	240	320	36	9	80	0.1125000
NODE_101809_length_363_cov_2.795455	240	320	37	1	80	0.0125000
NODE_101822_length_363_cov_2.481061	86	166	0	80	80	1.0000000
NODE_101822_length_363_cov_2.481061	139	219	0	80	80	1.0000000
NODE_101879_length_363_cov_2.034091	46	126	0	11	80	0.1375000
NODE_101879_length_363_cov_2.034091	46	126	2	69	80	0.8625000
NODE_101879_length_363_cov_2.034091	99	153	0	35	54	0.6481481
NODE_101879_length_363_cov_2.034091	99	153	2	19	54	0.3518519
NODE_101992_length_363_cov_1.541667	235	315	0	80	80	1.0000000
NODE_102022_length_363_cov_1.477273	141	202	0	2	61	0.0327869
NODE_102022_length_363_cov_1.477273	141	202	2	1	61	0.0163934
NODE_102022_length_363_cov_1.477273	141	202	4	3	61	0.0491803
NODE_102022_length_363_cov_1.477273	141	202	8	4	61	0.0655738
NODE_102022_length_363_cov_1.477273	141	202	10	5	61	0.0819672
NODE_102022_length_363_cov_1.477273	141	202	12	12	61	0.1967213
NODE_102022_length_363_cov_1.477273	141	202	14	8	61	0.1311475
NODE_102022_length_363_cov_1.477273	141	202	16	26	61	0.4262295
NODE_102022_length_363_cov_1.477273	153	210	10	3	57	0.0526316
NODE_102022_length_363_cov_1.477273	153	210	12	12	57	0.2105263
NODE_102022_length_363_cov_1.477273	153	210	14	8	57	0.1403509
NODE_102022_length_363_cov_1.477273	153	210	16	34	57	0.5964912
NODE_102187_length_363_cov_1.113636	245	316	0	11	71	0.1549296
NODE_102187_length_363_cov_1.113636	245	316	4	5	71	0.0704225
NODE_102187_length_363_cov_1.113636	245	316	6	22	71	0.3098592
NODE_102187_length_363_cov_1.113636	245	316	8	33	71	0.4647887
NODE_102464_length_362_cov_54.927757	52	116	0	64	64	1.0000000
NODE_102465_length_362_cov_29.273764	86	166	0	80	80	1.0000000
NODE_102465_length_362_cov_29.273764	139	219	0	80	80	1.0000000
NODE_102467_length_362_cov_14.847909	130	210	0	80	80	1.0000000
NODE_102467_length_362_cov_14.847909	183	263	0	80	80	1.0000000
NODE_102633_length_362_cov_2.159696	133	216	0	83	83	1.0000000
NODE_103259_length_361_cov_4.641221	249	312	8	1	63	0.0158730
NODE_103259_length_361_cov_4.641221	249	312	10	9	63	0.1428571
NODE_103259_length_361_cov_4.641221	249	312	12	7	63	0.1111111
NODE_103259_length_361_cov_4.641221	249	312	14	8	63	0.1269841
NODE_103259_length_361_cov_4.641221	249	312	16	38	63	0.6031746
NODE_103280_length_361_cov_3.717557	185	265	2	5	80	0.0625000
NODE_103280_length_361_cov_3.717557	185	265	4	6	80	0.0750000
NODE_103280_length_361_cov_3.717557	185	265	6	69	80	0.8625000
NODE_103280_length_361_cov_3.717557	238	265	2	5	27	0.1851852
NODE_103280_length_361_cov_3.717557	238	265	6	22	27	0.8148148
NODE_103314_length_361_cov_2.988550	121	201	8	2	80	0.0250000
NODE_103314_length_361_cov_2.988550	121	201	12	3	80	0.0375000
NODE_103314_length_361_cov_2.988550	121	201	16	36	80	0.4500000
NODE_103314_length_361_cov_2.988550	121	201	18	39	80	0.4875000
NODE_103314_length_361_cov_2.988550	174	216	4	6	42	0.1428571
NODE_103314_length_361_cov_2.988550	174	216	10	2	42	0.0476190
NODE_103314_length_361_cov_2.988550	174	216	12	6	42	0.1428571
NODE_103314_length_361_cov_2.988550	174	216	14	1	42	0.0238095
NODE_103314_length_361_cov_2.988550	174	216	18	27	42	0.6428571
NODE_103338_length_361_cov_2.641221	4	33	4	11	29	0.3793103
NODE_103338_length_361_cov_2.641221	4	33	6	18	29	0.6206896
NODE_103338_length_361_cov_2.641221	101	182	2	81	81	1.0000000
NODE_103391_length_361_cov_2.137405	138	194	0	56	56	1.0000000
NODE_103396_length_361_cov_2.106870	192	256	0	64	64	1.0000000
NODE_103418_length_361_cov_1.969466	137	198	4	30	61	0.4918033
NODE_103418_length_361_cov_1.969466	137	198	7	3	61	0.0491803
NODE_103418_length_361_cov_1.969466	137	198	8	28	61	0.4590164
NODE_103632_length_361_cov_1.343511	171	250	0	79	79	1.0000000
NODE_103802_length_361_cov_1.000000	60	123	0	63	63	1.0000000
NODE_104057_length_360_cov_8.191571	171	242	0	71	71	1.0000000
NODE_104057_length_360_cov_8.191571	176	242	0	66	66	1.0000000
NODE_104057_length_360_cov_8.191571	215	279	0	64	64	1.0000000
NODE_104057_length_360_cov_8.191571	215	279	0	64	64	1.0000000
NODE_104079_length_360_cov_5.003831	86	166	0	80	80	1.0000000
NODE_104091_length_360_cov_4.111111	158	238	88	1	80	0.0125000
NODE_104091_length_360_cov_4.111111	158	238	90	1	80	0.0125000
NODE_104091_length_360_cov_4.111111	158	238	92	1	80	0.0125000
NODE_104091_length_360_cov_4.111111	158	238	94	1	80	0.0125000
NODE_104091_length_360_cov_4.111111	158	238	96	6	80	0.0750000
NODE_104091_length_360_cov_4.111111	158	238	98	1	80	0.0125000
NODE_104091_length_360_cov_4.111111	158	238	100	3	80	0.0375000
NODE_104091_length_360_cov_4.111111	158	238	101	1	80	0.0125000
NODE_104091_length_360_cov_4.111111	158	238	102	1	80	0.0125000
NODE_104091_length_360_cov_4.111111	158	238	104	2	80	0.0250000
NODE_104091_length_360_cov_4.111111	158	238	105	2	80	0.0250000
NODE_104091_length_360_cov_4.111111	158	238	106	5	80	0.0625000
NODE_104091_length_360_cov_4.111111	158	238	110	1	80	0.0125000
NODE_104091_length_360_cov_4.111111	158	238	114	4	80	0.0500000
NODE_104091_length_360_cov_4.111111	158	238	118	2	80	0.0250000
NODE_104091_length_360_cov_4.111111	158	238	120	3	80	0.0375000
NODE_104091_length_360_cov_4.111111	158	238	121	4	80	0.0500000
NODE_104091_length_360_cov_4.111111	158	238	122	3	80	0.0375000
NODE_104091_length_360_cov_4.111111	158	238	123	2	80	0.0250000
NODE_104091_length_360_cov_4.111111	158	238	124	4	80	0.0500000
NODE_104091_length_360_cov_4.111111	158	238	125	2	80	0.0250000
NODE_104091_length_360_cov_4.111111	158	238	127	10	80	0.1250000
NODE_104091_length_360_cov_4.111111	158	238	128	3	80	0.0375000
NODE_104091_length_360_cov_4.111111	158	238	130	17	80	0.2125000
NODE_104102_length_360_cov_3.613027	123	203	0	80	80	1.0000000
NODE_104102_length_360_cov_3.613027	176	256	0	80	80	1.0000000
NODE_104129_length_360_cov_3.080460	48	70	0	22	22	1.0000000
NODE_104162_length_360_cov_2.689655	118	198	8	2	80	0.0250000
NODE_104162_length_360_cov_2.689655	118	198	10	5	80	0.0625000
NODE_104162_length_360_cov_2.689655	118	198	12	9	80	0.1125000
NODE_104162_length_360_cov_2.689655	118	198	14	50	80	0.6250000
NODE_104162_length_360_cov_2.689655	118	198	16	14	80	0.1750000
NODE_104261_length_360_cov_1.977011	235	286	0	51	51	1.0000000
NODE_104572_length_360_cov_1.149425	273	353	0	80	80	1.0000000
NODE_104669_length_360_cov_0.965517	119	175	2	56	56	1.0000000
NODE_104671_length_360_cov_0.957854	140	186	0	46	46	1.0000000
NODE_104858_length_359_cov_45.519231	140	220	5	12	80	0.1500000
NODE_104858_length_359_cov_45.519231	140	220	6	38	80	0.4750000
NODE_104858_length_359_cov_45.519231	140	220	7	17	80	0.2125000
NODE_104858_length_359_cov_45.519231	140	220	8	13	80	0.1625000
NODE_104858_length_359_cov_45.519231	193	273	2	48	80	0.6000000
NODE_104858_length_359_cov_45.519231	193	273	4	1	80	0.0125000
NODE_104858_length_359_cov_45.519231	193	273	5	16	80	0.2000000
NODE_104858_length_359_cov_45.519231	193	273	7	15	80	0.1875000
NODE_104932_length_359_cov_3.296154	67	147	4	41	80	0.5125000
NODE_104932_length_359_cov_3.296154	67	147	6	11	80	0.1375000
NODE_104932_length_359_cov_3.296154	67	147	8	14	80	0.1750000
NODE_104932_length_359_cov_3.296154	67	147	10	4	80	0.0500000
NODE_104932_length_359_cov_3.296154	67	147	14	10	80	0.1250000
NODE_104932_length_359_cov_3.296154	120	177	6	5	57	0.0877193
NODE_104932_length_359_cov_3.296154	120	177	8	8	57	0.1403509
NODE_104932_length_359_cov_3.296154	120	177	10	4	57	0.0701754
NODE_104932_length_359_cov_3.296154	120	177	14	29	57	0.5087720
NODE_104932_length_359_cov_3.296154	120	177	16	3	57	0.0526316
NODE_104932_length_359_cov_3.296154	120	177	18	8	57	0.1403509
NODE_104932_length_359_cov_3.296154	201	256	10	13	55	0.2363636
NODE_104932_length_359_cov_3.296154	201	256	12	15	55	0.2727273
NODE_104932_length_359_cov_3.296154	201	256	14	4	55	0.0727273
NODE_104932_length_359_cov_3.296154	201	256	16	9	55	0.1636364
NODE_104932_length_359_cov_3.296154	201	256	18	4	55	0.0727273
NODE_104932_length_359_cov_3.296154	201	256	20	10	55	0.1818182
NODE_104936_length_359_cov_3.276923	5	95	0	90	90	1.0000000
NODE_104954_length_359_cov_3.007692	156	212	2	12	56	0.2142857
NODE_104954_length_359_cov_3.007692	156	212	4	44	56	0.7857143
NODE_104998_length_359_cov_2.523077	148	228	0	80	80	1.0000000
NODE_104998_length_359_cov_2.523077	201	278	0	77	77	1.0000000
NODE_105002_length_359_cov_2.419231	106	186	6	79	80	0.9875000
NODE_105002_length_359_cov_2.419231	106	186	8	1	80	0.0125000
NODE_105002_length_359_cov_2.419231	159	211	2	3	52	0.0576923
NODE_105002_length_359_cov_2.419231	159	211	4	15	52	0.2884615
NODE_105002_length_359_cov_2.419231	159	211	6	32	52	0.6153846
NODE_105002_length_359_cov_2.419231	159	211	8	1	52	0.0192308
NODE_105002_length_359_cov_2.419231	159	211	10	1	52	0.0192308
NODE_105006_length_359_cov_2.353846	172	243	0	1	71	0.0140845
NODE_105006_length_359_cov_2.353846	172	243	6	65	71	0.9154930
NODE_105006_length_359_cov_2.353846	172	243	8	5	71	0.0704225
NODE_105006_length_359_cov_2.353846	216	296	2	41	80	0.5125000
NODE_105006_length_359_cov_2.353846	216	296	6	22	80	0.2750000
NODE_105006_length_359_cov_2.353846	216	296	8	17	80	0.2125000
NODE_105026_length_359_cov_2.257692	211	270	0	59	59	1.0000000
NODE_105063_length_359_cov_2.003846	8	88	0	80	80	1.0000000
NODE_105063_length_359_cov_2.003846	61	139	0	78	78	1.0000000
NODE_105106_length_359_cov_1.815385	126	207	2	81	81	1.0000000
NODE_105106_length_359_cov_1.815385	180	227	2	47	47	1.0000000
NODE_105142_length_359_cov_1.692308	88	116	2	28	28	1.0000000
NODE_105373_length_359_cov_1.096154	64	89	0	25	25	1.0000000
NODE_105599_length_359_cov_0.711538	222	248	0	26	26	1.0000000
NODE_105600_length_359_cov_0.707692	10	90	0	80	80	1.0000000
NODE_105600_length_359_cov_0.707692	10	90	0	80	80	1.0000000
NODE_105600_length_359_cov_0.707692	63	143	0	80	80	1.0000000
NODE_105678_length_358_cov_19.760618	213	293	2	8	80	0.1000000
NODE_105678_length_358_cov_19.760618	213	293	4	72	80	0.9000000
NODE_105678_length_358_cov_19.760618	266	346	0	26	80	0.3250000
NODE_105678_length_358_cov_19.760618	266	346	2	21	80	0.2625000
NODE_105678_length_358_cov_19.760618	266	346	3	1	80	0.0125000
NODE_105678_length_358_cov_19.760618	266	346	4	32	80	0.4000000
NODE_105679_length_358_cov_18.455598	303	358	3	5	55	0.0909091
NODE_105679_length_358_cov_18.455598	303	358	5	8	55	0.1454545
NODE_105679_length_358_cov_18.455598	303	358	6	42	55	0.7636364
NODE_105680_length_358_cov_17.023166	0	63	0	5	63	0.0793651
NODE_105680_length_358_cov_17.023166	0	63	4	8	63	0.1269841
NODE_105680_length_358_cov_17.023166	0	63	6	3	63	0.0476190
NODE_105680_length_358_cov_17.023166	0	63	7	5	63	0.0793651
NODE_105680_length_358_cov_17.023166	0	63	9	20	63	0.3174603
NODE_105680_length_358_cov_17.023166	0	63	13	13	63	0.2063492
NODE_105680_length_358_cov_17.023166	0	63	15	9	63	0.1428571
NODE_105680_length_358_cov_17.023166	0	63	0	5	63	0.0793651
NODE_105680_length_358_cov_17.023166	0	63	4	8	63	0.1269841
NODE_105680_length_358_cov_17.023166	0	63	6	3	63	0.0476190
NODE_105680_length_358_cov_17.023166	0	63	7	5	63	0.0793651
NODE_105680_length_358_cov_17.023166	0	63	9	20	63	0.3174603
NODE_105680_length_358_cov_17.023166	0	63	13	13	63	0.2063492
NODE_105680_length_358_cov_17.023166	0	63	15	9	63	0.1428571
NODE_105680_length_358_cov_17.023166	0	63	0	5	63	0.0793651
NODE_105680_length_358_cov_17.023166	0	63	4	8	63	0.1269841
NODE_105680_length_358_cov_17.023166	0	63	6	3	63	0.0476190
NODE_105680_length_358_cov_17.023166	0	63	7	5	63	0.0793651
NODE_105680_length_358_cov_17.023166	0	63	9	20	63	0.3174603
NODE_105680_length_358_cov_17.023166	0	63	13	13	63	0.2063492
NODE_105680_length_358_cov_17.023166	0	63	15	9	63	0.1428571
NODE_105680_length_358_cov_17.023166	36	116	9	5	80	0.0625000
NODE_105680_length_358_cov_17.023166	36	116	13	13	80	0.1625000
NODE_105680_length_358_cov_17.023166	36	116	15	9	80	0.1125000
NODE_105680_length_358_cov_17.023166	36	116	16	53	80	0.6625000
NODE_105680_length_358_cov_17.023166	53	115	13	1	62	0.0161290
NODE_105680_length_358_cov_17.023166	53	115	15	9	62	0.1451613
NODE_105680_length_358_cov_17.023166	53	115	16	52	62	0.8387097
NODE_105686_length_358_cov_6.509653	109	155	2	30	46	0.6521739
NODE_105686_length_358_cov_6.509653	109	155	3	1	46	0.0217391
NODE_105686_length_358_cov_6.509653	109	155	4	15	46	0.3260870
NODE_105710_length_358_cov_4.239382	114	143	6	8	29	0.2758621
NODE_105710_length_358_cov_4.239382	114	143	10	1	29	0.0344828
NODE_105710_length_358_cov_4.239382	114	143	12	4	29	0.1379310
NODE_105710_length_358_cov_4.239382	114	143	18	6	29	0.2068966
NODE_105710_length_358_cov_4.239382	114	143	22	8	29	0.2758621
NODE_105710_length_358_cov_4.239382	114	143	24	2	29	0.0689655
NODE_105710_length_358_cov_4.239382	180	245	8	1	65	0.0153846
NODE_105710_length_358_cov_4.239382	180	245	15	10	65	0.1538462
NODE_105710_length_358_cov_4.239382	180	245	21	8	65	0.1230769
NODE_105710_length_358_cov_4.239382	180	245	22	41	65	0.6307693
NODE_105710_length_358_cov_4.239382	180	245	24	5	65	0.0769231
NODE_105710_length_358_cov_4.239382	218	298	2	36	80	0.4500000
NODE_105710_length_358_cov_4.239382	218	298	8	18	80	0.2250000
NODE_105710_length_358_cov_4.239382	218	298	15	10	80	0.1250000
NODE_105710_length_358_cov_4.239382	218	298	21	8	80	0.1000000
NODE_105710_length_358_cov_4.239382	218	298	22	8	80	0.1000000
NODE_105846_length_358_cov_2.162162	229	305	0	76	76	1.0000000
NODE_105902_length_358_cov_1.926641	290	358	0	68	68	1.0000000
NODE_105910_length_358_cov_1.884170	250	317	0	8	67	0.1194030
NODE_105910_length_358_cov_1.884170	250	317	2	59	67	0.8805970
NODE_105923_length_358_cov_1.841699	189	269	9	2	80	0.0250000
NODE_105923_length_358_cov_1.841699	189	269	11	3	80	0.0375000
NODE_105923_length_358_cov_1.841699	189	269	19	2	80	0.0250000
NODE_105923_length_358_cov_1.841699	189	269	21	9	80	0.1125000
NODE_105923_length_358_cov_1.841699	189	269	24	6	80	0.0750000
NODE_105923_length_358_cov_1.841699	189	269	26	1	80	0.0125000
NODE_105923_length_358_cov_1.841699	189	269	27	9	80	0.1125000
NODE_105923_length_358_cov_1.841699	189	269	29	19	80	0.2375000
NODE_105923_length_358_cov_1.841699	189	269	31	4	80	0.0500000
NODE_105923_length_358_cov_1.841699	189	269	33	8	80	0.1000000
NODE_105923_length_358_cov_1.841699	189	269	35	1	80	0.0125000
NODE_105923_length_358_cov_1.841699	189	269	37	16	80	0.2000000
NODE_106096_length_358_cov_1.235521	99	179	24	14	80	0.1750000
NODE_106096_length_358_cov_1.235521	99	179	28	2	80	0.0250000
NODE_106096_length_358_cov_1.235521	99	179	30	49	80	0.6125000
NODE_106096_length_358_cov_1.235521	99	179	32	15	80	0.1875000
NODE_106096_length_358_cov_1.235521	152	222	4	16	70	0.2285714
NODE_106096_length_358_cov_1.235521	152	222	5	7	70	0.1000000
NODE_106096_length_358_cov_1.235521	152	222	10	1	70	0.0142857
NODE_106096_length_358_cov_1.235521	152	222	12	1	70	0.0142857
NODE_106096_length_358_cov_1.235521	152	222	16	3	70	0.0428571
NODE_106096_length_358_cov_1.235521	152	222	20	1	70	0.0142857
NODE_106096_length_358_cov_1.235521	152	222	21	10	70	0.1428571
NODE_106096_length_358_cov_1.235521	152	222	23	1	70	0.0142857
NODE_106096_length_358_cov_1.235521	152	222	24	17	70	0.2428571
NODE_106096_length_358_cov_1.235521	152	222	28	2	70	0.0285714
NODE_106096_length_358_cov_1.235521	152	222	30	11	70	0.1571429
NODE_106189_length_358_cov_1.096525	148	228	0	5	80	0.0625000
NODE_106189_length_358_cov_1.096525	148	228	2	9	80	0.1125000
NODE_106189_length_358_cov_1.096525	148	228	6	66	80	0.8250000
NODE_106233_length_358_cov_0.984556	193	265	0	3	72	0.0416667
NODE_106233_length_358_cov_0.984556	193	265	2	69	72	0.9583333
NODE_106489_length_357_cov_381.833333	244	324	147	4	80	0.0500000
NODE_106489_length_357_cov_381.833333	244	324	151	2	80	0.0250000
NODE_106489_length_357_cov_381.833333	244	324	161	2	80	0.0250000
NODE_106489_length_357_cov_381.833333	244	324	173	1	80	0.0125000
NODE_106489_length_357_cov_381.833333	244	324	177	1	80	0.0125000
NODE_106489_length_357_cov_381.833333	244	324	194	1	80	0.0125000
NODE_106489_length_357_cov_381.833333	244	324	195	1	80	0.0125000
NODE_106489_length_357_cov_381.833333	244	324	199	3	80	0.0375000
NODE_106489_length_357_cov_381.833333	244	324	200	1	80	0.0125000
NODE_106489_length_357_cov_381.833333	244	324	201	1	80	0.0125000
NODE_106489_length_357_cov_381.833333	244	324	204	1	80	0.0125000
NODE_106489_length_357_cov_381.833333	244	324	206	1	80	0.0125000
NODE_106489_length_357_cov_381.833333	244	324	210	1	80	0.0125000
NODE_106489_length_357_cov_381.833333	244	324	214	5	80	0.0625000
NODE_106489_length_357_cov_381.833333	244	324	215	2	80	0.0250000
NODE_106489_length_357_cov_381.833333	244	324	216	1	80	0.0125000
NODE_106489_length_357_cov_381.833333	244	324	217	11	80	0.1375000
NODE_106489_length_357_cov_381.833333	244	324	218	27	80	0.3375000
NODE_106489_length_357_cov_381.833333	244	324	219	14	80	0.1750000
NODE_106493_length_357_cov_7.643411	45	125	0	80	80	1.0000000
NODE_106493_length_357_cov_7.643411	98	178	0	80	80	1.0000000
NODE_106495_length_357_cov_7.027132	157	237	0	80	80	1.0000000
NODE_106495_length_357_cov_7.027132	210	252	0	42	42	1.0000000
NODE_106496_length_357_cov_6.732558	183	263	16	29	80	0.3625000
NODE_106496_length_357_cov_6.732558	183	263	18	30	80	0.3750000
NODE_106496_length_357_cov_6.732558	183	263	20	21	80	0.2625000
NODE_106529_length_357_cov_4.081395	145	225	2	80	80	1.0000000
NODE_106529_length_357_cov_4.081395	198	271	0	13	73	0.1780822
NODE_106529_length_357_cov_4.081395	198	271	2	60	73	0.8219178
NODE_106542_length_357_cov_3.724806	192	265	2	30	73	0.4109589
NODE_106542_length_357_cov_3.724806	192	265	4	43	73	0.5890411
NODE_106558_length_357_cov_3.341085	205	285	0	80	80	1.0000000
NODE_106558_length_357_cov_3.341085	258	338	0	80	80	1.0000000
NODE_106625_length_357_cov_2.414729	245	302	0	57	57	1.0000000
NODE_106625_length_357_cov_2.414729	275	355	0	80	80	1.0000000
NODE_106661_length_357_cov_2.174419	250	330	0	80	80	1.0000000
NODE_106666_length_357_cov_2.166667	103	133	2	4	30	0.1333333
NODE_106666_length_357_cov_2.166667	103	133	4	26	30	0.8666667
NODE_106666_length_357_cov_2.166667	112	133	4	21	21	1.0000000
NODE_106702_length_357_cov_1.961240	150	169	4	19	19	1.0000000
NODE_106708_length_357_cov_1.918605	173	253	8	70	80	0.8750000
NODE_106708_length_357_cov_1.918605	173	253	10	10	80	0.1250000
NODE_106737_length_357_cov_1.782946	73	142	0	4	69	0.0579710
NODE_106737_length_357_cov_1.782946	73	142	2	14	69	0.2028985
NODE_106737_length_357_cov_1.782946	73	142	4	51	69	0.7391304
NODE_106737_length_357_cov_1.782946	115	195	0	25	80	0.3125000
NODE_106737_length_357_cov_1.782946	115	195	2	11	80	0.1375000
NODE_106737_length_357_cov_1.782946	115	195	4	44	80	0.5500000
NODE_107002_length_357_cov_1.127907	98	129	5	27	31	0.8709677
NODE_107002_length_357_cov_1.127907	98	129	6	4	31	0.1290323
NODE_107306_length_356_cov_5.299611	140	200	2	5	60	0.0833333
NODE_107306_length_356_cov_5.299611	140	200	8	14	60	0.2333333
NODE_107306_length_356_cov_5.299611	140	200	10	41	60	0.6833333
NODE_107347_length_356_cov_3.400778	255	317	6	11	62	0.1774193
NODE_107347_length_356_cov_3.400778	255	317	8	51	62	0.8225806
NODE_107347_length_356_cov_3.400778	308	353	2	18	45	0.4000000
NODE_107347_length_356_cov_3.400778	308	353	6	3	45	0.0666667
NODE_107347_length_356_cov_3.400778	308	353	8	24	45	0.5333334
NODE_107402_length_356_cov_2.657588	256	298	64	8	42	0.1904762
NODE_107402_length_356_cov_2.657588	256	298	66	11	42	0.2619048
NODE_107402_length_356_cov_2.657588	256	298	68	11	42	0.2619048
NODE_107402_length_356_cov_2.657588	256	298	70	12	42	0.2857143
NODE_107402_length_356_cov_2.657588	265	338	35	1	73	0.0136986
NODE_107402_length_356_cov_2.657588	265	338	39	5	73	0.0684932
NODE_107402_length_356_cov_2.657588	265	338	43	1	73	0.0136986
NODE_107402_length_356_cov_2.657588	265	338	44	1	73	0.0136986
NODE_107402_length_356_cov_2.657588	265	338	46	1	73	0.0136986
NODE_107402_length_356_cov_2.657588	265	338	52	5	73	0.0684932
NODE_107402_length_356_cov_2.657588	265	338	56	9	73	0.1232877
NODE_107402_length_356_cov_2.657588	265	338	60	4	73	0.0547945
NODE_107402_length_356_cov_2.657588	265	338	62	8	73	0.1095890
NODE_107402_length_356_cov_2.657588	265	338	64	13	73	0.1780822
NODE_107402_length_356_cov_2.657588	265	338	66	7	73	0.0958904
NODE_107402_length_356_cov_2.657588	265	338	68	8	73	0.1095890
NODE_107402_length_356_cov_2.657588	265	338	70	10	73	0.1369863
NODE_107402_length_356_cov_2.657588	299	351	14	1	52	0.0192308
NODE_107402_length_356_cov_2.657588	299	351	16	3	52	0.0576923
NODE_107402_length_356_cov_2.657588	299	351	20	2	52	0.0384615
NODE_107402_length_356_cov_2.657588	299	351	21	1	52	0.0192308
NODE_107402_length_356_cov_2.657588	299	351	28	1	52	0.0192308
NODE_107402_length_356_cov_2.657588	299	351	30	4	52	0.0769231
NODE_107402_length_356_cov_2.657588	299	351	32	1	52	0.0192308
NODE_107402_length_356_cov_2.657588	299	351	35	1	52	0.0192308
NODE_107402_length_356_cov_2.657588	299	351	39	5	52	0.0961538
NODE_107402_length_356_cov_2.657588	299	351	43	1	52	0.0192308
NODE_107402_length_356_cov_2.657588	299	351	44	1	52	0.0192308
NODE_107402_length_356_cov_2.657588	299	351	46	1	52	0.0192308
NODE_107402_length_356_cov_2.657588	299	351	52	5	52	0.0961538
NODE_107402_length_356_cov_2.657588	299	351	56	9	52	0.1730769
NODE_107402_length_356_cov_2.657588	299	351	60	4	52	0.0769231
NODE_107402_length_356_cov_2.657588	299	351	62	8	52	0.1538462
NODE_107402_length_356_cov_2.657588	299	351	64	4	52	0.0769231
NODE_107452_length_356_cov_2.237354	90	135	0	8	45	0.1777778
NODE_107452_length_356_cov_2.237354	90	135	2	37	45	0.8222222
NODE_107475_length_356_cov_1.996109	127	194	0	67	67	1.0000000
NODE_107521_length_356_cov_1.813230	296	341	0	45	45	1.0000000
NODE_107606_length_356_cov_1.560311	192	272	0	12	80	0.1500000
NODE_107606_length_356_cov_1.560311	192	272	1	49	80	0.6125000
NODE_107606_length_356_cov_1.560311	192	272	2	5	80	0.0625000
NODE_107606_length_356_cov_1.560311	192	272	4	14	80	0.1750000
NODE_107606_length_356_cov_1.560311	245	319	0	51	74	0.6891892
NODE_107606_length_356_cov_1.560311	245	319	1	23	74	0.3108108
NODE_108122_length_355_cov_6.796875	127	173	0	14	46	0.3043478
NODE_108122_length_355_cov_6.796875	127	173	3	1	46	0.0217391
NODE_108122_length_355_cov_6.796875	127	173	4	31	46	0.6739131
NODE_108210_length_355_cov_2.734375	111	162	0	51	51	1.0000000
NODE_108210_length_355_cov_2.734375	142	222	0	80	80	1.0000000
NODE_108215_length_355_cov_2.707031	277	314	0	37	37	1.0000000
NODE_108215_length_355_cov_2.707031	287	353	0	66	66	1.0000000
NODE_108239_length_355_cov_2.500000	38	82	0	7	44	0.1590909
NODE_108239_length_355_cov_2.500000	38	82	6	2	44	0.0454545
NODE_108239_length_355_cov_2.500000	38	82	8	35	44	0.7954546
NODE_108278_length_355_cov_2.207031	258	308	0	50	50	1.0000000
NODE_108284_length_355_cov_2.179688	153	233	2	9	80	0.1125000
NODE_108284_length_355_cov_2.179688	153	233	3	26	80	0.3250000
NODE_108284_length_355_cov_2.179688	153	233	5	45	80	0.5625000
NODE_108284_length_355_cov_2.179688	206	286	1	36	80	0.4500000
NODE_108284_length_355_cov_2.179688	206	286	3	24	80	0.3000000
NODE_108284_length_355_cov_2.179688	206	286	5	20	80	0.2500000
NODE_108291_length_355_cov_2.132812	261	334	0	73	73	1.0000000
NODE_108291_length_355_cov_2.132812	301	342	0	41	41	1.0000000
NODE_108315_length_355_cov_2.007812	281	347	0	55	66	0.8333333
NODE_108315_length_355_cov_2.007812	281	347	2	11	66	0.1666667
NODE_108395_length_355_cov_1.765625	186	247	12	15	61	0.2459016
NODE_108395_length_355_cov_1.765625	186	247	14	46	61	0.7540984
NODE_108395_length_355_cov_1.765625	220	300	12	31	80	0.3875000
NODE_108395_length_355_cov_1.765625	220	300	14	49	80	0.6125000
NODE_109015_length_354_cov_6.843137	53	132	0	79	79	1.0000000
NODE_109015_length_354_cov_6.843137	53	132	0	79	79	1.0000000
NODE_109015_length_354_cov_6.843137	105	185	0	80	80	1.0000000
NODE_109015_length_354_cov_6.843137	105	185	0	80	80	1.0000000
NODE_109033_length_354_cov_4.823529	208	255	0	47	47	1.0000000
NODE_109054_length_354_cov_3.956863	145	208	0	5	63	0.0793651
NODE_109054_length_354_cov_3.956863	145	208	2	58	63	0.9206349
NODE_109054_length_354_cov_3.956863	181	261	0	32	80	0.4000000
NODE_109054_length_354_cov_3.956863	181	261	2	48	80	0.6000000
NODE_109057_length_354_cov_3.878431	198	244	0	46	46	1.0000000
NODE_109089_length_354_cov_3.207843	130	199	0	69	69	1.0000000
NODE_109126_length_354_cov_2.725490	179	259	2	61	80	0.7625000
NODE_109126_length_354_cov_2.725490	179	259	4	7	80	0.0875000
NODE_109126_length_354_cov_2.725490	179	259	6	12	80	0.1500000
NODE_109126_length_354_cov_2.725490	235	312	2	5	77	0.0649351
NODE_109126_length_354_cov_2.725490	235	312	4	7	77	0.0909091
NODE_109126_length_354_cov_2.725490	235	312	6	65	77	0.8441558
NODE_109128_length_354_cov_2.713725	16	76	0	60	60	1.0000000
NODE_109128_length_354_cov_2.713725	90	149	0	59	59	1.0000000
NODE_109140_length_354_cov_2.580392	176	234	0	19	58	0.3275862
NODE_109140_length_354_cov_2.580392	176	234	4	39	58	0.6724138
NODE_109140_length_354_cov_2.580392	207	251	4	35	44	0.7954546
NODE_109140_length_354_cov_2.580392	207	251	6	6	44	0.1363636
NODE_109140_length_354_cov_2.580392	207	251	8	3	44	0.0681818
NODE_109237_length_354_cov_1.996078	79	145	0	66	66	1.0000000
NODE_109237_length_354_cov_1.996078	118	200	0	82	82	1.0000000
NODE_109244_length_354_cov_1.988235	7	77	0	20	70	0.2857143
NODE_109244_length_354_cov_1.988235	7	77	2	6	70	0.0857143
NODE_109244_length_354_cov_1.988235	7	77	10	16	70	0.2285714
NODE_109244_length_354_cov_1.988235	7	77	11	1	70	0.0142857
NODE_109244_length_354_cov_1.988235	7	77	12	7	70	0.1000000
NODE_109244_length_354_cov_1.988235	7	77	14	20	70	0.2857143
NODE_109244_length_354_cov_1.988235	64	130	8	4	66	0.0606061
NODE_109244_length_354_cov_1.988235	64	130	10	1	66	0.0151515
NODE_109244_length_354_cov_1.988235	64	130	14	52	66	0.7878788
NODE_109244_length_354_cov_1.988235	64	130	18	9	66	0.1363636
NODE_109321_length_354_cov_1.682353	99	171	8	61	72	0.8472222
NODE_109321_length_354_cov_1.682353	99	171	10	11	72	0.1527778
NODE_109321_length_354_cov_1.682353	144	224	2	15	80	0.1875000
NODE_109321_length_354_cov_1.682353	144	224	5	3	80	0.0375000
NODE_109321_length_354_cov_1.682353	144	224	7	23	80	0.2875000
NODE_109321_length_354_cov_1.682353	144	224	8	16	80	0.2000000
NODE_109321_length_354_cov_1.682353	144	224	10	23	80	0.2875000
NODE_109852_length_353_cov_11.169291	14	90	0	76	76	1.0000000
NODE_109852_length_353_cov_11.169291	67	143	0	76	76	1.0000000
NODE_109911_length_353_cov_3.874016	220	256	0	36	36	1.0000000
NODE_109911_length_353_cov_3.874016	265	334	0	69	69	1.0000000
NODE_109928_length_353_cov_3.488189	200	282	4	15	82	0.1829268
NODE_109928_length_353_cov_3.488189	200	282	6	2	82	0.0243902
NODE_109928_length_353_cov_3.488189	200	282	8	7	82	0.0853659
NODE_109928_length_353_cov_3.488189	200	282	10	2	82	0.0243902
NODE_109928_length_353_cov_3.488189	200	282	12	56	82	0.6829268
NODE_109976_length_353_cov_2.826772	8	88	0	22	80	0.2750000
NODE_109976_length_353_cov_2.826772	8	88	2	58	80	0.7250000
NODE_109976_length_353_cov_2.826772	61	120	2	59	59	1.0000000
NODE_110022_length_353_cov_2.417323	260	336	0	76	76	1.0000000
NODE_110610_length_353_cov_0.744094	299	318	0	19	19	1.0000000
NODE_110708_length_352_cov_34.691700	110	203	0	89	93	0.9569892
NODE_110708_length_352_cov_34.691700	110	203	2	1	93	0.0107527
NODE_110708_length_352_cov_34.691700	110	203	4	1	93	0.0107527
NODE_110708_length_352_cov_34.691700	110	203	27	1	93	0.0107527
NODE_110708_length_352_cov_34.691700	110	203	45	1	93	0.0107527
NODE_110710_length_352_cov_17.944664	20	100	0	80	80	1.0000000
NODE_110710_length_352_cov_17.944664	73	153	0	80	80	1.0000000
NODE_110710_length_352_cov_17.944664	273	352	0	49	79	0.6202531
NODE_110710_length_352_cov_17.944664	273	352	4	30	79	0.3797468
NODE_110735_length_352_cov_4.707510	157	237	4	3	80	0.0375000
NODE_110735_length_352_cov_4.707510	157	237	6	9	80	0.1125000
NODE_110735_length_352_cov_4.707510	157	237	7	7	80	0.0875000
NODE_110735_length_352_cov_4.707510	157	237	8	2	80	0.0250000
NODE_110735_length_352_cov_4.707510	157	237	11	3	80	0.0375000
NODE_110735_length_352_cov_4.707510	157	237	13	13	80	0.1625000
NODE_110735_length_352_cov_4.707510	157	237	14	12	80	0.1500000
NODE_110735_length_352_cov_4.707510	157	237	16	31	80	0.3875000
NODE_110749_length_352_cov_4.221344	144	205	0	61	61	1.0000000
NODE_110749_length_352_cov_4.221344	178	259	0	81	81	1.0000000
NODE_110754_length_352_cov_4.011858	98	143	0	45	45	1.0000000
NODE_110754_length_352_cov_4.011858	151	228	0	13	77	0.1688312
NODE_110754_length_352_cov_4.011858	151	228	2	2	77	0.0259740
NODE_110754_length_352_cov_4.011858	151	228	3	56	77	0.7272727
NODE_110754_length_352_cov_4.011858	151	228	5	6	77	0.0779221
NODE_110798_length_352_cov_2.849802	74	154	0	80	80	1.0000000
NODE_110798_length_352_cov_2.849802	127	198	0	71	71	1.0000000
NODE_110820_length_352_cov_2.683794	0	77	0	17	77	0.2207792
NODE_110820_length_352_cov_2.683794	0	77	4	60	77	0.7792208
NODE_110820_length_352_cov_2.683794	50	130	0	34	80	0.4250000
NODE_110820_length_352_cov_2.683794	50	130	4	46	80	0.5750000
NODE_110832_length_352_cov_2.608696	90	136	0	9	46	0.1956522
NODE_110832_length_352_cov_2.608696	90	136	2	37	46	0.8043478
NODE_110832_length_352_cov_2.608696	144	189	2	45	45	1.0000000
NODE_110838_length_352_cov_2.577075	111	191	0	9	80	0.1125000
NODE_110838_length_352_cov_2.577075	111	191	2	63	80	0.7875000
NODE_110838_length_352_cov_2.577075	111	191	4	1	80	0.0125000
NODE_110838_length_352_cov_2.577075	111	191	6	7	80	0.0875000
NODE_110876_length_352_cov_2.264822	171	251	0	80	80	1.0000000
NODE_110938_length_352_cov_2.007905	277	326	0	49	49	1.0000000
NODE_111439_length_352_cov_0.806324	165	238	12	1	73	0.0136986
NODE_111439_length_352_cov_0.806324	165	238	16	1	73	0.0136986
NODE_111439_length_352_cov_0.806324	165	238	22	1	73	0.0136986
NODE_111439_length_352_cov_0.806324	165	238	24	2	73	0.0273973
NODE_111439_length_352_cov_0.806324	165	238	26	1	73	0.0136986
NODE_111439_length_352_cov_0.806324	165	238	28	4	73	0.0547945
NODE_111439_length_352_cov_0.806324	165	238	30	1	73	0.0136986
NODE_111439_length_352_cov_0.806324	165	238	32	1	73	0.0136986
NODE_111439_length_352_cov_0.806324	165	238	34	2	73	0.0273973
NODE_111439_length_352_cov_0.806324	165	238	38	5	73	0.0684932
NODE_111439_length_352_cov_0.806324	165	238	42	4	73	0.0547945
NODE_111439_length_352_cov_0.806324	165	238	44	6	73	0.0821918
NODE_111439_length_352_cov_0.806324	165	238	50	1	73	0.0136986
NODE_111439_length_352_cov_0.806324	165	238	52	6	73	0.0821918
NODE_111439_length_352_cov_0.806324	165	238	56	1	73	0.0136986
NODE_111439_length_352_cov_0.806324	165	238	58	4	73	0.0547945
NODE_111439_length_352_cov_0.806324	165	238	62	5	73	0.0684932
NODE_111439_length_352_cov_0.806324	165	238	64	4	73	0.0547945
NODE_111439_length_352_cov_0.806324	165	238	66	2	73	0.0273973
NODE_111439_length_352_cov_0.806324	165	238	68	2	73	0.0273973
NODE_111439_length_352_cov_0.806324	165	238	70	2	73	0.0273973
NODE_111439_length_352_cov_0.806324	165	238	72	1	73	0.0136986
NODE_111439_length_352_cov_0.806324	165	238	74	2	73	0.0273973
NODE_111439_length_352_cov_0.806324	165	238	76	6	73	0.0821918
NODE_111439_length_352_cov_0.806324	165	238	78	1	73	0.0136986
NODE_111439_length_352_cov_0.806324	165	238	80	7	73	0.0958904
NODE_111593_length_351_cov_5.003968	115	195	0	15	80	0.1875000
NODE_111593_length_351_cov_5.003968	115	195	6	32	80	0.4000000
NODE_111593_length_351_cov_5.003968	115	195	10	33	80	0.4125000
NODE_111662_length_351_cov_2.900794	289	320	0	31	31	1.0000000
NODE_111738_length_351_cov_2.376984	79	159	0	39	80	0.4875000
NODE_111738_length_351_cov_2.376984	79	159	2	39	80	0.4875000
NODE_111738_length_351_cov_2.376984	79	159	8	2	80	0.0250000
NODE_111759_length_351_cov_2.226190	116	170	30	1	54	0.0185185
NODE_111759_length_351_cov_2.226190	116	170	32	8	54	0.1481481
NODE_111759_length_351_cov_2.226190	116	170	34	7	54	0.1296296
NODE_111759_length_351_cov_2.226190	116	170	36	27	54	0.5000000
NODE_111759_length_351_cov_2.226190	116	170	38	11	54	0.2037037
NODE_111769_length_351_cov_2.186508	198	277	4	44	79	0.5569620
NODE_111769_length_351_cov_2.186508	198	277	5	29	79	0.3670886
NODE_111769_length_351_cov_2.186508	198	277	6	6	79	0.0759494
NODE_111861_length_351_cov_1.809524	276	309	0	33	33	1.0000000
NODE_111969_length_351_cov_1.515873	228	299	2	54	71	0.7605634
NODE_111969_length_351_cov_1.515873	228	299	4	17	71	0.2394366
NODE_112493_length_350_cov_232.529880	25	92	40	2	67	0.0298507
NODE_112493_length_350_cov_232.529880	25	92	52	4	67	0.0597015
NODE_112493_length_350_cov_232.529880	25	92	54	1	67	0.0149254
NODE_112493_length_350_cov_232.529880	25	92	62	1	67	0.0149254
NODE_112493_length_350_cov_232.529880	25	92	64	2	67	0.0298507
NODE_112493_length_350_cov_232.529880	25	92	68	1	67	0.0149254
NODE_112493_length_350_cov_232.529880	25	92	69	1	67	0.0149254
NODE_112493_length_350_cov_232.529880	25	92	73	1	67	0.0149254
NODE_112493_length_350_cov_232.529880	25	92	81	1	67	0.0149254
NODE_112493_length_350_cov_232.529880	25	92	83	1	67	0.0149254
NODE_112493_length_350_cov_232.529880	25	92	90	1	67	0.0149254
NODE_112493_length_350_cov_232.529880	25	92	99	4	67	0.0597015
NODE_112493_length_350_cov_232.529880	25	92	103	1	67	0.0149254
NODE_112493_length_350_cov_232.529880	25	92	108	1	67	0.0149254
NODE_112493_length_350_cov_232.529880	25	92	118	2	67	0.0298507
NODE_112493_length_350_cov_232.529880	25	92	126	2	67	0.0298507
NODE_112493_length_350_cov_232.529880	25	92	128	2	67	0.0298507
NODE_112493_length_350_cov_232.529880	25	92	134	1	67	0.0149254
NODE_112493_length_350_cov_232.529880	25	92	146	1	67	0.0149254
NODE_112493_length_350_cov_232.529880	25	92	148	1	67	0.0149254
NODE_112493_length_350_cov_232.529880	25	92	150	1	67	0.0149254
NODE_112493_length_350_cov_232.529880	25	92	152	2	67	0.0298507
NODE_112493_length_350_cov_232.529880	25	92	156	1	67	0.0149254
NODE_112493_length_350_cov_232.529880	25	92	158	3	67	0.0447761
NODE_112493_length_350_cov_232.529880	25	92	160	4	67	0.0597015
NODE_112493_length_350_cov_232.529880	25	92	166	1	67	0.0149254
NODE_112493_length_350_cov_232.529880	25	92	170	1	67	0.0149254
NODE_112493_length_350_cov_232.529880	25	92	179	1	67	0.0149254
NODE_112493_length_350_cov_232.529880	25	92	180	3	67	0.0447761
NODE_112493_length_350_cov_232.529880	25	92	182	2	67	0.0298507
NODE_112493_length_350_cov_232.529880	25	92	184	1	67	0.0149254
NODE_112493_length_350_cov_232.529880	25	92	186	4	67	0.0597015
NODE_112493_length_350_cov_232.529880	25	92	188	6	67	0.0895522
NODE_112493_length_350_cov_232.529880	25	92	190	6	67	0.0895522
NODE_112494_length_350_cov_40.677291	181	246	11	2	65	0.0307692
NODE_112494_length_350_cov_40.677291	181	246	16	3	65	0.0461538
NODE_112494_length_350_cov_40.677291	181	246	17	3	65	0.0461538
NODE_112494_length_350_cov_40.677291	181	246	19	5	65	0.0769231
NODE_112494_length_350_cov_40.677291	181	246	21	11	65	0.1692308
NODE_112494_length_350_cov_40.677291	181	246	22	5	65	0.0769231
NODE_112494_length_350_cov_40.677291	181	246	23	6	65	0.0923077
NODE_112494_length_350_cov_40.677291	181	246	25	30	65	0.4615385
NODE_112535_length_350_cov_4.179283	114	194	0	62	80	0.7750000
NODE_112535_length_350_cov_4.179283	114	194	4	18	80	0.2250000
NODE_112535_length_350_cov_4.179283	167	244	0	9	77	0.1168831
NODE_112535_length_350_cov_4.179283	167	244	4	21	77	0.2727273
NODE_112535_length_350_cov_4.179283	167	244	6	32	77	0.4155844
NODE_112535_length_350_cov_4.179283	167	244	12	15	77	0.1948052
NODE_112554_length_350_cov_3.573705	128	202	8	33	74	0.4459459
NODE_112554_length_350_cov_3.573705	128	202	11	6	74	0.0810811
NODE_112554_length_350_cov_3.573705	128	202	13	3	74	0.0405405
NODE_112554_length_350_cov_3.573705	128	202	15	5	74	0.0675676
NODE_112554_length_350_cov_3.573705	128	202	17	14	74	0.1891892
NODE_112554_length_350_cov_3.573705	128	202	19	13	74	0.1756757
NODE_112554_length_350_cov_3.573705	178	241	4	4	63	0.0634921
NODE_112554_length_350_cov_3.573705	178	241	6	6	63	0.0952381
NODE_112554_length_350_cov_3.573705	178	241	8	53	63	0.8412699
NODE_112627_length_350_cov_2.478088	266	297	2	31	31	1.0000000
NODE_112647_length_350_cov_2.346614	97	148	63	6	51	0.1176471
NODE_112647_length_350_cov_2.346614	97	148	64	1	51	0.0196078
NODE_112647_length_350_cov_2.346614	97	148	65	2	51	0.0392157
NODE_112647_length_350_cov_2.346614	97	148	66	2	51	0.0392157
NODE_112647_length_350_cov_2.346614	97	148	68	2	51	0.0392157
NODE_112647_length_350_cov_2.346614	97	148	69	2	51	0.0392157
NODE_112647_length_350_cov_2.346614	97	148	70	3	51	0.0588235
NODE_112647_length_350_cov_2.346614	97	148	71	2	51	0.0392157
NODE_112647_length_350_cov_2.346614	97	148	74	4	51	0.0784314
NODE_112647_length_350_cov_2.346614	97	148	76	2	51	0.0392157
NODE_112647_length_350_cov_2.346614	97	148	78	16	51	0.3137255
NODE_112647_length_350_cov_2.346614	97	148	80	9	51	0.1764706
NODE_112714_length_350_cov_2.031873	181	238	20	1	57	0.0175439
NODE_112714_length_350_cov_2.031873	181	238	22	5	57	0.0877193
NODE_112714_length_350_cov_2.031873	181	238	23	2	57	0.0350877
NODE_112714_length_350_cov_2.031873	181	238	24	4	57	0.0701754
NODE_112714_length_350_cov_2.031873	181	238	26	13	57	0.2280702
NODE_112714_length_350_cov_2.031873	181	238	28	32	57	0.5614035
NODE_112997_length_350_cov_1.223108	202	275	0	20	73	0.2739726
NODE_112997_length_350_cov_1.223108	202	275	4	21	73	0.2876712
NODE_112997_length_350_cov_1.223108	202	275	6	2	73	0.0273973
NODE_112997_length_350_cov_1.223108	202	275	8	3	73	0.0410959
NODE_112997_length_350_cov_1.223108	202	275	10	3	73	0.0410959
NODE_112997_length_350_cov_1.223108	202	275	16	3	73	0.0410959
NODE_112997_length_350_cov_1.223108	202	275	18	3	73	0.0410959
NODE_112997_length_350_cov_1.223108	202	275	20	2	73	0.0273973
NODE_112997_length_350_cov_1.223108	202	275	22	1	73	0.0136986
NODE_112997_length_350_cov_1.223108	202	275	24	2	73	0.0273973
NODE_112997_length_350_cov_1.223108	202	275	28	1	73	0.0136986
NODE_112997_length_350_cov_1.223108	202	275	30	6	73	0.0821918
NODE_112997_length_350_cov_1.223108	202	275	34	6	73	0.0821918
NODE_113450_length_349_cov_4.268000	83	163	0	17	80	0.2125000
NODE_113450_length_349_cov_4.268000	83	163	2	63	80	0.7875000
NODE_113450_length_349_cov_4.268000	83	163	0	17	80	0.2125000
NODE_113450_length_349_cov_4.268000	83	163	2	63	80	0.7875000
NODE_113450_length_349_cov_4.268000	136	216	0	70	80	0.8750000
NODE_113450_length_349_cov_4.268000	136	216	2	10	80	0.1250000
NODE_113450_length_349_cov_4.268000	145	180	0	34	35	0.9714286
NODE_113450_length_349_cov_4.268000	145	180	2	1	35	0.0285714
NODE_113473_length_349_cov_3.648000	219	300	7	8	81	0.0987654
NODE_113473_length_349_cov_3.648000	219	300	11	8	81	0.0987654
NODE_113473_length_349_cov_3.648000	219	300	12	10	81	0.1234568
NODE_113473_length_349_cov_3.648000	219	300	14	5	81	0.0617284
NODE_113473_length_349_cov_3.648000	219	300	16	5	81	0.0617284
NODE_113473_length_349_cov_3.648000	219	300	18	4	81	0.0493827
NODE_113473_length_349_cov_3.648000	219	300	22	25	81	0.3086420
NODE_113473_length_349_cov_3.648000	219	300	24	16	81	0.1975309
NODE_113480_length_349_cov_3.484000	196	276	4	37	80	0.4625000
NODE_113480_length_349_cov_3.484000	196	276	5	19	80	0.2375000
NODE_113480_length_349_cov_3.484000	196	276	8	24	80	0.3000000
NODE_113486_length_349_cov_3.364000	219	284	3	24	65	0.3692308
NODE_113486_length_349_cov_3.364000	219	284	4	41	65	0.6307693
NODE_113511_length_349_cov_2.916000	94	189	2	28	95	0.2947368
NODE_113511_length_349_cov_2.916000	94	189	6	51	95	0.5368421
NODE_113511_length_349_cov_2.916000	94	189	8	16	95	0.1684211
NODE_113571_length_349_cov_2.420000	35	54	0	19	19	1.0000000
NODE_113647_length_349_cov_1.964000	32	63	0	31	31	1.0000000
NODE_113654_length_349_cov_1.928000	9	77	2	3	68	0.0441176
NODE_113654_length_349_cov_1.928000	9	77	6	65	68	0.9558824
NODE_113654_length_349_cov_1.928000	62	115	0	38	53	0.7169811
NODE_113654_length_349_cov_1.928000	62	115	2	3	53	0.0566038
NODE_113654_length_349_cov_1.928000	62	115	6	12	53	0.2264151
NODE_113710_length_349_cov_1.684000	225	265	0	22	40	0.5500000
NODE_113710_length_349_cov_1.684000	225	265	2	7	40	0.1750000
NODE_113710_length_349_cov_1.684000	225	265	4	3	40	0.0750000
NODE_113710_length_349_cov_1.684000	225	265	6	2	40	0.0500000
NODE_113710_length_349_cov_1.684000	225	265	8	3	40	0.0750000
NODE_113710_length_349_cov_1.684000	225	265	10	3	40	0.0750000
NODE_113825_length_349_cov_1.392000	32	95	0	63	63	1.0000000
NODE_113961_length_349_cov_1.056000	316	339	0	23	23	1.0000000
NODE_114002_length_349_cov_1.020000	177	257	0	80	80	1.0000000
NODE_114263_length_348_cov_34.867470	156	236	0	80	80	1.0000000
NODE_114263_length_348_cov_34.867470	209	289	0	80	80	1.0000000
NODE_114296_length_348_cov_4.180723	106	186	0	80	80	1.0000000
NODE_114296_length_348_cov_4.180723	159	239	0	80	80	1.0000000
NODE_114330_length_348_cov_3.277108	83	137	0	54	54	1.0000000
NODE_114330_length_348_cov_3.277108	145	197	0	52	52	1.0000000
NODE_114424_length_348_cov_2.305221	204	273	4	69	69	1.0000000
NODE_114448_length_348_cov_2.216867	103	152	0	49	49	1.0000000
NODE_114505_length_348_cov_1.995984	170	239	0	69	69	1.0000000
NODE_114591_length_348_cov_1.638554	309	346	0	37	37	1.0000000
NODE_114643_length_348_cov_1.485944	9	60	0	51	51	1.0000000
NODE_115147_length_347_cov_15.100806	57	137	0	80	80	1.0000000
NODE_115147_length_347_cov_15.100806	110	152	0	42	42	1.0000000
NODE_115147_length_347_cov_15.100806	182	209	0	27	27	1.0000000
NODE_115147_length_347_cov_15.100806	290	317	0	27	27	1.0000000
NODE_115161_length_347_cov_5.967742	110	173	2	4	63	0.0634921
NODE_115161_length_347_cov_5.967742	110	173	4	59	63	0.9365079
NODE_115195_length_347_cov_4.028226	260	329	0	69	69	1.0000000
NODE_115321_length_347_cov_2.463710	99	141	2	42	42	1.0000000
NODE_115321_length_347_cov_2.463710	108	143	2	35	35	1.0000000
NODE_115331_length_347_cov_2.391129	35	70	2	35	35	1.0000000
NODE_115331_length_347_cov_2.391129	37	79	2	42	42	1.0000000
NODE_115331_length_347_cov_2.391129	77	105	0	2	28	0.0714286
NODE_115331_length_347_cov_2.391129	77	105	2	26	28	0.9285714
NODE_115397_length_347_cov_2.048387	15	34	0	19	19	1.0000000
NODE_115417_length_347_cov_1.967742	205	268	0	63	63	1.0000000
NODE_115450_length_347_cov_1.818548	109	156	0	47	47	1.0000000
NODE_115771_length_347_cov_1.028226	230	255	0	25	25	1.0000000
NODE_116114_length_346_cov_74.433198	10	90	0	3	80	0.0375000
NODE_116114_length_346_cov_74.433198	10	90	2	26	80	0.3250000
NODE_116114_length_346_cov_74.433198	10	90	8	15	80	0.1875000
NODE_116114_length_346_cov_74.433198	10	90	10	36	80	0.4500000
NODE_116114_length_346_cov_74.433198	19	90	2	20	71	0.2816902
NODE_116114_length_346_cov_74.433198	19	90	8	15	71	0.2112676
NODE_116114_length_346_cov_74.433198	19	90	10	36	71	0.5070422
NODE_116114_length_346_cov_74.433198	192	272	0	7	80	0.0875000
NODE_116114_length_346_cov_74.433198	192	272	2	26	80	0.3250000
NODE_116114_length_346_cov_74.433198	192	272	4	47	80	0.5875000
NODE_116115_length_346_cov_67.834008	133	213	0	80	80	1.0000000
NODE_116115_length_346_cov_67.834008	186	266	0	80	80	1.0000000
NODE_116117_length_346_cov_10.299595	190	270	0	15	80	0.1875000
NODE_116117_length_346_cov_10.299595	190	270	2	65	80	0.8125000
NODE_116117_length_346_cov_10.299595	243	323	0	68	80	0.8500000
NODE_116117_length_346_cov_10.299595	243	323	2	12	80	0.1500000
NODE_116119_length_346_cov_9.566802	159	239	0	80	80	1.0000000
NODE_116119_length_346_cov_9.566802	212	292	0	80	80	1.0000000
NODE_116134_length_346_cov_5.506073	157	238	2	19	81	0.2345679
NODE_116134_length_346_cov_5.506073	157	238	6	15	81	0.1851852
NODE_116134_length_346_cov_5.506073	157	238	10	33	81	0.4074074
NODE_116134_length_346_cov_5.506073	157	238	12	14	81	0.1728395
NODE_116155_length_346_cov_4.368421	205	264	0	59	59	1.0000000
NODE_116159_length_346_cov_4.032389	121	141	0	20	20	1.0000000
NODE_116184_length_346_cov_3.400810	194	253	0	59	59	1.0000000
NODE_116212_length_346_cov_3.008097	183	263	0	80	80	1.0000000
NODE_116257_length_346_cov_2.538462	47	102	0	55	55	1.0000000
NODE_116257_length_346_cov_2.538462	118	173	0	55	55	1.0000000
NODE_116439_length_346_cov_1.700405	71	107	0	36	36	1.0000000
NODE_117035_length_345_cov_47.699187	0	66	0	66	66	1.0000000
NODE_117035_length_345_cov_47.699187	39	119	0	80	80	1.0000000
NODE_117035_length_345_cov_47.699187	115	182	0	52	67	0.7761194
NODE_117035_length_345_cov_47.699187	115	182	3	3	67	0.0447761
NODE_117035_length_345_cov_47.699187	115	182	6	12	67	0.1791045
NODE_117035_length_345_cov_47.699187	246	311	6	65	65	1.0000000
NODE_117036_length_345_cov_13.439024	28	108	0	80	80	1.0000000
NODE_117036_length_345_cov_13.439024	81	161	0	80	80	1.0000000
NODE_117037_length_345_cov_9.906504	224	283	0	59	59	1.0000000
NODE_117051_length_345_cov_5.475610	52	132	0	21	80	0.2625000
NODE_117051_length_345_cov_5.475610	52	132	1	12	80	0.1500000
NODE_117051_length_345_cov_5.475610	52	132	3	47	80	0.5875000
NODE_117051_length_345_cov_5.475610	105	185	0	15	80	0.1875000
NODE_117051_length_345_cov_5.475610	105	185	1	21	80	0.2625000
NODE_117051_length_345_cov_5.475610	105	185	2	44	80	0.5500000
NODE_117055_length_345_cov_5.321138	104	152	0	48	48	1.0000000
NODE_117065_length_345_cov_4.524390	205	269	0	64	64	1.0000000
NODE_117075_length_345_cov_4.109756	95	157	0	62	62	1.0000000
NODE_117075_length_345_cov_4.109756	162	204	0	17	42	0.4047619
NODE_117075_length_345_cov_4.109756	162	204	2	25	42	0.5952381
NODE_117076_length_345_cov_4.073171	251	326	0	75	75	1.0000000
NODE_117084_length_345_cov_3.776423	199	273	0	2	74	0.0270270
NODE_117084_length_345_cov_3.776423	199	273	2	4	74	0.0540541
NODE_117084_length_345_cov_3.776423	199	273	4	68	74	0.9189189
NODE_117084_length_345_cov_3.776423	246	326	0	44	80	0.5500000
NODE_117084_length_345_cov_3.776423	246	326	2	4	80	0.0500000
NODE_117084_length_345_cov_3.776423	246	326	4	32	80	0.4000000
NODE_117148_length_345_cov_2.821138	61	141	6	2	80	0.0250000
NODE_117148_length_345_cov_2.821138	61	141	8	20	80	0.2500000
NODE_117148_length_345_cov_2.821138	61	141	10	58	80	0.7250000
NODE_117205_length_345_cov_2.333333	47	90	8	1	43	0.0232558
NODE_117205_length_345_cov_2.333333	47	90	10	1	43	0.0232558
NODE_117205_length_345_cov_2.333333	47	90	12	4	43	0.0930233
NODE_117205_length_345_cov_2.333333	47	90	13	2	43	0.0465116
NODE_117205_length_345_cov_2.333333	47	90	17	8	43	0.1860465
NODE_117205_length_345_cov_2.333333	47	90	18	1	43	0.0232558
NODE_117205_length_345_cov_2.333333	47	90	20	2	43	0.0465116
NODE_117205_length_345_cov_2.333333	47	90	22	3	43	0.0697674
NODE_117205_length_345_cov_2.333333	47	90	26	2	43	0.0465116
NODE_117205_length_345_cov_2.333333	47	90	28	3	43	0.0697674
NODE_117205_length_345_cov_2.333333	47	90	32	16	43	0.3720930
NODE_117205_length_345_cov_2.333333	63	147	18	1	84	0.0119048
NODE_117205_length_345_cov_2.333333	63	147	20	2	84	0.0238095
NODE_117205_length_345_cov_2.333333	63	147	22	3	84	0.0357143
NODE_117205_length_345_cov_2.333333	63	147	26	2	84	0.0238095
NODE_117205_length_345_cov_2.333333	63	147	28	3	84	0.0357143
NODE_117205_length_345_cov_2.333333	63	147	30	4	84	0.0476190
NODE_117205_length_345_cov_2.333333	63	147	32	25	84	0.2976190
NODE_117205_length_345_cov_2.333333	63	147	34	7	84	0.0833333
NODE_117205_length_345_cov_2.333333	63	147	36	12	84	0.1428571
NODE_117205_length_345_cov_2.333333	63	147	38	25	84	0.2976190
NODE_117219_length_345_cov_2.239837	0	81	1	2	81	0.0246914
NODE_117219_length_345_cov_2.239837	0	81	3	1	81	0.0123457
NODE_117219_length_345_cov_2.239837	0	81	5	6	81	0.0740741
NODE_117219_length_345_cov_2.239837	0	81	6	7	81	0.0864198
NODE_117219_length_345_cov_2.239837	0	81	9	1	81	0.0123457
NODE_117219_length_345_cov_2.239837	0	81	10	8	81	0.0987654
NODE_117219_length_345_cov_2.239837	0	81	12	4	81	0.0493827
NODE_117219_length_345_cov_2.239837	0	81	14	1	81	0.0123457
NODE_117219_length_345_cov_2.239837	0	81	16	10	81	0.1234568
NODE_117219_length_345_cov_2.239837	0	81	18	1	81	0.0123457
NODE_117219_length_345_cov_2.239837	0	81	20	3	81	0.0370370
NODE_117219_length_345_cov_2.239837	0	81	24	3	81	0.0370370
NODE_117219_length_345_cov_2.239837	0	81	26	6	81	0.0740741
NODE_117219_length_345_cov_2.239837	0	81	28	28	81	0.3456790
NODE_117669_length_345_cov_1.040650	6	73	4	18	67	0.2686567
NODE_117669_length_345_cov_1.040650	6	73	7	2	67	0.0298507
NODE_117669_length_345_cov_1.040650	6	73	8	10	67	0.1492537
NODE_117669_length_345_cov_1.040650	6	73	10	14	67	0.2089552
NODE_117669_length_345_cov_1.040650	6	73	12	1	67	0.0149254
NODE_117669_length_345_cov_1.040650	6	73	13	3	67	0.0447761
NODE_117669_length_345_cov_1.040650	6	73	14	5	67	0.0746269
NODE_117669_length_345_cov_1.040650	6	73	15	14	67	0.2089552
NODE_117989_length_344_cov_54.020408	6	55	0	28	49	0.5714286
NODE_117989_length_344_cov_54.020408	6	55	2	21	49	0.4285714
NODE_117989_length_344_cov_54.020408	28	105	0	6	77	0.0779221
NODE_117989_length_344_cov_54.020408	28	105	2	36	77	0.4675325
NODE_117989_length_344_cov_54.020408	28	105	3	4	77	0.0519481
NODE_117989_length_344_cov_54.020408	28	105	4	31	77	0.4025974
NODE_117989_length_344_cov_54.020408	28	105	0	6	77	0.0779221
NODE_117989_length_344_cov_54.020408	28	105	2	36	77	0.4675325
NODE_117989_length_344_cov_54.020408	28	105	3	4	77	0.0519481
NODE_117989_length_344_cov_54.020408	28	105	4	31	77	0.4025974
NODE_117989_length_344_cov_54.020408	112	178	6	28	66	0.4242424
NODE_117989_length_344_cov_54.020408	112	178	7	4	66	0.0606061
NODE_117989_length_344_cov_54.020408	112	178	8	27	66	0.4090909
NODE_117989_length_344_cov_54.020408	112	178	9	3	66	0.0454545
NODE_117989_length_344_cov_54.020408	112	178	10	4	66	0.0606061
NODE_118009_length_344_cov_5.016327	72	125	15	1	53	0.0188679
NODE_118009_length_344_cov_5.016327	72	125	16	2	53	0.0377358
NODE_118009_length_344_cov_5.016327	72	125	19	3	53	0.0566038
NODE_118009_length_344_cov_5.016327	72	125	21	1	53	0.0188679
NODE_118009_length_344_cov_5.016327	72	125	23	5	53	0.0943396
NODE_118009_length_344_cov_5.016327	72	125	25	1	53	0.0188679
NODE_118009_length_344_cov_5.016327	72	125	27	2	53	0.0377358
NODE_118009_length_344_cov_5.016327	72	125	29	4	53	0.0754717
NODE_118009_length_344_cov_5.016327	72	125	30	1	53	0.0188679
NODE_118009_length_344_cov_5.016327	72	125	34	1	53	0.0188679
NODE_118009_length_344_cov_5.016327	72	125	36	32	53	0.6037736
NODE_118009_length_344_cov_5.016327	136	203	8	4	67	0.0597015
NODE_118009_length_344_cov_5.016327	136	203	10	6	67	0.0895522
NODE_118009_length_344_cov_5.016327	136	203	12	7	67	0.1044776
NODE_118009_length_344_cov_5.016327	136	203	13	1	67	0.0149254
NODE_118009_length_344_cov_5.016327	136	203	15	2	67	0.0298507
NODE_118009_length_344_cov_5.016327	136	203	17	4	67	0.0597015
NODE_118009_length_344_cov_5.016327	136	203	19	4	67	0.0597015
NODE_118009_length_344_cov_5.016327	136	203	21	3	67	0.0447761
NODE_118009_length_344_cov_5.016327	136	203	23	5	67	0.0746269
NODE_118009_length_344_cov_5.016327	136	203	25	4	67	0.0597015
NODE_118009_length_344_cov_5.016327	136	203	26	5	67	0.0746269
NODE_118009_length_344_cov_5.016327	136	203	28	2	67	0.0298507
NODE_118009_length_344_cov_5.016327	136	203	30	12	67	0.1791045
NODE_118009_length_344_cov_5.016327	136	203	32	7	67	0.1044776
NODE_118009_length_344_cov_5.016327	136	203	36	1	67	0.0149254
NODE_118017_length_344_cov_4.579592	172	254	0	82	82	1.0000000
NODE_118045_length_344_cov_3.840816	197	240	0	43	43	1.0000000
NODE_118074_length_344_cov_3.293878	149	189	4	40	40	1.0000000
NODE_118074_length_344_cov_3.293878	162	229	4	67	67	1.0000000
NODE_118111_length_344_cov_2.751020	24	87	2	63	63	1.0000000
NODE_118179_length_344_cov_2.126531	274	305	0	31	31	1.0000000
NODE_118243_length_344_cov_1.914286	114	194	0	55	80	0.6875000
NODE_118243_length_344_cov_1.914286	114	194	1	25	80	0.3125000
NODE_118243_length_344_cov_1.914286	167	247	0	63	80	0.7875000
NODE_118243_length_344_cov_1.914286	167	247	2	17	80	0.2125000
NODE_118297_length_344_cov_1.685714	180	220	1	40	40	1.0000000
NODE_118393_length_344_cov_1.457143	160	240	15	4	80	0.0500000
NODE_118393_length_344_cov_1.457143	160	240	16	4	80	0.0500000
NODE_118393_length_344_cov_1.457143	160	240	17	18	80	0.2250000
NODE_118393_length_344_cov_1.457143	160	240	19	23	80	0.2875000
NODE_118393_length_344_cov_1.457143	160	240	21	2	80	0.0250000
NODE_118393_length_344_cov_1.457143	160	240	23	4	80	0.0500000
NODE_118393_length_344_cov_1.457143	160	240	25	11	80	0.1375000
NODE_118393_length_344_cov_1.457143	160	240	27	14	80	0.1750000
NODE_118393_length_344_cov_1.457143	213	273	6	8	60	0.1333333
NODE_118393_length_344_cov_1.457143	213	273	7	2	60	0.0333333
NODE_118393_length_344_cov_1.457143	213	273	9	1	60	0.0166667
NODE_118393_length_344_cov_1.457143	213	273	11	5	60	0.0833333
NODE_118393_length_344_cov_1.457143	213	273	13	6	60	0.1000000
NODE_118393_length_344_cov_1.457143	213	273	14	7	60	0.1166667
NODE_118393_length_344_cov_1.457143	213	273	15	8	60	0.1333333
NODE_118393_length_344_cov_1.457143	213	273	16	4	60	0.0666667
NODE_118393_length_344_cov_1.457143	213	273	17	5	60	0.0833333
NODE_118393_length_344_cov_1.457143	213	273	19	2	60	0.0333333
NODE_118393_length_344_cov_1.457143	213	273	21	2	60	0.0333333
NODE_118393_length_344_cov_1.457143	213	273	25	10	60	0.1666667
NODE_118743_length_344_cov_0.800000	123	163	0	40	40	1.0000000
NODE_118899_length_343_cov_3.770492	2	60	0	58	58	1.0000000
NODE_118905_length_343_cov_3.598361	97	170	3	2	73	0.0273973
NODE_118905_length_343_cov_3.598361	97	170	4	9	73	0.1232877
NODE_118905_length_343_cov_3.598361	97	170	8	13	73	0.1780822
NODE_118905_length_343_cov_3.598361	97	170	10	49	73	0.6712329
NODE_118905_length_343_cov_3.598361	150	223	0	1	73	0.0136986
NODE_118905_length_343_cov_3.598361	150	223	4	22	73	0.3013699
NODE_118905_length_343_cov_3.598361	150	223	6	10	73	0.1369863
NODE_118905_length_343_cov_3.598361	150	223	10	40	73	0.5479452
NODE_118911_length_343_cov_3.401639	48	128	20	3	80	0.0375000
NODE_118911_length_343_cov_3.401639	48	128	22	2	80	0.0250000
NODE_118911_length_343_cov_3.401639	48	128	23	3	80	0.0375000
NODE_118911_length_343_cov_3.401639	48	128	25	1	80	0.0125000
NODE_118911_length_343_cov_3.401639	48	128	28	2	80	0.0250000
NODE_118911_length_343_cov_3.401639	48	128	30	4	80	0.0500000
NODE_118911_length_343_cov_3.401639	48	128	33	3	80	0.0375000
NODE_118911_length_343_cov_3.401639	48	128	34	5	80	0.0625000
NODE_118911_length_343_cov_3.401639	48	128	35	2	80	0.0250000
NODE_118911_length_343_cov_3.401639	48	128	37	3	80	0.0375000
NODE_118911_length_343_cov_3.401639	48	128	38	4	80	0.0500000
NODE_118911_length_343_cov_3.401639	48	128	44	1	80	0.0125000
NODE_118911_length_343_cov_3.401639	48	128	45	3	80	0.0375000
NODE_118911_length_343_cov_3.401639	48	128	46	1	80	0.0125000
NODE_118911_length_343_cov_3.401639	48	128	50	3	80	0.0375000
NODE_118911_length_343_cov_3.401639	48	128	51	22	80	0.2750000
NODE_118911_length_343_cov_3.401639	48	128	53	2	80	0.0250000
NODE_118911_length_343_cov_3.401639	48	128	55	2	80	0.0250000
NODE_118911_length_343_cov_3.401639	48	128	57	6	80	0.0750000
NODE_118911_length_343_cov_3.401639	48	128	58	1	80	0.0125000
NODE_118911_length_343_cov_3.401639	48	128	59	7	80	0.0875000
NODE_118941_length_343_cov_3.049180	12	62	0	50	50	1.0000000
NODE_118941_length_343_cov_3.049180	82	111	0	10	29	0.3448276
NODE_118941_length_343_cov_3.049180	82	111	2	19	29	0.6551724
NODE_118941_length_343_cov_3.049180	133	205	2	16	72	0.2222222
NODE_118941_length_343_cov_3.049180	133	205	4	43	72	0.5972222
NODE_118941_length_343_cov_3.049180	133	205	6	13	72	0.1805556
NODE_118957_length_343_cov_2.770492	236	316	6	1	80	0.0125000
NODE_118957_length_343_cov_2.770492	236	316	13	4	80	0.0500000
NODE_118957_length_343_cov_2.770492	236	316	15	6	80	0.0750000
NODE_118957_length_343_cov_2.770492	236	316	18	22	80	0.2750000
NODE_118957_length_343_cov_2.770492	236	316	20	2	80	0.0250000
NODE_118957_length_343_cov_2.770492	236	316	24	8	80	0.1000000
NODE_118957_length_343_cov_2.770492	236	316	26	2	80	0.0250000
NODE_118957_length_343_cov_2.770492	236	316	28	1	80	0.0125000
NODE_118957_length_343_cov_2.770492	236	316	32	5	80	0.0625000
NODE_118957_length_343_cov_2.770492	236	316	34	13	80	0.1625000
NODE_118957_length_343_cov_2.770492	236	316	38	6	80	0.0750000
NODE_118957_length_343_cov_2.770492	236	316	39	2	80	0.0250000
NODE_118957_length_343_cov_2.770492	236	316	40	8	80	0.1000000
NODE_118978_length_343_cov_2.590164	167	225	4	19	58	0.3275862
NODE_118978_length_343_cov_2.590164	167	225	6	29	58	0.5000000
NODE_118978_length_343_cov_2.590164	167	225	8	10	58	0.1724138
NODE_118998_length_343_cov_2.430328	208	274	0	12	66	0.1818182
NODE_118998_length_343_cov_2.430328	208	274	2	18	66	0.2727273
NODE_118998_length_343_cov_2.430328	208	274	6	33	66	0.5000000
NODE_118998_length_343_cov_2.430328	208	274	8	3	66	0.0454545
NODE_119040_length_343_cov_2.209016	32	111	0	38	79	0.4810127
NODE_119040_length_343_cov_2.209016	32	111	2	33	79	0.4177215
NODE_119040_length_343_cov_2.209016	32	111	4	1	79	0.0126582
NODE_119040_length_343_cov_2.209016	32	111	6	7	79	0.0886076
NODE_119067_length_343_cov_2.081967	95	177	0	82	82	1.0000000
NODE_119067_length_343_cov_2.081967	150	199	0	49	49	1.0000000
NODE_119202_length_343_cov_1.635246	0	52	2	41	52	0.7884616
NODE_119202_length_343_cov_1.635246	0	52	4	11	52	0.2115385
NODE_119439_length_343_cov_1.143443	60	120	0	60	60	1.0000000
NODE_119834_length_342_cov_3.872428	136	216	4	39	80	0.4875000
NODE_119834_length_342_cov_3.872428	136	216	5	3	80	0.0375000
NODE_119834_length_342_cov_3.872428	136	216	6	30	80	0.3750000
NODE_119834_length_342_cov_3.872428	136	216	10	8	80	0.1000000
NODE_119834_length_342_cov_3.872428	189	259	6	32	70	0.4571429
NODE_119834_length_342_cov_3.872428	189	259	7	5	70	0.0714286
NODE_119834_length_342_cov_3.872428	189	259	8	1	70	0.0142857
NODE_119834_length_342_cov_3.872428	189	259	9	17	70	0.2428571
NODE_119834_length_342_cov_3.872428	189	259	10	15	70	0.2142857
NODE_119840_length_342_cov_3.769547	146	212	0	66	66	1.0000000
NODE_119841_length_342_cov_3.740741	113	146	0	33	33	1.0000000
NODE_119846_length_342_cov_3.674897	20	100	0	78	80	0.9750000
NODE_119846_length_342_cov_3.674897	20	100	4	2	80	0.0250000
NODE_119846_length_342_cov_3.674897	73	153	0	25	80	0.3125000
NODE_119846_length_342_cov_3.674897	73	153	4	55	80	0.6875000
NODE_119847_length_342_cov_3.588477	117	197	0	18	80	0.2250000
NODE_119847_length_342_cov_3.588477	117	197	4	62	80	0.7750000
NODE_119849_length_342_cov_3.530864	72	151	0	7	79	0.0886076
NODE_119849_length_342_cov_3.530864	72	151	2	72	79	0.9113924
NODE_119852_length_342_cov_3.423868	172	252	6	80	80	1.0000000
NODE_119852_length_342_cov_3.423868	225	283	0	2	58	0.0344828
NODE_119852_length_342_cov_3.423868	225	283	2	1	58	0.0172414
NODE_119852_length_342_cov_3.423868	225	283	6	55	58	0.9482759
NODE_119922_length_342_cov_2.432099	16	81	0	65	65	1.0000000
NODE_119993_length_342_cov_2.049383	249	317	2	68	68	1.0000000
NODE_120047_length_342_cov_1.864198	138	190	4	2	52	0.0384615
NODE_120047_length_342_cov_1.864198	138	190	6	6	52	0.1153846
NODE_120047_length_342_cov_1.864198	138	190	8	7	52	0.1346154
NODE_120047_length_342_cov_1.864198	138	190	10	37	52	0.7115384
NODE_120047_length_342_cov_1.864198	183	243	4	20	60	0.3333333
NODE_120047_length_342_cov_1.864198	183	243	6	2	60	0.0333333
NODE_120047_length_342_cov_1.864198	183	243	8	6	60	0.1000000
NODE_120047_length_342_cov_1.864198	183	243	10	32	60	0.5333334
NODE_120073_length_342_cov_1.720165	91	147	14	39	56	0.6964286
NODE_120073_length_342_cov_1.720165	91	147	16	2	56	0.0357143
NODE_120073_length_342_cov_1.720165	91	147	18	15	56	0.2678571
NODE_120284_length_342_cov_1.271605	201	240	0	39	39	1.0000000
NODE_120755_length_341_cov_15.896694	50	130	0	28	80	0.3500000
NODE_120755_length_341_cov_15.896694	50	130	2	52	80	0.6500000
NODE_120755_length_341_cov_15.896694	103	183	0	41	80	0.5125000
NODE_120755_length_341_cov_15.896694	103	183	2	39	80	0.4875000
NODE_120757_length_341_cov_9.756198	117	196	0	79	79	1.0000000
NODE_120770_length_341_cov_5.404959	141	220	0	12	79	0.1518987
NODE_120770_length_341_cov_5.404959	141	220	2	55	79	0.6962025
NODE_120770_length_341_cov_5.404959	141	220	4	5	79	0.0632911
NODE_120770_length_341_cov_5.404959	141	220	6	2	79	0.0253165
NODE_120770_length_341_cov_5.404959	141	220	8	3	79	0.0379747
NODE_120770_length_341_cov_5.404959	141	220	10	2	79	0.0253165
NODE_120780_length_341_cov_4.669421	301	320	0	19	19	1.0000000
NODE_120783_length_341_cov_4.438017	57	132	0	9	75	0.1200000
NODE_120783_length_341_cov_4.438017	57	132	2	4	75	0.0533333
NODE_120783_length_341_cov_4.438017	57	132	6	62	75	0.8266667
NODE_120783_length_341_cov_4.438017	110	185	2	9	75	0.1200000
NODE_120783_length_341_cov_4.438017	110	185	6	57	75	0.7600000
NODE_120783_length_341_cov_4.438017	110	185	8	9	75	0.1200000
NODE_120785_length_341_cov_4.400826	164	244	0	80	80	1.0000000
NODE_120785_length_341_cov_4.400826	224	297	0	73	73	1.0000000
NODE_120797_length_341_cov_3.896694	58	122	2	2	64	0.0312500
NODE_120797_length_341_cov_3.896694	58	122	4	1	64	0.0156250
NODE_120797_length_341_cov_3.896694	58	122	5	1	64	0.0156250
NODE_120797_length_341_cov_3.896694	58	122	6	1	64	0.0156250
NODE_120797_length_341_cov_3.896694	58	122	8	3	64	0.0468750
NODE_120797_length_341_cov_3.896694	58	122	10	5	64	0.0781250
NODE_120797_length_341_cov_3.896694	58	122	12	3	64	0.0468750
NODE_120797_length_341_cov_3.896694	58	122	14	1	64	0.0156250
NODE_120797_length_341_cov_3.896694	58	122	19	2	64	0.0312500
NODE_120797_length_341_cov_3.896694	58	122	23	1	64	0.0156250
NODE_120797_length_341_cov_3.896694	58	122	24	3	64	0.0468750
NODE_120797_length_341_cov_3.896694	58	122	25	1	64	0.0156250
NODE_120797_length_341_cov_3.896694	58	122	28	2	64	0.0312500
NODE_120797_length_341_cov_3.896694	58	122	33	1	64	0.0156250
NODE_120797_length_341_cov_3.896694	58	122	35	6	64	0.0937500
NODE_120797_length_341_cov_3.896694	58	122	37	8	64	0.1250000
NODE_120797_length_341_cov_3.896694	58	122	38	3	64	0.0468750
NODE_120797_length_341_cov_3.896694	58	122	40	3	64	0.0468750
NODE_120797_length_341_cov_3.896694	58	122	41	1	64	0.0156250
NODE_120797_length_341_cov_3.896694	58	122	42	2	64	0.0312500
NODE_120797_length_341_cov_3.896694	58	122	45	1	64	0.0156250
NODE_120797_length_341_cov_3.896694	58	122	47	1	64	0.0156250
NODE_120797_length_341_cov_3.896694	58	122	51	1	64	0.0156250
NODE_120797_length_341_cov_3.896694	58	122	53	1	64	0.0156250
NODE_120797_length_341_cov_3.896694	58	122	54	1	64	0.0156250
NODE_120797_length_341_cov_3.896694	58	122	66	3	64	0.0468750
NODE_120797_length_341_cov_3.896694	58	122	67	2	64	0.0312500
NODE_120797_length_341_cov_3.896694	58	122	68	3	64	0.0468750
NODE_120797_length_341_cov_3.896694	58	122	72	1	64	0.0156250
NODE_120805_length_341_cov_3.727273	191	273	10	19	82	0.2317073
NODE_120805_length_341_cov_3.727273	191	273	12	9	82	0.1097561
NODE_120805_length_341_cov_3.727273	191	273	14	49	82	0.5975610
NODE_120805_length_341_cov_3.727273	191	273	16	5	82	0.0609756
NODE_120805_length_341_cov_3.727273	253	326	4	2	73	0.0273973
NODE_120805_length_341_cov_3.727273	253	326	6	4	73	0.0547945
NODE_120805_length_341_cov_3.727273	253	326	8	2	73	0.0273973
NODE_120805_length_341_cov_3.727273	253	326	12	47	73	0.6438356
NODE_120805_length_341_cov_3.727273	253	326	14	18	73	0.2465753
NODE_120839_length_341_cov_3.000000	91	161	0	70	70	1.0000000
NODE_120839_length_341_cov_3.000000	146	215	0	69	69	1.0000000
NODE_120840_length_341_cov_3.000000	127	207	0	80	80	1.0000000
NODE_120892_length_341_cov_2.533058	92	172	0	80	80	1.0000000
NODE_120901_length_341_cov_2.495868	8	89	2	81	81	1.0000000
NODE_120946_length_341_cov_2.235537	10	90	0	80	80	1.0000000
NODE_120972_length_341_cov_2.103306	46	125	0	25	79	0.3164557
NODE_120972_length_341_cov_2.103306	46	125	2	48	79	0.6075949
NODE_120972_length_341_cov_2.103306	46	125	4	6	79	0.0759494
NODE_120994_length_341_cov_2.066116	147	184	13	3	37	0.0810811
NODE_120994_length_341_cov_2.066116	147	184	15	30	37	0.8108108
NODE_120994_length_341_cov_2.066116	147	184	17	4	37	0.1081081
NODE_121052_length_341_cov_1.772727	179	250	0	18	71	0.2535211
NODE_121052_length_341_cov_1.772727	179	250	2	53	71	0.7464789
NODE_121064_length_341_cov_1.727273	105	185	0	16	80	0.2000000
NODE_121064_length_341_cov_1.727273	105	185	2	20	80	0.2500000
NODE_121064_length_341_cov_1.727273	105	185	4	44	80	0.5500000
NODE_121160_length_341_cov_1.475207	120	185	8	31	65	0.4769231
NODE_121160_length_341_cov_1.475207	120	185	10	34	65	0.5230770
NODE_121160_length_341_cov_1.475207	158	238	8	13	80	0.1625000
NODE_121160_length_341_cov_1.475207	158	238	10	46	80	0.5750000
NODE_121160_length_341_cov_1.475207	158	238	12	21	80	0.2625000
NODE_121173_length_341_cov_1.471074	186	266	0	62	80	0.7750000
NODE_121173_length_341_cov_1.471074	186	266	2	18	80	0.2250000
NODE_121173_length_341_cov_1.471074	239	319	0	13	80	0.1625000
NODE_121173_length_341_cov_1.471074	239	319	2	67	80	0.8375000
NODE_121211_length_341_cov_1.342975	284	322	0	10	38	0.2631579
NODE_121211_length_341_cov_1.342975	284	322	2	28	38	0.7368421
NODE_121431_length_341_cov_0.991736	36	89	0	3	53	0.0566038
NODE_121431_length_341_cov_0.991736	36	89	2	50	53	0.9433962
NODE_121693_length_340_cov_541.348548	86	144	766	1	58	0.0172414
NODE_121693_length_340_cov_541.348548	86	144	774	1	58	0.0172414
NODE_121693_length_340_cov_541.348548	86	144	798	1	58	0.0172414
NODE_121693_length_340_cov_541.348548	86	144	811	1	58	0.0172414
NODE_121693_length_340_cov_541.348548	86	144	835	1	58	0.0172414
NODE_121693_length_340_cov_541.348548	86	144	840	1	58	0.0172414
NODE_121693_length_340_cov_541.348548	86	144	879	1	58	0.0172414
NODE_121693_length_340_cov_541.348548	86	144	890	1	58	0.0172414
NODE_121693_length_340_cov_541.348548	86	144	905	1	58	0.0172414
NODE_121693_length_340_cov_541.348548	86	144	956	1	58	0.0172414
NODE_121693_length_340_cov_541.348548	86	144	986	1	58	0.0172414
NODE_121693_length_340_cov_541.348548	86	144	1004	1	58	0.0172414
NODE_121693_length_340_cov_541.348548	86	144	1043	1	58	0.0172414
NODE_121693_length_340_cov_541.348548	86	144	1103	1	58	0.0172414
NODE_121693_length_340_cov_541.348548	86	144	1143	1	58	0.0172414
NODE_121693_length_340_cov_541.348548	86	144	1161	1	58	0.0172414
NODE_121693_length_340_cov_541.348548	86	144	1209	1	58	0.0172414
NODE_121693_length_340_cov_541.348548	86	144	1227	1	58	0.0172414
NODE_121693_length_340_cov_541.348548	86	144	1236	1	58	0.0172414
NODE_121693_length_340_cov_541.348548	86	144	1264	1	58	0.0172414
NODE_121693_length_340_cov_541.348548	86	144	1289	1	58	0.0172414
NODE_121693_length_340_cov_541.348548	86	144	1337	1	58	0.0172414
NODE_121693_length_340_cov_541.348548	86	144	1342	1	58	0.0172414
NODE_121693_length_340_cov_541.348548	86	144	1352	1	58	0.0172414
NODE_121693_length_340_cov_541.348548	86	144	1367	1	58	0.0172414
NODE_121693_length_340_cov_541.348548	86	144	1383	1	58	0.0172414
NODE_121693_length_340_cov_541.348548	86	144	1424	1	58	0.0172414
NODE_121693_length_340_cov_541.348548	86	144	1428	1	58	0.0172414
NODE_121693_length_340_cov_541.348548	86	144	1440	1	58	0.0172414
NODE_121693_length_340_cov_541.348548	86	144	1450	1	58	0.0172414
NODE_121693_length_340_cov_541.348548	86	144	1498	1	58	0.0172414
NODE_121693_length_340_cov_541.348548	86	144	1509	1	58	0.0172414
NODE_121693_length_340_cov_541.348548	86	144	1516	1	58	0.0172414
NODE_121693_length_340_cov_541.348548	86	144	1540	1	58	0.0172414
NODE_121693_length_340_cov_541.348548	86	144	1566	1	58	0.0172414
NODE_121693_length_340_cov_541.348548	86	144	1577	1	58	0.0172414
NODE_121693_length_340_cov_541.348548	86	144	1585	1	58	0.0172414
NODE_121693_length_340_cov_541.348548	86	144	1589	1	58	0.0172414
NODE_121693_length_340_cov_541.348548	86	144	1617	1	58	0.0172414
NODE_121693_length_340_cov_541.348548	86	144	1648	1	58	0.0172414
NODE_121693_length_340_cov_541.348548	86	144	1690	1	58	0.0172414
NODE_121693_length_340_cov_541.348548	86	144	1710	1	58	0.0172414
NODE_121693_length_340_cov_541.348548	86	144	1731	1	58	0.0172414
NODE_121693_length_340_cov_541.348548	86	144	1765	1	58	0.0172414
NODE_121693_length_340_cov_541.348548	86	144	1776	1	58	0.0172414
NODE_121693_length_340_cov_541.348548	86	144	1806	1	58	0.0172414
NODE_121693_length_340_cov_541.348548	86	144	1818	1	58	0.0172414
NODE_121693_length_340_cov_541.348548	86	144	1821	1	58	0.0172414
NODE_121693_length_340_cov_541.348548	86	144	1841	1	58	0.0172414
NODE_121693_length_340_cov_541.348548	86	144	1888	1	58	0.0172414
NODE_121693_length_340_cov_541.348548	86	144	1929	1	58	0.0172414
NODE_121693_length_340_cov_541.348548	86	144	1949	1	58	0.0172414
NODE_121693_length_340_cov_541.348548	86	144	1988	1	58	0.0172414
NODE_121693_length_340_cov_541.348548	86	144	2010	1	58	0.0172414
NODE_121693_length_340_cov_541.348548	86	144	2038	1	58	0.0172414
NODE_121693_length_340_cov_541.348548	86	144	2061	1	58	0.0172414
NODE_121693_length_340_cov_541.348548	86	144	2091	1	58	0.0172414
NODE_121693_length_340_cov_541.348548	86	144	2120	1	58	0.0172414
NODE_121693_length_340_cov_541.348548	86	154	766	1	68	0.0147059
NODE_121693_length_340_cov_541.348548	86	154	774	1	68	0.0147059
NODE_121693_length_340_cov_541.348548	86	154	798	1	68	0.0147059
NODE_121693_length_340_cov_541.348548	86	154	811	1	68	0.0147059
NODE_121693_length_340_cov_541.348548	86	154	835	1	68	0.0147059
NODE_121693_length_340_cov_541.348548	86	154	840	1	68	0.0147059
NODE_121693_length_340_cov_541.348548	86	154	879	1	68	0.0147059
NODE_121693_length_340_cov_541.348548	86	154	890	1	68	0.0147059
NODE_121693_length_340_cov_541.348548	86	154	905	1	68	0.0147059
NODE_121693_length_340_cov_541.348548	86	154	956	1	68	0.0147059
NODE_121693_length_340_cov_541.348548	86	154	986	1	68	0.0147059
NODE_121693_length_340_cov_541.348548	86	154	1004	1	68	0.0147059
NODE_121693_length_340_cov_541.348548	86	154	1043	1	68	0.0147059
NODE_121693_length_340_cov_541.348548	86	154	1103	1	68	0.0147059
NODE_121693_length_340_cov_541.348548	86	154	1143	1	68	0.0147059
NODE_121693_length_340_cov_541.348548	86	154	1161	1	68	0.0147059
NODE_121693_length_340_cov_541.348548	86	154	1209	1	68	0.0147059
NODE_121693_length_340_cov_541.348548	86	154	1227	1	68	0.0147059
NODE_121693_length_340_cov_541.348548	86	154	1236	1	68	0.0147059
NODE_121693_length_340_cov_541.348548	86	154	1264	1	68	0.0147059
NODE_121693_length_340_cov_541.348548	86	154	1289	1	68	0.0147059
NODE_121693_length_340_cov_541.348548	86	154	1337	1	68	0.0147059
NODE_121693_length_340_cov_541.348548	86	154	1342	1	68	0.0147059
NODE_121693_length_340_cov_541.348548	86	154	1352	1	68	0.0147059
NODE_121693_length_340_cov_541.348548	86	154	1367	1	68	0.0147059
NODE_121693_length_340_cov_541.348548	86	154	1383	1	68	0.0147059
NODE_121693_length_340_cov_541.348548	86	154	1424	1	68	0.0147059
NODE_121693_length_340_cov_541.348548	86	154	1428	1	68	0.0147059
NODE_121693_length_340_cov_541.348548	86	154	1440	1	68	0.0147059
NODE_121693_length_340_cov_541.348548	86	154	1450	1	68	0.0147059
NODE_121693_length_340_cov_541.348548	86	154	1498	1	68	0.0147059
NODE_121693_length_340_cov_541.348548	86	154	1509	1	68	0.0147059
NODE_121693_length_340_cov_541.348548	86	154	1516	1	68	0.0147059
NODE_121693_length_340_cov_541.348548	86	154	1540	1	68	0.0147059
NODE_121693_length_340_cov_541.348548	86	154	1566	1	68	0.0147059
NODE_121693_length_340_cov_541.348548	86	154	1577	1	68	0.0147059
NODE_121693_length_340_cov_541.348548	86	154	1585	1	68	0.0147059
NODE_121693_length_340_cov_541.348548	86	154	1589	1	68	0.0147059
NODE_121693_length_340_cov_541.348548	86	154	1617	1	68	0.0147059
NODE_121693_length_340_cov_541.348548	86	154	1648	1	68	0.0147059
NODE_121693_length_340_cov_541.348548	86	154	1690	1	68	0.0147059
NODE_121693_length_340_cov_541.348548	86	154	1710	1	68	0.0147059
NODE_121693_length_340_cov_541.348548	86	154	1731	1	68	0.0147059
NODE_121693_length_340_cov_541.348548	86	154	1765	1	68	0.0147059
NODE_121693_length_340_cov_541.348548	86	154	1776	1	68	0.0147059
NODE_121693_length_340_cov_541.348548	86	154	1806	1	68	0.0147059
NODE_121693_length_340_cov_541.348548	86	154	1818	1	68	0.0147059
NODE_121693_length_340_cov_541.348548	86	154	1821	1	68	0.0147059
NODE_121693_length_340_cov_541.348548	86	154	1841	1	68	0.0147059
NODE_121693_length_340_cov_541.348548	86	154	1888	1	68	0.0147059
NODE_121693_length_340_cov_541.348548	86	154	1929	1	68	0.0147059
NODE_121693_length_340_cov_541.348548	86	154	1949	1	68	0.0147059
NODE_121693_length_340_cov_541.348548	86	154	1988	1	68	0.0147059
NODE_121693_length_340_cov_541.348548	86	154	2010	1	68	0.0147059
NODE_121693_length_340_cov_541.348548	86	154	2038	1	68	0.0147059
NODE_121693_length_340_cov_541.348548	86	154	2061	1	68	0.0147059
NODE_121693_length_340_cov_541.348548	86	154	2091	1	68	0.0147059
NODE_121693_length_340_cov_541.348548	86	154	2120	1	68	0.0147059
NODE_121693_length_340_cov_541.348548	86	154	2126	1	68	0.0147059
NODE_121693_length_340_cov_541.348548	86	154	2135	1	68	0.0147059
NODE_121693_length_340_cov_541.348548	86	154	2161	1	68	0.0147059
NODE_121693_length_340_cov_541.348548	86	154	2177	1	68	0.0147059
NODE_121693_length_340_cov_541.348548	86	154	2178	1	68	0.0147059
NODE_121693_length_340_cov_541.348548	86	154	2182	1	68	0.0147059
NODE_121693_length_340_cov_541.348548	86	154	2185	1	68	0.0147059
NODE_121693_length_340_cov_541.348548	86	154	2198	1	68	0.0147059
NODE_121693_length_340_cov_541.348548	86	154	2201	1	68	0.0147059
NODE_121693_length_340_cov_541.348548	86	154	2218	1	68	0.0147059
NODE_121693_length_340_cov_541.348548	86	107	766	1	21	0.0476190
NODE_121693_length_340_cov_541.348548	86	107	774	1	21	0.0476190
NODE_121693_length_340_cov_541.348548	86	107	798	1	21	0.0476190
NODE_121693_length_340_cov_541.348548	86	107	811	1	21	0.0476190
NODE_121693_length_340_cov_541.348548	86	107	835	1	21	0.0476190
NODE_121693_length_340_cov_541.348548	86	107	840	1	21	0.0476190
NODE_121693_length_340_cov_541.348548	86	107	879	1	21	0.0476190
NODE_121693_length_340_cov_541.348548	86	107	890	1	21	0.0476190
NODE_121693_length_340_cov_541.348548	86	107	905	1	21	0.0476190
NODE_121693_length_340_cov_541.348548	86	107	956	1	21	0.0476190
NODE_121693_length_340_cov_541.348548	86	107	986	1	21	0.0476190
NODE_121693_length_340_cov_541.348548	86	107	1004	1	21	0.0476190
NODE_121693_length_340_cov_541.348548	86	107	1043	1	21	0.0476190
NODE_121693_length_340_cov_541.348548	86	107	1103	1	21	0.0476190
NODE_121693_length_340_cov_541.348548	86	107	1143	1	21	0.0476190
NODE_121693_length_340_cov_541.348548	86	107	1161	1	21	0.0476190
NODE_121693_length_340_cov_541.348548	86	107	1209	1	21	0.0476190
NODE_121693_length_340_cov_541.348548	86	107	1227	1	21	0.0476190
NODE_121693_length_340_cov_541.348548	86	107	1236	1	21	0.0476190
NODE_121693_length_340_cov_541.348548	86	107	1264	1	21	0.0476190
NODE_121693_length_340_cov_541.348548	86	107	1289	1	21	0.0476190
NODE_121694_length_340_cov_50.755187	196	266	32	5	70	0.0714286
NODE_121694_length_340_cov_50.755187	196	266	34	2	70	0.0285714
NODE_121694_length_340_cov_50.755187	196	266	38	5	70	0.0714286
NODE_121694_length_340_cov_50.755187	196	266	42	17	70	0.2428571
NODE_121694_length_340_cov_50.755187	196	266	44	5	70	0.0714286
NODE_121694_length_340_cov_50.755187	196	266	46	14	70	0.2000000
NODE_121694_length_340_cov_50.755187	196	266	48	12	70	0.1714286
NODE_121694_length_340_cov_50.755187	196	266	50	10	70	0.1428571
NODE_121696_length_340_cov_8.917012	240	270	0	30	30	1.0000000
NODE_121696_length_340_cov_8.917012	243	315	0	72	72	1.0000000
NODE_121702_length_340_cov_6.439834	175	255	0	80	80	1.0000000
NODE_121702_length_340_cov_6.439834	228	310	0	82	82	1.0000000
NODE_121708_length_340_cov_5.883817	72	121	0	1	49	0.0204082
NODE_121708_length_340_cov_5.883817	72	121	2	1	49	0.0204082
NODE_121708_length_340_cov_5.883817	72	121	4	4	49	0.0816327
NODE_121708_length_340_cov_5.883817	72	121	6	2	49	0.0408163
NODE_121708_length_340_cov_5.883817	72	121	10	41	49	0.8367347
NODE_121708_length_340_cov_5.883817	82	113	10	31	31	1.0000000
NODE_121714_length_340_cov_5.228216	116	186	0	70	70	1.0000000
NODE_121714_length_340_cov_5.228216	159	201	0	42	42	1.0000000
NODE_121730_length_340_cov_4.497925	136	184	0	48	48	1.0000000
NODE_121752_length_340_cov_3.759336	88	169	0	63	81	0.7777778
NODE_121752_length_340_cov_3.759336	88	169	2	18	81	0.2222222
NODE_121849_length_340_cov_2.506224	68	114	0	46	46	1.0000000
NODE_121951_length_340_cov_1.995851	29	101	0	20	72	0.2777778
NODE_121951_length_340_cov_1.995851	29	101	2	52	72	0.7222222
NODE_121951_length_340_cov_1.995851	96	143	2	41	47	0.8723404
NODE_121951_length_340_cov_1.995851	96	143	4	6	47	0.1276596
NODE_122154_length_340_cov_1.427386	244	274	0	30	30	1.0000000
NODE_122218_length_340_cov_1.282158	71	135	0	64	64	1.0000000
NODE_122218_length_340_cov_1.282158	128	188	0	60	60	1.0000000
NODE_122218_length_340_cov_1.282158	142	189	0	47	47	1.0000000
NODE_122220_length_340_cov_1.278008	51	102	2	51	51	1.0000000
NODE_122321_length_340_cov_1.199170	98	160	0	62	62	1.0000000
NODE_122381_length_340_cov_1.070539	32	65	0	18	33	0.5454546
NODE_122381_length_340_cov_1.070539	32	65	2	15	33	0.4545455
NODE_122429_length_340_cov_1.020747	209	228	0	19	19	1.0000000
NODE_122686_length_339_cov_87.841667	149	227	161	2	78	0.0256410
NODE_122686_length_339_cov_87.841667	149	227	164	1	78	0.0128205
NODE_122686_length_339_cov_87.841667	149	227	166	1	78	0.0128205
NODE_122686_length_339_cov_87.841667	149	227	168	1	78	0.0128205
NODE_122686_length_339_cov_87.841667	149	227	170	1	78	0.0128205
NODE_122686_length_339_cov_87.841667	149	227	177	1	78	0.0128205
NODE_122686_length_339_cov_87.841667	149	227	186	1	78	0.0128205
NODE_122686_length_339_cov_87.841667	149	227	188	2	78	0.0256410
NODE_122686_length_339_cov_87.841667	149	227	190	4	78	0.0512821
NODE_122686_length_339_cov_87.841667	149	227	191	1	78	0.0128205
NODE_122686_length_339_cov_87.841667	149	227	206	1	78	0.0128205
NODE_122686_length_339_cov_87.841667	149	227	208	1	78	0.0128205
NODE_122686_length_339_cov_87.841667	149	227	212	2	78	0.0256410
NODE_122686_length_339_cov_87.841667	149	227	213	1	78	0.0128205
NODE_122686_length_339_cov_87.841667	149	227	218	1	78	0.0128205
NODE_122686_length_339_cov_87.841667	149	227	221	1	78	0.0128205
NODE_122686_length_339_cov_87.841667	149	227	223	5	78	0.0641026
NODE_122686_length_339_cov_87.841667	149	227	224	1	78	0.0128205
NODE_122686_length_339_cov_87.841667	149	227	225	3	78	0.0384615
NODE_122686_length_339_cov_87.841667	149	227	226	1	78	0.0128205
NODE_122686_length_339_cov_87.841667	149	227	227	5	78	0.0641026
NODE_122686_length_339_cov_87.841667	149	227	228	1	78	0.0128205
NODE_122686_length_339_cov_87.841667	149	227	229	1	78	0.0128205
NODE_122686_length_339_cov_87.841667	149	227	231	4	78	0.0512821
NODE_122686_length_339_cov_87.841667	149	227	232	1	78	0.0128205
NODE_122686_length_339_cov_87.841667	149	227	233	2	78	0.0256410
NODE_122686_length_339_cov_87.841667	149	227	235	2	78	0.0256410
NODE_122686_length_339_cov_87.841667	149	227	239	2	78	0.0256410
NODE_122686_length_339_cov_87.841667	149	227	241	1	78	0.0128205
NODE_122686_length_339_cov_87.841667	149	227	249	2	78	0.0256410
NODE_122686_length_339_cov_87.841667	149	227	253	2	78	0.0256410
NODE_122686_length_339_cov_87.841667	149	227	259	3	78	0.0384615
NODE_122686_length_339_cov_87.841667	149	227	260	2	78	0.0256410
NODE_122686_length_339_cov_87.841667	149	227	261	2	78	0.0256410
NODE_122686_length_339_cov_87.841667	149	227	262	2	78	0.0256410
NODE_122686_length_339_cov_87.841667	149	227	266	1	78	0.0128205
NODE_122686_length_339_cov_87.841667	149	227	267	2	78	0.0256410
NODE_122686_length_339_cov_87.841667	149	227	268	1	78	0.0128205
NODE_122686_length_339_cov_87.841667	149	227	269	1	78	0.0128205
NODE_122686_length_339_cov_87.841667	149	227	270	1	78	0.0128205
NODE_122686_length_339_cov_87.841667	149	227	271	2	78	0.0256410
NODE_122686_length_339_cov_87.841667	149	227	272	2	78	0.0256410
NODE_122686_length_339_cov_87.841667	149	227	273	1	78	0.0128205
NODE_122686_length_339_cov_87.841667	149	227	274	2	78	0.0256410
NODE_122686_length_339_cov_87.841667	149	227	276	1	78	0.0128205
NODE_122687_length_339_cov_14.304167	69	138	16	21	69	0.3043478
NODE_122687_length_339_cov_14.304167	69	138	20	11	69	0.1594203
NODE_122687_length_339_cov_14.304167	69	138	22	37	69	0.5362319
NODE_122687_length_339_cov_14.304167	69	138	16	21	69	0.3043478
NODE_122687_length_339_cov_14.304167	69	138	20	11	69	0.1594203
NODE_122687_length_339_cov_14.304167	69	138	22	37	69	0.5362319
NODE_122687_length_339_cov_14.304167	69	138	16	21	69	0.3043478
NODE_122687_length_339_cov_14.304167	69	138	20	11	69	0.1594203
NODE_122687_length_339_cov_14.304167	69	138	22	37	69	0.5362319
NODE_122687_length_339_cov_14.304167	88	138	16	21	50	0.4200000
NODE_122687_length_339_cov_14.304167	88	138	20	11	50	0.2200000
NODE_122687_length_339_cov_14.304167	88	138	22	18	50	0.3600000
NODE_122687_length_339_cov_14.304167	111	160	8	1	49	0.0204082
NODE_122687_length_339_cov_14.304167	111	160	9	1	49	0.0204082
NODE_122687_length_339_cov_14.304167	111	160	10	20	49	0.4081633
NODE_122687_length_339_cov_14.304167	111	160	16	21	49	0.4285714
NODE_122687_length_339_cov_14.304167	111	160	20	6	49	0.1224490
NODE_122727_length_339_cov_4.320833	187	267	0	39	80	0.4875000
NODE_122727_length_339_cov_4.320833	187	267	2	41	80	0.5125000
NODE_122804_length_339_cov_2.754167	45	125	1	12	80	0.1500000
NODE_122804_length_339_cov_2.754167	45	125	3	1	80	0.0125000
NODE_122804_length_339_cov_2.754167	45	125	6	13	80	0.1625000
NODE_122804_length_339_cov_2.754167	45	125	7	54	80	0.6750000
NODE_122971_length_339_cov_1.841667	265	312	0	47	47	1.0000000
NODE_123041_length_339_cov_1.662500	10	57	0	47	47	1.0000000
NODE_123182_length_339_cov_1.275000	247	312	0	65	65	1.0000000
NODE_123285_length_339_cov_1.070833	147	169	0	22	22	1.0000000
NODE_123633_length_338_cov_57.163180	59	120	0	61	61	1.0000000
NODE_123633_length_338_cov_57.163180	102	176	0	74	74	1.0000000
NODE_123674_length_338_cov_4.263598	113	165	0	52	52	1.0000000
NODE_123679_length_338_cov_4.079498	96	151	0	55	55	1.0000000
NODE_123689_length_338_cov_3.841004	122	149	0	27	27	1.0000000
NODE_123793_length_338_cov_2.393305	216	288	6	72	72	1.0000000
NODE_123795_length_338_cov_2.380753	29	93	0	40	64	0.6250000
NODE_123795_length_338_cov_2.380753	29	93	2	24	64	0.3750000
NODE_123919_length_338_cov_1.878661	146	232	0	2	86	0.0232558
NODE_123919_length_338_cov_1.878661	146	232	1	29	86	0.3372093
NODE_123919_length_338_cov_1.878661	146	232	2	17	86	0.1976744
NODE_123919_length_338_cov_1.878661	146	232	4	1	86	0.0116279
NODE_123919_length_338_cov_1.878661	146	232	6	2	86	0.0232558
NODE_123919_length_338_cov_1.878661	146	232	8	6	86	0.0697674
NODE_123919_length_338_cov_1.878661	146	232	10	6	86	0.0697674
NODE_123919_length_338_cov_1.878661	146	232	12	9	86	0.1046512
NODE_123919_length_338_cov_1.878661	146	232	14	2	86	0.0232558
NODE_123919_length_338_cov_1.878661	146	232	16	7	86	0.0813954
NODE_123919_length_338_cov_1.878661	146	232	18	5	86	0.0581395
NODE_123944_length_338_cov_1.740586	79	159	2	36	80	0.4500000
NODE_123944_length_338_cov_1.740586	79	159	4	44	80	0.5500000
NODE_123946_length_338_cov_1.732218	216	257	0	41	41	1.0000000
NODE_124046_length_338_cov_1.493724	14	90	0	76	76	1.0000000
NODE_124247_length_338_cov_1.100418	265	333	0	68	68	1.0000000
NODE_124456_length_338_cov_0.849372	281	338	0	57	57	1.0000000
NODE_124533_length_338_cov_0.711297	188	263	2	2	75	0.0266667
NODE_124533_length_338_cov_0.711297	188	263	4	26	75	0.3466667
NODE_124533_length_338_cov_0.711297	188	263	6	47	75	0.6266667
NODE_124625_length_337_cov_468.180672	107	187	33	4	80	0.0500000
NODE_124625_length_337_cov_468.180672	107	187	34	4	80	0.0500000
NODE_124625_length_337_cov_468.180672	107	187	36	5	80	0.0625000
NODE_124625_length_337_cov_468.180672	107	187	37	22	80	0.2750000
NODE_124625_length_337_cov_468.180672	107	187	39	1	80	0.0125000
NODE_124625_length_337_cov_468.180672	107	187	43	1	80	0.0125000
NODE_124625_length_337_cov_468.180672	107	187	45	1	80	0.0125000
NODE_124625_length_337_cov_468.180672	107	187	49	6	80	0.0750000
NODE_124625_length_337_cov_468.180672	107	187	51	2	80	0.0250000
NODE_124625_length_337_cov_468.180672	107	187	53	1	80	0.0125000
NODE_124625_length_337_cov_468.180672	107	187	55	1	80	0.0125000
NODE_124625_length_337_cov_468.180672	107	187	57	2	80	0.0250000
NODE_124625_length_337_cov_468.180672	107	187	58	7	80	0.0875000
NODE_124625_length_337_cov_468.180672	107	187	59	1	80	0.0125000
NODE_124625_length_337_cov_468.180672	107	187	60	6	80	0.0750000
NODE_124625_length_337_cov_468.180672	107	187	61	3	80	0.0375000
NODE_124625_length_337_cov_468.180672	107	187	62	13	80	0.1625000
NODE_124625_length_337_cov_468.180672	160	230	3	1	70	0.0142857
NODE_124625_length_337_cov_468.180672	160	230	4	16	70	0.2285714
NODE_124625_length_337_cov_468.180672	160	230	6	3	70	0.0428571
NODE_124625_length_337_cov_468.180672	160	230	8	5	70	0.0714286
NODE_124625_length_337_cov_468.180672	160	230	9	3	70	0.0428571
NODE_124625_length_337_cov_468.180672	160	230	13	1	70	0.0142857
NODE_124625_length_337_cov_468.180672	160	230	19	4	70	0.0571429
NODE_124625_length_337_cov_468.180672	160	230	22	1	70	0.0142857
NODE_124625_length_337_cov_468.180672	160	230	23	2	70	0.0285714
NODE_124625_length_337_cov_468.180672	160	230	24	3	70	0.0428571
NODE_124625_length_337_cov_468.180672	160	230	26	2	70	0.0285714
NODE_124625_length_337_cov_468.180672	160	230	27	1	70	0.0142857
NODE_124625_length_337_cov_468.180672	160	230	32	1	70	0.0142857
NODE_124625_length_337_cov_468.180672	160	230	33	4	70	0.0571429
NODE_124625_length_337_cov_468.180672	160	230	34	4	70	0.0571429
NODE_124625_length_337_cov_468.180672	160	230	36	5	70	0.0714286
NODE_124625_length_337_cov_468.180672	160	230	37	14	70	0.2000000
NODE_124625_length_337_cov_468.180672	226	306	4	7	80	0.0875000
NODE_124625_length_337_cov_468.180672	226	306	6	24	80	0.3000000
NODE_124625_length_337_cov_468.180672	226	306	8	49	80	0.6125000
NODE_124625_length_337_cov_468.180672	279	337	2	22	58	0.3793103
NODE_124625_length_337_cov_468.180672	279	337	4	14	58	0.2413793
NODE_124625_length_337_cov_468.180672	279	337	6	19	58	0.3275862
NODE_124625_length_337_cov_468.180672	279	337	8	3	58	0.0517241
NODE_124626_length_337_cov_91.344538	1	50	16	1	49	0.0204082
NODE_124626_length_337_cov_91.344538	1	50	18	2	49	0.0408163
NODE_124626_length_337_cov_91.344538	1	50	24	3	49	0.0612245
NODE_124626_length_337_cov_91.344538	1	50	26	3	49	0.0612245
NODE_124626_length_337_cov_91.344538	1	50	32	1	49	0.0204082
NODE_124626_length_337_cov_91.344538	1	50	44	2	49	0.0408163
NODE_124626_length_337_cov_91.344538	1	50	48	2	49	0.0408163
NODE_124626_length_337_cov_91.344538	1	50	52	6	49	0.1224490
NODE_124626_length_337_cov_91.344538	1	50	54	2	49	0.0408163
NODE_124626_length_337_cov_91.344538	1	50	58	1	49	0.0204082
NODE_124626_length_337_cov_91.344538	1	50	60	2	49	0.0408163
NODE_124626_length_337_cov_91.344538	1	50	73	3	49	0.0612245
NODE_124626_length_337_cov_91.344538	1	50	75	4	49	0.0816327
NODE_124626_length_337_cov_91.344538	1	50	77	1	49	0.0204082
NODE_124626_length_337_cov_91.344538	1	50	83	2	49	0.0408163
NODE_124626_length_337_cov_91.344538	1	50	85	2	49	0.0408163
NODE_124626_length_337_cov_91.344538	1	50	89	2	49	0.0408163
NODE_124626_length_337_cov_91.344538	1	50	92	5	49	0.1020408
NODE_124626_length_337_cov_91.344538	1	50	94	2	49	0.0408163
NODE_124626_length_337_cov_91.344538	1	50	95	3	49	0.0612245
NODE_124626_length_337_cov_91.344538	23	103	58	1	80	0.0125000
NODE_124626_length_337_cov_91.344538	23	103	60	2	80	0.0250000
NODE_124626_length_337_cov_91.344538	23	103	73	3	80	0.0375000
NODE_124626_length_337_cov_91.344538	23	103	75	4	80	0.0500000
NODE_124626_length_337_cov_91.344538	23	103	77	1	80	0.0125000
NODE_124626_length_337_cov_91.344538	23	103	83	2	80	0.0250000
NODE_124626_length_337_cov_91.344538	23	103	85	2	80	0.0250000
NODE_124626_length_337_cov_91.344538	23	103	89	2	80	0.0250000
NODE_124626_length_337_cov_91.344538	23	103	92	5	80	0.0625000
NODE_124626_length_337_cov_91.344538	23	103	94	2	80	0.0250000
NODE_124626_length_337_cov_91.344538	23	103	95	4	80	0.0500000
NODE_124626_length_337_cov_91.344538	23	103	97	1	80	0.0125000
NODE_124626_length_337_cov_91.344538	23	103	99	1	80	0.0125000
NODE_124626_length_337_cov_91.344538	23	103	105	1	80	0.0125000
NODE_124626_length_337_cov_91.344538	23	103	113	1	80	0.0125000
NODE_124626_length_337_cov_91.344538	23	103	118	1	80	0.0125000
NODE_124626_length_337_cov_91.344538	23	103	119	1	80	0.0125000
NODE_124626_length_337_cov_91.344538	23	103	123	1	80	0.0125000
NODE_124626_length_337_cov_91.344538	23	103	124	1	80	0.0125000
NODE_124626_length_337_cov_91.344538	23	103	126	1	80	0.0125000
NODE_124626_length_337_cov_91.344538	23	103	128	1	80	0.0125000
NODE_124626_length_337_cov_91.344538	23	103	132	1	80	0.0125000
NODE_124626_length_337_cov_91.344538	23	103	136	4	80	0.0500000
NODE_124626_length_337_cov_91.344538	23	103	138	1	80	0.0125000
NODE_124626_length_337_cov_91.344538	23	103	139	2	80	0.0250000
NODE_124626_length_337_cov_91.344538	23	103	140	1	80	0.0125000
NODE_124626_length_337_cov_91.344538	23	103	142	2	80	0.0250000
NODE_124626_length_337_cov_91.344538	23	103	143	1	80	0.0125000
NODE_124626_length_337_cov_91.344538	23	103	145	3	80	0.0375000
NODE_124626_length_337_cov_91.344538	23	103	146	1	80	0.0125000
NODE_124626_length_337_cov_91.344538	23	103	150	2	80	0.0250000
NODE_124626_length_337_cov_91.344538	23	103	151	2	80	0.0250000
NODE_124626_length_337_cov_91.344538	23	103	154	2	80	0.0250000
NODE_124626_length_337_cov_91.344538	23	103	159	1	80	0.0125000
NODE_124626_length_337_cov_91.344538	23	103	163	6	80	0.0750000
NODE_124626_length_337_cov_91.344538	23	103	165	3	80	0.0375000
NODE_124626_length_337_cov_91.344538	23	103	167	1	80	0.0125000
NODE_124626_length_337_cov_91.344538	23	103	168	1	80	0.0125000
NODE_124626_length_337_cov_91.344538	23	103	181	2	80	0.0250000
NODE_124626_length_337_cov_91.344538	23	103	182	1	80	0.0125000
NODE_124626_length_337_cov_91.344538	23	103	186	5	80	0.0625000
NODE_124627_length_337_cov_73.352941	71	151	0	80	80	1.0000000
NODE_124627_length_337_cov_73.352941	124	204	0	80	80	1.0000000
NODE_124629_length_337_cov_46.978992	220	305	0	6	85	0.0705882
NODE_124629_length_337_cov_46.978992	220	305	4	8	85	0.0941176
NODE_124629_length_337_cov_46.978992	220	305	6	13	85	0.1529412
NODE_124629_length_337_cov_46.978992	220	305	10	58	85	0.6823530
NODE_124629_length_337_cov_46.978992	220	305	0	6	85	0.0705882
NODE_124629_length_337_cov_46.978992	220	305	4	8	85	0.0941176
NODE_124629_length_337_cov_46.978992	220	305	6	13	85	0.1529412
NODE_124629_length_337_cov_46.978992	220	305	10	58	85	0.6823530
NODE_124629_length_337_cov_46.978992	220	305	0	6	85	0.0705882
NODE_124629_length_337_cov_46.978992	220	305	4	8	85	0.0941176
NODE_124629_length_337_cov_46.978992	220	305	6	13	85	0.1529412
NODE_124629_length_337_cov_46.978992	220	305	10	58	85	0.6823530
NODE_124629_length_337_cov_46.978992	278	327	0	28	49	0.5714286
NODE_124629_length_337_cov_46.978992	278	327	4	8	49	0.1632653
NODE_124629_length_337_cov_46.978992	278	327	10	13	49	0.2653061
NODE_124629_length_337_cov_46.978992	278	337	0	38	59	0.6440678
NODE_124629_length_337_cov_46.978992	278	337	4	8	59	0.1355932
NODE_124629_length_337_cov_46.978992	278	337	10	13	59	0.2203390
NODE_124629_length_337_cov_46.978992	283	337	0	38	54	0.7037037
NODE_124629_length_337_cov_46.978992	283	337	4	8	54	0.1481481
NODE_124629_length_337_cov_46.978992	283	337	10	8	54	0.1481481
NODE_124640_length_337_cov_6.214286	52	95	0	43	43	1.0000000
NODE_124669_length_337_cov_4.298319	5	58	0	53	53	1.0000000
NODE_124703_length_337_cov_3.478992	179	259	39	2	80	0.0250000
NODE_124703_length_337_cov_3.478992	179	259	44	5	80	0.0625000
NODE_124703_length_337_cov_3.478992	179	259	45	5	80	0.0625000
NODE_124703_length_337_cov_3.478992	179	259	46	42	80	0.5250000
NODE_124703_length_337_cov_3.478992	179	259	47	10	80	0.1250000
NODE_124703_length_337_cov_3.478992	179	259	48	2	80	0.0250000
NODE_124703_length_337_cov_3.478992	179	259	49	1	80	0.0125000
NODE_124703_length_337_cov_3.478992	179	259	50	3	80	0.0375000
NODE_124703_length_337_cov_3.478992	179	259	52	10	80	0.1250000
NODE_124703_length_337_cov_3.478992	232	307	0	1	75	0.0133333
NODE_124703_length_337_cov_3.478992	232	307	4	1	75	0.0133333
NODE_124703_length_337_cov_3.478992	232	307	20	12	75	0.1600000
NODE_124703_length_337_cov_3.478992	232	307	22	3	75	0.0400000
NODE_124703_length_337_cov_3.478992	232	307	29	2	75	0.0266667
NODE_124703_length_337_cov_3.478992	232	307	31	1	75	0.0133333
NODE_124703_length_337_cov_3.478992	232	307	37	24	75	0.3200000
NODE_124703_length_337_cov_3.478992	232	307	39	6	75	0.0800000
NODE_124703_length_337_cov_3.478992	232	307	44	1	75	0.0133333
NODE_124703_length_337_cov_3.478992	232	307	46	24	75	0.3200000
NODE_124759_length_337_cov_2.647059	80	146	2	8	66	0.1212121
NODE_124759_length_337_cov_2.647059	80	146	5	2	66	0.0303030
NODE_124759_length_337_cov_2.647059	80	146	6	44	66	0.6666667
NODE_124759_length_337_cov_2.647059	80	146	10	12	66	0.1818182
NODE_124858_length_337_cov_2.121849	23	103	0	80	80	1.0000000
NODE_124858_length_337_cov_2.121849	76	141	0	64	65	0.9846154
NODE_124858_length_337_cov_2.121849	76	141	2	1	65	0.0153846
NODE_125001_length_337_cov_1.689076	138	218	0	80	80	1.0000000
NODE_125024_length_337_cov_1.592437	109	151	0	42	42	1.0000000
NODE_125024_length_337_cov_1.592437	126	204	0	78	78	1.0000000
NODE_125074_length_337_cov_1.466387	266	332	0	66	66	1.0000000
NODE_125271_length_337_cov_1.071429	279	319	0	4	40	0.1000000
NODE_125271_length_337_cov_1.071429	279	319	2	7	40	0.1750000
NODE_125271_length_337_cov_1.071429	279	319	4	29	40	0.7250000
NODE_125332_length_337_cov_0.978992	227	272	0	45	45	1.0000000
NODE_125633_length_336_cov_7.843882	151	231	0	80	80	1.0000000
NODE_125645_length_336_cov_5.578059	159	220	0	3	61	0.0491803
NODE_125645_length_336_cov_5.578059	159	220	2	58	61	0.9508197
NODE_125645_length_336_cov_5.578059	212	273	2	61	61	1.0000000
NODE_125663_length_336_cov_4.481013	129	207	18	10	78	0.1282051
NODE_125663_length_336_cov_4.481013	129	207	20	4	78	0.0512821
NODE_125663_length_336_cov_4.481013	129	207	22	3	78	0.0384615
NODE_125663_length_336_cov_4.481013	129	207	23	4	78	0.0512821
NODE_125663_length_336_cov_4.481013	129	207	24	17	78	0.2179487
NODE_125663_length_336_cov_4.481013	129	207	26	4	78	0.0512821
NODE_125663_length_336_cov_4.481013	129	207	30	4	78	0.0512821
NODE_125663_length_336_cov_4.481013	129	207	32	9	78	0.1153846
NODE_125663_length_336_cov_4.481013	129	207	37	3	78	0.0384615
NODE_125663_length_336_cov_4.481013	129	207	39	5	78	0.0641026
NODE_125663_length_336_cov_4.481013	129	207	41	4	78	0.0512821
NODE_125663_length_336_cov_4.481013	129	207	45	4	78	0.0512821
NODE_125663_length_336_cov_4.481013	129	207	47	3	78	0.0384615
NODE_125663_length_336_cov_4.481013	129	207	49	4	78	0.0512821
NODE_125752_length_336_cov_2.755274	83	112	4	16	29	0.5517241
NODE_125752_length_336_cov_2.755274	83	112	6	9	29	0.3103448
NODE_125752_length_336_cov_2.755274	83	112	8	4	29	0.1379310
NODE_125752_length_336_cov_2.755274	187	268	4	14	81	0.1728395
NODE_125752_length_336_cov_2.755274	187	268	6	6	81	0.0740741
NODE_125752_length_336_cov_2.755274	187	268	8	4	81	0.0493827
NODE_125752_length_336_cov_2.755274	187	268	10	18	81	0.2222222
NODE_125752_length_336_cov_2.755274	187	268	12	1	81	0.0123457
NODE_125752_length_336_cov_2.755274	187	268	14	4	81	0.0493827
NODE_125752_length_336_cov_2.755274	187	268	16	7	81	0.0864198
NODE_125752_length_336_cov_2.755274	187	268	17	2	81	0.0246914
NODE_125752_length_336_cov_2.755274	187	268	18	19	81	0.2345679
NODE_125752_length_336_cov_2.755274	187	268	19	6	81	0.0740741
NODE_125806_length_336_cov_2.358650	60	133	0	15	73	0.2054795
NODE_125806_length_336_cov_2.358650	60	133	2	18	73	0.2465753
NODE_125806_length_336_cov_2.358650	60	133	4	40	73	0.5479452
NODE_125811_length_336_cov_2.337553	93	173	0	80	80	1.0000000
NODE_125965_length_336_cov_1.729958	78	141	0	63	63	1.0000000
NODE_125965_length_336_cov_1.729958	131	194	0	63	63	1.0000000
NODE_126134_length_336_cov_1.333333	34	114	0	80	80	1.0000000
NODE_126134_length_336_cov_1.333333	87	124	0	37	37	1.0000000
NODE_126134_length_336_cov_1.333333	182	213	0	31	31	1.0000000
NODE_126216_length_336_cov_1.244726	222	276	4	25	54	0.4629630
NODE_126216_length_336_cov_1.244726	222	276	6	29	54	0.5370370
NODE_126216_length_336_cov_1.244726	288	312	0	3	24	0.1250000
NODE_126216_length_336_cov_1.244726	288	312	2	16	24	0.6666667
NODE_126216_length_336_cov_1.244726	288	312	4	5	24	0.2083333
NODE_126260_length_336_cov_1.143460	129	154	0	25	25	1.0000000
NODE_126545_length_336_cov_0.670886	259	288	0	29	29	1.0000000
NODE_126606_length_335_cov_16.114407	162	242	0	80	80	1.0000000
NODE_126606_length_335_cov_16.114407	215	295	0	80	80	1.0000000
NODE_126609_length_335_cov_9.258475	177	250	4	52	73	0.7123288
NODE_126609_length_335_cov_9.258475	177	250	6	14	73	0.1917808
NODE_126609_length_335_cov_9.258475	177	250	8	7	73	0.0958904
NODE_126614_length_335_cov_7.207627	29	109	1	80	80	1.0000000
NODE_126614_length_335_cov_7.207627	82	162	1	48	80	0.6000000
NODE_126614_length_335_cov_7.207627	82	162	2	32	80	0.4000000
NODE_126636_length_335_cov_5.046610	182	263	2	81	81	1.0000000
NODE_126639_length_335_cov_4.995763	144	215	0	71	71	1.0000000
NODE_126665_length_335_cov_3.923729	163	231	0	68	68	1.0000000
NODE_126787_length_335_cov_2.411017	230	294	2	20	64	0.3125000
NODE_126787_length_335_cov_2.411017	230	294	3	2	64	0.0312500
NODE_126787_length_335_cov_2.411017	230	294	4	42	64	0.6562500
NODE_126791_length_335_cov_2.402542	164	240	0	19	76	0.2500000
NODE_126791_length_335_cov_2.402542	164	240	2	14	76	0.1842105
NODE_126791_length_335_cov_2.402542	164	240	4	3	76	0.0394737
NODE_126791_length_335_cov_2.402542	164	240	8	2	76	0.0263158
NODE_126791_length_335_cov_2.402542	164	240	10	2	76	0.0263158
NODE_126791_length_335_cov_2.402542	164	240	14	10	76	0.1315790
NODE_126791_length_335_cov_2.402542	164	240	16	2	76	0.0263158
NODE_126791_length_335_cov_2.402542	164	240	18	7	76	0.0921053
NODE_126791_length_335_cov_2.402542	164	240	20	17	76	0.2236842
NODE_126792_length_335_cov_2.398305	116	179	0	40	63	0.6349207
NODE_126792_length_335_cov_2.398305	116	179	2	23	63	0.3650794
NODE_126826_length_335_cov_2.161017	82	141	0	59	59	1.0000000
NODE_126835_length_335_cov_2.152542	61	134	0	73	73	1.0000000
NODE_126835_length_335_cov_2.152542	114	134	0	20	20	1.0000000
NODE_126920_length_335_cov_1.766949	257	330	2	15	73	0.2054795
NODE_126920_length_335_cov_1.766949	257	330	4	17	73	0.2328767
NODE_126920_length_335_cov_1.766949	257	330	6	41	73	0.5616438
NODE_126920_length_335_cov_1.766949	297	335	0	3	38	0.0789474
NODE_126920_length_335_cov_1.766949	297	335	2	17	38	0.4473684
NODE_126920_length_335_cov_1.766949	297	335	4	17	38	0.4473684
NODE_126920_length_335_cov_1.766949	297	335	6	1	38	0.0263158
NODE_127022_length_335_cov_1.529661	255	320	0	65	65	1.0000000
NODE_127023_length_335_cov_1.525424	222	266	0	44	44	1.0000000
NODE_127062_length_335_cov_1.457627	38	87	0	49	49	1.0000000
NODE_127130_length_335_cov_1.296610	291	311	0	20	20	1.0000000
NODE_127130_length_335_cov_1.296610	291	311	0	20	20	1.0000000
NODE_127143_length_335_cov_1.292373	202	232	4	13	30	0.4333333
NODE_127143_length_335_cov_1.292373	202	232	6	17	30	0.5666667
NODE_127200_length_335_cov_1.194915	75	156	22	2	81	0.0246914
NODE_127200_length_335_cov_1.194915	75	156	24	1	81	0.0123457
NODE_127200_length_335_cov_1.194915	75	156	25	2	81	0.0246914
NODE_127200_length_335_cov_1.194915	75	156	26	9	81	0.1111111
NODE_127200_length_335_cov_1.194915	75	156	28	28	81	0.3456790
NODE_127200_length_335_cov_1.194915	75	156	29	5	81	0.0617284
NODE_127200_length_335_cov_1.194915	75	156	34	3	81	0.0370370
NODE_127200_length_335_cov_1.194915	75	156	36	20	81	0.2469136
NODE_127200_length_335_cov_1.194915	75	156	37	11	81	0.1358025
NODE_127200_length_335_cov_1.194915	129	195	22	2	66	0.0303030
NODE_127200_length_335_cov_1.194915	129	195	24	1	66	0.0151515
NODE_127200_length_335_cov_1.194915	129	195	25	2	66	0.0303030
NODE_127200_length_335_cov_1.194915	129	195	26	9	66	0.1363636
NODE_127200_length_335_cov_1.194915	129	195	27	3	66	0.0454545
NODE_127200_length_335_cov_1.194915	129	195	28	9	66	0.1363636
NODE_127200_length_335_cov_1.194915	129	195	29	6	66	0.0909091
NODE_127200_length_335_cov_1.194915	129	195	30	4	66	0.0606061
NODE_127200_length_335_cov_1.194915	129	195	31	8	66	0.1212121
NODE_127200_length_335_cov_1.194915	129	195	32	7	66	0.1060606
NODE_127200_length_335_cov_1.194915	129	195	33	7	66	0.1060606
NODE_127200_length_335_cov_1.194915	129	195	35	3	66	0.0454545
NODE_127200_length_335_cov_1.194915	129	195	36	2	66	0.0303030
NODE_127200_length_335_cov_1.194915	129	195	37	3	66	0.0454545
NODE_127310_length_335_cov_0.983051	96	117	0	21	21	1.0000000
NODE_127585_length_334_cov_275.425532	135	215	407	1	80	0.0125000
NODE_127585_length_334_cov_275.425532	135	215	409	1	80	0.0125000
NODE_127585_length_334_cov_275.425532	135	215	410	1	80	0.0125000
NODE_127585_length_334_cov_275.425532	135	215	425	1	80	0.0125000
NODE_127585_length_334_cov_275.425532	135	215	427	1	80	0.0125000
NODE_127585_length_334_cov_275.425532	135	215	428	1	80	0.0125000
NODE_127585_length_334_cov_275.425532	135	215	429	1	80	0.0125000
NODE_127585_length_334_cov_275.425532	135	215	433	1	80	0.0125000
NODE_127585_length_334_cov_275.425532	135	215	438	1	80	0.0125000
NODE_127585_length_334_cov_275.425532	135	215	439	1	80	0.0125000
NODE_127585_length_334_cov_275.425532	135	215	441	1	80	0.0125000
NODE_127585_length_334_cov_275.425532	135	215	443	1	80	0.0125000
NODE_127585_length_334_cov_275.425532	135	215	447	1	80	0.0125000
NODE_127585_length_334_cov_275.425532	135	215	449	1	80	0.0125000
NODE_127585_length_334_cov_275.425532	135	215	451	1	80	0.0125000
NODE_127585_length_334_cov_275.425532	135	215	452	1	80	0.0125000
NODE_127585_length_334_cov_275.425532	135	215	456	1	80	0.0125000
NODE_127585_length_334_cov_275.425532	135	215	459	1	80	0.0125000
NODE_127585_length_334_cov_275.425532	135	215	461	1	80	0.0125000
NODE_127585_length_334_cov_275.425532	135	215	463	3	80	0.0375000
NODE_127585_length_334_cov_275.425532	135	215	464	1	80	0.0125000
NODE_127585_length_334_cov_275.425532	135	215	468	1	80	0.0125000
NODE_127585_length_334_cov_275.425532	135	215	474	1	80	0.0125000
NODE_127585_length_334_cov_275.425532	135	215	475	1	80	0.0125000
NODE_127585_length_334_cov_275.425532	135	215	476	1	80	0.0125000
NODE_127585_length_334_cov_275.425532	135	215	481	3	80	0.0375000
NODE_127585_length_334_cov_275.425532	135	215	484	1	80	0.0125000
NODE_127585_length_334_cov_275.425532	135	215	485	2	80	0.0250000
NODE_127585_length_334_cov_275.425532	135	215	487	1	80	0.0125000
NODE_127585_length_334_cov_275.425532	135	215	491	1	80	0.0125000
NODE_127585_length_334_cov_275.425532	135	215	495	1	80	0.0125000
NODE_127585_length_334_cov_275.425532	135	215	497	1	80	0.0125000
NODE_127585_length_334_cov_275.425532	135	215	501	1	80	0.0125000
NODE_127585_length_334_cov_275.425532	135	215	505	1	80	0.0125000
NODE_127585_length_334_cov_275.425532	135	215	514	1	80	0.0125000
NODE_127585_length_334_cov_275.425532	135	215	515	1	80	0.0125000
NODE_127585_length_334_cov_275.425532	135	215	519	4	80	0.0500000
NODE_127585_length_334_cov_275.425532	135	215	521	1	80	0.0125000
NODE_127585_length_334_cov_275.425532	135	215	522	1	80	0.0125000
NODE_127585_length_334_cov_275.425532	135	215	524	1	80	0.0125000
NODE_127585_length_334_cov_275.425532	135	215	526	1	80	0.0125000
NODE_127585_length_334_cov_275.425532	135	215	529	1	80	0.0125000
NODE_127585_length_334_cov_275.425532	135	215	532	1	80	0.0125000
NODE_127585_length_334_cov_275.425532	135	215	536	1	80	0.0125000
NODE_127585_length_334_cov_275.425532	135	215	544	2	80	0.0250000
NODE_127585_length_334_cov_275.425532	135	215	545	2	80	0.0250000
NODE_127585_length_334_cov_275.425532	135	215	550	1	80	0.0125000
NODE_127585_length_334_cov_275.425532	135	215	551	3	80	0.0375000
NODE_127585_length_334_cov_275.425532	135	215	555	1	80	0.0125000
NODE_127585_length_334_cov_275.425532	135	215	558	1	80	0.0125000
NODE_127585_length_334_cov_275.425532	135	215	560	1	80	0.0125000
NODE_127585_length_334_cov_275.425532	135	215	563	2	80	0.0250000
NODE_127585_length_334_cov_275.425532	135	215	566	3	80	0.0375000
NODE_127585_length_334_cov_275.425532	135	215	569	1	80	0.0125000
NODE_127585_length_334_cov_275.425532	135	215	571	2	80	0.0250000
NODE_127585_length_334_cov_275.425532	135	215	573	1	80	0.0125000
NODE_127585_length_334_cov_275.425532	135	215	578	1	80	0.0125000
NODE_127585_length_334_cov_275.425532	135	215	579	1	80	0.0125000
NODE_127585_length_334_cov_275.425532	135	215	581	1	80	0.0125000
NODE_127585_length_334_cov_275.425532	135	215	583	1	80	0.0125000
NODE_127585_length_334_cov_275.425532	135	215	584	1	80	0.0125000
NODE_127585_length_334_cov_275.425532	135	215	589	2	80	0.0250000
NODE_127585_length_334_cov_275.425532	135	215	590	1	80	0.0125000
NODE_127585_length_334_cov_275.425532	188	269	289	2	81	0.0246914
NODE_127585_length_334_cov_275.425532	188	269	290	3	81	0.0370370
NODE_127585_length_334_cov_275.425532	188	269	294	1	81	0.0123457
NODE_127585_length_334_cov_275.425532	188	269	295	7	81	0.0864198
NODE_127585_length_334_cov_275.425532	188	269	296	4	81	0.0493827
NODE_127585_length_334_cov_275.425532	188	269	297	1	81	0.0123457
NODE_127585_length_334_cov_275.425532	188	269	298	7	81	0.0864198
NODE_127585_length_334_cov_275.425532	188	269	299	4	81	0.0493827
NODE_127585_length_334_cov_275.425532	188	269	300	1	81	0.0123457
NODE_127585_length_334_cov_275.425532	188	269	303	4	81	0.0493827
NODE_127585_length_334_cov_275.425532	188	269	312	1	81	0.0123457
NODE_127585_length_334_cov_275.425532	188	269	324	1	81	0.0123457
NODE_127585_length_334_cov_275.425532	188	269	335	3	81	0.0370370
NODE_127585_length_334_cov_275.425532	188	269	343	1	81	0.0123457
NODE_127585_length_334_cov_275.425532	188	269	355	1	81	0.0123457
NODE_127585_length_334_cov_275.425532	188	269	356	1	81	0.0123457
NODE_127585_length_334_cov_275.425532	188	269	364	1	81	0.0123457
NODE_127585_length_334_cov_275.425532	188	269	372	1	81	0.0123457
NODE_127585_length_334_cov_275.425532	188	269	373	1	81	0.0123457
NODE_127585_length_334_cov_275.425532	188	269	377	1	81	0.0123457
NODE_127585_length_334_cov_275.425532	188	269	383	1	81	0.0123457
NODE_127585_length_334_cov_275.425532	188	269	399	1	81	0.0123457
NODE_127585_length_334_cov_275.425532	188	269	402	1	81	0.0123457
NODE_127585_length_334_cov_275.425532	188	269	405	1	81	0.0123457
NODE_127585_length_334_cov_275.425532	188	269	407	1	81	0.0123457
NODE_127585_length_334_cov_275.425532	188	269	418	1	81	0.0123457
NODE_127585_length_334_cov_275.425532	188	269	420	1	81	0.0123457
NODE_127585_length_334_cov_275.425532	188	269	425	1	81	0.0123457
NODE_127585_length_334_cov_275.425532	188	269	427	1	81	0.0123457
NODE_127585_length_334_cov_275.425532	188	269	428	1	81	0.0123457
NODE_127585_length_334_cov_275.425532	188	269	429	1	81	0.0123457
NODE_127585_length_334_cov_275.425532	188	269	433	1	81	0.0123457
NODE_127585_length_334_cov_275.425532	188	269	441	1	81	0.0123457
NODE_127585_length_334_cov_275.425532	188	269	443	1	81	0.0123457
NODE_127585_length_334_cov_275.425532	188	269	447	1	81	0.0123457
NODE_127585_length_334_cov_275.425532	188	269	449	1	81	0.0123457
NODE_127585_length_334_cov_275.425532	188	269	456	1	81	0.0123457
NODE_127585_length_334_cov_275.425532	188	269	461	1	81	0.0123457
NODE_127585_length_334_cov_275.425532	188	269	463	3	81	0.0370370
NODE_127585_length_334_cov_275.425532	188	269	464	1	81	0.0123457
NODE_127585_length_334_cov_275.425532	188	269	468	1	81	0.0123457
NODE_127585_length_334_cov_275.425532	188	269	475	1	81	0.0123457
NODE_127585_length_334_cov_275.425532	188	269	481	3	81	0.0370370
NODE_127585_length_334_cov_275.425532	188	269	484	1	81	0.0123457
NODE_127585_length_334_cov_275.425532	188	269	485	2	81	0.0246914
NODE_127585_length_334_cov_275.425532	188	269	491	1	81	0.0123457
NODE_127585_length_334_cov_275.425532	188	269	495	1	81	0.0123457
NODE_127585_length_334_cov_275.425532	188	269	497	1	81	0.0123457
NODE_127585_length_334_cov_275.425532	188	269	501	1	81	0.0123457
NODE_127585_length_334_cov_275.425532	188	269	505	1	81	0.0123457
NODE_127586_length_334_cov_14.753191	135	215	0	34	80	0.4250000
NODE_127586_length_334_cov_14.753191	135	215	2	46	80	0.5750000
NODE_127586_length_334_cov_14.753191	188	268	2	80	80	1.0000000
NODE_127610_length_334_cov_4.829787	92	174	0	77	82	0.9390244
NODE_127610_length_334_cov_4.829787	92	174	2	5	82	0.0609756
NODE_127610_length_334_cov_4.829787	151	237	0	18	86	0.2093023
NODE_127610_length_334_cov_4.829787	151	237	2	68	86	0.7906977
NODE_127612_length_334_cov_4.817021	179	231	0	51	52	0.9807692
NODE_127612_length_334_cov_4.817021	179	231	2	1	52	0.0192308
NODE_127626_length_334_cov_4.438298	121	201	0	69	80	0.8625000
NODE_127626_length_334_cov_4.438298	121	201	2	1	80	0.0125000
NODE_127626_length_334_cov_4.438298	121	201	4	10	80	0.1250000
NODE_127672_length_334_cov_3.604255	248	314	4	66	66	1.0000000
NODE_127672_length_334_cov_3.604255	287	334	2	1	47	0.0212766
NODE_127672_length_334_cov_3.604255	287	334	4	46	47	0.9787234
NODE_127844_length_334_cov_2.165957	0	48	0	48	48	1.0000000
NODE_128026_length_334_cov_1.595745	253	328	0	75	75	1.0000000
NODE_128258_length_334_cov_1.157447	146	177	0	31	31	1.0000000
NODE_128665_length_333_cov_5.423077	172	242	0	70	70	1.0000000
NODE_128673_length_333_cov_4.867521	122	172	2	8	50	0.1600000
NODE_128673_length_333_cov_4.867521	122	172	4	2	50	0.0400000
NODE_128673_length_333_cov_4.867521	122	172	6	40	50	0.8000000
NODE_128673_length_333_cov_4.867521	175	255	4	57	80	0.7125000
NODE_128673_length_333_cov_4.867521	175	255	8	23	80	0.2875000
NODE_128673_length_333_cov_4.867521	194	219	4	4	25	0.1600000
NODE_128673_length_333_cov_4.867521	194	219	8	21	25	0.8400000
NODE_128717_length_333_cov_3.717949	49	129	0	1	80	0.0125000
NODE_128717_length_333_cov_3.717949	49	129	2	12	80	0.1500000
NODE_128717_length_333_cov_3.717949	49	129	4	9	80	0.1125000
NODE_128717_length_333_cov_3.717949	49	129	14	3	80	0.0375000
NODE_128717_length_333_cov_3.717949	49	129	16	11	80	0.1375000
NODE_128717_length_333_cov_3.717949	49	129	18	16	80	0.2000000
NODE_128717_length_333_cov_3.717949	49	129	22	24	80	0.3000000
NODE_128717_length_333_cov_3.717949	49	129	24	4	80	0.0500000
NODE_128717_length_333_cov_3.717949	102	182	20	3	80	0.0375000
NODE_128717_length_333_cov_3.717949	102	182	22	28	80	0.3500000
NODE_128717_length_333_cov_3.717949	102	182	24	40	80	0.5000000
NODE_128717_length_333_cov_3.717949	102	182	26	9	80	0.1125000
NODE_128767_length_333_cov_2.897436	59	139	2	14	80	0.1750000
NODE_128767_length_333_cov_2.897436	59	139	3	3	80	0.0375000
NODE_128767_length_333_cov_2.897436	59	139	7	18	80	0.2250000
NODE_128767_length_333_cov_2.897436	59	139	8	7	80	0.0875000
NODE_128767_length_333_cov_2.897436	59	139	10	37	80	0.4625000
NODE_128767_length_333_cov_2.897436	59	139	12	1	80	0.0125000
NODE_128850_length_333_cov_2.307692	68	148	0	2	80	0.0250000
NODE_128850_length_333_cov_2.307692	68	148	2	78	80	0.9750000
NODE_128933_length_333_cov_1.940171	135	215	2	34	80	0.4250000
NODE_128933_length_333_cov_1.940171	135	215	3	1	80	0.0125000
NODE_128933_length_333_cov_1.940171	135	215	4	45	80	0.5625000
NODE_129252_length_333_cov_1.200855	0	80	0	56	80	0.7000000
NODE_129252_length_333_cov_1.200855	0	80	2	24	80	0.3000000
NODE_129263_length_333_cov_1.170940	146	193	6	4	47	0.0851064
NODE_129263_length_333_cov_1.170940	146	193	8	21	47	0.4468085
NODE_129263_length_333_cov_1.170940	146	193	10	22	47	0.4680851
NODE_129263_length_333_cov_1.170940	203	243	6	4	40	0.1000000
NODE_129263_length_333_cov_1.170940	203	243	8	17	40	0.4250000
NODE_129263_length_333_cov_1.170940	203	243	10	19	40	0.4750000
NODE_129303_length_333_cov_1.089744	241	306	2	31	65	0.4769231
NODE_129303_length_333_cov_1.089744	241	306	4	34	65	0.5230770
NODE_129310_length_333_cov_1.089744	206	226	0	20	20	1.0000000
NODE_129665_length_332_cov_5.386266	101	167	0	66	66	1.0000000
NODE_129680_length_332_cov_4.768240	221	250	0	21	29	0.7241379
NODE_129680_length_332_cov_4.768240	221	250	2	8	29	0.2758621
NODE_129695_length_332_cov_4.343348	130	179	0	49	49	1.0000000
NODE_129698_length_332_cov_4.201717	191	237	3	46	46	1.0000000
NODE_129698_length_332_cov_4.201717	211	290	2	47	79	0.5949367
NODE_129698_length_332_cov_4.201717	211	290	3	32	79	0.4050633
NODE_129879_length_332_cov_2.274678	187	227	4	3	40	0.0750000
NODE_129879_length_332_cov_2.274678	187	227	6	5	40	0.1250000
NODE_129879_length_332_cov_2.274678	187	227	8	5	40	0.1250000
NODE_129879_length_332_cov_2.274678	187	227	10	4	40	0.1000000
NODE_129879_length_332_cov_2.274678	187	227	11	1	40	0.0250000
NODE_129879_length_332_cov_2.274678	187	227	12	3	40	0.0750000
NODE_129879_length_332_cov_2.274678	187	227	14	5	40	0.1250000
NODE_129879_length_332_cov_2.274678	187	227	16	1	40	0.0250000
NODE_129879_length_332_cov_2.274678	187	227	18	1	40	0.0250000
NODE_129879_length_332_cov_2.274678	187	227	20	4	40	0.1000000
NODE_129879_length_332_cov_2.274678	187	227	22	4	40	0.1000000
NODE_129879_length_332_cov_2.274678	187	227	24	4	40	0.1000000
NODE_129901_length_332_cov_2.184549	194	258	2	25	64	0.3906250
NODE_129901_length_332_cov_2.184549	194	258	4	39	64	0.6093750
NODE_130053_length_332_cov_1.682403	241	316	0	75	75	1.0000000
NODE_130055_length_332_cov_1.673820	157	220	0	63	63	1.0000000
NODE_130183_length_332_cov_1.364807	132	212	0	30	80	0.3750000
NODE_130183_length_332_cov_1.364807	132	212	2	5	80	0.0625000
NODE_130183_length_332_cov_1.364807	132	212	3	10	80	0.1250000
NODE_130183_length_332_cov_1.364807	132	212	5	35	80	0.4375000
NODE_130187_length_332_cov_1.356223	276	332	0	3	56	0.0535714
NODE_130187_length_332_cov_1.356223	276	332	5	1	56	0.0178571
NODE_130187_length_332_cov_1.356223	276	332	6	1	56	0.0178571
NODE_130187_length_332_cov_1.356223	276	332	8	6	56	0.1071429
NODE_130187_length_332_cov_1.356223	276	332	10	45	56	0.8035714
NODE_130312_length_332_cov_1.210300	120	176	0	56	56	1.0000000
NODE_130757_length_331_cov_5.254310	141	221	0	80	80	1.0000000
NODE_130757_length_331_cov_5.254310	194	274	0	80	80	1.0000000
NODE_130781_length_331_cov_4.323276	26	108	0	2	82	0.0243902
NODE_130781_length_331_cov_4.323276	26	108	2	3	82	0.0365854
NODE_130781_length_331_cov_4.323276	26	108	4	4	82	0.0487805
NODE_130781_length_331_cov_4.323276	26	108	6	7	82	0.0853659
NODE_130781_length_331_cov_4.323276	26	108	8	44	82	0.5365854
NODE_130781_length_331_cov_4.323276	26	108	10	8	82	0.0975610
NODE_130781_length_331_cov_4.323276	26	108	12	14	82	0.1707317
NODE_130902_length_331_cov_2.603448	128	181	0	40	53	0.7547170
NODE_130902_length_331_cov_2.603448	128	181	2	13	53	0.2452830
NODE_131036_length_331_cov_1.965517	183	216	0	33	33	1.0000000
NODE_131054_length_331_cov_1.896552	266	331	0	41	65	0.6307693
NODE_131054_length_331_cov_1.896552	266	331	2	9	65	0.1384615
NODE_131054_length_331_cov_1.896552	266	331	4	15	65	0.2307692
NODE_131817_length_330_cov_14.731602	209	280	2	15	71	0.2112676
NODE_131817_length_330_cov_14.731602	209	280	16	56	71	0.7887324
NODE_131840_length_330_cov_4.935065	16	97	0	81	81	1.0000000
NODE_131840_length_330_cov_4.935065	81	149	0	68	68	1.0000000
NODE_131841_length_330_cov_4.891775	177	255	0	78	78	1.0000000
NODE_131845_length_330_cov_4.740260	134	209	2	9	75	0.1200000
NODE_131845_length_330_cov_4.740260	134	209	4	66	75	0.8800000
NODE_131892_length_330_cov_3.467532	161	225	4	5	64	0.0781250
NODE_131892_length_330_cov_3.467532	161	225	5	1	64	0.0156250
NODE_131892_length_330_cov_3.467532	161	225	6	19	64	0.2968750
NODE_131892_length_330_cov_3.467532	161	225	7	26	64	0.4062500
NODE_131892_length_330_cov_3.467532	161	225	8	13	64	0.2031250
NODE_131969_length_330_cov_2.601732	8	88	2	33	80	0.4125000
NODE_131969_length_330_cov_2.601732	8	88	8	5	80	0.0625000
NODE_131969_length_330_cov_2.601732	8	88	10	42	80	0.5250000
NODE_132188_length_330_cov_1.623377	154	200	0	46	46	1.0000000
NODE_132238_length_330_cov_1.541126	98	156	0	58	58	1.0000000
NODE_132268_length_330_cov_1.467532	234	287	0	53	53	1.0000000
NODE_132268_length_330_cov_1.467532	242	283	0	41	41	1.0000000
NODE_132306_length_330_cov_1.346320	230	296	4	21	66	0.3181818
NODE_132306_length_330_cov_1.346320	230	296	6	45	66	0.6818182
NODE_132306_length_330_cov_1.346320	230	257	6	27	27	1.0000000
NODE_132410_length_330_cov_1.220779	249	272	0	23	23	1.0000000
NODE_132478_length_330_cov_1.103896	189	227	2	38	38	1.0000000
NODE_132542_length_330_cov_1.038961	219	297	29	12	78	0.1538462
NODE_132542_length_330_cov_1.038961	219	297	30	1	78	0.0128205
NODE_132542_length_330_cov_1.038961	219	297	31	7	78	0.0897436
NODE_132542_length_330_cov_1.038961	219	297	35	12	78	0.1538462
NODE_132542_length_330_cov_1.038961	219	297	36	2	78	0.0256410
NODE_132542_length_330_cov_1.038961	219	297	40	4	78	0.0512821
NODE_132542_length_330_cov_1.038961	219	297	42	8	78	0.1025641
NODE_132542_length_330_cov_1.038961	219	297	44	5	78	0.0641026
NODE_132542_length_330_cov_1.038961	219	297	45	2	78	0.0256410
NODE_132542_length_330_cov_1.038961	219	297	54	1	78	0.0128205
NODE_132542_length_330_cov_1.038961	219	297	62	1	78	0.0128205
NODE_132542_length_330_cov_1.038961	219	297	83	1	78	0.0128205
NODE_132542_length_330_cov_1.038961	219	297	84	5	78	0.0641026
NODE_132542_length_330_cov_1.038961	219	297	86	1	78	0.0128205
NODE_132542_length_330_cov_1.038961	219	297	94	1	78	0.0128205
NODE_132542_length_330_cov_1.038961	219	297	96	4	78	0.0512821
NODE_132542_length_330_cov_1.038961	219	297	98	1	78	0.0128205
NODE_132542_length_330_cov_1.038961	219	297	99	4	78	0.0512821
NODE_132542_length_330_cov_1.038961	219	297	101	1	78	0.0128205
NODE_132542_length_330_cov_1.038961	219	297	103	2	78	0.0256410
NODE_132542_length_330_cov_1.038961	219	297	109	2	78	0.0256410
NODE_132542_length_330_cov_1.038961	219	297	119	1	78	0.0128205
NODE_132688_length_330_cov_0.883117	284	330	0	46	46	1.0000000
NODE_132873_length_329_cov_110.178261	138	167	4	6	29	0.2068966
NODE_132873_length_329_cov_110.178261	138	167	6	8	29	0.2758621
NODE_132873_length_329_cov_110.178261	138	167	8	9	29	0.3103448
NODE_132873_length_329_cov_110.178261	138	167	10	3	29	0.1034483
NODE_132873_length_329_cov_110.178261	138	167	14	1	29	0.0344828
NODE_132873_length_329_cov_110.178261	138	167	16	1	29	0.0344828
NODE_132873_length_329_cov_110.178261	138	167	18	1	29	0.0344828
NODE_132873_length_329_cov_110.178261	189	269	26	1	80	0.0125000
NODE_132873_length_329_cov_110.178261	189	269	28	3	80	0.0375000
NODE_132873_length_329_cov_110.178261	189	269	30	1	80	0.0125000
NODE_132873_length_329_cov_110.178261	189	269	32	4	80	0.0500000
NODE_132873_length_329_cov_110.178261	189	269	34	5	80	0.0625000
NODE_132873_length_329_cov_110.178261	189	269	36	7	80	0.0875000
NODE_132873_length_329_cov_110.178261	189	269	38	26	80	0.3250000
NODE_132873_length_329_cov_110.178261	189	269	40	33	80	0.4125000
NODE_132873_length_329_cov_110.178261	242	322	8	21	80	0.2625000
NODE_132873_length_329_cov_110.178261	242	322	12	6	80	0.0750000
NODE_132873_length_329_cov_110.178261	242	322	15	1	80	0.0125000
NODE_132873_length_329_cov_110.178261	242	322	16	3	80	0.0375000
NODE_132873_length_329_cov_110.178261	242	322	22	2	80	0.0250000
NODE_132873_length_329_cov_110.178261	242	322	26	21	80	0.2625000
NODE_132873_length_329_cov_110.178261	242	322	28	3	80	0.0375000
NODE_132873_length_329_cov_110.178261	242	322	30	1	80	0.0125000
NODE_132873_length_329_cov_110.178261	242	322	32	4	80	0.0500000
NODE_132873_length_329_cov_110.178261	242	322	34	5	80	0.0625000
NODE_132873_length_329_cov_110.178261	242	322	36	5	80	0.0625000
NODE_132873_length_329_cov_110.178261	242	322	38	8	80	0.1000000
NODE_132879_length_329_cov_8.882609	61	141	0	80	80	1.0000000
NODE_132879_length_329_cov_8.882609	114	194	0	80	80	1.0000000
NODE_132885_length_329_cov_6.586957	166	207	4	5	41	0.1219512
NODE_132885_length_329_cov_6.586957	166	207	6	36	41	0.8780488
NODE_132908_length_329_cov_4.617391	175	229	0	54	54	1.0000000
NODE_132970_length_329_cov_3.160870	59	139	2	16	80	0.2000000
NODE_132970_length_329_cov_3.160870	59	139	6	64	80	0.8000000
NODE_133003_length_329_cov_2.821739	164	209	0	45	45	1.0000000
NODE_133003_length_329_cov_2.821739	184	262	0	78	78	1.0000000
NODE_133033_length_329_cov_2.560870	139	201	0	55	62	0.8870968
NODE_133033_length_329_cov_2.560870	139	201	2	7	62	0.1129032
NODE_133036_length_329_cov_2.543478	145	206	6	3	61	0.0491803
NODE_133036_length_329_cov_2.543478	145	206	8	58	61	0.9508197
NODE_133123_length_329_cov_2.143478	39	119	4	12	80	0.1500000
NODE_133123_length_329_cov_2.143478	39	119	6	10	80	0.1250000
NODE_133123_length_329_cov_2.143478	39	119	8	6	80	0.0750000
NODE_133123_length_329_cov_2.143478	39	119	10	13	80	0.1625000
NODE_133123_length_329_cov_2.143478	39	119	12	2	80	0.0250000
NODE_133123_length_329_cov_2.143478	39	119	14	9	80	0.1125000
NODE_133123_length_329_cov_2.143478	39	119	16	28	80	0.3500000
NODE_133123_length_329_cov_2.143478	92	158	8	4	66	0.0606061
NODE_133123_length_329_cov_2.143478	92	158	12	8	66	0.1212121
NODE_133123_length_329_cov_2.143478	92	158	14	17	66	0.2575758
NODE_133123_length_329_cov_2.143478	92	158	16	37	66	0.5606061
NODE_133184_length_329_cov_1.865217	182	252	0	3	70	0.0428571
NODE_133184_length_329_cov_1.865217	182	252	2	29	70	0.4142857
NODE_133184_length_329_cov_1.865217	182	252	3	1	70	0.0142857
NODE_133184_length_329_cov_1.865217	182	252	5	5	70	0.0714286
NODE_133184_length_329_cov_1.865217	182	252	6	29	70	0.4142857
NODE_133184_length_329_cov_1.865217	182	252	10	1	70	0.0142857
NODE_133184_length_329_cov_1.865217	182	252	12	2	70	0.0285714
NODE_133200_length_329_cov_1.791304	50	84	0	34	34	1.0000000
NODE_133200_length_329_cov_1.791304	92	149	6	7	57	0.1228070
NODE_133200_length_329_cov_1.791304	92	149	10	50	57	0.8771930
NODE_133200_length_329_cov_1.791304	145	203	4	27	58	0.4655173
NODE_133200_length_329_cov_1.791304	145	203	9	1	58	0.0172414
NODE_133200_length_329_cov_1.791304	145	203	10	30	58	0.5172414
NODE_133332_length_329_cov_1.508696	261	323	0	62	62	1.0000000
NODE_133348_length_329_cov_1.469565	168	237	0	14	69	0.2028985
NODE_133348_length_329_cov_1.469565	168	237	2	55	69	0.7971014
NODE_133376_length_329_cov_1.391304	275	307	18	15	32	0.4687500
NODE_133376_length_329_cov_1.391304	275	307	20	4	32	0.1250000
NODE_133376_length_329_cov_1.391304	275	307	21	1	32	0.0312500
NODE_133376_length_329_cov_1.391304	275	307	23	9	32	0.2812500
NODE_133376_length_329_cov_1.391304	275	307	24	3	32	0.0937500
NODE_133547_length_329_cov_1.165217	199	242	0	43	43	1.0000000
NODE_133768_length_329_cov_0.878261	221	296	0	75	75	1.0000000
NODE_133970_length_328_cov_4.484716	95	175	2	40	80	0.5000000
NODE_133970_length_328_cov_4.484716	95	175	4	40	80	0.5000000
NODE_133989_length_328_cov_4.087336	79	159	0	7	80	0.0875000
NODE_133989_length_328_cov_4.087336	79	159	4	73	80	0.9125000
NODE_133989_length_328_cov_4.087336	132	207	0	14	75	0.1866667
NODE_133989_length_328_cov_4.087336	132	207	1	1	75	0.0133333
NODE_133989_length_328_cov_4.087336	132	207	2	25	75	0.3333333
NODE_133989_length_328_cov_4.087336	132	207	4	35	75	0.4666667
NODE_133993_length_328_cov_3.895197	110	190	23	7	80	0.0875000
NODE_133993_length_328_cov_3.895197	110	190	27	72	80	0.9000000
NODE_133993_length_328_cov_3.895197	110	190	31	1	80	0.0125000
NODE_134019_length_328_cov_3.393013	30	78	0	48	48	1.0000000
NODE_134144_length_328_cov_2.161572	103	134	6	3	31	0.0967742
NODE_134144_length_328_cov_2.161572	103	134	10	7	31	0.2258064
NODE_134144_length_328_cov_2.161572	103	134	12	21	31	0.6774194
NODE_134247_length_328_cov_1.781659	16	44	0	28	28	1.0000000
NODE_134335_length_328_cov_1.567686	0	76	0	76	76	1.0000000
NODE_134335_length_328_cov_1.567686	49	94	0	43	45	0.9555556
NODE_134335_length_328_cov_1.567686	49	94	2	2	45	0.0444444
NODE_134452_length_328_cov_1.336245	0	73	0	73	73	1.0000000
NODE_134508_length_328_cov_1.266376	78	158	0	10	80	0.1250000
NODE_134508_length_328_cov_1.266376	78	158	2	33	80	0.4125000
NODE_134508_length_328_cov_1.266376	78	158	4	37	80	0.4625000
NODE_135002_length_327_cov_4.934211	170	250	0	80	80	1.0000000
NODE_135009_length_327_cov_4.701754	225	305	0	68	80	0.8500000
NODE_135009_length_327_cov_4.701754	225	305	2	12	80	0.1500000
NODE_135018_length_327_cov_4.241228	97	173	6	5	76	0.0657895
NODE_135018_length_327_cov_4.241228	97	173	8	69	76	0.9078947
NODE_135018_length_327_cov_4.241228	97	173	10	2	76	0.0263158
NODE_135037_length_327_cov_3.719298	70	150	0	80	80	1.0000000
NODE_135063_length_327_cov_3.350877	156	227	0	4	71	0.0563380
NODE_135063_length_327_cov_3.350877	156	227	2	1	71	0.0140845
NODE_135063_length_327_cov_3.350877	156	227	4	66	71	0.9295775
NODE_135328_length_327_cov_1.780702	191	271	8	2	80	0.0250000
NODE_135328_length_327_cov_1.780702	191	271	10	11	80	0.1375000
NODE_135328_length_327_cov_1.780702	191	271	11	1	80	0.0125000
NODE_135328_length_327_cov_1.780702	191	271	13	2	80	0.0250000
NODE_135328_length_327_cov_1.780702	191	271	17	3	80	0.0375000
NODE_135328_length_327_cov_1.780702	191	271	22	1	80	0.0125000
NODE_135328_length_327_cov_1.780702	191	271	23	16	80	0.2000000
NODE_135328_length_327_cov_1.780702	191	271	24	7	80	0.0875000
NODE_135328_length_327_cov_1.780702	191	271	26	37	80	0.4625000
NODE_136081_length_326_cov_3.964758	178	228	0	50	50	1.0000000
NODE_136100_length_326_cov_3.502203	211	253	0	42	42	1.0000000
NODE_136100_length_326_cov_3.502203	220	255	0	35	35	1.0000000
NODE_136116_length_326_cov_3.202643	149	203	2	3	54	0.0555556
NODE_136116_length_326_cov_3.202643	149	203	4	1	54	0.0185185
NODE_136116_length_326_cov_3.202643	149	203	6	2	54	0.0370370
NODE_136116_length_326_cov_3.202643	149	203	8	12	54	0.2222222
NODE_136116_length_326_cov_3.202643	149	203	9	20	54	0.3703704
NODE_136116_length_326_cov_3.202643	149	203	10	16	54	0.2962963
NODE_136130_length_326_cov_3.057269	107	126	0	19	19	1.0000000
NODE_136176_length_326_cov_2.594714	125	196	0	71	71	1.0000000
NODE_136283_length_326_cov_2.123348	184	244	0	60	60	1.0000000
NODE_136496_length_326_cov_1.515419	86	166	2	80	80	1.0000000
NODE_137182_length_325_cov_4.893805	142	222	44	1	80	0.0125000
NODE_137182_length_325_cov_4.893805	142	222	46	4	80	0.0500000
NODE_137182_length_325_cov_4.893805	142	222	50	2	80	0.0250000
NODE_137182_length_325_cov_4.893805	142	222	56	1	80	0.0125000
NODE_137182_length_325_cov_4.893805	142	222	57	28	80	0.3500000
NODE_137182_length_325_cov_4.893805	142	222	61	1	80	0.0125000
NODE_137182_length_325_cov_4.893805	142	222	62	2	80	0.0250000
NODE_137182_length_325_cov_4.893805	142	222	63	6	80	0.0750000
NODE_137182_length_325_cov_4.893805	142	222	65	2	80	0.0250000
NODE_137182_length_325_cov_4.893805	142	222	67	10	80	0.1250000
NODE_137182_length_325_cov_4.893805	142	222	68	14	80	0.1750000
NODE_137182_length_325_cov_4.893805	142	222	70	9	80	0.1125000
NODE_137182_length_325_cov_4.893805	195	275	18	3	80	0.0375000
NODE_137182_length_325_cov_4.893805	195	275	21	1	80	0.0125000
NODE_137182_length_325_cov_4.893805	195	275	22	10	80	0.1250000
NODE_137182_length_325_cov_4.893805	195	275	23	8	80	0.1000000
NODE_137182_length_325_cov_4.893805	195	275	24	7	80	0.0875000
NODE_137182_length_325_cov_4.893805	195	275	31	1	80	0.0125000
NODE_137182_length_325_cov_4.893805	195	275	36	1	80	0.0125000
NODE_137182_length_325_cov_4.893805	195	275	37	4	80	0.0500000
NODE_137182_length_325_cov_4.893805	195	275	39	2	80	0.0250000
NODE_137182_length_325_cov_4.893805	195	275	40	10	80	0.1250000
NODE_137182_length_325_cov_4.893805	195	275	42	5	80	0.0625000
NODE_137182_length_325_cov_4.893805	195	275	44	2	80	0.0250000
NODE_137182_length_325_cov_4.893805	195	275	46	4	80	0.0500000
NODE_137182_length_325_cov_4.893805	195	275	50	2	80	0.0250000
NODE_137182_length_325_cov_4.893805	195	275	56	1	80	0.0125000
NODE_137182_length_325_cov_4.893805	195	275	62	2	80	0.0250000
NODE_137182_length_325_cov_4.893805	195	275	67	3	80	0.0375000
NODE_137182_length_325_cov_4.893805	195	275	68	9	80	0.1125000
NODE_137182_length_325_cov_4.893805	195	275	70	5	80	0.0625000
NODE_137199_length_325_cov_4.000000	134	198	8	17	64	0.2656250
NODE_137199_length_325_cov_4.000000	134	198	10	38	64	0.5937500
NODE_137199_length_325_cov_4.000000	134	198	12	9	64	0.1406250
NODE_137221_length_325_cov_3.513274	191	266	40	1	75	0.0133333
NODE_137221_length_325_cov_3.513274	191	266	42	9	75	0.1200000
NODE_137221_length_325_cov_3.513274	191	266	44	10	75	0.1333333
NODE_137221_length_325_cov_3.513274	191	266	46	10	75	0.1333333
NODE_137221_length_325_cov_3.513274	191	266	47	1	75	0.0133333
NODE_137221_length_325_cov_3.513274	191	266	48	6	75	0.0800000
NODE_137221_length_325_cov_3.513274	191	266	49	2	75	0.0266667
NODE_137221_length_325_cov_3.513274	191	266	50	14	75	0.1866667
NODE_137221_length_325_cov_3.513274	191	266	52	6	75	0.0800000
NODE_137221_length_325_cov_3.513274	191	266	53	3	75	0.0400000
NODE_137221_length_325_cov_3.513274	191	266	54	4	75	0.0533333
NODE_137221_length_325_cov_3.513274	191	266	56	8	75	0.1066667
NODE_137221_length_325_cov_3.513274	191	266	58	1	75	0.0133333
NODE_137221_length_325_cov_3.513274	240	319	14	3	79	0.0379747
NODE_137221_length_325_cov_3.513274	240	319	22	1	79	0.0126582
NODE_137221_length_325_cov_3.513274	240	319	24	4	79	0.0506329
NODE_137221_length_325_cov_3.513274	240	319	25	1	79	0.0126582
NODE_137221_length_325_cov_3.513274	240	319	26	12	79	0.1518987
NODE_137221_length_325_cov_3.513274	240	319	27	3	79	0.0379747
NODE_137221_length_325_cov_3.513274	240	319	28	5	79	0.0632911
NODE_137221_length_325_cov_3.513274	240	319	32	2	79	0.0253165
NODE_137221_length_325_cov_3.513274	240	319	34	2	79	0.0253165
NODE_137221_length_325_cov_3.513274	240	319	36	15	79	0.1898734
NODE_137221_length_325_cov_3.513274	240	319	38	4	79	0.0506329
NODE_137221_length_325_cov_3.513274	240	319	40	2	79	0.0253165
NODE_137221_length_325_cov_3.513274	240	319	42	9	79	0.1139240
NODE_137221_length_325_cov_3.513274	240	319	44	10	79	0.1265823
NODE_137221_length_325_cov_3.513274	240	319	46	6	79	0.0759494
NODE_137223_length_325_cov_3.469027	216	278	0	62	62	1.0000000
NODE_137224_length_325_cov_3.429204	178	224	2	46	46	1.0000000
NODE_137243_length_325_cov_3.168142	188	274	0	47	86	0.5465117
NODE_137243_length_325_cov_3.168142	188	274	2	39	86	0.4534884
NODE_137268_length_325_cov_2.880531	72	152	2	5	80	0.0625000
NODE_137268_length_325_cov_2.880531	72	152	4	8	80	0.1000000
NODE_137268_length_325_cov_2.880531	72	152	6	31	80	0.3875000
NODE_137268_length_325_cov_2.880531	72	152	8	7	80	0.0875000
NODE_137268_length_325_cov_2.880531	72	152	10	29	80	0.3625000
NODE_137268_length_325_cov_2.880531	125	205	8	1	80	0.0125000
NODE_137268_length_325_cov_2.880531	125	205	9	10	80	0.1250000
NODE_137268_length_325_cov_2.880531	125	205	10	30	80	0.3750000
NODE_137268_length_325_cov_2.880531	125	205	11	19	80	0.2375000
NODE_137268_length_325_cov_2.880531	125	205	12	2	80	0.0250000
NODE_137268_length_325_cov_2.880531	125	205	13	10	80	0.1250000
NODE_137268_length_325_cov_2.880531	125	205	15	8	80	0.1000000
NODE_137291_length_325_cov_2.707965	203	261	0	29	58	0.5000000
NODE_137291_length_325_cov_2.707965	203	261	2	29	58	0.5000000
NODE_137296_length_325_cov_2.703540	68	148	8	80	80	1.0000000
NODE_137330_length_325_cov_2.500000	0	42	0	42	42	1.0000000
NODE_137407_length_325_cov_2.048673	122	202	22	7	80	0.0875000
NODE_137407_length_325_cov_2.048673	122	202	24	1	80	0.0125000
NODE_137407_length_325_cov_2.048673	122	202	26	4	80	0.0500000
NODE_137407_length_325_cov_2.048673	122	202	28	32	80	0.4000000
NODE_137407_length_325_cov_2.048673	122	202	30	11	80	0.1375000
NODE_137407_length_325_cov_2.048673	122	202	32	8	80	0.1000000
NODE_137407_length_325_cov_2.048673	122	202	33	1	80	0.0125000
NODE_137407_length_325_cov_2.048673	122	202	34	16	80	0.2000000
NODE_137409_length_325_cov_2.035398	83	154	0	71	71	1.0000000
NODE_137642_length_325_cov_1.464602	153	224	4	71	71	1.0000000
NODE_137939_length_325_cov_1.017699	103	134	2	20	31	0.6451613
NODE_137939_length_325_cov_1.017699	103	134	4	11	31	0.3548387
NODE_138113_length_325_cov_0.827434	258	308	2	17	50	0.3400000
NODE_138113_length_325_cov_0.827434	258	308	4	5	50	0.1000000
NODE_138113_length_325_cov_0.827434	258	308	6	11	50	0.2200000
NODE_138113_length_325_cov_0.827434	258	308	10	17	50	0.3400000
NODE_138309_length_324_cov_4.737778	113	160	0	47	47	1.0000000
NODE_138309_length_324_cov_4.737778	142	213	0	71	71	1.0000000
NODE_138358_length_324_cov_3.626667	218	273	0	55	55	1.0000000
NODE_138396_length_324_cov_3.124444	101	181	0	80	80	1.0000000
NODE_138396_length_324_cov_3.124444	256	285	0	29	29	1.0000000
NODE_138416_length_324_cov_2.924444	114	198	2	18	84	0.2142857
NODE_138416_length_324_cov_2.924444	114	198	4	3	84	0.0357143
NODE_138416_length_324_cov_2.924444	114	198	6	5	84	0.0595238
NODE_138416_length_324_cov_2.924444	114	198	8	5	84	0.0595238
NODE_138416_length_324_cov_2.924444	114	198	10	14	84	0.1666667
NODE_138416_length_324_cov_2.924444	114	198	12	39	84	0.4642857
NODE_138416_length_324_cov_2.924444	178	237	2	48	59	0.8135593
NODE_138416_length_324_cov_2.924444	178	237	4	11	59	0.1864407
NODE_138418_length_324_cov_2.915556	141	221	0	80	80	1.0000000
NODE_138434_length_324_cov_2.715556	4	51	0	47	47	1.0000000
NODE_138434_length_324_cov_2.715556	24	104	0	80	80	1.0000000
NODE_138463_length_324_cov_2.506667	270	306	0	36	36	1.0000000
NODE_138483_length_324_cov_2.448889	187	238	0	51	51	1.0000000
NODE_138527_length_324_cov_2.248889	30	96	0	38	66	0.5757576
NODE_138527_length_324_cov_2.248889	30	96	2	28	66	0.4242424
NODE_138778_length_324_cov_1.502222	10	90	2	45	80	0.5625000
NODE_138778_length_324_cov_1.502222	10	90	4	35	80	0.4375000
NODE_138792_length_324_cov_1.457778	0	45	0	7	45	0.1555556
NODE_138792_length_324_cov_1.457778	0	45	2	38	45	0.8444445
NODE_138792_length_324_cov_1.457778	18	75	2	49	57	0.8596491
NODE_138792_length_324_cov_1.457778	18	75	4	1	57	0.0175439
NODE_138792_length_324_cov_1.457778	18	75	14	1	57	0.0175439
NODE_138792_length_324_cov_1.457778	18	75	16	1	57	0.0175439
NODE_138792_length_324_cov_1.457778	18	75	18	1	57	0.0175439
NODE_138792_length_324_cov_1.457778	18	75	20	4	57	0.0701754
NODE_138808_length_324_cov_1.382222	263	304	0	41	41	1.0000000
NODE_139129_length_324_cov_1.017778	0	59	0	59	59	1.0000000
NODE_139497_length_323_cov_6.669643	215	286	0	24	71	0.3380282
NODE_139497_length_323_cov_6.669643	215	286	2	47	71	0.6619718
NODE_139497_length_323_cov_6.669643	268	315	0	47	47	1.0000000
NODE_139511_length_323_cov_5.089286	224	290	0	1	66	0.0151515
NODE_139511_length_323_cov_5.089286	224	290	2	65	66	0.9848485
NODE_139511_length_323_cov_5.089286	263	319	2	56	56	1.0000000
NODE_139572_length_323_cov_3.276786	189	269	3	7	80	0.0875000
NODE_139572_length_323_cov_3.276786	189	269	5	22	80	0.2750000
NODE_139572_length_323_cov_3.276786	189	269	7	7	80	0.0875000
NODE_139572_length_323_cov_3.276786	189	269	9	15	80	0.1875000
NODE_139572_length_323_cov_3.276786	189	269	10	3	80	0.0375000
NODE_139572_length_323_cov_3.276786	189	269	14	8	80	0.1000000
NODE_139572_length_323_cov_3.276786	189	269	15	3	80	0.0375000
NODE_139572_length_323_cov_3.276786	189	269	16	5	80	0.0625000
NODE_139572_length_323_cov_3.276786	189	269	17	10	80	0.1250000
NODE_139575_length_323_cov_3.263393	101	181	0	5	80	0.0625000
NODE_139575_length_323_cov_3.263393	101	181	4	61	80	0.7625000
NODE_139575_length_323_cov_3.263393	101	181	6	1	80	0.0125000
NODE_139575_length_323_cov_3.263393	101	181	8	13	80	0.1625000
NODE_139591_length_323_cov_3.089286	128	208	0	80	80	1.0000000
NODE_139591_length_323_cov_3.089286	166	208	0	42	42	1.0000000
NODE_139591_length_323_cov_3.089286	181	261	0	80	80	1.0000000
NODE_139591_length_323_cov_3.089286	181	261	0	80	80	1.0000000
NODE_139629_length_323_cov_2.683036	144	215	8	5	71	0.0704225
NODE_139629_length_323_cov_2.683036	144	215	10	5	71	0.0704225
NODE_139629_length_323_cov_2.683036	144	215	12	1	71	0.0140845
NODE_139629_length_323_cov_2.683036	144	215	16	60	71	0.8450704
NODE_139746_length_323_cov_2.089286	64	144	12	80	80	1.0000000
NODE_139797_length_323_cov_1.888393	148	207	0	59	59	1.0000000
NODE_139901_length_323_cov_1.705357	195	262	0	67	67	1.0000000
NODE_139901_length_323_cov_1.705357	235	315	0	80	80	1.0000000
NODE_140651_length_322_cov_5.475336	56	136	0	80	80	1.0000000
NODE_140651_length_322_cov_5.475336	113	189	0	76	76	1.0000000
NODE_140692_length_322_cov_3.753363	63	133	0	58	70	0.8285714
NODE_140692_length_322_cov_3.753363	63	133	2	12	70	0.1714286
NODE_140692_length_322_cov_3.753363	116	190	0	74	74	1.0000000
NODE_140693_length_322_cov_3.735426	60	86	0	26	26	1.0000000
NODE_140693_length_322_cov_3.735426	99	139	0	40	40	1.0000000
NODE_140701_length_322_cov_3.605381	73	116	5	7	43	0.1627907
NODE_140701_length_322_cov_3.605381	73	116	7	1	43	0.0232558
NODE_140701_length_322_cov_3.605381	73	116	8	4	43	0.0930233
NODE_140701_length_322_cov_3.605381	73	116	10	2	43	0.0465116
NODE_140701_length_322_cov_3.605381	73	116	12	5	43	0.1162791
NODE_140701_length_322_cov_3.605381	73	116	14	24	43	0.5581396
NODE_140702_length_322_cov_3.600897	75	145	0	20	70	0.2857143
NODE_140702_length_322_cov_3.600897	75	145	4	17	70	0.2428571
NODE_140702_length_322_cov_3.600897	75	145	6	33	70	0.4714286
NODE_140820_length_322_cov_2.304933	182	213	2	31	31	1.0000000
NODE_141738_length_321_cov_8.527027	176	240	0	13	64	0.2031250
NODE_141738_length_321_cov_8.527027	176	240	2	15	64	0.2343750
NODE_141738_length_321_cov_8.527027	176	240	6	36	64	0.5625000
NODE_141786_length_321_cov_4.094595	196	266	0	70	70	1.0000000
NODE_141811_length_321_cov_3.563063	59	131	6	9	72	0.1250000
NODE_141811_length_321_cov_3.563063	59	131	8	3	72	0.0416667
NODE_141811_length_321_cov_3.563063	59	131	11	6	72	0.0833333
NODE_141811_length_321_cov_3.563063	59	131	12	12	72	0.1666667
NODE_141811_length_321_cov_3.563063	59	131	14	42	72	0.5833333
NODE_141811_length_321_cov_3.563063	112	183	2	22	71	0.3098592
NODE_141811_length_321_cov_3.563063	112	183	4	30	71	0.4225352
NODE_141811_length_321_cov_3.563063	112	183	6	9	71	0.1267606
NODE_141811_length_321_cov_3.563063	112	183	8	3	71	0.0422535
NODE_141811_length_321_cov_3.563063	112	183	12	7	71	0.0985916
NODE_141813_length_321_cov_3.540541	112	141	4	29	29	1.0000000
NODE_141833_length_321_cov_3.049550	65	115	38	15	50	0.3000000
NODE_141833_length_321_cov_3.049550	65	115	40	3	50	0.0600000
NODE_141833_length_321_cov_3.049550	65	115	42	9	50	0.1800000
NODE_141833_length_321_cov_3.049550	65	115	44	3	50	0.0600000
NODE_141833_length_321_cov_3.049550	65	115	46	4	50	0.0800000
NODE_141833_length_321_cov_3.049550	65	115	50	9	50	0.1800000
NODE_141833_length_321_cov_3.049550	65	115	52	7	50	0.1400000
NODE_141833_length_321_cov_3.049550	95	138	42	3	43	0.0697674
NODE_141833_length_321_cov_3.049550	95	138	46	7	43	0.1627907
NODE_141833_length_321_cov_3.049550	95	138	48	6	43	0.1395349
NODE_141833_length_321_cov_3.049550	95	138	50	20	43	0.4651163
NODE_141833_length_321_cov_3.049550	95	138	52	7	43	0.1627907
NODE_141833_length_321_cov_3.049550	118	168	8	1	50	0.0200000
NODE_141833_length_321_cov_3.049550	118	168	14	2	50	0.0400000
NODE_141833_length_321_cov_3.049550	118	168	18	2	50	0.0400000
NODE_141833_length_321_cov_3.049550	118	168	22	1	50	0.0200000
NODE_141833_length_321_cov_3.049550	118	168	23	2	50	0.0400000
NODE_141833_length_321_cov_3.049550	118	168	26	3	50	0.0600000
NODE_141833_length_321_cov_3.049550	118	168	28	1	50	0.0200000
NODE_141833_length_321_cov_3.049550	118	168	32	1	50	0.0200000
NODE_141833_length_321_cov_3.049550	118	168	36	3	50	0.0600000
NODE_141833_length_321_cov_3.049550	118	168	38	10	50	0.2000000
NODE_141833_length_321_cov_3.049550	118	168	41	3	50	0.0600000
NODE_141833_length_321_cov_3.049550	118	168	42	4	50	0.0800000
NODE_141833_length_321_cov_3.049550	118	168	46	3	50	0.0600000
NODE_141833_length_321_cov_3.049550	118	168	48	6	50	0.1200000
NODE_141833_length_321_cov_3.049550	118	168	50	8	50	0.1600000
NODE_141837_length_321_cov_2.995495	146	220	0	74	74	1.0000000
NODE_141842_length_321_cov_2.981982	251	304	0	53	53	1.0000000
NODE_141876_length_321_cov_2.734234	239	306	2	67	67	1.0000000
NODE_141910_length_321_cov_2.427928	221	265	0	44	44	1.0000000
NODE_141922_length_321_cov_2.315315	22	65	0	43	43	1.0000000
NODE_141951_length_321_cov_2.270270	43	105	0	3	62	0.0483871
NODE_141951_length_321_cov_2.270270	43	105	2	59	62	0.9516129
NODE_141951_length_321_cov_2.270270	120	203	0	7	83	0.0843373
NODE_141951_length_321_cov_2.270270	120	203	2	76	83	0.9156626
NODE_141951_length_321_cov_2.270270	127	208	0	12	81	0.1481481
NODE_141951_length_321_cov_2.270270	127	208	2	69	81	0.8518519
NODE_142200_length_321_cov_1.576577	241	321	0	80	80	1.0000000
NODE_142363_length_321_cov_1.319820	253	304	2	51	51	1.0000000
NODE_142484_length_321_cov_1.130631	0	43	0	43	43	1.0000000
NODE_142700_length_321_cov_0.869369	248	294	0	46	46	1.0000000
NODE_142885_length_320_cov_200.484163	264	320	7	5	56	0.0892857
NODE_142885_length_320_cov_200.484163	264	320	9	1	56	0.0178571
NODE_142885_length_320_cov_200.484163	264	320	11	2	56	0.0357143
NODE_142885_length_320_cov_200.484163	264	320	16	1	56	0.0178571
NODE_142885_length_320_cov_200.484163	264	320	18	1	56	0.0178571
NODE_142885_length_320_cov_200.484163	264	320	20	2	56	0.0357143
NODE_142885_length_320_cov_200.484163	264	320	28	2	56	0.0357143
NODE_142885_length_320_cov_200.484163	264	320	33	1	56	0.0178571
NODE_142885_length_320_cov_200.484163	264	320	35	9	56	0.1607143
NODE_142885_length_320_cov_200.484163	264	320	37	8	56	0.1428571
NODE_142885_length_320_cov_200.484163	264	320	39	4	56	0.0714286
NODE_142885_length_320_cov_200.484163	264	320	42	10	56	0.1785714
NODE_142885_length_320_cov_200.484163	264	320	43	1	56	0.0178571
NODE_142885_length_320_cov_200.484163	264	320	44	5	56	0.0892857
NODE_142885_length_320_cov_200.484163	264	320	46	4	56	0.0714286
NODE_142886_length_320_cov_73.357466	51	97	0	46	46	1.0000000
NODE_142886_length_320_cov_73.357466	108	154	0	46	46	1.0000000
NODE_142886_length_320_cov_73.357466	165	245	0	80	80	1.0000000
NODE_142886_length_320_cov_73.357466	218	296	0	78	78	1.0000000
NODE_142887_length_320_cov_35.787330	212	292	8	3	80	0.0375000
NODE_142887_length_320_cov_35.787330	212	292	14	12	80	0.1500000
NODE_142887_length_320_cov_35.787330	212	292	16	10	80	0.1250000
NODE_142887_length_320_cov_35.787330	212	292	20	55	80	0.6875000
NODE_142887_length_320_cov_35.787330	212	292	8	3	80	0.0375000
NODE_142887_length_320_cov_35.787330	212	292	14	12	80	0.1500000
NODE_142887_length_320_cov_35.787330	212	292	16	10	80	0.1250000
NODE_142887_length_320_cov_35.787330	212	292	20	55	80	0.6875000
NODE_142887_length_320_cov_35.787330	212	292	8	3	80	0.0375000
NODE_142887_length_320_cov_35.787330	212	292	14	12	80	0.1500000
NODE_142887_length_320_cov_35.787330	212	292	16	10	80	0.1250000
NODE_142887_length_320_cov_35.787330	212	292	20	55	80	0.6875000
NODE_142887_length_320_cov_35.787330	212	292	8	3	80	0.0375000
NODE_142887_length_320_cov_35.787330	212	292	14	12	80	0.1500000
NODE_142887_length_320_cov_35.787330	212	292	16	10	80	0.1250000
NODE_142887_length_320_cov_35.787330	212	292	20	55	80	0.6875000
NODE_142887_length_320_cov_35.787330	212	292	8	3	80	0.0375000
NODE_142887_length_320_cov_35.787330	212	292	14	12	80	0.1500000
NODE_142887_length_320_cov_35.787330	212	292	16	10	80	0.1250000
NODE_142887_length_320_cov_35.787330	212	292	20	55	80	0.6875000
NODE_142887_length_320_cov_35.787330	265	314	1	16	49	0.3265306
NODE_142887_length_320_cov_35.787330	265	314	7	2	49	0.0408163
NODE_142887_length_320_cov_35.787330	265	314	8	3	49	0.0612245
NODE_142887_length_320_cov_35.787330	265	314	14	13	49	0.2653061
NODE_142887_length_320_cov_35.787330	265	314	16	10	49	0.2040816
NODE_142887_length_320_cov_35.787330	265	314	20	5	49	0.1020408
NODE_142887_length_320_cov_35.787330	265	320	1	22	55	0.4000000
NODE_142887_length_320_cov_35.787330	265	320	7	2	55	0.0363636
NODE_142887_length_320_cov_35.787330	265	320	8	3	55	0.0545455
NODE_142887_length_320_cov_35.787330	265	320	14	13	55	0.2363636
NODE_142887_length_320_cov_35.787330	265	320	16	10	55	0.1818182
NODE_142887_length_320_cov_35.787330	265	320	20	5	55	0.0909091
NODE_142887_length_320_cov_35.787330	265	320	1	22	55	0.4000000
NODE_142887_length_320_cov_35.787330	265	320	7	2	55	0.0363636
NODE_142887_length_320_cov_35.787330	265	320	8	3	55	0.0545455
NODE_142887_length_320_cov_35.787330	265	320	14	13	55	0.2363636
NODE_142887_length_320_cov_35.787330	265	320	16	10	55	0.1818182
NODE_142887_length_320_cov_35.787330	265	320	20	5	55	0.0909091
NODE_142887_length_320_cov_35.787330	268	320	1	22	52	0.4230769
NODE_142887_length_320_cov_35.787330	268	320	7	2	52	0.0384615
NODE_142887_length_320_cov_35.787330	268	320	8	3	52	0.0576923
NODE_142887_length_320_cov_35.787330	268	320	14	13	52	0.2500000
NODE_142887_length_320_cov_35.787330	268	320	16	10	52	0.1923077
NODE_142887_length_320_cov_35.787330	268	320	20	2	52	0.0384615
NODE_142887_length_320_cov_35.787330	270	320	1	22	50	0.4400000
NODE_142887_length_320_cov_35.787330	270	320	7	2	50	0.0400000
NODE_142887_length_320_cov_35.787330	270	320	8	3	50	0.0600000
NODE_142887_length_320_cov_35.787330	270	320	14	13	50	0.2600000
NODE_142887_length_320_cov_35.787330	270	320	16	10	50	0.2000000
NODE_142900_length_320_cov_5.841629	115	172	6	11	57	0.1929825
NODE_142900_length_320_cov_5.841629	115	172	8	16	57	0.2807018
NODE_142900_length_320_cov_5.841629	115	172	10	11	57	0.1929825
NODE_142900_length_320_cov_5.841629	115	172	14	19	57	0.3333333
NODE_142900_length_320_cov_5.841629	168	225	0	24	57	0.4210526
NODE_142900_length_320_cov_5.841629	168	225	4	13	57	0.2280702
NODE_142900_length_320_cov_5.841629	168	225	6	20	57	0.3508772
NODE_142934_length_320_cov_4.153846	134	200	0	20	66	0.3030303
NODE_142934_length_320_cov_4.153846	134	200	3	31	66	0.4696970
NODE_142934_length_320_cov_4.153846	134	200	4	15	66	0.2272727
NODE_142958_length_320_cov_3.733032	5	40	0	35	35	1.0000000
NODE_142985_length_320_cov_3.402715	142	222	4	14	80	0.1750000
NODE_142985_length_320_cov_3.402715	142	222	6	25	80	0.3125000
NODE_142985_length_320_cov_3.402715	142	222	8	34	80	0.4250000
NODE_142985_length_320_cov_3.402715	142	222	10	7	80	0.0875000
NODE_143076_length_320_cov_2.475113	120	187	4	16	67	0.2388060
NODE_143076_length_320_cov_2.475113	120	187	6	15	67	0.2238806
NODE_143076_length_320_cov_2.475113	120	187	11	1	67	0.0149254
NODE_143076_length_320_cov_2.475113	120	187	12	9	67	0.1343284
NODE_143076_length_320_cov_2.475113	120	187	14	1	67	0.0149254
NODE_143076_length_320_cov_2.475113	120	187	16	10	67	0.1492537
NODE_143076_length_320_cov_2.475113	120	187	18	1	67	0.0149254
NODE_143076_length_320_cov_2.475113	120	187	20	5	67	0.0746269
NODE_143076_length_320_cov_2.475113	120	187	24	1	67	0.0149254
NODE_143076_length_320_cov_2.475113	120	187	26	1	67	0.0149254
NODE_143076_length_320_cov_2.475113	120	187	30	2	67	0.0298507
NODE_143076_length_320_cov_2.475113	120	187	38	1	67	0.0149254
NODE_143076_length_320_cov_2.475113	120	187	40	4	67	0.0597015
NODE_143142_length_320_cov_2.171946	16	96	0	2	80	0.0250000
NODE_143142_length_320_cov_2.171946	16	96	1	4	80	0.0500000
NODE_143142_length_320_cov_2.171946	16	96	2	1	80	0.0125000
NODE_143142_length_320_cov_2.171946	16	96	6	3	80	0.0375000
NODE_143142_length_320_cov_2.171946	16	96	12	8	80	0.1000000
NODE_143142_length_320_cov_2.171946	16	96	22	29	80	0.3625000
NODE_143142_length_320_cov_2.171946	16	96	24	31	80	0.3875000
NODE_143142_length_320_cov_2.171946	16	96	28	2	80	0.0250000
NODE_143142_length_320_cov_2.171946	69	149	22	2	80	0.0250000
NODE_143142_length_320_cov_2.171946	69	149	24	30	80	0.3750000
NODE_143142_length_320_cov_2.171946	69	149	26	2	80	0.0250000
NODE_143142_length_320_cov_2.171946	69	149	28	8	80	0.1000000
NODE_143142_length_320_cov_2.171946	69	149	30	38	80	0.4750000
NODE_143207_length_320_cov_1.900452	37	117	4	4	80	0.0500000
NODE_143207_length_320_cov_1.900452	37	117	5	9	80	0.1125000
NODE_143207_length_320_cov_1.900452	37	117	6	67	80	0.8375000
NODE_143207_length_320_cov_1.900452	90	164	0	32	74	0.4324324
NODE_143207_length_320_cov_1.900452	90	164	2	4	74	0.0540541
NODE_143207_length_320_cov_1.900452	90	164	4	15	74	0.2027027
NODE_143207_length_320_cov_1.900452	90	164	6	23	74	0.3108108
NODE_143230_length_320_cov_1.846154	188	220	0	32	32	1.0000000
NODE_143309_length_320_cov_1.665158	144	198	6	26	54	0.4814815
NODE_143309_length_320_cov_1.665158	144	198	8	28	54	0.5185185
NODE_143309_length_320_cov_1.665158	198	251	4	10	53	0.1886792
NODE_143309_length_320_cov_1.665158	198	251	6	36	53	0.6792453
NODE_143309_length_320_cov_1.665158	198	251	8	7	53	0.1320755
NODE_143351_length_320_cov_1.601810	157	181	0	24	24	1.0000000
NODE_143351_length_320_cov_1.601810	231	290	0	59	59	1.0000000
NODE_143366_length_320_cov_1.556561	0	39	0	7	39	0.1794872
NODE_143366_length_320_cov_1.556561	0	39	2	14	39	0.3589744
NODE_143366_length_320_cov_1.556561	0	39	4	15	39	0.3846154
NODE_143366_length_320_cov_1.556561	0	39	8	3	39	0.0769231
NODE_143442_length_320_cov_1.384615	18	98	0	80	80	1.0000000
NODE_143442_length_320_cov_1.384615	71	145	0	73	74	0.9864865
NODE_143442_length_320_cov_1.384615	71	145	2	1	74	0.0135135
NODE_143521_length_320_cov_1.312217	117	170	0	42	53	0.7924528
NODE_143521_length_320_cov_1.312217	117	170	2	11	53	0.2075472
NODE_143670_length_320_cov_1.117647	58	109	0	23	51	0.4509804
NODE_143670_length_320_cov_1.117647	58	109	2	1	51	0.0196078
NODE_143670_length_320_cov_1.117647	58	109	4	27	51	0.5294118
NODE_144091_length_319_cov_5.940909	122	202	0	24	80	0.3000000
NODE_144091_length_319_cov_5.940909	122	202	4	56	80	0.7000000
NODE_144107_length_319_cov_4.700000	16	47	0	31	31	1.0000000
NODE_144137_length_319_cov_4.068182	5	36	0	31	31	1.0000000
NODE_144162_length_319_cov_3.568182	149	229	0	80	80	1.0000000
NODE_144206_length_319_cov_3.036364	112	174	0	62	62	1.0000000
NODE_144226_length_319_cov_2.800000	25	106	4	4	81	0.0493827
NODE_144226_length_319_cov_2.800000	25	106	5	1	81	0.0123457
NODE_144226_length_319_cov_2.800000	25	106	7	1	81	0.0123457
NODE_144226_length_319_cov_2.800000	25	106	14	1	81	0.0123457
NODE_144226_length_319_cov_2.800000	25	106	39	1	81	0.0123457
NODE_144226_length_319_cov_2.800000	25	106	41	2	81	0.0246914
NODE_144226_length_319_cov_2.800000	25	106	45	1	81	0.0123457
NODE_144226_length_319_cov_2.800000	25	106	50	2	81	0.0246914
NODE_144226_length_319_cov_2.800000	25	106	55	2	81	0.0246914
NODE_144226_length_319_cov_2.800000	25	106	57	1	81	0.0123457
NODE_144226_length_319_cov_2.800000	25	106	58	2	81	0.0246914
NODE_144226_length_319_cov_2.800000	25	106	60	1	81	0.0123457
NODE_144226_length_319_cov_2.800000	25	106	71	1	81	0.0123457
NODE_144226_length_319_cov_2.800000	25	106	73	8	81	0.0987654
NODE_144226_length_319_cov_2.800000	25	106	80	1	81	0.0123457
NODE_144226_length_319_cov_2.800000	25	106	88	1	81	0.0123457
NODE_144226_length_319_cov_2.800000	25	106	89	5	81	0.0617284
NODE_144226_length_319_cov_2.800000	25	106	95	2	81	0.0246914
NODE_144226_length_319_cov_2.800000	25	106	97	3	81	0.0370370
NODE_144226_length_319_cov_2.800000	25	106	99	2	81	0.0246914
NODE_144226_length_319_cov_2.800000	25	106	102	2	81	0.0246914
NODE_144226_length_319_cov_2.800000	25	106	104	4	81	0.0493827
NODE_144226_length_319_cov_2.800000	25	106	106	2	81	0.0246914
NODE_144226_length_319_cov_2.800000	25	106	112	1	81	0.0123457
NODE_144226_length_319_cov_2.800000	25	106	115	1	81	0.0123457
NODE_144226_length_319_cov_2.800000	25	106	117	2	81	0.0246914
NODE_144226_length_319_cov_2.800000	25	106	118	3	81	0.0370370
NODE_144226_length_319_cov_2.800000	25	106	120	1	81	0.0123457
NODE_144226_length_319_cov_2.800000	25	106	124	1	81	0.0123457
NODE_144226_length_319_cov_2.800000	25	106	126	1	81	0.0123457
NODE_144226_length_319_cov_2.800000	25	106	127	2	81	0.0246914
NODE_144226_length_319_cov_2.800000	25	106	136	1	81	0.0123457
NODE_144226_length_319_cov_2.800000	25	106	140	1	81	0.0123457
NODE_144226_length_319_cov_2.800000	25	106	149	2	81	0.0246914
NODE_144226_length_319_cov_2.800000	25	106	157	1	81	0.0123457
NODE_144226_length_319_cov_2.800000	25	106	159	1	81	0.0123457
NODE_144226_length_319_cov_2.800000	25	106	163	1	81	0.0123457
NODE_144226_length_319_cov_2.800000	25	106	169	3	81	0.0370370
NODE_144226_length_319_cov_2.800000	25	106	175	1	81	0.0123457
NODE_144226_length_319_cov_2.800000	25	106	182	1	81	0.0123457
NODE_144226_length_319_cov_2.800000	25	106	183	7	81	0.0864198
NODE_144226_length_319_cov_2.800000	79	158	117	2	79	0.0253165
NODE_144226_length_319_cov_2.800000	79	158	118	1	79	0.0126582
NODE_144226_length_319_cov_2.800000	79	158	120	1	79	0.0126582
NODE_144226_length_319_cov_2.800000	79	158	124	1	79	0.0126582
NODE_144226_length_319_cov_2.800000	79	158	126	1	79	0.0126582
NODE_144226_length_319_cov_2.800000	79	158	127	2	79	0.0253165
NODE_144226_length_319_cov_2.800000	79	158	136	1	79	0.0126582
NODE_144226_length_319_cov_2.800000	79	158	140	1	79	0.0126582
NODE_144226_length_319_cov_2.800000	79	158	149	2	79	0.0253165
NODE_144226_length_319_cov_2.800000	79	158	157	1	79	0.0126582
NODE_144226_length_319_cov_2.800000	79	158	159	1	79	0.0126582
NODE_144226_length_319_cov_2.800000	79	158	163	1	79	0.0126582
NODE_144226_length_319_cov_2.800000	79	158	167	1	79	0.0126582
NODE_144226_length_319_cov_2.800000	79	158	169	7	79	0.0886076
NODE_144226_length_319_cov_2.800000	79	158	173	1	79	0.0126582
NODE_144226_length_319_cov_2.800000	79	158	175	2	79	0.0253165
NODE_144226_length_319_cov_2.800000	79	158	176	6	79	0.0759494
NODE_144226_length_319_cov_2.800000	79	158	177	2	79	0.0253165
NODE_144226_length_319_cov_2.800000	79	158	178	6	79	0.0759494
NODE_144226_length_319_cov_2.800000	79	158	179	3	79	0.0379747
NODE_144226_length_319_cov_2.800000	79	158	180	6	79	0.0759494
NODE_144226_length_319_cov_2.800000	79	158	181	9	79	0.1139240
NODE_144226_length_319_cov_2.800000	79	158	182	1	79	0.0126582
NODE_144226_length_319_cov_2.800000	79	158	183	20	79	0.2531646
NODE_144237_length_319_cov_2.740909	67	147	0	6	80	0.0750000
NODE_144237_length_319_cov_2.740909	67	147	2	4	80	0.0500000
NODE_144237_length_319_cov_2.740909	67	147	6	9	80	0.1125000
NODE_144237_length_319_cov_2.740909	67	147	13	3	80	0.0375000
NODE_144237_length_319_cov_2.740909	67	147	15	3	80	0.0375000
NODE_144237_length_319_cov_2.740909	67	147	16	2	80	0.0250000
NODE_144237_length_319_cov_2.740909	67	147	17	13	80	0.1625000
NODE_144237_length_319_cov_2.740909	67	147	18	40	80	0.5000000
NODE_144252_length_319_cov_2.586364	247	319	0	38	72	0.5277778
NODE_144252_length_319_cov_2.586364	247	319	2	34	72	0.4722222
NODE_144272_length_319_cov_2.463636	90	153	0	63	63	1.0000000
NODE_144272_length_319_cov_2.463636	163	216	0	6	53	0.1132075
NODE_144272_length_319_cov_2.463636	163	216	6	47	53	0.8867925
NODE_144316_length_319_cov_2.259091	146	212	0	66	66	1.0000000
NODE_144340_length_319_cov_2.163636	213	275	0	62	62	1.0000000
NODE_144390_length_319_cov_1.968182	120	200	0	80	80	1.0000000
NODE_144616_length_319_cov_1.431818	111	157	0	46	46	1.0000000
NODE_144629_length_319_cov_1.395455	129	179	0	50	50	1.0000000
NODE_144788_length_319_cov_1.190909	119	182	0	36	63	0.5714286
NODE_144788_length_319_cov_1.190909	119	182	2	27	63	0.4285714
NODE_144788_length_319_cov_1.190909	197	232	2	31	35	0.8857143
NODE_144788_length_319_cov_1.190909	197	232	4	4	35	0.1142857
NODE_145289_length_318_cov_232.639269	169	198	592	1	29	0.0344828
NODE_145289_length_318_cov_232.639269	169	198	597	1	29	0.0344828
NODE_145289_length_318_cov_232.639269	169	198	601	1	29	0.0344828
NODE_145289_length_318_cov_232.639269	169	198	603	1	29	0.0344828
NODE_145289_length_318_cov_232.639269	169	198	611	1	29	0.0344828
NODE_145289_length_318_cov_232.639269	169	198	622	1	29	0.0344828
NODE_145289_length_318_cov_232.639269	169	198	623	1	29	0.0344828
NODE_145289_length_318_cov_232.639269	169	198	629	1	29	0.0344828
NODE_145289_length_318_cov_232.639269	169	198	635	1	29	0.0344828
NODE_145289_length_318_cov_232.639269	169	198	640	2	29	0.0689655
NODE_145289_length_318_cov_232.639269	169	198	642	1	29	0.0344828
NODE_145289_length_318_cov_232.639269	169	198	643	2	29	0.0689655
NODE_145289_length_318_cov_232.639269	169	198	651	2	29	0.0689655
NODE_145289_length_318_cov_232.639269	169	198	653	1	29	0.0344828
NODE_145289_length_318_cov_232.639269	169	198	667	1	29	0.0344828
NODE_145289_length_318_cov_232.639269	169	198	670	1	29	0.0344828
NODE_145289_length_318_cov_232.639269	169	198	677	2	29	0.0689655
NODE_145289_length_318_cov_232.639269	169	198	696	2	29	0.0689655
NODE_145289_length_318_cov_232.639269	169	198	701	2	29	0.0689655
NODE_145289_length_318_cov_232.639269	169	198	702	1	29	0.0344828
NODE_145289_length_318_cov_232.639269	169	198	705	1	29	0.0344828
NODE_145289_length_318_cov_232.639269	169	198	708	2	29	0.0689655
NODE_145289_length_318_cov_232.639269	171	246	560	1	75	0.0133333
NODE_145289_length_318_cov_232.639269	171	246	564	1	75	0.0133333
NODE_145289_length_318_cov_232.639269	171	246	565	1	75	0.0133333
NODE_145289_length_318_cov_232.639269	171	246	578	1	75	0.0133333
NODE_145289_length_318_cov_232.639269	171	246	581	1	75	0.0133333
NODE_145289_length_318_cov_232.639269	171	246	588	1	75	0.0133333
NODE_145289_length_318_cov_232.639269	171	246	590	1	75	0.0133333
NODE_145289_length_318_cov_232.639269	171	246	600	2	75	0.0266667
NODE_145289_length_318_cov_232.639269	171	246	601	1	75	0.0133333
NODE_145289_length_318_cov_232.639269	171	246	603	1	75	0.0133333
NODE_145289_length_318_cov_232.639269	171	246	607	1	75	0.0133333
NODE_145289_length_318_cov_232.639269	171	246	611	1	75	0.0133333
NODE_145289_length_318_cov_232.639269	171	246	619	1	75	0.0133333
NODE_145289_length_318_cov_232.639269	171	246	621	1	75	0.0133333
NODE_145289_length_318_cov_232.639269	171	246	622	1	75	0.0133333
NODE_145289_length_318_cov_232.639269	171	246	623	1	75	0.0133333
NODE_145289_length_318_cov_232.639269	171	246	624	1	75	0.0133333
NODE_145289_length_318_cov_232.639269	171	246	629	1	75	0.0133333
NODE_145289_length_318_cov_232.639269	171	246	632	1	75	0.0133333
NODE_145289_length_318_cov_232.639269	171	246	635	1	75	0.0133333
NODE_145289_length_318_cov_232.639269	171	246	636	1	75	0.0133333
NODE_145289_length_318_cov_232.639269	171	246	638	1	75	0.0133333
NODE_145289_length_318_cov_232.639269	171	246	640	2	75	0.0266667
NODE_145289_length_318_cov_232.639269	171	246	642	1	75	0.0133333
NODE_145289_length_318_cov_232.639269	171	246	643	2	75	0.0266667
NODE_145289_length_318_cov_232.639269	171	246	649	1	75	0.0133333
NODE_145289_length_318_cov_232.639269	171	246	651	2	75	0.0266667
NODE_145289_length_318_cov_232.639269	171	246	653	1	75	0.0133333
NODE_145289_length_318_cov_232.639269	171	246	661	1	75	0.0133333
NODE_145289_length_318_cov_232.639269	171	246	665	1	75	0.0133333
NODE_145289_length_318_cov_232.639269	171	246	667	1	75	0.0133333
NODE_145289_length_318_cov_232.639269	171	246	668	1	75	0.0133333
NODE_145289_length_318_cov_232.639269	171	246	670	1	75	0.0133333
NODE_145289_length_318_cov_232.639269	171	246	677	2	75	0.0266667
NODE_145289_length_318_cov_232.639269	171	246	682	1	75	0.0133333
NODE_145289_length_318_cov_232.639269	171	246	684	1	75	0.0133333
NODE_145289_length_318_cov_232.639269	171	246	690	1	75	0.0133333
NODE_145289_length_318_cov_232.639269	171	246	695	1	75	0.0133333
NODE_145289_length_318_cov_232.639269	171	246	696	2	75	0.0266667
NODE_145289_length_318_cov_232.639269	171	246	697	1	75	0.0133333
NODE_145289_length_318_cov_232.639269	171	246	698	1	75	0.0133333
NODE_145289_length_318_cov_232.639269	171	246	701	4	75	0.0533333
NODE_145289_length_318_cov_232.639269	171	246	702	1	75	0.0133333
NODE_145289_length_318_cov_232.639269	171	246	705	2	75	0.0266667
NODE_145289_length_318_cov_232.639269	171	246	706	1	75	0.0133333
NODE_145289_length_318_cov_232.639269	171	246	708	2	75	0.0266667
NODE_145289_length_318_cov_232.639269	171	246	709	1	75	0.0133333
NODE_145289_length_318_cov_232.639269	171	246	710	3	75	0.0400000
NODE_145289_length_318_cov_232.639269	171	246	711	3	75	0.0400000
NODE_145289_length_318_cov_232.639269	171	246	713	1	75	0.0133333
NODE_145289_length_318_cov_232.639269	171	246	715	3	75	0.0400000
NODE_145289_length_318_cov_232.639269	171	246	716	1	75	0.0133333
NODE_145289_length_318_cov_232.639269	171	246	717	2	75	0.0266667
NODE_145289_length_318_cov_232.639269	171	246	718	1	75	0.0133333
NODE_145289_length_318_cov_232.639269	171	246	719	2	75	0.0266667
NODE_145289_length_318_cov_232.639269	171	246	721	1	75	0.0133333
NODE_145333_length_318_cov_4.237443	222	294	2	8	72	0.1111111
NODE_145333_length_318_cov_4.237443	222	294	4	5	72	0.0694444
NODE_145333_length_318_cov_4.237443	222	294	6	11	72	0.1527778
NODE_145333_length_318_cov_4.237443	222	294	8	48	72	0.6666667
NODE_145348_length_318_cov_3.721461	98	148	0	50	50	1.0000000
NODE_145362_length_318_cov_3.515982	60	129	0	47	69	0.6811594
NODE_145362_length_318_cov_3.515982	60	129	2	3	69	0.0434783
NODE_145362_length_318_cov_3.515982	60	129	4	19	69	0.2753623
NODE_145362_length_318_cov_3.515982	60	140	0	47	80	0.5875000
NODE_145362_length_318_cov_3.515982	60	140	2	3	80	0.0375000
NODE_145362_length_318_cov_3.515982	60	140	4	30	80	0.3750000
NODE_145362_length_318_cov_3.515982	60	140	0	47	80	0.5875000
NODE_145362_length_318_cov_3.515982	60	140	2	3	80	0.0375000
NODE_145362_length_318_cov_3.515982	60	140	4	30	80	0.3750000
NODE_145362_length_318_cov_3.515982	113	153	4	40	40	1.0000000
NODE_145362_length_318_cov_3.515982	122	153	4	31	31	1.0000000
NODE_145465_length_318_cov_2.557078	205	247	0	17	42	0.4047619
NODE_145465_length_318_cov_2.557078	205	247	2	25	42	0.5952381
NODE_145551_length_318_cov_2.109589	70	150	1	3	80	0.0375000
NODE_145551_length_318_cov_2.109589	70	150	2	45	80	0.5625000
NODE_145551_length_318_cov_2.109589	70	150	3	4	80	0.0500000
NODE_145551_length_318_cov_2.109589	70	150	4	28	80	0.3500000
NODE_145619_length_318_cov_1.945205	229	286	6	57	57	1.0000000
NODE_145709_length_318_cov_1.739726	242	308	0	41	66	0.6212121
NODE_145709_length_318_cov_1.739726	242	308	2	25	66	0.3787879
NODE_145725_length_318_cov_1.684932	49	80	0	31	31	1.0000000
NODE_145787_length_318_cov_1.561644	99	158	4	59	59	1.0000000
NODE_145807_length_318_cov_1.493151	151	195	0	44	44	1.0000000
NODE_145807_length_318_cov_1.493151	199	258	0	59	59	1.0000000
NODE_145968_length_318_cov_1.301370	91	141	2	50	50	1.0000000
NODE_146017_length_318_cov_1.173516	83	150	2	13	67	0.1940299
NODE_146017_length_318_cov_1.173516	83	150	6	54	67	0.8059701
NODE_146065_length_318_cov_1.127854	24	51	0	27	27	1.0000000
NODE_146065_length_318_cov_1.127854	24	60	0	36	36	1.0000000
NODE_146467_length_317_cov_55.467890	172	243	25	1	71	0.0140845
NODE_146467_length_317_cov_55.467890	172	243	27	2	71	0.0281690
NODE_146467_length_317_cov_55.467890	172	243	29	3	71	0.0422535
NODE_146467_length_317_cov_55.467890	172	243	31	11	71	0.1549296
NODE_146467_length_317_cov_55.467890	172	243	35	1	71	0.0140845
NODE_146467_length_317_cov_55.467890	172	243	36	3	71	0.0422535
NODE_146467_length_317_cov_55.467890	172	243	37	9	71	0.1267606
NODE_146467_length_317_cov_55.467890	172	243	38	1	71	0.0140845
NODE_146467_length_317_cov_55.467890	172	243	42	1	71	0.0140845
NODE_146467_length_317_cov_55.467890	172	243	43	6	71	0.0845070
NODE_146467_length_317_cov_55.467890	172	243	44	2	71	0.0281690
NODE_146467_length_317_cov_55.467890	172	243	45	5	71	0.0704225
NODE_146467_length_317_cov_55.467890	172	243	46	12	71	0.1690141
NODE_146467_length_317_cov_55.467890	172	243	48	4	71	0.0563380
NODE_146467_length_317_cov_55.467890	172	243	50	10	71	0.1408451
NODE_146487_length_317_cov_5.252294	247	307	6	60	60	1.0000000
NODE_146503_length_317_cov_4.467890	105	185	0	80	80	1.0000000
NODE_146503_length_317_cov_4.467890	113	193	0	72	80	0.9000000
NODE_146503_length_317_cov_4.467890	113	193	4	8	80	0.1000000
NODE_146554_length_317_cov_3.298165	146	206	0	60	60	1.0000000
NODE_146562_length_317_cov_3.266055	111	191	6	24	80	0.3000000
NODE_146562_length_317_cov_3.266055	111	191	7	16	80	0.2000000
NODE_146562_length_317_cov_3.266055	111	191	8	8	80	0.1000000
NODE_146562_length_317_cov_3.266055	111	191	10	32	80	0.4000000
NODE_146562_length_317_cov_3.266055	164	244	2	31	80	0.3875000
NODE_146562_length_317_cov_3.266055	164	244	4	20	80	0.2500000
NODE_146562_length_317_cov_3.266055	164	244	6	26	80	0.3250000
NODE_146562_length_317_cov_3.266055	164	244	7	3	80	0.0375000
NODE_146585_length_317_cov_3.036697	3	79	4	76	76	1.0000000
NODE_146601_length_317_cov_2.825688	14	94	0	80	80	1.0000000
NODE_146601_length_317_cov_2.825688	67	147	0	75	80	0.9375000
NODE_146601_length_317_cov_2.825688	67	147	2	5	80	0.0625000
NODE_146602_length_317_cov_2.821101	142	208	0	17	66	0.2575758
NODE_146602_length_317_cov_2.821101	142	208	2	13	66	0.1969697
NODE_146602_length_317_cov_2.821101	142	208	4	36	66	0.5454546
NODE_146604_length_317_cov_2.816514	121	201	0	80	80	1.0000000
NODE_146612_length_317_cov_2.779817	67	138	0	27	71	0.3802817
NODE_146612_length_317_cov_2.779817	67	138	2	44	71	0.6197183
NODE_147046_length_317_cov_1.353211	166	239	0	25	73	0.3424658
NODE_147046_length_317_cov_1.353211	166	239	2	8	73	0.1095890
NODE_147046_length_317_cov_1.353211	166	239	4	40	73	0.5479452
NODE_147046_length_317_cov_1.353211	212	292	2	20	80	0.2500000
NODE_147046_length_317_cov_1.353211	212	292	4	60	80	0.7500000
NODE_147172_length_317_cov_1.160550	58	117	0	25	59	0.4237288
NODE_147172_length_317_cov_1.160550	58	117	4	34	59	0.5762712
NODE_147172_length_317_cov_1.160550	90	170	4	32	80	0.4000000
NODE_147172_length_317_cov_1.160550	90	170	6	14	80	0.1750000
NODE_147172_length_317_cov_1.160550	90	170	10	9	80	0.1125000
NODE_147172_length_317_cov_1.160550	90	170	12	25	80	0.3125000
NODE_147187_length_317_cov_1.137615	245	313	0	68	68	1.0000000
NODE_147259_length_317_cov_0.967890	170	211	0	41	41	1.0000000
NODE_147373_length_317_cov_0.926606	194	232	0	6	38	0.1578947
NODE_147373_length_317_cov_0.926606	194	232	2	32	38	0.8421053
NODE_147383_length_317_cov_0.912844	186	244	0	58	58	1.0000000
NODE_147595_length_316_cov_31.502304	96	174	0	9	78	0.1153846
NODE_147595_length_316_cov_31.502304	96	174	2	6	78	0.0769231
NODE_147595_length_316_cov_31.502304	96	174	4	6	78	0.0769231
NODE_147595_length_316_cov_31.502304	96	174	5	1	78	0.0128205
NODE_147595_length_316_cov_31.502304	96	174	7	7	78	0.0897436
NODE_147595_length_316_cov_31.502304	96	174	8	10	78	0.1282051
NODE_147595_length_316_cov_31.502304	96	174	10	1	78	0.0128205
NODE_147595_length_316_cov_31.502304	96	174	12	1	78	0.0128205
NODE_147595_length_316_cov_31.502304	96	174	15	1	78	0.0128205
NODE_147595_length_316_cov_31.502304	96	174	17	2	78	0.0256410
NODE_147595_length_316_cov_31.502304	96	174	18	3	78	0.0384615
NODE_147595_length_316_cov_31.502304	96	174	19	1	78	0.0128205
NODE_147595_length_316_cov_31.502304	96	174	21	2	78	0.0256410
NODE_147595_length_316_cov_31.502304	96	174	23	1	78	0.0128205
NODE_147595_length_316_cov_31.502304	96	174	24	5	78	0.0641026
NODE_147595_length_316_cov_31.502304	96	174	28	1	78	0.0128205
NODE_147595_length_316_cov_31.502304	96	174	32	2	78	0.0256410
NODE_147595_length_316_cov_31.502304	96	174	33	2	78	0.0256410
NODE_147595_length_316_cov_31.502304	96	174	35	2	78	0.0256410
NODE_147595_length_316_cov_31.502304	96	174	36	3	78	0.0384615
NODE_147595_length_316_cov_31.502304	96	174	38	2	78	0.0256410
NODE_147595_length_316_cov_31.502304	96	174	42	1	78	0.0128205
NODE_147595_length_316_cov_31.502304	96	174	46	2	78	0.0256410
NODE_147595_length_316_cov_31.502304	96	174	48	1	78	0.0128205
NODE_147595_length_316_cov_31.502304	96	174	54	1	78	0.0128205
NODE_147595_length_316_cov_31.502304	96	174	56	3	78	0.0384615
NODE_147595_length_316_cov_31.502304	96	174	58	2	78	0.0256410
NODE_147595_length_316_cov_31.502304	96	121	0	9	25	0.3600000
NODE_147595_length_316_cov_31.502304	96	121	2	6	25	0.2400000
NODE_147595_length_316_cov_31.502304	96	121	4	6	25	0.2400000
NODE_147595_length_316_cov_31.502304	96	121	5	1	25	0.0400000
NODE_147595_length_316_cov_31.502304	96	121	7	3	25	0.1200000
NODE_147609_length_316_cov_6.179724	225	278	0	52	53	0.9811321
NODE_147609_length_316_cov_6.179724	225	278	2	1	53	0.0188679
NODE_147623_length_316_cov_5.539171	91	171	0	17	80	0.2125000
NODE_147623_length_316_cov_5.539171	91	171	2	46	80	0.5750000
NODE_147623_length_316_cov_5.539171	91	171	4	17	80	0.2125000
NODE_147668_length_316_cov_3.732719	128	208	0	67	80	0.8375000
NODE_147668_length_316_cov_3.732719	128	208	4	13	80	0.1625000
NODE_147668_length_316_cov_3.732719	181	257	0	14	76	0.1842105
NODE_147668_length_316_cov_3.732719	181	257	4	62	76	0.8157895
NODE_147680_length_316_cov_3.589862	185	247	0	62	62	1.0000000
NODE_147684_length_316_cov_3.520737	101	143	0	24	42	0.5714286
NODE_147684_length_316_cov_3.520737	101	143	2	18	42	0.4285714
NODE_147702_length_316_cov_3.221198	108	184	0	2	76	0.0263158
NODE_147702_length_316_cov_3.221198	108	184	2	33	76	0.4342105
NODE_147702_length_316_cov_3.221198	108	184	4	41	76	0.5394737
NODE_147734_length_316_cov_2.824885	274	311	0	37	37	1.0000000
NODE_147736_length_316_cov_2.820276	200	280	0	25	80	0.3125000
NODE_147736_length_316_cov_2.820276	200	280	2	55	80	0.6875000
NODE_147757_length_316_cov_2.672811	23	80	6	57	57	1.0000000
NODE_147796_length_316_cov_2.456221	104	144	0	40	40	1.0000000
NODE_147985_length_316_cov_1.751152	73	122	2	15	49	0.3061225
NODE_147985_length_316_cov_1.751152	73	122	4	2	49	0.0408163
NODE_147985_length_316_cov_1.751152	73	122	6	14	49	0.2857143
NODE_147985_length_316_cov_1.751152	73	122	8	18	49	0.3673469
NODE_148030_length_316_cov_1.640553	218	300	0	82	82	1.0000000
NODE_148042_length_316_cov_1.631336	180	233	2	53	53	1.0000000
NODE_148042_length_316_cov_1.631336	180	215	2	35	35	1.0000000
NODE_148080_length_316_cov_1.520737	194	275	0	81	81	1.0000000
NODE_148080_length_316_cov_1.520737	248	302	0	54	54	1.0000000
NODE_148086_length_316_cov_1.493088	64	144	0	12	80	0.1500000
NODE_148086_length_316_cov_1.493088	64	144	2	16	80	0.2000000
NODE_148086_length_316_cov_1.493088	64	144	4	10	80	0.1250000
NODE_148086_length_316_cov_1.493088	64	144	6	6	80	0.0750000
NODE_148086_length_316_cov_1.493088	64	144	8	9	80	0.1125000
NODE_148086_length_316_cov_1.493088	64	144	10	27	80	0.3375000
NODE_148193_length_316_cov_1.377880	22	64	0	37	42	0.8809524
NODE_148193_length_316_cov_1.377880	22	64	1	5	42	0.1190476
NODE_148204_length_316_cov_1.350230	74	117	12	43	43	1.0000000
NODE_148204_length_316_cov_1.350230	90	140	8	9	50	0.1800000
NODE_148204_length_316_cov_1.350230	90	140	10	9	50	0.1800000
NODE_148204_length_316_cov_1.350230	90	140	12	32	50	0.6400000
NODE_148533_length_316_cov_0.940092	104	180	0	10	76	0.1315790
NODE_148533_length_316_cov_0.940092	104	180	2	6	76	0.0789474
NODE_148533_length_316_cov_0.940092	104	180	4	17	76	0.2236842
NODE_148533_length_316_cov_0.940092	104	180	8	11	76	0.1447368
NODE_148533_length_316_cov_0.940092	104	180	10	32	76	0.4210526
NODE_148533_length_316_cov_0.940092	155	234	0	17	79	0.2151899
NODE_148533_length_316_cov_0.940092	155	234	4	12	79	0.1518987
NODE_148533_length_316_cov_0.940092	155	234	6	5	79	0.0632911
NODE_148533_length_316_cov_0.940092	155	234	10	45	79	0.5696203
NODE_148693_length_316_cov_0.695853	232	267	0	35	35	1.0000000
NODE_148778_length_315_cov_6.967593	127	191	2	3	64	0.0468750
NODE_148778_length_315_cov_6.967593	127	191	4	13	64	0.2031250
NODE_148778_length_315_cov_6.967593	127	191	6	48	64	0.7500000
NODE_148786_length_315_cov_6.300926	67	147	0	80	80	1.0000000
NODE_148786_length_315_cov_6.300926	120	200	0	80	80	1.0000000
NODE_148812_length_315_cov_4.449074	125	205	0	59	80	0.7375000
NODE_148812_length_315_cov_4.449074	125	205	2	21	80	0.2625000
NODE_148812_length_315_cov_4.449074	178	225	0	47	47	1.0000000
NODE_148834_length_315_cov_4.009259	0	61	0	61	61	1.0000000
NODE_148834_length_315_cov_4.009259	42	61	0	19	19	1.0000000
NODE_148872_length_315_cov_3.421296	37	120	6	3	83	0.0361446
NODE_148872_length_315_cov_3.421296	37	120	8	1	83	0.0120482
NODE_148872_length_315_cov_3.421296	37	120	10	31	83	0.3734940
NODE_148872_length_315_cov_3.421296	37	120	12	16	83	0.1927711
NODE_148872_length_315_cov_3.421296	37	120	14	21	83	0.2530121
NODE_148872_length_315_cov_3.421296	37	120	16	11	83	0.1325301
NODE_148915_length_315_cov_2.847222	0	74	0	74	74	1.0000000
NODE_148915_length_315_cov_2.847222	47	127	0	80	80	1.0000000
NODE_148921_length_315_cov_2.833333	186	253	0	14	67	0.2089552
NODE_148921_length_315_cov_2.833333	186	253	2	53	67	0.7910448
NODE_148921_length_315_cov_2.833333	186	253	0	14	67	0.2089552
NODE_148921_length_315_cov_2.833333	186	253	2	53	67	0.7910448
NODE_148991_length_315_cov_2.416667	44	117	25	2	73	0.0273973
NODE_148991_length_315_cov_2.416667	44	117	27	2	73	0.0273973
NODE_148991_length_315_cov_2.416667	44	117	31	5	73	0.0684932
NODE_148991_length_315_cov_2.416667	44	117	35	1	73	0.0136986
NODE_148991_length_315_cov_2.416667	44	117	37	2	73	0.0273973
NODE_148991_length_315_cov_2.416667	44	117	39	4	73	0.0547945
NODE_148991_length_315_cov_2.416667	44	117	46	2	73	0.0273973
NODE_148991_length_315_cov_2.416667	44	117	53	2	73	0.0273973
NODE_148991_length_315_cov_2.416667	44	117	56	1	73	0.0136986
NODE_148991_length_315_cov_2.416667	44	117	60	10	73	0.1369863
NODE_148991_length_315_cov_2.416667	44	117	64	1	73	0.0136986
NODE_148991_length_315_cov_2.416667	44	117	70	4	73	0.0547945
NODE_148991_length_315_cov_2.416667	44	117	76	1	73	0.0136986
NODE_148991_length_315_cov_2.416667	44	117	84	1	73	0.0136986
NODE_148991_length_315_cov_2.416667	44	117	86	1	73	0.0136986
NODE_148991_length_315_cov_2.416667	44	117	96	5	73	0.0684932
NODE_148991_length_315_cov_2.416667	44	117	105	1	73	0.0136986
NODE_148991_length_315_cov_2.416667	44	117	107	3	73	0.0410959
NODE_148991_length_315_cov_2.416667	44	117	108	2	73	0.0273973
NODE_148991_length_315_cov_2.416667	44	117	109	2	73	0.0273973
NODE_148991_length_315_cov_2.416667	44	117	113	1	73	0.0136986
NODE_148991_length_315_cov_2.416667	44	117	117	1	73	0.0136986
NODE_148991_length_315_cov_2.416667	44	117	118	1	73	0.0136986
NODE_148991_length_315_cov_2.416667	44	117	120	1	73	0.0136986
NODE_148991_length_315_cov_2.416667	44	117	123	1	73	0.0136986
NODE_148991_length_315_cov_2.416667	44	117	133	2	73	0.0273973
NODE_148991_length_315_cov_2.416667	44	117	136	7	73	0.0958904
NODE_148991_length_315_cov_2.416667	44	117	137	3	73	0.0410959
NODE_148991_length_315_cov_2.416667	44	117	138	2	73	0.0273973
NODE_148991_length_315_cov_2.416667	44	117	139	2	73	0.0273973
NODE_149074_length_315_cov_2.115741	128	193	0	8	65	0.1230769
NODE_149074_length_315_cov_2.115741	128	193	2	57	65	0.8769231
NODE_149095_length_315_cov_2.004630	270	315	0	45	45	1.0000000
NODE_149201_length_315_cov_1.731481	125	202	0	37	77	0.4805195
NODE_149201_length_315_cov_1.731481	125	202	2	12	77	0.1558442
NODE_149201_length_315_cov_1.731481	125	202	4	26	77	0.3376623
NODE_149201_length_315_cov_1.731481	125	202	6	2	77	0.0259740
NODE_149391_length_315_cov_1.384259	183	233	2	50	50	1.0000000
NODE_149935_length_315_cov_0.430556	125	145	0	20	20	1.0000000
NODE_149943_length_314_cov_108.139535	151	213	0	2	62	0.0322581
NODE_149943_length_314_cov_108.139535	151	213	14	5	62	0.0806452
NODE_149943_length_314_cov_108.139535	151	213	16	1	62	0.0161290
NODE_149943_length_314_cov_108.139535	151	213	18	2	62	0.0322581
NODE_149943_length_314_cov_108.139535	151	213	20	52	62	0.8387097
NODE_149943_length_314_cov_108.139535	160	213	0	2	53	0.0377358
NODE_149943_length_314_cov_108.139535	160	213	14	5	53	0.0943396
NODE_149943_length_314_cov_108.139535	160	213	16	1	53	0.0188679
NODE_149943_length_314_cov_108.139535	160	213	18	2	53	0.0377358
NODE_149943_length_314_cov_108.139535	160	213	20	43	53	0.8113208
NODE_149944_length_314_cov_48.134884	245	314	0	69	69	1.0000000
NODE_149946_length_314_cov_9.097674	149	206	0	6	57	0.1052632
NODE_149946_length_314_cov_9.097674	149	206	2	51	57	0.8947368
NODE_149967_length_314_cov_4.897674	109	189	2	80	80	1.0000000
NODE_150004_length_314_cov_3.823256	119	199	0	54	80	0.6750000
NODE_150004_length_314_cov_3.823256	119	199	2	5	80	0.0625000
NODE_150004_length_314_cov_3.823256	119	199	4	18	80	0.2250000
NODE_150004_length_314_cov_3.823256	119	199	6	3	80	0.0375000
NODE_150020_length_314_cov_3.558140	32	92	10	1	60	0.0166667
NODE_150020_length_314_cov_3.558140	32	92	14	10	60	0.1666667
NODE_150020_length_314_cov_3.558140	32	92	18	19	60	0.3166667
NODE_150020_length_314_cov_3.558140	32	92	20	30	60	0.5000000
NODE_150035_length_314_cov_3.316279	84	126	14	19	42	0.4523810
NODE_150035_length_314_cov_3.316279	84	126	18	23	42	0.5476190
NODE_150035_length_314_cov_3.316279	127	180	2	20	53	0.3773585
NODE_150035_length_314_cov_3.316279	127	180	4	8	53	0.1509434
NODE_150035_length_314_cov_3.316279	127	180	8	4	53	0.0754717
NODE_150035_length_314_cov_3.316279	127	180	10	5	53	0.0943396
NODE_150035_length_314_cov_3.316279	127	180	12	9	53	0.1698113
NODE_150035_length_314_cov_3.316279	127	180	13	2	53	0.0377358
NODE_150035_length_314_cov_3.316279	127	180	14	5	53	0.0943396
NODE_150035_length_314_cov_3.316279	128	148	10	5	20	0.2500000
NODE_150035_length_314_cov_3.316279	128	148	12	9	20	0.4500000
NODE_150035_length_314_cov_3.316279	128	148	13	2	20	0.1000000
NODE_150035_length_314_cov_3.316279	128	148	14	4	20	0.2000000
NODE_150066_length_314_cov_3.032558	252	308	0	2	56	0.0357143
NODE_150066_length_314_cov_3.032558	252	308	2	8	56	0.1428571
NODE_150066_length_314_cov_3.032558	252	308	4	9	56	0.1607143
NODE_150066_length_314_cov_3.032558	252	308	8	18	56	0.3214286
NODE_150066_length_314_cov_3.032558	252	308	10	2	56	0.0357143
NODE_150066_length_314_cov_3.032558	252	308	12	8	56	0.1428571
NODE_150066_length_314_cov_3.032558	252	308	14	9	56	0.1607143
NODE_150141_length_314_cov_2.520930	0	61	0	61	61	1.0000000
NODE_150141_length_314_cov_2.520930	34	93	0	59	59	1.0000000
NODE_150153_length_314_cov_2.441860	48	84	0	36	36	1.0000000
NODE_150159_length_314_cov_2.395349	62	112	6	41	50	0.8200000
NODE_150159_length_314_cov_2.395349	62	112	8	9	50	0.1800000
NODE_150200_length_314_cov_2.265116	7	53	0	14	46	0.3043478
NODE_150200_length_314_cov_2.265116	7	53	2	32	46	0.6956522
NODE_150220_length_314_cov_2.144186	224	264	0	40	40	1.0000000
NODE_150257_length_314_cov_2.004651	68	148	0	16	80	0.2000000
NODE_150257_length_314_cov_2.004651	68	148	2	64	80	0.8000000
NODE_150257_length_314_cov_2.004651	121	201	0	69	80	0.8625000
NODE_150257_length_314_cov_2.004651	121	201	2	11	80	0.1375000
NODE_150385_length_314_cov_1.665116	204	242	0	38	38	1.0000000
NODE_150385_length_314_cov_1.665116	215	295	0	80	80	1.0000000
NODE_150647_length_314_cov_1.223256	7	87	0	80	80	1.0000000
NODE_150709_length_314_cov_1.167442	1	69	0	68	68	1.0000000
NODE_151193_length_313_cov_156.051402	177	254	29	1	77	0.0129870
NODE_151193_length_313_cov_156.051402	177	254	30	15	77	0.1948052
NODE_151193_length_313_cov_156.051402	177	254	36	4	77	0.0519481
NODE_151193_length_313_cov_156.051402	177	254	40	57	77	0.7402598
NODE_151193_length_313_cov_156.051402	177	254	29	1	77	0.0129870
NODE_151193_length_313_cov_156.051402	177	254	30	15	77	0.1948052
NODE_151193_length_313_cov_156.051402	177	254	36	4	77	0.0519481
NODE_151193_length_313_cov_156.051402	177	254	40	57	77	0.7402598
NODE_151214_length_313_cov_5.359813	135	196	0	61	61	1.0000000
NODE_151214_length_313_cov_5.359813	169	241	0	72	72	1.0000000
NODE_151230_length_313_cov_4.794393	126	206	4	16	80	0.2000000
NODE_151230_length_313_cov_4.794393	126	206	6	19	80	0.2375000
NODE_151230_length_313_cov_4.794393	126	206	8	8	80	0.1000000
NODE_151230_length_313_cov_4.794393	126	206	9	9	80	0.1125000
NODE_151230_length_313_cov_4.794393	126	206	10	28	80	0.3500000
NODE_151230_length_313_cov_4.794393	179	259	4	14	80	0.1750000
NODE_151230_length_313_cov_4.794393	179	259	6	9	80	0.1125000
NODE_151230_length_313_cov_4.794393	179	259	8	6	80	0.0750000
NODE_151230_length_313_cov_4.794393	179	259	9	8	80	0.1000000
NODE_151230_length_313_cov_4.794393	179	259	10	43	80	0.5375000
NODE_151232_length_313_cov_4.761682	104	162	0	58	58	1.0000000
NODE_151232_length_313_cov_4.761682	135	215	0	80	80	1.0000000
NODE_151277_length_313_cov_3.560748	106	186	4	1	80	0.0125000
NODE_151277_length_313_cov_3.560748	106	186	6	79	80	0.9875000
NODE_151331_length_313_cov_2.953271	92	153	2	59	61	0.9672131
NODE_151331_length_313_cov_2.953271	92	153	4	2	61	0.0327869
NODE_151364_length_313_cov_2.640187	110	182	0	72	72	1.0000000
NODE_151364_length_313_cov_2.640187	113	184	0	71	71	1.0000000
NODE_151409_length_313_cov_2.383178	58	137	0	79	79	1.0000000
NODE_151409_length_313_cov_2.383178	110	190	0	78	80	0.9750000
NODE_151409_length_313_cov_2.383178	110	190	2	2	80	0.0250000
NODE_151474_length_313_cov_2.107477	153	221	2	21	68	0.3088235
NODE_151474_length_313_cov_2.107477	153	221	4	8	68	0.1176471
NODE_151474_length_313_cov_2.107477	153	221	6	35	68	0.5147059
NODE_151474_length_313_cov_2.107477	153	221	8	4	68	0.0588235
NODE_151510_length_313_cov_1.934579	107	187	2	5	80	0.0625000
NODE_151510_length_313_cov_1.934579	107	187	3	22	80	0.2750000
NODE_151510_length_313_cov_1.934579	107	187	4	1	80	0.0125000
NODE_151510_length_313_cov_1.934579	107	187	10	2	80	0.0250000
NODE_151510_length_313_cov_1.934579	107	187	12	3	80	0.0375000
NODE_151510_length_313_cov_1.934579	107	187	14	5	80	0.0625000
NODE_151510_length_313_cov_1.934579	107	187	15	6	80	0.0750000
NODE_151510_length_313_cov_1.934579	107	187	17	1	80	0.0125000
NODE_151510_length_313_cov_1.934579	107	187	19	4	80	0.0500000
NODE_151510_length_313_cov_1.934579	107	187	21	1	80	0.0125000
NODE_151510_length_313_cov_1.934579	107	187	24	5	80	0.0625000
NODE_151510_length_313_cov_1.934579	107	187	26	8	80	0.1000000
NODE_151510_length_313_cov_1.934579	107	187	30	3	80	0.0375000
NODE_151510_length_313_cov_1.934579	107	187	34	3	80	0.0375000
NODE_151510_length_313_cov_1.934579	107	187	36	2	80	0.0250000
NODE_151510_length_313_cov_1.934579	107	187	40	3	80	0.0375000
NODE_151510_length_313_cov_1.934579	107	187	42	6	80	0.0750000
NODE_151510_length_313_cov_1.934579	160	240	24	2	80	0.0250000
NODE_151510_length_313_cov_1.934579	160	240	26	8	80	0.1000000
NODE_151510_length_313_cov_1.934579	160	240	30	3	80	0.0375000
NODE_151510_length_313_cov_1.934579	160	240	34	3	80	0.0375000
NODE_151510_length_313_cov_1.934579	160	240	36	2	80	0.0250000
NODE_151510_length_313_cov_1.934579	160	240	40	3	80	0.0375000
NODE_151510_length_313_cov_1.934579	160	240	42	26	80	0.3250000
NODE_151510_length_313_cov_1.934579	160	240	44	8	80	0.1000000
NODE_151510_length_313_cov_1.934579	160	240	46	9	80	0.1125000
NODE_151510_length_313_cov_1.934579	160	240	48	16	80	0.2000000
NODE_151576_length_313_cov_1.780374	236	296	0	31	60	0.5166667
NODE_151576_length_313_cov_1.780374	236	296	1	24	60	0.4000000
NODE_151576_length_313_cov_1.780374	236	296	2	5	60	0.0833333
NODE_151623_length_313_cov_1.663551	58	135	4	8	77	0.1038961
NODE_151623_length_313_cov_1.663551	58	135	8	69	77	0.8961039
NODE_151703_length_313_cov_1.439252	0	64	0	64	64	1.0000000
NODE_151703_length_313_cov_1.439252	37	82	0	45	45	1.0000000
NODE_151753_length_313_cov_1.429907	74	111	4	37	37	1.0000000
NODE_151753_length_313_cov_1.429907	109	172	2	11	63	0.1746032
NODE_151753_length_313_cov_1.429907	109	172	4	52	63	0.8253968
NODE_151953_length_313_cov_1.172897	106	161	0	5	55	0.0909091
NODE_151953_length_313_cov_1.172897	106	161	2	45	55	0.8181818
NODE_151953_length_313_cov_1.172897	106	161	4	4	55	0.0727273
NODE_151953_length_313_cov_1.172897	106	161	6	1	55	0.0181818
NODE_151953_length_313_cov_1.172897	149	214	2	7	65	0.1076923
NODE_151953_length_313_cov_1.172897	149	214	4	4	65	0.0615385
NODE_151953_length_313_cov_1.172897	149	214	6	24	65	0.3692308
NODE_151953_length_313_cov_1.172897	149	214	8	2	65	0.0307692
NODE_151953_length_313_cov_1.172897	149	214	10	8	65	0.1230769
NODE_151953_length_313_cov_1.172897	149	214	12	4	65	0.0615385
NODE_151953_length_313_cov_1.172897	149	214	14	10	65	0.1538462
NODE_151953_length_313_cov_1.172897	149	214	16	6	65	0.0923077
NODE_152525_length_312_cov_3.723005	178	238	10	3	60	0.0500000
NODE_152525_length_312_cov_3.723005	178	238	12	11	60	0.1833333
NODE_152525_length_312_cov_3.723005	178	238	16	1	60	0.0166667
NODE_152525_length_312_cov_3.723005	178	238	18	19	60	0.3166667
NODE_152525_length_312_cov_3.723005	178	238	20	26	60	0.4333333
NODE_152525_length_312_cov_3.723005	231	291	12	5	60	0.0833333
NODE_152525_length_312_cov_3.723005	231	291	14	34	60	0.5666667
NODE_152525_length_312_cov_3.723005	231	291	16	1	60	0.0166667
NODE_152525_length_312_cov_3.723005	231	291	17	1	60	0.0166667
NODE_152525_length_312_cov_3.723005	231	291	18	19	60	0.3166667
NODE_152609_length_312_cov_2.723005	34	96	3	62	62	1.0000000
NODE_152609_length_312_cov_2.723005	87	149	1	35	62	0.5645161
NODE_152609_length_312_cov_2.723005	87	149	3	27	62	0.4354839
NODE_152680_length_312_cov_2.333333	6	70	0	52	64	0.8125000
NODE_152680_length_312_cov_2.333333	6	70	2	12	64	0.1875000
NODE_152680_length_312_cov_2.333333	43	123	0	15	80	0.1875000
NODE_152680_length_312_cov_2.333333	43	123	2	65	80	0.8125000
NODE_152686_length_312_cov_2.267606	176	208	8	32	32	1.0000000
NODE_152697_length_312_cov_2.234742	108	169	0	60	61	0.9836066
NODE_152697_length_312_cov_2.234742	108	169	6	1	61	0.0163934
NODE_152751_length_312_cov_2.014085	141	205	0	3	64	0.0468750
NODE_152751_length_312_cov_2.014085	141	205	2	61	64	0.9531250
NODE_152751_length_312_cov_2.014085	178	258	2	80	80	1.0000000
NODE_152827_length_312_cov_1.835681	176	221	0	45	45	1.0000000
NODE_152827_length_312_cov_1.835681	194	269	0	75	75	1.0000000
NODE_153222_length_312_cov_1.173709	87	133	0	4	46	0.0869565
NODE_153222_length_312_cov_1.173709	87	133	4	9	46	0.1956522
NODE_153222_length_312_cov_1.173709	87	133	7	1	46	0.0217391
NODE_153222_length_312_cov_1.173709	87	133	8	1	46	0.0217391
NODE_153222_length_312_cov_1.173709	87	133	12	2	46	0.0434783
NODE_153222_length_312_cov_1.173709	87	133	14	2	46	0.0434783
NODE_153222_length_312_cov_1.173709	87	133	16	2	46	0.0434783
NODE_153222_length_312_cov_1.173709	87	133	18	1	46	0.0217391
NODE_153222_length_312_cov_1.173709	87	133	19	2	46	0.0434783
NODE_153222_length_312_cov_1.173709	87	133	21	4	46	0.0869565
NODE_153222_length_312_cov_1.173709	87	133	22	4	46	0.0869565
NODE_153222_length_312_cov_1.173709	87	133	26	3	46	0.0652174
NODE_153222_length_312_cov_1.173709	87	133	27	2	46	0.0434783
NODE_153222_length_312_cov_1.173709	87	133	28	1	46	0.0217391
NODE_153222_length_312_cov_1.173709	87	133	29	1	46	0.0217391
NODE_153222_length_312_cov_1.173709	87	133	32	1	46	0.0217391
NODE_153222_length_312_cov_1.173709	87	133	34	6	46	0.1304348
NODE_153222_length_312_cov_1.173709	150	217	48	4	67	0.0597015
NODE_153222_length_312_cov_1.173709	150	217	50	1	67	0.0149254
NODE_153222_length_312_cov_1.173709	150	217	52	1	67	0.0149254
NODE_153222_length_312_cov_1.173709	150	217	54	1	67	0.0149254
NODE_153222_length_312_cov_1.173709	150	217	56	1	67	0.0149254
NODE_153222_length_312_cov_1.173709	150	217	58	2	67	0.0298507
NODE_153222_length_312_cov_1.173709	150	217	62	2	67	0.0298507
NODE_153222_length_312_cov_1.173709	150	217	67	5	67	0.0746269
NODE_153222_length_312_cov_1.173709	150	217	68	5	67	0.0746269
NODE_153222_length_312_cov_1.173709	150	217	72	1	67	0.0149254
NODE_153222_length_312_cov_1.173709	150	217	74	9	67	0.1343284
NODE_153222_length_312_cov_1.173709	150	217	76	6	67	0.0895522
NODE_153222_length_312_cov_1.173709	150	217	78	1	67	0.0149254
NODE_153222_length_312_cov_1.173709	150	217	80	26	67	0.3880597
NODE_153222_length_312_cov_1.173709	150	217	82	1	67	0.0149254
NODE_153222_length_312_cov_1.173709	150	217	86	1	67	0.0149254
NODE_153532_length_312_cov_0.788732	49	110	0	61	61	1.0000000
NODE_153532_length_312_cov_0.788732	102	163	0	61	61	1.0000000
NODE_153708_length_311_cov_5.179245	155	235	0	7	80	0.0875000
NODE_153708_length_311_cov_5.179245	155	235	2	73	80	0.9125000
NODE_153721_length_311_cov_4.589623	133	200	4	2	67	0.0298507
NODE_153721_length_311_cov_4.589623	133	200	6	65	67	0.9701493
NODE_153730_length_311_cov_4.358491	199	263	0	64	64	1.0000000
NODE_153743_length_311_cov_3.929245	91	127	2	2	36	0.0555556
NODE_153743_length_311_cov_3.929245	91	127	6	34	36	0.9444444
NODE_153755_length_311_cov_3.825472	224	304	0	7	80	0.0875000
NODE_153755_length_311_cov_3.825472	224	304	2	12	80	0.1500000
NODE_153755_length_311_cov_3.825472	224	304	4	2	80	0.0250000
NODE_153755_length_311_cov_3.825472	224	304	6	8	80	0.1000000
NODE_153755_length_311_cov_3.825472	224	304	12	10	80	0.1250000
NODE_153755_length_311_cov_3.825472	224	304	14	2	80	0.0250000
NODE_153755_length_311_cov_3.825472	224	304	16	1	80	0.0125000
NODE_153755_length_311_cov_3.825472	224	304	18	4	80	0.0500000
NODE_153755_length_311_cov_3.825472	224	304	20	13	80	0.1625000
NODE_153755_length_311_cov_3.825472	224	304	24	21	80	0.2625000
NODE_153773_length_311_cov_3.466981	106	186	0	40	80	0.5000000
NODE_153773_length_311_cov_3.466981	106	186	2	5	80	0.0625000
NODE_153773_length_311_cov_3.466981	106	186	4	19	80	0.2375000
NODE_153773_length_311_cov_3.466981	106	186	6	10	80	0.1250000
NODE_153773_length_311_cov_3.466981	106	186	7	6	80	0.0750000
NODE_153796_length_311_cov_3.188679	39	96	0	57	57	1.0000000
NODE_153846_length_311_cov_2.702830	144	193	0	49	49	1.0000000
NODE_153850_length_311_cov_2.665094	43	113	0	2	70	0.0285714
NODE_153850_length_311_cov_2.665094	43	113	2	3	70	0.0428571
NODE_153850_length_311_cov_2.665094	43	113	4	65	70	0.9285714
NODE_153859_length_311_cov_2.617925	206	284	0	78	78	1.0000000
NODE_153859_length_311_cov_2.617925	257	301	0	44	44	1.0000000
NODE_153913_length_311_cov_2.349057	177	204	2	27	27	1.0000000
NODE_153919_length_311_cov_2.325472	74	138	0	64	64	1.0000000
NODE_153947_length_311_cov_2.188679	21	92	0	71	71	1.0000000
NODE_154014_length_311_cov_1.924528	46	65	0	19	19	1.0000000
NODE_154056_length_311_cov_1.891509	122	180	0	58	58	1.0000000
NODE_154188_length_311_cov_1.594340	0	35	0	35	35	1.0000000
NODE_154190_length_311_cov_1.589623	96	151	4	13	55	0.2363636
NODE_154190_length_311_cov_1.589623	96	151	8	42	55	0.7636364
NODE_154194_length_311_cov_1.570755	125	145	0	20	20	1.0000000
NODE_154957_length_311_cov_0.613208	136	216	0	80	80	1.0000000
NODE_154957_length_311_cov_0.613208	189	264	0	75	75	1.0000000
NODE_154996_length_310_cov_96.995261	211	249	107	3	38	0.0789474
NODE_154996_length_310_cov_96.995261	211	249	111	2	38	0.0526316
NODE_154996_length_310_cov_96.995261	211	249	115	4	38	0.1052632
NODE_154996_length_310_cov_96.995261	211	249	119	5	38	0.1315790
NODE_154996_length_310_cov_96.995261	211	249	121	1	38	0.0263158
NODE_154996_length_310_cov_96.995261	211	249	122	6	38	0.1578947
NODE_154996_length_310_cov_96.995261	211	249	126	4	38	0.1052632
NODE_154996_length_310_cov_96.995261	211	249	130	1	38	0.0263158
NODE_154996_length_310_cov_96.995261	211	249	132	4	38	0.1052632
NODE_154996_length_310_cov_96.995261	211	249	134	2	38	0.0526316
NODE_154996_length_310_cov_96.995261	211	249	136	1	38	0.0263158
NODE_154996_length_310_cov_96.995261	211	249	138	1	38	0.0263158
NODE_154996_length_310_cov_96.995261	211	249	139	1	38	0.0263158
NODE_154996_length_310_cov_96.995261	211	249	143	1	38	0.0263158
NODE_154996_length_310_cov_96.995261	211	249	145	2	38	0.0526316
NODE_155001_length_310_cov_7.767773	80	151	0	71	71	1.0000000
NODE_155001_length_310_cov_7.767773	134	189	0	55	55	1.0000000
NODE_155017_length_310_cov_5.914692	84	134	0	49	50	0.9800000
NODE_155017_length_310_cov_5.914692	84	134	2	1	50	0.0200000
NODE_155017_length_310_cov_5.914692	113	134	0	21	21	1.0000000
NODE_155017_length_310_cov_5.914692	113	188	0	75	75	1.0000000
NODE_155066_length_310_cov_3.777251	146	226	0	80	80	1.0000000
NODE_155115_length_310_cov_3.180095	137	211	2	21	74	0.2837838
NODE_155115_length_310_cov_3.180095	137	211	4	15	74	0.2027027
NODE_155115_length_310_cov_3.180095	137	211	6	9	74	0.1216216
NODE_155115_length_310_cov_3.180095	137	211	8	4	74	0.0540541
NODE_155115_length_310_cov_3.180095	137	211	9	2	74	0.0270270
NODE_155115_length_310_cov_3.180095	137	211	10	13	74	0.1756757
NODE_155115_length_310_cov_3.180095	137	211	11	1	74	0.0135135
NODE_155115_length_310_cov_3.180095	137	211	12	9	74	0.1216216
NODE_155179_length_310_cov_2.630332	122	174	0	52	52	1.0000000
NODE_155179_length_310_cov_2.630332	175	222	0	47	47	1.0000000
NODE_155180_length_310_cov_2.625592	258	301	0	43	43	1.0000000
NODE_155195_length_310_cov_2.563981	149	196	2	9	47	0.1914894
NODE_155195_length_310_cov_2.563981	149	196	4	8	47	0.1702128
NODE_155195_length_310_cov_2.563981	149	196	6	5	47	0.1063830
NODE_155195_length_310_cov_2.563981	149	196	7	25	47	0.5319149
NODE_155195_length_310_cov_2.563981	169	249	0	2	80	0.0250000
NODE_155195_length_310_cov_2.563981	169	249	1	2	80	0.0250000
NODE_155195_length_310_cov_2.563981	169	249	2	58	80	0.7250000
NODE_155195_length_310_cov_2.563981	169	249	4	8	80	0.1000000
NODE_155195_length_310_cov_2.563981	169	249	6	5	80	0.0625000
NODE_155195_length_310_cov_2.563981	169	249	7	5	80	0.0625000
NODE_155261_length_310_cov_2.298578	213	259	2	4	46	0.0869565
NODE_155261_length_310_cov_2.298578	213	259	4	42	46	0.9130435
NODE_155334_length_310_cov_2.009479	223	303	0	5	80	0.0625000
NODE_155334_length_310_cov_2.009479	223	303	5	1	80	0.0125000
NODE_155334_length_310_cov_2.009479	223	303	6	74	80	0.9250000
NODE_155439_length_310_cov_1.729858	53	91	0	38	38	1.0000000
NODE_155768_length_310_cov_1.222749	181	244	0	63	63	1.0000000
NODE_155864_length_310_cov_1.142180	65	135	6	2	70	0.0285714
NODE_155864_length_310_cov_1.142180	65	135	8	3	70	0.0428571
NODE_155864_length_310_cov_1.142180	65	135	10	7	70	0.1000000
NODE_155864_length_310_cov_1.142180	65	135	12	5	70	0.0714286
NODE_155864_length_310_cov_1.142180	65	135	14	35	70	0.5000000
NODE_155864_length_310_cov_1.142180	65	135	16	18	70	0.2571429
NODE_155937_length_310_cov_0.966825	131	212	0	81	81	1.0000000
NODE_155937_length_310_cov_0.966825	193	256	0	63	63	1.0000000
NODE_156078_length_310_cov_0.924171	180	222	2	42	42	1.0000000
NODE_156174_length_310_cov_0.739336	208	288	0	80	80	1.0000000
NODE_156332_length_309_cov_8.552381	154	234	0	80	80	1.0000000
NODE_156340_length_309_cov_6.147619	20	83	0	63	63	1.0000000
NODE_156349_length_309_cov_5.147619	213	291	0	78	78	1.0000000
NODE_156364_length_309_cov_4.585714	15	95	0	1	80	0.0125000
NODE_156364_length_309_cov_4.585714	15	95	2	27	80	0.3375000
NODE_156364_length_309_cov_4.585714	15	95	4	52	80	0.6500000
NODE_156472_length_309_cov_3.028571	0	47	0	47	47	1.0000000
NODE_156472_length_309_cov_3.028571	20	101	0	81	81	1.0000000
NODE_156563_length_309_cov_2.304762	179	218	0	17	39	0.4358974
NODE_156563_length_309_cov_2.304762	179	218	2	18	39	0.4615385
NODE_156563_length_309_cov_2.304762	179	218	4	1	39	0.0256410
NODE_156563_length_309_cov_2.304762	179	218	6	3	39	0.0769231
NODE_156615_length_309_cov_2.095238	55	85	4	30	30	1.0000000
NODE_156678_length_309_cov_1.938095	2	73	0	71	71	1.0000000
NODE_156950_length_309_cov_1.414286	189	231	0	42	42	1.0000000
NODE_156978_length_309_cov_1.376190	94	168	0	46	74	0.6216216
NODE_156978_length_309_cov_1.376190	94	168	2	3	74	0.0405405
NODE_156978_length_309_cov_1.376190	94	168	4	23	74	0.3108108
NODE_156978_length_309_cov_1.376190	94	168	6	2	74	0.0270270
NODE_157334_length_309_cov_0.966667	134	153	0	19	19	1.0000000
NODE_157469_length_309_cov_0.738095	150	215	10	29	65	0.4461538
NODE_157469_length_309_cov_0.738095	150	215	12	35	65	0.5384616
NODE_157469_length_309_cov_0.738095	150	215	14	1	65	0.0153846
NODE_157661_length_308_cov_4.775120	137	174	0	37	37	1.0000000
NODE_157690_length_308_cov_3.966507	126	206	0	76	80	0.9500000
NODE_157690_length_308_cov_3.966507	126	206	2	4	80	0.0500000
NODE_157705_length_308_cov_3.665072	11	75	0	64	64	1.0000000
NODE_157819_length_308_cov_2.593301	137	193	0	56	56	1.0000000
NODE_157852_length_308_cov_2.435407	14	58	0	44	44	1.0000000
NODE_157852_length_308_cov_2.435407	31	111	0	80	80	1.0000000
NODE_157898_length_308_cov_2.191388	14	80	0	66	66	1.0000000
NODE_157903_length_308_cov_2.191388	236	296	0	60	60	1.0000000
NODE_157969_length_308_cov_1.952153	251	296	0	45	45	1.0000000
NODE_158083_length_308_cov_1.708134	102	148	0	46	46	1.0000000
NODE_158276_length_308_cov_1.435407	196	276	0	23	80	0.2875000
NODE_158276_length_308_cov_1.435407	196	276	2	57	80	0.7125000
NODE_158439_length_308_cov_1.162679	260	300	0	40	40	1.0000000
NODE_158439_length_308_cov_1.162679	273	307	0	34	34	1.0000000
NODE_158447_length_308_cov_1.148325	35	83	0	40	48	0.8333333
NODE_158447_length_308_cov_1.148325	35	83	4	8	48	0.1666667
NODE_158448_length_308_cov_1.148325	253	308	0	55	55	1.0000000
NODE_158510_length_308_cov_1.038278	147	202	0	55	55	1.0000000
NODE_158811_length_308_cov_0.684211	196	275	0	79	79	1.0000000
NODE_158821_length_308_cov_0.660287	109	157	0	5	48	0.1041667
NODE_158821_length_308_cov_0.660287	109	157	4	15	48	0.3125000
NODE_158821_length_308_cov_0.660287	109	157	8	3	48	0.0625000
NODE_158821_length_308_cov_0.660287	109	157	10	3	48	0.0625000
NODE_158821_length_308_cov_0.660287	109	157	12	7	48	0.1458333
NODE_158821_length_308_cov_0.660287	109	157	15	10	48	0.2083333
NODE_158821_length_308_cov_0.660287	109	157	16	5	48	0.1041667
NODE_158821_length_308_cov_0.660287	130	210	8	2	80	0.0250000
NODE_158821_length_308_cov_0.660287	130	210	10	3	80	0.0375000
NODE_158821_length_308_cov_0.660287	130	210	12	12	80	0.1500000
NODE_158821_length_308_cov_0.660287	130	210	15	10	80	0.1250000
NODE_158821_length_308_cov_0.660287	130	210	16	53	80	0.6625000
NODE_158905_length_307_cov_30.725962	0	73	0	73	73	1.0000000
NODE_158905_length_307_cov_30.725962	46	99	0	53	53	1.0000000
NODE_158906_length_307_cov_25.096154	84	164	0	80	80	1.0000000
NODE_158906_length_307_cov_25.096154	137	217	0	80	80	1.0000000
NODE_158933_length_307_cov_5.524038	150	221	0	24	71	0.3380282
NODE_158933_length_307_cov_5.524038	150	221	2	47	71	0.6619718
NODE_158983_length_307_cov_3.730769	172	252	0	80	80	1.0000000
NODE_158983_length_307_cov_3.730769	225	305	0	80	80	1.0000000
NODE_158999_length_307_cov_3.322115	20	100	0	43	80	0.5375000
NODE_158999_length_307_cov_3.322115	20	100	2	37	80	0.4625000
NODE_158999_length_307_cov_3.322115	78	153	0	12	75	0.1600000
NODE_158999_length_307_cov_3.322115	78	153	2	63	75	0.8400000
NODE_159000_length_307_cov_3.317308	12	94	2	5	82	0.0609756
NODE_159000_length_307_cov_3.317308	12	94	4	8	82	0.0975610
NODE_159000_length_307_cov_3.317308	12	94	8	21	82	0.2560976
NODE_159000_length_307_cov_3.317308	12	94	10	48	82	0.5853658
NODE_159000_length_307_cov_3.317308	76	134	0	15	58	0.2586207
NODE_159000_length_307_cov_3.317308	76	134	2	5	58	0.0862069
NODE_159000_length_307_cov_3.317308	76	134	4	9	58	0.1551724
NODE_159000_length_307_cov_3.317308	76	134	8	3	58	0.0517241
NODE_159000_length_307_cov_3.317308	76	134	10	26	58	0.4482759
NODE_159053_length_307_cov_2.870192	43	108	0	65	65	1.0000000
NODE_159084_length_307_cov_2.653846	117	177	22	1	60	0.0166667
NODE_159084_length_307_cov_2.653846	117	177	26	3	60	0.0500000
NODE_159084_length_307_cov_2.653846	117	177	30	4	60	0.0666667
NODE_159084_length_307_cov_2.653846	117	177	32	35	60	0.5833333
NODE_159084_length_307_cov_2.653846	117	177	34	7	60	0.1166667
NODE_159084_length_307_cov_2.653846	117	177	38	6	60	0.1000000
NODE_159084_length_307_cov_2.653846	117	177	40	4	60	0.0666667
NODE_159142_length_307_cov_2.346154	54	105	2	51	51	1.0000000
NODE_159351_length_307_cov_1.716346	124	165	0	3	41	0.0731707
NODE_159351_length_307_cov_1.716346	124	165	2	38	41	0.9268293
NODE_159362_length_307_cov_1.716346	30	93	0	30	63	0.4761905
NODE_159362_length_307_cov_1.716346	30	93	2	1	63	0.0158730
NODE_159362_length_307_cov_1.716346	30	93	6	6	63	0.0952381
NODE_159362_length_307_cov_1.716346	30	93	10	23	63	0.3650794
NODE_159362_length_307_cov_1.716346	30	93	12	3	63	0.0476190
NODE_159407_length_307_cov_1.600962	221	269	0	48	48	1.0000000
NODE_159407_length_307_cov_1.600962	242	307	0	65	65	1.0000000
NODE_159447_length_307_cov_1.475962	252	307	0	55	55	1.0000000
NODE_159585_length_307_cov_1.326923	96	142	0	46	46	1.0000000
NODE_159585_length_307_cov_1.326923	115	195	0	80	80	1.0000000
NODE_159618_length_307_cov_1.264423	13	61	0	43	48	0.8958333
NODE_159618_length_307_cov_1.264423	13	61	10	4	48	0.0833333
NODE_159618_length_307_cov_1.264423	13	61	11	1	48	0.0208333
NODE_159618_length_307_cov_1.264423	23	54	0	31	31	1.0000000
NODE_159696_length_307_cov_1.197115	92	121	0	29	29	1.0000000
NODE_159787_length_307_cov_1.000000	132	168	0	36	36	1.0000000
NODE_160213_length_306_cov_74.526570	68	136	10	24	68	0.3529412
NODE_160213_length_306_cov_74.526570	68	136	20	2	68	0.0294118
NODE_160213_length_306_cov_74.526570	68	136	22	7	68	0.1029412
NODE_160213_length_306_cov_74.526570	68	136	24	35	68	0.5147059
NODE_160213_length_306_cov_74.526570	68	148	10	24	80	0.3000000
NODE_160213_length_306_cov_74.526570	68	148	20	2	80	0.0250000
NODE_160213_length_306_cov_74.526570	68	148	22	14	80	0.1750000
NODE_160213_length_306_cov_74.526570	68	148	24	40	80	0.5000000
NODE_160213_length_306_cov_74.526570	121	201	17	1	80	0.0125000
NODE_160213_length_306_cov_74.526570	121	201	18	21	80	0.2625000
NODE_160213_length_306_cov_74.526570	121	201	20	2	80	0.0250000
NODE_160213_length_306_cov_74.526570	121	201	22	36	80	0.4500000
NODE_160213_length_306_cov_74.526570	121	201	24	20	80	0.2500000
NODE_160213_length_306_cov_74.526570	121	201	17	1	80	0.0125000
NODE_160213_length_306_cov_74.526570	121	201	18	21	80	0.2625000
NODE_160213_length_306_cov_74.526570	121	201	20	2	80	0.0250000
NODE_160213_length_306_cov_74.526570	121	201	22	36	80	0.4500000
NODE_160213_length_306_cov_74.526570	121	201	24	20	80	0.2500000
NODE_160213_length_306_cov_74.526570	197	277	0	70	80	0.8750000
NODE_160213_length_306_cov_74.526570	197	277	13	1	80	0.0125000
NODE_160213_length_306_cov_74.526570	197	277	14	5	80	0.0625000
NODE_160213_length_306_cov_74.526570	197	277	17	1	80	0.0125000
NODE_160213_length_306_cov_74.526570	197	277	18	3	80	0.0375000
NODE_160213_length_306_cov_74.526570	197	277	0	70	80	0.8750000
NODE_160213_length_306_cov_74.526570	197	277	13	1	80	0.0125000
NODE_160213_length_306_cov_74.526570	197	277	14	5	80	0.0625000
NODE_160213_length_306_cov_74.526570	197	277	17	1	80	0.0125000
NODE_160213_length_306_cov_74.526570	197	277	18	3	80	0.0375000
NODE_160213_length_306_cov_74.526570	197	277	0	70	80	0.8750000
NODE_160213_length_306_cov_74.526570	197	277	13	1	80	0.0125000
NODE_160213_length_306_cov_74.526570	197	277	14	5	80	0.0625000
NODE_160213_length_306_cov_74.526570	197	277	17	1	80	0.0125000
NODE_160213_length_306_cov_74.526570	197	277	18	3	80	0.0375000
NODE_160213_length_306_cov_74.526570	250	299	0	49	49	1.0000000
NODE_160213_length_306_cov_74.526570	250	306	0	56	56	1.0000000
NODE_160213_length_306_cov_74.526570	255	306	0	51	51	1.0000000
NODE_160217_length_306_cov_7.396135	23	117	0	49	94	0.5212766
NODE_160217_length_306_cov_7.396135	23	117	2	3	94	0.0319149
NODE_160217_length_306_cov_7.396135	23	117	4	42	94	0.4468085
NODE_160217_length_306_cov_7.396135	90	170	4	80	80	1.0000000
NODE_160261_length_306_cov_4.275362	67	147	0	80	80	1.0000000
NODE_160275_length_306_cov_3.937198	104	176	6	60	72	0.8333333
NODE_160275_length_306_cov_3.937198	104	176	8	12	72	0.1666667
NODE_160300_length_306_cov_3.444444	130	206	0	76	76	1.0000000
NODE_160323_length_306_cov_3.217391	198	278	4	5	80	0.0625000
NODE_160323_length_306_cov_3.217391	198	278	6	35	80	0.4375000
NODE_160323_length_306_cov_3.217391	198	278	8	14	80	0.1750000
NODE_160323_length_306_cov_3.217391	198	278	10	26	80	0.3250000
NODE_160333_length_306_cov_3.043478	90	171	6	52	81	0.6419753
NODE_160333_length_306_cov_3.043478	90	171	8	29	81	0.3580247
NODE_160333_length_306_cov_3.043478	144	202	0	24	58	0.4137931
NODE_160333_length_306_cov_3.043478	144	202	6	21	58	0.3620690
NODE_160333_length_306_cov_3.043478	144	202	8	13	58	0.2241379
NODE_160340_length_306_cov_2.956522	242	273	13	29	31	0.9354839
NODE_160340_length_306_cov_2.956522	242	273	15	2	31	0.0645161
NODE_160355_length_306_cov_2.884058	173	243	2	16	70	0.2285714
NODE_160355_length_306_cov_2.884058	173	243	4	54	70	0.7714286
NODE_160403_length_306_cov_2.574879	122	203	4	4	81	0.0493827
NODE_160403_length_306_cov_2.574879	122	203	6	19	81	0.2345679
NODE_160403_length_306_cov_2.574879	122	203	8	24	81	0.2962963
NODE_160403_length_306_cov_2.574879	122	203	10	2	81	0.0246914
NODE_160403_length_306_cov_2.574879	122	203	12	3	81	0.0370370
NODE_160403_length_306_cov_2.574879	122	203	14	29	81	0.3580247
NODE_160403_length_306_cov_2.574879	176	254	5	4	78	0.0512821
NODE_160403_length_306_cov_2.574879	176	254	9	2	78	0.0256410
NODE_160403_length_306_cov_2.574879	176	254	10	4	78	0.0512821
NODE_160403_length_306_cov_2.574879	176	254	12	8	78	0.1025641
NODE_160403_length_306_cov_2.574879	176	254	14	60	78	0.7692308
NODE_160475_length_306_cov_2.265700	223	278	0	55	55	1.0000000
NODE_160512_length_306_cov_2.106280	73	149	0	22	76	0.2894737
NODE_160512_length_306_cov_2.106280	73	149	4	31	76	0.4078947
NODE_160512_length_306_cov_2.106280	73	149	6	23	76	0.3026316
NODE_160512_length_306_cov_2.106280	125	205	0	10	80	0.1250000
NODE_160512_length_306_cov_2.106280	125	205	2	15	80	0.1875000
NODE_160512_length_306_cov_2.106280	125	205	4	1	80	0.0125000
NODE_160512_length_306_cov_2.106280	125	205	6	54	80	0.6750000
NODE_160608_length_306_cov_1.879227	165	196	10	31	31	1.0000000
NODE_160752_length_306_cov_1.478261	206	237	2	31	31	1.0000000
NODE_160761_length_306_cov_1.478261	157	220	0	63	63	1.0000000
NODE_160833_length_306_cov_1.434783	40	88	0	48	48	1.0000000
NODE_160875_length_306_cov_1.357488	128	171	0	43	43	1.0000000
NODE_160992_length_306_cov_1.222222	216	252	0	36	36	1.0000000
NODE_160992_length_306_cov_1.222222	230	305	0	75	75	1.0000000
NODE_161018_length_306_cov_1.188406	79	159	0	80	80	1.0000000
NODE_161042_length_306_cov_1.130435	122	202	0	80	80	1.0000000
NODE_161042_length_306_cov_1.130435	175	255	0	80	80	1.0000000
NODE_161078_length_306_cov_1.067633	156	188	0	32	32	1.0000000
NODE_161234_length_306_cov_0.975845	219	247	0	9	28	0.3214286
NODE_161234_length_306_cov_0.975845	219	247	2	19	28	0.6785714
NODE_161246_length_306_cov_0.956522	206	284	6	69	78	0.8846154
NODE_161246_length_306_cov_0.956522	206	284	8	9	78	0.1153846
NODE_161550_length_305_cov_5.718447	177	243	0	66	66	1.0000000
NODE_161566_length_305_cov_4.854369	55	135	0	80	80	1.0000000
NODE_161584_length_305_cov_4.266990	186	266	0	80	80	1.0000000
NODE_161723_length_305_cov_2.616505	220	263	0	8	43	0.1860465
NODE_161723_length_305_cov_2.616505	220	263	2	35	43	0.8139535
NODE_161723_length_305_cov_2.616505	236	305	0	50	69	0.7246377
NODE_161723_length_305_cov_2.616505	236	305	2	19	69	0.2753623
NODE_161726_length_305_cov_2.597087	171	256	43	2	85	0.0235294
NODE_161726_length_305_cov_2.597087	171	256	44	7	85	0.0823529
NODE_161726_length_305_cov_2.597087	171	256	48	1	85	0.0117647
NODE_161726_length_305_cov_2.597087	171	256	54	1	85	0.0117647
NODE_161726_length_305_cov_2.597087	171	256	58	5	85	0.0588235
NODE_161726_length_305_cov_2.597087	171	256	60	4	85	0.0470588
NODE_161726_length_305_cov_2.597087	171	256	62	1	85	0.0117647
NODE_161726_length_305_cov_2.597087	171	256	63	1	85	0.0117647
NODE_161726_length_305_cov_2.597087	171	256	65	1	85	0.0117647
NODE_161726_length_305_cov_2.597087	171	256	68	2	85	0.0235294
NODE_161726_length_305_cov_2.597087	171	256	72	1	85	0.0117647
NODE_161726_length_305_cov_2.597087	171	256	74	1	85	0.0117647
NODE_161726_length_305_cov_2.597087	171	256	82	1	85	0.0117647
NODE_161726_length_305_cov_2.597087	171	256	84	2	85	0.0235294
NODE_161726_length_305_cov_2.597087	171	256	86	1	85	0.0117647
NODE_161726_length_305_cov_2.597087	171	256	90	1	85	0.0117647
NODE_161726_length_305_cov_2.597087	171	256	92	1	85	0.0117647
NODE_161726_length_305_cov_2.597087	171	256	93	1	85	0.0117647
NODE_161726_length_305_cov_2.597087	171	256	96	1	85	0.0117647
NODE_161726_length_305_cov_2.597087	171	256	100	1	85	0.0117647
NODE_161726_length_305_cov_2.597087	171	256	103	1	85	0.0117647
NODE_161726_length_305_cov_2.597087	171	256	105	1	85	0.0117647
NODE_161726_length_305_cov_2.597087	171	256	106	4	85	0.0470588
NODE_161726_length_305_cov_2.597087	171	256	107	1	85	0.0117647
NODE_161726_length_305_cov_2.597087	171	256	110	5	85	0.0588235
NODE_161726_length_305_cov_2.597087	171	256	113	2	85	0.0235294
NODE_161726_length_305_cov_2.597087	171	256	116	2	85	0.0235294
NODE_161726_length_305_cov_2.597087	171	256	118	3	85	0.0352941
NODE_161726_length_305_cov_2.597087	171	256	119	1	85	0.0117647
NODE_161726_length_305_cov_2.597087	171	256	121	29	85	0.3411765
NODE_161732_length_305_cov_2.533981	3	57	0	54	54	1.0000000
NODE_161775_length_305_cov_2.339806	149	237	11	6	88	0.0681818
NODE_161775_length_305_cov_2.339806	149	237	17	22	88	0.2500000
NODE_161775_length_305_cov_2.339806	149	237	19	60	88	0.6818182
NODE_161795_length_305_cov_2.228155	194	274	0	9	80	0.1125000
NODE_161795_length_305_cov_2.228155	194	274	1	1	80	0.0125000
NODE_161795_length_305_cov_2.228155	194	274	2	70	80	0.8750000
NODE_161795_length_305_cov_2.228155	247	300	0	35	53	0.6603774
NODE_161795_length_305_cov_2.228155	247	300	1	1	53	0.0188679
NODE_161795_length_305_cov_2.228155	247	300	2	17	53	0.3207547
NODE_161877_length_305_cov_1.975728	44	116	0	6	72	0.0833333
NODE_161877_length_305_cov_1.975728	44	116	2	2	72	0.0277778
NODE_161877_length_305_cov_1.975728	44	116	6	64	72	0.8888889
NODE_161908_length_305_cov_1.883495	135	172	34	6	37	0.1621622
NODE_161908_length_305_cov_1.883495	135	172	36	8	37	0.2162162
NODE_161908_length_305_cov_1.883495	135	172	38	3	37	0.0810811
NODE_161908_length_305_cov_1.883495	135	172	42	5	37	0.1351351
NODE_161908_length_305_cov_1.883495	135	172	43	1	37	0.0270270
NODE_161908_length_305_cov_1.883495	135	172	45	1	37	0.0270270
NODE_161908_length_305_cov_1.883495	135	172	47	1	37	0.0270270
NODE_161908_length_305_cov_1.883495	135	172	53	7	37	0.1891892
NODE_161908_length_305_cov_1.883495	135	172	61	2	37	0.0540541
NODE_161908_length_305_cov_1.883495	135	172	62	3	37	0.0810811
NODE_161990_length_305_cov_1.674757	14	80	8	62	66	0.9393939
NODE_161990_length_305_cov_1.674757	14	80	12	4	66	0.0606061
NODE_161990_length_305_cov_1.674757	53	133	8	23	80	0.2875000
NODE_161990_length_305_cov_1.674757	53	133	10	15	80	0.1875000
NODE_161990_length_305_cov_1.674757	53	133	12	29	80	0.3625000
NODE_161990_length_305_cov_1.674757	53	133	14	4	80	0.0500000
NODE_161990_length_305_cov_1.674757	53	133	16	3	80	0.0375000
NODE_161990_length_305_cov_1.674757	53	133	18	6	80	0.0750000
NODE_161996_length_305_cov_1.655340	110	179	4	18	69	0.2608696
NODE_161996_length_305_cov_1.655340	110	179	6	51	69	0.7391304
NODE_162123_length_305_cov_1.466019	153	238	43	6	85	0.0705882
NODE_162123_length_305_cov_1.466019	153	238	61	1	85	0.0117647
NODE_162123_length_305_cov_1.466019	153	238	63	1	85	0.0117647
NODE_162123_length_305_cov_1.466019	153	238	64	3	85	0.0352941
NODE_162123_length_305_cov_1.466019	153	238	66	6	85	0.0705882
NODE_162123_length_305_cov_1.466019	153	238	68	23	85	0.2705882
NODE_162123_length_305_cov_1.466019	153	238	69	1	85	0.0117647
NODE_162123_length_305_cov_1.466019	153	238	70	19	85	0.2235294
NODE_162123_length_305_cov_1.466019	153	238	72	6	85	0.0705882
NODE_162123_length_305_cov_1.466019	153	238	74	1	85	0.0117647
NODE_162123_length_305_cov_1.466019	153	238	76	2	85	0.0235294
NODE_162123_length_305_cov_1.466019	153	238	92	2	85	0.0235294
NODE_162123_length_305_cov_1.466019	153	238	94	5	85	0.0588235
NODE_162123_length_305_cov_1.466019	153	238	95	1	85	0.0117647
NODE_162123_length_305_cov_1.466019	153	238	96	8	85	0.0941176
NODE_162123_length_305_cov_1.466019	222	284	68	12	62	0.1935484
NODE_162123_length_305_cov_1.466019	222	284	70	6	62	0.0967742
NODE_162123_length_305_cov_1.466019	222	284	72	1	62	0.0161290
NODE_162123_length_305_cov_1.466019	222	284	79	1	62	0.0161290
NODE_162123_length_305_cov_1.466019	222	284	80	1	62	0.0161290
NODE_162123_length_305_cov_1.466019	222	284	82	2	62	0.0322581
NODE_162123_length_305_cov_1.466019	222	284	86	12	62	0.1935484
NODE_162123_length_305_cov_1.466019	222	284	88	1	62	0.0161290
NODE_162123_length_305_cov_1.466019	222	284	90	2	62	0.0322581
NODE_162123_length_305_cov_1.466019	222	284	92	6	62	0.0967742
NODE_162123_length_305_cov_1.466019	222	284	94	7	62	0.1129032
NODE_162123_length_305_cov_1.466019	222	284	95	1	62	0.0161290
NODE_162123_length_305_cov_1.466019	222	284	96	10	62	0.1612903
NODE_162169_length_305_cov_1.398058	28	75	0	9	47	0.1914894
NODE_162169_length_305_cov_1.398058	28	75	2	31	47	0.6595744
NODE_162169_length_305_cov_1.398058	28	75	4	7	47	0.1489362
NODE_162198_length_305_cov_1.330097	212	292	5	1	80	0.0125000
NODE_162198_length_305_cov_1.330097	212	292	6	2	80	0.0250000
NODE_162198_length_305_cov_1.330097	212	292	8	3	80	0.0375000
NODE_162198_length_305_cov_1.330097	212	292	11	4	80	0.0500000
NODE_162198_length_305_cov_1.330097	212	292	13	2	80	0.0250000
NODE_162198_length_305_cov_1.330097	212	292	15	3	80	0.0375000
NODE_162198_length_305_cov_1.330097	212	292	19	1	80	0.0125000
NODE_162198_length_305_cov_1.330097	212	292	23	1	80	0.0125000
NODE_162198_length_305_cov_1.330097	212	292	25	2	80	0.0250000
NODE_162198_length_305_cov_1.330097	212	292	27	4	80	0.0500000
NODE_162198_length_305_cov_1.330097	212	292	29	1	80	0.0125000
NODE_162198_length_305_cov_1.330097	212	292	33	3	80	0.0375000
NODE_162198_length_305_cov_1.330097	212	292	35	1	80	0.0125000
NODE_162198_length_305_cov_1.330097	212	292	38	1	80	0.0125000
NODE_162198_length_305_cov_1.330097	212	292	40	15	80	0.1875000
NODE_162198_length_305_cov_1.330097	212	292	42	2	80	0.0250000
NODE_162198_length_305_cov_1.330097	212	292	46	1	80	0.0125000
NODE_162198_length_305_cov_1.330097	212	292	48	1	80	0.0125000
NODE_162198_length_305_cov_1.330097	212	292	54	1	80	0.0125000
NODE_162198_length_305_cov_1.330097	212	292	58	6	80	0.0750000
NODE_162198_length_305_cov_1.330097	212	292	62	1	80	0.0125000
NODE_162198_length_305_cov_1.330097	212	292	66	7	80	0.0875000
NODE_162198_length_305_cov_1.330097	212	292	68	11	80	0.1375000
NODE_162198_length_305_cov_1.330097	212	292	70	1	80	0.0125000
NODE_162198_length_305_cov_1.330097	212	292	72	5	80	0.0625000
NODE_162198_length_305_cov_1.330097	265	305	1	9	40	0.2250000
NODE_162198_length_305_cov_1.330097	265	305	3	1	40	0.0250000
NODE_162198_length_305_cov_1.330097	265	305	5	4	40	0.1000000
NODE_162198_length_305_cov_1.330097	265	305	6	2	40	0.0500000
NODE_162198_length_305_cov_1.330097	265	305	8	3	40	0.0750000
NODE_162198_length_305_cov_1.330097	265	305	11	4	40	0.1000000
NODE_162198_length_305_cov_1.330097	265	305	13	2	40	0.0500000
NODE_162198_length_305_cov_1.330097	265	305	15	3	40	0.0750000
NODE_162198_length_305_cov_1.330097	265	305	19	1	40	0.0250000
NODE_162198_length_305_cov_1.330097	265	305	23	1	40	0.0250000
NODE_162198_length_305_cov_1.330097	265	305	25	2	40	0.0500000
NODE_162198_length_305_cov_1.330097	265	305	27	4	40	0.1000000
NODE_162198_length_305_cov_1.330097	265	305	29	1	40	0.0250000
NODE_162198_length_305_cov_1.330097	265	305	33	3	40	0.0750000
NODE_162359_length_305_cov_1.111650	245	275	0	30	30	1.0000000
NODE_162411_length_305_cov_0.990291	46	126	0	80	80	1.0000000
NODE_162593_length_305_cov_0.873786	73	109	0	36	36	1.0000000
NODE_162782_length_305_cov_0.631068	86	166	0	80	80	1.0000000
NODE_162782_length_305_cov_0.631068	139	186	0	47	47	1.0000000
NODE_162854_length_304_cov_44.482927	61	102	139	2	41	0.0487805
NODE_162854_length_304_cov_44.482927	61	102	143	2	41	0.0487805
NODE_162854_length_304_cov_44.482927	61	102	149	1	41	0.0243902
NODE_162854_length_304_cov_44.482927	61	102	151	5	41	0.1219512
NODE_162854_length_304_cov_44.482927	61	102	153	5	41	0.1219512
NODE_162854_length_304_cov_44.482927	61	102	155	3	41	0.0731707
NODE_162854_length_304_cov_44.482927	61	102	157	2	41	0.0487805
NODE_162854_length_304_cov_44.482927	61	102	159	4	41	0.0975610
NODE_162854_length_304_cov_44.482927	61	102	161	9	41	0.2195122
NODE_162854_length_304_cov_44.482927	61	102	163	1	41	0.0243902
NODE_162854_length_304_cov_44.482927	61	102	164	3	41	0.0731707
NODE_162854_length_304_cov_44.482927	61	102	165	4	41	0.0975610
NODE_162855_length_304_cov_30.678049	205	281	0	76	76	1.0000000
NODE_162855_length_304_cov_30.678049	254	304	0	50	50	1.0000000
NODE_162886_length_304_cov_4.956098	72	152	2	4	80	0.0500000
NODE_162886_length_304_cov_4.956098	72	152	4	4	80	0.0500000
NODE_162886_length_304_cov_4.956098	72	152	6	72	80	0.9000000
NODE_162919_length_304_cov_3.980488	46	126	0	80	80	1.0000000
NODE_162919_length_304_cov_3.980488	99	179	0	80	80	1.0000000
NODE_162932_length_304_cov_3.809756	108	156	0	2	48	0.0416667
NODE_162932_length_304_cov_3.809756	108	156	2	19	48	0.3958333
NODE_162932_length_304_cov_3.809756	108	156	4	27	48	0.5625000
NODE_162955_length_304_cov_3.424390	67	129	0	62	62	1.0000000
NODE_162955_length_304_cov_3.424390	120	182	0	62	62	1.0000000
NODE_162997_length_304_cov_2.980488	105	126	0	15	21	0.7142857
NODE_162997_length_304_cov_2.980488	105	126	2	6	21	0.2857143
NODE_163048_length_304_cov_2.629268	106	186	10	1	80	0.0125000
NODE_163048_length_304_cov_2.629268	106	186	12	2	80	0.0250000
NODE_163048_length_304_cov_2.629268	106	186	15	12	80	0.1500000
NODE_163048_length_304_cov_2.629268	106	186	16	39	80	0.4875000
NODE_163048_length_304_cov_2.629268	106	186	18	2	80	0.0250000
NODE_163048_length_304_cov_2.629268	106	186	20	24	80	0.3000000
NODE_163048_length_304_cov_2.629268	159	209	2	1	50	0.0200000
NODE_163048_length_304_cov_2.629268	159	209	4	12	50	0.2400000
NODE_163048_length_304_cov_2.629268	159	209	6	6	50	0.1200000
NODE_163048_length_304_cov_2.629268	159	209	8	4	50	0.0800000
NODE_163048_length_304_cov_2.629268	159	209	10	1	50	0.0200000
NODE_163048_length_304_cov_2.629268	159	209	15	11	50	0.2200000
NODE_163048_length_304_cov_2.629268	159	209	20	15	50	0.3000000
NODE_163116_length_304_cov_2.239024	57	137	0	5	80	0.0625000
NODE_163116_length_304_cov_2.239024	57	137	4	75	80	0.9375000
NODE_163116_length_304_cov_2.239024	110	152	0	20	42	0.4761905
NODE_163116_length_304_cov_2.239024	110	152	4	22	42	0.5238096
NODE_163148_length_304_cov_2.170732	112	145	0	26	33	0.7878788
NODE_163148_length_304_cov_2.170732	112	145	2	7	33	0.2121212
NODE_163148_length_304_cov_2.170732	146	198	2	46	52	0.8846154
NODE_163148_length_304_cov_2.170732	146	198	4	6	52	0.1153846
NODE_163333_length_304_cov_1.687805	219	288	0	69	69	1.0000000
NODE_163432_length_304_cov_1.492683	190	238	0	19	48	0.3958333
NODE_163432_length_304_cov_1.492683	190	238	2	29	48	0.6041667
NODE_163559_length_304_cov_1.287805	99	165	1	10	66	0.1515152
NODE_163559_length_304_cov_1.287805	99	165	3	18	66	0.2727273
NODE_163559_length_304_cov_1.287805	99	165	4	29	66	0.4393939
NODE_163559_length_304_cov_1.287805	99	165	5	9	66	0.1363636
NODE_163670_length_304_cov_1.175610	0	30	0	30	30	1.0000000
NODE_163895_length_304_cov_0.951220	70	150	10	3	80	0.0375000
NODE_163895_length_304_cov_0.951220	70	150	14	7	80	0.0875000
NODE_163895_length_304_cov_0.951220	70	150	16	1	80	0.0125000
NODE_163895_length_304_cov_0.951220	70	150	17	4	80	0.0500000
NODE_163895_length_304_cov_0.951220	70	150	18	12	80	0.1500000
NODE_163895_length_304_cov_0.951220	70	150	20	30	80	0.3750000
NODE_163895_length_304_cov_0.951220	70	150	22	22	80	0.2750000
NODE_163895_length_304_cov_0.951220	70	150	24	1	80	0.0125000
NODE_164171_length_303_cov_30.843137	46	97	0	51	51	1.0000000
NODE_164194_length_303_cov_5.401961	33	79	0	46	46	1.0000000
NODE_164224_length_303_cov_4.210784	136	205	10	1	69	0.0144928
NODE_164224_length_303_cov_4.210784	136	205	20	3	69	0.0434783
NODE_164224_length_303_cov_4.210784	136	205	22	1	69	0.0144928
NODE_164224_length_303_cov_4.210784	136	205	24	4	69	0.0579710
NODE_164224_length_303_cov_4.210784	136	205	26	3	69	0.0434783
NODE_164224_length_303_cov_4.210784	136	205	28	1	69	0.0144928
NODE_164224_length_303_cov_4.210784	136	205	30	6	69	0.0869565
NODE_164224_length_303_cov_4.210784	136	205	34	3	69	0.0434783
NODE_164224_length_303_cov_4.210784	136	205	36	14	69	0.2028985
NODE_164224_length_303_cov_4.210784	136	205	38	33	69	0.4782609
NODE_164224_length_303_cov_4.210784	178	259	0	50	81	0.6172839
NODE_164224_length_303_cov_4.210784	178	259	2	1	81	0.0123457
NODE_164224_length_303_cov_4.210784	178	259	6	2	81	0.0246914
NODE_164224_length_303_cov_4.210784	178	259	8	1	81	0.0123457
NODE_164224_length_303_cov_4.210784	178	259	10	1	81	0.0123457
NODE_164224_length_303_cov_4.210784	178	259	20	3	81	0.0370370
NODE_164224_length_303_cov_4.210784	178	259	22	1	81	0.0123457
NODE_164224_length_303_cov_4.210784	178	259	24	4	81	0.0493827
NODE_164224_length_303_cov_4.210784	178	259	26	3	81	0.0370370
NODE_164224_length_303_cov_4.210784	178	259	28	1	81	0.0123457
NODE_164224_length_303_cov_4.210784	178	259	30	6	81	0.0740741
NODE_164224_length_303_cov_4.210784	178	259	34	3	81	0.0370370
NODE_164224_length_303_cov_4.210784	178	259	36	5	81	0.0617284
NODE_164251_length_303_cov_3.671569	9	75	1	19	66	0.2878788
NODE_164251_length_303_cov_3.671569	9	75	3	16	66	0.2424242
NODE_164251_length_303_cov_3.671569	9	75	4	31	66	0.4696970
NODE_164251_length_303_cov_3.671569	48	128	4	80	80	1.0000000
NODE_164251_length_303_cov_3.671569	48	128	4	80	80	1.0000000
NODE_164251_length_303_cov_3.671569	220	300	0	4	80	0.0500000
NODE_164251_length_303_cov_3.671569	220	300	2	76	80	0.9500000
NODE_164267_length_303_cov_3.500000	55	123	0	1	68	0.0147059
NODE_164267_length_303_cov_3.500000	55	123	2	29	68	0.4264706
NODE_164267_length_303_cov_3.500000	55	123	4	2	68	0.0294118
NODE_164267_length_303_cov_3.500000	55	123	6	4	68	0.0588235
NODE_164267_length_303_cov_3.500000	55	123	8	32	68	0.4705882
NODE_164272_length_303_cov_3.460784	0	67	0	29	67	0.4328358
NODE_164272_length_303_cov_3.460784	0	67	2	1	67	0.0149254
NODE_164272_length_303_cov_3.460784	0	67	4	2	67	0.0298507
NODE_164272_length_303_cov_3.460784	0	67	6	5	67	0.0746269
NODE_164272_length_303_cov_3.460784	0	67	10	1	67	0.0149254
NODE_164272_length_303_cov_3.460784	0	67	12	1	67	0.0149254
NODE_164272_length_303_cov_3.460784	0	67	17	8	67	0.1194030
NODE_164272_length_303_cov_3.460784	0	67	19	1	67	0.0149254
NODE_164272_length_303_cov_3.460784	0	67	21	3	67	0.0447761
NODE_164272_length_303_cov_3.460784	0	67	23	1	67	0.0149254
NODE_164272_length_303_cov_3.460784	0	67	25	2	67	0.0298507
NODE_164272_length_303_cov_3.460784	0	67	27	2	67	0.0298507
NODE_164272_length_303_cov_3.460784	0	67	31	1	67	0.0149254
NODE_164272_length_303_cov_3.460784	0	67	33	1	67	0.0149254
NODE_164272_length_303_cov_3.460784	0	67	35	3	67	0.0447761
NODE_164272_length_303_cov_3.460784	0	67	41	1	67	0.0149254
NODE_164272_length_303_cov_3.460784	0	67	45	2	67	0.0298507
NODE_164272_length_303_cov_3.460784	0	67	47	3	67	0.0447761
NODE_164272_length_303_cov_3.460784	98	178	224	1	80	0.0125000
NODE_164272_length_303_cov_3.460784	98	178	235	1	80	0.0125000
NODE_164272_length_303_cov_3.460784	98	178	248	1	80	0.0125000
NODE_164272_length_303_cov_3.460784	98	178	264	1	80	0.0125000
NODE_164272_length_303_cov_3.460784	98	178	270	1	80	0.0125000
NODE_164272_length_303_cov_3.460784	98	178	280	1	80	0.0125000
NODE_164272_length_303_cov_3.460784	98	178	283	1	80	0.0125000
NODE_164272_length_303_cov_3.460784	98	178	291	1	80	0.0125000
NODE_164272_length_303_cov_3.460784	98	178	296	1	80	0.0125000
NODE_164272_length_303_cov_3.460784	98	178	299	1	80	0.0125000
NODE_164272_length_303_cov_3.460784	98	178	305	1	80	0.0125000
NODE_164272_length_303_cov_3.460784	98	178	311	1	80	0.0125000
NODE_164272_length_303_cov_3.460784	98	178	325	1	80	0.0125000
NODE_164272_length_303_cov_3.460784	98	178	327	1	80	0.0125000
NODE_164272_length_303_cov_3.460784	98	178	333	1	80	0.0125000
NODE_164272_length_303_cov_3.460784	98	178	345	1	80	0.0125000
NODE_164272_length_303_cov_3.460784	98	178	356	1	80	0.0125000
NODE_164272_length_303_cov_3.460784	98	178	380	1	80	0.0125000
NODE_164272_length_303_cov_3.460784	98	178	383	2	80	0.0250000
NODE_164272_length_303_cov_3.460784	98	178	384	1	80	0.0125000
NODE_164272_length_303_cov_3.460784	98	178	385	3	80	0.0375000
NODE_164272_length_303_cov_3.460784	98	178	387	2	80	0.0250000
NODE_164272_length_303_cov_3.460784	98	178	389	1	80	0.0125000
NODE_164272_length_303_cov_3.460784	98	178	391	1	80	0.0125000
NODE_164272_length_303_cov_3.460784	98	178	393	1	80	0.0125000
NODE_164272_length_303_cov_3.460784	98	178	394	1	80	0.0125000
NODE_164272_length_303_cov_3.460784	98	178	399	2	80	0.0250000
NODE_164272_length_303_cov_3.460784	98	178	401	1	80	0.0125000
NODE_164272_length_303_cov_3.460784	98	178	410	2	80	0.0250000
NODE_164272_length_303_cov_3.460784	98	178	414	1	80	0.0125000
NODE_164272_length_303_cov_3.460784	98	178	422	1	80	0.0125000
NODE_164272_length_303_cov_3.460784	98	178	429	1	80	0.0125000
NODE_164272_length_303_cov_3.460784	98	178	433	1	80	0.0125000
NODE_164272_length_303_cov_3.460784	98	178	437	1	80	0.0125000
NODE_164272_length_303_cov_3.460784	98	178	447	1	80	0.0125000
NODE_164272_length_303_cov_3.460784	98	178	451	1	80	0.0125000
NODE_164272_length_303_cov_3.460784	98	178	456	1	80	0.0125000
NODE_164272_length_303_cov_3.460784	98	178	465	1	80	0.0125000
NODE_164272_length_303_cov_3.460784	98	178	467	1	80	0.0125000
NODE_164272_length_303_cov_3.460784	98	178	468	2	80	0.0250000
NODE_164272_length_303_cov_3.460784	98	178	469	1	80	0.0125000
NODE_164272_length_303_cov_3.460784	98	178	471	2	80	0.0250000
NODE_164272_length_303_cov_3.460784	98	178	484	1	80	0.0125000
NODE_164272_length_303_cov_3.460784	98	178	485	1	80	0.0125000
NODE_164272_length_303_cov_3.460784	98	178	486	1	80	0.0125000
NODE_164272_length_303_cov_3.460784	98	178	487	1	80	0.0125000
NODE_164272_length_303_cov_3.460784	98	178	489	1	80	0.0125000
NODE_164272_length_303_cov_3.460784	98	178	491	1	80	0.0125000
NODE_164272_length_303_cov_3.460784	98	178	495	1	80	0.0125000
NODE_164272_length_303_cov_3.460784	98	178	499	1	80	0.0125000
NODE_164272_length_303_cov_3.460784	98	178	500	4	80	0.0500000
NODE_164272_length_303_cov_3.460784	98	178	501	1	80	0.0125000
NODE_164272_length_303_cov_3.460784	98	178	504	1	80	0.0125000
NODE_164272_length_303_cov_3.460784	98	178	505	3	80	0.0375000
NODE_164272_length_303_cov_3.460784	98	178	506	3	80	0.0375000
NODE_164272_length_303_cov_3.460784	98	178	507	1	80	0.0125000
NODE_164272_length_303_cov_3.460784	98	178	508	1	80	0.0125000
NODE_164272_length_303_cov_3.460784	98	178	512	1	80	0.0125000
NODE_164272_length_303_cov_3.460784	98	178	513	1	80	0.0125000
NODE_164272_length_303_cov_3.460784	98	178	514	1	80	0.0125000
NODE_164272_length_303_cov_3.460784	98	178	524	1	80	0.0125000
NODE_164272_length_303_cov_3.460784	98	178	526	1	80	0.0125000
NODE_164272_length_303_cov_3.460784	98	178	534	1	80	0.0125000
NODE_164272_length_303_cov_3.460784	98	178	546	1	80	0.0125000
NODE_164272_length_303_cov_3.460784	98	178	550	1	80	0.0125000
NODE_164272_length_303_cov_3.460784	151	191	484	1	40	0.0250000
NODE_164272_length_303_cov_3.460784	151	191	485	1	40	0.0250000
NODE_164272_length_303_cov_3.460784	151	191	486	1	40	0.0250000
NODE_164272_length_303_cov_3.460784	151	191	487	1	40	0.0250000
NODE_164272_length_303_cov_3.460784	151	191	491	1	40	0.0250000
NODE_164272_length_303_cov_3.460784	151	191	495	1	40	0.0250000
NODE_164272_length_303_cov_3.460784	151	191	500	3	40	0.0750000
NODE_164272_length_303_cov_3.460784	151	191	501	1	40	0.0250000
NODE_164272_length_303_cov_3.460784	151	191	504	1	40	0.0250000
NODE_164272_length_303_cov_3.460784	151	191	505	3	40	0.0750000
NODE_164272_length_303_cov_3.460784	151	191	506	3	40	0.0750000
NODE_164272_length_303_cov_3.460784	151	191	507	1	40	0.0250000
NODE_164272_length_303_cov_3.460784	151	191	508	1	40	0.0250000
NODE_164272_length_303_cov_3.460784	151	191	512	1	40	0.0250000
NODE_164272_length_303_cov_3.460784	151	191	513	1	40	0.0250000
NODE_164272_length_303_cov_3.460784	151	191	514	1	40	0.0250000
NODE_164272_length_303_cov_3.460784	151	191	524	1	40	0.0250000
NODE_164272_length_303_cov_3.460784	151	191	526	1	40	0.0250000
NODE_164272_length_303_cov_3.460784	151	191	534	1	40	0.0250000
NODE_164272_length_303_cov_3.460784	151	191	546	1	40	0.0250000
NODE_164272_length_303_cov_3.460784	151	191	548	3	40	0.0750000
NODE_164272_length_303_cov_3.460784	151	191	550	3	40	0.0750000
NODE_164272_length_303_cov_3.460784	151	191	554	1	40	0.0250000
NODE_164272_length_303_cov_3.460784	151	191	556	1	40	0.0250000
NODE_164272_length_303_cov_3.460784	151	191	558	2	40	0.0500000
NODE_164272_length_303_cov_3.460784	151	191	562	1	40	0.0250000
NODE_164272_length_303_cov_3.460784	151	191	564	2	40	0.0500000
NODE_164272_length_303_cov_3.460784	151	191	565	1	40	0.0250000
NODE_164283_length_303_cov_3.352941	77	146	0	69	69	1.0000000
NODE_164433_length_303_cov_2.284314	78	158	0	80	80	1.0000000
NODE_164433_length_303_cov_2.284314	215	295	0	13	80	0.1625000
NODE_164433_length_303_cov_2.284314	215	295	2	3	80	0.0375000
NODE_164433_length_303_cov_2.284314	215	295	4	3	80	0.0375000
NODE_164433_length_303_cov_2.284314	215	295	6	4	80	0.0500000
NODE_164433_length_303_cov_2.284314	215	295	10	57	80	0.7125000
NODE_164581_length_303_cov_1.848039	90	170	0	80	80	1.0000000
NODE_164581_length_303_cov_1.848039	143	223	0	80	80	1.0000000
NODE_164581_length_303_cov_1.848039	212	235	0	23	23	1.0000000
NODE_164668_length_303_cov_1.686275	62	88	0	26	26	1.0000000
NODE_164695_length_303_cov_1.583333	206	270	0	64	64	1.0000000
NODE_164800_length_303_cov_1.475490	155	221	0	66	66	1.0000000
NODE_164846_length_303_cov_1.392157	135	213	11	3	78	0.0384615
NODE_164846_length_303_cov_1.392157	135	213	13	46	78	0.5897436
NODE_164846_length_303_cov_1.392157	135	213	14	29	78	0.3717949
NODE_164878_length_303_cov_1.318627	0	75	0	75	75	1.0000000
NODE_164974_length_303_cov_1.215686	278	297	0	19	19	1.0000000
NODE_165498_length_302_cov_10.852217	266	300	0	7	34	0.2058824
NODE_165498_length_302_cov_10.852217	266	300	4	27	34	0.7941176
NODE_165502_length_302_cov_7.896552	46	131	0	85	85	1.0000000
NODE_165502_length_302_cov_7.896552	104	160	0	56	56	1.0000000
NODE_165505_length_302_cov_7.266010	135	191	0	56	56	1.0000000
NODE_165507_length_302_cov_7.216749	93	149	0	55	56	0.9821429
NODE_165507_length_302_cov_7.216749	93	149	4	1	56	0.0178571
NODE_165507_length_302_cov_7.216749	155	226	0	71	71	1.0000000
NODE_165517_length_302_cov_6.172414	179	243	0	64	64	1.0000000
NODE_165517_length_302_cov_6.172414	232	287	0	55	55	1.0000000
NODE_165528_length_302_cov_5.586207	221	293	2	5	72	0.0694444
NODE_165528_length_302_cov_5.586207	221	293	4	35	72	0.4861111
NODE_165528_length_302_cov_5.586207	221	293	6	3	72	0.0416667
NODE_165528_length_302_cov_5.586207	221	293	8	6	72	0.0833333
NODE_165528_length_302_cov_5.586207	221	293	9	2	72	0.0277778
NODE_165528_length_302_cov_5.586207	221	293	11	1	72	0.0138889
NODE_165528_length_302_cov_5.586207	221	293	13	12	72	0.1666667
NODE_165528_length_302_cov_5.586207	221	293	14	4	72	0.0555556
NODE_165528_length_302_cov_5.586207	221	293	16	1	72	0.0138889
NODE_165528_length_302_cov_5.586207	221	293	18	3	72	0.0416667
NODE_165641_length_302_cov_2.985222	104	186	2	1	82	0.0121951
NODE_165641_length_302_cov_2.985222	104	186	4	8	82	0.0975610
NODE_165641_length_302_cov_2.985222	104	186	6	13	82	0.1585366
NODE_165641_length_302_cov_2.985222	104	186	10	5	82	0.0609756
NODE_165641_length_302_cov_2.985222	104	186	12	55	82	0.6707317
NODE_165848_length_302_cov_2.009852	12	34	0	22	22	1.0000000
NODE_165934_length_302_cov_1.758621	98	152	6	21	54	0.3888889
NODE_165934_length_302_cov_1.758621	98	152	7	33	54	0.6111111
NODE_165945_length_302_cov_1.758621	230	294	0	64	64	1.0000000
NODE_166007_length_302_cov_1.620690	172	232	4	10	60	0.1666667
NODE_166007_length_302_cov_1.620690	172	232	5	7	60	0.1166667
NODE_166007_length_302_cov_1.620690	172	232	7	1	60	0.0166667
NODE_166007_length_302_cov_1.620690	172	232	8	31	60	0.5166667
NODE_166007_length_302_cov_1.620690	172	232	10	7	60	0.1166667
NODE_166007_length_302_cov_1.620690	172	232	12	4	60	0.0666667
NODE_166007_length_302_cov_1.620690	225	277	0	7	52	0.1346154
NODE_166007_length_302_cov_1.620690	225	277	4	45	52	0.8653846
NODE_166320_length_302_cov_1.172414	34	103	0	69	69	1.0000000
NODE_166381_length_302_cov_1.044335	54	130	0	28	76	0.3684210
NODE_166381_length_302_cov_1.044335	54	130	2	6	76	0.0789474
NODE_166381_length_302_cov_1.044335	54	130	4	42	76	0.5526316
NODE_166617_length_302_cov_0.847291	94	172	0	78	78	1.0000000
NODE_166617_length_302_cov_0.847291	94	172	0	78	78	1.0000000
NODE_166617_length_302_cov_0.847291	103	172	0	69	69	1.0000000
NODE_166638_length_302_cov_0.807882	97	177	0	80	80	1.0000000
NODE_166819_length_301_cov_6.960396	268	299	0	31	31	1.0000000
NODE_166827_length_301_cov_6.148515	214	283	0	69	69	1.0000000
NODE_166889_length_301_cov_3.747525	116	196	4	44	80	0.5500000
NODE_166889_length_301_cov_3.747525	116	196	5	9	80	0.1125000
NODE_166889_length_301_cov_3.747525	116	196	7	1	80	0.0125000
NODE_166889_length_301_cov_3.747525	116	196	9	26	80	0.3250000
NODE_166904_length_301_cov_3.509901	217	277	8	1	60	0.0166667
NODE_166904_length_301_cov_3.509901	217	277	10	3	60	0.0500000
NODE_166904_length_301_cov_3.509901	217	277	13	6	60	0.1000000
NODE_166904_length_301_cov_3.509901	217	277	17	1	60	0.0166667
NODE_166904_length_301_cov_3.509901	217	277	18	2	60	0.0333333
NODE_166904_length_301_cov_3.509901	217	277	21	3	60	0.0500000
NODE_166904_length_301_cov_3.509901	217	277	25	4	60	0.0666667
NODE_166904_length_301_cov_3.509901	217	277	35	1	60	0.0166667
NODE_166904_length_301_cov_3.509901	217	277	37	2	60	0.0333333
NODE_166904_length_301_cov_3.509901	217	277	40	2	60	0.0333333
NODE_166904_length_301_cov_3.509901	217	277	41	5	60	0.0833333
NODE_166904_length_301_cov_3.509901	217	277	44	1	60	0.0166667
NODE_166904_length_301_cov_3.509901	217	277	49	1	60	0.0166667
NODE_166904_length_301_cov_3.509901	217	277	51	3	60	0.0500000
NODE_166904_length_301_cov_3.509901	217	277	55	3	60	0.0500000
NODE_166904_length_301_cov_3.509901	217	277	56	2	60	0.0333333
NODE_166904_length_301_cov_3.509901	217	277	57	3	60	0.0500000
NODE_166904_length_301_cov_3.509901	217	277	59	2	60	0.0333333
NODE_166904_length_301_cov_3.509901	217	277	65	2	60	0.0333333
NODE_166904_length_301_cov_3.509901	217	277	71	3	60	0.0500000
NODE_166904_length_301_cov_3.509901	217	277	77	3	60	0.0500000
NODE_166904_length_301_cov_3.509901	217	277	79	2	60	0.0333333
NODE_166904_length_301_cov_3.509901	217	277	86	1	60	0.0166667
NODE_166904_length_301_cov_3.509901	217	277	88	1	60	0.0166667
NODE_166904_length_301_cov_3.509901	217	277	94	1	60	0.0166667
NODE_166904_length_301_cov_3.509901	217	277	95	2	60	0.0333333
NODE_166993_length_301_cov_2.653465	133	213	0	80	80	1.0000000
NODE_167126_length_301_cov_2.084158	178	258	8	1	80	0.0125000
NODE_167126_length_301_cov_2.084158	178	258	12	3	80	0.0375000
NODE_167126_length_301_cov_2.084158	178	258	14	1	80	0.0125000
NODE_167126_length_301_cov_2.084158	178	258	16	1	80	0.0125000
NODE_167126_length_301_cov_2.084158	178	258	18	3	80	0.0375000
NODE_167126_length_301_cov_2.084158	178	258	20	1	80	0.0125000
NODE_167126_length_301_cov_2.084158	178	258	22	2	80	0.0250000
NODE_167126_length_301_cov_2.084158	178	258	27	1	80	0.0125000
NODE_167126_length_301_cov_2.084158	178	258	28	1	80	0.0125000
NODE_167126_length_301_cov_2.084158	178	258	30	1	80	0.0125000
NODE_167126_length_301_cov_2.084158	178	258	34	3	80	0.0375000
NODE_167126_length_301_cov_2.084158	178	258	36	2	80	0.0250000
NODE_167126_length_301_cov_2.084158	178	258	38	14	80	0.1750000
NODE_167126_length_301_cov_2.084158	178	258	40	22	80	0.2750000
NODE_167126_length_301_cov_2.084158	178	258	44	6	80	0.0750000
NODE_167126_length_301_cov_2.084158	178	258	46	18	80	0.2250000
NODE_167215_length_301_cov_1.831683	111	175	0	64	64	1.0000000
NODE_167215_length_301_cov_1.831683	164	228	0	64	64	1.0000000
NODE_167308_length_301_cov_1.603960	173	233	2	60	60	1.0000000
NODE_167313_length_301_cov_1.584158	30	108	2	78	78	1.0000000
NODE_167434_length_301_cov_1.470297	90	165	0	75	75	1.0000000
NODE_167508_length_301_cov_1.326733	175	247	2	1	72	0.0138889
NODE_167508_length_301_cov_1.326733	175	247	3	71	72	0.9861111
NODE_167612_length_301_cov_1.247525	29	73	0	44	44	1.0000000
NODE_167642_length_301_cov_1.183168	123	203	0	13	80	0.1625000
NODE_167642_length_301_cov_1.183168	123	203	2	1	80	0.0125000
NODE_167642_length_301_cov_1.183168	123	203	4	22	80	0.2750000
NODE_167642_length_301_cov_1.183168	123	203	6	1	80	0.0125000
NODE_167642_length_301_cov_1.183168	123	203	10	1	80	0.0125000
NODE_167642_length_301_cov_1.183168	123	203	12	2	80	0.0250000
NODE_167642_length_301_cov_1.183168	123	203	14	6	80	0.0750000
NODE_167642_length_301_cov_1.183168	123	203	16	8	80	0.1000000
NODE_167642_length_301_cov_1.183168	123	203	18	26	80	0.3250000
NODE_167659_length_301_cov_1.163366	10	83	0	73	73	1.0000000
NODE_167659_length_301_cov_1.163366	91	121	0	30	30	1.0000000
NODE_167668_length_301_cov_1.148515	161	209	2	48	48	1.0000000
NODE_167880_length_301_cov_0.980198	242	297	0	55	55	1.0000000
NODE_167891_length_301_cov_0.960396	22	63	0	41	41	1.0000000
NODE_168253_length_300_cov_3.402985	44	124	2	24	80	0.3000000
NODE_168253_length_300_cov_3.402985	44	124	4	3	80	0.0375000
NODE_168253_length_300_cov_3.402985	44	124	5	1	80	0.0125000
NODE_168253_length_300_cov_3.402985	44	124	6	52	80	0.6500000
NODE_168253_length_300_cov_3.402985	97	177	0	44	80	0.5500000
NODE_168253_length_300_cov_3.402985	97	177	2	33	80	0.4125000
NODE_168253_length_300_cov_3.402985	97	177	5	1	80	0.0125000
NODE_168253_length_300_cov_3.402985	97	177	6	2	80	0.0250000
NODE_168253_length_300_cov_3.402985	173	254	0	81	81	1.0000000
NODE_168253_length_300_cov_3.402985	233	300	0	67	67	1.0000000
NODE_168265_length_300_cov_3.298507	18	98	2	37	80	0.4625000
NODE_168265_length_300_cov_3.298507	18	98	4	43	80	0.5375000
NODE_168360_length_300_cov_2.597015	110	182	6	2	72	0.0277778
NODE_168360_length_300_cov_2.597015	110	182	8	2	72	0.0277778
NODE_168360_length_300_cov_2.597015	110	182	10	8	72	0.1111111
NODE_168360_length_300_cov_2.597015	110	182	12	60	72	0.8333333
NODE_168363_length_300_cov_2.572139	28	102	4	27	74	0.3648649
NODE_168363_length_300_cov_2.572139	28	102	6	17	74	0.2297297
NODE_168363_length_300_cov_2.572139	28	102	8	7	74	0.0945946
NODE_168363_length_300_cov_2.572139	28	102	10	1	74	0.0135135
NODE_168363_length_300_cov_2.572139	28	102	12	3	74	0.0405405
NODE_168363_length_300_cov_2.572139	28	102	14	3	74	0.0405405
NODE_168363_length_300_cov_2.572139	28	102	24	3	74	0.0405405
NODE_168363_length_300_cov_2.572139	28	102	26	2	74	0.0270270
NODE_168363_length_300_cov_2.572139	28	102	28	2	74	0.0270270
NODE_168363_length_300_cov_2.572139	28	102	30	6	74	0.0810811
NODE_168363_length_300_cov_2.572139	28	102	32	3	74	0.0405405
NODE_168363_length_300_cov_2.572139	75	141	8	4	66	0.0606061
NODE_168363_length_300_cov_2.572139	75	141	10	1	66	0.0151515
NODE_168363_length_300_cov_2.572139	75	141	12	3	66	0.0454545
NODE_168363_length_300_cov_2.572139	75	141	14	3	66	0.0454545
NODE_168363_length_300_cov_2.572139	75	141	24	3	66	0.0454545
NODE_168363_length_300_cov_2.572139	75	141	26	2	66	0.0303030
NODE_168363_length_300_cov_2.572139	75	141	28	2	66	0.0303030
NODE_168363_length_300_cov_2.572139	75	141	30	29	66	0.4393939
NODE_168363_length_300_cov_2.572139	75	141	32	19	66	0.2878788
NODE_168402_length_300_cov_2.417910	0	44	0	3	44	0.0681818
NODE_168402_length_300_cov_2.417910	0	44	4	41	44	0.9318182
NODE_168459_length_300_cov_2.174129	117	197	0	6	80	0.0750000
NODE_168459_length_300_cov_2.174129	117	197	2	17	80	0.2125000
NODE_168459_length_300_cov_2.174129	117	197	4	51	80	0.6375000
NODE_168459_length_300_cov_2.174129	117	197	6	6	80	0.0750000
NODE_168459_length_300_cov_2.174129	170	250	4	37	80	0.4625000
NODE_168459_length_300_cov_2.174129	170	250	6	4	80	0.0500000
NODE_168459_length_300_cov_2.174129	170	250	8	2	80	0.0250000
NODE_168459_length_300_cov_2.174129	170	250	18	1	80	0.0125000
NODE_168459_length_300_cov_2.174129	170	250	22	1	80	0.0125000
NODE_168459_length_300_cov_2.174129	170	250	34	1	80	0.0125000
NODE_168459_length_300_cov_2.174129	170	250	39	1	80	0.0125000
NODE_168459_length_300_cov_2.174129	170	250	40	2	80	0.0250000
NODE_168459_length_300_cov_2.174129	170	250	46	1	80	0.0125000
NODE_168459_length_300_cov_2.174129	170	250	52	1	80	0.0125000
NODE_168459_length_300_cov_2.174129	170	250	56	1	80	0.0125000
NODE_168459_length_300_cov_2.174129	170	250	58	1	80	0.0125000
NODE_168459_length_300_cov_2.174129	170	250	60	1	80	0.0125000
NODE_168459_length_300_cov_2.174129	170	250	64	1	80	0.0125000
NODE_168459_length_300_cov_2.174129	170	250	70	4	80	0.0500000
NODE_168459_length_300_cov_2.174129	170	250	72	18	80	0.2250000
NODE_168459_length_300_cov_2.174129	170	250	74	3	80	0.0375000
NODE_168459_length_300_cov_2.174129	216	296	39	1	80	0.0125000
NODE_168459_length_300_cov_2.174129	216	296	40	2	80	0.0250000
NODE_168459_length_300_cov_2.174129	216	296	41	1	80	0.0125000
NODE_168459_length_300_cov_2.174129	216	296	46	1	80	0.0125000
NODE_168459_length_300_cov_2.174129	216	296	51	1	80	0.0125000
NODE_168459_length_300_cov_2.174129	216	296	52	1	80	0.0125000
NODE_168459_length_300_cov_2.174129	216	296	56	1	80	0.0125000
NODE_168459_length_300_cov_2.174129	216	296	57	3	80	0.0375000
NODE_168459_length_300_cov_2.174129	216	296	58	1	80	0.0125000
NODE_168459_length_300_cov_2.174129	216	296	59	2	80	0.0250000
NODE_168459_length_300_cov_2.174129	216	296	60	1	80	0.0125000
NODE_168459_length_300_cov_2.174129	216	296	63	2	80	0.0250000
NODE_168459_length_300_cov_2.174129	216	296	64	1	80	0.0125000
NODE_168459_length_300_cov_2.174129	216	296	65	1	80	0.0125000
NODE_168459_length_300_cov_2.174129	216	296	67	6	80	0.0750000
NODE_168459_length_300_cov_2.174129	216	296	69	13	80	0.1625000
NODE_168459_length_300_cov_2.174129	216	296	70	4	80	0.0500000
NODE_168459_length_300_cov_2.174129	216	296	71	11	80	0.1375000
NODE_168459_length_300_cov_2.174129	216	296	72	24	80	0.3000000
NODE_168459_length_300_cov_2.174129	216	296	74	3	80	0.0375000
NODE_168462_length_300_cov_2.164179	122	141	2	19	19	1.0000000
NODE_168479_length_300_cov_2.079602	127	207	0	80	80	1.0000000
NODE_168479_length_300_cov_2.079602	203	273	0	70	70	1.0000000
NODE_168541_length_300_cov_1.965174	15	86	0	71	71	1.0000000
NODE_168656_length_300_cov_1.731343	31	88	18	1	57	0.0175439
NODE_168656_length_300_cov_1.731343	31	88	20	2	57	0.0350877
NODE_168656_length_300_cov_1.731343	31	88	21	1	57	0.0175439
NODE_168656_length_300_cov_1.731343	31	88	26	1	57	0.0175439
NODE_168656_length_300_cov_1.731343	31	88	30	52	57	0.9122807
NODE_168906_length_300_cov_1.268657	62	98	0	36	36	1.0000000
NODE_168906_length_300_cov_1.268657	151	186	0	35	35	1.0000000
NODE_169014_length_300_cov_1.104478	86	165	6	4	79	0.0506329
NODE_169014_length_300_cov_1.104478	86	165	8	6	79	0.0759494
NODE_169014_length_300_cov_1.104478	86	165	10	69	79	0.8734177
NODE_169053_length_300_cov_1.029851	110	177	0	67	67	1.0000000
NODE_169053_length_300_cov_1.029851	120	177	0	57	57	1.0000000
NODE_169378_length_300_cov_0.716418	191	210	0	19	19	1.0000000
NODE_169528_length_299_cov_4.435000	48	128	8	2	80	0.0250000
NODE_169528_length_299_cov_4.435000	48	128	12	14	80	0.1750000
NODE_169528_length_299_cov_4.435000	48	128	14	10	80	0.1250000
NODE_169528_length_299_cov_4.435000	48	128	15	39	80	0.4875000
NODE_169528_length_299_cov_4.435000	48	128	16	7	80	0.0875000
NODE_169528_length_299_cov_4.435000	48	128	18	8	80	0.1000000
NODE_169528_length_299_cov_4.435000	101	167	4	18	66	0.2727273
NODE_169528_length_299_cov_4.435000	101	167	6	17	66	0.2575758
NODE_169528_length_299_cov_4.435000	101	167	8	6	66	0.0909091
NODE_169528_length_299_cov_4.435000	101	167	12	14	66	0.2121212
NODE_169528_length_299_cov_4.435000	101	167	16	3	66	0.0454545
NODE_169528_length_299_cov_4.435000	101	167	18	8	66	0.1212121
NODE_169567_length_299_cov_3.780000	114	181	0	67	67	1.0000000
NODE_169631_length_299_cov_3.095000	0	73	0	73	73	1.0000000
NODE_169631_length_299_cov_3.095000	0	20	0	20	20	1.0000000
NODE_169725_length_299_cov_2.495000	46	126	2	52	80	0.6500000
NODE_169725_length_299_cov_2.495000	46	126	4	28	80	0.3500000
NODE_169725_length_299_cov_2.495000	99	179	2	54	80	0.6750000
NODE_169725_length_299_cov_2.495000	99	179	4	26	80	0.3250000
NODE_169769_length_299_cov_2.275000	127	192	0	64	65	0.9846154
NODE_169769_length_299_cov_2.275000	127	192	2	1	65	0.0153846
NODE_169781_length_299_cov_2.250000	72	135	2	12	63	0.1904762
NODE_169781_length_299_cov_2.250000	72	135	4	20	63	0.3174603
NODE_169781_length_299_cov_2.250000	72	135	6	31	63	0.4920635
NODE_169781_length_299_cov_2.250000	108	188	4	73	80	0.9125000
NODE_169781_length_299_cov_2.250000	108	188	6	7	80	0.0875000
NODE_169811_length_299_cov_2.090000	25	105	0	50	80	0.6250000
NODE_169811_length_299_cov_2.090000	25	105	3	30	80	0.3750000
NODE_169888_length_299_cov_1.955000	173	214	20	4	41	0.0975610
NODE_169888_length_299_cov_1.955000	173	214	24	2	41	0.0487805
NODE_169888_length_299_cov_1.955000	173	214	26	4	41	0.0975610
NODE_169888_length_299_cov_1.955000	173	214	28	3	41	0.0731707
NODE_169888_length_299_cov_1.955000	173	214	30	6	41	0.1463415
NODE_169888_length_299_cov_1.955000	173	214	32	1	41	0.0243902
NODE_169888_length_299_cov_1.955000	173	214	34	1	41	0.0243902
NODE_169888_length_299_cov_1.955000	173	214	36	6	41	0.1463415
NODE_169888_length_299_cov_1.955000	173	214	38	1	41	0.0243902
NODE_169888_length_299_cov_1.955000	173	214	44	6	41	0.1463415
NODE_169888_length_299_cov_1.955000	173	214	48	1	41	0.0243902
NODE_169888_length_299_cov_1.955000	173	214	54	4	41	0.0975610
NODE_169888_length_299_cov_1.955000	173	214	56	2	41	0.0487805
NODE_169888_length_299_cov_1.955000	187	227	30	5	40	0.1250000
NODE_169888_length_299_cov_1.955000	187	227	32	1	40	0.0250000
NODE_169888_length_299_cov_1.955000	187	227	34	1	40	0.0250000
NODE_169888_length_299_cov_1.955000	187	227	36	6	40	0.1500000
NODE_169888_length_299_cov_1.955000	187	227	38	1	40	0.0250000
NODE_169888_length_299_cov_1.955000	187	227	44	6	40	0.1500000
NODE_169888_length_299_cov_1.955000	187	227	48	1	40	0.0250000
NODE_169888_length_299_cov_1.955000	187	227	54	4	40	0.1000000
NODE_169888_length_299_cov_1.955000	187	227	56	3	40	0.0750000
NODE_169888_length_299_cov_1.955000	187	227	58	4	40	0.1000000
NODE_169888_length_299_cov_1.955000	187	227	60	3	40	0.0750000
NODE_169888_length_299_cov_1.955000	187	227	62	5	40	0.1250000
NODE_169916_length_299_cov_1.885000	29	109	4	12	80	0.1500000
NODE_169916_length_299_cov_1.885000	29	109	8	53	80	0.6625000
NODE_169916_length_299_cov_1.885000	29	109	10	15	80	0.1875000
NODE_169920_length_299_cov_1.880000	204	236	0	32	32	1.0000000
NODE_169938_length_299_cov_1.840000	154	190	0	36	36	1.0000000
NODE_169995_length_299_cov_1.710000	211	291	0	80	80	1.0000000
NODE_170048_length_299_cov_1.550000	174	205	8	31	31	1.0000000
NODE_170501_length_299_cov_1.020000	42	115	2	73	73	1.0000000
NODE_170546_length_299_cov_1.020000	132	175	2	43	43	1.0000000
NODE_170620_length_299_cov_0.935000	173	216	6	10	43	0.2325581
NODE_170620_length_299_cov_0.935000	173	216	8	33	43	0.7674419
NODE_170691_length_299_cov_0.765000	86	128	0	42	42	1.0000000
NODE_170887_length_298_cov_20.894472	70	150	0	80	80	1.0000000
NODE_170887_length_298_cov_20.894472	123	203	0	80	80	1.0000000
NODE_170888_length_298_cov_13.859296	228	298	8	14	70	0.2000000
NODE_170888_length_298_cov_13.859296	228	298	10	1	70	0.0142857
NODE_170888_length_298_cov_13.859296	228	298	12	4	70	0.0571429
NODE_170888_length_298_cov_13.859296	228	298	14	7	70	0.1000000
NODE_170888_length_298_cov_13.859296	228	298	18	1	70	0.0142857
NODE_170888_length_298_cov_13.859296	228	298	20	1	70	0.0142857
NODE_170888_length_298_cov_13.859296	228	298	23	1	70	0.0142857
NODE_170888_length_298_cov_13.859296	228	298	28	1	70	0.0142857
NODE_170888_length_298_cov_13.859296	228	298	30	3	70	0.0428571
NODE_170888_length_298_cov_13.859296	228	298	32	3	70	0.0428571
NODE_170888_length_298_cov_13.859296	228	298	38	2	70	0.0285714
NODE_170888_length_298_cov_13.859296	228	298	42	10	70	0.1428571
NODE_170888_length_298_cov_13.859296	228	298	48	9	70	0.1285714
NODE_170888_length_298_cov_13.859296	228	298	52	13	70	0.1857143
NODE_170909_length_298_cov_5.859296	1	65	0	11	64	0.1718750
NODE_170909_length_298_cov_5.859296	1	65	2	2	64	0.0312500
NODE_170909_length_298_cov_5.859296	1	65	4	1	64	0.0156250
NODE_170909_length_298_cov_5.859296	1	65	8	3	64	0.0468750
NODE_170909_length_298_cov_5.859296	1	65	10	6	64	0.0937500
NODE_170909_length_298_cov_5.859296	1	65	12	29	64	0.4531250
NODE_170909_length_298_cov_5.859296	1	65	16	12	64	0.1875000
NODE_170909_length_298_cov_5.859296	38	118	10	4	80	0.0500000
NODE_170909_length_298_cov_5.859296	38	118	12	22	80	0.2750000
NODE_170909_length_298_cov_5.859296	38	118	14	16	80	0.2000000
NODE_170909_length_298_cov_5.859296	38	118	16	15	80	0.1875000
NODE_170909_length_298_cov_5.859296	38	118	18	23	80	0.2875000
NODE_170909_length_298_cov_5.859296	114	194	0	31	80	0.3875000
NODE_170909_length_298_cov_5.859296	114	194	2	16	80	0.2000000
NODE_170909_length_298_cov_5.859296	114	194	6	16	80	0.2000000
NODE_170909_length_298_cov_5.859296	114	194	8	13	80	0.1625000
NODE_170909_length_298_cov_5.859296	114	194	10	4	80	0.0500000
NODE_170909_length_298_cov_5.859296	167	238	2	13	71	0.1830986
NODE_170909_length_298_cov_5.859296	167	238	6	1	71	0.0140845
NODE_170909_length_298_cov_5.859296	167	238	8	57	71	0.8028169
NODE_170964_length_298_cov_3.829146	80	160	69	2	80	0.0250000
NODE_170964_length_298_cov_3.829146	80	160	71	3	80	0.0375000
NODE_170964_length_298_cov_3.829146	80	160	73	1	80	0.0125000
NODE_170964_length_298_cov_3.829146	80	160	74	6	80	0.0750000
NODE_170964_length_298_cov_3.829146	80	160	75	4	80	0.0500000
NODE_170964_length_298_cov_3.829146	80	160	77	2	80	0.0250000
NODE_170964_length_298_cov_3.829146	80	160	78	4	80	0.0500000
NODE_170964_length_298_cov_3.829146	80	160	79	1	80	0.0125000
NODE_170964_length_298_cov_3.829146	80	160	81	6	80	0.0750000
NODE_170964_length_298_cov_3.829146	80	160	83	9	80	0.1125000
NODE_170964_length_298_cov_3.829146	80	160	85	7	80	0.0875000
NODE_170964_length_298_cov_3.829146	80	160	86	1	80	0.0125000
NODE_170964_length_298_cov_3.829146	80	160	87	3	80	0.0375000
NODE_170964_length_298_cov_3.829146	80	160	89	14	80	0.1750000
NODE_170964_length_298_cov_3.829146	80	160	90	1	80	0.0125000
NODE_170964_length_298_cov_3.829146	80	160	91	4	80	0.0500000
NODE_170964_length_298_cov_3.829146	80	160	93	12	80	0.1500000
NODE_170964_length_298_cov_3.829146	133	213	46	5	80	0.0625000
NODE_170964_length_298_cov_3.829146	133	213	50	3	80	0.0375000
NODE_170964_length_298_cov_3.829146	133	213	52	4	80	0.0500000
NODE_170964_length_298_cov_3.829146	133	213	58	1	80	0.0125000
NODE_170964_length_298_cov_3.829146	133	213	60	6	80	0.0750000
NODE_170964_length_298_cov_3.829146	133	213	62	4	80	0.0500000
NODE_170964_length_298_cov_3.829146	133	213	63	1	80	0.0125000
NODE_170964_length_298_cov_3.829146	133	213	65	3	80	0.0375000
NODE_170964_length_298_cov_3.829146	133	213	69	1	80	0.0125000
NODE_170964_length_298_cov_3.829146	133	213	73	2	80	0.0250000
NODE_170964_length_298_cov_3.829146	133	213	75	3	80	0.0375000
NODE_170964_length_298_cov_3.829146	133	213	77	4	80	0.0500000
NODE_170964_length_298_cov_3.829146	133	213	78	4	80	0.0500000
NODE_170964_length_298_cov_3.829146	133	213	79	2	80	0.0250000
NODE_170964_length_298_cov_3.829146	133	213	81	4	80	0.0500000
NODE_170964_length_298_cov_3.829146	133	213	82	5	80	0.0625000
NODE_170964_length_298_cov_3.829146	133	213	83	8	80	0.1000000
NODE_170964_length_298_cov_3.829146	133	213	84	4	80	0.0500000
NODE_170964_length_298_cov_3.829146	133	213	85	5	80	0.0625000
NODE_170964_length_298_cov_3.829146	133	213	86	2	80	0.0250000
NODE_170964_length_298_cov_3.829146	133	213	87	2	80	0.0250000
NODE_170964_length_298_cov_3.829146	133	213	88	1	80	0.0125000
NODE_170964_length_298_cov_3.829146	133	213	89	5	80	0.0625000
NODE_170964_length_298_cov_3.829146	133	213	90	1	80	0.0125000
NODE_170968_length_298_cov_3.733668	203	283	2	80	80	1.0000000
NODE_170972_length_298_cov_3.673367	117	175	0	42	58	0.7241379
NODE_170972_length_298_cov_3.673367	117	175	2	16	58	0.2758621
NODE_171043_length_298_cov_2.924623	159	239	8	35	80	0.4375000
NODE_171043_length_298_cov_2.924623	159	239	10	13	80	0.1625000
NODE_171043_length_298_cov_2.924623	159	239	12	7	80	0.0875000
NODE_171043_length_298_cov_2.924623	159	239	14	17	80	0.2125000
NODE_171043_length_298_cov_2.924623	159	239	16	3	80	0.0375000
NODE_171043_length_298_cov_2.924623	159	239	18	4	80	0.0500000
NODE_171043_length_298_cov_2.924623	159	239	24	1	80	0.0125000
NODE_171043_length_298_cov_2.924623	212	265	4	3	53	0.0566038
NODE_171043_length_298_cov_2.924623	212	265	6	12	53	0.2264151
NODE_171043_length_298_cov_2.924623	212	265	8	38	53	0.7169811
NODE_171047_length_298_cov_2.854271	50	120	0	70	70	1.0000000
NODE_171082_length_298_cov_2.663317	87	167	0	34	80	0.4250000
NODE_171082_length_298_cov_2.663317	87	167	2	11	80	0.1375000
NODE_171082_length_298_cov_2.663317	87	167	4	7	80	0.0875000
NODE_171082_length_298_cov_2.663317	87	167	6	24	80	0.3000000
NODE_171082_length_298_cov_2.663317	87	167	8	4	80	0.0500000
NODE_171082_length_298_cov_2.663317	140	192	0	52	52	1.0000000
NODE_171191_length_298_cov_2.201005	112	166	0	54	54	1.0000000
NODE_171210_length_298_cov_2.120603	135	166	0	31	31	1.0000000
NODE_171226_length_298_cov_2.055276	69	132	0	63	63	1.0000000
NODE_171286_length_298_cov_2.025126	21	92	0	71	71	1.0000000
NODE_171356_length_298_cov_1.798995	0	67	2	64	67	0.9552239
NODE_171356_length_298_cov_1.798995	0	67	5	3	67	0.0447761
NODE_171356_length_298_cov_1.798995	40	106	2	24	66	0.3636364
NODE_171356_length_298_cov_1.798995	40	106	5	9	66	0.1363636
NODE_171356_length_298_cov_1.798995	40	106	6	1	66	0.0151515
NODE_171356_length_298_cov_1.798995	40	106	7	14	66	0.2121212
NODE_171356_length_298_cov_1.798995	40	106	9	18	66	0.2727273
NODE_171391_length_298_cov_1.788945	140	197	0	13	57	0.2280702
NODE_171391_length_298_cov_1.788945	140	197	2	21	57	0.3684210
NODE_171391_length_298_cov_1.788945	140	197	4	23	57	0.4035088
NODE_171415_length_298_cov_1.733668	56	91	20	2	35	0.0571429
NODE_171415_length_298_cov_1.733668	56	91	26	1	35	0.0285714
NODE_171415_length_298_cov_1.733668	56	91	28	6	35	0.1714286
NODE_171415_length_298_cov_1.733668	56	91	30	3	35	0.0857143
NODE_171415_length_298_cov_1.733668	56	91	32	20	35	0.5714286
NODE_171415_length_298_cov_1.733668	56	91	34	2	35	0.0571429
NODE_171415_length_298_cov_1.733668	56	91	36	1	35	0.0285714
NODE_171415_length_298_cov_1.733668	118	172	4	7	54	0.1296296
NODE_171415_length_298_cov_1.733668	118	172	10	1	54	0.0185185
NODE_171415_length_298_cov_1.733668	118	172	11	3	54	0.0555556
NODE_171415_length_298_cov_1.733668	118	172	13	5	54	0.0925926
NODE_171415_length_298_cov_1.733668	118	172	17	5	54	0.0925926
NODE_171415_length_298_cov_1.733668	118	172	18	12	54	0.2222222
NODE_171415_length_298_cov_1.733668	118	172	20	21	54	0.3888889
NODE_171505_length_298_cov_1.537688	101	154	0	53	53	1.0000000
NODE_172083_length_298_cov_0.829146	34	96	0	62	62	1.0000000
NODE_172330_length_297_cov_6.525253	100	122	0	22	22	1.0000000
NODE_172352_length_297_cov_4.888889	150	218	4	1	68	0.0147059
NODE_172352_length_297_cov_4.888889	150	218	6	16	68	0.2352941
NODE_172352_length_297_cov_4.888889	150	218	8	46	68	0.6764706
NODE_172352_length_297_cov_4.888889	150	218	10	5	68	0.0735294
NODE_172356_length_297_cov_4.671717	56	120	0	64	64	1.0000000
NODE_172422_length_297_cov_3.338384	96	176	0	78	80	0.9750000
NODE_172422_length_297_cov_3.338384	96	176	2	2	80	0.0250000
NODE_172422_length_297_cov_3.338384	149	198	0	49	49	1.0000000
NODE_172447_length_297_cov_3.040404	0	55	0	55	55	1.0000000
NODE_172447_length_297_cov_3.040404	14	55	0	41	41	1.0000000
NODE_172447_length_297_cov_3.040404	65	119	0	54	54	1.0000000
NODE_172574_length_297_cov_2.308081	8	70	0	1	62	0.0161290
NODE_172574_length_297_cov_2.308081	8	70	2	19	62	0.3064516
NODE_172574_length_297_cov_2.308081	8	70	4	42	62	0.6774194
NODE_172606_length_297_cov_2.196970	219	259	73	1	40	0.0250000
NODE_172606_length_297_cov_2.196970	219	259	76	1	40	0.0250000
NODE_172606_length_297_cov_2.196970	219	259	81	1	40	0.0250000
NODE_172606_length_297_cov_2.196970	219	259	83	3	40	0.0750000
NODE_172606_length_297_cov_2.196970	219	259	87	1	40	0.0250000
NODE_172606_length_297_cov_2.196970	219	259	99	1	40	0.0250000
NODE_172606_length_297_cov_2.196970	219	259	107	1	40	0.0250000
NODE_172606_length_297_cov_2.196970	219	259	115	2	40	0.0500000
NODE_172606_length_297_cov_2.196970	219	259	117	1	40	0.0250000
NODE_172606_length_297_cov_2.196970	219	259	125	1	40	0.0250000
NODE_172606_length_297_cov_2.196970	219	259	126	4	40	0.1000000
NODE_172606_length_297_cov_2.196970	219	259	132	1	40	0.0250000
NODE_172606_length_297_cov_2.196970	219	259	134	2	40	0.0500000
NODE_172606_length_297_cov_2.196970	219	259	136	2	40	0.0500000
NODE_172606_length_297_cov_2.196970	219	259	140	2	40	0.0500000
NODE_172606_length_297_cov_2.196970	219	259	146	1	40	0.0250000
NODE_172606_length_297_cov_2.196970	219	259	147	4	40	0.1000000
NODE_172606_length_297_cov_2.196970	219	259	153	6	40	0.1500000
NODE_172606_length_297_cov_2.196970	219	259	157	1	40	0.0250000
NODE_172606_length_297_cov_2.196970	219	259	158	2	40	0.0500000
NODE_172606_length_297_cov_2.196970	219	259	160	2	40	0.0500000
NODE_172629_length_297_cov_2.106061	81	161	0	43	80	0.5375000
NODE_172629_length_297_cov_2.106061	81	161	2	30	80	0.3750000
NODE_172629_length_297_cov_2.106061	81	161	4	7	80	0.0875000
NODE_172629_length_297_cov_2.106061	134	178	2	20	44	0.4545455
NODE_172629_length_297_cov_2.106061	134	178	4	24	44	0.5454546
NODE_172668_length_297_cov_2.060606	46	76	0	30	30	1.0000000
NODE_172697_length_297_cov_2.010101	9	85	0	4	76	0.0526316
NODE_172697_length_297_cov_2.010101	9	85	2	2	76	0.0263158
NODE_172697_length_297_cov_2.010101	9	85	6	68	76	0.8947368
NODE_172697_length_297_cov_2.010101	9	85	8	2	76	0.0263158
NODE_172783_length_297_cov_1.777778	168	208	8	12	40	0.3000000
NODE_172783_length_297_cov_1.777778	168	208	10	22	40	0.5500000
NODE_172783_length_297_cov_1.777778	168	208	14	6	40	0.1500000
NODE_172855_length_297_cov_1.595960	175	255	2	2	80	0.0250000
NODE_172855_length_297_cov_1.595960	175	255	4	12	80	0.1500000
NODE_172855_length_297_cov_1.595960	175	255	8	14	80	0.1750000
NODE_172855_length_297_cov_1.595960	175	255	12	7	80	0.0875000
NODE_172855_length_297_cov_1.595960	175	255	14	10	80	0.1250000
NODE_172855_length_297_cov_1.595960	175	255	16	8	80	0.1000000
NODE_172855_length_297_cov_1.595960	175	255	18	3	80	0.0375000
NODE_172855_length_297_cov_1.595960	175	255	20	3	80	0.0375000
NODE_172855_length_297_cov_1.595960	175	255	24	11	80	0.1375000
NODE_172855_length_297_cov_1.595960	175	255	26	10	80	0.1250000
NODE_172862_length_297_cov_1.570707	100	177	0	77	77	1.0000000
NODE_172863_length_297_cov_1.570707	194	275	0	13	81	0.1604938
NODE_172863_length_297_cov_1.570707	194	275	2	25	81	0.3086420
NODE_172863_length_297_cov_1.570707	194	275	4	43	81	0.5308642
NODE_173063_length_297_cov_1.338384	140	199	0	59	59	1.0000000
NODE_173136_length_297_cov_1.277778	39	115	0	76	76	1.0000000
NODE_173176_length_297_cov_1.196970	7	87	0	80	80	1.0000000
NODE_173176_length_297_cov_1.196970	60	116	0	56	56	1.0000000
NODE_173345_length_297_cov_1.030303	0	33	0	33	33	1.0000000
NODE_173467_length_297_cov_0.888889	109	172	0	63	63	1.0000000
NODE_173520_length_297_cov_0.782828	24	104	0	6	80	0.0750000
NODE_173520_length_297_cov_0.782828	24	104	2	74	80	0.9250000
NODE_173708_length_296_cov_41.390863	189	260	2	71	71	1.0000000
NODE_173709_length_296_cov_34.776650	214	294	0	80	80	1.0000000
NODE_173758_length_296_cov_4.243655	14	54	0	21	40	0.5250000
NODE_173758_length_296_cov_4.243655	14	54	2	19	40	0.4750000
NODE_173773_length_296_cov_3.954315	120	200	0	80	80	1.0000000
NODE_173787_length_296_cov_3.736041	6	46	0	17	40	0.4250000
NODE_173787_length_296_cov_3.736041	6	46	2	14	40	0.3500000
NODE_173787_length_296_cov_3.736041	6	46	6	9	40	0.2250000
NODE_173797_length_296_cov_3.619289	193	251	0	8	58	0.1379310
NODE_173797_length_296_cov_3.619289	193	251	2	2	58	0.0344828
NODE_173797_length_296_cov_3.619289	193	251	3	2	58	0.0344828
NODE_173797_length_296_cov_3.619289	193	251	4	46	58	0.7931035
NODE_173797_length_296_cov_3.619289	246	296	0	50	50	1.0000000
NODE_173859_length_296_cov_3.015228	177	257	0	80	80	1.0000000
NODE_173992_length_296_cov_2.309645	5	77	12	2	72	0.0277778
NODE_173992_length_296_cov_2.309645	5	77	13	4	72	0.0555556
NODE_173992_length_296_cov_2.309645	5	77	15	1	72	0.0138889
NODE_173992_length_296_cov_2.309645	5	77	17	1	72	0.0138889
NODE_173992_length_296_cov_2.309645	5	77	21	4	72	0.0555556
NODE_173992_length_296_cov_2.309645	5	77	22	8	72	0.1111111
NODE_173992_length_296_cov_2.309645	5	77	24	11	72	0.1527778
NODE_173992_length_296_cov_2.309645	5	77	26	9	72	0.1250000
NODE_173992_length_296_cov_2.309645	5	77	28	1	72	0.0138889
NODE_173992_length_296_cov_2.309645	5	77	30	9	72	0.1250000
NODE_173992_length_296_cov_2.309645	5	77	32	4	72	0.0555556
NODE_173992_length_296_cov_2.309645	5	77	36	14	72	0.1944444
NODE_173992_length_296_cov_2.309645	5	77	38	4	72	0.0555556
NODE_173992_length_296_cov_2.309645	50	130	30	5	80	0.0625000
NODE_173992_length_296_cov_2.309645	50	130	32	4	80	0.0500000
NODE_173992_length_296_cov_2.309645	50	130	36	14	80	0.1750000
NODE_173992_length_296_cov_2.309645	50	130	38	10	80	0.1250000
NODE_173992_length_296_cov_2.309645	50	130	42	10	80	0.1250000
NODE_173992_length_296_cov_2.309645	50	130	44	1	80	0.0125000
NODE_173992_length_296_cov_2.309645	50	130	46	1	80	0.0125000
NODE_173992_length_296_cov_2.309645	50	130	47	12	80	0.1500000
NODE_173992_length_296_cov_2.309645	50	130	49	12	80	0.1500000
NODE_173992_length_296_cov_2.309645	50	130	50	1	80	0.0125000
NODE_173992_length_296_cov_2.309645	50	130	51	9	80	0.1125000
NODE_173992_length_296_cov_2.309645	50	130	53	1	80	0.0125000
NODE_174040_length_296_cov_2.081218	90	139	2	49	49	1.0000000
NODE_174167_length_296_cov_1.807107	199	246	0	47	47	1.0000000
NODE_174167_length_296_cov_1.807107	219	296	0	77	77	1.0000000
NODE_174213_length_296_cov_1.670051	28	103	2	7	75	0.0933333
NODE_174213_length_296_cov_1.670051	28	103	4	50	75	0.6666667
NODE_174213_length_296_cov_1.670051	28	103	6	18	75	0.2400000
NODE_174274_length_296_cov_1.553299	102	179	4	22	77	0.2857143
NODE_174274_length_296_cov_1.553299	102	179	5	55	77	0.7142857
NODE_174274_length_296_cov_1.553299	160	179	4	19	19	1.0000000
NODE_174438_length_296_cov_1.319797	82	162	0	80	80	1.0000000
NODE_174438_length_296_cov_1.319797	135	205	0	70	70	1.0000000
NODE_174545_length_296_cov_1.258883	222	280	0	58	58	1.0000000
NODE_174554_length_296_cov_1.238579	90	147	0	57	57	1.0000000
NODE_174614_length_296_cov_1.116751	130	169	10	15	39	0.3846154
NODE_174614_length_296_cov_1.116751	130	169	14	3	39	0.0769231
NODE_174614_length_296_cov_1.116751	130	169	16	21	39	0.5384616
NODE_175210_length_295_cov_4.290816	2	70	0	68	68	1.0000000
NODE_175210_length_295_cov_4.290816	55	123	0	68	68	1.0000000
NODE_175220_length_295_cov_4.040816	119	165	0	4	46	0.0869565
NODE_175220_length_295_cov_4.040816	119	165	2	22	46	0.4782609
NODE_175220_length_295_cov_4.040816	119	165	4	4	46	0.0869565
NODE_175220_length_295_cov_4.040816	119	165	6	16	46	0.3478261
NODE_175258_length_295_cov_3.576531	130	198	0	68	68	1.0000000
NODE_175324_length_295_cov_2.918367	0	77	0	77	77	1.0000000
NODE_175416_length_295_cov_2.454082	216	277	6	54	61	0.8852459
NODE_175416_length_295_cov_2.454082	216	277	8	7	61	0.1147541
NODE_175475_length_295_cov_2.224490	11	91	7	4	80	0.0500000
NODE_175475_length_295_cov_2.224490	11	91	8	2	80	0.0250000
NODE_175475_length_295_cov_2.224490	11	91	9	4	80	0.0500000
NODE_175475_length_295_cov_2.224490	11	91	11	22	80	0.2750000
NODE_175475_length_295_cov_2.224490	11	91	12	48	80	0.6000000
NODE_175483_length_295_cov_2.183673	93	151	3	9	58	0.1551724
NODE_175483_length_295_cov_2.183673	93	151	11	3	58	0.0517241
NODE_175483_length_295_cov_2.183673	93	151	15	1	58	0.0172414
NODE_175483_length_295_cov_2.183673	93	151	16	2	58	0.0344828
NODE_175483_length_295_cov_2.183673	93	151	21	5	58	0.0862069
NODE_175483_length_295_cov_2.183673	93	151	25	1	58	0.0172414
NODE_175483_length_295_cov_2.183673	93	151	32	3	58	0.0517241
NODE_175483_length_295_cov_2.183673	93	151	35	6	58	0.1034483
NODE_175483_length_295_cov_2.183673	93	151	36	7	58	0.1206897
NODE_175483_length_295_cov_2.183673	93	151	37	21	58	0.3620690
NODE_175483_length_295_cov_2.183673	124	204	34	6	80	0.0750000
NODE_175483_length_295_cov_2.183673	124	204	35	9	80	0.1125000
NODE_175483_length_295_cov_2.183673	124	204	36	6	80	0.0750000
NODE_175483_length_295_cov_2.183673	124	204	37	59	80	0.7375000
NODE_175597_length_295_cov_1.867347	191	239	8	1	48	0.0208333
NODE_175597_length_295_cov_1.867347	191	239	12	21	48	0.4375000
NODE_175597_length_295_cov_1.867347	191	239	14	26	48	0.5416667
NODE_175598_length_295_cov_1.862245	225	285	0	8	60	0.1333333
NODE_175598_length_295_cov_1.862245	225	285	2	52	60	0.8666667
NODE_175721_length_295_cov_1.596939	173	254	0	81	81	1.0000000
NODE_175804_length_295_cov_1.520408	217	282	0	16	65	0.2461538
NODE_175804_length_295_cov_1.520408	217	282	2	9	65	0.1384615
NODE_175804_length_295_cov_1.520408	217	282	4	40	65	0.6153846
NODE_175930_length_295_cov_1.301020	99	121	0	22	22	1.0000000
NODE_176250_length_295_cov_0.938776	200	247	0	47	47	1.0000000
NODE_176367_length_295_cov_0.780612	24	44	0	20	20	1.0000000
NODE_176436_length_295_cov_0.724490	6	87	0	81	81	1.0000000
NODE_176436_length_295_cov_0.724490	83	163	0	80	80	1.0000000
NODE_176436_length_295_cov_0.724490	136	216	0	80	80	1.0000000
NODE_176547_length_294_cov_83.882051	143	173	0	30	30	1.0000000
NODE_176547_length_294_cov_83.882051	209	239	0	30	30	1.0000000
NODE_176549_length_294_cov_50.589744	187	258	1	17	71	0.2394366
NODE_176549_length_294_cov_50.589744	187	258	3	1	71	0.0140845
NODE_176549_length_294_cov_50.589744	187	258	5	15	71	0.2112676
NODE_176549_length_294_cov_50.589744	187	258	6	2	71	0.0281690
NODE_176549_length_294_cov_50.589744	187	258	7	36	71	0.5070422
NODE_176561_length_294_cov_6.676923	61	138	0	77	77	1.0000000
NODE_176596_length_294_cov_4.538462	127	214	6	13	87	0.1494253
NODE_176596_length_294_cov_4.538462	127	214	10	38	87	0.4367816
NODE_176596_length_294_cov_4.538462	127	214	12	36	87	0.4137931
NODE_176598_length_294_cov_4.512821	218	248	0	30	30	1.0000000
NODE_176600_length_294_cov_4.497436	159	200	0	41	41	1.0000000
NODE_176697_length_294_cov_2.953846	114	194	4	22	80	0.2750000
NODE_176697_length_294_cov_2.953846	114	194	6	54	80	0.6750000
NODE_176697_length_294_cov_2.953846	114	194	8	4	80	0.0500000
NODE_176727_length_294_cov_2.764103	103	183	0	80	80	1.0000000
NODE_176727_length_294_cov_2.764103	156	236	0	40	80	0.5000000
NODE_176727_length_294_cov_2.764103	156	236	2	40	80	0.5000000
NODE_176728_length_294_cov_2.764103	224	282	6	52	58	0.8965517
NODE_176728_length_294_cov_2.764103	224	282	7	2	58	0.0344828
NODE_176728_length_294_cov_2.764103	224	282	11	1	58	0.0172414
NODE_176728_length_294_cov_2.764103	224	282	12	2	58	0.0344828
NODE_176728_length_294_cov_2.764103	224	282	14	1	58	0.0172414
NODE_176728_length_294_cov_2.764103	225	277	6	47	52	0.9038461
NODE_176728_length_294_cov_2.764103	225	277	7	2	52	0.0384615
NODE_176728_length_294_cov_2.764103	225	277	11	1	52	0.0192308
NODE_176728_length_294_cov_2.764103	225	277	12	2	52	0.0384615
NODE_176735_length_294_cov_2.697436	204	261	2	57	57	1.0000000
NODE_176735_length_294_cov_2.697436	234	294	0	4	60	0.0666667
NODE_176735_length_294_cov_2.697436	234	294	2	56	60	0.9333333
NODE_176779_length_294_cov_2.517949	23	85	2	62	62	1.0000000
NODE_176816_length_294_cov_2.353846	129	167	14	26	38	0.6842105
NODE_176816_length_294_cov_2.353846	129	167	16	4	38	0.1052632
NODE_176816_length_294_cov_2.353846	129	167	18	8	38	0.2105263
NODE_176833_length_294_cov_2.338462	133	213	2	3	80	0.0375000
NODE_176833_length_294_cov_2.338462	133	213	4	35	80	0.4375000
NODE_176833_length_294_cov_2.338462	133	213	6	21	80	0.2625000
NODE_176833_length_294_cov_2.338462	133	213	8	21	80	0.2625000
NODE_176943_length_294_cov_2.046154	219	269	0	50	50	1.0000000
NODE_176957_length_294_cov_2.010256	191	235	0	44	44	1.0000000
NODE_176999_length_294_cov_1.902564	52	83	0	29	31	0.9354839
NODE_176999_length_294_cov_1.902564	52	83	2	2	31	0.0645161
NODE_177102_length_294_cov_1.692308	46	112	0	51	66	0.7727273
NODE_177102_length_294_cov_1.692308	46	112	2	15	66	0.2272727
NODE_177187_length_294_cov_1.569231	49	95	0	46	46	1.0000000
NODE_177252_length_294_cov_1.482051	28	108	2	5	80	0.0625000
NODE_177252_length_294_cov_1.482051	28	108	4	75	80	0.9375000
NODE_177252_length_294_cov_1.482051	201	281	2	28	80	0.3500000
NODE_177252_length_294_cov_1.482051	201	281	4	1	80	0.0125000
NODE_177252_length_294_cov_1.482051	201	281	6	51	80	0.6375000
NODE_177252_length_294_cov_1.482051	201	281	2	28	80	0.3500000
NODE_177252_length_294_cov_1.482051	201	281	4	1	80	0.0125000
NODE_177252_length_294_cov_1.482051	201	281	6	51	80	0.6375000
NODE_177298_length_294_cov_1.420513	216	262	0	46	46	1.0000000
NODE_177298_length_294_cov_1.420513	235	294	0	59	59	1.0000000
NODE_177972_length_294_cov_0.666667	245	293	0	48	48	1.0000000
NODE_178066_length_293_cov_6.257732	167	247	0	20	80	0.2500000
NODE_178066_length_293_cov_6.257732	167	247	2	60	80	0.7500000
NODE_178161_length_293_cov_3.567010	50	130	6	5	80	0.0625000
NODE_178161_length_293_cov_3.567010	50	130	8	18	80	0.2250000
NODE_178161_length_293_cov_3.567010	50	130	10	3	80	0.0375000
NODE_178161_length_293_cov_3.567010	50	130	12	49	80	0.6125000
NODE_178161_length_293_cov_3.567010	50	130	14	5	80	0.0625000
NODE_178226_length_293_cov_2.907216	218	281	2	63	63	1.0000000
NODE_178246_length_293_cov_2.768041	95	175	0	80	80	1.0000000
NODE_178246_length_293_cov_2.768041	148	228	0	80	80	1.0000000
NODE_178268_length_293_cov_2.628866	207	266	0	13	59	0.2203390
NODE_178268_length_293_cov_2.628866	207	266	2	35	59	0.5932204
NODE_178268_length_293_cov_2.628866	207	266	4	11	59	0.1864407
NODE_178277_length_293_cov_2.623711	182	223	6	18	41	0.4390244
NODE_178277_length_293_cov_2.623711	182	223	8	9	41	0.2195122
NODE_178277_length_293_cov_2.623711	182	223	10	14	41	0.3414634
NODE_178299_length_293_cov_2.561856	139	192	0	41	53	0.7735849
NODE_178299_length_293_cov_2.561856	139	192	2	3	53	0.0566038
NODE_178299_length_293_cov_2.561856	139	192	4	9	53	0.1698113
NODE_178299_length_293_cov_2.561856	177	223	0	3	46	0.0652174
NODE_178299_length_293_cov_2.561856	177	223	2	3	46	0.0652174
NODE_178299_length_293_cov_2.561856	177	223	4	40	46	0.8695652
NODE_178317_length_293_cov_2.448454	98	158	0	60	60	1.0000000
NODE_178351_length_293_cov_2.335052	62	91	0	16	29	0.5517241
NODE_178351_length_293_cov_2.335052	62	91	1	13	29	0.4482759
NODE_178357_length_293_cov_2.314433	35	89	0	21	54	0.3888889
NODE_178357_length_293_cov_2.314433	35	89	1	3	54	0.0555556
NODE_178357_length_293_cov_2.314433	35	89	3	30	54	0.5555556
NODE_178523_length_293_cov_1.840206	27	107	0	17	80	0.2125000
NODE_178523_length_293_cov_1.840206	27	107	2	63	80	0.7875000
NODE_178523_length_293_cov_1.840206	80	160	0	70	80	0.8750000
NODE_178523_length_293_cov_1.840206	80	160	2	10	80	0.1250000
NODE_178560_length_293_cov_1.804124	144	173	12	10	29	0.3448276
NODE_178560_length_293_cov_1.804124	144	173	16	2	29	0.0689655
NODE_178560_length_293_cov_1.804124	144	173	18	17	29	0.5862069
NODE_178570_length_293_cov_1.778351	224	258	0	34	34	1.0000000
NODE_178646_length_293_cov_1.577320	158	177	0	19	19	1.0000000
NODE_178692_length_293_cov_1.577320	161	225	0	64	64	1.0000000
NODE_178693_length_293_cov_1.577320	15	55	0	38	40	0.9500000
NODE_178693_length_293_cov_1.577320	15	55	2	2	40	0.0500000
NODE_178788_length_293_cov_1.402062	3	72	0	69	69	1.0000000
NODE_178822_length_293_cov_1.319588	202	268	0	66	66	1.0000000
NODE_178927_length_293_cov_1.226804	84	141	0	57	57	1.0000000
NODE_179542_length_292_cov_4.523316	240	290	0	50	50	1.0000000
NODE_179552_length_292_cov_4.145078	106	186	0	80	80	1.0000000
NODE_179604_length_292_cov_3.502591	129	205	0	8	76	0.1052632
NODE_179604_length_292_cov_3.502591	129	205	6	3	76	0.0394737
NODE_179604_length_292_cov_3.502591	129	205	10	3	76	0.0394737
NODE_179604_length_292_cov_3.502591	129	205	12	13	76	0.1710526
NODE_179604_length_292_cov_3.502591	129	205	16	3	76	0.0394737
NODE_179604_length_292_cov_3.502591	129	205	20	10	76	0.1315790
NODE_179604_length_292_cov_3.502591	129	205	23	7	76	0.0921053
NODE_179604_length_292_cov_3.502591	129	205	24	29	76	0.3815790
NODE_179613_length_292_cov_3.435233	176	200	3	6	24	0.2500000
NODE_179613_length_292_cov_3.435233	176	200	6	18	24	0.7500000
NODE_179621_length_292_cov_3.341969	70	150	2	56	80	0.7000000
NODE_179621_length_292_cov_3.341969	70	150	6	24	80	0.3000000
NODE_179621_length_292_cov_3.341969	118	175	0	18	57	0.3157895
NODE_179621_length_292_cov_3.341969	118	175	2	39	57	0.6842105
NODE_179627_length_292_cov_3.222798	47	127	0	80	80	1.0000000
NODE_179627_length_292_cov_3.222798	100	129	0	29	29	1.0000000
NODE_179819_length_292_cov_2.238342	211	290	2	79	79	1.0000000
NODE_179943_length_292_cov_1.865285	34	114	110	7	80	0.0875000
NODE_179943_length_292_cov_1.865285	34	114	118	1	80	0.0125000
NODE_179943_length_292_cov_1.865285	34	114	124	3	80	0.0375000
NODE_179943_length_292_cov_1.865285	34	114	125	1	80	0.0125000
NODE_179943_length_292_cov_1.865285	34	114	129	1	80	0.0125000
NODE_179943_length_292_cov_1.865285	34	114	133	8	80	0.1000000
NODE_179943_length_292_cov_1.865285	34	114	135	2	80	0.0250000
NODE_179943_length_292_cov_1.865285	34	114	137	3	80	0.0375000
NODE_179943_length_292_cov_1.865285	34	114	139	1	80	0.0125000
NODE_179943_length_292_cov_1.865285	34	114	150	2	80	0.0250000
NODE_179943_length_292_cov_1.865285	34	114	151	9	80	0.1125000
NODE_179943_length_292_cov_1.865285	34	114	152	4	80	0.0500000
NODE_179943_length_292_cov_1.865285	34	114	153	5	80	0.0625000
NODE_179943_length_292_cov_1.865285	34	114	154	8	80	0.1000000
NODE_179943_length_292_cov_1.865285	34	114	155	2	80	0.0250000
NODE_179943_length_292_cov_1.865285	34	114	156	15	80	0.1875000
NODE_179943_length_292_cov_1.865285	34	114	157	8	80	0.1000000
NODE_179943_length_292_cov_1.865285	87	167	26	2	80	0.0250000
NODE_179943_length_292_cov_1.865285	87	167	27	2	80	0.0250000
NODE_179943_length_292_cov_1.865285	87	167	28	4	80	0.0500000
NODE_179943_length_292_cov_1.865285	87	167	29	1	80	0.0125000
NODE_179943_length_292_cov_1.865285	87	167	30	2	80	0.0250000
NODE_179943_length_292_cov_1.865285	87	167	31	1	80	0.0125000
NODE_179943_length_292_cov_1.865285	87	167	42	5	80	0.0625000
NODE_179943_length_292_cov_1.865285	87	167	44	6	80	0.0750000
NODE_179943_length_292_cov_1.865285	87	167	46	1	80	0.0125000
NODE_179943_length_292_cov_1.865285	87	167	56	1	80	0.0125000
NODE_179943_length_292_cov_1.865285	87	167	58	1	80	0.0125000
NODE_179943_length_292_cov_1.865285	87	167	71	4	80	0.0500000
NODE_179943_length_292_cov_1.865285	87	167	75	5	80	0.0625000
NODE_179943_length_292_cov_1.865285	87	167	77	7	80	0.0875000
NODE_179943_length_292_cov_1.865285	87	167	81	1	80	0.0125000
NODE_179943_length_292_cov_1.865285	87	167	89	1	80	0.0125000
NODE_179943_length_292_cov_1.865285	87	167	95	2	80	0.0250000
NODE_179943_length_292_cov_1.865285	87	167	99	4	80	0.0500000
NODE_179943_length_292_cov_1.865285	87	167	108	2	80	0.0250000
NODE_179943_length_292_cov_1.865285	87	167	110	7	80	0.0875000
NODE_179943_length_292_cov_1.865285	87	167	112	1	80	0.0125000
NODE_179943_length_292_cov_1.865285	87	167	118	1	80	0.0125000
NODE_179943_length_292_cov_1.865285	87	167	124	3	80	0.0375000
NODE_179943_length_292_cov_1.865285	87	167	125	1	80	0.0125000
NODE_179943_length_292_cov_1.865285	87	167	129	1	80	0.0125000
NODE_179943_length_292_cov_1.865285	87	167	133	8	80	0.1000000
NODE_179943_length_292_cov_1.865285	87	167	135	2	80	0.0250000
NODE_179943_length_292_cov_1.865285	87	167	137	3	80	0.0375000
NODE_179943_length_292_cov_1.865285	87	167	139	1	80	0.0125000
NODE_180013_length_292_cov_1.761658	174	254	0	77	80	0.9625000
NODE_180013_length_292_cov_1.761658	174	254	4	3	80	0.0375000
NODE_180029_length_292_cov_1.699482	0	80	0	52	80	0.6500000
NODE_180029_length_292_cov_1.699482	0	80	2	4	80	0.0500000
NODE_180029_length_292_cov_1.699482	0	80	4	2	80	0.0250000
NODE_180029_length_292_cov_1.699482	0	80	6	9	80	0.1125000
NODE_180029_length_292_cov_1.699482	0	80	8	8	80	0.1000000
NODE_180029_length_292_cov_1.699482	0	80	10	5	80	0.0625000
NODE_180068_length_292_cov_1.611399	89	157	2	68	68	1.0000000
NODE_180210_length_292_cov_1.455959	72	115	20	3	43	0.0697674
NODE_180210_length_292_cov_1.455959	72	115	22	2	43	0.0465116
NODE_180210_length_292_cov_1.455959	72	115	24	38	43	0.8837209
NODE_180210_length_292_cov_1.455959	203	265	2	62	62	1.0000000
NODE_180302_length_292_cov_1.321244	102	182	7	24	80	0.3000000
NODE_180302_length_292_cov_1.321244	102	182	8	14	80	0.1750000
NODE_180302_length_292_cov_1.321244	102	182	9	2	80	0.0250000
NODE_180302_length_292_cov_1.321244	102	182	12	1	80	0.0125000
NODE_180302_length_292_cov_1.321244	102	182	13	10	80	0.1250000
NODE_180302_length_292_cov_1.321244	102	182	14	4	80	0.0500000
NODE_180302_length_292_cov_1.321244	102	182	15	25	80	0.3125000
NODE_180302_length_292_cov_1.321244	155	217	7	59	62	0.9516129
NODE_180302_length_292_cov_1.321244	155	217	8	3	62	0.0483871
NODE_180968_length_291_cov_45.031250	71	145	2	74	74	1.0000000
NODE_180968_length_291_cov_45.031250	71	145	2	74	74	1.0000000
NODE_180968_length_291_cov_45.031250	118	184	2	28	66	0.4242424
NODE_180968_length_291_cov_45.031250	118	184	4	4	66	0.0606061
NODE_180968_length_291_cov_45.031250	118	184	6	16	66	0.2424242
NODE_180968_length_291_cov_45.031250	118	184	8	4	66	0.0606061
NODE_180968_length_291_cov_45.031250	118	184	10	9	66	0.1363636
NODE_180968_length_291_cov_45.031250	118	184	11	3	66	0.0454545
NODE_180968_length_291_cov_45.031250	118	184	12	2	66	0.0303030
NODE_180969_length_291_cov_14.791667	125	205	0	80	80	1.0000000
NODE_180969_length_291_cov_14.791667	178	258	0	80	80	1.0000000
NODE_180983_length_291_cov_5.536458	97	169	0	72	72	1.0000000
NODE_180986_length_291_cov_5.401042	77	130	0	38	53	0.7169811
NODE_180986_length_291_cov_5.401042	77	130	2	15	53	0.2830189
NODE_180998_length_291_cov_4.859375	185	257	2	72	72	1.0000000
NODE_181043_length_291_cov_3.723958	196	276	0	80	80	1.0000000
NODE_181057_length_291_cov_3.531250	129	152	2	23	23	1.0000000
NODE_181191_length_291_cov_2.390625	18	80	0	61	62	0.9838710
NODE_181191_length_291_cov_2.390625	18	80	2	1	62	0.0161290
NODE_181272_length_291_cov_2.125000	70	117	0	47	47	1.0000000
NODE_181391_length_291_cov_1.859375	197	228	6	31	31	1.0000000
NODE_181497_length_291_cov_1.593750	144	175	0	31	31	1.0000000
NODE_181530_length_291_cov_1.593750	206	281	0	75	75	1.0000000
NODE_181599_length_291_cov_1.552083	189	269	2	2	80	0.0250000
NODE_181599_length_291_cov_1.552083	189	269	4	22	80	0.2750000
NODE_181599_length_291_cov_1.552083	189	269	5	11	80	0.1375000
NODE_181599_length_291_cov_1.552083	189	269	6	4	80	0.0500000
NODE_181599_length_291_cov_1.552083	189	269	7	8	80	0.1000000
NODE_181599_length_291_cov_1.552083	189	269	8	33	80	0.4125000
NODE_181615_length_291_cov_1.520833	180	258	0	12	78	0.1538462
NODE_181615_length_291_cov_1.520833	180	258	2	26	78	0.3333333
NODE_181615_length_291_cov_1.520833	180	258	4	40	78	0.5128205
NODE_181623_length_291_cov_1.510417	245	291	0	46	46	1.0000000
NODE_181696_length_291_cov_1.385417	80	120	2	21	40	0.5250000
NODE_181696_length_291_cov_1.385417	80	120	4	19	40	0.4750000
NODE_181791_length_291_cov_1.322917	70	96	0	26	26	1.0000000
NODE_181799_length_291_cov_1.307292	108	188	0	11	80	0.1375000
NODE_181799_length_291_cov_1.307292	108	188	2	10	80	0.1250000
NODE_181799_length_291_cov_1.307292	108	188	3	1	80	0.0125000
NODE_181799_length_291_cov_1.307292	108	188	4	20	80	0.2500000
NODE_181799_length_291_cov_1.307292	108	188	6	12	80	0.1500000
NODE_181799_length_291_cov_1.307292	108	188	8	10	80	0.1250000
NODE_181799_length_291_cov_1.307292	108	188	14	2	80	0.0250000
NODE_181799_length_291_cov_1.307292	108	188	16	14	80	0.1750000
NODE_181907_length_291_cov_1.114583	79	174	28	8	95	0.0842105
NODE_181907_length_291_cov_1.114583	79	174	29	10	95	0.1052632
NODE_181907_length_291_cov_1.114583	79	174	30	5	95	0.0526316
NODE_181907_length_291_cov_1.114583	79	174	31	5	95	0.0526316
NODE_181907_length_291_cov_1.114583	79	174	32	13	95	0.1368421
NODE_181907_length_291_cov_1.114583	79	174	34	24	95	0.2526316
NODE_181907_length_291_cov_1.114583	79	174	35	7	95	0.0736842
NODE_181907_length_291_cov_1.114583	79	174	36	23	95	0.2421053
NODE_181930_length_291_cov_1.078125	4	85	2	4	81	0.0493827
NODE_181930_length_291_cov_1.078125	4	85	4	11	81	0.1358025
NODE_181930_length_291_cov_1.078125	4	85	6	21	81	0.2592593
NODE_181930_length_291_cov_1.078125	4	85	10	2	81	0.0246914
NODE_181930_length_291_cov_1.078125	4	85	11	2	81	0.0246914
NODE_181930_length_291_cov_1.078125	4	85	12	40	81	0.4938272
NODE_181930_length_291_cov_1.078125	4	85	14	1	81	0.0123457
NODE_182112_length_291_cov_1.031250	5	50	0	45	45	1.0000000
NODE_182205_length_291_cov_0.890625	0	55	0	55	55	1.0000000
NODE_182252_length_291_cov_0.802083	80	160	0	9	80	0.1125000
NODE_182252_length_291_cov_0.802083	80	160	2	49	80	0.6125000
NODE_182252_length_291_cov_0.802083	80	160	4	22	80	0.2750000
NODE_182491_length_290_cov_96.963351	44	124	0	80	80	1.0000000
NODE_182491_length_290_cov_96.963351	97	177	0	80	80	1.0000000
NODE_182512_length_290_cov_5.968586	89	150	2	61	61	1.0000000
NODE_182512_length_290_cov_5.968586	142	203	2	15	61	0.2459016
NODE_182512_length_290_cov_5.968586	142	203	8	46	61	0.7540984
NODE_182535_length_290_cov_4.968586	32	52	0	20	20	1.0000000
NODE_182535_length_290_cov_4.968586	73	93	0	20	20	1.0000000
NODE_182547_length_290_cov_4.670157	63	139	0	10	76	0.1315790
NODE_182547_length_290_cov_4.670157	63	139	2	66	76	0.8684211
NODE_182550_length_290_cov_4.575916	110	153	0	43	43	1.0000000
NODE_182589_length_290_cov_3.816754	113	186	0	73	73	1.0000000
NODE_182607_length_290_cov_3.612565	114	181	0	67	67	1.0000000
NODE_182622_length_290_cov_3.445026	91	150	2	59	59	1.0000000
NODE_182772_length_290_cov_2.596859	189	218	2	22	29	0.7586207
NODE_182772_length_290_cov_2.596859	189	218	6	7	29	0.2413793
NODE_182844_length_290_cov_2.319372	45	74	2	29	29	1.0000000
NODE_182973_length_290_cov_2.041885	59	139	0	5	80	0.0625000
NODE_182973_length_290_cov_2.041885	59	139	2	75	80	0.9375000
NODE_182995_length_290_cov_1.979058	229	271	16	4	42	0.0952381
NODE_182995_length_290_cov_1.979058	229	271	20	8	42	0.1904762
NODE_182995_length_290_cov_1.979058	229	271	21	1	42	0.0238095
NODE_182995_length_290_cov_1.979058	229	271	23	1	42	0.0238095
NODE_182995_length_290_cov_1.979058	229	271	24	9	42	0.2142857
NODE_182995_length_290_cov_1.979058	229	271	26	8	42	0.1904762
NODE_182995_length_290_cov_1.979058	229	271	28	4	42	0.0952381
NODE_182995_length_290_cov_1.979058	229	271	30	5	42	0.1190476
NODE_182995_length_290_cov_1.979058	229	271	32	2	42	0.0476190
NODE_183288_length_290_cov_1.602094	16	68	0	52	52	1.0000000
NODE_183347_length_290_cov_1.575916	173	250	0	77	77	1.0000000
NODE_183373_length_290_cov_1.544503	151	203	0	42	52	0.8076923
NODE_183373_length_290_cov_1.544503	151	203	2	10	52	0.1923077
NODE_183403_length_290_cov_1.513089	22	107	0	85	85	1.0000000
NODE_183436_length_290_cov_1.460733	11	91	0	7	80	0.0875000
NODE_183436_length_290_cov_1.460733	11	91	2	73	80	0.9125000
NODE_183546_length_290_cov_1.335079	91	163	2	10	72	0.1388889
NODE_183546_length_290_cov_1.335079	91	163	4	9	72	0.1250000
NODE_183546_length_290_cov_1.335079	91	163	5	18	72	0.2500000
NODE_183546_length_290_cov_1.335079	91	163	6	7	72	0.0972222
NODE_183546_length_290_cov_1.335079	91	163	7	28	72	0.3888889
NODE_183546_length_290_cov_1.335079	144	216	2	10	72	0.1388889
NODE_183546_length_290_cov_1.335079	144	216	4	62	72	0.8611111
NODE_183642_length_290_cov_1.314136	0	80	2	7	80	0.0875000
NODE_183642_length_290_cov_1.314136	0	80	6	63	80	0.7875000
NODE_183642_length_290_cov_1.314136	0	80	8	10	80	0.1250000
NODE_183663_length_290_cov_1.287958	17	97	0	80	80	1.0000000
NODE_183946_length_290_cov_1.068063	0	60	0	60	60	1.0000000
NODE_183946_length_290_cov_1.068063	33	113	0	80	80	1.0000000
NODE_184119_length_290_cov_1.000000	198	254	2	17	56	0.3035714
NODE_184119_length_290_cov_1.000000	198	254	4	39	56	0.6964286
NODE_184326_length_290_cov_0.832461	154	236	0	82	82	1.0000000
NODE_184585_length_290_cov_0.701571	201	281	0	80	80	1.0000000
NODE_184716_length_289_cov_554.947368	45	125	682	1	80	0.0125000
NODE_184716_length_289_cov_554.947368	45	125	696	1	80	0.0125000
NODE_184716_length_289_cov_554.947368	45	125	711	1	80	0.0125000
NODE_184716_length_289_cov_554.947368	45	125	715	1	80	0.0125000
NODE_184716_length_289_cov_554.947368	45	125	731	1	80	0.0125000
NODE_184716_length_289_cov_554.947368	45	125	733	1	80	0.0125000
NODE_184716_length_289_cov_554.947368	45	125	739	1	80	0.0125000
NODE_184716_length_289_cov_554.947368	45	125	745	2	80	0.0250000
NODE_184716_length_289_cov_554.947368	45	125	749	1	80	0.0125000
NODE_184716_length_289_cov_554.947368	45	125	760	1	80	0.0125000
NODE_184716_length_289_cov_554.947368	45	125	765	1	80	0.0125000
NODE_184716_length_289_cov_554.947368	45	125	767	1	80	0.0125000
NODE_184716_length_289_cov_554.947368	45	125	770	1	80	0.0125000
NODE_184716_length_289_cov_554.947368	45	125	772	1	80	0.0125000
NODE_184716_length_289_cov_554.947368	45	125	777	1	80	0.0125000
NODE_184716_length_289_cov_554.947368	45	125	782	4	80	0.0500000
NODE_184716_length_289_cov_554.947368	45	125	784	1	80	0.0125000
NODE_184716_length_289_cov_554.947368	45	125	785	1	80	0.0125000
NODE_184716_length_289_cov_554.947368	45	125	786	2	80	0.0250000
NODE_184716_length_289_cov_554.947368	45	125	789	1	80	0.0125000
NODE_184716_length_289_cov_554.947368	45	125	792	2	80	0.0250000
NODE_184716_length_289_cov_554.947368	45	125	794	1	80	0.0125000
NODE_184716_length_289_cov_554.947368	45	125	798	1	80	0.0125000
NODE_184716_length_289_cov_554.947368	45	125	799	4	80	0.0500000
NODE_184716_length_289_cov_554.947368	45	125	805	3	80	0.0375000
NODE_184716_length_289_cov_554.947368	45	125	807	3	80	0.0375000
NODE_184716_length_289_cov_554.947368	45	125	808	1	80	0.0125000
NODE_184716_length_289_cov_554.947368	45	125	810	1	80	0.0125000
NODE_184716_length_289_cov_554.947368	45	125	811	1	80	0.0125000
NODE_184716_length_289_cov_554.947368	45	125	814	1	80	0.0125000
NODE_184716_length_289_cov_554.947368	45	125	816	6	80	0.0750000
NODE_184716_length_289_cov_554.947368	45	125	818	1	80	0.0125000
NODE_184716_length_289_cov_554.947368	45	125	822	1	80	0.0125000
NODE_184716_length_289_cov_554.947368	45	125	823	3	80	0.0375000
NODE_184716_length_289_cov_554.947368	45	125	825	1	80	0.0125000
NODE_184716_length_289_cov_554.947368	45	125	826	1	80	0.0125000
NODE_184716_length_289_cov_554.947368	45	125	828	2	80	0.0250000
NODE_184716_length_289_cov_554.947368	45	125	829	1	80	0.0125000
NODE_184716_length_289_cov_554.947368	45	125	831	1	80	0.0125000
NODE_184716_length_289_cov_554.947368	45	125	834	2	80	0.0250000
NODE_184716_length_289_cov_554.947368	45	125	835	1	80	0.0125000
NODE_184716_length_289_cov_554.947368	45	125	841	9	80	0.1125000
NODE_184716_length_289_cov_554.947368	45	125	842	1	80	0.0125000
NODE_184716_length_289_cov_554.947368	45	125	844	1	80	0.0125000
NODE_184716_length_289_cov_554.947368	45	125	845	1	80	0.0125000
NODE_184716_length_289_cov_554.947368	45	125	849	4	80	0.0500000
NODE_184716_length_289_cov_554.947368	45	125	850	1	80	0.0125000
NODE_184729_length_289_cov_7.436842	181	229	2	2	48	0.0416667
NODE_184729_length_289_cov_7.436842	181	229	4	46	48	0.9583333
NODE_184745_length_289_cov_5.789474	35	100	2	65	65	1.0000000
NODE_184745_length_289_cov_5.789474	85	153	2	61	68	0.8970588
NODE_184745_length_289_cov_5.789474	85	153	4	7	68	0.1029412
NODE_184745_length_289_cov_5.789474	146	181	2	35	35	1.0000000
NODE_184781_length_289_cov_4.515789	192	254	0	62	62	1.0000000
NODE_184806_length_289_cov_4.136842	101	148	2	27	47	0.5744681
NODE_184806_length_289_cov_4.136842	101	148	4	20	47	0.4255319
NODE_184892_length_289_cov_2.973684	38	83	0	45	45	1.0000000
NODE_184960_length_289_cov_2.678947	105	168	6	22	63	0.3492064
NODE_184960_length_289_cov_2.678947	105	168	8	12	63	0.1904762
NODE_184960_length_289_cov_2.678947	105	168	10	29	63	0.4603175
NODE_184960_length_289_cov_2.678947	158	204	6	24	46	0.5217391
NODE_184960_length_289_cov_2.678947	158	204	8	16	46	0.3478261
NODE_184960_length_289_cov_2.678947	158	204	10	6	46	0.1304348
NODE_184963_length_289_cov_2.673684	216	263	0	47	47	1.0000000
NODE_185036_length_289_cov_2.378947	233	289	0	56	56	1.0000000
NODE_185152_length_289_cov_2.089474	26	91	0	65	65	1.0000000
NODE_185213_length_289_cov_1.921053	0	54	0	54	54	1.0000000
NODE_185383_length_289_cov_1.642105	58	123	0	24	65	0.3692308
NODE_185383_length_289_cov_1.642105	58	123	4	41	65	0.6307693
NODE_185570_length_289_cov_1.547368	81	124	0	43	43	1.0000000
NODE_185617_length_289_cov_1.489474	192	274	0	82	82	1.0000000
NODE_185622_length_289_cov_1.484211	50	69	0	6	19	0.3157895
NODE_185622_length_289_cov_1.484211	50	69	2	13	19	0.6842105
NODE_185708_length_289_cov_1.357895	31	74	0	43	43	1.0000000
NODE_185852_length_289_cov_1.278947	239	270	0	31	31	1.0000000
NODE_185864_length_289_cov_1.252632	23	66	4	43	43	1.0000000
NODE_185926_length_289_cov_1.168421	40	100	0	60	60	1.0000000
NODE_185937_length_289_cov_1.152632	0	50	6	50	50	1.0000000
NODE_185937_length_289_cov_1.152632	41	103	6	62	62	1.0000000
NODE_186095_length_289_cov_1.073684	152	198	0	16	46	0.3478261
NODE_186095_length_289_cov_1.073684	152	198	2	30	46	0.6521739
NODE_186491_length_289_cov_0.878947	113	193	0	1	80	0.0125000
NODE_186491_length_289_cov_0.878947	113	193	4	5	80	0.0625000
NODE_186491_length_289_cov_0.878947	113	193	11	5	80	0.0625000
NODE_186491_length_289_cov_0.878947	113	193	12	3	80	0.0375000
NODE_186491_length_289_cov_0.878947	113	193	18	4	80	0.0500000
NODE_186491_length_289_cov_0.878947	113	193	20	62	80	0.7750000
NODE_186491_length_289_cov_0.878947	166	246	0	12	80	0.1500000
NODE_186491_length_289_cov_0.878947	166	246	4	1	80	0.0125000
NODE_186491_length_289_cov_0.878947	166	246	14	4	80	0.0500000
NODE_186491_length_289_cov_0.878947	166	246	18	5	80	0.0625000
NODE_186491_length_289_cov_0.878947	166	246	20	58	80	0.7250000
NODE_186507_length_289_cov_0.863158	116	211	6	6	95	0.0631579
NODE_186507_length_289_cov_0.863158	116	211	8	5	95	0.0526316
NODE_186507_length_289_cov_0.863158	116	211	9	2	95	0.0210526
NODE_186507_length_289_cov_0.863158	116	211	10	54	95	0.5684211
NODE_186507_length_289_cov_0.863158	116	211	12	28	95	0.2947368
NODE_186515_length_289_cov_0.857895	6	75	0	69	69	1.0000000
NODE_186547_length_289_cov_0.831579	230	289	2	45	59	0.7627119
NODE_186547_length_289_cov_0.831579	230	289	6	3	59	0.0508475
NODE_186547_length_289_cov_0.831579	230	289	8	2	59	0.0338983
NODE_186547_length_289_cov_0.831579	230	289	9	6	59	0.1016949
NODE_186547_length_289_cov_0.831579	230	289	12	2	59	0.0338983
NODE_186547_length_289_cov_0.831579	230	289	14	1	59	0.0169492
NODE_186631_length_289_cov_0.805263	98	159	2	9	61	0.1475410
NODE_186631_length_289_cov_0.805263	98	159	4	10	61	0.1639344
NODE_186631_length_289_cov_0.805263	98	159	6	42	61	0.6885246
NODE_186865_length_289_cov_0.568421	141	213	0	72	72	1.0000000
NODE_186934_length_288_cov_11.089947	135	195	8	60	60	1.0000000
NODE_187025_length_288_cov_3.587302	108	188	0	80	80	1.0000000
NODE_187049_length_288_cov_3.296296	61	125	0	31	64	0.4843750
NODE_187049_length_288_cov_3.296296	61	125	6	33	64	0.5156250
NODE_187049_length_288_cov_3.296296	102	178	0	2	76	0.0263158
NODE_187049_length_288_cov_3.296296	102	178	4	1	76	0.0131579
NODE_187049_length_288_cov_3.296296	102	178	6	73	76	0.9605263
NODE_187062_length_288_cov_3.206349	149	202	0	53	53	1.0000000
NODE_187170_length_288_cov_2.539683	4	68	2	8	64	0.1250000
NODE_187170_length_288_cov_2.539683	4	68	4	2	64	0.0312500
NODE_187170_length_288_cov_2.539683	4	68	6	54	64	0.8437500
NODE_187187_length_288_cov_2.465608	137	182	0	45	45	1.0000000
NODE_187191_length_288_cov_2.449735	216	278	0	62	62	1.0000000
NODE_187191_length_288_cov_2.449735	237	273	0	36	36	1.0000000
NODE_187248_length_288_cov_2.275132	10	46	12	36	36	1.0000000
NODE_187248_length_288_cov_2.275132	13	86	12	73	73	1.0000000
NODE_187248_length_288_cov_2.275132	47	100	4	3	53	0.0566038
NODE_187248_length_288_cov_2.275132	47	100	8	5	53	0.0943396
NODE_187248_length_288_cov_2.275132	47	100	10	6	53	0.1132075
NODE_187248_length_288_cov_2.275132	47	100	12	39	53	0.7358491
NODE_187318_length_288_cov_2.153439	50	81	4	20	31	0.6451613
NODE_187318_length_288_cov_2.153439	50	81	6	11	31	0.3548387
NODE_187431_length_288_cov_1.915344	0	75	0	75	75	1.0000000
NODE_187443_length_288_cov_1.888889	49	125	0	24	76	0.3157895
NODE_187443_length_288_cov_1.888889	49	125	2	52	76	0.6842105
NODE_187484_length_288_cov_1.878307	0	42	0	42	42	1.0000000
NODE_187484_length_288_cov_1.878307	15	63	0	48	48	1.0000000
NODE_187810_length_288_cov_1.492063	0	42	0	42	42	1.0000000
NODE_188135_length_288_cov_1.158730	213	288	0	75	75	1.0000000
NODE_188161_length_288_cov_1.100529	256	288	0	7	32	0.2187500
NODE_188161_length_288_cov_1.100529	256	288	2	25	32	0.7812500
NODE_188169_length_288_cov_1.079365	10	74	0	64	64	1.0000000
NODE_188169_length_288_cov_1.079365	65	110	0	45	45	1.0000000
NODE_188760_length_288_cov_0.809524	141	170	6	8	29	0.2758621
NODE_188760_length_288_cov_0.809524	141	170	8	21	29	0.7241379
NODE_189068_length_287_cov_7.632979	117	184	12	5	67	0.0746269
NODE_189068_length_287_cov_7.632979	117	184	14	4	67	0.0597015
NODE_189068_length_287_cov_7.632979	117	184	16	3	67	0.0447761
NODE_189068_length_287_cov_7.632979	117	184	18	2	67	0.0298507
NODE_189068_length_287_cov_7.632979	117	184	20	53	67	0.7910448
NODE_189079_length_287_cov_6.510638	20	100	0	80	80	1.0000000
NODE_189097_length_287_cov_5.781915	164	246	0	7	82	0.0853659
NODE_189097_length_287_cov_5.781915	164	246	4	75	82	0.9146342
NODE_189182_length_287_cov_3.590426	114	194	0	20	80	0.2500000
NODE_189182_length_287_cov_3.590426	114	194	2	60	80	0.7500000
NODE_189192_length_287_cov_3.452128	0	52	0	52	52	1.0000000
NODE_189208_length_287_cov_3.281915	263	286	0	23	23	1.0000000
NODE_189266_length_287_cov_2.936170	41	110	0	69	69	1.0000000
NODE_189266_length_287_cov_2.936170	41	111	0	70	70	1.0000000
NODE_189266_length_287_cov_2.936170	94	167	0	73	73	1.0000000
NODE_189266_length_287_cov_2.936170	156	179	0	23	23	1.0000000
NODE_189330_length_287_cov_2.638298	22	86	0	64	64	1.0000000
NODE_189381_length_287_cov_2.436170	182	262	4	8	80	0.1000000
NODE_189381_length_287_cov_2.436170	182	262	6	7	80	0.0875000
NODE_189381_length_287_cov_2.436170	182	262	8	54	80	0.6750000
NODE_189381_length_287_cov_2.436170	182	262	10	11	80	0.1375000
NODE_189582_length_287_cov_1.984043	137	166	16	21	29	0.7241379
NODE_189582_length_287_cov_1.984043	137	166	18	8	29	0.2758621
NODE_189594_length_287_cov_1.941489	56	123	0	67	67	1.0000000
NODE_189614_length_287_cov_1.904255	8	51	0	2	43	0.0465116
NODE_189614_length_287_cov_1.904255	8	51	1	18	43	0.4186046
NODE_189614_length_287_cov_1.904255	8	51	2	17	43	0.3953488
NODE_189614_length_287_cov_1.904255	8	51	4	6	43	0.1395349
NODE_189710_length_287_cov_1.803191	146	217	0	71	71	1.0000000
NODE_189843_length_287_cov_1.627660	113	175	14	22	62	0.3548387
NODE_189843_length_287_cov_1.627660	113	175	16	12	62	0.1935484
NODE_189843_length_287_cov_1.627660	113	175	18	1	62	0.0161290
NODE_189843_length_287_cov_1.627660	113	175	22	17	62	0.2741936
NODE_189843_length_287_cov_1.627660	113	175	24	6	62	0.0967742
NODE_189843_length_287_cov_1.627660	113	175	26	2	62	0.0322581
NODE_189843_length_287_cov_1.627660	113	175	28	1	62	0.0161290
NODE_189843_length_287_cov_1.627660	113	175	30	1	62	0.0161290
NODE_189843_length_287_cov_1.627660	148	228	8	3	80	0.0375000
NODE_189843_length_287_cov_1.627660	148	228	10	5	80	0.0625000
NODE_189843_length_287_cov_1.627660	148	228	11	5	80	0.0625000
NODE_189843_length_287_cov_1.627660	148	228	12	27	80	0.3375000
NODE_189843_length_287_cov_1.627660	148	228	14	34	80	0.4250000
NODE_189843_length_287_cov_1.627660	148	228	16	5	80	0.0625000
NODE_189843_length_287_cov_1.627660	148	228	18	1	80	0.0125000
NODE_189864_length_287_cov_1.627660	14	59	0	13	45	0.2888889
NODE_189864_length_287_cov_1.627660	14	59	2	24	45	0.5333334
NODE_189864_length_287_cov_1.627660	14	59	4	8	45	0.1777778
NODE_189864_length_287_cov_1.627660	41	112	2	27	71	0.3802817
NODE_189864_length_287_cov_1.627660	41	112	4	44	71	0.6197183
NODE_189949_length_287_cov_1.574468	150	220	4	70	70	1.0000000
NODE_189985_length_287_cov_1.531915	123	154	0	31	31	1.0000000
NODE_190122_length_287_cov_1.356383	93	147	0	54	54	1.0000000
NODE_190142_length_287_cov_1.356383	135	199	0	64	64	1.0000000
NODE_190189_length_287_cov_1.335106	149	201	0	52	52	1.0000000
NODE_190654_length_287_cov_1.037234	23	44	0	21	21	1.0000000
NODE_190701_length_287_cov_0.994681	206	225	0	19	19	1.0000000
NODE_190802_length_287_cov_0.898936	0	57	0	2	57	0.0350877
NODE_190802_length_287_cov_0.898936	0	57	1	2	57	0.0350877
NODE_190802_length_287_cov_0.898936	0	57	3	8	57	0.1403509
NODE_190802_length_287_cov_0.898936	0	57	4	15	57	0.2631579
NODE_190802_length_287_cov_0.898936	0	57	6	2	57	0.0350877
NODE_190802_length_287_cov_0.898936	0	57	8	6	57	0.1052632
NODE_190802_length_287_cov_0.898936	0	57	14	2	57	0.0350877
NODE_190802_length_287_cov_0.898936	0	57	16	3	57	0.0526316
NODE_190802_length_287_cov_0.898936	0	57	18	4	57	0.0701754
NODE_190802_length_287_cov_0.898936	0	57	20	1	57	0.0175439
NODE_190802_length_287_cov_0.898936	0	57	22	1	57	0.0175439
NODE_190802_length_287_cov_0.898936	0	57	26	3	57	0.0526316
NODE_190802_length_287_cov_0.898936	0	57	28	5	57	0.0877193
NODE_190802_length_287_cov_0.898936	0	57	30	2	57	0.0350877
NODE_190802_length_287_cov_0.898936	0	57	32	1	57	0.0175439
NODE_190873_length_287_cov_0.840426	46	121	0	75	75	1.0000000
NODE_191306_length_286_cov_141.540107	4	63	0	59	59	1.0000000
NODE_191389_length_286_cov_3.935829	79	123	6	38	44	0.8636364
NODE_191389_length_286_cov_3.935829	79	123	10	6	44	0.1363636
NODE_191391_length_286_cov_3.871658	45	121	4	11	76	0.1447368
NODE_191391_length_286_cov_3.871658	45	121	10	65	76	0.8552632
NODE_191391_length_286_cov_3.871658	102	169	0	34	67	0.5074627
NODE_191391_length_286_cov_3.871658	102	169	4	25	67	0.3731343
NODE_191391_length_286_cov_3.871658	102	169	10	8	67	0.1194030
NODE_191393_length_286_cov_3.812834	62	142	0	80	80	1.0000000
NODE_191430_length_286_cov_3.352941	63	143	0	2	80	0.0250000
NODE_191430_length_286_cov_3.352941	63	143	2	78	80	0.9750000
NODE_191430_length_286_cov_3.352941	116	196	0	28	80	0.3500000
NODE_191430_length_286_cov_3.352941	116	196	2	52	80	0.6500000
NODE_191466_length_286_cov_3.101604	217	271	0	54	54	1.0000000
NODE_191509_length_286_cov_2.823529	56	122	22	3	66	0.0454545
NODE_191509_length_286_cov_2.823529	56	122	26	1	66	0.0151515
NODE_191509_length_286_cov_2.823529	56	122	28	3	66	0.0454545
NODE_191509_length_286_cov_2.823529	56	122	32	3	66	0.0454545
NODE_191509_length_286_cov_2.823529	56	122	34	3	66	0.0454545
NODE_191509_length_286_cov_2.823529	56	122	40	3	66	0.0454545
NODE_191509_length_286_cov_2.823529	56	122	45	5	66	0.0757576
NODE_191509_length_286_cov_2.823529	56	122	47	3	66	0.0454545
NODE_191509_length_286_cov_2.823529	56	122	51	1	66	0.0151515
NODE_191509_length_286_cov_2.823529	56	122	63	1	66	0.0151515
NODE_191509_length_286_cov_2.823529	56	122	67	1	66	0.0151515
NODE_191509_length_286_cov_2.823529	56	122	71	2	66	0.0303030
NODE_191509_length_286_cov_2.823529	56	122	75	1	66	0.0151515
NODE_191509_length_286_cov_2.823529	56	122	77	1	66	0.0151515
NODE_191509_length_286_cov_2.823529	56	122	79	1	66	0.0151515
NODE_191509_length_286_cov_2.823529	56	122	83	6	66	0.0909091
NODE_191509_length_286_cov_2.823529	56	122	89	1	66	0.0151515
NODE_191509_length_286_cov_2.823529	56	122	91	1	66	0.0151515
NODE_191509_length_286_cov_2.823529	56	122	93	2	66	0.0303030
NODE_191509_length_286_cov_2.823529	56	122	97	2	66	0.0303030
NODE_191509_length_286_cov_2.823529	56	122	99	3	66	0.0454545
NODE_191509_length_286_cov_2.823529	56	122	101	1	66	0.0151515
NODE_191509_length_286_cov_2.823529	56	122	105	1	66	0.0151515
NODE_191509_length_286_cov_2.823529	56	122	106	7	66	0.1060606
NODE_191509_length_286_cov_2.823529	56	122	110	1	66	0.0151515
NODE_191509_length_286_cov_2.823529	56	122	114	1	66	0.0151515
NODE_191509_length_286_cov_2.823529	56	122	116	4	66	0.0606061
NODE_191509_length_286_cov_2.823529	56	122	118	3	66	0.0454545
NODE_191509_length_286_cov_2.823529	56	122	120	1	66	0.0151515
NODE_191598_length_286_cov_2.438503	151	218	0	67	67	1.0000000
NODE_191754_length_286_cov_2.037433	57	138	5	8	81	0.0987654
NODE_191754_length_286_cov_2.037433	57	138	7	22	81	0.2716049
NODE_191754_length_286_cov_2.037433	57	138	9	5	81	0.0617284
NODE_191754_length_286_cov_2.037433	57	138	10	17	81	0.2098765
NODE_191754_length_286_cov_2.037433	57	138	11	29	81	0.3580247
NODE_191892_length_286_cov_1.807487	186	232	0	26	46	0.5652174
NODE_191892_length_286_cov_1.807487	186	232	2	20	46	0.4347826
NODE_191892_length_286_cov_1.807487	239	285	0	1	46	0.0217391
NODE_191892_length_286_cov_1.807487	239	285	2	45	46	0.9782609
NODE_192100_length_286_cov_1.566845	112	160	2	12	48	0.2500000
NODE_192100_length_286_cov_1.566845	112	160	4	36	48	0.7500000
NODE_192100_length_286_cov_1.566845	165	213	2	48	48	1.0000000
NODE_192150_length_286_cov_1.497326	107	160	8	23	53	0.4339623
NODE_192150_length_286_cov_1.497326	107	160	9	3	53	0.0566038
NODE_192150_length_286_cov_1.497326	107	160	10	27	53	0.5094340
NODE_192233_length_286_cov_1.363636	20	87	2	67	67	1.0000000
NODE_192302_length_286_cov_1.358289	218	262	2	44	44	1.0000000
NODE_192357_length_286_cov_1.304813	147	205	4	22	58	0.3793103
NODE_192357_length_286_cov_1.304813	147	205	6	36	58	0.6206896
NODE_192427_length_286_cov_1.203209	30	76	0	46	46	1.0000000
NODE_192427_length_286_cov_1.203209	49	129	0	58	80	0.7250000
NODE_192427_length_286_cov_1.203209	49	129	2	22	80	0.2750000
NODE_192757_length_286_cov_1.074866	160	220	0	33	60	0.5500000
NODE_192757_length_286_cov_1.074866	160	220	2	27	60	0.4500000
NODE_193023_length_286_cov_0.871658	218	279	0	20	61	0.3278688
NODE_193023_length_286_cov_0.871658	218	279	4	41	61	0.6721311
NODE_193038_length_286_cov_0.855615	224	281	0	36	57	0.6315789
NODE_193038_length_286_cov_0.855615	224	281	2	21	57	0.3684210
NODE_193362_length_286_cov_0.625668	110	190	0	80	80	1.0000000
NODE_193362_length_286_cov_0.625668	163	240	0	77	77	1.0000000
NODE_193481_length_285_cov_7.392473	91	152	0	61	61	1.0000000
NODE_193481_length_285_cov_7.392473	150	184	0	34	34	1.0000000
NODE_193513_length_285_cov_4.650538	0	74	0	74	74	1.0000000
NODE_193513_length_285_cov_4.650538	47	127	0	80	80	1.0000000
NODE_193513_length_285_cov_4.650538	123	203	0	80	80	1.0000000
NODE_193513_length_285_cov_4.650538	176	256	0	80	80	1.0000000
NODE_193532_length_285_cov_4.091398	91	154	2	8	63	0.1269841
NODE_193532_length_285_cov_4.091398	91	154	4	55	63	0.8730159
NODE_193538_length_285_cov_4.010753	120	201	0	81	81	1.0000000
NODE_193547_length_285_cov_3.854839	97	151	5	2	54	0.0370370
NODE_193547_length_285_cov_3.854839	97	151	7	52	54	0.9629630
NODE_193547_length_285_cov_3.854839	106	153	5	3	47	0.0638298
NODE_193547_length_285_cov_3.854839	106	153	7	43	47	0.9148936
NODE_193547_length_285_cov_3.854839	106	153	9	1	47	0.0212766
NODE_193566_length_285_cov_3.607527	197	258	0	20	61	0.3278688
NODE_193566_length_285_cov_3.607527	197	258	6	3	61	0.0491803
NODE_193566_length_285_cov_3.607527	197	258	7	2	61	0.0327869
NODE_193566_length_285_cov_3.607527	197	258	9	2	61	0.0327869
NODE_193566_length_285_cov_3.607527	197	258	10	10	61	0.1639344
NODE_193566_length_285_cov_3.607527	197	258	12	7	61	0.1147541
NODE_193566_length_285_cov_3.607527	197	258	14	8	61	0.1311475
NODE_193566_length_285_cov_3.607527	197	258	18	9	61	0.1475410
NODE_193624_length_285_cov_3.037634	190	272	0	82	82	1.0000000
NODE_193660_length_285_cov_2.806452	215	279	0	6	64	0.0937500
NODE_193660_length_285_cov_2.806452	215	279	2	58	64	0.9062500
NODE_193688_length_285_cov_2.736559	106	173	0	56	67	0.8358209
NODE_193688_length_285_cov_2.736559	106	173	7	1	67	0.0149254
NODE_193688_length_285_cov_2.736559	106	173	8	10	67	0.1492537
NODE_193784_length_285_cov_2.311828	220	262	0	42	42	1.0000000
NODE_193883_length_285_cov_2.043011	77	150	2	43	73	0.5890411
NODE_193883_length_285_cov_2.043011	77	150	3	17	73	0.2328767
NODE_193883_length_285_cov_2.043011	77	150	4	11	73	0.1506849
NODE_193883_length_285_cov_2.043011	77	150	6	2	73	0.0273973
NODE_193883_length_285_cov_2.043011	155	197	4	30	42	0.7142857
NODE_193883_length_285_cov_2.043011	155	197	6	12	42	0.2857143
NODE_193978_length_285_cov_1.876344	67	110	0	23	43	0.5348837
NODE_193978_length_285_cov_1.876344	67	110	2	20	43	0.4651163
NODE_194150_length_285_cov_1.645161	112	160	6	2	48	0.0416667
NODE_194150_length_285_cov_1.645161	112	160	8	12	48	0.2500000
NODE_194150_length_285_cov_1.645161	112	160	10	34	48	0.7083333
NODE_194260_length_285_cov_1.548387	124	172	0	12	48	0.2500000
NODE_194260_length_285_cov_1.548387	124	172	2	36	48	0.7500000
NODE_194332_length_285_cov_1.456989	210	277	0	67	67	1.0000000
NODE_194499_length_285_cov_1.327957	114	191	0	4	77	0.0519481
NODE_194499_length_285_cov_1.327957	114	191	4	73	77	0.9480519
NODE_194865_length_285_cov_1.096774	175	229	0	44	54	0.8148148
NODE_194865_length_285_cov_1.096774	175	229	2	5	54	0.0925926
NODE_194865_length_285_cov_1.096774	175	229	4	5	54	0.0925926
NODE_194865_length_285_cov_1.096774	230	271	0	41	41	1.0000000
NODE_195109_length_285_cov_0.924731	128	208	2	32	80	0.4000000
NODE_195109_length_285_cov_0.924731	128	208	4	48	80	0.6000000
NODE_195115_length_285_cov_0.919355	5	65	0	60	60	1.0000000
NODE_195124_length_285_cov_0.913978	6	80	0	74	74	1.0000000
NODE_195124_length_285_cov_0.913978	58	133	0	75	75	1.0000000
NODE_195642_length_284_cov_7.967568	143	207	12	1	64	0.0156250
NODE_195642_length_284_cov_7.967568	143	207	14	3	64	0.0468750
NODE_195642_length_284_cov_7.967568	143	207	16	11	64	0.1718750
NODE_195642_length_284_cov_7.967568	143	207	17	9	64	0.1406250
NODE_195642_length_284_cov_7.967568	143	207	19	1	64	0.0156250
NODE_195642_length_284_cov_7.967568	143	207	23	3	64	0.0468750
NODE_195642_length_284_cov_7.967568	143	207	24	1	64	0.0156250
NODE_195642_length_284_cov_7.967568	143	207	26	13	64	0.2031250
NODE_195642_length_284_cov_7.967568	143	207	28	22	64	0.3437500
NODE_195667_length_284_cov_5.016216	115	169	8	54	54	1.0000000
NODE_195715_length_284_cov_3.913514	26	82	0	56	56	1.0000000
NODE_195760_length_284_cov_3.405405	209	283	0	50	74	0.6756757
NODE_195760_length_284_cov_3.405405	209	283	1	16	74	0.2162162
NODE_195760_length_284_cov_3.405405	209	283	2	8	74	0.1081081
NODE_195863_length_284_cov_2.718919	138	162	0	8	24	0.3333333
NODE_195863_length_284_cov_2.718919	138	162	2	16	24	0.6666667
NODE_195863_length_284_cov_2.718919	138	215	0	8	77	0.1038961
NODE_195863_length_284_cov_2.718919	138	215	2	69	77	0.8961039
NODE_196090_length_284_cov_2.097297	46	122	0	76	76	1.0000000
NODE_196253_length_284_cov_1.756757	27	100	0	19	73	0.2602740
NODE_196253_length_284_cov_1.756757	27	100	2	19	73	0.2602740
NODE_196253_length_284_cov_1.756757	27	100	4	35	73	0.4794520
NODE_196253_length_284_cov_1.756757	97	153	4	56	56	1.0000000
NODE_196273_length_284_cov_1.713514	24	59	0	35	35	1.0000000
NODE_196372_length_284_cov_1.654054	207	251	0	44	44	1.0000000
NODE_196426_length_284_cov_1.643243	180	239	0	6	59	0.1016949
NODE_196426_length_284_cov_1.643243	180	239	1	29	59	0.4915254
NODE_196426_length_284_cov_1.643243	180	239	2	24	59	0.4067796
NODE_196505_length_284_cov_1.540541	148	186	47	2	38	0.0526316
NODE_196505_length_284_cov_1.540541	148	186	51	1	38	0.0263158
NODE_196505_length_284_cov_1.540541	148	186	54	2	38	0.0526316
NODE_196505_length_284_cov_1.540541	148	186	55	4	38	0.1052632
NODE_196505_length_284_cov_1.540541	148	186	56	8	38	0.2105263
NODE_196505_length_284_cov_1.540541	148	186	57	4	38	0.1052632
NODE_196505_length_284_cov_1.540541	148	186	58	2	38	0.0526316
NODE_196505_length_284_cov_1.540541	148	186	59	12	38	0.3157895
NODE_196505_length_284_cov_1.540541	148	186	65	2	38	0.0526316
NODE_196505_length_284_cov_1.540541	148	186	67	1	38	0.0263158
NODE_196670_length_284_cov_1.378378	65	145	0	6	80	0.0750000
NODE_196670_length_284_cov_1.378378	65	145	1	3	80	0.0375000
NODE_196670_length_284_cov_1.378378	65	145	3	43	80	0.5375000
NODE_196670_length_284_cov_1.378378	65	145	5	1	80	0.0125000
NODE_196670_length_284_cov_1.378378	65	145	11	7	80	0.0875000
NODE_196670_length_284_cov_1.378378	65	145	12	6	80	0.0750000
NODE_196670_length_284_cov_1.378378	65	145	14	4	80	0.0500000
NODE_196670_length_284_cov_1.378378	65	145	16	2	80	0.0250000
NODE_196670_length_284_cov_1.378378	65	145	21	3	80	0.0375000
NODE_196670_length_284_cov_1.378378	65	145	25	5	80	0.0625000
NODE_196670_length_284_cov_1.378378	118	165	11	7	47	0.1489362
NODE_196670_length_284_cov_1.378378	118	165	12	6	47	0.1276596
NODE_196670_length_284_cov_1.378378	118	165	14	4	47	0.0851064
NODE_196670_length_284_cov_1.378378	118	165	16	2	47	0.0425532
NODE_196670_length_284_cov_1.378378	118	165	21	3	47	0.0638298
NODE_196670_length_284_cov_1.378378	118	165	25	5	47	0.1063830
NODE_196670_length_284_cov_1.378378	118	165	29	1	47	0.0212766
NODE_196670_length_284_cov_1.378378	118	165	31	2	47	0.0425532
NODE_196670_length_284_cov_1.378378	118	165	32	1	47	0.0212766
NODE_196670_length_284_cov_1.378378	118	165	34	12	47	0.2553191
NODE_196670_length_284_cov_1.378378	118	165	36	4	47	0.0851064
NODE_196733_length_284_cov_1.329730	114	170	0	21	56	0.3750000
NODE_196733_length_284_cov_1.329730	114	170	4	35	56	0.6250000
NODE_197755_length_284_cov_0.686486	13	94	0	81	81	1.0000000
NODE_197755_length_284_cov_0.686486	13	94	0	81	81	1.0000000
NODE_197755_length_284_cov_0.686486	13	94	0	81	81	1.0000000
NODE_197835_length_284_cov_0.551351	167	219	0	52	52	1.0000000
NODE_197936_length_283_cov_4.434783	81	137	20	2	56	0.0357143
NODE_197936_length_283_cov_4.434783	81	137	22	20	56	0.3571429
NODE_197936_length_283_cov_4.434783	81	137	24	17	56	0.3035714
NODE_197936_length_283_cov_4.434783	81	137	32	4	56	0.0714286
NODE_197936_length_283_cov_4.434783	81	137	34	13	56	0.2321429
NODE_197936_length_283_cov_4.434783	114	190	0	1	76	0.0131579
NODE_197936_length_283_cov_4.434783	114	190	1	9	76	0.1184211
NODE_197936_length_283_cov_4.434783	114	190	2	3	76	0.0394737
NODE_197936_length_283_cov_4.434783	114	190	3	6	76	0.0789474
NODE_197936_length_283_cov_4.434783	114	190	4	3	76	0.0394737
NODE_197936_length_283_cov_4.434783	114	190	8	2	76	0.0263158
NODE_197936_length_283_cov_4.434783	114	190	9	15	76	0.1973684
NODE_197936_length_283_cov_4.434783	114	190	12	1	76	0.0131579
NODE_197936_length_283_cov_4.434783	114	190	13	5	76	0.0657895
NODE_197936_length_283_cov_4.434783	114	190	15	1	76	0.0131579
NODE_197936_length_283_cov_4.434783	114	190	19	1	76	0.0131579
NODE_197936_length_283_cov_4.434783	114	190	20	8	76	0.1052632
NODE_197936_length_283_cov_4.434783	114	190	22	20	76	0.2631579
NODE_197936_length_283_cov_4.434783	114	190	24	1	76	0.0131579
NODE_197936_length_283_cov_4.434783	190	270	0	5	80	0.0625000
NODE_197936_length_283_cov_4.434783	190	270	2	5	80	0.0625000
NODE_197936_length_283_cov_4.434783	190	270	4	7	80	0.0875000
NODE_197936_length_283_cov_4.434783	190	270	6	7	80	0.0875000
NODE_197936_length_283_cov_4.434783	190	270	8	56	80	0.7000000
NODE_197937_length_283_cov_4.429348	104	168	11	18	64	0.2812500
NODE_197937_length_283_cov_4.429348	104	168	16	26	64	0.4062500
NODE_197937_length_283_cov_4.429348	104	168	17	5	64	0.0781250
NODE_197937_length_283_cov_4.429348	104	168	18	8	64	0.1250000
NODE_197937_length_283_cov_4.429348	104	168	19	7	64	0.1093750
NODE_197937_length_283_cov_4.429348	104	168	11	18	64	0.2812500
NODE_197937_length_283_cov_4.429348	104	168	16	26	64	0.4062500
NODE_197937_length_283_cov_4.429348	104	168	17	5	64	0.0781250
NODE_197937_length_283_cov_4.429348	104	168	18	8	64	0.1250000
NODE_197937_length_283_cov_4.429348	104	168	19	7	64	0.1093750
NODE_197937_length_283_cov_4.429348	141	207	10	25	66	0.3787879
NODE_197937_length_283_cov_4.429348	141	207	12	3	66	0.0454545
NODE_197937_length_283_cov_4.429348	141	207	16	19	66	0.2878788
NODE_197937_length_283_cov_4.429348	141	207	18	19	66	0.2878788
NODE_197937_length_283_cov_4.429348	141	221	10	39	80	0.4875000
NODE_197937_length_283_cov_4.429348	141	221	12	3	80	0.0375000
NODE_197937_length_283_cov_4.429348	141	221	16	19	80	0.2375000
NODE_197937_length_283_cov_4.429348	141	221	18	19	80	0.2375000
NODE_198007_length_283_cov_3.369565	0	35	0	35	35	1.0000000
NODE_198022_length_283_cov_3.309783	47	91	0	44	44	1.0000000
NODE_198081_length_283_cov_2.923913	95	137	2	4	42	0.0952381
NODE_198081_length_283_cov_2.923913	95	137	3	1	42	0.0238095
NODE_198081_length_283_cov_2.923913	95	137	4	10	42	0.2380952
NODE_198081_length_283_cov_2.923913	95	137	6	19	42	0.4523810
NODE_198081_length_283_cov_2.923913	95	137	8	3	42	0.0714286
NODE_198081_length_283_cov_2.923913	95	137	12	5	42	0.1190476
NODE_198081_length_283_cov_2.923913	110	190	6	19	80	0.2375000
NODE_198081_length_283_cov_2.923913	110	190	8	3	80	0.0375000
NODE_198081_length_283_cov_2.923913	110	190	12	39	80	0.4875000
NODE_198081_length_283_cov_2.923913	110	190	14	19	80	0.2375000
NODE_198098_length_283_cov_2.782609	120	200	8	80	80	1.0000000
NODE_198109_length_283_cov_2.771739	29	72	6	15	43	0.3488372
NODE_198109_length_283_cov_2.771739	29	72	8	16	43	0.3720930
NODE_198109_length_283_cov_2.771739	29	72	9	12	43	0.2790698
NODE_198171_length_283_cov_2.494565	186	229	0	43	43	1.0000000
NODE_198176_length_283_cov_2.494565	181	238	0	57	57	1.0000000
NODE_198271_length_283_cov_2.217391	222	281	0	59	59	1.0000000
NODE_198518_length_283_cov_1.777174	40	120	0	80	80	1.0000000
NODE_198745_length_283_cov_1.543478	125	161	6	3	36	0.0833333
NODE_198745_length_283_cov_1.543478	125	161	7	2	36	0.0555556
NODE_198745_length_283_cov_1.543478	125	161	12	3	36	0.0833333
NODE_198745_length_283_cov_1.543478	125	161	19	1	36	0.0277778
NODE_198745_length_283_cov_1.543478	125	161	22	1	36	0.0277778
NODE_198745_length_283_cov_1.543478	125	161	23	1	36	0.0277778
NODE_198745_length_283_cov_1.543478	125	161	24	3	36	0.0833333
NODE_198745_length_283_cov_1.543478	125	161	26	10	36	0.2777778
NODE_198745_length_283_cov_1.543478	125	161	28	6	36	0.1666667
NODE_198745_length_283_cov_1.543478	125	161	30	1	36	0.0277778
NODE_198745_length_283_cov_1.543478	125	161	32	2	36	0.0555556
NODE_198745_length_283_cov_1.543478	125	161	34	3	36	0.0833333
NODE_198751_length_283_cov_1.538043	182	203	0	21	21	1.0000000
NODE_198986_length_283_cov_1.304348	208	270	0	62	62	1.0000000
NODE_199042_length_283_cov_1.211957	157	234	0	7	77	0.0909091
NODE_199042_length_283_cov_1.211957	157	234	2	70	77	0.9090909
NODE_199070_length_283_cov_1.168478	183	250	4	20	67	0.2985075
NODE_199070_length_283_cov_1.168478	183	250	6	47	67	0.7014925
NODE_199606_length_283_cov_0.918478	146	226	2	73	80	0.9125000
NODE_199606_length_283_cov_0.918478	146	226	3	5	80	0.0625000
NODE_199606_length_283_cov_0.918478	146	226	4	2	80	0.0250000
NODE_199606_length_283_cov_0.918478	199	279	0	16	80	0.2000000
NODE_199606_length_283_cov_0.918478	199	279	2	55	80	0.6875000
NODE_199606_length_283_cov_0.918478	199	279	3	5	80	0.0625000
NODE_199606_length_283_cov_0.918478	199	279	4	4	80	0.0500000
NODE_199641_length_283_cov_0.885870	143	205	14	29	62	0.4677419
NODE_199641_length_283_cov_0.885870	143	205	16	33	62	0.5322581
NODE_199958_length_283_cov_0.706522	119	159	0	40	40	1.0000000
NODE_200085_length_282_cov_51.027322	219	280	0	61	61	1.0000000
NODE_200085_length_282_cov_51.027322	219	282	0	63	63	1.0000000
NODE_200166_length_282_cov_3.901639	38	118	0	80	80	1.0000000
NODE_200166_length_282_cov_3.901639	91	171	0	80	80	1.0000000
NODE_200171_length_282_cov_3.874317	96	116	6	3	20	0.1500000
NODE_200171_length_282_cov_3.874317	96	116	8	17	20	0.8500000
NODE_200201_length_282_cov_3.562842	224	279	0	54	55	0.9818182
NODE_200201_length_282_cov_3.562842	224	279	4	1	55	0.0181818
NODE_200270_length_282_cov_2.890710	41	123	0	12	82	0.1463415
NODE_200270_length_282_cov_2.890710	41	123	2	10	82	0.1219512
NODE_200270_length_282_cov_2.890710	41	123	4	60	82	0.7317073
NODE_200276_length_282_cov_2.846995	26	47	0	21	21	1.0000000
NODE_200304_length_282_cov_2.770492	145	225	4	80	80	1.0000000
NODE_200304_length_282_cov_2.770492	198	278	0	19	80	0.2375000
NODE_200304_length_282_cov_2.770492	198	278	1	9	80	0.1125000
NODE_200304_length_282_cov_2.770492	198	278	2	17	80	0.2125000
NODE_200304_length_282_cov_2.770492	198	278	4	35	80	0.4375000
NODE_200329_length_282_cov_2.655738	46	119	0	12	73	0.1643836
NODE_200329_length_282_cov_2.655738	46	119	2	61	73	0.8356164
NODE_200329_length_282_cov_2.655738	100	159	0	25	59	0.4237288
NODE_200329_length_282_cov_2.655738	100	159	2	34	59	0.5762712
NODE_200335_length_282_cov_2.622951	0	36	0	36	36	1.0000000
NODE_200335_length_282_cov_2.622951	9	89	0	51	80	0.6375000
NODE_200335_length_282_cov_2.622951	9	89	2	29	80	0.3625000
NODE_200336_length_282_cov_2.622951	38	111	0	29	73	0.3972603
NODE_200336_length_282_cov_2.622951	38	111	2	44	73	0.6027398
NODE_200336_length_282_cov_2.622951	98	144	2	46	46	1.0000000
NODE_200367_length_282_cov_2.508197	138	186	0	48	48	1.0000000
NODE_200367_length_282_cov_2.508197	191	234	0	43	43	1.0000000
NODE_200425_length_282_cov_2.289617	68	137	6	24	69	0.3478261
NODE_200425_length_282_cov_2.289617	68	137	7	21	69	0.3043478
NODE_200425_length_282_cov_2.289617	68	137	10	24	69	0.3478261
NODE_200443_length_282_cov_2.229508	169	249	0	80	80	1.0000000
NODE_200501_length_282_cov_2.163934	138	192	0	54	54	1.0000000
NODE_200634_length_282_cov_1.901639	149	216	4	5	67	0.0746269
NODE_200634_length_282_cov_1.901639	149	216	6	18	67	0.2686567
NODE_200634_length_282_cov_1.901639	149	216	10	44	67	0.6567164
NODE_200924_length_282_cov_1.612022	123	162	0	39	39	1.0000000
NODE_201084_length_282_cov_1.393443	158	225	0	67	67	1.0000000
NODE_201219_length_282_cov_1.273224	91	140	2	28	49	0.5714286
NODE_201219_length_282_cov_1.273224	91	140	4	21	49	0.4285714
NODE_201413_length_282_cov_1.114754	5	53	2	2	48	0.0416667
NODE_201413_length_282_cov_1.114754	5	53	4	46	48	0.9583333
NODE_202284_length_281_cov_7.895604	165	210	32	2	45	0.0444444
NODE_202284_length_281_cov_7.895604	165	210	36	1	45	0.0222222
NODE_202284_length_281_cov_7.895604	165	210	40	1	45	0.0222222
NODE_202284_length_281_cov_7.895604	165	210	42	3	45	0.0666667
NODE_202284_length_281_cov_7.895604	165	210	44	2	45	0.0444444
NODE_202284_length_281_cov_7.895604	165	210	48	3	45	0.0666667
NODE_202284_length_281_cov_7.895604	165	210	52	33	45	0.7333333
NODE_202284_length_281_cov_7.895604	183	263	42	3	80	0.0375000
NODE_202284_length_281_cov_7.895604	183	263	48	14	80	0.1750000
NODE_202284_length_281_cov_7.895604	183	263	50	6	80	0.0750000
NODE_202284_length_281_cov_7.895604	183	263	52	57	80	0.7125000
NODE_202294_length_281_cov_6.379121	151	231	0	80	80	1.0000000
NODE_202333_length_281_cov_4.565934	71	127	0	56	56	1.0000000
NODE_202337_length_281_cov_4.494505	211	261	0	50	50	1.0000000
NODE_202356_length_281_cov_4.219780	85	135	0	50	50	1.0000000
NODE_202356_length_281_cov_4.219780	145	188	0	43	43	1.0000000
NODE_202401_length_281_cov_3.620879	245	281	0	36	36	1.0000000
NODE_202421_length_281_cov_3.324176	104	161	8	2	57	0.0350877
NODE_202421_length_281_cov_3.324176	104	161	12	5	57	0.0877193
NODE_202421_length_281_cov_3.324176	104	161	14	11	57	0.1929825
NODE_202421_length_281_cov_3.324176	104	161	18	14	57	0.2456140
NODE_202421_length_281_cov_3.324176	104	161	21	25	57	0.4385965
NODE_202421_length_281_cov_3.324176	112	192	13	2	80	0.0250000
NODE_202421_length_281_cov_3.324176	112	192	14	10	80	0.1250000
NODE_202421_length_281_cov_3.324176	112	192	15	5	80	0.0625000
NODE_202421_length_281_cov_3.324176	112	192	18	15	80	0.1875000
NODE_202421_length_281_cov_3.324176	112	192	21	48	80	0.6000000
NODE_202436_length_281_cov_3.197802	6	80	0	74	74	1.0000000
NODE_202473_length_281_cov_2.923077	92	150	0	58	58	1.0000000
NODE_202650_length_281_cov_2.241758	5	58	0	53	53	1.0000000
NODE_202712_length_281_cov_2.120879	56	136	0	65	80	0.8125000
NODE_202712_length_281_cov_2.120879	56	136	8	15	80	0.1875000
NODE_202788_length_281_cov_1.961538	199	270	0	24	71	0.3380282
NODE_202788_length_281_cov_1.961538	199	270	1	14	71	0.1971831
NODE_202788_length_281_cov_1.961538	199	270	2	33	71	0.4647887
NODE_203008_length_281_cov_1.675824	147	199	4	52	52	1.0000000
NODE_203008_length_281_cov_1.675824	178	198	4	20	20	1.0000000
NODE_203008_length_281_cov_1.675824	200	241	0	36	41	0.8780488
NODE_203008_length_281_cov_1.675824	200	241	4	5	41	0.1219512
NODE_203065_length_281_cov_1.653846	29	65	0	36	36	1.0000000
NODE_203168_length_281_cov_1.483516	85	135	0	50	50	1.0000000
NODE_203168_length_281_cov_1.483516	86	166	0	80	80	1.0000000
NODE_203168_length_281_cov_1.483516	139	184	0	45	45	1.0000000
NODE_203183_length_281_cov_1.461538	223	276	0	51	53	0.9622642
NODE_203183_length_281_cov_1.461538	223	276	2	2	53	0.0377358
NODE_203262_length_281_cov_1.401099	237	281	2	44	44	1.0000000
NODE_203281_length_281_cov_1.401099	150	214	2	24	64	0.3750000
NODE_203281_length_281_cov_1.401099	150	214	7	1	64	0.0156250
NODE_203281_length_281_cov_1.401099	150	214	8	1	64	0.0156250
NODE_203281_length_281_cov_1.401099	150	214	12	20	64	0.3125000
NODE_203281_length_281_cov_1.401099	150	214	14	4	64	0.0625000
NODE_203281_length_281_cov_1.401099	150	214	16	14	64	0.2187500
NODE_203281_length_281_cov_1.401099	187	267	0	10	80	0.1250000
NODE_203281_length_281_cov_1.401099	187	267	2	67	80	0.8375000
NODE_203281_length_281_cov_1.401099	187	267	7	1	80	0.0125000
NODE_203281_length_281_cov_1.401099	187	267	8	1	80	0.0125000
NODE_203281_length_281_cov_1.401099	187	267	12	1	80	0.0125000
NODE_203292_length_281_cov_1.401099	31	111	0	2	80	0.0250000
NODE_203292_length_281_cov_1.401099	31	111	2	78	80	0.9750000
NODE_203440_length_281_cov_1.186813	0	79	0	27	79	0.3417721
NODE_203440_length_281_cov_1.186813	0	79	4	26	79	0.3291139
NODE_203440_length_281_cov_1.186813	0	79	10	12	79	0.1518987
NODE_203440_length_281_cov_1.186813	0	79	12	1	79	0.0126582
NODE_203440_length_281_cov_1.186813	0	79	14	13	79	0.1645570
NODE_203440_length_281_cov_1.186813	52	132	4	1	80	0.0125000
NODE_203440_length_281_cov_1.186813	52	132	10	12	80	0.1500000
NODE_203440_length_281_cov_1.186813	52	132	12	1	80	0.0125000
NODE_203440_length_281_cov_1.186813	52	132	14	13	80	0.1625000
NODE_203440_length_281_cov_1.186813	52	132	16	1	80	0.0125000
NODE_203440_length_281_cov_1.186813	52	132	20	9	80	0.1125000
NODE_203440_length_281_cov_1.186813	52	132	24	1	80	0.0125000
NODE_203440_length_281_cov_1.186813	52	132	26	1	80	0.0125000
NODE_203440_length_281_cov_1.186813	52	132	28	26	80	0.3250000
NODE_203440_length_281_cov_1.186813	52	132	32	15	80	0.1875000
NODE_203516_length_281_cov_1.120879	47	82	0	35	35	1.0000000
NODE_203534_length_281_cov_1.120879	243	276	0	33	33	1.0000000
NODE_203544_length_281_cov_1.120879	216	281	4	13	65	0.2000000
NODE_203544_length_281_cov_1.120879	216	281	5	52	65	0.8000000
NODE_203785_length_281_cov_1.060440	139	179	18	13	40	0.3250000
NODE_203785_length_281_cov_1.060440	139	179	20	1	40	0.0250000
NODE_203785_length_281_cov_1.060440	139	179	22	2	40	0.0500000
NODE_203785_length_281_cov_1.060440	139	179	24	5	40	0.1250000
NODE_203785_length_281_cov_1.060440	139	179	26	4	40	0.1000000
NODE_203785_length_281_cov_1.060440	139	179	28	15	40	0.3750000
NODE_204094_length_281_cov_0.840659	72	138	0	38	66	0.5757576
NODE_204094_length_281_cov_0.840659	72	138	2	28	66	0.4242424
NODE_204094_length_281_cov_0.840659	111	191	2	80	80	1.0000000
NODE_204467_length_280_cov_39.320442	118	198	0	80	80	1.0000000
NODE_204467_length_280_cov_39.320442	181	251	0	70	70	1.0000000
NODE_204468_length_280_cov_34.259669	97	137	0	2	40	0.0500000
NODE_204468_length_280_cov_34.259669	97	137	4	31	40	0.7750000
NODE_204468_length_280_cov_34.259669	97	137	6	7	40	0.1750000
NODE_204532_length_280_cov_4.287293	53	100	0	47	47	1.0000000
NODE_204532_length_280_cov_4.287293	129	186	0	23	57	0.4035088
NODE_204532_length_280_cov_4.287293	129	186	2	5	57	0.0877193
NODE_204532_length_280_cov_4.287293	129	186	4	29	57	0.5087720
NODE_204596_length_280_cov_3.436464	34	103	36	7	69	0.1014493
NODE_204596_length_280_cov_3.436464	34	103	40	9	69	0.1304348
NODE_204596_length_280_cov_3.436464	34	103	44	7	69	0.1014493
NODE_204596_length_280_cov_3.436464	34	103	48	3	69	0.0434783
NODE_204596_length_280_cov_3.436464	34	103	50	2	69	0.0289855
NODE_204596_length_280_cov_3.436464	34	103	52	1	69	0.0144928
NODE_204596_length_280_cov_3.436464	34	103	54	2	69	0.0289855
NODE_204596_length_280_cov_3.436464	34	103	56	7	69	0.1014493
NODE_204596_length_280_cov_3.436464	34	103	57	1	69	0.0144928
NODE_204596_length_280_cov_3.436464	34	103	58	4	69	0.0579710
NODE_204596_length_280_cov_3.436464	34	103	60	26	69	0.3768116
NODE_204597_length_280_cov_3.430939	17	97	6	19	80	0.2375000
NODE_204597_length_280_cov_3.430939	17	97	8	9	80	0.1125000
NODE_204597_length_280_cov_3.430939	17	97	12	25	80	0.3125000
NODE_204597_length_280_cov_3.430939	17	97	14	27	80	0.3375000
NODE_204597_length_280_cov_3.430939	27	97	6	9	70	0.1285714
NODE_204597_length_280_cov_3.430939	27	97	8	9	70	0.1285714
NODE_204597_length_280_cov_3.430939	27	97	12	25	70	0.3571429
NODE_204597_length_280_cov_3.430939	27	97	14	27	70	0.3857143
NODE_204674_length_280_cov_2.988950	118	164	0	30	46	0.6521739
NODE_204674_length_280_cov_2.988950	118	164	2	1	46	0.0217391
NODE_204674_length_280_cov_2.988950	118	164	3	7	46	0.1521739
NODE_204674_length_280_cov_2.988950	118	164	6	8	46	0.1739130
NODE_204938_length_280_cov_2.165746	2	48	0	46	46	1.0000000
NODE_204938_length_280_cov_2.165746	6	48	0	42	42	1.0000000
NODE_204938_length_280_cov_2.165746	21	101	0	80	80	1.0000000
NODE_204938_length_280_cov_2.165746	22	101	0	79	79	1.0000000
NODE_204938_length_280_cov_2.165746	32	101	0	69	69	1.0000000
NODE_204976_length_280_cov_2.022099	105	148	0	7	43	0.1627907
NODE_204976_length_280_cov_2.022099	105	148	3	36	43	0.8372093
NODE_204976_length_280_cov_2.022099	121	148	3	27	27	1.0000000
NODE_205044_length_280_cov_1.889503	50	132	0	82	82	1.0000000
NODE_205062_length_280_cov_1.828729	45	75	6	9	30	0.3000000
NODE_205062_length_280_cov_1.828729	45	75	8	21	30	0.7000000
NODE_205410_length_280_cov_1.425414	17	50	0	12	33	0.3636364
NODE_205410_length_280_cov_1.425414	17	50	2	21	33	0.6363636
NODE_205410_length_280_cov_1.425414	70	112	2	42	42	1.0000000
NODE_205416_length_280_cov_1.414365	37	97	0	60	60	1.0000000
NODE_205633_length_280_cov_1.187845	56	136	0	80	80	1.0000000
NODE_205635_length_280_cov_1.182320	154	234	2	1	80	0.0125000
NODE_205635_length_280_cov_1.182320	154	234	4	5	80	0.0625000
NODE_205635_length_280_cov_1.182320	154	234	6	74	80	0.9250000
NODE_205635_length_280_cov_1.182320	207	280	0	45	73	0.6164383
NODE_205635_length_280_cov_1.182320	207	280	2	2	73	0.0273973
NODE_205635_length_280_cov_1.182320	207	280	4	5	73	0.0684932
NODE_205635_length_280_cov_1.182320	207	280	6	21	73	0.2876712
NODE_205701_length_280_cov_1.127072	204	265	0	61	61	1.0000000
NODE_205794_length_280_cov_1.127072	0	39	0	39	39	1.0000000
NODE_205801_length_280_cov_1.127072	218	253	0	35	35	1.0000000
NODE_205894_length_280_cov_1.127072	0	59	0	59	59	1.0000000
NODE_206211_length_280_cov_0.911602	176	256	0	80	80	1.0000000
NODE_206211_length_280_cov_0.911602	229	280	0	51	51	1.0000000
NODE_206319_length_280_cov_0.845304	211	268	0	57	57	1.0000000
NODE_206531_length_280_cov_0.779006	129	203	21	23	74	0.3108108
NODE_206531_length_280_cov_0.779006	129	203	23	9	74	0.1216216
NODE_206531_length_280_cov_0.779006	129	203	24	21	74	0.2837838
NODE_206531_length_280_cov_0.779006	129	203	28	21	74	0.2837838
NODE_206721_length_279_cov_50.005556	51	130	54	2	79	0.0253165
NODE_206721_length_279_cov_50.005556	51	130	56	2	79	0.0253165
NODE_206721_length_279_cov_50.005556	51	130	58	21	79	0.2658228
NODE_206721_length_279_cov_50.005556	51	130	60	1	79	0.0126582
NODE_206721_length_279_cov_50.005556	51	130	62	1	79	0.0126582
NODE_206721_length_279_cov_50.005556	51	130	64	3	79	0.0379747
NODE_206721_length_279_cov_50.005556	51	130	66	5	79	0.0632911
NODE_206721_length_279_cov_50.005556	51	130	68	1	79	0.0126582
NODE_206721_length_279_cov_50.005556	51	130	70	3	79	0.0379747
NODE_206721_length_279_cov_50.005556	51	130	74	1	79	0.0126582
NODE_206721_length_279_cov_50.005556	51	130	76	8	79	0.1012658
NODE_206721_length_279_cov_50.005556	51	130	78	4	79	0.0506329
NODE_206721_length_279_cov_50.005556	51	130	82	8	79	0.1012658
NODE_206721_length_279_cov_50.005556	51	130	84	4	79	0.0506329
NODE_206721_length_279_cov_50.005556	51	130	86	11	79	0.1392405
NODE_206721_length_279_cov_50.005556	51	130	88	4	79	0.0506329
NODE_206721_length_279_cov_50.005556	103	179	19	2	76	0.0263158
NODE_206721_length_279_cov_50.005556	103	179	21	3	76	0.0394737
NODE_206721_length_279_cov_50.005556	103	179	23	3	76	0.0394737
NODE_206721_length_279_cov_50.005556	103	179	25	1	76	0.0131579
NODE_206721_length_279_cov_50.005556	103	179	29	2	76	0.0263158
NODE_206721_length_279_cov_50.005556	103	179	35	2	76	0.0263158
NODE_206721_length_279_cov_50.005556	103	179	38	4	76	0.0526316
NODE_206721_length_279_cov_50.005556	103	179	40	13	76	0.1710526
NODE_206721_length_279_cov_50.005556	103	179	42	6	76	0.0789474
NODE_206721_length_279_cov_50.005556	103	179	47	1	76	0.0131579
NODE_206721_length_279_cov_50.005556	103	179	48	5	76	0.0657895
NODE_206721_length_279_cov_50.005556	103	179	50	4	76	0.0526316
NODE_206721_length_279_cov_50.005556	103	179	52	2	76	0.0263158
NODE_206721_length_279_cov_50.005556	103	179	54	2	76	0.0263158
NODE_206721_length_279_cov_50.005556	103	179	60	1	76	0.0131579
NODE_206721_length_279_cov_50.005556	103	179	66	2	76	0.0263158
NODE_206721_length_279_cov_50.005556	103	179	68	1	76	0.0131579
NODE_206721_length_279_cov_50.005556	103	179	70	2	76	0.0263158
NODE_206721_length_279_cov_50.005556	103	179	76	4	76	0.0526316
NODE_206721_length_279_cov_50.005556	103	179	78	1	76	0.0131579
NODE_206721_length_279_cov_50.005556	103	179	82	6	76	0.0789474
NODE_206721_length_279_cov_50.005556	103	179	84	3	76	0.0394737
NODE_206721_length_279_cov_50.005556	103	179	86	2	76	0.0263158
NODE_206721_length_279_cov_50.005556	103	179	88	4	76	0.0526316
NODE_206744_length_279_cov_6.055556	196	228	0	20	32	0.6250000
NODE_206744_length_279_cov_6.055556	196	228	2	8	32	0.2500000
NODE_206744_length_279_cov_6.055556	196	228	4	4	32	0.1250000
NODE_206762_length_279_cov_5.166667	197	277	0	80	80	1.0000000
NODE_206788_length_279_cov_4.427778	107	187	0	13	80	0.1625000
NODE_206788_length_279_cov_4.427778	107	187	2	60	80	0.7500000
NODE_206788_length_279_cov_4.427778	107	187	4	7	80	0.0875000
NODE_206879_length_279_cov_3.200000	205	225	0	20	20	1.0000000
NODE_206886_length_279_cov_3.116667	115	195	0	20	80	0.2500000
NODE_206886_length_279_cov_3.116667	115	195	2	60	80	0.7500000
NODE_206886_length_279_cov_3.116667	168	248	0	46	80	0.5750000
NODE_206886_length_279_cov_3.116667	168	248	2	34	80	0.4250000
NODE_206972_length_279_cov_2.600000	67	147	0	9	80	0.1125000
NODE_206972_length_279_cov_2.600000	67	147	2	71	80	0.8875000
NODE_206972_length_279_cov_2.600000	120	199	0	61	79	0.7721519
NODE_206972_length_279_cov_2.600000	120	199	2	18	79	0.2278481
NODE_207023_length_279_cov_2.427778	155	199	0	44	44	1.0000000
NODE_207052_length_279_cov_2.283333	168	240	1	2	72	0.0277778
NODE_207052_length_279_cov_2.283333	168	240	2	70	72	0.9722222
NODE_207054_length_279_cov_2.277778	190	265	0	41	75	0.5466667
NODE_207054_length_279_cov_2.277778	190	265	2	34	75	0.4533333
NODE_207086_length_279_cov_2.266667	66	109	0	43	43	1.0000000
NODE_207115_length_279_cov_2.255556	115	176	0	60	61	0.9836066
NODE_207115_length_279_cov_2.255556	115	176	2	1	61	0.0163934
NODE_207115_length_279_cov_2.255556	168	222	0	54	54	1.0000000
NODE_207155_length_279_cov_2.200000	57	104	2	14	47	0.2978723
NODE_207155_length_279_cov_2.200000	57	104	4	5	47	0.1063830
NODE_207155_length_279_cov_2.200000	57	104	6	28	47	0.5957447
NODE_207269_length_279_cov_1.977778	0	62	0	62	62	1.0000000
NODE_207293_length_279_cov_1.944444	63	105	0	42	42	1.0000000
NODE_207306_length_279_cov_1.916667	182	262	0	80	80	1.0000000
NODE_207318_length_279_cov_1.866667	63	143	0	4	80	0.0500000
NODE_207318_length_279_cov_1.866667	63	143	27	24	80	0.3000000
NODE_207318_length_279_cov_1.866667	63	143	31	15	80	0.1875000
NODE_207318_length_279_cov_1.866667	63	143	32	2	80	0.0250000
NODE_207318_length_279_cov_1.866667	63	143	38	35	80	0.4375000
NODE_207387_length_279_cov_1.700000	8	37	0	29	29	1.0000000
NODE_207389_length_279_cov_1.700000	10	42	0	32	32	1.0000000
NODE_207534_length_279_cov_1.672222	103	183	0	80	80	1.0000000
NODE_207641_length_279_cov_1.433333	51	110	0	59	59	1.0000000
NODE_207641_length_279_cov_1.433333	83	119	0	36	36	1.0000000
NODE_207929_length_279_cov_1.144444	146	211	2	41	65	0.6307693
NODE_207929_length_279_cov_1.144444	146	211	6	24	65	0.3692308
NODE_207929_length_279_cov_1.144444	184	266	2	3	82	0.0365854
NODE_207929_length_279_cov_1.144444	184	266	4	29	82	0.3536585
NODE_207929_length_279_cov_1.144444	184	266	6	50	82	0.6097561
NODE_207931_length_279_cov_1.138889	125	188	212	1	63	0.0158730
NODE_207931_length_279_cov_1.138889	125	188	229	1	63	0.0158730
NODE_207931_length_279_cov_1.138889	125	188	231	2	63	0.0317460
NODE_207931_length_279_cov_1.138889	125	188	232	1	63	0.0158730
NODE_207931_length_279_cov_1.138889	125	188	236	1	63	0.0158730
NODE_207931_length_279_cov_1.138889	125	188	237	2	63	0.0317460
NODE_207931_length_279_cov_1.138889	125	188	239	2	63	0.0317460
NODE_207931_length_279_cov_1.138889	125	188	242	1	63	0.0158730
NODE_207931_length_279_cov_1.138889	125	188	247	1	63	0.0158730
NODE_207931_length_279_cov_1.138889	125	188	248	2	63	0.0317460
NODE_207931_length_279_cov_1.138889	125	188	251	2	63	0.0317460
NODE_207931_length_279_cov_1.138889	125	188	252	2	63	0.0317460
NODE_207931_length_279_cov_1.138889	125	188	253	2	63	0.0317460
NODE_207931_length_279_cov_1.138889	125	188	254	2	63	0.0317460
NODE_207931_length_279_cov_1.138889	125	188	255	3	63	0.0476190
NODE_207931_length_279_cov_1.138889	125	188	256	1	63	0.0158730
NODE_207931_length_279_cov_1.138889	125	188	257	1	63	0.0158730
NODE_207931_length_279_cov_1.138889	125	188	258	2	63	0.0317460
NODE_207931_length_279_cov_1.138889	125	188	259	1	63	0.0158730
NODE_207931_length_279_cov_1.138889	125	188	260	1	63	0.0158730
NODE_207931_length_279_cov_1.138889	125	188	261	4	63	0.0634921
NODE_207931_length_279_cov_1.138889	125	188	266	2	63	0.0317460
NODE_207931_length_279_cov_1.138889	125	188	268	6	63	0.0952381
NODE_207931_length_279_cov_1.138889	125	188	269	3	63	0.0476190
NODE_207931_length_279_cov_1.138889	125	188	270	5	63	0.0793651
NODE_207931_length_279_cov_1.138889	125	188	271	1	63	0.0158730
NODE_207931_length_279_cov_1.138889	125	188	272	1	63	0.0158730
NODE_207931_length_279_cov_1.138889	125	188	273	4	63	0.0634921
NODE_207931_length_279_cov_1.138889	125	188	274	4	63	0.0634921
NODE_207931_length_279_cov_1.138889	125	188	275	1	63	0.0158730
NODE_207931_length_279_cov_1.138889	125	188	276	1	63	0.0158730
NODE_207932_length_279_cov_1.138889	111	191	0	80	80	1.0000000
NODE_207948_length_279_cov_1.133333	231	271	0	40	40	1.0000000
NODE_208183_length_279_cov_1.116667	15	92	2	4	77	0.0519481
NODE_208183_length_279_cov_1.116667	15	92	4	4	77	0.0519481
NODE_208183_length_279_cov_1.116667	15	92	6	69	77	0.8961039
NODE_208334_length_279_cov_0.988889	181	261	2	80	80	1.0000000
NODE_208410_length_279_cov_0.927778	50	69	0	19	19	1.0000000
NODE_208410_length_279_cov_0.927778	50	69	0	19	19	1.0000000
NODE_208664_length_279_cov_0.844444	35	70	2	35	35	1.0000000
NODE_209293_length_278_cov_44.882682	158	210	10	6	52	0.1153846
NODE_209293_length_278_cov_44.882682	158	210	12	7	52	0.1346154
NODE_209293_length_278_cov_44.882682	158	210	14	1	52	0.0192308
NODE_209293_length_278_cov_44.882682	158	210	16	6	52	0.1153846
NODE_209293_length_278_cov_44.882682	158	210	18	2	52	0.0384615
NODE_209293_length_278_cov_44.882682	158	210	20	15	52	0.2884615
NODE_209293_length_278_cov_44.882682	158	210	22	3	52	0.0576923
NODE_209293_length_278_cov_44.882682	158	210	25	1	52	0.0192308
NODE_209293_length_278_cov_44.882682	158	210	32	7	52	0.1346154
NODE_209293_length_278_cov_44.882682	158	210	38	1	52	0.0192308
NODE_209293_length_278_cov_44.882682	158	210	41	3	52	0.0576923
NODE_209293_length_278_cov_44.882682	206	232	6	3	26	0.1153846
NODE_209293_length_278_cov_44.882682	206	232	8	11	26	0.4230769
NODE_209293_length_278_cov_44.882682	206	232	10	12	26	0.4615385
NODE_209293_length_278_cov_44.882682	206	265	2	21	59	0.3559322
NODE_209293_length_278_cov_44.882682	206	265	4	1	59	0.0169492
NODE_209293_length_278_cov_44.882682	206	265	6	14	59	0.2372881
NODE_209293_length_278_cov_44.882682	206	265	8	11	59	0.1864407
NODE_209293_length_278_cov_44.882682	206	265	10	12	59	0.2033898
NODE_209294_length_278_cov_37.474860	0	52	0	52	52	1.0000000
NODE_209294_length_278_cov_37.474860	48	128	0	80	80	1.0000000
NODE_209294_length_278_cov_37.474860	101	181	0	80	80	1.0000000
NODE_209295_length_278_cov_21.340782	84	164	0	19	80	0.2375000
NODE_209295_length_278_cov_21.340782	84	164	2	61	80	0.7625000
NODE_209295_length_278_cov_21.340782	137	217	0	13	80	0.1625000
NODE_209295_length_278_cov_21.340782	137	217	2	67	80	0.8375000
NODE_209360_length_278_cov_4.156425	132	210	4	17	78	0.2179487
NODE_209360_length_278_cov_4.156425	132	210	6	18	78	0.2307692
NODE_209360_length_278_cov_4.156425	132	210	8	32	78	0.4102564
NODE_209360_length_278_cov_4.156425	132	210	10	3	78	0.0384615
NODE_209360_length_278_cov_4.156425	132	210	14	8	78	0.1025641
NODE_209360_length_278_cov_4.156425	193	263	4	4	70	0.0571429
NODE_209360_length_278_cov_4.156425	193	263	6	66	70	0.9428571
NODE_209372_length_278_cov_3.977654	142	221	0	62	79	0.7848101
NODE_209372_length_278_cov_3.977654	142	221	2	17	79	0.2151899
NODE_209378_length_278_cov_3.865922	168	210	0	42	42	1.0000000
NODE_209552_length_278_cov_2.558659	93	123	0	30	30	1.0000000
NODE_209565_length_278_cov_2.513966	54	106	2	52	52	1.0000000
NODE_209565_length_278_cov_2.513966	79	158	2	75	79	0.9493671
NODE_209565_length_278_cov_2.513966	79	158	4	4	79	0.0506329
NODE_209605_length_278_cov_2.296089	127	207	0	80	80	1.0000000
NODE_209883_length_278_cov_1.731844	145	194	25	3	49	0.0612245
NODE_209883_length_278_cov_1.731844	145	194	29	3	49	0.0612245
NODE_209883_length_278_cov_1.731844	145	194	31	9	49	0.1836735
NODE_209883_length_278_cov_1.731844	145	194	33	2	49	0.0408163
NODE_209883_length_278_cov_1.731844	145	194	35	1	49	0.0204082
NODE_209883_length_278_cov_1.731844	145	194	36	1	49	0.0204082
NODE_209883_length_278_cov_1.731844	145	194	38	1	49	0.0204082
NODE_209883_length_278_cov_1.731844	145	194	40	1	49	0.0204082
NODE_209883_length_278_cov_1.731844	145	194	44	1	49	0.0204082
NODE_209883_length_278_cov_1.731844	145	194	46	17	49	0.3469388
NODE_209883_length_278_cov_1.731844	145	194	47	1	49	0.0204082
NODE_209883_length_278_cov_1.731844	145	194	48	1	49	0.0204082
NODE_209883_length_278_cov_1.731844	145	194	50	2	49	0.0408163
NODE_209883_length_278_cov_1.731844	145	194	52	6	49	0.1224490
NODE_210038_length_278_cov_1.681564	129	184	0	29	55	0.5272727
NODE_210038_length_278_cov_1.681564	129	184	2	26	55	0.4727273
NODE_210068_length_278_cov_1.636872	13	41	16	2	28	0.0714286
NODE_210068_length_278_cov_1.636872	13	41	20	2	28	0.0714286
NODE_210068_length_278_cov_1.636872	13	41	22	24	28	0.8571429
NODE_210373_length_278_cov_1.290503	3	67	24	1	64	0.0156250
NODE_210373_length_278_cov_1.290503	3	67	29	7	64	0.1093750
NODE_210373_length_278_cov_1.290503	3	67	34	9	64	0.1406250
NODE_210373_length_278_cov_1.290503	3	67	36	1	64	0.0156250
NODE_210373_length_278_cov_1.290503	3	67	38	1	64	0.0156250
NODE_210373_length_278_cov_1.290503	3	67	44	1	64	0.0156250
NODE_210373_length_278_cov_1.290503	3	67	46	2	64	0.0312500
NODE_210373_length_278_cov_1.290503	3	67	48	6	64	0.0937500
NODE_210373_length_278_cov_1.290503	3	67	50	3	64	0.0468750
NODE_210373_length_278_cov_1.290503	3	67	52	4	64	0.0625000
NODE_210373_length_278_cov_1.290503	3	67	53	3	64	0.0468750
NODE_210373_length_278_cov_1.290503	3	67	55	2	64	0.0312500
NODE_210373_length_278_cov_1.290503	3	67	57	9	64	0.1406250
NODE_210373_length_278_cov_1.290503	3	67	58	2	64	0.0312500
NODE_210373_length_278_cov_1.290503	3	67	60	12	64	0.1875000
NODE_210373_length_278_cov_1.290503	3	67	62	1	64	0.0156250
NODE_210373_length_278_cov_1.290503	3	67	24	1	64	0.0156250
NODE_210373_length_278_cov_1.290503	3	67	29	7	64	0.1093750
NODE_210373_length_278_cov_1.290503	3	67	34	9	64	0.1406250
NODE_210373_length_278_cov_1.290503	3	67	36	1	64	0.0156250
NODE_210373_length_278_cov_1.290503	3	67	38	1	64	0.0156250
NODE_210373_length_278_cov_1.290503	3	67	44	1	64	0.0156250
NODE_210373_length_278_cov_1.290503	3	67	46	2	64	0.0312500
NODE_210373_length_278_cov_1.290503	3	67	48	6	64	0.0937500
NODE_210373_length_278_cov_1.290503	3	67	50	3	64	0.0468750
NODE_210373_length_278_cov_1.290503	3	67	52	4	64	0.0625000
NODE_210373_length_278_cov_1.290503	3	67	53	3	64	0.0468750
NODE_210373_length_278_cov_1.290503	3	67	55	2	64	0.0312500
NODE_210373_length_278_cov_1.290503	3	67	57	9	64	0.1406250
NODE_210373_length_278_cov_1.290503	3	67	58	2	64	0.0312500
NODE_210373_length_278_cov_1.290503	3	67	60	12	64	0.1875000
NODE_210373_length_278_cov_1.290503	3	67	62	1	64	0.0156250
NODE_210373_length_278_cov_1.290503	3	67	24	1	64	0.0156250
NODE_210373_length_278_cov_1.290503	3	67	29	7	64	0.1093750
NODE_210373_length_278_cov_1.290503	3	67	34	9	64	0.1406250
NODE_210373_length_278_cov_1.290503	3	67	36	1	64	0.0156250
NODE_210373_length_278_cov_1.290503	3	67	38	1	64	0.0156250
NODE_210373_length_278_cov_1.290503	3	67	44	1	64	0.0156250
NODE_210373_length_278_cov_1.290503	3	67	46	2	64	0.0312500
NODE_210373_length_278_cov_1.290503	3	67	48	6	64	0.0937500
NODE_210373_length_278_cov_1.290503	3	67	50	3	64	0.0468750
NODE_210373_length_278_cov_1.290503	3	67	52	4	64	0.0625000
NODE_210373_length_278_cov_1.290503	3	67	53	3	64	0.0468750
NODE_210373_length_278_cov_1.290503	3	67	55	2	64	0.0312500
NODE_210373_length_278_cov_1.290503	3	67	57	9	64	0.1406250
NODE_210373_length_278_cov_1.290503	3	67	58	2	64	0.0312500
NODE_210373_length_278_cov_1.290503	3	67	60	12	64	0.1875000
NODE_210373_length_278_cov_1.290503	3	67	62	1	64	0.0156250
NODE_210463_length_278_cov_1.150838	52	76	12	24	24	1.0000000
NODE_210463_length_278_cov_1.150838	58	84	12	26	26	1.0000000
NODE_210559_length_278_cov_1.139665	108	187	0	10	79	0.1265823
NODE_210559_length_278_cov_1.139665	108	187	2	53	79	0.6708861
NODE_210559_length_278_cov_1.139665	108	187	4	7	79	0.0886076
NODE_210559_length_278_cov_1.139665	108	187	6	9	79	0.1139240
NODE_210612_length_278_cov_1.139665	232	278	0	46	46	1.0000000
NODE_210691_length_278_cov_1.139665	210	278	0	68	68	1.0000000
NODE_212166_length_277_cov_2.691011	0	60	0	60	60	1.0000000
NODE_212166_length_277_cov_2.691011	33	113	0	80	80	1.0000000
NODE_212175_length_277_cov_2.617978	85	127	0	42	42	1.0000000
NODE_212233_length_277_cov_2.438202	137	218	4	1	81	0.0123457
NODE_212233_length_277_cov_2.438202	137	218	8	59	81	0.7283950
NODE_212233_length_277_cov_2.438202	137	218	10	8	81	0.0987654
NODE_212233_length_277_cov_2.438202	137	218	12	13	81	0.1604938
NODE_212357_length_277_cov_2.140449	234	276	0	42	42	1.0000000
NODE_212377_length_277_cov_2.095506	41	114	0	73	73	1.0000000
NODE_212377_length_277_cov_2.095506	41	114	0	73	73	1.0000000
NODE_212377_length_277_cov_2.095506	94	161	0	67	67	1.0000000
NODE_212525_length_277_cov_1.837079	92	172	0	80	80	1.0000000
NODE_212558_length_277_cov_1.764045	115	155	2	32	40	0.8000000
NODE_212558_length_277_cov_1.764045	115	155	4	8	40	0.2000000
NODE_212605_length_277_cov_1.719101	150	215	0	10	65	0.1538462
NODE_212605_length_277_cov_1.719101	150	215	2	55	65	0.8461539
NODE_212845_length_277_cov_1.505618	0	47	4	1	47	0.0212766
NODE_212845_length_277_cov_1.505618	0	47	6	46	47	0.9787234
NODE_212845_length_277_cov_1.505618	20	100	2	13	80	0.1625000
NODE_212845_length_277_cov_1.505618	20	100	4	1	80	0.0125000
NODE_212845_length_277_cov_1.505618	20	100	6	66	80	0.8250000
NODE_212970_length_277_cov_1.426966	113	191	0	31	78	0.3974359
NODE_212970_length_277_cov_1.426966	113	191	2	1	78	0.0128205
NODE_212970_length_277_cov_1.426966	113	191	4	34	78	0.4358974
NODE_212970_length_277_cov_1.426966	113	191	6	3	78	0.0384615
NODE_212970_length_277_cov_1.426966	113	191	8	9	78	0.1153846
NODE_213057_length_277_cov_1.314607	127	176	4	49	49	1.0000000
NODE_213091_length_277_cov_1.258427	141	222	0	68	81	0.8395061
NODE_213091_length_277_cov_1.258427	141	222	2	13	81	0.1604938
NODE_213223_length_277_cov_1.146067	19	95	6	6	76	0.0789474
NODE_213223_length_277_cov_1.146067	19	95	8	9	76	0.1184211
NODE_213223_length_277_cov_1.146067	19	95	10	18	76	0.2368421
NODE_213223_length_277_cov_1.146067	19	95	12	6	76	0.0789474
NODE_213223_length_277_cov_1.146067	19	95	13	16	76	0.2105263
NODE_213223_length_277_cov_1.146067	19	95	14	9	76	0.1184211
NODE_213223_length_277_cov_1.146067	19	95	16	10	76	0.1315790
NODE_213223_length_277_cov_1.146067	19	95	18	1	76	0.0131579
NODE_213223_length_277_cov_1.146067	19	95	20	1	76	0.0131579
NODE_213490_length_277_cov_1.061798	67	105	0	38	38	1.0000000
NODE_213505_length_277_cov_1.044944	19	77	0	58	58	1.0000000
NODE_214572_length_276_cov_31.774011	91	153	8	1	62	0.0161290
NODE_214572_length_276_cov_31.774011	91	153	9	3	62	0.0483871
NODE_214572_length_276_cov_31.774011	91	153	10	1	62	0.0161290
NODE_214572_length_276_cov_31.774011	91	153	14	3	62	0.0483871
NODE_214572_length_276_cov_31.774011	91	153	15	5	62	0.0806452
NODE_214572_length_276_cov_31.774011	91	153	17	1	62	0.0161290
NODE_214572_length_276_cov_31.774011	91	153	21	6	62	0.0967742
NODE_214572_length_276_cov_31.774011	91	153	22	1	62	0.0161290
NODE_214572_length_276_cov_31.774011	91	153	24	2	62	0.0322581
NODE_214572_length_276_cov_31.774011	91	153	25	1	62	0.0161290
NODE_214572_length_276_cov_31.774011	91	153	28	2	62	0.0322581
NODE_214572_length_276_cov_31.774011	91	153	30	1	62	0.0161290
NODE_214572_length_276_cov_31.774011	91	153	31	1	62	0.0161290
NODE_214572_length_276_cov_31.774011	91	153	33	1	62	0.0161290
NODE_214572_length_276_cov_31.774011	91	153	43	1	62	0.0161290
NODE_214572_length_276_cov_31.774011	91	153	45	1	62	0.0161290
NODE_214572_length_276_cov_31.774011	91	153	50	1	62	0.0161290
NODE_214572_length_276_cov_31.774011	91	153	57	1	62	0.0161290
NODE_214572_length_276_cov_31.774011	91	153	59	1	62	0.0161290
NODE_214572_length_276_cov_31.774011	91	153	65	2	62	0.0322581
NODE_214572_length_276_cov_31.774011	91	153	67	3	62	0.0483871
NODE_214572_length_276_cov_31.774011	91	153	69	5	62	0.0806452
NODE_214572_length_276_cov_31.774011	91	153	71	3	62	0.0483871
NODE_214572_length_276_cov_31.774011	91	153	73	1	62	0.0161290
NODE_214572_length_276_cov_31.774011	91	153	75	6	62	0.0967742
NODE_214572_length_276_cov_31.774011	91	153	77	7	62	0.1129032
NODE_214572_length_276_cov_31.774011	91	153	78	1	62	0.0161290
NODE_214576_length_276_cov_10.056497	66	146	0	6	80	0.0750000
NODE_214576_length_276_cov_10.056497	66	146	5	28	80	0.3500000
NODE_214576_length_276_cov_10.056497	66	146	7	9	80	0.1125000
NODE_214576_length_276_cov_10.056497	66	146	9	21	80	0.2625000
NODE_214576_length_276_cov_10.056497	66	146	13	16	80	0.2000000
NODE_214698_length_276_cov_3.564972	176	256	0	6	80	0.0750000
NODE_214698_length_276_cov_3.564972	176	256	1	32	80	0.4000000
NODE_214698_length_276_cov_3.564972	176	256	2	23	80	0.2875000
NODE_214698_length_276_cov_3.564972	176	256	4	19	80	0.2375000
NODE_214785_length_276_cov_2.920904	203	260	0	57	57	1.0000000
NODE_214785_length_276_cov_2.920904	233	276	0	43	43	1.0000000
NODE_214883_length_276_cov_2.542373	164	204	10	18	40	0.4500000
NODE_214883_length_276_cov_2.542373	164	204	12	9	40	0.2250000
NODE_214883_length_276_cov_2.542373	164	204	13	10	40	0.2500000
NODE_214883_length_276_cov_2.542373	164	204	14	3	40	0.0750000
NODE_215016_length_276_cov_2.197740	64	144	6	19	80	0.2375000
NODE_215016_length_276_cov_2.197740	64	144	10	58	80	0.7250000
NODE_215016_length_276_cov_2.197740	64	144	12	3	80	0.0375000
NODE_215086_length_276_cov_2.022599	136	193	0	11	57	0.1929825
NODE_215086_length_276_cov_2.022599	136	193	2	46	57	0.8070176
NODE_215105_length_276_cov_2.016949	97	138	0	41	41	1.0000000
NODE_215139_length_276_cov_2.005650	82	153	0	63	71	0.8873239
NODE_215139_length_276_cov_2.005650	82	153	2	8	71	0.1126761
NODE_215234_length_276_cov_1.734463	102	182	12	1	80	0.0125000
NODE_215234_length_276_cov_1.734463	102	182	16	2	80	0.0250000
NODE_215234_length_276_cov_1.734463	102	182	18	3	80	0.0375000
NODE_215234_length_276_cov_1.734463	102	182	20	2	80	0.0250000
NODE_215234_length_276_cov_1.734463	102	182	24	1	80	0.0125000
NODE_215234_length_276_cov_1.734463	102	182	28	2	80	0.0250000
NODE_215234_length_276_cov_1.734463	102	182	32	2	80	0.0250000
NODE_215234_length_276_cov_1.734463	102	182	34	4	80	0.0500000
NODE_215234_length_276_cov_1.734463	102	182	36	1	80	0.0125000
NODE_215234_length_276_cov_1.734463	102	182	38	2	80	0.0250000
NODE_215234_length_276_cov_1.734463	102	182	40	1	80	0.0125000
NODE_215234_length_276_cov_1.734463	102	182	44	4	80	0.0500000
NODE_215234_length_276_cov_1.734463	102	182	46	2	80	0.0250000
NODE_215234_length_276_cov_1.734463	102	182	50	1	80	0.0125000
NODE_215234_length_276_cov_1.734463	102	182	51	1	80	0.0125000
NODE_215234_length_276_cov_1.734463	102	182	53	1	80	0.0125000
NODE_215234_length_276_cov_1.734463	102	182	55	1	80	0.0125000
NODE_215234_length_276_cov_1.734463	102	182	63	5	80	0.0625000
NODE_215234_length_276_cov_1.734463	102	182	65	9	80	0.1125000
NODE_215234_length_276_cov_1.734463	102	182	67	4	80	0.0500000
NODE_215234_length_276_cov_1.734463	102	182	69	3	80	0.0375000
NODE_215234_length_276_cov_1.734463	102	182	74	16	80	0.2000000
NODE_215234_length_276_cov_1.734463	102	182	76	2	80	0.0250000
NODE_215234_length_276_cov_1.734463	102	182	78	10	80	0.1250000
NODE_215516_length_276_cov_1.525424	70	116	0	46	46	1.0000000
NODE_215516_length_276_cov_1.525424	123	169	0	46	46	1.0000000
NODE_215519_length_276_cov_1.514124	115	155	30	1	40	0.0250000
NODE_215519_length_276_cov_1.514124	115	155	32	39	40	0.9750000
NODE_215748_length_276_cov_1.288136	114	154	4	30	40	0.7500000
NODE_215748_length_276_cov_1.288136	114	154	6	10	40	0.2500000
NODE_216141_length_276_cov_1.124294	122	170	0	48	48	1.0000000
NODE_216141_length_276_cov_1.124294	132	163	0	31	31	1.0000000
NODE_216220_length_276_cov_1.039548	7	68	0	12	61	0.1967213
NODE_216220_length_276_cov_1.039548	7	68	2	49	61	0.8032787
NODE_216220_length_276_cov_1.039548	7	70	0	12	63	0.1904762
NODE_216220_length_276_cov_1.039548	7	70	2	51	63	0.8095238
NODE_216220_length_276_cov_1.039548	7	70	0	12	63	0.1904762
NODE_216220_length_276_cov_1.039548	7	70	2	51	63	0.8095238
NODE_216220_length_276_cov_1.039548	7	70	0	12	63	0.1904762
NODE_216220_length_276_cov_1.039548	7	70	2	51	63	0.8095238
NODE_216269_length_276_cov_1.000000	48	89	2	5	41	0.1219512
NODE_216269_length_276_cov_1.000000	48	89	4	36	41	0.8780488
NODE_216269_length_276_cov_1.000000	62	106	2	22	44	0.5000000
NODE_216269_length_276_cov_1.000000	62	106	4	22	44	0.5000000
NODE_216414_length_276_cov_0.898305	54	105	0	51	51	1.0000000
NODE_217265_length_275_cov_85.085227	94	174	0	21	80	0.2625000
NODE_217265_length_275_cov_85.085227	94	174	2	14	80	0.1750000
NODE_217265_length_275_cov_85.085227	94	174	4	45	80	0.5625000
NODE_217265_length_275_cov_85.085227	147	227	0	74	80	0.9250000
NODE_217265_length_275_cov_85.085227	147	227	2	6	80	0.0750000
NODE_217287_length_275_cov_5.818182	0	44	0	44	44	1.0000000
NODE_217355_length_275_cov_3.857955	0	67	0	67	67	1.0000000
NODE_217396_length_275_cov_3.306818	199	275	0	76	76	1.0000000
NODE_217402_length_275_cov_3.284091	127	175	0	48	48	1.0000000
NODE_217433_length_275_cov_2.977273	95	145	2	17	50	0.3400000
NODE_217433_length_275_cov_2.977273	95	145	4	33	50	0.6600000
NODE_217531_length_275_cov_2.585227	85	122	63	2	37	0.0540541
NODE_217531_length_275_cov_2.585227	85	122	64	21	37	0.5675676
NODE_217531_length_275_cov_2.585227	85	122	65	7	37	0.1891892
NODE_217531_length_275_cov_2.585227	85	122	68	7	37	0.1891892
NODE_217714_length_275_cov_2.090909	0	47	2	47	47	1.0000000
NODE_217714_length_275_cov_2.090909	20	91	2	71	71	1.0000000
NODE_217801_length_275_cov_1.960227	198	251	4	53	53	1.0000000
NODE_217835_length_275_cov_1.875000	190	247	2	57	57	1.0000000
NODE_217839_length_275_cov_1.857955	52	119	0	4	67	0.0597015
NODE_217839_length_275_cov_1.857955	52	119	2	39	67	0.5820895
NODE_217839_length_275_cov_1.857955	52	119	4	24	67	0.3582090
NODE_217839_length_275_cov_1.857955	136	182	0	12	46	0.2608696
NODE_217839_length_275_cov_1.857955	136	182	2	22	46	0.4782609
NODE_217839_length_275_cov_1.857955	136	182	4	12	46	0.2608696
NODE_217885_length_275_cov_1.755682	21	76	0	55	55	1.0000000
NODE_217912_length_275_cov_1.738636	225	256	0	31	31	1.0000000
NODE_217967_length_275_cov_1.738636	161	241	2	25	80	0.3125000
NODE_217967_length_275_cov_1.738636	161	241	4	55	80	0.6875000
NODE_218257_length_275_cov_1.448864	123	155	14	32	32	1.0000000
NODE_218402_length_275_cov_1.301136	132	196	0	64	64	1.0000000
NODE_218706_length_275_cov_1.159091	13	93	2	14	80	0.1750000
NODE_218706_length_275_cov_1.159091	13	93	4	66	80	0.8250000
NODE_218734_length_275_cov_1.153409	11	91	0	80	80	1.0000000
NODE_219031_length_275_cov_0.937500	13	49	23	8	36	0.2222222
NODE_219031_length_275_cov_0.937500	13	49	25	2	36	0.0555556
NODE_219031_length_275_cov_0.937500	13	49	27	5	36	0.1388889
NODE_219031_length_275_cov_0.937500	13	49	31	2	36	0.0555556
NODE_219031_length_275_cov_0.937500	13	49	33	3	36	0.0833333
NODE_219031_length_275_cov_0.937500	13	49	35	1	36	0.0277778
NODE_219031_length_275_cov_0.937500	13	49	37	3	36	0.0833333
NODE_219031_length_275_cov_0.937500	13	49	39	3	36	0.0833333
NODE_219031_length_275_cov_0.937500	13	49	41	3	36	0.0833333
NODE_219031_length_275_cov_0.937500	13	49	44	1	36	0.0277778
NODE_219031_length_275_cov_0.937500	13	49	46	5	36	0.1388889
NODE_219031_length_275_cov_0.937500	22	86	25	1	64	0.0156250
NODE_219031_length_275_cov_0.937500	22	86	27	5	64	0.0781250
NODE_219031_length_275_cov_0.937500	22	86	31	2	64	0.0312500
NODE_219031_length_275_cov_0.937500	22	86	33	3	64	0.0468750
NODE_219031_length_275_cov_0.937500	22	86	35	1	64	0.0156250
NODE_219031_length_275_cov_0.937500	22	86	37	3	64	0.0468750
NODE_219031_length_275_cov_0.937500	22	86	39	3	64	0.0468750
NODE_219031_length_275_cov_0.937500	22	86	41	3	64	0.0468750
NODE_219031_length_275_cov_0.937500	22	86	44	1	64	0.0156250
NODE_219031_length_275_cov_0.937500	22	86	46	8	64	0.1250000
NODE_219031_length_275_cov_0.937500	22	86	47	2	64	0.0312500
NODE_219031_length_275_cov_0.937500	22	86	48	4	64	0.0625000
NODE_219031_length_275_cov_0.937500	22	86	50	1	64	0.0156250
NODE_219031_length_275_cov_0.937500	22	86	56	6	64	0.0937500
NODE_219031_length_275_cov_0.937500	22	86	58	13	64	0.2031250
NODE_219031_length_275_cov_0.937500	22	86	66	1	64	0.0156250
NODE_219031_length_275_cov_0.937500	22	86	68	1	64	0.0156250
NODE_219031_length_275_cov_0.937500	22	86	74	1	64	0.0156250
NODE_219031_length_275_cov_0.937500	22	86	75	2	64	0.0312500
NODE_219031_length_275_cov_0.937500	22	86	77	1	64	0.0156250
NODE_219031_length_275_cov_0.937500	22	86	79	2	64	0.0312500
NODE_219220_length_275_cov_0.869318	67	126	0	59	59	1.0000000
NODE_219655_length_275_cov_0.579545	40	70	0	30	30	1.0000000
NODE_220021_length_274_cov_6.074286	141	175	2	34	34	1.0000000
NODE_220047_length_274_cov_4.845714	48	105	0	57	57	1.0000000
NODE_220047_length_274_cov_4.845714	113	175	0	62	62	1.0000000
NODE_220078_length_274_cov_4.080000	210	274	0	64	64	1.0000000
NODE_220215_length_274_cov_2.988571	104	161	2	57	57	1.0000000
NODE_220221_length_274_cov_2.937143	199	234	0	35	35	1.0000000
NODE_220293_length_274_cov_2.622857	29	76	4	1	47	0.0212766
NODE_220293_length_274_cov_2.622857	29	76	6	46	47	0.9787234
NODE_220293_length_274_cov_2.622857	82	157	0	70	75	0.9333333
NODE_220293_length_274_cov_2.622857	82	157	2	5	75	0.0666667
NODE_220413_length_274_cov_2.308571	51	130	8	3	79	0.0379747
NODE_220413_length_274_cov_2.308571	51	130	10	2	79	0.0253165
NODE_220413_length_274_cov_2.308571	51	130	14	5	79	0.0632911
NODE_220413_length_274_cov_2.308571	51	130	20	4	79	0.0506329
NODE_220413_length_274_cov_2.308571	51	130	26	4	79	0.0506329
NODE_220413_length_274_cov_2.308571	51	130	28	1	79	0.0126582
NODE_220413_length_274_cov_2.308571	51	130	34	2	79	0.0253165
NODE_220413_length_274_cov_2.308571	51	130	35	1	79	0.0126582
NODE_220413_length_274_cov_2.308571	51	130	38	1	79	0.0126582
NODE_220413_length_274_cov_2.308571	51	130	41	3	79	0.0379747
NODE_220413_length_274_cov_2.308571	51	130	43	2	79	0.0253165
NODE_220413_length_274_cov_2.308571	51	130	45	1	79	0.0126582
NODE_220413_length_274_cov_2.308571	51	130	55	1	79	0.0126582
NODE_220413_length_274_cov_2.308571	51	130	57	1	79	0.0126582
NODE_220413_length_274_cov_2.308571	51	130	59	3	79	0.0379747
NODE_220413_length_274_cov_2.308571	51	130	62	3	79	0.0379747
NODE_220413_length_274_cov_2.308571	51	130	64	1	79	0.0126582
NODE_220413_length_274_cov_2.308571	51	130	66	5	79	0.0632911
NODE_220413_length_274_cov_2.308571	51	130	68	2	79	0.0253165
NODE_220413_length_274_cov_2.308571	51	130	72	5	79	0.0632911
NODE_220413_length_274_cov_2.308571	51	130	74	1	79	0.0126582
NODE_220413_length_274_cov_2.308571	51	130	78	3	79	0.0379747
NODE_220413_length_274_cov_2.308571	51	130	80	1	79	0.0126582
NODE_220413_length_274_cov_2.308571	51	130	82	2	79	0.0253165
NODE_220413_length_274_cov_2.308571	51	130	84	2	79	0.0253165
NODE_220413_length_274_cov_2.308571	51	130	85	2	79	0.0253165
NODE_220413_length_274_cov_2.308571	51	130	86	4	79	0.0506329
NODE_220413_length_274_cov_2.308571	51	130	87	1	79	0.0126582
NODE_220413_length_274_cov_2.308571	51	130	88	7	79	0.0886076
NODE_220413_length_274_cov_2.308571	51	130	89	6	79	0.0759494
NODE_220504_length_274_cov_2.062857	172	242	0	39	70	0.5571429
NODE_220504_length_274_cov_2.062857	172	242	2	31	70	0.4428571
NODE_220504_length_274_cov_2.062857	215	256	0	41	41	1.0000000
NODE_220662_length_274_cov_1.754286	219	259	2	40	40	1.0000000
NODE_220681_length_274_cov_1.748571	168	231	0	22	63	0.3492064
NODE_220681_length_274_cov_1.748571	168	231	2	41	63	0.6507937
NODE_220806_length_274_cov_1.737143	134	172	0	38	38	1.0000000
NODE_220847_length_274_cov_1.685714	132	189	2	4	57	0.0701754
NODE_220847_length_274_cov_1.685714	132	189	4	53	57	0.9298246
NODE_220847_length_274_cov_1.685714	141	199	2	14	58	0.2413793
NODE_220847_length_274_cov_1.685714	141	199	4	44	58	0.7586207
NODE_220966_length_274_cov_1.502857	170	232	0	62	62	1.0000000
NODE_220966_length_274_cov_1.502857	223	274	0	51	51	1.0000000
NODE_221005_length_274_cov_1.457143	118	147	0	29	29	1.0000000
NODE_221101_length_274_cov_1.434286	25	69	0	44	44	1.0000000
NODE_221211_length_274_cov_1.285714	84	156	0	72	72	1.0000000
NODE_221612_length_274_cov_1.131429	205	251	0	3	46	0.0652174
NODE_221612_length_274_cov_1.131429	205	251	2	41	46	0.8913044
NODE_221612_length_274_cov_1.131429	205	251	4	2	46	0.0434783
NODE_221764_length_274_cov_0.994286	219	260	0	41	41	1.0000000
NODE_222849_length_273_cov_4.948276	204	262	0	21	58	0.3620690
NODE_222849_length_273_cov_4.948276	204	262	2	37	58	0.6379310
NODE_222849_length_273_cov_4.948276	204	258	0	17	54	0.3148148
NODE_222849_length_273_cov_4.948276	204	258	2	37	54	0.6851852
NODE_222914_length_273_cov_3.712644	103	183	2	2	80	0.0250000
NODE_222914_length_273_cov_3.712644	103	183	8	1	80	0.0125000
NODE_222914_length_273_cov_3.712644	103	183	10	1	80	0.0125000
NODE_222914_length_273_cov_3.712644	103	183	11	1	80	0.0125000
NODE_222914_length_273_cov_3.712644	103	183	13	7	80	0.0875000
NODE_222914_length_273_cov_3.712644	103	183	14	2	80	0.0250000
NODE_222914_length_273_cov_3.712644	103	183	15	1	80	0.0125000
NODE_222914_length_273_cov_3.712644	103	183	17	3	80	0.0375000
NODE_222914_length_273_cov_3.712644	103	183	20	4	80	0.0500000
NODE_222914_length_273_cov_3.712644	103	183	22	10	80	0.1250000
NODE_222914_length_273_cov_3.712644	103	183	23	20	80	0.2500000
NODE_222914_length_273_cov_3.712644	103	183	25	15	80	0.1875000
NODE_222914_length_273_cov_3.712644	103	183	26	13	80	0.1625000
NODE_222955_length_273_cov_3.298851	69	100	0	31	31	1.0000000
NODE_222955_length_273_cov_3.298851	73	153	0	80	80	1.0000000
NODE_222974_length_273_cov_3.195402	122	189	2	3	67	0.0447761
NODE_222974_length_273_cov_3.195402	122	189	4	64	67	0.9552239
NODE_222991_length_273_cov_3.063218	76	151	22	1	75	0.0133333
NODE_222991_length_273_cov_3.063218	76	151	24	4	75	0.0533333
NODE_222991_length_273_cov_3.063218	76	151	26	2	75	0.0266667
NODE_222991_length_273_cov_3.063218	76	151	28	5	75	0.0666667
NODE_222991_length_273_cov_3.063218	76	151	30	5	75	0.0666667
NODE_222991_length_273_cov_3.063218	76	151	34	8	75	0.1066667
NODE_222991_length_273_cov_3.063218	76	151	36	3	75	0.0400000
NODE_222991_length_273_cov_3.063218	76	151	40	4	75	0.0533333
NODE_222991_length_273_cov_3.063218	76	151	42	2	75	0.0266667
NODE_222991_length_273_cov_3.063218	76	151	44	1	75	0.0133333
NODE_222991_length_273_cov_3.063218	76	151	48	2	75	0.0266667
NODE_222991_length_273_cov_3.063218	76	151	50	1	75	0.0133333
NODE_222991_length_273_cov_3.063218	76	151	52	16	75	0.2133333
NODE_222991_length_273_cov_3.063218	76	151	54	6	75	0.0800000
NODE_222991_length_273_cov_3.063218	76	151	56	15	75	0.2000000
NODE_222991_length_273_cov_3.063218	135	191	16	15	56	0.2678571
NODE_222991_length_273_cov_3.063218	135	191	18	13	56	0.2321429
NODE_222991_length_273_cov_3.063218	135	191	19	1	56	0.0178571
NODE_222991_length_273_cov_3.063218	135	191	20	8	56	0.1428571
NODE_222991_length_273_cov_3.063218	135	191	21	3	56	0.0535714
NODE_222991_length_273_cov_3.063218	135	191	22	1	56	0.0178571
NODE_222991_length_273_cov_3.063218	135	191	24	4	56	0.0714286
NODE_222991_length_273_cov_3.063218	135	191	26	2	56	0.0357143
NODE_222991_length_273_cov_3.063218	135	191	28	5	56	0.0892857
NODE_222991_length_273_cov_3.063218	135	191	30	4	56	0.0714286
NODE_223066_length_273_cov_2.706897	11	45	0	34	34	1.0000000
NODE_223203_length_273_cov_2.339080	69	145	6	10	76	0.1315790
NODE_223203_length_273_cov_2.339080	69	145	10	2	76	0.0263158
NODE_223203_length_273_cov_2.339080	69	145	12	1	76	0.0131579
NODE_223203_length_273_cov_2.339080	69	145	14	1	76	0.0131579
NODE_223203_length_273_cov_2.339080	69	145	16	16	76	0.2105263
NODE_223203_length_273_cov_2.339080	69	145	20	2	76	0.0263158
NODE_223203_length_273_cov_2.339080	69	145	22	5	76	0.0657895
NODE_223203_length_273_cov_2.339080	69	145	24	8	76	0.1052632
NODE_223203_length_273_cov_2.339080	69	145	26	31	76	0.4078947
NODE_223353_length_273_cov_2.051724	31	74	2	43	43	1.0000000
NODE_223377_length_273_cov_2.034483	81	161	3	6	80	0.0750000
NODE_223377_length_273_cov_2.034483	81	161	4	12	80	0.1500000
NODE_223377_length_273_cov_2.034483	81	161	5	6	80	0.0750000
NODE_223377_length_273_cov_2.034483	81	161	6	17	80	0.2125000
NODE_223377_length_273_cov_2.034483	81	161	8	39	80	0.4875000
NODE_223377_length_273_cov_2.034483	213	263	0	2	50	0.0400000
NODE_223377_length_273_cov_2.034483	213	263	1	6	50	0.1200000
NODE_223377_length_273_cov_2.034483	213	263	2	11	50	0.2200000
NODE_223377_length_273_cov_2.034483	213	263	4	5	50	0.1000000
NODE_223377_length_273_cov_2.034483	213	263	6	2	50	0.0400000
NODE_223377_length_273_cov_2.034483	213	263	8	4	50	0.0800000
NODE_223377_length_273_cov_2.034483	213	263	10	4	50	0.0800000
NODE_223377_length_273_cov_2.034483	213	263	12	16	50	0.3200000
NODE_223680_length_273_cov_1.706897	181	238	0	57	57	1.0000000
NODE_223913_length_273_cov_1.442529	5	47	0	42	42	1.0000000
NODE_224023_length_273_cov_1.281609	167	247	0	80	80	1.0000000
NODE_224082_length_273_cov_1.189655	120	156	0	36	36	1.0000000
NODE_224082_length_273_cov_1.189655	129	160	0	31	31	1.0000000
NODE_224165_length_273_cov_1.172414	94	130	6	13	36	0.3611111
NODE_224165_length_273_cov_1.172414	94	130	8	23	36	0.6388889
NODE_224254_length_273_cov_1.172414	8	58	0	50	50	1.0000000
NODE_224367_length_273_cov_1.166667	74	93	0	1	19	0.0526316
NODE_224367_length_273_cov_1.166667	74	93	2	18	19	0.9473684
NODE_224441_length_273_cov_1.091954	6	42	6	6	36	0.1666667
NODE_224441_length_273_cov_1.091954	6	42	8	1	36	0.0277778
NODE_224441_length_273_cov_1.091954	6	42	10	29	36	0.8055556
NODE_224441_length_273_cov_1.091954	43	95	6	4	52	0.0769231
NODE_224441_length_273_cov_1.091954	43	95	8	22	52	0.4230769
NODE_224441_length_273_cov_1.091954	43	95	10	26	52	0.5000000
NODE_224587_length_273_cov_0.971264	188	235	0	47	47	1.0000000
NODE_225303_length_273_cov_0.586207	27	88	0	61	61	1.0000000
NODE_225344_length_273_cov_0.586207	24	79	0	9	55	0.1636364
NODE_225344_length_273_cov_0.586207	24	79	2	46	55	0.8363636
NODE_225344_length_273_cov_0.586207	81	113	2	32	32	1.0000000
NODE_225592_length_272_cov_6.190751	172	236	0	9	64	0.1406250
NODE_225592_length_272_cov_6.190751	172	236	2	21	64	0.3281250
NODE_225592_length_272_cov_6.190751	172	236	4	34	64	0.5312500
NODE_225607_length_272_cov_5.335260	193	272	0	79	79	1.0000000
NODE_225633_length_272_cov_4.716763	228	257	0	29	29	1.0000000
NODE_225656_length_272_cov_4.219653	93	166	0	36	73	0.4931507
NODE_225656_length_272_cov_4.219653	93	166	1	5	73	0.0684932
NODE_225656_length_272_cov_4.219653	93	166	2	32	73	0.4383562
NODE_225656_length_272_cov_4.219653	146	219	2	73	73	1.0000000
NODE_225658_length_272_cov_4.184971	75	128	18	15	53	0.2830189
NODE_225658_length_272_cov_4.184971	75	128	20	38	53	0.7169811
NODE_225739_length_272_cov_3.352601	154	199	2	6	45	0.1333333
NODE_225739_length_272_cov_3.352601	154	199	4	39	45	0.8666667
NODE_225872_length_272_cov_2.664740	106	186	0	7	80	0.0875000
NODE_225872_length_272_cov_2.664740	106	186	2	14	80	0.1750000
NODE_225872_length_272_cov_2.664740	106	186	4	59	80	0.7375000
NODE_226010_length_272_cov_2.335260	33	103	0	52	70	0.7428572
NODE_226010_length_272_cov_2.335260	33	103	1	5	70	0.0714286
NODE_226010_length_272_cov_2.335260	33	103	2	13	70	0.1857143
NODE_226029_length_272_cov_2.277457	219	256	0	37	37	1.0000000
NODE_226045_length_272_cov_2.236994	104	184	2	3	80	0.0375000
NODE_226045_length_272_cov_2.236994	104	184	4	7	80	0.0875000
NODE_226045_length_272_cov_2.236994	104	184	6	8	80	0.1000000
NODE_226045_length_272_cov_2.236994	104	184	8	3	80	0.0375000
NODE_226045_length_272_cov_2.236994	104	184	10	3	80	0.0375000
NODE_226045_length_272_cov_2.236994	104	184	14	1	80	0.0125000
NODE_226045_length_272_cov_2.236994	104	184	20	7	80	0.0875000
NODE_226045_length_272_cov_2.236994	104	184	22	2	80	0.0250000
NODE_226045_length_272_cov_2.236994	104	184	24	12	80	0.1500000
NODE_226045_length_272_cov_2.236994	104	184	26	8	80	0.1000000
NODE_226045_length_272_cov_2.236994	104	184	28	2	80	0.0250000
NODE_226045_length_272_cov_2.236994	104	184	30	2	80	0.0250000
NODE_226045_length_272_cov_2.236994	104	184	32	8	80	0.1000000
NODE_226045_length_272_cov_2.236994	104	184	34	12	80	0.1500000
NODE_226045_length_272_cov_2.236994	104	184	36	2	80	0.0250000
NODE_226169_length_272_cov_1.982659	172	252	2	47	80	0.5875000
NODE_226169_length_272_cov_1.982659	172	252	4	33	80	0.4125000
NODE_226245_length_272_cov_1.780347	37	99	2	1	62	0.0161290
NODE_226245_length_272_cov_1.780347	37	99	4	4	62	0.0645161
NODE_226245_length_272_cov_1.780347	37	99	6	57	62	0.9193549
NODE_226245_length_272_cov_1.780347	90	152	0	1	62	0.0161290
NODE_226245_length_272_cov_1.780347	90	152	2	13	62	0.2096774
NODE_226245_length_272_cov_1.780347	90	152	4	27	62	0.4354839
NODE_226245_length_272_cov_1.780347	90	152	6	21	62	0.3387097
NODE_226248_length_272_cov_1.768786	12	45	0	33	33	1.0000000
NODE_226461_length_272_cov_1.618497	97	160	12	1	63	0.0158730
NODE_226461_length_272_cov_1.618497	97	160	14	6	63	0.0952381
NODE_226461_length_272_cov_1.618497	97	160	16	4	63	0.0634921
NODE_226461_length_272_cov_1.618497	97	160	18	8	63	0.1269841
NODE_226461_length_272_cov_1.618497	97	160	21	1	63	0.0158730
NODE_226461_length_272_cov_1.618497	97	160	22	7	63	0.1111111
NODE_226461_length_272_cov_1.618497	97	160	26	7	63	0.1111111
NODE_226461_length_272_cov_1.618497	97	160	28	13	63	0.2063492
NODE_226461_length_272_cov_1.618497	97	160	29	4	63	0.0634921
NODE_226461_length_272_cov_1.618497	97	160	30	3	63	0.0476190
NODE_226461_length_272_cov_1.618497	97	160	31	8	63	0.1269841
NODE_226461_length_272_cov_1.618497	97	160	39	1	63	0.0158730
NODE_226508_length_272_cov_1.543353	69	137	2	68	68	1.0000000
NODE_227037_length_272_cov_1.173410	147	203	0	4	56	0.0714286
NODE_227037_length_272_cov_1.173410	147	203	1	11	56	0.1964286
NODE_227037_length_272_cov_1.173410	147	203	2	41	56	0.7321429
NODE_227265_length_272_cov_0.988439	169	215	0	5	46	0.1086956
NODE_227265_length_272_cov_0.988439	169	215	2	41	46	0.8913044
NODE_227444_length_272_cov_0.884393	126	163	0	37	37	1.0000000
NODE_228332_length_271_cov_5.238372	103	183	0	37	80	0.4625000
NODE_228332_length_271_cov_5.238372	103	183	2	43	80	0.5375000
NODE_228423_length_271_cov_3.546512	102	165	0	63	63	1.0000000
NODE_228429_length_271_cov_3.476744	62	93	0	31	31	1.0000000
NODE_228494_length_271_cov_2.959302	96	176	0	52	80	0.6500000
NODE_228494_length_271_cov_2.959302	96	176	2	28	80	0.3500000
NODE_228494_length_271_cov_2.959302	149	229	2	80	80	1.0000000
NODE_228554_length_271_cov_2.715116	160	241	0	81	81	1.0000000
NODE_228593_length_271_cov_2.622093	180	253	0	73	73	1.0000000
NODE_228623_length_271_cov_2.465116	45	75	0	30	30	1.0000000
NODE_228731_length_271_cov_2.284884	95	158	2	4	63	0.0634921
NODE_228731_length_271_cov_2.284884	95	158	4	16	63	0.2539683
NODE_228731_length_271_cov_2.284884	95	158	6	6	63	0.0952381
NODE_228731_length_271_cov_2.284884	95	158	8	9	63	0.1428571
NODE_228731_length_271_cov_2.284884	95	158	10	28	63	0.4444444
NODE_228731_length_271_cov_2.284884	131	211	0	46	80	0.5750000
NODE_228731_length_271_cov_2.284884	131	211	2	11	80	0.1375000
NODE_228731_length_271_cov_2.284884	131	211	4	16	80	0.2000000
NODE_228731_length_271_cov_2.284884	131	211	6	6	80	0.0750000
NODE_228731_length_271_cov_2.284884	131	211	8	1	80	0.0125000
NODE_228737_length_271_cov_2.273256	163	219	0	56	56	1.0000000
NODE_228830_length_271_cov_2.069767	130	212	2	82	82	1.0000000
NODE_228932_length_271_cov_1.784884	135	183	0	48	48	1.0000000
NODE_228937_length_271_cov_1.779070	204	268	2	64	64	1.0000000
NODE_229085_length_271_cov_1.755814	119	199	0	45	80	0.5625000
NODE_229085_length_271_cov_1.755814	119	199	2	35	80	0.4375000
NODE_229242_length_271_cov_1.523256	122	183	0	61	61	1.0000000
NODE_229254_length_271_cov_1.511628	106	186	36	6	80	0.0750000
NODE_229254_length_271_cov_1.511628	106	186	38	8	80	0.1000000
NODE_229254_length_271_cov_1.511628	106	186	42	3	80	0.0375000
NODE_229254_length_271_cov_1.511628	106	186	44	6	80	0.0750000
NODE_229254_length_271_cov_1.511628	106	186	46	2	80	0.0250000
NODE_229254_length_271_cov_1.511628	106	186	48	8	80	0.1000000
NODE_229254_length_271_cov_1.511628	106	186	50	9	80	0.1125000
NODE_229254_length_271_cov_1.511628	106	186	52	18	80	0.2250000
NODE_229254_length_271_cov_1.511628	106	186	56	9	80	0.1125000
NODE_229254_length_271_cov_1.511628	106	186	58	7	80	0.0875000
NODE_229254_length_271_cov_1.511628	106	186	60	4	80	0.0500000
NODE_229525_length_271_cov_1.226744	119	184	0	65	65	1.0000000
NODE_229541_length_271_cov_1.197674	88	145	2	14	57	0.2456140
NODE_229541_length_271_cov_1.197674	88	145	4	43	57	0.7543859
NODE_229541_length_271_cov_1.197674	118	192	4	38	74	0.5135135
NODE_229541_length_271_cov_1.197674	118	192	5	4	74	0.0540541
NODE_229541_length_271_cov_1.197674	118	192	6	5	74	0.0675676
NODE_229541_length_271_cov_1.197674	118	192	7	27	74	0.3648649
NODE_230154_length_271_cov_0.918605	155	227	0	25	72	0.3472222
NODE_230154_length_271_cov_0.918605	155	227	2	47	72	0.6527778
NODE_230255_length_271_cov_0.889535	101	148	0	47	47	1.0000000
NODE_230318_length_271_cov_0.889535	127	188	0	61	61	1.0000000
NODE_231165_length_270_cov_4.818713	72	118	2	46	46	1.0000000
NODE_231187_length_270_cov_4.327485	5	82	2	77	77	1.0000000
NODE_231240_length_270_cov_3.666667	87	154	4	67	67	1.0000000
NODE_231240_length_270_cov_3.666667	140	207	0	42	67	0.6268657
NODE_231240_length_270_cov_3.666667	140	207	4	25	67	0.3731343
NODE_231263_length_270_cov_3.491228	186	270	0	46	84	0.5476190
NODE_231263_length_270_cov_3.491228	186	270	2	38	84	0.4523810
NODE_231310_length_270_cov_3.105263	43	90	4	37	47	0.7872341
NODE_231310_length_270_cov_3.105263	43	90	6	10	47	0.2127660
NODE_231316_length_270_cov_3.046784	64	135	0	71	71	1.0000000
NODE_231439_length_270_cov_2.649123	210	270	0	60	60	1.0000000
NODE_231655_length_270_cov_2.087719	16	55	0	39	39	1.0000000
NODE_231655_length_270_cov_2.087719	78	108	0	30	30	1.0000000
NODE_231714_length_270_cov_2.040936	103	159	11	1	56	0.0178571
NODE_231714_length_270_cov_2.040936	103	159	29	4	56	0.0714286
NODE_231714_length_270_cov_2.040936	103	159	35	1	56	0.0178571
NODE_231714_length_270_cov_2.040936	103	159	37	1	56	0.0178571
NODE_231714_length_270_cov_2.040936	103	159	39	1	56	0.0178571
NODE_231714_length_270_cov_2.040936	103	159	45	1	56	0.0178571
NODE_231714_length_270_cov_2.040936	103	159	47	3	56	0.0535714
NODE_231714_length_270_cov_2.040936	103	159	49	2	56	0.0357143
NODE_231714_length_270_cov_2.040936	103	159	51	1	56	0.0178571
NODE_231714_length_270_cov_2.040936	103	159	57	1	56	0.0178571
NODE_231714_length_270_cov_2.040936	103	159	58	1	56	0.0178571
NODE_231714_length_270_cov_2.040936	103	159	62	2	56	0.0357143
NODE_231714_length_270_cov_2.040936	103	159	64	1	56	0.0178571
NODE_231714_length_270_cov_2.040936	103	159	66	1	56	0.0178571
NODE_231714_length_270_cov_2.040936	103	159	68	2	56	0.0357143
NODE_231714_length_270_cov_2.040936	103	159	69	1	56	0.0178571
NODE_231714_length_270_cov_2.040936	103	159	70	1	56	0.0178571
NODE_231714_length_270_cov_2.040936	103	159	72	4	56	0.0714286
NODE_231714_length_270_cov_2.040936	103	159	76	1	56	0.0178571
NODE_231714_length_270_cov_2.040936	103	159	77	1	56	0.0178571
NODE_231714_length_270_cov_2.040936	103	159	79	1	56	0.0178571
NODE_231714_length_270_cov_2.040936	103	159	81	2	56	0.0357143
NODE_231714_length_270_cov_2.040936	103	159	85	1	56	0.0178571
NODE_231714_length_270_cov_2.040936	103	159	87	5	56	0.0892857
NODE_231714_length_270_cov_2.040936	103	159	89	1	56	0.0178571
NODE_231714_length_270_cov_2.040936	103	159	91	3	56	0.0535714
NODE_231714_length_270_cov_2.040936	103	159	92	3	56	0.0535714
NODE_231714_length_270_cov_2.040936	103	159	94	1	56	0.0178571
NODE_231714_length_270_cov_2.040936	103	159	95	1	56	0.0178571
NODE_231714_length_270_cov_2.040936	103	159	97	3	56	0.0535714
NODE_231714_length_270_cov_2.040936	103	159	101	4	56	0.0714286
NODE_231726_length_270_cov_2.017544	1	48	0	47	47	1.0000000
NODE_231820_length_270_cov_1.789474	146	228	0	26	82	0.3170732
NODE_231820_length_270_cov_1.789474	146	228	2	56	82	0.6829268
NODE_232008_length_270_cov_1.678363	178	246	0	68	68	1.0000000
NODE_232021_length_270_cov_1.666667	127	191	41	1	64	0.0156250
NODE_232021_length_270_cov_1.666667	127	191	43	2	64	0.0312500
NODE_232021_length_270_cov_1.666667	127	191	44	1	64	0.0156250
NODE_232021_length_270_cov_1.666667	127	191	49	5	64	0.0781250
NODE_232021_length_270_cov_1.666667	127	191	50	1	64	0.0156250
NODE_232021_length_270_cov_1.666667	127	191	52	9	64	0.1406250
NODE_232021_length_270_cov_1.666667	127	191	57	1	64	0.0156250
NODE_232021_length_270_cov_1.666667	127	191	59	1	64	0.0156250
NODE_232021_length_270_cov_1.666667	127	191	64	1	64	0.0156250
NODE_232021_length_270_cov_1.666667	127	191	67	1	64	0.0156250
NODE_232021_length_270_cov_1.666667	127	191	71	6	64	0.0937500
NODE_232021_length_270_cov_1.666667	127	191	75	1	64	0.0156250
NODE_232021_length_270_cov_1.666667	127	191	79	1	64	0.0156250
NODE_232021_length_270_cov_1.666667	127	191	81	1	64	0.0156250
NODE_232021_length_270_cov_1.666667	127	191	87	2	64	0.0312500
NODE_232021_length_270_cov_1.666667	127	191	91	2	64	0.0312500
NODE_232021_length_270_cov_1.666667	127	191	95	7	64	0.1093750
NODE_232021_length_270_cov_1.666667	127	191	96	3	64	0.0468750
NODE_232021_length_270_cov_1.666667	127	191	100	1	64	0.0156250
NODE_232021_length_270_cov_1.666667	127	191	102	1	64	0.0156250
NODE_232021_length_270_cov_1.666667	127	191	104	2	64	0.0312500
NODE_232021_length_270_cov_1.666667	127	191	106	2	64	0.0312500
NODE_232021_length_270_cov_1.666667	127	191	109	1	64	0.0156250
NODE_232021_length_270_cov_1.666667	127	191	117	1	64	0.0156250
NODE_232021_length_270_cov_1.666667	127	191	119	1	64	0.0156250
NODE_232021_length_270_cov_1.666667	127	191	120	1	64	0.0156250
NODE_232021_length_270_cov_1.666667	127	191	122	2	64	0.0312500
NODE_232021_length_270_cov_1.666667	127	191	124	4	64	0.0625000
NODE_232021_length_270_cov_1.666667	127	191	126	2	64	0.0312500
NODE_232021_length_270_cov_1.666667	180	227	17	2	47	0.0425532
NODE_232021_length_270_cov_1.666667	180	227	18	13	47	0.2765957
NODE_232021_length_270_cov_1.666667	180	227	21	3	47	0.0638298
NODE_232021_length_270_cov_1.666667	180	227	22	4	47	0.0851064
NODE_232021_length_270_cov_1.666667	180	227	31	1	47	0.0212766
NODE_232021_length_270_cov_1.666667	180	227	32	1	47	0.0212766
NODE_232021_length_270_cov_1.666667	180	227	34	3	47	0.0638298
NODE_232021_length_270_cov_1.666667	180	227	37	8	47	0.1702128
NODE_232021_length_270_cov_1.666667	180	227	40	1	47	0.0212766
NODE_232021_length_270_cov_1.666667	180	227	41	1	47	0.0212766
NODE_232021_length_270_cov_1.666667	180	227	43	2	47	0.0425532
NODE_232021_length_270_cov_1.666667	180	227	44	1	47	0.0212766
NODE_232021_length_270_cov_1.666667	180	227	49	5	47	0.1063830
NODE_232021_length_270_cov_1.666667	180	227	50	1	47	0.0212766
NODE_232021_length_270_cov_1.666667	180	227	52	1	47	0.0212766
NODE_232087_length_270_cov_1.555556	138	218	0	72	80	0.9000000
NODE_232087_length_270_cov_1.555556	138	218	2	8	80	0.1000000
NODE_232331_length_270_cov_1.280702	4	75	0	71	71	1.0000000
NODE_232331_length_270_cov_1.280702	57	137	0	80	80	1.0000000
NODE_232331_length_270_cov_1.280702	65	120	0	55	55	1.0000000
NODE_232331_length_270_cov_1.280702	125	198	0	73	73	1.0000000
NODE_232440_length_270_cov_1.192982	146	194	0	48	48	1.0000000
NODE_232583_length_270_cov_1.192982	61	141	0	80	80	1.0000000
NODE_233290_length_270_cov_0.847953	53	128	0	2	75	0.0266667
NODE_233290_length_270_cov_0.847953	53	128	4	2	75	0.0266667
NODE_233290_length_270_cov_0.847953	53	128	6	62	75	0.8266667
NODE_233290_length_270_cov_0.847953	53	128	8	9	75	0.1200000
NODE_234072_length_269_cov_3.894118	30	110	0	80	80	1.0000000
NODE_234072_length_269_cov_3.894118	83	163	0	80	80	1.0000000
NODE_234100_length_269_cov_3.605882	175	205	0	30	30	1.0000000
NODE_234116_length_269_cov_3.523529	192	233	2	38	41	0.9268293
NODE_234116_length_269_cov_3.523529	192	233	4	3	41	0.0731707
NODE_234116_length_269_cov_3.523529	206	268	0	10	62	0.1612903
NODE_234116_length_269_cov_3.523529	206	268	2	52	62	0.8387097
NODE_234118_length_269_cov_3.505882	13	93	2	80	80	1.0000000
NODE_234118_length_269_cov_3.505882	66	145	0	52	79	0.6582279
NODE_234118_length_269_cov_3.505882	66	145	2	27	79	0.3417721
NODE_234162_length_269_cov_3.147059	134	174	0	40	40	1.0000000
NODE_234167_length_269_cov_3.111765	39	119	2	11	80	0.1375000
NODE_234167_length_269_cov_3.111765	39	119	4	17	80	0.2125000
NODE_234167_length_269_cov_3.111765	39	119	6	3	80	0.0375000
NODE_234167_length_269_cov_3.111765	39	119	8	6	80	0.0750000
NODE_234167_length_269_cov_3.111765	39	119	10	43	80	0.5375000
NODE_234167_length_269_cov_3.111765	92	169	0	14	77	0.1818182
NODE_234167_length_269_cov_3.111765	92	169	2	15	77	0.1948052
NODE_234167_length_269_cov_3.111765	92	169	4	8	77	0.1038961
NODE_234167_length_269_cov_3.111765	92	169	6	3	77	0.0389610
NODE_234167_length_269_cov_3.111765	92	169	8	4	77	0.0519481
NODE_234167_length_269_cov_3.111765	92	169	10	33	77	0.4285714
NODE_234178_length_269_cov_3.000000	166	233	0	67	67	1.0000000
NODE_234205_length_269_cov_2.947059	55	123	0	68	68	1.0000000
NODE_234224_length_269_cov_2.858824	9	89	0	80	80	1.0000000
NODE_234224_length_269_cov_2.858824	62	91	0	29	29	1.0000000
NODE_234228_length_269_cov_2.823529	0	73	0	11	73	0.1506849
NODE_234228_length_269_cov_2.823529	0	73	2	11	73	0.1506849
NODE_234228_length_269_cov_2.823529	0	73	7	2	73	0.0273973
NODE_234228_length_269_cov_2.823529	0	73	8	49	73	0.6712329
NODE_234228_length_269_cov_2.823529	46	77	8	27	31	0.8709677
NODE_234228_length_269_cov_2.823529	46	77	10	4	31	0.1290323
NODE_234431_length_269_cov_2.311765	111	157	0	46	46	1.0000000
NODE_234431_length_269_cov_2.311765	130	209	0	79	79	1.0000000
NODE_234606_length_269_cov_1.958824	176	248	0	3	72	0.0416667
NODE_234606_length_269_cov_1.958824	176	248	2	3	72	0.0416667
NODE_234606_length_269_cov_1.958824	176	248	4	66	72	0.9166667
NODE_234647_length_269_cov_1.847059	72	99	0	10	27	0.3703704
NODE_234647_length_269_cov_1.847059	72	99	2	17	27	0.6296296
NODE_234657_length_269_cov_1.823529	30	81	8	7	51	0.1372549
NODE_234657_length_269_cov_1.823529	30	81	10	9	51	0.1764706
NODE_234657_length_269_cov_1.823529	30	81	12	21	51	0.4117647
NODE_234657_length_269_cov_1.823529	30	81	16	3	51	0.0588235
NODE_234657_length_269_cov_1.823529	30	81	20	11	51	0.2156863
NODE_234758_length_269_cov_1.800000	0	42	0	42	42	1.0000000
NODE_234978_length_269_cov_1.552941	90	170	0	4	80	0.0500000
NODE_234978_length_269_cov_1.552941	90	170	2	76	80	0.9500000
NODE_235157_length_269_cov_1.400000	139	219	4	31	80	0.3875000
NODE_235157_length_269_cov_1.400000	139	219	6	25	80	0.3125000
NODE_235157_length_269_cov_1.400000	139	219	8	24	80	0.3000000
NODE_235168_length_269_cov_1.388235	185	252	2	67	67	1.0000000
NODE_235239_length_269_cov_1.288235	150	179	2	2	29	0.0689655
NODE_235239_length_269_cov_1.288235	150	179	4	4	29	0.1379310
NODE_235239_length_269_cov_1.288235	150	179	8	3	29	0.1034483
NODE_235239_length_269_cov_1.288235	150	179	10	14	29	0.4827586
NODE_235239_length_269_cov_1.288235	150	179	16	1	29	0.0344828
NODE_235239_length_269_cov_1.288235	150	179	18	5	29	0.1724138
NODE_235292_length_269_cov_1.217647	141	221	0	80	80	1.0000000
NODE_235561_length_269_cov_1.194118	107	170	2	63	63	1.0000000
NODE_235561_length_269_cov_1.194118	143	221	0	29	78	0.3717949
NODE_235561_length_269_cov_1.194118	143	221	2	49	78	0.6282051
NODE_235714_length_269_cov_1.094118	38	72	0	34	34	1.0000000
NODE_235780_length_269_cov_1.035294	6	36	0	30	30	1.0000000
NODE_235780_length_269_cov_1.035294	96	150	0	4	54	0.0740741
NODE_235780_length_269_cov_1.035294	96	150	2	50	54	0.9259259
NODE_235930_length_269_cov_0.917647	4	79	0	75	75	1.0000000
NODE_235930_length_269_cov_0.917647	57	93	0	36	36	1.0000000
NODE_236243_length_269_cov_0.782353	2	52	0	14	50	0.2800000
NODE_236243_length_269_cov_0.782353	2	52	2	22	50	0.4400000
NODE_236243_length_269_cov_0.782353	2	52	4	14	50	0.2800000
NODE_236243_length_269_cov_0.782353	76	132	4	46	56	0.8214286
NODE_236243_length_269_cov_0.782353	76	132	6	10	56	0.1785714
NODE_236856_length_268_cov_223.165680	161	188	0	4	27	0.1481481
NODE_236856_length_268_cov_223.165680	161	188	2	23	27	0.8518519
NODE_236856_length_268_cov_223.165680	161	241	0	4	80	0.0500000
NODE_236856_length_268_cov_223.165680	161	241	2	76	80	0.9500000
NODE_236878_length_268_cov_6.266272	29	111	0	65	82	0.7926829
NODE_236878_length_268_cov_6.266272	29	111	2	17	82	0.2073171
NODE_236909_length_268_cov_5.053254	137	217	0	80	80	1.0000000
NODE_236909_length_268_cov_5.053254	190	253	0	63	63	1.0000000
NODE_236911_length_268_cov_4.994083	92	168	0	66	76	0.8684211
NODE_236911_length_268_cov_4.994083	92	168	2	10	76	0.1315790
NODE_236972_length_268_cov_3.905325	1	61	6	25	60	0.4166667
NODE_236972_length_268_cov_3.905325	1	61	8	35	60	0.5833333
NODE_237107_length_268_cov_2.982249	95	175	12	14	80	0.1750000
NODE_237107_length_268_cov_2.982249	95	175	14	17	80	0.2125000
NODE_237107_length_268_cov_2.982249	95	175	16	45	80	0.5625000
NODE_237107_length_268_cov_2.982249	95	175	18	4	80	0.0500000
NODE_237115_length_268_cov_2.940828	28	97	0	69	69	1.0000000
NODE_237185_length_268_cov_2.668639	57	110	0	41	53	0.7735849
NODE_237185_length_268_cov_2.668639	57	110	2	12	53	0.2264151
NODE_237190_length_268_cov_2.621302	149	176	0	27	27	1.0000000
NODE_237325_length_268_cov_2.289941	87	127	261	5	40	0.1250000
NODE_237325_length_268_cov_2.289941	87	127	265	1	40	0.0250000
NODE_237325_length_268_cov_2.289941	87	127	266	1	40	0.0250000
NODE_237325_length_268_cov_2.289941	87	127	268	2	40	0.0500000
NODE_237325_length_268_cov_2.289941	87	127	275	1	40	0.0250000
NODE_237325_length_268_cov_2.289941	87	127	277	2	40	0.0500000
NODE_237325_length_268_cov_2.289941	87	127	279	1	40	0.0250000
NODE_237325_length_268_cov_2.289941	87	127	281	1	40	0.0250000
NODE_237325_length_268_cov_2.289941	87	127	285	3	40	0.0750000
NODE_237325_length_268_cov_2.289941	87	127	287	2	40	0.0500000
NODE_237325_length_268_cov_2.289941	87	127	292	1	40	0.0250000
NODE_237325_length_268_cov_2.289941	87	127	293	3	40	0.0750000
NODE_237325_length_268_cov_2.289941	87	127	295	1	40	0.0250000
NODE_237325_length_268_cov_2.289941	87	127	296	1	40	0.0250000
NODE_237325_length_268_cov_2.289941	87	127	300	3	40	0.0750000
NODE_237325_length_268_cov_2.289941	87	127	303	2	40	0.0500000
NODE_237325_length_268_cov_2.289941	87	127	307	5	40	0.1250000
NODE_237325_length_268_cov_2.289941	87	127	311	1	40	0.0250000
NODE_237325_length_268_cov_2.289941	87	127	313	1	40	0.0250000
NODE_237325_length_268_cov_2.289941	87	127	315	2	40	0.0500000
NODE_237325_length_268_cov_2.289941	87	127	317	1	40	0.0250000
NODE_237345_length_268_cov_2.224852	96	176	2	55	80	0.6875000
NODE_237345_length_268_cov_2.224852	96	176	4	25	80	0.3125000
NODE_237345_length_268_cov_2.224852	149	229	1	32	80	0.4000000
NODE_237345_length_268_cov_2.224852	149	229	2	48	80	0.6000000
NODE_237457_length_268_cov_2.005917	97	162	2	24	65	0.3692308
NODE_237457_length_268_cov_2.005917	97	162	4	28	65	0.4307692
NODE_237457_length_268_cov_2.005917	97	162	6	13	65	0.2000000
NODE_237502_length_268_cov_1.840237	80	155	2	11	75	0.1466667
NODE_237502_length_268_cov_1.840237	80	155	4	53	75	0.7066666
NODE_237502_length_268_cov_1.840237	80	155	6	11	75	0.1466667
NODE_237572_length_268_cov_1.810651	8	84	0	76	76	1.0000000
NODE_237831_length_268_cov_1.532544	186	257	4	13	71	0.1830986
NODE_237831_length_268_cov_1.532544	186	257	6	58	71	0.8169014
NODE_237906_length_268_cov_1.508876	52	131	0	24	79	0.3037975
NODE_237906_length_268_cov_1.508876	52	131	2	55	79	0.6962025
NODE_238009_length_268_cov_1.384615	0	46	0	46	46	1.0000000
NODE_238070_length_268_cov_1.278107	100	175	0	75	75	1.0000000
NODE_238153_length_268_cov_1.207101	187	209	0	22	22	1.0000000
NODE_238478_length_268_cov_1.153846	135	195	2	30	60	0.5000000
NODE_238478_length_268_cov_1.153846	135	195	4	23	60	0.3833333
NODE_238478_length_268_cov_1.153846	135	195	6	7	60	0.1166667
NODE_239018_length_268_cov_0.852071	59	119	14	2	60	0.0333333
NODE_239018_length_268_cov_0.852071	59	119	16	1	60	0.0166667
NODE_239018_length_268_cov_0.852071	59	119	22	57	60	0.9500000
NODE_239805_length_267_cov_4.297619	0	52	0	11	52	0.2115385
NODE_239805_length_267_cov_4.297619	0	52	2	41	52	0.7884616
NODE_239817_length_267_cov_4.119048	41	87	0	7	46	0.1521739
NODE_239817_length_267_cov_4.119048	41	87	2	39	46	0.8478261
NODE_239845_length_267_cov_3.785714	96	163	0	67	67	1.0000000
NODE_239845_length_267_cov_3.785714	136	178	0	42	42	1.0000000
NODE_239873_length_267_cov_3.535714	40	101	0	9	61	0.1475410
NODE_239873_length_267_cov_3.535714	40	101	2	3	61	0.0491803
NODE_239873_length_267_cov_3.535714	40	101	4	22	61	0.3606557
NODE_239873_length_267_cov_3.535714	40	101	6	27	61	0.4426230
NODE_239873_length_267_cov_3.535714	74	154	2	3	80	0.0375000
NODE_239873_length_267_cov_3.535714	74	154	4	24	80	0.3000000
NODE_239873_length_267_cov_3.535714	74	154	6	53	80	0.6625000
NODE_239958_length_267_cov_3.005952	216	267	0	51	51	1.0000000
NODE_239959_length_267_cov_3.000000	87	144	4	13	57	0.2280702
NODE_239959_length_267_cov_3.000000	87	144	8	1	57	0.0175439
NODE_239959_length_267_cov_3.000000	87	144	10	7	57	0.1228070
NODE_239959_length_267_cov_3.000000	87	144	12	3	57	0.0526316
NODE_239959_length_267_cov_3.000000	87	144	14	3	57	0.0526316
NODE_239959_length_267_cov_3.000000	87	144	16	5	57	0.0877193
NODE_239959_length_267_cov_3.000000	87	144	20	22	57	0.3859649
NODE_239959_length_267_cov_3.000000	87	144	22	3	57	0.0526316
NODE_240007_length_267_cov_2.726190	177	220	1	9	43	0.2093023
NODE_240007_length_267_cov_2.726190	177	220	3	3	43	0.0697674
NODE_240007_length_267_cov_2.726190	177	220	5	22	43	0.5116279
NODE_240007_length_267_cov_2.726190	177	220	7	9	43	0.2093023
NODE_240024_length_267_cov_2.690476	117	170	2	1	53	0.0188679
NODE_240024_length_267_cov_2.690476	117	170	4	1	53	0.0188679
NODE_240024_length_267_cov_2.690476	117	170	6	51	53	0.9622642
NODE_240029_length_267_cov_2.666667	198	267	0	69	69	1.0000000
NODE_240114_length_267_cov_2.428571	189	254	13	4	65	0.0615385
NODE_240114_length_267_cov_2.428571	189	254	15	2	65	0.0307692
NODE_240114_length_267_cov_2.428571	189	254	17	4	65	0.0615385
NODE_240114_length_267_cov_2.428571	189	254	20	2	65	0.0307692
NODE_240114_length_267_cov_2.428571	189	254	22	1	65	0.0153846
NODE_240114_length_267_cov_2.428571	189	254	24	1	65	0.0153846
NODE_240114_length_267_cov_2.428571	189	254	25	2	65	0.0307692
NODE_240114_length_267_cov_2.428571	189	254	30	3	65	0.0461538
NODE_240114_length_267_cov_2.428571	189	254	35	1	65	0.0153846
NODE_240114_length_267_cov_2.428571	189	254	43	2	65	0.0307692
NODE_240114_length_267_cov_2.428571	189	254	44	1	65	0.0153846
NODE_240114_length_267_cov_2.428571	189	254	49	2	65	0.0307692
NODE_240114_length_267_cov_2.428571	189	254	51	2	65	0.0307692
NODE_240114_length_267_cov_2.428571	189	254	56	2	65	0.0307692
NODE_240114_length_267_cov_2.428571	189	254	59	1	65	0.0153846
NODE_240114_length_267_cov_2.428571	189	254	61	2	65	0.0307692
NODE_240114_length_267_cov_2.428571	189	254	63	1	65	0.0153846
NODE_240114_length_267_cov_2.428571	189	254	64	1	65	0.0153846
NODE_240114_length_267_cov_2.428571	189	254	66	1	65	0.0153846
NODE_240114_length_267_cov_2.428571	189	254	70	1	65	0.0153846
NODE_240114_length_267_cov_2.428571	189	254	73	1	65	0.0153846
NODE_240114_length_267_cov_2.428571	189	254	78	1	65	0.0153846
NODE_240114_length_267_cov_2.428571	189	254	79	1	65	0.0153846
NODE_240114_length_267_cov_2.428571	189	254	81	1	65	0.0153846
NODE_240114_length_267_cov_2.428571	189	254	83	2	65	0.0307692
NODE_240114_length_267_cov_2.428571	189	254	84	1	65	0.0153846
NODE_240114_length_267_cov_2.428571	189	254	87	1	65	0.0153846
NODE_240114_length_267_cov_2.428571	189	254	88	1	65	0.0153846
NODE_240114_length_267_cov_2.428571	189	254	90	1	65	0.0153846
NODE_240114_length_267_cov_2.428571	189	254	92	3	65	0.0461538
NODE_240114_length_267_cov_2.428571	189	254	98	1	65	0.0153846
NODE_240114_length_267_cov_2.428571	189	254	99	1	65	0.0153846
NODE_240114_length_267_cov_2.428571	189	254	100	3	65	0.0461538
NODE_240114_length_267_cov_2.428571	189	254	105	1	65	0.0153846
NODE_240114_length_267_cov_2.428571	189	254	106	1	65	0.0153846
NODE_240114_length_267_cov_2.428571	189	254	109	2	65	0.0307692
NODE_240114_length_267_cov_2.428571	189	254	110	1	65	0.0153846
NODE_240114_length_267_cov_2.428571	189	254	115	2	65	0.0307692
NODE_240114_length_267_cov_2.428571	189	254	118	2	65	0.0307692
NODE_240114_length_267_cov_2.428571	189	254	124	1	65	0.0153846
NODE_240114_length_267_cov_2.428571	189	254	130	1	65	0.0153846
NODE_240207_length_267_cov_2.208333	45	103	4	21	58	0.3620690
NODE_240207_length_267_cov_2.208333	45	103	6	37	58	0.6379310
NODE_240246_length_267_cov_2.125000	124	175	4	51	51	1.0000000
NODE_240303_length_267_cov_2.077381	65	146	2	3	81	0.0370370
NODE_240303_length_267_cov_2.077381	65	146	4	78	81	0.9629630
NODE_240303_length_267_cov_2.077381	229	264	0	35	35	1.0000000
NODE_240331_length_267_cov_2.005952	147	228	2	1	81	0.0123457
NODE_240331_length_267_cov_2.005952	147	228	4	4	81	0.0493827
NODE_240331_length_267_cov_2.005952	147	228	6	6	81	0.0740741
NODE_240331_length_267_cov_2.005952	147	228	8	3	81	0.0370370
NODE_240331_length_267_cov_2.005952	147	228	10	8	81	0.0987654
NODE_240331_length_267_cov_2.005952	147	228	11	47	81	0.5802469
NODE_240331_length_267_cov_2.005952	147	228	12	12	81	0.1481481
NODE_240331_length_267_cov_2.005952	201	267	9	13	66	0.1969697
NODE_240331_length_267_cov_2.005952	201	267	11	53	66	0.8030303
NODE_240336_length_267_cov_1.988095	77	157	0	80	80	1.0000000
NODE_240336_length_267_cov_1.988095	130	210	0	80	80	1.0000000
NODE_240620_length_267_cov_1.755952	119	199	0	3	80	0.0375000
NODE_240620_length_267_cov_1.755952	119	199	2	77	80	0.9625000
NODE_240624_length_267_cov_1.750000	23	104	4	2	81	0.0246914
NODE_240624_length_267_cov_1.750000	23	104	8	9	81	0.1111111
NODE_240624_length_267_cov_1.750000	23	104	10	14	81	0.1728395
NODE_240624_length_267_cov_1.750000	23	104	14	2	81	0.0246914
NODE_240624_length_267_cov_1.750000	23	104	18	9	81	0.1111111
NODE_240624_length_267_cov_1.750000	23	104	24	2	81	0.0246914
NODE_240624_length_267_cov_1.750000	23	104	26	11	81	0.1358025
NODE_240624_length_267_cov_1.750000	23	104	28	31	81	0.3827161
NODE_240624_length_267_cov_1.750000	23	104	30	1	81	0.0123457
NODE_240624_length_267_cov_1.750000	179	208	0	5	29	0.1724138
NODE_240624_length_267_cov_1.750000	179	208	4	18	29	0.6206896
NODE_240624_length_267_cov_1.750000	179	208	6	1	29	0.0344828
NODE_240624_length_267_cov_1.750000	179	208	8	5	29	0.1724138
NODE_240653_length_267_cov_1.690476	18	90	0	72	72	1.0000000
NODE_240790_length_267_cov_1.517857	6	43	0	37	37	1.0000000
NODE_241075_length_267_cov_1.214286	37	91	0	5	54	0.0925926
NODE_241075_length_267_cov_1.214286	37	91	2	2	54	0.0370370
NODE_241075_length_267_cov_1.214286	37	91	4	47	54	0.8703704
NODE_241240_length_267_cov_1.214286	89	126	0	37	37	1.0000000
NODE_241352_length_267_cov_1.208333	124	164	2	12	40	0.3000000
NODE_241352_length_267_cov_1.208333	124	164	4	28	40	0.7000000
NODE_241484_length_267_cov_1.125000	57	103	2	46	46	1.0000000
NODE_241512_length_267_cov_1.089286	119	196	0	77	77	1.0000000
NODE_241512_length_267_cov_1.089286	169	249	0	80	80	1.0000000
NODE_241517_length_267_cov_1.083333	133	152	4	7	19	0.3684210
NODE_241517_length_267_cov_1.083333	133	152	6	12	19	0.6315789
NODE_241517_length_267_cov_1.083333	183	264	0	53	81	0.6543210
NODE_241517_length_267_cov_1.083333	183	264	2	28	81	0.3456790
NODE_241588_length_267_cov_1.017857	205	267	0	62	62	1.0000000
NODE_241633_length_267_cov_0.982143	4	75	0	8	71	0.1126761
NODE_241633_length_267_cov_0.982143	4	75	2	63	71	0.8873239
NODE_242999_length_266_cov_5.706587	120	199	0	79	79	1.0000000
NODE_242999_length_266_cov_5.706587	172	239	0	67	67	1.0000000
NODE_243010_length_266_cov_5.107784	68	150	0	82	82	1.0000000
NODE_243064_length_266_cov_4.125749	99	168	14	1	69	0.0144928
NODE_243064_length_266_cov_4.125749	99	168	17	1	69	0.0144928
NODE_243064_length_266_cov_4.125749	99	168	18	15	69	0.2173913
NODE_243064_length_266_cov_4.125749	99	168	20	28	69	0.4057971
NODE_243064_length_266_cov_4.125749	99	168	22	11	69	0.1594203
NODE_243064_length_266_cov_4.125749	99	168	24	13	69	0.1884058
NODE_243079_length_266_cov_3.958084	40	120	0	80	80	1.0000000
NODE_243079_length_266_cov_3.958084	93	159	0	66	66	1.0000000
NODE_243136_length_266_cov_3.419162	68	130	2	62	62	1.0000000
NODE_243136_length_266_cov_3.419162	116	183	2	67	67	1.0000000
NODE_243168_length_266_cov_3.137725	6	86	0	80	80	1.0000000
NODE_243168_length_266_cov_3.137725	59	120	0	61	61	1.0000000
NODE_243174_length_266_cov_3.107784	166	232	4	3	66	0.0454545
NODE_243174_length_266_cov_3.107784	166	232	6	2	66	0.0303030
NODE_243174_length_266_cov_3.107784	166	232	8	23	66	0.3484848
NODE_243174_length_266_cov_3.107784	166	232	10	1	66	0.0151515
NODE_243174_length_266_cov_3.107784	166	232	12	6	66	0.0909091
NODE_243174_length_266_cov_3.107784	166	232	14	3	66	0.0454545
NODE_243174_length_266_cov_3.107784	166	232	16	6	66	0.0909091
NODE_243174_length_266_cov_3.107784	166	232	22	1	66	0.0151515
NODE_243174_length_266_cov_3.107784	166	232	24	7	66	0.1060606
NODE_243174_length_266_cov_3.107784	166	232	28	3	66	0.0454545
NODE_243174_length_266_cov_3.107784	166	232	30	3	66	0.0454545
NODE_243174_length_266_cov_3.107784	166	232	32	2	66	0.0303030
NODE_243174_length_266_cov_3.107784	166	232	35	1	66	0.0151515
NODE_243174_length_266_cov_3.107784	166	232	37	3	66	0.0454545
NODE_243174_length_266_cov_3.107784	166	232	38	1	66	0.0151515
NODE_243174_length_266_cov_3.107784	166	232	39	1	66	0.0151515
NODE_243475_length_266_cov_2.179641	110	191	10	2	81	0.0246914
NODE_243475_length_266_cov_2.179641	110	191	12	17	81	0.2098765
NODE_243475_length_266_cov_2.179641	110	191	18	8	81	0.0987654
NODE_243475_length_266_cov_2.179641	110	191	20	11	81	0.1358025
NODE_243475_length_266_cov_2.179641	110	191	24	15	81	0.1851852
NODE_243475_length_266_cov_2.179641	110	191	26	6	81	0.0740741
NODE_243475_length_266_cov_2.179641	110	191	28	19	81	0.2345679
NODE_243475_length_266_cov_2.179641	110	191	30	3	81	0.0370370
NODE_243497_length_266_cov_2.137725	156	236	0	75	80	0.9375000
NODE_243497_length_266_cov_2.137725	156	236	3	5	80	0.0625000
NODE_243570_length_266_cov_2.023952	47	123	0	76	76	1.0000000
NODE_243972_length_266_cov_1.532934	155	235	0	53	80	0.6625000
NODE_243972_length_266_cov_1.532934	155	235	2	5	80	0.0625000
NODE_243972_length_266_cov_1.532934	155	235	4	22	80	0.2750000
NODE_244681_length_266_cov_1.113772	70	97	0	27	27	1.0000000
NODE_244760_length_266_cov_1.023952	144	201	2	29	57	0.5087720
NODE_244760_length_266_cov_1.023952	144	201	4	28	57	0.4912281
NODE_244760_length_266_cov_1.023952	199	265	0	1	66	0.0151515
NODE_244760_length_266_cov_1.023952	199	265	2	65	66	0.9848485
NODE_245049_length_266_cov_0.916168	51	122	0	71	71	1.0000000
NODE_245280_length_266_cov_0.730539	132	158	0	26	26	1.0000000
NODE_245538_length_266_cov_0.610778	99	139	4	40	40	1.0000000
NODE_245538_length_266_cov_0.610778	112	156	4	30	44	0.6818182
NODE_245538_length_266_cov_0.610778	112	156	5	14	44	0.3181818
NODE_246087_length_265_cov_7.843373	128	208	0	65	80	0.8125000
NODE_246087_length_265_cov_7.843373	128	208	2	11	80	0.1375000
NODE_246087_length_265_cov_7.843373	128	208	4	1	80	0.0125000
NODE_246087_length_265_cov_7.843373	128	208	6	3	80	0.0375000
NODE_246192_length_265_cov_4.054217	65	145	0	80	80	1.0000000
NODE_246192_length_265_cov_4.054217	118	198	0	80	80	1.0000000
NODE_246198_length_265_cov_3.993976	195	231	2	36	36	1.0000000
NODE_246284_length_265_cov_3.150602	183	263	0	80	80	1.0000000
NODE_246374_length_265_cov_2.789157	177	238	0	61	61	1.0000000
NODE_246409_length_265_cov_2.734940	167	247	0	11	80	0.1375000
NODE_246409_length_265_cov_2.734940	167	247	1	25	80	0.3125000
NODE_246409_length_265_cov_2.734940	167	247	2	44	80	0.5500000
NODE_246432_length_265_cov_2.608434	188	259	0	71	71	1.0000000
NODE_246606_length_265_cov_2.156627	197	237	49	3	40	0.0750000
NODE_246606_length_265_cov_2.156627	197	237	51	4	40	0.1000000
NODE_246606_length_265_cov_2.156627	197	237	55	2	40	0.0500000
NODE_246606_length_265_cov_2.156627	197	237	59	2	40	0.0500000
NODE_246606_length_265_cov_2.156627	197	237	69	6	40	0.1500000
NODE_246606_length_265_cov_2.156627	197	237	71	1	40	0.0250000
NODE_246606_length_265_cov_2.156627	197	237	76	1	40	0.0250000
NODE_246606_length_265_cov_2.156627	197	237	83	3	40	0.0750000
NODE_246606_length_265_cov_2.156627	197	237	89	11	40	0.2750000
NODE_246606_length_265_cov_2.156627	197	237	93	2	40	0.0500000
NODE_246606_length_265_cov_2.156627	197	237	95	5	40	0.1250000
NODE_246624_length_265_cov_2.150602	169	218	0	49	49	1.0000000
NODE_246692_length_265_cov_1.975904	15	44	2	29	29	1.0000000
NODE_246811_length_265_cov_1.843373	195	265	2	70	70	1.0000000
NODE_247028_length_265_cov_1.620482	115	186	0	71	71	1.0000000
NODE_247028_length_265_cov_1.620482	117	171	0	54	54	1.0000000
NODE_247031_length_265_cov_1.614458	53	113	14	4	60	0.0666667
NODE_247031_length_265_cov_1.614458	53	113	16	3	60	0.0500000
NODE_247031_length_265_cov_1.614458	53	113	18	6	60	0.1000000
NODE_247031_length_265_cov_1.614458	53	113	20	4	60	0.0666667
NODE_247031_length_265_cov_1.614458	53	113	21	2	60	0.0333333
NODE_247031_length_265_cov_1.614458	53	113	24	1	60	0.0166667
NODE_247031_length_265_cov_1.614458	53	113	29	1	60	0.0166667
NODE_247031_length_265_cov_1.614458	53	113	30	6	60	0.1000000
NODE_247031_length_265_cov_1.614458	53	113	34	6	60	0.1000000
NODE_247031_length_265_cov_1.614458	53	113	36	1	60	0.0166667
NODE_247031_length_265_cov_1.614458	53	113	37	1	60	0.0166667
NODE_247031_length_265_cov_1.614458	53	113	39	5	60	0.0833333
NODE_247031_length_265_cov_1.614458	53	113	41	8	60	0.1333333
NODE_247031_length_265_cov_1.614458	53	113	43	2	60	0.0333333
NODE_247031_length_265_cov_1.614458	53	113	44	6	60	0.1000000
NODE_247031_length_265_cov_1.614458	53	113	46	3	60	0.0500000
NODE_247031_length_265_cov_1.614458	53	113	48	1	60	0.0166667
NODE_247031_length_265_cov_1.614458	86	166	36	1	80	0.0125000
NODE_247031_length_265_cov_1.614458	86	166	37	1	80	0.0125000
NODE_247031_length_265_cov_1.614458	86	166	39	5	80	0.0625000
NODE_247031_length_265_cov_1.614458	86	166	41	8	80	0.1000000
NODE_247031_length_265_cov_1.614458	86	166	43	2	80	0.0250000
NODE_247031_length_265_cov_1.614458	86	166	44	6	80	0.0750000
NODE_247031_length_265_cov_1.614458	86	166	46	3	80	0.0375000
NODE_247031_length_265_cov_1.614458	86	166	48	2	80	0.0250000
NODE_247031_length_265_cov_1.614458	86	166	50	2	80	0.0250000
NODE_247031_length_265_cov_1.614458	86	166	52	4	80	0.0500000
NODE_247031_length_265_cov_1.614458	86	166	54	2	80	0.0250000
NODE_247031_length_265_cov_1.614458	86	166	56	16	80	0.2000000
NODE_247031_length_265_cov_1.614458	86	166	58	10	80	0.1250000
NODE_247031_length_265_cov_1.614458	86	166	60	7	80	0.0875000
NODE_247031_length_265_cov_1.614458	86	166	62	3	80	0.0375000
NODE_247031_length_265_cov_1.614458	86	166	64	4	80	0.0500000
NODE_247031_length_265_cov_1.614458	86	166	66	4	80	0.0500000
NODE_247314_length_265_cov_1.337349	107	168	12	6	61	0.0983607
NODE_247314_length_265_cov_1.337349	107	168	14	1	61	0.0163934
NODE_247314_length_265_cov_1.337349	107	168	16	9	61	0.1475410
NODE_247314_length_265_cov_1.337349	107	168	22	11	61	0.1803279
NODE_247314_length_265_cov_1.337349	107	168	24	34	61	0.5573770
NODE_247952_length_265_cov_1.000000	187	251	2	12	64	0.1875000
NODE_247952_length_265_cov_1.000000	187	251	4	52	64	0.8125000
NODE_247972_length_265_cov_0.987952	44	63	0	19	19	1.0000000
NODE_249395_length_264_cov_4.018182	141	178	0	37	37	1.0000000
NODE_249404_length_264_cov_3.957576	59	132	0	73	73	1.0000000
NODE_249404_length_264_cov_3.957576	112	192	0	80	80	1.0000000
NODE_249415_length_264_cov_3.824242	178	220	2	42	42	1.0000000
NODE_249452_length_264_cov_3.400000	73	125	0	52	52	1.0000000
NODE_249452_length_264_cov_3.400000	124	165	0	31	41	0.7560976
NODE_249452_length_264_cov_3.400000	124	165	2	2	41	0.0487805
NODE_249452_length_264_cov_3.400000	124	165	4	8	41	0.1951219
NODE_249485_length_264_cov_3.133333	119	186	0	67	67	1.0000000
NODE_249530_length_264_cov_3.012121	122	198	0	76	76	1.0000000
NODE_249904_length_264_cov_2.048485	32	98	3	1	66	0.0151515
NODE_249904_length_264_cov_2.048485	32	98	4	54	66	0.8181818
NODE_249904_length_264_cov_2.048485	32	98	6	2	66	0.0303030
NODE_249904_length_264_cov_2.048485	32	98	8	1	66	0.0151515
NODE_249904_length_264_cov_2.048485	32	98	10	1	66	0.0151515
NODE_249904_length_264_cov_2.048485	32	98	12	6	66	0.0909091
NODE_249904_length_264_cov_2.048485	32	98	14	1	66	0.0151515
NODE_249905_length_264_cov_2.048485	133	176	0	43	43	1.0000000
NODE_249912_length_264_cov_2.012121	20	84	0	64	64	1.0000000
NODE_249931_length_264_cov_1.951515	178	211	2	33	33	1.0000000
NODE_249982_length_264_cov_1.854545	130	161	0	31	31	1.0000000
NODE_250202_length_264_cov_1.745455	26	81	0	55	55	1.0000000
NODE_250202_length_264_cov_1.745455	86	153	0	67	67	1.0000000
NODE_250203_length_264_cov_1.745455	90	169	2	62	79	0.7848101
NODE_250203_length_264_cov_1.745455	90	169	6	3	79	0.0379747
NODE_250203_length_264_cov_1.745455	90	169	8	14	79	0.1772152
NODE_250203_length_264_cov_1.745455	143	207	2	9	64	0.1406250
NODE_250203_length_264_cov_1.745455	143	207	6	39	64	0.6093750
NODE_250203_length_264_cov_1.745455	143	207	8	16	64	0.2500000
NODE_250297_length_264_cov_1.569697	173	236	2	63	63	1.0000000
NODE_250314_length_264_cov_1.545455	206	255	6	49	49	1.0000000
NODE_250381_length_264_cov_1.545455	35	66	0	31	31	1.0000000
NODE_250446_length_264_cov_1.503030	0	63	0	63	63	1.0000000
NODE_250513_length_264_cov_1.406061	149	230	0	81	81	1.0000000
NODE_250513_length_264_cov_1.406061	225	260	0	35	35	1.0000000
NODE_250635_length_264_cov_1.236364	2	63	6	61	61	1.0000000
NODE_251015_length_264_cov_1.151515	11	68	0	57	57	1.0000000
NODE_251529_length_264_cov_0.921212	49	85	0	36	36	1.0000000
NODE_251703_length_264_cov_0.721212	233	252	0	19	19	1.0000000
NODE_252559_length_263_cov_5.115854	132	219	22	1	87	0.0114943
NODE_252559_length_263_cov_5.115854	132	219	24	1	87	0.0114943
NODE_252559_length_263_cov_5.115854	132	219	29	3	87	0.0344828
NODE_252559_length_263_cov_5.115854	132	219	35	5	87	0.0574713
NODE_252559_length_263_cov_5.115854	132	219	37	1	87	0.0114943
NODE_252559_length_263_cov_5.115854	132	219	41	1	87	0.0114943
NODE_252559_length_263_cov_5.115854	132	219	43	5	87	0.0574713
NODE_252559_length_263_cov_5.115854	132	219	44	2	87	0.0229885
NODE_252559_length_263_cov_5.115854	132	219	46	6	87	0.0689655
NODE_252559_length_263_cov_5.115854	132	219	48	5	87	0.0574713
NODE_252559_length_263_cov_5.115854	132	219	50	22	87	0.2528736
NODE_252559_length_263_cov_5.115854	132	219	52	13	87	0.1494253
NODE_252559_length_263_cov_5.115854	132	219	53	13	87	0.1494253
NODE_252559_length_263_cov_5.115854	132	219	54	9	87	0.1034483
NODE_252563_length_263_cov_4.914634	45	117	14	6	72	0.0833333
NODE_252563_length_263_cov_4.914634	45	117	16	10	72	0.1388889
NODE_252563_length_263_cov_4.914634	45	117	18	6	72	0.0833333
NODE_252563_length_263_cov_4.914634	45	117	20	8	72	0.1111111
NODE_252563_length_263_cov_4.914634	45	117	22	4	72	0.0555556
NODE_252563_length_263_cov_4.914634	45	117	24	1	72	0.0138889
NODE_252563_length_263_cov_4.914634	45	117	27	1	72	0.0138889
NODE_252563_length_263_cov_4.914634	45	117	28	24	72	0.3333333
NODE_252563_length_263_cov_4.914634	45	117	30	12	72	0.1666667
NODE_252595_length_263_cov_4.225610	67	124	2	16	57	0.2807018
NODE_252595_length_263_cov_4.225610	67	124	4	38	57	0.6666667
NODE_252595_length_263_cov_4.225610	67	124	6	3	57	0.0526316
NODE_252663_length_263_cov_3.518293	104	176	8	5	72	0.0694444
NODE_252663_length_263_cov_3.518293	104	176	9	9	72	0.1250000
NODE_252663_length_263_cov_3.518293	104	176	11	23	72	0.3194444
NODE_252663_length_263_cov_3.518293	104	176	12	35	72	0.4861111
NODE_252766_length_263_cov_2.908537	7	93	0	30	86	0.3488372
NODE_252766_length_263_cov_2.908537	7	93	2	3	86	0.0348837
NODE_252766_length_263_cov_2.908537	7	93	4	44	86	0.5116279
NODE_252766_length_263_cov_2.908537	7	93	8	6	86	0.0697674
NODE_252766_length_263_cov_2.908537	7	93	10	3	86	0.0348837
NODE_252778_length_263_cov_2.798780	67	146	4	10	79	0.1265823
NODE_252778_length_263_cov_2.798780	67	146	6	16	79	0.2025317
NODE_252778_length_263_cov_2.798780	67	146	8	18	79	0.2278481
NODE_252778_length_263_cov_2.798780	67	146	10	35	79	0.4430380
NODE_252932_length_263_cov_2.396341	207	238	0	31	31	1.0000000
NODE_253261_length_263_cov_1.865854	51	81	4	17	30	0.5666667
NODE_253261_length_263_cov_1.865854	51	81	6	8	30	0.2666667
NODE_253261_length_263_cov_1.865854	51	81	10	5	30	0.1666667
NODE_253310_length_263_cov_1.847561	113	189	0	3	76	0.0394737
NODE_253310_length_263_cov_1.847561	113	189	4	50	76	0.6578947
NODE_253310_length_263_cov_1.847561	113	189	6	23	76	0.3026316
NODE_253379_length_263_cov_1.750000	151	231	2	22	80	0.2750000
NODE_253379_length_263_cov_1.750000	151	231	3	1	80	0.0125000
NODE_253379_length_263_cov_1.750000	151	231	4	49	80	0.6125000
NODE_253379_length_263_cov_1.750000	151	231	6	6	80	0.0750000
NODE_253379_length_263_cov_1.750000	151	231	8	2	80	0.0250000
NODE_253468_length_263_cov_1.579268	32	95	14	1	63	0.0158730
NODE_253468_length_263_cov_1.579268	32	95	16	2	63	0.0317460
NODE_253468_length_263_cov_1.579268	32	95	18	3	63	0.0476190
NODE_253468_length_263_cov_1.579268	32	95	19	12	63	0.1904762
NODE_253468_length_263_cov_1.579268	32	95	21	7	63	0.1111111
NODE_253468_length_263_cov_1.579268	32	95	23	8	63	0.1269841
NODE_253468_length_263_cov_1.579268	32	95	27	4	63	0.0634921
NODE_253468_length_263_cov_1.579268	32	95	29	1	63	0.0158730
NODE_253468_length_263_cov_1.579268	32	95	33	2	63	0.0317460
NODE_253468_length_263_cov_1.579268	32	95	35	1	63	0.0158730
NODE_253468_length_263_cov_1.579268	32	95	37	22	63	0.3492064
NODE_253477_length_263_cov_1.567073	98	155	2	2	57	0.0350877
NODE_253477_length_263_cov_1.567073	98	155	4	55	57	0.9649123
NODE_253619_length_263_cov_1.506098	157	217	2	22	60	0.3666667
NODE_253619_length_263_cov_1.506098	157	217	4	38	60	0.6333333
NODE_253620_length_263_cov_1.506098	84	113	6	6	29	0.2068966
NODE_253620_length_263_cov_1.506098	84	113	8	23	29	0.7931035
NODE_253753_length_263_cov_1.286585	143	223	0	3	80	0.0375000
NODE_253753_length_263_cov_1.286585	143	223	4	3	80	0.0375000
NODE_253753_length_263_cov_1.286585	143	223	10	2	80	0.0250000
NODE_253753_length_263_cov_1.286585	143	223	12	6	80	0.0750000
NODE_253753_length_263_cov_1.286585	143	223	14	4	80	0.0500000
NODE_253753_length_263_cov_1.286585	143	223	17	18	80	0.2250000
NODE_253753_length_263_cov_1.286585	143	223	18	1	80	0.0125000
NODE_253753_length_263_cov_1.286585	143	223	20	1	80	0.0125000
NODE_253753_length_263_cov_1.286585	143	223	22	2	80	0.0250000
NODE_253753_length_263_cov_1.286585	143	223	26	2	80	0.0250000
NODE_253753_length_263_cov_1.286585	143	223	31	8	80	0.1000000
NODE_253753_length_263_cov_1.286585	143	223	33	6	80	0.0750000
NODE_253753_length_263_cov_1.286585	143	223	35	10	80	0.1250000
NODE_253753_length_263_cov_1.286585	143	223	36	4	80	0.0500000
NODE_253753_length_263_cov_1.286585	143	223	37	6	80	0.0750000
NODE_253753_length_263_cov_1.286585	143	223	38	4	80	0.0500000
NODE_253788_length_263_cov_1.243902	206	263	0	57	57	1.0000000
NODE_254174_length_263_cov_1.170732	12	66	0	54	54	1.0000000
NODE_254174_length_263_cov_1.170732	39	119	0	80	80	1.0000000
NODE_254301_length_263_cov_1.067073	137	202	0	65	65	1.0000000
NODE_254301_length_263_cov_1.067073	175	255	0	80	80	1.0000000
NODE_254783_length_263_cov_0.810976	163	245	58	2	82	0.0243902
NODE_254783_length_263_cov_0.810976	163	245	61	1	82	0.0121951
NODE_254783_length_263_cov_0.810976	163	245	63	1	82	0.0121951
NODE_254783_length_263_cov_0.810976	163	245	66	1	82	0.0121951
NODE_254783_length_263_cov_0.810976	163	245	71	1	82	0.0121951
NODE_254783_length_263_cov_0.810976	163	245	79	1	82	0.0121951
NODE_254783_length_263_cov_0.810976	163	245	81	1	82	0.0121951
NODE_254783_length_263_cov_0.810976	163	245	85	1	82	0.0121951
NODE_254783_length_263_cov_0.810976	163	245	90	1	82	0.0121951
NODE_254783_length_263_cov_0.810976	163	245	97	1	82	0.0121951
NODE_254783_length_263_cov_0.810976	163	245	103	1	82	0.0121951
NODE_254783_length_263_cov_0.810976	163	245	107	1	82	0.0121951
NODE_254783_length_263_cov_0.810976	163	245	112	1	82	0.0121951
NODE_254783_length_263_cov_0.810976	163	245	120	2	82	0.0243902
NODE_254783_length_263_cov_0.810976	163	245	124	1	82	0.0121951
NODE_254783_length_263_cov_0.810976	163	245	136	2	82	0.0243902
NODE_254783_length_263_cov_0.810976	163	245	144	1	82	0.0121951
NODE_254783_length_263_cov_0.810976	163	245	155	1	82	0.0121951
NODE_254783_length_263_cov_0.810976	163	245	157	1	82	0.0121951
NODE_254783_length_263_cov_0.810976	163	245	160	2	82	0.0243902
NODE_254783_length_263_cov_0.810976	163	245	161	1	82	0.0121951
NODE_254783_length_263_cov_0.810976	163	245	165	1	82	0.0121951
NODE_254783_length_263_cov_0.810976	163	245	173	1	82	0.0121951
NODE_254783_length_263_cov_0.810976	163	245	176	1	82	0.0121951
NODE_254783_length_263_cov_0.810976	163	245	179	3	82	0.0365854
NODE_254783_length_263_cov_0.810976	163	245	181	1	82	0.0121951
NODE_254783_length_263_cov_0.810976	163	245	189	1	82	0.0121951
NODE_254783_length_263_cov_0.810976	163	245	193	1	82	0.0121951
NODE_254783_length_263_cov_0.810976	163	245	198	2	82	0.0243902
NODE_254783_length_263_cov_0.810976	163	245	203	1	82	0.0121951
NODE_254783_length_263_cov_0.810976	163	245	213	1	82	0.0121951
NODE_254783_length_263_cov_0.810976	163	245	221	1	82	0.0121951
NODE_254783_length_263_cov_0.810976	163	245	229	1	82	0.0121951
NODE_254783_length_263_cov_0.810976	163	245	234	1	82	0.0121951
NODE_254783_length_263_cov_0.810976	163	245	247	1	82	0.0121951
NODE_254783_length_263_cov_0.810976	163	245	250	1	82	0.0121951
NODE_254783_length_263_cov_0.810976	163	245	256	1	82	0.0121951
NODE_254783_length_263_cov_0.810976	163	245	262	1	82	0.0121951
NODE_254783_length_263_cov_0.810976	163	245	268	1	82	0.0121951
NODE_254783_length_263_cov_0.810976	163	245	270	1	82	0.0121951
NODE_254783_length_263_cov_0.810976	163	245	276	1	82	0.0121951
NODE_254783_length_263_cov_0.810976	163	245	278	1	82	0.0121951
NODE_254783_length_263_cov_0.810976	163	245	286	1	82	0.0121951
NODE_254783_length_263_cov_0.810976	163	245	290	1	82	0.0121951
NODE_254783_length_263_cov_0.810976	163	245	291	1	82	0.0121951
NODE_254783_length_263_cov_0.810976	163	245	297	1	82	0.0121951
NODE_254783_length_263_cov_0.810976	163	245	301	1	82	0.0121951
NODE_254783_length_263_cov_0.810976	163	245	303	1	82	0.0121951
NODE_254783_length_263_cov_0.810976	163	245	309	1	82	0.0121951
NODE_254783_length_263_cov_0.810976	163	245	311	1	82	0.0121951
NODE_254783_length_263_cov_0.810976	163	245	316	1	82	0.0121951
NODE_254783_length_263_cov_0.810976	163	245	317	1	82	0.0121951
NODE_254783_length_263_cov_0.810976	163	245	320	1	82	0.0121951
NODE_254783_length_263_cov_0.810976	163	245	322	1	82	0.0121951
NODE_254783_length_263_cov_0.810976	163	245	324	1	82	0.0121951
NODE_254783_length_263_cov_0.810976	163	245	333	1	82	0.0121951
NODE_254783_length_263_cov_0.810976	163	245	335	1	82	0.0121951
NODE_254783_length_263_cov_0.810976	163	245	342	1	82	0.0121951
NODE_254783_length_263_cov_0.810976	163	245	346	1	82	0.0121951
NODE_254783_length_263_cov_0.810976	163	245	356	1	82	0.0121951
NODE_254783_length_263_cov_0.810976	163	245	357	1	82	0.0121951
NODE_254783_length_263_cov_0.810976	163	245	359	1	82	0.0121951
NODE_254783_length_263_cov_0.810976	163	245	369	3	82	0.0365854
NODE_254783_length_263_cov_0.810976	163	245	371	1	82	0.0121951
NODE_254783_length_263_cov_0.810976	163	245	375	1	82	0.0121951
NODE_254783_length_263_cov_0.810976	163	245	377	5	82	0.0609756
NODE_254783_length_263_cov_0.810976	163	245	379	3	82	0.0365854
NODE_255446_length_263_cov_0.621951	212	258	0	46	46	1.0000000
NODE_255524_length_263_cov_0.621951	131	151	0	20	20	1.0000000
NODE_255559_length_263_cov_0.621951	67	86	2	19	19	1.0000000
NODE_255727_length_262_cov_5.312883	20	82	0	62	62	1.0000000
NODE_255769_length_262_cov_4.447853	102	155	0	25	53	0.4716981
NODE_255769_length_262_cov_4.447853	102	155	2	25	53	0.4716981
NODE_255769_length_262_cov_4.447853	102	155	4	3	53	0.0566038
NODE_255821_length_262_cov_3.766871	48	89	0	41	41	1.0000000
NODE_255860_length_262_cov_3.435583	158	235	0	77	77	1.0000000
NODE_255945_length_262_cov_2.938650	142	222	6	68	80	0.8500000
NODE_255945_length_262_cov_2.938650	142	222	8	12	80	0.1500000
NODE_256009_length_262_cov_2.723926	103	183	0	27	80	0.3375000
NODE_256009_length_262_cov_2.723926	103	183	2	53	80	0.6625000
NODE_256049_length_262_cov_2.509202	88	148	2	2	60	0.0333333
NODE_256049_length_262_cov_2.509202	88	148	6	27	60	0.4500000
NODE_256049_length_262_cov_2.509202	88	148	9	5	60	0.0833333
NODE_256049_length_262_cov_2.509202	88	148	10	26	60	0.4333333
NODE_256050_length_262_cov_2.509202	0	61	0	61	61	1.0000000
NODE_256050_length_262_cov_2.509202	107	171	0	64	64	1.0000000
NODE_256050_length_262_cov_2.509202	144	224	0	80	80	1.0000000
NODE_256129_length_262_cov_2.429448	14	87	0	73	73	1.0000000
NODE_256129_length_262_cov_2.429448	62	149	0	87	87	1.0000000
NODE_256176_length_262_cov_2.226994	2	79	0	77	77	1.0000000
NODE_256187_length_262_cov_2.202454	61	81	0	20	20	1.0000000
NODE_256199_length_262_cov_2.190184	172	235	0	7	63	0.1111111
NODE_256199_length_262_cov_2.190184	172	235	2	56	63	0.8888889
NODE_256239_length_262_cov_2.177914	133	189	4	6	56	0.1071429
NODE_256239_length_262_cov_2.177914	133	189	7	1	56	0.0178571
NODE_256239_length_262_cov_2.177914	133	189	8	49	56	0.8750000
NODE_256265_length_262_cov_2.122699	96	157	8	7	61	0.1147541
NODE_256265_length_262_cov_2.122699	96	157	10	30	61	0.4918033
NODE_256265_length_262_cov_2.122699	96	157	12	8	61	0.1311475
NODE_256265_length_262_cov_2.122699	96	157	14	2	61	0.0327869
NODE_256265_length_262_cov_2.122699	96	157	15	1	61	0.0163934
NODE_256265_length_262_cov_2.122699	96	157	18	1	61	0.0163934
NODE_256265_length_262_cov_2.122699	96	157	20	12	61	0.1967213
NODE_256386_length_262_cov_1.877301	0	77	0	4	77	0.0519481
NODE_256386_length_262_cov_1.877301	0	77	2	73	77	0.9480519
NODE_256390_length_262_cov_1.877301	77	124	9	2	47	0.0425532
NODE_256390_length_262_cov_1.877301	77	124	11	2	47	0.0425532
NODE_256390_length_262_cov_1.877301	77	124	13	43	47	0.9148936
NODE_256481_length_262_cov_1.871166	192	252	0	60	60	1.0000000
NODE_256596_length_262_cov_1.736196	149	208	0	59	59	1.0000000
NODE_256630_length_262_cov_1.680982	2	82	0	80	80	1.0000000
NODE_256650_length_262_cov_1.656442	135	166	2	31	31	1.0000000
NODE_256659_length_262_cov_1.638037	111	142	20	15	31	0.4838710
NODE_256659_length_262_cov_1.638037	111	142	24	2	31	0.0645161
NODE_256659_length_262_cov_1.638037	111	142	26	6	31	0.1935484
NODE_256659_length_262_cov_1.638037	111	142	28	8	31	0.2580645
NODE_256704_length_262_cov_1.576687	102	182	0	43	80	0.5375000
NODE_256704_length_262_cov_1.576687	102	182	2	37	80	0.4625000
NODE_256704_length_262_cov_1.576687	155	221	0	7	66	0.1060606
NODE_256704_length_262_cov_1.576687	155	221	2	59	66	0.8939394
NODE_256742_length_262_cov_1.564417	69	124	0	49	55	0.8909091
NODE_256742_length_262_cov_1.564417	69	124	4	1	55	0.0181818
NODE_256742_length_262_cov_1.564417	69	124	10	5	55	0.0909091
NODE_256742_length_262_cov_1.564417	106	177	0	12	71	0.1690141
NODE_256742_length_262_cov_1.564417	106	177	4	1	71	0.0140845
NODE_256742_length_262_cov_1.564417	106	177	10	13	71	0.1830986
NODE_256742_length_262_cov_1.564417	106	177	12	5	71	0.0704225
NODE_256742_length_262_cov_1.564417	106	177	14	40	71	0.5633803
NODE_256933_length_262_cov_1.349693	52	102	0	50	50	1.0000000
NODE_256933_length_262_cov_1.349693	83	149	0	55	66	0.8333333
NODE_256933_length_262_cov_1.349693	83	149	2	11	66	0.1666667
NODE_257199_length_262_cov_1.251534	44	124	0	2	80	0.0250000
NODE_257199_length_262_cov_1.251534	44	124	1	3	80	0.0375000
NODE_257199_length_262_cov_1.251534	44	124	2	26	80	0.3250000
NODE_257199_length_262_cov_1.251534	44	124	3	3	80	0.0375000
NODE_257199_length_262_cov_1.251534	44	124	4	6	80	0.0750000
NODE_257199_length_262_cov_1.251534	44	124	8	4	80	0.0500000
NODE_257199_length_262_cov_1.251534	44	124	9	3	80	0.0375000
NODE_257199_length_262_cov_1.251534	44	124	11	16	80	0.2000000
NODE_257199_length_262_cov_1.251534	44	124	12	17	80	0.2125000
NODE_257199_length_262_cov_1.251534	97	171	8	3	74	0.0405405
NODE_257199_length_262_cov_1.251534	97	171	10	6	74	0.0810811
NODE_257199_length_262_cov_1.251534	97	171	11	10	74	0.1351351
NODE_257199_length_262_cov_1.251534	97	171	12	55	74	0.7432432
NODE_258876_length_261_cov_31.913580	32	112	7	38	80	0.4750000
NODE_258876_length_261_cov_31.913580	32	112	9	42	80	0.5250000
NODE_258876_length_261_cov_31.913580	85	171	0	24	86	0.2790698
NODE_258876_length_261_cov_31.913580	85	171	2	33	86	0.3837209
NODE_258876_length_261_cov_31.913580	85	171	9	29	86	0.3372093
NODE_258901_length_261_cov_6.376543	126	201	0	75	75	1.0000000
NODE_258901_length_261_cov_6.376543	179	254	0	75	75	1.0000000
NODE_258929_length_261_cov_5.469136	56	132	0	76	76	1.0000000
NODE_259329_length_261_cov_2.425926	53	134	0	15	81	0.1851852
NODE_259329_length_261_cov_2.425926	53	134	2	66	81	0.8148148
NODE_259361_length_261_cov_2.333333	41	136	0	2	95	0.0210526
NODE_259361_length_261_cov_2.333333	41	136	2	93	95	0.9789473
NODE_259435_length_261_cov_2.191358	86	122	0	13	36	0.3611111
NODE_259435_length_261_cov_2.191358	86	122	2	23	36	0.6388889
NODE_259495_length_261_cov_1.993827	134	214	0	8	80	0.1000000
NODE_259495_length_261_cov_1.993827	134	214	2	72	80	0.9000000
NODE_259672_length_261_cov_1.882716	51	105	8	1	54	0.0185185
NODE_259672_length_261_cov_1.882716	51	105	10	2	54	0.0370370
NODE_259672_length_261_cov_1.882716	51	105	12	2	54	0.0370370
NODE_259672_length_261_cov_1.882716	51	105	14	17	54	0.3148148
NODE_259672_length_261_cov_1.882716	51	105	16	4	54	0.0740741
NODE_259672_length_261_cov_1.882716	51	105	19	1	54	0.0185185
NODE_259672_length_261_cov_1.882716	51	105	20	27	54	0.5000000
NODE_259740_length_261_cov_1.839506	118	197	0	10	79	0.1265823
NODE_259740_length_261_cov_1.839506	118	197	2	53	79	0.6708861
NODE_259740_length_261_cov_1.839506	118	197	6	13	79	0.1645570
NODE_259740_length_261_cov_1.839506	118	197	8	3	79	0.0379747
NODE_259769_length_261_cov_1.783951	69	141	0	18	72	0.2500000
NODE_259769_length_261_cov_1.783951	69	141	1	4	72	0.0555556
NODE_259769_length_261_cov_1.783951	69	141	2	50	72	0.6944444
NODE_260089_length_261_cov_1.388889	202	247	0	45	45	1.0000000
NODE_260090_length_261_cov_1.382716	14	61	0	47	47	1.0000000
NODE_260428_length_261_cov_1.253086	100	138	6	38	38	1.0000000
NODE_260738_length_261_cov_1.030864	122	205	2	83	83	1.0000000
NODE_260738_length_261_cov_1.030864	129	210	2	81	81	1.0000000
NODE_260738_length_261_cov_1.030864	129	184	2	55	55	1.0000000
NODE_260738_length_261_cov_1.030864	187	248	0	26	61	0.4262295
NODE_260738_length_261_cov_1.030864	187	248	2	35	61	0.5737705
NODE_260767_length_261_cov_1.006173	3	45	0	19	42	0.4523810
NODE_260767_length_261_cov_1.006173	3	45	4	23	42	0.5476190
NODE_260767_length_261_cov_1.006173	46	98	4	52	52	1.0000000
NODE_262062_length_261_cov_0.580247	11	31	0	20	20	1.0000000
NODE_262121_length_260_cov_8.844720	74	138	2	64	64	1.0000000
NODE_262123_length_260_cov_8.447205	30	110	0	80	80	1.0000000
NODE_262123_length_260_cov_8.447205	83	167	0	84	84	1.0000000
NODE_262123_length_260_cov_8.447205	163	243	0	80	80	1.0000000
NODE_262149_length_260_cov_5.807453	38	118	0	13	80	0.1625000
NODE_262149_length_260_cov_5.807453	38	118	2	67	80	0.8375000
NODE_262149_length_260_cov_5.807453	91	171	2	80	80	1.0000000
NODE_262264_length_260_cov_3.645963	5	57	0	10	52	0.1923077
NODE_262264_length_260_cov_3.645963	5	57	2	42	52	0.8076923
NODE_262329_length_260_cov_3.167702	91	163	0	72	72	1.0000000
NODE_262378_length_260_cov_2.981366	58	127	0	69	69	1.0000000
NODE_262384_length_260_cov_2.913043	10	90	0	80	80	1.0000000
NODE_262708_length_260_cov_2.161491	174	251	0	77	77	1.0000000
NODE_262733_length_260_cov_2.080745	188	258	0	70	70	1.0000000
NODE_262788_length_260_cov_1.950311	27	85	0	58	58	1.0000000
NODE_262930_length_260_cov_1.900621	14	50	0	36	36	1.0000000
NODE_263117_length_260_cov_1.683230	50	130	0	9	80	0.1125000
NODE_263117_length_260_cov_1.683230	50	130	2	71	80	0.8875000
NODE_263428_length_260_cov_1.347826	38	118	0	80	80	1.0000000
NODE_263533_length_260_cov_1.267081	114	199	0	85	85	1.0000000
NODE_263556_length_260_cov_1.267081	198	244	0	46	46	1.0000000
NODE_263568_length_260_cov_1.267081	145	189	6	44	44	1.0000000
NODE_265483_length_259_cov_4.800000	35	95	0	60	60	1.0000000
NODE_265584_length_259_cov_3.675000	119	161	0	42	42	1.0000000
NODE_265584_length_259_cov_3.675000	134	214	0	80	80	1.0000000
NODE_265592_length_259_cov_3.593750	100	143	0	43	43	1.0000000
NODE_265611_length_259_cov_3.475000	198	259	25	9	61	0.1475410
NODE_265611_length_259_cov_3.475000	198	259	26	17	61	0.2786885
NODE_265611_length_259_cov_3.475000	198	259	30	20	61	0.3278688
NODE_265611_length_259_cov_3.475000	198	259	34	14	61	0.2295082
NODE_265611_length_259_cov_3.475000	198	259	40	1	61	0.0163934
NODE_265625_length_259_cov_3.331250	72	118	0	6	46	0.1304348
NODE_265625_length_259_cov_3.331250	72	118	2	40	46	0.8695652
NODE_265636_length_259_cov_3.237500	103	160	0	57	57	1.0000000
NODE_265704_length_259_cov_2.937500	209	233	6	24	24	1.0000000
NODE_265735_length_259_cov_2.850000	0	41	1	3	41	0.0731707
NODE_265735_length_259_cov_2.850000	0	41	2	38	41	0.9268293
NODE_265735_length_259_cov_2.850000	14	94	2	80	80	1.0000000
NODE_265818_length_259_cov_2.550000	9	82	4	10	73	0.1369863
NODE_265818_length_259_cov_2.550000	9	82	6	63	73	0.8630137
NODE_265942_length_259_cov_2.287500	147	225	0	78	78	1.0000000
NODE_265942_length_259_cov_2.287500	198	241	0	43	43	1.0000000
NODE_266032_length_259_cov_2.156250	0	72	0	72	72	1.0000000
NODE_266080_length_259_cov_2.012500	8	73	0	51	65	0.7846154
NODE_266080_length_259_cov_2.012500	8	73	4	14	65	0.2153846
NODE_266080_length_259_cov_2.012500	53	126	0	6	73	0.0821918
NODE_266080_length_259_cov_2.012500	53	126	4	67	73	0.9178082
NODE_266101_length_259_cov_1.962500	108	189	2	6	81	0.0740741
NODE_266101_length_259_cov_1.962500	108	189	4	44	81	0.5432099
NODE_266101_length_259_cov_1.962500	108	189	6	31	81	0.3827161
NODE_266117_length_259_cov_1.918750	49	120	0	44	71	0.6197183
NODE_266117_length_259_cov_1.918750	49	120	4	27	71	0.3802817
NODE_266183_length_259_cov_1.912500	114	177	2	58	63	0.9206349
NODE_266183_length_259_cov_1.912500	114	177	4	1	63	0.0158730
NODE_266183_length_259_cov_1.912500	114	177	6	4	63	0.0634921
NODE_266365_length_259_cov_1.837500	180	252	4	2	72	0.0277778
NODE_266365_length_259_cov_1.837500	180	252	8	2	72	0.0277778
NODE_266365_length_259_cov_1.837500	180	252	14	14	72	0.1944444
NODE_266365_length_259_cov_1.837500	180	252	20	28	72	0.3888889
NODE_266365_length_259_cov_1.837500	180	252	22	9	72	0.1250000
NODE_266365_length_259_cov_1.837500	180	252	24	16	72	0.2222222
NODE_266365_length_259_cov_1.837500	180	252	26	1	72	0.0138889
NODE_266609_length_259_cov_1.593750	27	67	2	1	40	0.0250000
NODE_266609_length_259_cov_1.593750	27	67	4	39	40	0.9750000
NODE_266746_length_259_cov_1.400000	117	164	0	12	47	0.2553191
NODE_266746_length_259_cov_1.400000	117	164	2	24	47	0.5106383
NODE_266746_length_259_cov_1.400000	117	164	4	11	47	0.2340426
NODE_266746_length_259_cov_1.400000	137	217	2	16	80	0.2000000
NODE_266746_length_259_cov_1.400000	137	217	4	64	80	0.8000000
NODE_268816_length_258_cov_6.415094	129	209	0	66	80	0.8250000
NODE_268816_length_258_cov_6.415094	129	209	2	14	80	0.1750000
NODE_268816_length_258_cov_6.415094	182	258	0	76	76	1.0000000
NODE_268823_length_258_cov_6.157233	1	81	0	80	80	1.0000000
NODE_268823_length_258_cov_6.157233	9	64	0	55	55	1.0000000
NODE_268852_length_258_cov_4.798742	83	163	4	80	80	1.0000000
NODE_268870_length_258_cov_4.396226	0	44	0	26	44	0.5909091
NODE_268870_length_258_cov_4.396226	0	44	2	18	44	0.4090909
NODE_268870_length_258_cov_4.396226	24	97	0	2	73	0.0273973
NODE_268870_length_258_cov_4.396226	24	97	2	71	73	0.9726027
NODE_268880_length_258_cov_4.301887	0	54	0	54	54	1.0000000
NODE_268942_length_258_cov_3.616352	29	58	0	29	29	1.0000000
NODE_268982_length_258_cov_3.352201	47	127	20	2	80	0.0250000
NODE_268982_length_258_cov_3.352201	47	127	30	1	80	0.0125000
NODE_268982_length_258_cov_3.352201	47	127	31	2	80	0.0250000
NODE_268982_length_258_cov_3.352201	47	127	32	4	80	0.0500000
NODE_268982_length_258_cov_3.352201	47	127	33	12	80	0.1500000
NODE_268982_length_258_cov_3.352201	47	127	35	11	80	0.1375000
NODE_268982_length_258_cov_3.352201	47	127	36	7	80	0.0875000
NODE_268982_length_258_cov_3.352201	47	127	38	22	80	0.2750000
NODE_268982_length_258_cov_3.352201	47	127	41	1	80	0.0125000
NODE_268982_length_258_cov_3.352201	47	127	42	18	80	0.2250000
NODE_269086_length_258_cov_2.886792	102	121	0	6	19	0.3157895
NODE_269086_length_258_cov_2.886792	102	121	2	13	19	0.6842105
NODE_269091_length_258_cov_2.880503	92	172	0	80	80	1.0000000
NODE_269102_length_258_cov_2.855346	96	138	18	3	42	0.0714286
NODE_269102_length_258_cov_2.855346	96	138	20	2	42	0.0476190
NODE_269102_length_258_cov_2.855346	96	138	22	5	42	0.1190476
NODE_269102_length_258_cov_2.855346	96	138	24	5	42	0.1190476
NODE_269102_length_258_cov_2.855346	96	138	26	20	42	0.4761905
NODE_269102_length_258_cov_2.855346	96	138	28	7	42	0.1666667
NODE_269102_length_258_cov_2.855346	148	191	0	16	43	0.3720930
NODE_269102_length_258_cov_2.855346	148	191	2	7	43	0.1627907
NODE_269102_length_258_cov_2.855346	148	191	6	5	43	0.1162791
NODE_269102_length_258_cov_2.855346	148	191	8	15	43	0.3488372
NODE_269113_length_258_cov_2.817610	10	58	0	6	48	0.1250000
NODE_269113_length_258_cov_2.817610	10	58	2	36	48	0.7500000
NODE_269113_length_258_cov_2.817610	10	58	4	6	48	0.1250000
NODE_269264_length_258_cov_2.383648	48	128	2	8	80	0.1000000
NODE_269264_length_258_cov_2.383648	48	128	4	72	80	0.9000000
NODE_269264_length_258_cov_2.383648	101	182	0	12	81	0.1481481
NODE_269264_length_258_cov_2.383648	101	182	1	5	81	0.0617284
NODE_269264_length_258_cov_2.383648	101	182	2	17	81	0.2098765
NODE_269264_length_258_cov_2.383648	101	182	4	47	81	0.5802469
NODE_269338_length_258_cov_2.238994	61	141	0	80	80	1.0000000
NODE_269615_length_258_cov_1.918239	0	51	0	1	51	0.0196078
NODE_269615_length_258_cov_1.918239	0	51	2	50	51	0.9803922
NODE_269682_length_258_cov_1.855346	26	47	0	13	21	0.6190476
NODE_269682_length_258_cov_1.855346	26	47	2	8	21	0.3809524
NODE_269682_length_258_cov_1.855346	71	104	2	3	33	0.0909091
NODE_269682_length_258_cov_1.855346	71	104	4	30	33	0.9090909
NODE_269682_length_258_cov_1.855346	81	156	4	47	75	0.6266667
NODE_269682_length_258_cov_1.855346	81	156	6	28	75	0.3733333
NODE_269749_length_258_cov_1.735849	105	176	0	4	71	0.0563380
NODE_269749_length_258_cov_1.735849	105	176	4	3	71	0.0422535
NODE_269749_length_258_cov_1.735849	105	176	6	33	71	0.4647887
NODE_269749_length_258_cov_1.735849	105	176	8	17	71	0.2394366
NODE_269749_length_258_cov_1.735849	105	176	10	2	71	0.0281690
NODE_269749_length_258_cov_1.735849	105	176	12	11	71	0.1549296
NODE_269749_length_258_cov_1.735849	105	176	14	1	71	0.0140845
NODE_269767_length_258_cov_1.710692	8	49	0	23	41	0.5609756
NODE_269767_length_258_cov_1.710692	8	49	2	18	41	0.4390244
NODE_270191_length_258_cov_1.283019	127	191	0	64	64	1.0000000
NODE_270191_length_258_cov_1.283019	164	227	0	63	63	1.0000000
NODE_270465_length_258_cov_1.270440	4	55	0	51	51	1.0000000
NODE_270504_length_258_cov_1.232704	90	166	2	4	76	0.0526316
NODE_270504_length_258_cov_1.232704	90	166	6	1	76	0.0131579
NODE_270504_length_258_cov_1.232704	90	166	8	1	76	0.0131579
NODE_270504_length_258_cov_1.232704	90	166	10	1	76	0.0131579
NODE_270504_length_258_cov_1.232704	90	166	12	1	76	0.0131579
NODE_270504_length_258_cov_1.232704	90	166	16	8	76	0.1052632
NODE_270504_length_258_cov_1.232704	90	166	18	40	76	0.5263158
NODE_270504_length_258_cov_1.232704	90	166	22	2	76	0.0263158
NODE_270504_length_258_cov_1.232704	90	166	26	13	76	0.1710526
NODE_270504_length_258_cov_1.232704	90	166	28	5	76	0.0657895
NODE_270547_length_258_cov_1.201258	49	98	2	49	49	1.0000000
NODE_270876_length_258_cov_0.962264	186	258	0	72	72	1.0000000
NODE_270970_length_258_cov_0.962264	69	124	0	55	55	1.0000000
NODE_272169_length_257_cov_71.158228	81	165	74	3	84	0.0357143
NODE_272169_length_257_cov_71.158228	81	165	80	2	84	0.0238095
NODE_272169_length_257_cov_71.158228	81	165	84	2	84	0.0238095
NODE_272169_length_257_cov_71.158228	81	165	87	1	84	0.0119048
NODE_272169_length_257_cov_71.158228	81	165	94	1	84	0.0119048
NODE_272169_length_257_cov_71.158228	81	165	97	6	84	0.0714286
NODE_272169_length_257_cov_71.158228	81	165	99	2	84	0.0238095
NODE_272169_length_257_cov_71.158228	81	165	101	3	84	0.0357143
NODE_272169_length_257_cov_71.158228	81	165	105	5	84	0.0595238
NODE_272169_length_257_cov_71.158228	81	165	106	2	84	0.0238095
NODE_272169_length_257_cov_71.158228	81	165	107	1	84	0.0119048
NODE_272169_length_257_cov_71.158228	81	165	108	4	84	0.0476190
NODE_272169_length_257_cov_71.158228	81	165	110	2	84	0.0238095
NODE_272169_length_257_cov_71.158228	81	165	111	2	84	0.0238095
NODE_272169_length_257_cov_71.158228	81	165	112	1	84	0.0119048
NODE_272169_length_257_cov_71.158228	81	165	113	6	84	0.0714286
NODE_272169_length_257_cov_71.158228	81	165	114	2	84	0.0238095
NODE_272169_length_257_cov_71.158228	81	165	116	5	84	0.0595238
NODE_272169_length_257_cov_71.158228	81	165	117	3	84	0.0357143
NODE_272169_length_257_cov_71.158228	81	165	118	4	84	0.0476190
NODE_272169_length_257_cov_71.158228	81	165	119	1	84	0.0119048
NODE_272169_length_257_cov_71.158228	81	165	120	2	84	0.0238095
NODE_272169_length_257_cov_71.158228	81	165	121	7	84	0.0833333
NODE_272169_length_257_cov_71.158228	81	165	122	5	84	0.0595238
NODE_272169_length_257_cov_71.158228	81	165	124	8	84	0.0952381
NODE_272169_length_257_cov_71.158228	81	165	126	1	84	0.0119048
NODE_272169_length_257_cov_71.158228	81	165	128	3	84	0.0357143
NODE_272169_length_257_cov_71.158228	145	218	46	1	73	0.0136986
NODE_272169_length_257_cov_71.158228	145	218	48	1	73	0.0136986
NODE_272169_length_257_cov_71.158228	145	218	52	1	73	0.0136986
NODE_272169_length_257_cov_71.158228	145	218	58	3	73	0.0410959
NODE_272169_length_257_cov_71.158228	145	218	64	8	73	0.1095890
NODE_272169_length_257_cov_71.158228	145	218	66	6	73	0.0821918
NODE_272169_length_257_cov_71.158228	145	218	68	2	73	0.0273973
NODE_272169_length_257_cov_71.158228	145	218	70	1	73	0.0136986
NODE_272169_length_257_cov_71.158228	145	218	72	7	73	0.0958904
NODE_272169_length_257_cov_71.158228	145	218	76	1	73	0.0136986
NODE_272169_length_257_cov_71.158228	145	218	78	2	73	0.0273973
NODE_272169_length_257_cov_71.158228	145	218	84	2	73	0.0273973
NODE_272169_length_257_cov_71.158228	145	218	86	6	73	0.0821918
NODE_272169_length_257_cov_71.158228	145	218	90	6	73	0.0821918
NODE_272169_length_257_cov_71.158228	145	218	92	1	73	0.0136986
NODE_272169_length_257_cov_71.158228	145	218	94	1	73	0.0136986
NODE_272169_length_257_cov_71.158228	145	218	100	1	73	0.0136986
NODE_272169_length_257_cov_71.158228	145	218	102	1	73	0.0136986
NODE_272169_length_257_cov_71.158228	145	218	104	1	73	0.0136986
NODE_272169_length_257_cov_71.158228	145	218	106	3	73	0.0410959
NODE_272169_length_257_cov_71.158228	145	218	108	4	73	0.0547945
NODE_272169_length_257_cov_71.158228	145	218	110	1	73	0.0136986
NODE_272169_length_257_cov_71.158228	145	218	112	1	73	0.0136986
NODE_272169_length_257_cov_71.158228	145	218	114	2	73	0.0273973
NODE_272169_length_257_cov_71.158228	145	218	116	5	73	0.0684932
NODE_272169_length_257_cov_71.158228	145	218	118	4	73	0.0547945
NODE_272169_length_257_cov_71.158228	145	218	124	1	73	0.0136986
NODE_272194_length_257_cov_6.329114	15	93	0	78	78	1.0000000
NODE_272275_length_257_cov_4.177215	25	86	0	61	61	1.0000000
NODE_272291_length_257_cov_3.987342	55	107	6	52	52	1.0000000
NODE_272304_length_257_cov_3.873418	145	225	0	80	80	1.0000000
NODE_272304_length_257_cov_3.873418	198	254	0	56	56	1.0000000
NODE_272322_length_257_cov_3.740506	133	199	6	3	66	0.0454545
NODE_272322_length_257_cov_3.740506	133	199	8	3	66	0.0454545
NODE_272322_length_257_cov_3.740506	133	199	11	7	66	0.1060606
NODE_272322_length_257_cov_3.740506	133	199	13	3	66	0.0454545
NODE_272322_length_257_cov_3.740506	133	199	14	2	66	0.0303030
NODE_272322_length_257_cov_3.740506	133	199	20	4	66	0.0606061
NODE_272322_length_257_cov_3.740506	133	199	22	2	66	0.0303030
NODE_272322_length_257_cov_3.740506	133	199	25	1	66	0.0151515
NODE_272322_length_257_cov_3.740506	133	199	26	1	66	0.0151515
NODE_272322_length_257_cov_3.740506	133	199	27	5	66	0.0757576
NODE_272322_length_257_cov_3.740506	133	199	29	1	66	0.0151515
NODE_272322_length_257_cov_3.740506	133	199	31	1	66	0.0151515
NODE_272322_length_257_cov_3.740506	133	199	32	4	66	0.0606061
NODE_272322_length_257_cov_3.740506	133	199	33	6	66	0.0909091
NODE_272322_length_257_cov_3.740506	133	199	35	2	66	0.0303030
NODE_272322_length_257_cov_3.740506	133	199	36	8	66	0.1212121
NODE_272322_length_257_cov_3.740506	133	199	38	2	66	0.0303030
NODE_272322_length_257_cov_3.740506	133	199	44	11	66	0.1666667
NODE_272322_length_257_cov_3.740506	177	256	2	28	79	0.3544304
NODE_272322_length_257_cov_3.740506	177	256	3	12	79	0.1518987
NODE_272322_length_257_cov_3.740506	177	256	4	8	79	0.1012658
NODE_272322_length_257_cov_3.740506	177	256	5	5	79	0.0632911
NODE_272322_length_257_cov_3.740506	177	256	6	7	79	0.0886076
NODE_272322_length_257_cov_3.740506	177	256	8	3	79	0.0379747
NODE_272322_length_257_cov_3.740506	177	256	11	7	79	0.0886076
NODE_272322_length_257_cov_3.740506	177	256	13	3	79	0.0379747
NODE_272322_length_257_cov_3.740506	177	256	14	2	79	0.0253165
NODE_272322_length_257_cov_3.740506	177	256	20	4	79	0.0506329
NODE_272486_length_257_cov_2.734177	1	65	0	64	64	1.0000000
NODE_272491_length_257_cov_2.677215	170	250	3	41	80	0.5125000
NODE_272491_length_257_cov_2.677215	170	250	7	1	80	0.0125000
NODE_272491_length_257_cov_2.677215	170	250	8	3	80	0.0375000
NODE_272491_length_257_cov_2.677215	170	250	14	3	80	0.0375000
NODE_272491_length_257_cov_2.677215	170	250	16	1	80	0.0125000
NODE_272491_length_257_cov_2.677215	170	250	18	7	80	0.0875000
NODE_272491_length_257_cov_2.677215	170	250	20	4	80	0.0500000
NODE_272491_length_257_cov_2.677215	170	250	22	2	80	0.0250000
NODE_272491_length_257_cov_2.677215	170	250	24	2	80	0.0250000
NODE_272491_length_257_cov_2.677215	170	250	28	2	80	0.0250000
NODE_272491_length_257_cov_2.677215	170	250	40	2	80	0.0250000
NODE_272491_length_257_cov_2.677215	170	250	42	8	80	0.1000000
NODE_272491_length_257_cov_2.677215	170	250	44	1	80	0.0125000
NODE_272491_length_257_cov_2.677215	170	250	46	3	80	0.0375000
NODE_272580_length_257_cov_2.537975	60	137	0	32	77	0.4155844
NODE_272580_length_257_cov_2.537975	60	137	2	45	77	0.5844156
NODE_272596_length_257_cov_2.487342	95	172	0	20	77	0.2597403
NODE_272596_length_257_cov_2.487342	95	172	1	6	77	0.0779221
NODE_272596_length_257_cov_2.487342	95	172	3	21	77	0.2727273
NODE_272596_length_257_cov_2.487342	95	172	6	4	77	0.0519481
NODE_272596_length_257_cov_2.487342	95	172	8	26	77	0.3376623
NODE_272625_length_257_cov_2.379747	106	186	2	20	80	0.2500000
NODE_272625_length_257_cov_2.379747	106	186	4	24	80	0.3000000
NODE_272625_length_257_cov_2.379747	106	186	8	12	80	0.1500000
NODE_272625_length_257_cov_2.379747	106	186	10	24	80	0.3000000
NODE_272625_length_257_cov_2.379747	159	207	6	12	48	0.2500000
NODE_272625_length_257_cov_2.379747	159	207	8	21	48	0.4375000
NODE_272625_length_257_cov_2.379747	159	207	10	15	48	0.3125000
NODE_272724_length_257_cov_2.221519	163	240	0	77	77	1.0000000
NODE_272729_length_257_cov_2.202532	16	97	0	81	81	1.0000000
NODE_273151_length_257_cov_1.664557	220	239	0	19	19	1.0000000
NODE_273357_length_257_cov_1.500000	85	166	6	27	81	0.3333333
NODE_273357_length_257_cov_1.500000	85	166	8	54	81	0.6666667
NODE_273462_length_257_cov_1.329114	120	186	4	66	66	1.0000000
NODE_273533_length_257_cov_1.291139	13	53	0	13	40	0.3250000
NODE_273533_length_257_cov_1.291139	13	53	2	27	40	0.6750000
NODE_273697_length_257_cov_1.291139	205	257	0	52	52	1.0000000
NODE_273894_length_257_cov_1.221519	10	74	0	64	64	1.0000000
NODE_273917_length_257_cov_1.196203	70	150	0	80	80	1.0000000
NODE_273917_length_257_cov_1.196203	123	204	0	81	81	1.0000000
NODE_275399_length_257_cov_0.645570	138	158	0	20	20	1.0000000
NODE_275419_length_257_cov_0.645570	181	241	0	59	60	0.9833333
NODE_275419_length_257_cov_0.645570	181	241	2	1	60	0.0166667
NODE_275598_length_256_cov_5.235669	30	77	2	47	47	1.0000000
NODE_275624_length_256_cov_4.598726	100	180	0	26	80	0.3250000
NODE_275624_length_256_cov_4.598726	100	180	2	54	80	0.6750000
NODE_275624_length_256_cov_4.598726	160	211	0	51	51	1.0000000
NODE_275682_length_256_cov_3.866242	112	166	0	13	54	0.2407407
NODE_275682_length_256_cov_3.866242	112	166	2	7	54	0.1296296
NODE_275682_length_256_cov_3.866242	112	166	4	10	54	0.1851852
NODE_275682_length_256_cov_3.866242	112	166	6	24	54	0.4444444
NODE_275840_length_256_cov_2.878981	79	159	0	37	80	0.4625000
NODE_275840_length_256_cov_2.878981	79	159	2	31	80	0.3875000
NODE_275840_length_256_cov_2.878981	79	159	4	12	80	0.1500000
NODE_275840_length_256_cov_2.878981	132	212	0	80	80	1.0000000
NODE_275909_length_256_cov_2.598726	157	222	0	65	65	1.0000000
NODE_275909_length_256_cov_2.598726	195	249	0	54	54	1.0000000
NODE_275981_length_256_cov_2.445860	104	183	0	79	79	1.0000000
NODE_276082_length_256_cov_2.229299	0	58	0	58	58	1.0000000
NODE_276082_length_256_cov_2.229299	17	68	0	51	51	1.0000000
NODE_276082_length_256_cov_2.229299	41	88	0	47	47	1.0000000
NODE_276082_length_256_cov_2.229299	42	122	0	80	80	1.0000000
NODE_276098_length_256_cov_2.184713	192	246	0	54	54	1.0000000
NODE_276119_length_256_cov_2.121019	150	236	0	49	86	0.5697674
NODE_276119_length_256_cov_2.121019	150	236	2	37	86	0.4302326
NODE_276174_length_256_cov_1.974522	130	174	4	1	44	0.0227273
NODE_276174_length_256_cov_1.974522	130	174	6	43	44	0.9772727
NODE_276471_length_256_cov_1.707006	39	92	0	1	53	0.0188679
NODE_276471_length_256_cov_1.707006	39	92	4	36	53	0.6792453
NODE_276471_length_256_cov_1.707006	39	92	7	4	53	0.0754717
NODE_276471_length_256_cov_1.707006	39	92	9	8	53	0.1509434
NODE_276471_length_256_cov_1.707006	39	92	11	4	53	0.0754717
NODE_276471_length_256_cov_1.707006	93	135	11	1	42	0.0238095
NODE_276471_length_256_cov_1.707006	93	135	13	3	42	0.0714286
NODE_276471_length_256_cov_1.707006	93	135	14	9	42	0.2142857
NODE_276471_length_256_cov_1.707006	93	135	18	1	42	0.0238095
NODE_276471_length_256_cov_1.707006	93	135	20	5	42	0.1190476
NODE_276471_length_256_cov_1.707006	93	135	22	7	42	0.1666667
NODE_276471_length_256_cov_1.707006	93	135	24	1	42	0.0238095
NODE_276471_length_256_cov_1.707006	93	135	26	1	42	0.0238095
NODE_276471_length_256_cov_1.707006	93	135	28	8	42	0.1904762
NODE_276471_length_256_cov_1.707006	93	135	30	6	42	0.1428571
NODE_276484_length_256_cov_1.700637	107	129	0	3	22	0.1363636
NODE_276484_length_256_cov_1.700637	107	129	4	19	22	0.8636364
NODE_276495_length_256_cov_1.675159	52	98	0	46	46	1.0000000
NODE_276654_length_256_cov_1.598726	125	202	2	9	77	0.1168831
NODE_276654_length_256_cov_1.598726	125	202	6	11	77	0.1428571
NODE_276654_length_256_cov_1.598726	125	202	8	6	77	0.0779221
NODE_276654_length_256_cov_1.598726	125	202	10	10	77	0.1298701
NODE_276654_length_256_cov_1.598726	125	202	12	2	77	0.0259740
NODE_276654_length_256_cov_1.598726	125	202	14	17	77	0.2207792
NODE_276654_length_256_cov_1.598726	125	202	16	22	77	0.2857143
NODE_276654_length_256_cov_1.598726	178	256	4	6	78	0.0769231
NODE_276654_length_256_cov_1.598726	178	256	6	2	78	0.0256410
NODE_276654_length_256_cov_1.598726	178	256	8	28	78	0.3589744
NODE_276654_length_256_cov_1.598726	178	256	10	1	78	0.0128205
NODE_276654_length_256_cov_1.598726	178	256	12	10	78	0.1282051
NODE_276654_length_256_cov_1.598726	178	256	14	11	78	0.1410256
NODE_276654_length_256_cov_1.598726	178	256	16	20	78	0.2564103
NODE_276672_length_256_cov_1.579618	110	172	7	2	62	0.0322581
NODE_276672_length_256_cov_1.579618	110	172	9	15	62	0.2419355
NODE_276672_length_256_cov_1.579618	110	172	13	37	62	0.5967742
NODE_276672_length_256_cov_1.579618	110	172	15	7	62	0.1129032
NODE_276672_length_256_cov_1.579618	110	172	16	1	62	0.0161290
NODE_276672_length_256_cov_1.579618	194	239	0	45	45	1.0000000
NODE_276742_length_256_cov_1.464968	112	135	2	23	23	1.0000000
NODE_276826_length_256_cov_1.331210	138	209	0	71	71	1.0000000
NODE_276826_length_256_cov_1.331210	182	240	0	58	58	1.0000000
NODE_277113_length_256_cov_1.299363	88	160	2	7	72	0.0972222
NODE_277113_length_256_cov_1.299363	88	160	4	22	72	0.3055556
NODE_277113_length_256_cov_1.299363	88	160	6	43	72	0.5972222
NODE_277305_length_256_cov_1.203822	3	43	0	17	40	0.4250000
NODE_277305_length_256_cov_1.203822	3	43	4	1	40	0.0250000
NODE_277305_length_256_cov_1.203822	3	43	5	7	40	0.1750000
NODE_277305_length_256_cov_1.203822	3	43	7	6	40	0.1500000
NODE_277305_length_256_cov_1.203822	3	43	9	8	40	0.2000000
NODE_277305_length_256_cov_1.203822	3	43	10	1	40	0.0250000
NODE_277305_length_256_cov_1.203822	16	96	0	4	80	0.0500000
NODE_277305_length_256_cov_1.203822	16	96	4	1	80	0.0125000
NODE_277305_length_256_cov_1.203822	16	96	5	7	80	0.0875000
NODE_277305_length_256_cov_1.203822	16	96	7	6	80	0.0750000
NODE_277305_length_256_cov_1.203822	16	96	9	8	80	0.1000000
NODE_277305_length_256_cov_1.203822	16	96	10	7	80	0.0875000
NODE_277305_length_256_cov_1.203822	16	96	12	4	80	0.0500000
NODE_277305_length_256_cov_1.203822	16	96	14	23	80	0.2875000
NODE_277305_length_256_cov_1.203822	16	96	16	20	80	0.2500000
NODE_278934_length_255_cov_73.756410	52	99	8	46	47	0.9787234
NODE_278934_length_255_cov_73.756410	52	99	10	1	47	0.0212766
NODE_278934_length_255_cov_73.756410	133	184	8	3	51	0.0588235
NODE_278934_length_255_cov_73.756410	133	184	10	25	51	0.4901961
NODE_278934_length_255_cov_73.756410	133	184	12	4	51	0.0784314
NODE_278934_length_255_cov_73.756410	133	184	17	1	51	0.0196078
NODE_278934_length_255_cov_73.756410	133	184	18	18	51	0.3529412
NODE_278934_length_255_cov_73.756410	157	237	0	21	80	0.2625000
NODE_278934_length_255_cov_73.756410	157	237	6	15	80	0.1875000
NODE_278934_length_255_cov_73.756410	157	237	8	20	80	0.2500000
NODE_278934_length_255_cov_73.756410	157	237	10	24	80	0.3000000
NODE_278937_length_255_cov_15.538462	219	255	0	36	36	1.0000000
NODE_279003_length_255_cov_4.884615	157	230	0	71	73	0.9726027
NODE_279003_length_255_cov_4.884615	157	230	12	2	73	0.0273973
NODE_279003_length_255_cov_4.884615	203	248	0	45	45	1.0000000
NODE_279058_length_255_cov_4.012821	68	148	0	35	80	0.4375000
NODE_279058_length_255_cov_4.012821	68	148	2	45	80	0.5625000
NODE_279075_length_255_cov_3.826923	16	80	4	5	64	0.0781250
NODE_279075_length_255_cov_3.826923	16	80	10	5	64	0.0781250
NODE_279075_length_255_cov_3.826923	16	80	12	52	64	0.8125000
NODE_279075_length_255_cov_3.826923	16	80	14	2	64	0.0312500
NODE_279102_length_255_cov_3.596154	30	60	0	2	30	0.0666667
NODE_279102_length_255_cov_3.596154	30	60	2	28	30	0.9333333
NODE_279134_length_255_cov_3.423077	64	109	2	7	45	0.1555556
NODE_279134_length_255_cov_3.423077	64	109	4	38	45	0.8444445
NODE_279166_length_255_cov_3.262821	0	48	6	6	48	0.1250000
NODE_279166_length_255_cov_3.262821	0	48	8	6	48	0.1250000
NODE_279166_length_255_cov_3.262821	0	48	9	12	48	0.2500000
NODE_279166_length_255_cov_3.262821	0	48	12	17	48	0.3541667
NODE_279166_length_255_cov_3.262821	0	48	14	7	48	0.1458333
NODE_279166_length_255_cov_3.262821	66	113	5	2	47	0.0425532
NODE_279166_length_255_cov_3.262821	66	113	9	7	47	0.1489362
NODE_279166_length_255_cov_3.262821	66	113	17	38	47	0.8085107
NODE_279241_length_255_cov_2.942308	157	176	0	19	19	1.0000000
NODE_279320_length_255_cov_2.621795	227	254	0	27	27	1.0000000
NODE_279379_length_255_cov_2.602564	131	185	0	4	54	0.0740741
NODE_279379_length_255_cov_2.602564	131	185	2	50	54	0.9259259
NODE_279427_length_255_cov_2.487179	43	119	2	9	76	0.1184211
NODE_279427_length_255_cov_2.487179	43	119	6	33	76	0.4342105
NODE_279427_length_255_cov_2.487179	43	119	8	34	76	0.4473684
NODE_279447_length_255_cov_2.435897	0	58	0	58	58	1.0000000
NODE_279462_length_255_cov_2.391026	189	255	0	66	66	1.0000000
NODE_279507_length_255_cov_2.288462	0	60	0	60	60	1.0000000
NODE_279510_length_255_cov_2.288462	0	74	0	74	74	1.0000000
NODE_279620_length_255_cov_2.089744	105	145	0	40	40	1.0000000
NODE_279649_length_255_cov_1.987179	0	72	0	72	72	1.0000000
NODE_279842_length_255_cov_1.910256	198	255	0	57	57	1.0000000
NODE_279871_length_255_cov_1.871795	16	68	0	52	52	1.0000000
NODE_279892_length_255_cov_1.826923	146	218	0	72	72	1.0000000
NODE_279956_length_255_cov_1.705128	0	45	0	44	45	0.9777778
NODE_279956_length_255_cov_1.705128	0	45	2	1	45	0.0222222
NODE_279956_length_255_cov_1.705128	41	121	0	3	80	0.0375000
NODE_279956_length_255_cov_1.705128	41	121	2	3	80	0.0375000
NODE_279956_length_255_cov_1.705128	41	121	6	8	80	0.1000000
NODE_279956_length_255_cov_1.705128	41	121	8	66	80	0.8250000
NODE_279956_length_255_cov_1.705128	94	174	2	8	80	0.1000000
NODE_279956_length_255_cov_1.705128	94	174	4	2	80	0.0250000
NODE_279956_length_255_cov_1.705128	94	174	6	5	80	0.0625000
NODE_279956_length_255_cov_1.705128	94	174	8	36	80	0.4500000
NODE_279956_length_255_cov_1.705128	94	174	9	23	80	0.2875000
NODE_279956_length_255_cov_1.705128	94	174	10	6	80	0.0750000
NODE_280153_length_255_cov_1.576923	43	117	0	3	74	0.0405405
NODE_280153_length_255_cov_1.576923	43	117	2	4	74	0.0540541
NODE_280153_length_255_cov_1.576923	43	117	4	24	74	0.3243243
NODE_280153_length_255_cov_1.576923	43	117	6	18	74	0.2432432
NODE_280153_length_255_cov_1.576923	43	117	16	3	74	0.0405405
NODE_280153_length_255_cov_1.576923	43	117	18	22	74	0.2972973
NODE_280153_length_255_cov_1.576923	90	175	2	2	85	0.0235294
NODE_280153_length_255_cov_1.576923	90	175	16	3	85	0.0352941
NODE_280153_length_255_cov_1.576923	90	175	18	56	85	0.6588235
NODE_280153_length_255_cov_1.576923	90	175	20	24	85	0.2823530
NODE_280168_length_255_cov_1.557692	62	125	4	63	63	1.0000000
NODE_280297_length_255_cov_1.358974	178	246	0	68	68	1.0000000
NODE_280904_length_255_cov_1.128205	183	219	0	36	36	1.0000000
NODE_281094_length_255_cov_0.987179	220	241	0	21	21	1.0000000
NODE_281380_length_255_cov_0.955128	119	171	2	52	52	1.0000000
NODE_281384_length_255_cov_0.955128	12	92	4	80	80	1.0000000
NODE_282137_length_255_cov_0.653846	87	106	0	19	19	1.0000000
NODE_282534_length_254_cov_4.935484	144	189	6	27	45	0.6000000
NODE_282534_length_254_cov_4.935484	144	189	8	18	45	0.4000000
NODE_282534_length_254_cov_4.935484	164	242	0	30	78	0.3846154
NODE_282534_length_254_cov_4.935484	164	242	6	48	78	0.6153846
NODE_282548_length_254_cov_4.722581	44	85	2	41	41	1.0000000
NODE_282576_length_254_cov_4.296774	149	174	0	25	25	1.0000000
NODE_282576_length_254_cov_4.296774	149	223	0	74	74	1.0000000
NODE_282590_length_254_cov_4.206452	57	86	18	7	29	0.2413793
NODE_282590_length_254_cov_4.206452	57	86	24	8	29	0.2758621
NODE_282590_length_254_cov_4.206452	57	86	26	3	29	0.1034483
NODE_282590_length_254_cov_4.206452	57	86	28	11	29	0.3793103
NODE_282626_length_254_cov_3.677419	7	64	2	11	57	0.1929825
NODE_282626_length_254_cov_3.677419	7	64	4	2	57	0.0350877
NODE_282626_length_254_cov_3.677419	7	64	6	1	57	0.0175439
NODE_282626_length_254_cov_3.677419	7	64	8	19	57	0.3333333
NODE_282626_length_254_cov_3.677419	7	64	10	24	57	0.4210526
NODE_282626_length_254_cov_3.677419	60	117	6	20	57	0.3508772
NODE_282626_length_254_cov_3.677419	60	117	8	9	57	0.1578947
NODE_282626_length_254_cov_3.677419	60	117	10	28	57	0.4912281
NODE_282642_length_254_cov_3.593548	154	197	0	2	43	0.0465116
NODE_282642_length_254_cov_3.593548	154	197	2	41	43	0.9534883
NODE_282659_length_254_cov_3.438710	82	129	0	43	47	0.9148936
NODE_282659_length_254_cov_3.438710	82	129	2	4	47	0.0851064
NODE_282659_length_254_cov_3.438710	102	182	0	27	80	0.3375000
NODE_282659_length_254_cov_3.438710	102	182	1	53	80	0.6625000
NODE_282736_length_254_cov_2.961290	5	79	0	19	74	0.2567568
NODE_282736_length_254_cov_2.961290	5	79	2	1	74	0.0135135
NODE_282736_length_254_cov_2.961290	5	79	4	54	74	0.7297297
NODE_282736_length_254_cov_2.961290	52	118	4	66	66	1.0000000
NODE_282771_length_254_cov_2.780645	169	252	0	3	83	0.0361446
NODE_282771_length_254_cov_2.780645	169	252	2	10	83	0.1204819
NODE_282771_length_254_cov_2.780645	169	252	4	2	83	0.0240964
NODE_282771_length_254_cov_2.780645	169	252	5	11	83	0.1325301
NODE_282771_length_254_cov_2.780645	169	252	7	2	83	0.0240964
NODE_282771_length_254_cov_2.780645	169	252	9	2	83	0.0240964
NODE_282771_length_254_cov_2.780645	169	252	10	13	83	0.1566265
NODE_282771_length_254_cov_2.780645	169	252	12	3	83	0.0361446
NODE_282771_length_254_cov_2.780645	169	252	18	1	83	0.0120482
NODE_282771_length_254_cov_2.780645	169	252	20	3	83	0.0361446
NODE_282771_length_254_cov_2.780645	169	252	26	1	83	0.0120482
NODE_282771_length_254_cov_2.780645	169	252	30	2	83	0.0240964
NODE_282771_length_254_cov_2.780645	169	252	33	3	83	0.0361446
NODE_282771_length_254_cov_2.780645	169	252	35	5	83	0.0602410
NODE_282771_length_254_cov_2.780645	169	252	41	2	83	0.0240964
NODE_282771_length_254_cov_2.780645	169	252	43	1	83	0.0120482
NODE_282771_length_254_cov_2.780645	169	252	47	1	83	0.0120482
NODE_282771_length_254_cov_2.780645	169	252	49	3	83	0.0361446
NODE_282771_length_254_cov_2.780645	169	252	51	4	83	0.0481928
NODE_282771_length_254_cov_2.780645	169	252	53	7	83	0.0843373
NODE_282771_length_254_cov_2.780645	169	252	55	4	83	0.0481928
NODE_282947_length_254_cov_2.341935	167	201	0	34	34	1.0000000
NODE_283082_length_254_cov_2.161290	14	74	0	60	60	1.0000000
NODE_283244_length_254_cov_1.974194	156	204	0	39	48	0.8125000
NODE_283244_length_254_cov_1.974194	156	204	2	9	48	0.1875000
NODE_283440_length_254_cov_1.780645	79	126	2	4	47	0.0851064
NODE_283440_length_254_cov_1.780645	79	126	8	6	47	0.1276596
NODE_283440_length_254_cov_1.780645	79	126	10	3	47	0.0638298
NODE_283440_length_254_cov_1.780645	79	126	12	5	47	0.1063830
NODE_283440_length_254_cov_1.780645	79	126	16	8	47	0.1702128
NODE_283440_length_254_cov_1.780645	79	126	20	21	47	0.4468085
NODE_283952_length_254_cov_1.316129	23	87	0	64	64	1.0000000
NODE_284013_length_254_cov_1.316129	193	215	0	22	22	1.0000000
NODE_284256_length_254_cov_1.258065	181	249	0	68	68	1.0000000
NODE_284275_length_254_cov_1.238710	9	82	0	68	73	0.9315069
NODE_284275_length_254_cov_1.238710	9	82	2	3	73	0.0410959
NODE_284275_length_254_cov_1.238710	9	82	4	2	73	0.0273973
NODE_284275_length_254_cov_1.238710	62	82	0	15	20	0.7500000
NODE_284275_length_254_cov_1.238710	62	82	2	3	20	0.1500000
NODE_284275_length_254_cov_1.238710	62	82	4	2	20	0.1000000
NODE_284277_length_254_cov_1.238710	54	73	0	19	19	1.0000000
NODE_284301_length_254_cov_1.219355	98	157	0	59	59	1.0000000
NODE_284638_length_254_cov_0.987097	139	193	0	54	54	1.0000000
NODE_284638_length_254_cov_0.987097	205	254	0	9	49	0.1836735
NODE_284638_length_254_cov_0.987097	205	254	2	40	49	0.8163266
NODE_284796_length_254_cov_0.987097	121	152	0	31	31	1.0000000
NODE_285963_length_253_cov_60.311688	137	202	4	1	65	0.0153846
NODE_285963_length_253_cov_60.311688	137	202	24	3	65	0.0461538
NODE_285963_length_253_cov_60.311688	137	202	26	1	65	0.0153846
NODE_285963_length_253_cov_60.311688	137	202	28	3	65	0.0461538
NODE_285963_length_253_cov_60.311688	137	202	36	2	65	0.0307692
NODE_285963_length_253_cov_60.311688	137	202	39	2	65	0.0307692
NODE_285963_length_253_cov_60.311688	137	202	40	1	65	0.0153846
NODE_285963_length_253_cov_60.311688	137	202	42	52	65	0.8000000
NODE_285963_length_253_cov_60.311688	175	253	6	1	78	0.0128205
NODE_285963_length_253_cov_60.311688	175	253	10	3	78	0.0384615
NODE_285963_length_253_cov_60.311688	175	253	14	1	78	0.0128205
NODE_285963_length_253_cov_60.311688	175	253	20	1	78	0.0128205
NODE_285963_length_253_cov_60.311688	175	253	27	1	78	0.0128205
NODE_285963_length_253_cov_60.311688	175	253	28	1	78	0.0128205
NODE_285963_length_253_cov_60.311688	175	253	30	3	78	0.0384615
NODE_285963_length_253_cov_60.311688	175	253	32	1	78	0.0128205
NODE_285963_length_253_cov_60.311688	175	253	34	3	78	0.0384615
NODE_285963_length_253_cov_60.311688	175	253	40	5	78	0.0641026
NODE_285963_length_253_cov_60.311688	175	253	42	58	78	0.7435898
NODE_285965_length_253_cov_41.519481	0	68	0	11	68	0.1617647
NODE_285965_length_253_cov_41.519481	0	68	8	1	68	0.0147059
NODE_285965_length_253_cov_41.519481	0	68	10	5	68	0.0735294
NODE_285965_length_253_cov_41.519481	0	68	15	9	68	0.1323529
NODE_285965_length_253_cov_41.519481	0	68	17	8	68	0.1176471
NODE_285965_length_253_cov_41.519481	0	68	18	3	68	0.0441176
NODE_285965_length_253_cov_41.519481	0	68	20	7	68	0.1029412
NODE_285965_length_253_cov_41.519481	0	68	22	24	68	0.3529412
NODE_285965_length_253_cov_41.519481	0	70	0	11	70	0.1571429
NODE_285965_length_253_cov_41.519481	0	70	8	1	70	0.0142857
NODE_285965_length_253_cov_41.519481	0	70	10	5	70	0.0714286
NODE_285965_length_253_cov_41.519481	0	70	15	9	70	0.1285714
NODE_285965_length_253_cov_41.519481	0	70	17	8	70	0.1142857
NODE_285965_length_253_cov_41.519481	0	70	18	3	70	0.0428571
NODE_285965_length_253_cov_41.519481	0	70	20	7	70	0.1000000
NODE_285965_length_253_cov_41.519481	0	70	22	26	70	0.3714286
NODE_285965_length_253_cov_41.519481	2	73	0	9	71	0.1267606
NODE_285965_length_253_cov_41.519481	2	73	8	1	71	0.0140845
NODE_285965_length_253_cov_41.519481	2	73	10	5	71	0.0704225
NODE_285965_length_253_cov_41.519481	2	73	15	9	71	0.1267606
NODE_285965_length_253_cov_41.519481	2	73	17	8	71	0.1126761
NODE_285965_length_253_cov_41.519481	2	73	18	3	71	0.0422535
NODE_285965_length_253_cov_41.519481	2	73	20	7	71	0.0985916
NODE_285965_length_253_cov_41.519481	2	73	22	27	71	0.3802817
NODE_285965_length_253_cov_41.519481	2	73	24	2	71	0.0281690
NODE_285965_length_253_cov_41.519481	7	73	0	4	66	0.0606061
NODE_285965_length_253_cov_41.519481	7	73	8	1	66	0.0151515
NODE_285965_length_253_cov_41.519481	7	73	10	5	66	0.0757576
NODE_285965_length_253_cov_41.519481	7	73	15	9	66	0.1363636
NODE_285965_length_253_cov_41.519481	7	73	17	8	66	0.1212121
NODE_285965_length_253_cov_41.519481	7	73	18	3	66	0.0454545
NODE_285965_length_253_cov_41.519481	7	73	20	7	66	0.1060606
NODE_285965_length_253_cov_41.519481	7	73	22	27	66	0.4090909
NODE_285965_length_253_cov_41.519481	7	73	24	2	66	0.0303030
NODE_285965_length_253_cov_41.519481	46	123	8	9	77	0.1168831
NODE_285965_length_253_cov_41.519481	46	123	17	1	77	0.0129870
NODE_285965_length_253_cov_41.519481	46	123	18	1	77	0.0129870
NODE_285965_length_253_cov_41.519481	46	123	20	2	77	0.0259740
NODE_285965_length_253_cov_41.519481	46	123	22	25	77	0.3246753
NODE_285965_length_253_cov_41.519481	46	123	24	3	77	0.0389610
NODE_285965_length_253_cov_41.519481	46	123	26	36	77	0.4675325
NODE_285965_length_253_cov_41.519481	46	123	8	9	77	0.1168831
NODE_285965_length_253_cov_41.519481	46	123	17	1	77	0.0129870
NODE_285965_length_253_cov_41.519481	46	123	18	1	77	0.0129870
NODE_285965_length_253_cov_41.519481	46	123	20	2	77	0.0259740
NODE_285965_length_253_cov_41.519481	46	123	22	25	77	0.3246753
NODE_285965_length_253_cov_41.519481	46	123	24	3	77	0.0389610
NODE_285965_length_253_cov_41.519481	46	123	26	36	77	0.4675325
NODE_285965_length_253_cov_41.519481	46	123	8	9	77	0.1168831
NODE_285965_length_253_cov_41.519481	46	123	17	1	77	0.0129870
NODE_285965_length_253_cov_41.519481	46	123	18	1	77	0.0129870
NODE_285965_length_253_cov_41.519481	46	123	20	2	77	0.0259740
NODE_285965_length_253_cov_41.519481	46	123	22	25	77	0.3246753
NODE_285965_length_253_cov_41.519481	46	123	24	3	77	0.0389610
NODE_285965_length_253_cov_41.519481	46	123	26	36	77	0.4675325
NODE_285967_length_253_cov_13.967532	25	105	0	80	80	1.0000000
NODE_285967_length_253_cov_13.967532	78	158	0	80	80	1.0000000
NODE_285969_length_253_cov_12.259740	0	54	0	54	54	1.0000000
NODE_285969_length_253_cov_12.259740	27	62	0	35	35	1.0000000
NODE_285969_length_253_cov_12.259740	51	131	0	80	80	1.0000000
NODE_285969_length_253_cov_12.259740	104	139	0	35	35	1.0000000
NODE_285969_length_253_cov_12.259740	128	208	0	80	80	1.0000000
NODE_285969_length_253_cov_12.259740	181	216	0	35	35	1.0000000
NODE_285987_length_253_cov_7.279221	184	250	0	59	66	0.8939394
NODE_285987_length_253_cov_7.279221	184	250	4	7	66	0.1060606
NODE_286022_length_253_cov_5.376623	66	147	8	1	81	0.0123457
NODE_286022_length_253_cov_5.376623	66	147	12	5	81	0.0617284
NODE_286022_length_253_cov_5.376623	66	147	14	9	81	0.1111111
NODE_286022_length_253_cov_5.376623	66	147	16	27	81	0.3333333
NODE_286022_length_253_cov_5.376623	66	147	18	6	81	0.0740741
NODE_286022_length_253_cov_5.376623	66	147	20	33	81	0.4074074
NODE_286022_length_253_cov_5.376623	120	185	13	1	65	0.0153846
NODE_286022_length_253_cov_5.376623	120	185	15	3	65	0.0461538
NODE_286022_length_253_cov_5.376623	120	185	16	22	65	0.3384615
NODE_286022_length_253_cov_5.376623	120	185	18	28	65	0.4307692
NODE_286022_length_253_cov_5.376623	120	185	20	11	65	0.1692308
NODE_286042_length_253_cov_4.896104	102	182	31	10	80	0.1250000
NODE_286042_length_253_cov_4.896104	102	182	38	1	80	0.0125000
NODE_286042_length_253_cov_4.896104	102	182	40	5	80	0.0625000
NODE_286042_length_253_cov_4.896104	102	182	42	2	80	0.0250000
NODE_286042_length_253_cov_4.896104	102	182	43	8	80	0.1000000
NODE_286042_length_253_cov_4.896104	102	182	47	5	80	0.0625000
NODE_286042_length_253_cov_4.896104	102	182	49	1	80	0.0125000
NODE_286042_length_253_cov_4.896104	102	182	51	1	80	0.0125000
NODE_286042_length_253_cov_4.896104	102	182	55	1	80	0.0125000
NODE_286042_length_253_cov_4.896104	102	182	57	12	80	0.1500000
NODE_286042_length_253_cov_4.896104	102	182	59	6	80	0.0750000
NODE_286042_length_253_cov_4.896104	102	182	60	2	80	0.0250000
NODE_286042_length_253_cov_4.896104	102	182	61	2	80	0.0250000
NODE_286042_length_253_cov_4.896104	102	182	64	4	80	0.0500000
NODE_286042_length_253_cov_4.896104	102	182	65	6	80	0.0750000
NODE_286042_length_253_cov_4.896104	102	182	66	4	80	0.0500000
NODE_286042_length_253_cov_4.896104	102	182	67	2	80	0.0250000
NODE_286042_length_253_cov_4.896104	102	182	68	8	80	0.1000000
NODE_286046_length_253_cov_4.798701	199	253	0	54	54	1.0000000
NODE_286069_length_253_cov_4.487013	85	126	0	41	41	1.0000000
NODE_286151_length_253_cov_3.500000	44	105	6	9	61	0.1475410
NODE_286151_length_253_cov_3.500000	44	105	8	25	61	0.4098361
NODE_286151_length_253_cov_3.500000	44	105	10	27	61	0.4426230
NODE_286151_length_253_cov_3.500000	90	158	0	16	68	0.2352941
NODE_286151_length_253_cov_3.500000	90	158	2	18	68	0.2647059
NODE_286151_length_253_cov_3.500000	90	158	6	28	68	0.4117647
NODE_286151_length_253_cov_3.500000	90	158	8	6	68	0.0882353
NODE_286259_length_253_cov_2.987013	85	165	0	80	80	1.0000000
NODE_286259_length_253_cov_2.987013	138	169	0	31	31	1.0000000
NODE_286275_length_253_cov_2.954545	100	148	0	48	48	1.0000000
NODE_286281_length_253_cov_2.909091	34	99	12	1	65	0.0153846
NODE_286281_length_253_cov_2.909091	34	99	14	7	65	0.1076923
NODE_286281_length_253_cov_2.909091	34	99	16	2	65	0.0307692
NODE_286281_length_253_cov_2.909091	34	99	20	24	65	0.3692308
NODE_286281_length_253_cov_2.909091	34	99	21	5	65	0.0769231
NODE_286281_length_253_cov_2.909091	34	99	22	26	65	0.4000000
NODE_286288_length_253_cov_2.889610	129	200	3	14	71	0.1971831
NODE_286288_length_253_cov_2.889610	129	200	5	2	71	0.0281690
NODE_286288_length_253_cov_2.889610	129	200	7	4	71	0.0563380
NODE_286288_length_253_cov_2.889610	129	200	9	12	71	0.1690141
NODE_286288_length_253_cov_2.889610	129	200	10	4	71	0.0563380
NODE_286288_length_253_cov_2.889610	129	200	12	20	71	0.2816902
NODE_286288_length_253_cov_2.889610	129	200	13	3	71	0.0422535
NODE_286288_length_253_cov_2.889610	129	200	15	12	71	0.1690141
NODE_286288_length_253_cov_2.889610	173	253	6	3	80	0.0375000
NODE_286288_length_253_cov_2.889610	173	253	8	16	80	0.2000000
NODE_286288_length_253_cov_2.889610	173	253	9	6	80	0.0750000
NODE_286288_length_253_cov_2.889610	173	253	10	4	80	0.0500000
NODE_286288_length_253_cov_2.889610	173	253	12	51	80	0.6375000
NODE_286289_length_253_cov_2.889610	21	76	1	55	55	1.0000000
NODE_286289_length_253_cov_2.889610	149	229	0	80	80	1.0000000
NODE_286379_length_253_cov_2.610390	113	193	0	46	80	0.5750000
NODE_286379_length_253_cov_2.610390	113	193	2	34	80	0.4250000
NODE_286386_length_253_cov_2.584416	97	154	0	57	57	1.0000000
NODE_286545_length_253_cov_2.240260	185	250	0	63	65	0.9692308
NODE_286545_length_253_cov_2.240260	185	250	1	2	65	0.0307692
NODE_286667_length_253_cov_1.987013	157	237	0	80	80	1.0000000
NODE_286667_length_253_cov_1.987013	210	253	0	43	43	1.0000000
NODE_286685_length_253_cov_1.987013	18	60	0	42	42	1.0000000
NODE_286829_length_253_cov_1.961039	186	232	0	46	46	1.0000000
NODE_286837_length_253_cov_1.948052	68	120	0	52	52	1.0000000
NODE_286838_length_253_cov_1.948052	63	114	0	51	51	1.0000000
NODE_286947_length_253_cov_1.746753	164	193	1	13	29	0.4482759
NODE_286947_length_253_cov_1.746753	164	193	2	16	29	0.5517241
NODE_287031_length_253_cov_1.655844	40	120	0	10	80	0.1250000
NODE_287031_length_253_cov_1.655844	40	120	2	13	80	0.1625000
NODE_287031_length_253_cov_1.655844	40	120	4	57	80	0.7125000
NODE_287031_length_253_cov_1.655844	93	152	2	16	59	0.2711864
NODE_287031_length_253_cov_1.655844	93	152	4	43	59	0.7288136
NODE_287133_length_253_cov_1.590909	102	148	0	46	46	1.0000000
NODE_287156_length_253_cov_1.558442	67	149	0	82	82	1.0000000
NODE_287230_length_253_cov_1.441558	49	113	0	38	64	0.5937500
NODE_287230_length_253_cov_1.441558	49	113	2	26	64	0.4062500
NODE_287230_length_253_cov_1.441558	102	166	2	64	64	1.0000000
NODE_287232_length_253_cov_1.441558	121	185	0	11	64	0.1718750
NODE_287232_length_253_cov_1.441558	121	185	4	29	64	0.4531250
NODE_287232_length_253_cov_1.441558	121	185	5	24	64	0.3750000
NODE_287234_length_253_cov_1.435065	50	81	2	31	31	1.0000000
NODE_287584_length_253_cov_1.324675	193	239	2	46	46	1.0000000
NODE_287599_length_253_cov_1.324675	90	132	34	6	42	0.1428571
NODE_287599_length_253_cov_1.324675	90	132	36	27	42	0.6428571
NODE_287599_length_253_cov_1.324675	90	132	38	9	42	0.2142857
NODE_287599_length_253_cov_1.324675	133	185	2	2	52	0.0384615
NODE_287599_length_253_cov_1.324675	133	185	6	2	52	0.0384615
NODE_287599_length_253_cov_1.324675	133	185	8	4	52	0.0769231
NODE_287599_length_253_cov_1.324675	133	185	10	3	52	0.0576923
NODE_287599_length_253_cov_1.324675	133	185	12	1	52	0.0192308
NODE_287599_length_253_cov_1.324675	133	185	14	1	52	0.0192308
NODE_287599_length_253_cov_1.324675	133	185	16	2	52	0.0384615
NODE_287599_length_253_cov_1.324675	133	185	18	4	52	0.0769231
NODE_287599_length_253_cov_1.324675	133	185	20	6	52	0.1153846
NODE_287599_length_253_cov_1.324675	133	185	22	2	52	0.0384615
NODE_287599_length_253_cov_1.324675	133	185	24	6	52	0.1153846
NODE_287599_length_253_cov_1.324675	133	185	30	2	52	0.0384615
NODE_287599_length_253_cov_1.324675	133	185	32	12	52	0.2307692
NODE_287599_length_253_cov_1.324675	133	185	34	5	52	0.0961538
NODE_287721_length_253_cov_1.285714	87	125	2	11	38	0.2894737
NODE_287721_length_253_cov_1.285714	87	125	4	27	38	0.7105263
NODE_287794_length_253_cov_1.214286	99	148	4	5	49	0.1020408
NODE_287794_length_253_cov_1.214286	99	148	6	44	49	0.8979592
NODE_287845_length_253_cov_1.181818	185	247	0	62	62	1.0000000
NODE_287845_length_253_cov_1.181818	185	247	0	62	62	1.0000000
NODE_287989_length_253_cov_1.064935	83	159	8	2	76	0.0263158
NODE_287989_length_253_cov_1.064935	83	159	10	1	76	0.0131579
NODE_287989_length_253_cov_1.064935	83	159	12	1	76	0.0131579
NODE_287989_length_253_cov_1.064935	83	159	16	2	76	0.0263158
NODE_287989_length_253_cov_1.064935	83	159	20	1	76	0.0131579
NODE_287989_length_253_cov_1.064935	83	159	26	1	76	0.0131579
NODE_287989_length_253_cov_1.064935	83	159	28	2	76	0.0263158
NODE_287989_length_253_cov_1.064935	83	159	30	3	76	0.0394737
NODE_287989_length_253_cov_1.064935	83	159	32	4	76	0.0526316
NODE_287989_length_253_cov_1.064935	83	159	34	5	76	0.0657895
NODE_287989_length_253_cov_1.064935	83	159	36	5	76	0.0657895
NODE_287989_length_253_cov_1.064935	83	159	38	31	76	0.4078947
NODE_287989_length_253_cov_1.064935	83	159	40	18	76	0.2368421
NODE_288099_length_253_cov_0.993506	0	44	0	44	44	1.0000000
NODE_288465_length_253_cov_0.870130	17	46	0	29	29	1.0000000
NODE_288478_length_253_cov_0.850649	0	89	0	89	89	1.0000000
NODE_289563_length_252_cov_4.771242	94	148	0	9	54	0.1666667
NODE_289563_length_252_cov_4.771242	94	148	2	45	54	0.8333333
NODE_289574_length_252_cov_4.614379	16	37	0	21	21	1.0000000
NODE_289624_length_252_cov_3.960784	7	85	0	78	78	1.0000000
NODE_289624_length_252_cov_3.960784	63	136	0	73	73	1.0000000
NODE_289663_length_252_cov_3.549020	89	157	0	68	68	1.0000000
NODE_289672_length_252_cov_3.405229	26	107	0	7	81	0.0864198
NODE_289672_length_252_cov_3.405229	26	107	2	11	81	0.1358025
NODE_289672_length_252_cov_3.405229	26	107	4	11	81	0.1358025
NODE_289672_length_252_cov_3.405229	26	107	6	26	81	0.3209876
NODE_289672_length_252_cov_3.405229	26	107	8	26	81	0.3209876
NODE_289705_length_252_cov_3.307190	91	141	2	50	50	1.0000000
NODE_289742_length_252_cov_3.032680	135	212	2	13	77	0.1688312
NODE_289742_length_252_cov_3.032680	135	212	4	15	77	0.1948052
NODE_289742_length_252_cov_3.032680	135	212	6	1	77	0.0129870
NODE_289742_length_252_cov_3.032680	135	212	8	48	77	0.6233766
NODE_289775_length_252_cov_2.928105	0	57	0	57	57	1.0000000
NODE_289799_length_252_cov_2.803922	41	121	0	80	80	1.0000000
NODE_290032_length_252_cov_2.320261	0	64	0	58	64	0.9062500
NODE_290032_length_252_cov_2.320261	0	64	4	1	64	0.0156250
NODE_290032_length_252_cov_2.320261	0	64	34	3	64	0.0468750
NODE_290032_length_252_cov_2.320261	0	64	38	2	64	0.0312500
NODE_290046_length_252_cov_2.281046	120	170	0	25	50	0.5000000
NODE_290046_length_252_cov_2.281046	120	170	2	25	50	0.5000000
NODE_290066_length_252_cov_2.215686	137	175	55	2	38	0.0526316
NODE_290066_length_252_cov_2.215686	137	175	56	5	38	0.1315790
NODE_290066_length_252_cov_2.215686	137	175	57	1	38	0.0263158
NODE_290066_length_252_cov_2.215686	137	175	58	12	38	0.3157895
NODE_290066_length_252_cov_2.215686	137	175	59	2	38	0.0526316
NODE_290066_length_252_cov_2.215686	137	175	60	15	38	0.3947369
NODE_290066_length_252_cov_2.215686	137	175	61	1	38	0.0263158
NODE_290103_length_252_cov_2.052288	18	39	0	21	21	1.0000000
NODE_290238_length_252_cov_1.993464	80	139	4	15	59	0.2542373
NODE_290238_length_252_cov_1.993464	80	139	6	44	59	0.7457627
NODE_290385_length_252_cov_1.810458	3	49	0	46	46	1.0000000
NODE_290623_length_252_cov_1.594771	103	156	0	53	53	1.0000000
NODE_290623_length_252_cov_1.594771	152	192	0	40	40	1.0000000
NODE_290638_length_252_cov_1.568627	1	68	0	59	67	0.8805970
NODE_290638_length_252_cov_1.568627	1	68	2	8	67	0.1194030
NODE_290767_length_252_cov_1.359477	26	93	0	67	67	1.0000000
NODE_290790_length_252_cov_1.333333	179	232	2	53	53	1.0000000
NODE_290850_length_252_cov_1.333333	187	222	0	35	35	1.0000000
NODE_291072_length_252_cov_1.333333	31	111	0	80	80	1.0000000
NODE_291076_length_252_cov_1.333333	90	140	6	4	50	0.0800000
NODE_291076_length_252_cov_1.333333	90	140	8	5	50	0.1000000
NODE_291076_length_252_cov_1.333333	90	140	10	1	50	0.0200000
NODE_291076_length_252_cov_1.333333	90	140	14	3	50	0.0600000
NODE_291076_length_252_cov_1.333333	90	140	16	10	50	0.2000000
NODE_291076_length_252_cov_1.333333	90	140	18	27	50	0.5400000
NODE_291118_length_252_cov_1.326797	112	143	4	21	31	0.6774194
NODE_291118_length_252_cov_1.326797	112	143	6	10	31	0.3225806
NODE_291351_length_252_cov_1.156863	1	32	0	22	31	0.7096774
NODE_291351_length_252_cov_1.156863	1	32	2	7	31	0.2258064
NODE_291351_length_252_cov_1.156863	1	32	4	2	31	0.0645161
NODE_291650_length_252_cov_1.000000	49	79	0	30	30	1.0000000
NODE_291911_length_252_cov_0.836601	125	172	0	14	47	0.2978723
NODE_291911_length_252_cov_0.836601	125	172	8	25	47	0.5319149
NODE_291911_length_252_cov_0.836601	125	172	12	1	47	0.0212766
NODE_291911_length_252_cov_0.836601	125	172	16	5	47	0.1063830
NODE_291911_length_252_cov_0.836601	125	172	18	2	47	0.0425532
NODE_293004_length_251_cov_5.032895	0	62	0	62	62	1.0000000
NODE_293005_length_251_cov_5.026316	84	164	0	80	80	1.0000000
NODE_293165_length_251_cov_3.302632	187	249	0	35	62	0.5645161
NODE_293165_length_251_cov_3.302632	187	249	1	13	62	0.2096774
NODE_293165_length_251_cov_3.302632	187	249	2	14	62	0.2258064
NODE_293195_length_251_cov_3.131579	96	148	0	8	52	0.1538462
NODE_293195_length_251_cov_3.131579	96	148	2	18	52	0.3461539
NODE_293195_length_251_cov_3.131579	96	148	6	26	52	0.5000000
NODE_293238_length_251_cov_2.980263	11	38	10	2	27	0.0740741
NODE_293238_length_251_cov_2.980263	11	38	11	1	27	0.0370370
NODE_293238_length_251_cov_2.980263	11	38	15	2	27	0.0740741
NODE_293238_length_251_cov_2.980263	11	38	16	6	27	0.2222222
NODE_293238_length_251_cov_2.980263	11	38	17	5	27	0.1851852
NODE_293238_length_251_cov_2.980263	11	38	18	1	27	0.0370370
NODE_293238_length_251_cov_2.980263	11	38	19	1	27	0.0370370
NODE_293238_length_251_cov_2.980263	11	38	26	3	27	0.1111111
NODE_293238_length_251_cov_2.980263	11	38	27	6	27	0.2222222
NODE_293238_length_251_cov_2.980263	11	91	10	2	80	0.0250000
NODE_293238_length_251_cov_2.980263	11	91	11	1	80	0.0125000
NODE_293238_length_251_cov_2.980263	11	91	15	2	80	0.0250000
NODE_293238_length_251_cov_2.980263	11	91	16	6	80	0.0750000
NODE_293238_length_251_cov_2.980263	11	91	17	5	80	0.0625000
NODE_293238_length_251_cov_2.980263	11	91	18	1	80	0.0125000
NODE_293238_length_251_cov_2.980263	11	91	19	1	80	0.0125000
NODE_293238_length_251_cov_2.980263	11	91	26	3	80	0.0375000
NODE_293238_length_251_cov_2.980263	11	91	27	15	80	0.1875000
NODE_293238_length_251_cov_2.980263	11	91	28	43	80	0.5375000
NODE_293238_length_251_cov_2.980263	11	91	29	1	80	0.0125000
NODE_293259_length_251_cov_2.842105	170	198	0	14	28	0.5000000
NODE_293259_length_251_cov_2.842105	170	198	2	14	28	0.5000000
NODE_293279_length_251_cov_2.743421	181	232	0	51	51	1.0000000
NODE_293335_length_251_cov_2.677632	35	54	0	19	19	1.0000000
NODE_293454_length_251_cov_2.348684	196	251	0	55	55	1.0000000
NODE_293502_length_251_cov_2.328947	86	149	0	58	63	0.9206349
NODE_293502_length_251_cov_2.328947	86	149	2	5	63	0.0793651
NODE_293516_length_251_cov_2.296053	91	171	0	14	80	0.1750000
NODE_293516_length_251_cov_2.296053	91	171	1	1	80	0.0125000
NODE_293516_length_251_cov_2.296053	91	171	2	6	80	0.0750000
NODE_293516_length_251_cov_2.296053	91	171	4	59	80	0.7375000
NODE_293516_length_251_cov_2.296053	144	224	0	67	80	0.8375000
NODE_293516_length_251_cov_2.296053	144	224	1	1	80	0.0125000
NODE_293516_length_251_cov_2.296053	144	224	2	6	80	0.0750000
NODE_293516_length_251_cov_2.296053	144	224	4	6	80	0.0750000
NODE_293591_length_251_cov_2.065789	7	52	0	45	45	1.0000000
NODE_293698_length_251_cov_2.013158	96	179	0	83	83	1.0000000
NODE_293698_length_251_cov_2.013158	96	179	0	83	83	1.0000000
NODE_293698_length_251_cov_2.013158	152	203	0	51	51	1.0000000
NODE_293698_length_251_cov_2.013158	152	201	0	49	49	1.0000000
NODE_293919_length_251_cov_1.710526	135	194	0	59	59	1.0000000
NODE_294028_length_251_cov_1.671053	94	127	0	33	33	1.0000000
NODE_294063_length_251_cov_1.644737	135	164	0	21	29	0.7241379
NODE_294063_length_251_cov_1.644737	135	164	4	8	29	0.2758621
NODE_294147_length_251_cov_1.473684	137	202	0	65	65	1.0000000
NODE_294153_length_251_cov_1.460526	17	78	0	7	61	0.1147541
NODE_294153_length_251_cov_1.460526	17	78	2	54	61	0.8852459
NODE_294190_length_251_cov_1.407895	182	246	0	64	64	1.0000000
NODE_294393_length_251_cov_1.342105	9	89	0	80	80	1.0000000
NODE_294393_length_251_cov_1.342105	62	91	0	29	29	1.0000000
NODE_294624_length_251_cov_1.296053	7	47	0	40	40	1.0000000
NODE_294624_length_251_cov_1.296053	24	47	0	23	23	1.0000000
NODE_295165_length_251_cov_1.006579	4	50	0	46	46	1.0000000
NODE_296033_length_251_cov_0.671053	184	204	0	20	20	1.0000000
NODE_296386_length_251_cov_0.572368	54	74	0	20	20	1.0000000
NODE_296437_length_250_cov_35.662252	33	99	0	66	66	1.0000000
NODE_296437_length_250_cov_35.662252	143	223	0	80	80	1.0000000
NODE_296456_length_250_cov_6.503311	186	250	0	5	64	0.0781250
NODE_296456_length_250_cov_6.503311	186	250	4	59	64	0.9218750
NODE_296467_length_250_cov_5.867550	99	120	0	21	21	1.0000000
NODE_296520_length_250_cov_4.662252	143	187	0	44	44	1.0000000
NODE_296520_length_250_cov_4.662252	160	227	0	67	67	1.0000000
NODE_296598_length_250_cov_3.715232	37	90	2	1	53	0.0188679
NODE_296598_length_250_cov_3.715232	37	90	4	52	53	0.9811321
NODE_296633_length_250_cov_3.417219	113	193	0	27	80	0.3375000
NODE_296633_length_250_cov_3.417219	113	193	2	47	80	0.5875000
NODE_296633_length_250_cov_3.417219	113	193	4	6	80	0.0750000
NODE_296633_length_250_cov_3.417219	166	246	0	80	80	1.0000000
NODE_296653_length_250_cov_3.364238	0	61	2	3	61	0.0491803
NODE_296653_length_250_cov_3.364238	0	61	4	1	61	0.0163934
NODE_296653_length_250_cov_3.364238	0	61	6	5	61	0.0819672
NODE_296653_length_250_cov_3.364238	0	61	8	3	61	0.0491803
NODE_296653_length_250_cov_3.364238	0	61	10	2	61	0.0327869
NODE_296653_length_250_cov_3.364238	0	61	14	13	61	0.2131148
NODE_296653_length_250_cov_3.364238	0	61	16	34	61	0.5573770
NODE_296653_length_250_cov_3.364238	34	94	16	60	60	1.0000000
NODE_296680_length_250_cov_3.225166	157	209	0	52	52	1.0000000
NODE_296680_length_250_cov_3.225166	182	250	0	68	68	1.0000000
NODE_296699_length_250_cov_3.086093	33	67	0	34	34	1.0000000
NODE_296703_length_250_cov_3.052980	29	94	0	6	65	0.0923077
NODE_296703_length_250_cov_3.052980	29	94	11	26	65	0.4000000
NODE_296703_length_250_cov_3.052980	29	94	13	6	65	0.0923077
NODE_296703_length_250_cov_3.052980	29	94	15	27	65	0.4153846
NODE_296707_length_250_cov_3.039735	51	106	0	55	55	1.0000000
NODE_296737_length_250_cov_2.986755	124	185	14	2	61	0.0327869
NODE_296737_length_250_cov_2.986755	124	185	15	10	61	0.1639344
NODE_296737_length_250_cov_2.986755	124	185	16	5	61	0.0819672
NODE_296737_length_250_cov_2.986755	124	185	17	15	61	0.2459016
NODE_296737_length_250_cov_2.986755	124	185	19	29	61	0.4754098
NODE_296737_length_250_cov_2.986755	172	243	2	2	71	0.0281690
NODE_296737_length_250_cov_2.986755	172	243	3	10	71	0.1408451
NODE_296737_length_250_cov_2.986755	172	243	5	20	71	0.2816902
NODE_296737_length_250_cov_2.986755	172	243	7	1	71	0.0140845
NODE_296737_length_250_cov_2.986755	172	243	9	4	71	0.0563380
NODE_296737_length_250_cov_2.986755	172	243	11	15	71	0.2112676
NODE_296737_length_250_cov_2.986755	172	243	13	6	71	0.0845070
NODE_296737_length_250_cov_2.986755	172	243	17	3	71	0.0422535
NODE_296737_length_250_cov_2.986755	172	243	19	10	71	0.1408451
NODE_296885_length_250_cov_2.516556	0	49	0	49	49	1.0000000
NODE_296893_length_250_cov_2.476821	94	174	0	80	80	1.0000000
NODE_296893_length_250_cov_2.476821	147	227	0	80	80	1.0000000
NODE_296897_length_250_cov_2.470199	166	212	0	46	46	1.0000000
NODE_297070_length_250_cov_2.059603	150	207	0	57	57	1.0000000
NODE_297211_length_250_cov_2.019868	74	141	12	6	67	0.0895522
NODE_297211_length_250_cov_2.019868	74	141	14	6	67	0.0895522
NODE_297211_length_250_cov_2.019868	74	141	16	2	67	0.0298507
NODE_297211_length_250_cov_2.019868	74	141	18	12	67	0.1791045
NODE_297211_length_250_cov_2.019868	74	141	22	27	67	0.4029851
NODE_297211_length_250_cov_2.019868	74	141	24	14	67	0.2089552
NODE_297211_length_250_cov_2.019868	158	204	6	15	46	0.3260870
NODE_297211_length_250_cov_2.019868	158	204	8	4	46	0.0869565
NODE_297211_length_250_cov_2.019868	158	204	10	14	46	0.3043478
NODE_297211_length_250_cov_2.019868	158	204	14	13	46	0.2826087
NODE_297550_length_250_cov_1.688742	6	42	0	36	36	1.0000000
NODE_297624_length_250_cov_1.635762	150	191	6	36	41	0.8780488
NODE_297624_length_250_cov_1.635762	150	191	8	5	41	0.1219512
NODE_297679_length_250_cov_1.529801	59	108	0	49	49	1.0000000
NODE_297679_length_250_cov_1.529801	81	161	0	80	80	1.0000000
NODE_297693_length_250_cov_1.516556	124	184	0	53	60	0.8833333
NODE_297693_length_250_cov_1.516556	124	184	2	7	60	0.1166667
NODE_297693_length_250_cov_1.516556	166	237	0	71	71	1.0000000
NODE_297762_length_250_cov_1.377483	0	80	0	80	80	1.0000000
NODE_297963_length_250_cov_1.350993	40	98	0	58	58	1.0000000
NODE_298213_length_250_cov_1.291391	116	196	2	3	80	0.0375000
NODE_298213_length_250_cov_1.291391	116	196	4	1	80	0.0125000
NODE_298213_length_250_cov_1.291391	116	196	6	3	80	0.0375000
NODE_298213_length_250_cov_1.291391	116	196	10	1	80	0.0125000
NODE_298213_length_250_cov_1.291391	116	196	12	1	80	0.0125000
NODE_298213_length_250_cov_1.291391	116	196	14	4	80	0.0500000
NODE_298213_length_250_cov_1.291391	116	196	16	12	80	0.1500000
NODE_298213_length_250_cov_1.291391	116	196	20	1	80	0.0125000
NODE_298213_length_250_cov_1.291391	116	196	22	54	80	0.6750000
NODE_298719_length_250_cov_1.013245	126	163	0	37	37	1.0000000
NODE_298794_length_250_cov_1.006623	129	148	0	19	19	1.0000000
NODE_298900_length_250_cov_0.920530	126	178	36	1	52	0.0192308
NODE_298900_length_250_cov_0.920530	126	178	38	5	52	0.0961538
NODE_298900_length_250_cov_0.920530	126	178	40	4	52	0.0769231
NODE_298900_length_250_cov_0.920530	126	178	42	5	52	0.0961538
NODE_298900_length_250_cov_0.920530	126	178	44	37	52	0.7115384
NODE_299979_length_249_cov_55.413333	97	172	0	75	75	1.0000000
NODE_299979_length_249_cov_55.413333	150	225	0	75	75	1.0000000
NODE_300012_length_247_cov_51.243243	172	247	0	35	75	0.4666667
NODE_300012_length_247_cov_51.243243	172	247	4	35	75	0.4666667
NODE_300012_length_247_cov_51.243243	172	247	6	5	75	0.0666667
NODE_300014_length_247_cov_37.614865	156	239	0	83	83	1.0000000
NODE_300056_length_245_cov_40.876712	138	202	66	3	64	0.0468750
NODE_300056_length_245_cov_40.876712	138	202	70	1	64	0.0156250
NODE_300056_length_245_cov_40.876712	138	202	74	3	64	0.0468750
NODE_300056_length_245_cov_40.876712	138	202	75	5	64	0.0781250
NODE_300056_length_245_cov_40.876712	138	202	78	2	64	0.0312500
NODE_300056_length_245_cov_40.876712	138	202	90	3	64	0.0468750
NODE_300056_length_245_cov_40.876712	138	202	95	3	64	0.0468750
NODE_300056_length_245_cov_40.876712	138	202	99	2	64	0.0312500
NODE_300056_length_245_cov_40.876712	138	202	103	6	64	0.0937500
NODE_300056_length_245_cov_40.876712	138	202	110	16	64	0.2500000
NODE_300056_length_245_cov_40.876712	138	202	113	4	64	0.0625000
NODE_300056_length_245_cov_40.876712	138	202	114	3	64	0.0468750
NODE_300056_length_245_cov_40.876712	138	202	116	2	64	0.0312500
NODE_300056_length_245_cov_40.876712	138	202	118	1	64	0.0156250
NODE_300056_length_245_cov_40.876712	138	202	120	4	64	0.0625000
NODE_300056_length_245_cov_40.876712	138	202	122	6	64	0.0937500
NODE_300056_length_245_cov_40.876712	138	202	66	3	64	0.0468750
NODE_300056_length_245_cov_40.876712	138	202	70	1	64	0.0156250
NODE_300056_length_245_cov_40.876712	138	202	74	3	64	0.0468750
NODE_300056_length_245_cov_40.876712	138	202	75	5	64	0.0781250
NODE_300056_length_245_cov_40.876712	138	202	78	2	64	0.0312500
NODE_300056_length_245_cov_40.876712	138	202	90	3	64	0.0468750
NODE_300056_length_245_cov_40.876712	138	202	95	3	64	0.0468750
NODE_300056_length_245_cov_40.876712	138	202	99	2	64	0.0312500
NODE_300056_length_245_cov_40.876712	138	202	103	6	64	0.0937500
NODE_300056_length_245_cov_40.876712	138	202	110	16	64	0.2500000
NODE_300056_length_245_cov_40.876712	138	202	113	4	64	0.0625000
NODE_300056_length_245_cov_40.876712	138	202	114	3	64	0.0468750
NODE_300056_length_245_cov_40.876712	138	202	116	2	64	0.0312500
NODE_300056_length_245_cov_40.876712	138	202	118	1	64	0.0156250
NODE_300056_length_245_cov_40.876712	138	202	120	4	64	0.0625000
NODE_300056_length_245_cov_40.876712	138	202	122	6	64	0.0937500
NODE_300056_length_245_cov_40.876712	138	202	66	3	64	0.0468750
NODE_300056_length_245_cov_40.876712	138	202	70	1	64	0.0156250
NODE_300056_length_245_cov_40.876712	138	202	74	3	64	0.0468750
NODE_300056_length_245_cov_40.876712	138	202	75	5	64	0.0781250
NODE_300056_length_245_cov_40.876712	138	202	78	2	64	0.0312500
NODE_300056_length_245_cov_40.876712	138	202	90	3	64	0.0468750
NODE_300056_length_245_cov_40.876712	138	202	95	3	64	0.0468750
NODE_300056_length_245_cov_40.876712	138	202	99	2	64	0.0312500
NODE_300056_length_245_cov_40.876712	138	202	103	6	64	0.0937500
NODE_300056_length_245_cov_40.876712	138	202	110	16	64	0.2500000
NODE_300056_length_245_cov_40.876712	138	202	113	4	64	0.0625000
NODE_300056_length_245_cov_40.876712	138	202	114	3	64	0.0468750
NODE_300056_length_245_cov_40.876712	138	202	116	2	64	0.0312500
NODE_300056_length_245_cov_40.876712	138	202	118	1	64	0.0156250
NODE_300056_length_245_cov_40.876712	138	202	120	4	64	0.0625000
NODE_300056_length_245_cov_40.876712	138	202	122	6	64	0.0937500
NODE_300056_length_245_cov_40.876712	175	241	17	2	66	0.0303030
NODE_300056_length_245_cov_40.876712	175	241	18	4	66	0.0606061
NODE_300056_length_245_cov_40.876712	175	241	21	2	66	0.0303030
NODE_300056_length_245_cov_40.876712	175	241	29	1	66	0.0151515
NODE_300056_length_245_cov_40.876712	175	241	30	3	66	0.0454545
NODE_300056_length_245_cov_40.876712	175	241	31	5	66	0.0757576
NODE_300056_length_245_cov_40.876712	175	241	33	2	66	0.0303030
NODE_300056_length_245_cov_40.876712	175	241	37	2	66	0.0303030
NODE_300056_length_245_cov_40.876712	175	241	40	2	66	0.0303030
NODE_300056_length_245_cov_40.876712	175	241	44	1	66	0.0151515
NODE_300056_length_245_cov_40.876712	175	241	45	1	66	0.0151515
NODE_300056_length_245_cov_40.876712	175	241	47	3	66	0.0454545
NODE_300056_length_245_cov_40.876712	175	241	55	1	66	0.0151515
NODE_300056_length_245_cov_40.876712	175	241	59	1	66	0.0151515
NODE_300056_length_245_cov_40.876712	175	241	62	1	66	0.0151515
NODE_300056_length_245_cov_40.876712	175	241	63	1	66	0.0151515
NODE_300056_length_245_cov_40.876712	175	241	66	10	66	0.1515152
NODE_300056_length_245_cov_40.876712	175	241	70	1	66	0.0151515
NODE_300056_length_245_cov_40.876712	175	241	74	3	66	0.0454545
NODE_300056_length_245_cov_40.876712	175	241	75	5	66	0.0757576
NODE_300056_length_245_cov_40.876712	175	241	78	2	66	0.0303030
NODE_300056_length_245_cov_40.876712	175	241	90	3	66	0.0454545
NODE_300056_length_245_cov_40.876712	175	241	95	3	66	0.0454545
NODE_300056_length_245_cov_40.876712	175	241	99	2	66	0.0303030
NODE_300056_length_245_cov_40.876712	175	241	103	5	66	0.0757576
NODE_300147_length_240_cov_80.744681	167	238	5	2	71	0.0281690
NODE_300147_length_240_cov_80.744681	167	238	8	23	71	0.3239437
NODE_300147_length_240_cov_80.744681	167	238	10	14	71	0.1971831
NODE_300147_length_240_cov_80.744681	167	238	14	5	71	0.0704225
NODE_300147_length_240_cov_80.744681	167	238	18	19	71	0.2676056
NODE_300147_length_240_cov_80.744681	167	238	22	3	71	0.0422535
NODE_300147_length_240_cov_80.744681	167	238	24	5	71	0.0704225
NODE_300148_length_240_cov_38.035461	31	82	0	51	51	1.0000000
NODE_300165_length_239_cov_72.878571	0	48	0	48	48	1.0000000
NODE_300165_length_239_cov_72.878571	21	101	0	52	80	0.6500000
NODE_300165_length_239_cov_72.878571	21	101	4	28	80	0.3500000
NODE_300165_length_239_cov_72.878571	150	230	0	15	80	0.1875000
NODE_300165_length_239_cov_72.878571	150	230	4	65	80	0.8125000
NODE_300165_length_239_cov_72.878571	150	230	0	15	80	0.1875000
NODE_300165_length_239_cov_72.878571	150	230	4	65	80	0.8125000
NODE_300165_length_239_cov_72.878571	150	212	4	62	62	1.0000000
NODE_300165_length_239_cov_72.878571	150	221	0	6	71	0.0845070
NODE_300165_length_239_cov_72.878571	150	221	4	65	71	0.9154930
NODE_300208_length_238_cov_385.683453	35	104	239	2	69	0.0289855
NODE_300208_length_238_cov_385.683453	35	104	252	1	69	0.0144928
NODE_300208_length_238_cov_385.683453	35	104	254	1	69	0.0144928
NODE_300208_length_238_cov_385.683453	35	104	262	1	69	0.0144928
NODE_300208_length_238_cov_385.683453	35	104	272	1	69	0.0144928
NODE_300208_length_238_cov_385.683453	35	104	280	1	69	0.0144928
NODE_300208_length_238_cov_385.683453	35	104	289	1	69	0.0144928
NODE_300208_length_238_cov_385.683453	35	104	297	1	69	0.0144928
NODE_300208_length_238_cov_385.683453	35	104	303	1	69	0.0144928
NODE_300208_length_238_cov_385.683453	35	104	322	1	69	0.0144928
NODE_300208_length_238_cov_385.683453	35	104	330	1	69	0.0144928
NODE_300208_length_238_cov_385.683453	35	104	349	1	69	0.0144928
NODE_300208_length_238_cov_385.683453	35	104	352	1	69	0.0144928
NODE_300208_length_238_cov_385.683453	35	104	377	1	69	0.0144928
NODE_300208_length_238_cov_385.683453	35	104	386	1	69	0.0144928
NODE_300208_length_238_cov_385.683453	35	104	401	2	69	0.0289855
NODE_300208_length_238_cov_385.683453	35	104	407	1	69	0.0144928
NODE_300208_length_238_cov_385.683453	35	104	421	2	69	0.0289855
NODE_300208_length_238_cov_385.683453	35	104	430	1	69	0.0144928
NODE_300208_length_238_cov_385.683453	35	104	441	1	69	0.0144928
NODE_300208_length_238_cov_385.683453	35	104	446	2	69	0.0289855
NODE_300208_length_238_cov_385.683453	35	104	454	1	69	0.0144928
NODE_300208_length_238_cov_385.683453	35	104	456	5	69	0.0724638
NODE_300208_length_238_cov_385.683453	35	104	468	1	69	0.0144928
NODE_300208_length_238_cov_385.683453	35	104	602	2	69	0.0289855
NODE_300208_length_238_cov_385.683453	35	104	610	1	69	0.0144928
NODE_300208_length_238_cov_385.683453	35	104	611	1	69	0.0144928
NODE_300208_length_238_cov_385.683453	35	104	626	1	69	0.0144928
NODE_300208_length_238_cov_385.683453	35	104	630	1	69	0.0144928
NODE_300208_length_238_cov_385.683453	35	104	638	1	69	0.0144928
NODE_300208_length_238_cov_385.683453	35	104	644	1	69	0.0144928
NODE_300208_length_238_cov_385.683453	35	104	653	1	69	0.0144928
NODE_300208_length_238_cov_385.683453	35	104	657	1	69	0.0144928
NODE_300208_length_238_cov_385.683453	35	104	670	1	69	0.0144928
NODE_300208_length_238_cov_385.683453	35	104	674	1	69	0.0144928
NODE_300208_length_238_cov_385.683453	35	104	678	1	69	0.0144928
NODE_300208_length_238_cov_385.683453	35	104	684	1	69	0.0144928
NODE_300208_length_238_cov_385.683453	35	104	686	1	69	0.0144928
NODE_300208_length_238_cov_385.683453	35	104	696	1	69	0.0144928
NODE_300208_length_238_cov_385.683453	35	104	698	1	69	0.0144928
NODE_300208_length_238_cov_385.683453	35	104	704	1	69	0.0144928
NODE_300208_length_238_cov_385.683453	35	104	707	1	69	0.0144928
NODE_300208_length_238_cov_385.683453	35	104	714	1	69	0.0144928
NODE_300208_length_238_cov_385.683453	35	104	720	1	69	0.0144928
NODE_300208_length_238_cov_385.683453	35	104	723	2	69	0.0289855
NODE_300208_length_238_cov_385.683453	35	104	729	1	69	0.0144928
NODE_300208_length_238_cov_385.683453	35	104	731	1	69	0.0144928
NODE_300208_length_238_cov_385.683453	35	104	735	1	69	0.0144928
NODE_300208_length_238_cov_385.683453	35	104	741	1	69	0.0144928
NODE_300208_length_238_cov_385.683453	35	104	749	1	69	0.0144928
NODE_300208_length_238_cov_385.683453	35	104	753	1	69	0.0144928
NODE_300208_length_238_cov_385.683453	35	104	759	1	69	0.0144928
NODE_300208_length_238_cov_385.683453	35	104	771	2	69	0.0289855
NODE_300208_length_238_cov_385.683453	35	104	776	2	69	0.0289855
NODE_300208_length_238_cov_385.683453	35	104	782	1	69	0.0144928
NODE_300208_length_238_cov_385.683453	35	104	784	1	69	0.0144928
NODE_300208_length_238_cov_385.683453	35	104	786	1	69	0.0144928
NODE_300225_length_237_cov_101.543478	83	163	2	24	80	0.3000000
NODE_300225_length_237_cov_101.543478	83	163	8	22	80	0.2750000
NODE_300225_length_237_cov_101.543478	83	163	10	34	80	0.4250000
NODE_300225_length_237_cov_101.543478	83	163	2	24	80	0.3000000
NODE_300225_length_237_cov_101.543478	83	163	8	22	80	0.2750000
NODE_300225_length_237_cov_101.543478	83	163	10	34	80	0.4250000
NODE_300225_length_237_cov_101.543478	83	163	2	24	80	0.3000000
NODE_300225_length_237_cov_101.543478	83	163	8	22	80	0.2750000
NODE_300225_length_237_cov_101.543478	83	163	10	34	80	0.4250000
NODE_300225_length_237_cov_101.543478	83	163	2	24	80	0.3000000
NODE_300225_length_237_cov_101.543478	83	163	8	22	80	0.2750000
NODE_300225_length_237_cov_101.543478	83	163	10	34	80	0.4250000
NODE_300225_length_237_cov_101.543478	136	216	0	19	80	0.2375000
NODE_300225_length_237_cov_101.543478	136	216	8	56	80	0.7000000
NODE_300225_length_237_cov_101.543478	136	216	10	5	80	0.0625000
NODE_300225_length_237_cov_101.543478	136	216	0	19	80	0.2375000
NODE_300225_length_237_cov_101.543478	136	216	8	56	80	0.7000000
NODE_300225_length_237_cov_101.543478	136	216	10	5	80	0.0625000
NODE_300225_length_237_cov_101.543478	136	216	0	19	80	0.2375000
NODE_300225_length_237_cov_101.543478	136	216	8	56	80	0.7000000
NODE_300225_length_237_cov_101.543478	136	216	10	5	80	0.0625000
NODE_300225_length_237_cov_101.543478	138	216	0	19	78	0.2435897
NODE_300225_length_237_cov_101.543478	138	216	8	56	78	0.7179487
NODE_300225_length_237_cov_101.543478	138	216	10	3	78	0.0384615
NODE_300225_length_237_cov_101.543478	138	216	0	19	78	0.2435897
NODE_300225_length_237_cov_101.543478	138	216	8	56	78	0.7179487
NODE_300225_length_237_cov_101.543478	138	216	10	3	78	0.0384615
NODE_300227_length_237_cov_49.623188	13	88	0	75	75	1.0000000
NODE_300227_length_237_cov_49.623188	73	153	0	80	80	1.0000000
NODE_300227_length_237_cov_49.623188	126	206	0	80	80	1.0000000
NODE_300289_length_235_cov_67.904412	0	62	0	62	62	1.0000000
NODE_300289_length_235_cov_67.904412	25	111	0	86	86	1.0000000
NODE_300289_length_235_cov_67.904412	69	150	0	81	81	1.0000000
NODE_300289_length_235_cov_67.904412	113	194	0	81	81	1.0000000
NODE_300289_length_235_cov_67.904412	157	235	0	78	78	1.0000000
NODE_300322_length_234_cov_76.496296	0	76	0	9	76	0.1184211
NODE_300322_length_234_cov_76.496296	0	76	2	42	76	0.5526316
NODE_300322_length_234_cov_76.496296	0	76	4	25	76	0.3289474
NODE_300322_length_234_cov_76.496296	0	76	0	9	76	0.1184211
NODE_300322_length_234_cov_76.496296	0	76	2	42	76	0.5526316
NODE_300322_length_234_cov_76.496296	0	76	4	25	76	0.3289474
NODE_300322_length_234_cov_76.496296	0	76	0	9	76	0.1184211
NODE_300322_length_234_cov_76.496296	0	76	2	42	76	0.5526316
NODE_300322_length_234_cov_76.496296	0	76	4	25	76	0.3289474
NODE_300322_length_234_cov_76.496296	0	76	0	9	76	0.1184211
NODE_300322_length_234_cov_76.496296	0	76	2	42	76	0.5526316
NODE_300322_length_234_cov_76.496296	0	76	4	25	76	0.3289474
NODE_300322_length_234_cov_76.496296	49	128	2	21	79	0.2658228
NODE_300322_length_234_cov_76.496296	49	128	4	58	79	0.7341772
NODE_300322_length_234_cov_76.496296	49	128	2	21	79	0.2658228
NODE_300322_length_234_cov_76.496296	49	128	4	58	79	0.7341772
NODE_300322_length_234_cov_76.496296	124	204	0	75	80	0.9375000
NODE_300322_length_234_cov_76.496296	124	204	2	5	80	0.0625000
NODE_300322_length_234_cov_76.496296	124	204	0	75	80	0.9375000
NODE_300322_length_234_cov_76.496296	124	204	2	5	80	0.0625000
NODE_300322_length_234_cov_76.496296	124	204	0	75	80	0.9375000
NODE_300322_length_234_cov_76.496296	124	204	2	5	80	0.0625000
NODE_300322_length_234_cov_76.496296	177	226	0	49	49	1.0000000
NODE_300322_length_234_cov_76.496296	177	234	0	57	57	1.0000000
NODE_300322_length_234_cov_76.496296	182	234	0	52	52	1.0000000
NODE_300323_length_234_cov_71.548148	90	162	17	1	72	0.0138889
NODE_300323_length_234_cov_71.548148	90	162	18	71	72	0.9861111
NODE_300323_length_234_cov_71.548148	90	162	17	1	72	0.0138889
NODE_300323_length_234_cov_71.548148	90	162	18	71	72	0.9861111
NODE_300323_length_234_cov_71.548148	135	215	0	17	80	0.2125000
NODE_300323_length_234_cov_71.548148	135	215	6	3	80	0.0375000
NODE_300323_length_234_cov_71.548148	135	215	8	4	80	0.0500000
NODE_300323_length_234_cov_71.548148	135	215	14	2	80	0.0250000
NODE_300323_length_234_cov_71.548148	135	215	15	25	80	0.3125000
NODE_300323_length_234_cov_71.548148	135	215	17	3	80	0.0375000
NODE_300323_length_234_cov_71.548148	135	215	18	26	80	0.3250000
NODE_300323_length_234_cov_71.548148	135	215	0	17	80	0.2125000
NODE_300323_length_234_cov_71.548148	135	215	6	3	80	0.0375000
NODE_300323_length_234_cov_71.548148	135	215	8	4	80	0.0500000
NODE_300323_length_234_cov_71.548148	135	215	14	2	80	0.0250000
NODE_300323_length_234_cov_71.548148	135	215	15	25	80	0.3125000
NODE_300323_length_234_cov_71.548148	135	215	17	3	80	0.0375000
NODE_300323_length_234_cov_71.548148	135	215	18	26	80	0.3250000
NODE_300357_length_233_cov_180.701493	0	65	0	62	65	0.9538462
NODE_300357_length_233_cov_180.701493	0	65	5	1	65	0.0153846
NODE_300357_length_233_cov_180.701493	0	65	6	2	65	0.0307692
NODE_300357_length_233_cov_180.701493	38	118	0	24	80	0.3000000
NODE_300357_length_233_cov_180.701493	38	118	5	1	80	0.0125000
NODE_300357_length_233_cov_180.701493	38	118	6	55	80	0.6875000
NODE_300392_length_232_cov_132.045113	53	133	0	80	80	1.0000000
NODE_300392_length_232_cov_132.045113	106	186	0	80	80	1.0000000
NODE_300471_length_230_cov_34.427481	0	59	0	59	59	1.0000000
NODE_300471_length_230_cov_34.427481	0	59	0	59	59	1.0000000
NODE_300471_length_230_cov_34.427481	10	59	0	49	49	1.0000000
NODE_300487_length_229_cov_76.907692	94	176	32	4	82	0.0487805
NODE_300487_length_229_cov_76.907692	94	176	34	2	82	0.0243902
NODE_300487_length_229_cov_76.907692	94	176	36	2	82	0.0243902
NODE_300487_length_229_cov_76.907692	94	176	40	6	82	0.0731707
NODE_300487_length_229_cov_76.907692	94	176	43	4	82	0.0487805
NODE_300487_length_229_cov_76.907692	94	176	45	2	82	0.0243902
NODE_300487_length_229_cov_76.907692	94	176	46	2	82	0.0243902
NODE_300487_length_229_cov_76.907692	94	176	48	1	82	0.0121951
NODE_300487_length_229_cov_76.907692	94	176	49	3	82	0.0365854
NODE_300487_length_229_cov_76.907692	94	176	52	3	82	0.0365854
NODE_300487_length_229_cov_76.907692	94	176	53	8	82	0.0975610
NODE_300487_length_229_cov_76.907692	94	176	54	4	82	0.0487805
NODE_300487_length_229_cov_76.907692	94	176	56	2	82	0.0243902
NODE_300487_length_229_cov_76.907692	94	176	58	6	82	0.0731707
NODE_300487_length_229_cov_76.907692	94	176	60	3	82	0.0365854
NODE_300487_length_229_cov_76.907692	94	176	62	2	82	0.0243902
NODE_300487_length_229_cov_76.907692	94	176	68	1	82	0.0121951
NODE_300487_length_229_cov_76.907692	94	176	70	5	82	0.0609756
NODE_300487_length_229_cov_76.907692	94	176	72	12	82	0.1463415
NODE_300487_length_229_cov_76.907692	94	176	74	10	82	0.1219512
NODE_300523_length_228_cov_127.131783	0	76	0	16	76	0.2105263
NODE_300523_length_228_cov_127.131783	0	76	9	11	76	0.1447368
NODE_300523_length_228_cov_127.131783	0	76	10	27	76	0.3552631
NODE_300523_length_228_cov_127.131783	0	76	12	5	76	0.0657895
NODE_300523_length_228_cov_127.131783	0	76	14	17	76	0.2236842
NODE_300523_length_228_cov_127.131783	5	76	0	11	71	0.1549296
NODE_300523_length_228_cov_127.131783	5	76	9	11	71	0.1549296
NODE_300523_length_228_cov_127.131783	5	76	10	27	71	0.3802817
NODE_300523_length_228_cov_127.131783	5	76	12	5	71	0.0704225
NODE_300523_length_228_cov_127.131783	5	76	14	17	71	0.2394366
NODE_300523_length_228_cov_127.131783	10	76	0	6	66	0.0909091
NODE_300523_length_228_cov_127.131783	10	76	9	11	66	0.1666667
NODE_300523_length_228_cov_127.131783	10	76	10	27	66	0.4090909
NODE_300523_length_228_cov_127.131783	10	76	12	5	66	0.0757576
NODE_300523_length_228_cov_127.131783	10	76	14	17	66	0.2575758
NODE_300523_length_228_cov_127.131783	49	129	10	21	80	0.2625000
NODE_300523_length_228_cov_127.131783	49	129	11	2	80	0.0250000
NODE_300523_length_228_cov_127.131783	49	129	12	5	80	0.0625000
NODE_300523_length_228_cov_127.131783	49	129	14	26	80	0.3250000
NODE_300523_length_228_cov_127.131783	49	129	20	1	80	0.0125000
NODE_300523_length_228_cov_127.131783	49	129	21	10	80	0.1250000
NODE_300523_length_228_cov_127.131783	49	129	22	15	80	0.1875000
NODE_300523_length_228_cov_127.131783	49	129	10	21	80	0.2625000
NODE_300523_length_228_cov_127.131783	49	129	11	2	80	0.0250000
NODE_300523_length_228_cov_127.131783	49	129	12	5	80	0.0625000
NODE_300523_length_228_cov_127.131783	49	129	14	26	80	0.3250000
NODE_300523_length_228_cov_127.131783	49	129	20	1	80	0.0125000
NODE_300523_length_228_cov_127.131783	49	129	21	10	80	0.1250000
NODE_300523_length_228_cov_127.131783	49	129	22	15	80	0.1875000
NODE_300523_length_228_cov_127.131783	49	129	10	21	80	0.2625000
NODE_300523_length_228_cov_127.131783	49	129	11	2	80	0.0250000
NODE_300523_length_228_cov_127.131783	49	129	12	5	80	0.0625000
NODE_300523_length_228_cov_127.131783	49	129	14	26	80	0.3250000
NODE_300523_length_228_cov_127.131783	49	129	20	1	80	0.0125000
NODE_300523_length_228_cov_127.131783	49	129	21	10	80	0.1250000
NODE_300523_length_228_cov_127.131783	49	129	22	15	80	0.1875000
NODE_300523_length_228_cov_127.131783	125	205	8	60	80	0.7500000
NODE_300523_length_228_cov_127.131783	125	205	10	20	80	0.2500000
NODE_300523_length_228_cov_127.131783	125	205	8	60	80	0.7500000
NODE_300523_length_228_cov_127.131783	125	205	10	20	80	0.2500000
NODE_300523_length_228_cov_127.131783	125	205	8	60	80	0.7500000
NODE_300523_length_228_cov_127.131783	125	205	10	20	80	0.2500000
NODE_300523_length_228_cov_127.131783	178	228	7	2	50	0.0400000
NODE_300523_length_228_cov_127.131783	178	228	8	48	50	0.9600000
NODE_300523_length_228_cov_127.131783	178	228	7	2	50	0.0400000
NODE_300523_length_228_cov_127.131783	178	228	8	48	50	0.9600000
NODE_300523_length_228_cov_127.131783	178	228	7	2	50	0.0400000
NODE_300523_length_228_cov_127.131783	178	228	8	48	50	0.9600000
NODE_300524_length_228_cov_94.255814	34	99	0	44	65	0.6769231
NODE_300524_length_228_cov_94.255814	34	99	2	21	65	0.3230769
NODE_300524_length_228_cov_94.255814	34	114	0	44	80	0.5500000
NODE_300524_length_228_cov_94.255814	34	114	2	26	80	0.3250000
NODE_300524_length_228_cov_94.255814	34	114	12	6	80	0.0750000
NODE_300524_length_228_cov_94.255814	34	114	14	4	80	0.0500000
NODE_300524_length_228_cov_94.255814	41	111	0	37	70	0.5285714
NODE_300524_length_228_cov_94.255814	41	111	2	26	70	0.3714286
NODE_300524_length_228_cov_94.255814	41	111	12	6	70	0.0857143
NODE_300524_length_228_cov_94.255814	41	111	14	1	70	0.0142857
NODE_300524_length_228_cov_94.255814	43	114	0	35	71	0.4929577
NODE_300524_length_228_cov_94.255814	43	114	2	26	71	0.3661972
NODE_300524_length_228_cov_94.255814	43	114	12	6	71	0.0845070
NODE_300524_length_228_cov_94.255814	43	114	14	4	71	0.0563380
NODE_300524_length_228_cov_94.255814	87	167	2	17	80	0.2125000
NODE_300524_length_228_cov_94.255814	87	167	12	7	80	0.0875000
NODE_300524_length_228_cov_94.255814	87	167	14	56	80	0.7000000
NODE_300524_length_228_cov_94.255814	87	167	2	17	80	0.2125000
NODE_300524_length_228_cov_94.255814	87	167	12	7	80	0.0875000
NODE_300524_length_228_cov_94.255814	87	167	14	56	80	0.7000000
NODE_300524_length_228_cov_94.255814	87	167	2	17	80	0.2125000
NODE_300524_length_228_cov_94.255814	87	167	12	7	80	0.0875000
NODE_300524_length_228_cov_94.255814	87	167	14	56	80	0.7000000
NODE_300524_length_228_cov_94.255814	87	167	2	17	80	0.2125000
NODE_300524_length_228_cov_94.255814	87	167	12	7	80	0.0875000
NODE_300524_length_228_cov_94.255814	87	167	14	56	80	0.7000000
NODE_300547_length_228_cov_0.395349	27	107	0	80	80	1.0000000
NODE_300547_length_228_cov_0.395349	70	150	0	80	80	1.0000000
NODE_300556_length_227_cov_37.429688	40	111	0	7	71	0.0985916
NODE_300556_length_227_cov_37.429688	40	111	7	44	71	0.6197183
NODE_300556_length_227_cov_37.429688	40	111	10	8	71	0.1126761
NODE_300556_length_227_cov_37.429688	40	111	12	4	71	0.0563380
NODE_300556_length_227_cov_37.429688	40	111	16	2	71	0.0281690
NODE_300556_length_227_cov_37.429688	40	111	17	6	71	0.0845070
NODE_300556_length_227_cov_37.429688	49	112	7	42	63	0.6666667
NODE_300556_length_227_cov_37.429688	49	112	10	8	63	0.1269841
NODE_300556_length_227_cov_37.429688	49	112	12	4	63	0.0634921
NODE_300556_length_227_cov_37.429688	49	112	16	2	63	0.0317460
NODE_300556_length_227_cov_37.429688	49	112	17	7	63	0.1111111
NODE_300556_length_227_cov_37.429688	93	172	10	6	79	0.0759494
NODE_300556_length_227_cov_37.429688	93	172	12	4	79	0.0506329
NODE_300556_length_227_cov_37.429688	93	172	13	14	79	0.1772152
NODE_300556_length_227_cov_37.429688	93	172	14	14	79	0.1772152
NODE_300556_length_227_cov_37.429688	93	172	16	2	79	0.0253165
NODE_300556_length_227_cov_37.429688	93	172	17	37	79	0.4683544
NODE_300556_length_227_cov_37.429688	93	172	18	2	79	0.0253165
NODE_300556_length_227_cov_37.429688	168	227	3	30	59	0.5084746
NODE_300556_length_227_cov_37.429688	168	227	5	12	59	0.2033898
NODE_300556_length_227_cov_37.429688	168	227	9	1	59	0.0169492
NODE_300556_length_227_cov_37.429688	168	227	11	6	59	0.1016949
NODE_300556_length_227_cov_37.429688	168	227	13	10	59	0.1694915
NODE_300556_length_227_cov_37.429688	168	227	3	30	59	0.5084746
NODE_300556_length_227_cov_37.429688	168	227	5	12	59	0.2033898
NODE_300556_length_227_cov_37.429688	168	227	9	1	59	0.0169492
NODE_300556_length_227_cov_37.429688	168	227	11	6	59	0.1016949
NODE_300556_length_227_cov_37.429688	168	227	13	10	59	0.1694915
NODE_300595_length_226_cov_547.629921	82	162	773	1	80	0.0125000
NODE_300595_length_226_cov_547.629921	82	162	796	1	80	0.0125000
NODE_300595_length_226_cov_547.629921	82	162	800	1	80	0.0125000
NODE_300595_length_226_cov_547.629921	82	162	801	1	80	0.0125000
NODE_300595_length_226_cov_547.629921	82	162	808	1	80	0.0125000
NODE_300595_length_226_cov_547.629921	82	162	809	1	80	0.0125000
NODE_300595_length_226_cov_547.629921	82	162	812	1	80	0.0125000
NODE_300595_length_226_cov_547.629921	82	162	819	1	80	0.0125000
NODE_300595_length_226_cov_547.629921	82	162	822	1	80	0.0125000
NODE_300595_length_226_cov_547.629921	82	162	823	1	80	0.0125000
NODE_300595_length_226_cov_547.629921	82	162	827	1	80	0.0125000
NODE_300595_length_226_cov_547.629921	82	162	833	1	80	0.0125000
NODE_300595_length_226_cov_547.629921	82	162	835	1	80	0.0125000
NODE_300595_length_226_cov_547.629921	82	162	836	1	80	0.0125000
NODE_300595_length_226_cov_547.629921	82	162	845	1	80	0.0125000
NODE_300595_length_226_cov_547.629921	82	162	846	1	80	0.0125000
NODE_300595_length_226_cov_547.629921	82	162	858	2	80	0.0250000
NODE_300595_length_226_cov_547.629921	82	162	862	2	80	0.0250000
NODE_300595_length_226_cov_547.629921	82	162	865	1	80	0.0125000
NODE_300595_length_226_cov_547.629921	82	162	869	1	80	0.0125000
NODE_300595_length_226_cov_547.629921	82	162	872	1	80	0.0125000
NODE_300595_length_226_cov_547.629921	82	162	878	1	80	0.0125000
NODE_300595_length_226_cov_547.629921	82	162	880	1	80	0.0125000
NODE_300595_length_226_cov_547.629921	82	162	888	1	80	0.0125000
NODE_300595_length_226_cov_547.629921	82	162	897	1	80	0.0125000
NODE_300595_length_226_cov_547.629921	82	162	905	1	80	0.0125000
NODE_300595_length_226_cov_547.629921	82	162	906	1	80	0.0125000
NODE_300595_length_226_cov_547.629921	82	162	919	1	80	0.0125000
NODE_300595_length_226_cov_547.629921	82	162	920	1	80	0.0125000
NODE_300595_length_226_cov_547.629921	82	162	928	1	80	0.0125000
NODE_300595_length_226_cov_547.629921	82	162	935	1	80	0.0125000
NODE_300595_length_226_cov_547.629921	82	162	937	1	80	0.0125000
NODE_300595_length_226_cov_547.629921	82	162	939	1	80	0.0125000
NODE_300595_length_226_cov_547.629921	82	162	947	1	80	0.0125000
NODE_300595_length_226_cov_547.629921	82	162	951	1	80	0.0125000
NODE_300595_length_226_cov_547.629921	82	162	955	4	80	0.0500000
NODE_300595_length_226_cov_547.629921	82	162	957	1	80	0.0125000
NODE_300595_length_226_cov_547.629921	82	162	962	1	80	0.0125000
NODE_300595_length_226_cov_547.629921	82	162	974	1	80	0.0125000
NODE_300595_length_226_cov_547.629921	82	162	978	1	80	0.0125000
NODE_300595_length_226_cov_547.629921	82	162	987	1	80	0.0125000
NODE_300595_length_226_cov_547.629921	82	162	997	2	80	0.0250000
NODE_300595_length_226_cov_547.629921	82	162	998	1	80	0.0125000
NODE_300595_length_226_cov_547.629921	82	162	999	1	80	0.0125000
NODE_300595_length_226_cov_547.629921	82	162	1003	1	80	0.0125000
NODE_300595_length_226_cov_547.629921	82	162	1006	1	80	0.0125000
NODE_300595_length_226_cov_547.629921	82	162	1014	1	80	0.0125000
NODE_300595_length_226_cov_547.629921	82	162	1017	1	80	0.0125000
NODE_300595_length_226_cov_547.629921	82	162	1021	2	80	0.0250000
NODE_300595_length_226_cov_547.629921	82	162	1022	1	80	0.0125000
NODE_300595_length_226_cov_547.629921	82	162	1023	2	80	0.0250000
NODE_300595_length_226_cov_547.629921	82	162	1024	1	80	0.0125000
NODE_300595_length_226_cov_547.629921	82	162	1026	2	80	0.0250000
NODE_300595_length_226_cov_547.629921	82	162	1030	1	80	0.0125000
NODE_300595_length_226_cov_547.629921	82	162	1031	1	80	0.0125000
NODE_300595_length_226_cov_547.629921	82	162	1035	1	80	0.0125000
NODE_300595_length_226_cov_547.629921	82	162	1039	2	80	0.0250000
NODE_300595_length_226_cov_547.629921	82	162	1043	2	80	0.0250000
NODE_300595_length_226_cov_547.629921	82	162	1044	1	80	0.0125000
NODE_300595_length_226_cov_547.629921	82	162	1045	2	80	0.0250000
NODE_300595_length_226_cov_547.629921	82	162	1046	1	80	0.0125000
NODE_300595_length_226_cov_547.629921	82	162	1047	2	80	0.0250000
NODE_300595_length_226_cov_547.629921	82	162	1051	3	80	0.0375000
NODE_300595_length_226_cov_547.629921	82	162	1056	1	80	0.0125000
NODE_300595_length_226_cov_547.629921	82	162	1057	1	80	0.0125000
NODE_300617_length_225_cov_41.269841	81	165	26	2	84	0.0238095
NODE_300617_length_225_cov_41.269841	81	165	28	5	84	0.0595238
NODE_300617_length_225_cov_41.269841	81	165	30	5	84	0.0595238
NODE_300617_length_225_cov_41.269841	81	165	32	6	84	0.0714286
NODE_300617_length_225_cov_41.269841	81	165	34	5	84	0.0595238
NODE_300617_length_225_cov_41.269841	81	165	36	5	84	0.0595238
NODE_300617_length_225_cov_41.269841	81	165	38	11	84	0.1309524
NODE_300617_length_225_cov_41.269841	81	165	41	1	84	0.0119048
NODE_300617_length_225_cov_41.269841	81	165	42	36	84	0.4285714
NODE_300617_length_225_cov_41.269841	81	165	44	8	84	0.0952381
NODE_300617_length_225_cov_41.269841	134	218	2	2	84	0.0238095
NODE_300617_length_225_cov_41.269841	134	218	4	5	84	0.0595238
NODE_300617_length_225_cov_41.269841	134	218	6	1	84	0.0119048
NODE_300617_length_225_cov_41.269841	134	218	9	1	84	0.0119048
NODE_300617_length_225_cov_41.269841	134	218	12	7	84	0.0833333
NODE_300617_length_225_cov_41.269841	134	218	14	2	84	0.0238095
NODE_300617_length_225_cov_41.269841	134	218	15	1	84	0.0119048
NODE_300617_length_225_cov_41.269841	134	218	16	9	84	0.1071429
NODE_300617_length_225_cov_41.269841	134	218	20	22	84	0.2619048
NODE_300617_length_225_cov_41.269841	134	218	22	1	84	0.0119048
NODE_300617_length_225_cov_41.269841	134	218	25	1	84	0.0119048
NODE_300617_length_225_cov_41.269841	134	218	26	3	84	0.0357143
NODE_300617_length_225_cov_41.269841	134	218	28	5	84	0.0595238
NODE_300617_length_225_cov_41.269841	134	218	30	3	84	0.0357143
NODE_300617_length_225_cov_41.269841	134	218	32	6	84	0.0714286
NODE_300617_length_225_cov_41.269841	134	218	34	3	84	0.0357143
NODE_300617_length_225_cov_41.269841	134	218	38	4	84	0.0476190
NODE_300617_length_225_cov_41.269841	134	218	42	8	84	0.0952381
NODE_300661_length_224_cov_209.528000	12	84	12	5	72	0.0694444
NODE_300661_length_224_cov_209.528000	12	84	20	1	72	0.0138889
NODE_300661_length_224_cov_209.528000	12	84	22	1	72	0.0138889
NODE_300661_length_224_cov_209.528000	12	84	24	4	72	0.0555556
NODE_300661_length_224_cov_209.528000	12	84	26	6	72	0.0833333
NODE_300661_length_224_cov_209.528000	12	84	28	4	72	0.0555556
NODE_300661_length_224_cov_209.528000	12	84	30	2	72	0.0277778
NODE_300661_length_224_cov_209.528000	12	84	32	8	72	0.1111111
NODE_300661_length_224_cov_209.528000	12	84	40	1	72	0.0138889
NODE_300661_length_224_cov_209.528000	12	84	42	2	72	0.0277778
NODE_300661_length_224_cov_209.528000	12	84	43	1	72	0.0138889
NODE_300661_length_224_cov_209.528000	12	84	46	1	72	0.0138889
NODE_300661_length_224_cov_209.528000	12	84	47	8	72	0.1111111
NODE_300661_length_224_cov_209.528000	12	84	49	5	72	0.0694444
NODE_300661_length_224_cov_209.528000	12	84	51	1	72	0.0138889
NODE_300661_length_224_cov_209.528000	12	84	52	2	72	0.0277778
NODE_300661_length_224_cov_209.528000	12	84	54	3	72	0.0416667
NODE_300661_length_224_cov_209.528000	12	84	56	17	72	0.2361111
NODE_300663_length_224_cov_146.568000	13	72	2	25	59	0.4237288
NODE_300663_length_224_cov_146.568000	13	72	5	6	59	0.1016949
NODE_300663_length_224_cov_146.568000	13	72	7	10	59	0.1694915
NODE_300663_length_224_cov_146.568000	13	72	10	6	59	0.1016949
NODE_300663_length_224_cov_146.568000	13	72	14	2	59	0.0338983
NODE_300663_length_224_cov_146.568000	13	72	16	3	59	0.0508475
NODE_300663_length_224_cov_146.568000	13	72	20	2	59	0.0338983
NODE_300663_length_224_cov_146.568000	13	72	22	5	59	0.0847458
NODE_300663_length_224_cov_146.568000	46	72	7	8	26	0.3076923
NODE_300663_length_224_cov_146.568000	46	72	10	6	26	0.2307692
NODE_300663_length_224_cov_146.568000	46	72	14	2	26	0.0769231
NODE_300663_length_224_cov_146.568000	46	72	16	3	26	0.1153846
NODE_300663_length_224_cov_146.568000	46	72	20	2	26	0.0769231
NODE_300663_length_224_cov_146.568000	46	72	22	5	26	0.1923077
NODE_300663_length_224_cov_146.568000	68	120	22	10	52	0.1923077
NODE_300663_length_224_cov_146.568000	68	120	24	3	52	0.0576923
NODE_300663_length_224_cov_146.568000	68	120	26	1	52	0.0192308
NODE_300663_length_224_cov_146.568000	68	120	32	3	52	0.0576923
NODE_300663_length_224_cov_146.568000	68	120	34	6	52	0.1153846
NODE_300663_length_224_cov_146.568000	68	120	36	2	52	0.0384615
NODE_300663_length_224_cov_146.568000	68	120	38	2	52	0.0384615
NODE_300663_length_224_cov_146.568000	68	120	44	9	52	0.1730769
NODE_300663_length_224_cov_146.568000	68	120	46	3	52	0.0576923
NODE_300663_length_224_cov_146.568000	68	120	48	2	52	0.0384615
NODE_300663_length_224_cov_146.568000	68	120	54	1	52	0.0192308
NODE_300663_length_224_cov_146.568000	68	120	56	7	52	0.1346154
NODE_300663_length_224_cov_146.568000	68	120	58	3	52	0.0576923
NODE_300665_length_224_cov_59.088000	98	178	2	8	80	0.1000000
NODE_300665_length_224_cov_59.088000	98	178	4	4	80	0.0500000
NODE_300665_length_224_cov_59.088000	98	178	6	14	80	0.1750000
NODE_300665_length_224_cov_59.088000	98	178	8	54	80	0.6750000
NODE_300665_length_224_cov_59.088000	98	178	2	8	80	0.1000000
NODE_300665_length_224_cov_59.088000	98	178	4	4	80	0.0500000
NODE_300665_length_224_cov_59.088000	98	178	6	14	80	0.1750000
NODE_300665_length_224_cov_59.088000	98	178	8	54	80	0.6750000
NODE_300665_length_224_cov_59.088000	98	178	2	8	80	0.1000000
NODE_300665_length_224_cov_59.088000	98	178	4	4	80	0.0500000
NODE_300665_length_224_cov_59.088000	98	178	6	14	80	0.1750000
NODE_300665_length_224_cov_59.088000	98	178	8	54	80	0.6750000
NODE_300665_length_224_cov_59.088000	151	217	0	7	66	0.1060606
NODE_300665_length_224_cov_59.088000	151	217	6	40	66	0.6060606
NODE_300665_length_224_cov_59.088000	151	217	8	19	66	0.2878788
NODE_300665_length_224_cov_59.088000	151	224	0	14	73	0.1917808
NODE_300665_length_224_cov_59.088000	151	224	6	40	73	0.5479452
NODE_300665_length_224_cov_59.088000	151	224	8	19	73	0.2602740
NODE_300667_length_224_cov_43.640000	98	157	2	59	59	1.0000000
NODE_300667_length_224_cov_43.640000	98	157	2	59	59	1.0000000
NODE_300667_length_224_cov_43.640000	106	157	2	51	51	1.0000000
NODE_300669_length_224_cov_36.224000	100	171	8	48	71	0.6760563
NODE_300669_length_224_cov_36.224000	100	171	12	23	71	0.3239437
NODE_300669_length_224_cov_36.224000	151	224	2	6	73	0.0821918
NODE_300669_length_224_cov_36.224000	151	224	4	4	73	0.0547945
NODE_300669_length_224_cov_36.224000	151	224	8	63	73	0.8630137
NODE_300696_length_223_cov_35.814516	0	54	0	6	54	0.1111111
NODE_300696_length_223_cov_35.814516	0	54	2	2	54	0.0370370
NODE_300696_length_223_cov_35.814516	0	54	4	7	54	0.1296296
NODE_300696_length_223_cov_35.814516	0	54	6	12	54	0.2222222
NODE_300696_length_223_cov_35.814516	0	54	8	13	54	0.2407407
NODE_300696_length_223_cov_35.814516	0	54	10	7	54	0.1296296
NODE_300696_length_223_cov_35.814516	0	54	12	7	54	0.1296296
NODE_300696_length_223_cov_35.814516	30	107	8	10	77	0.1298701
NODE_300696_length_223_cov_35.814516	30	107	10	7	77	0.0909091
NODE_300696_length_223_cov_35.814516	30	107	12	7	77	0.0909091
NODE_300696_length_223_cov_35.814516	30	107	14	2	77	0.0259740
NODE_300696_length_223_cov_35.814516	30	107	16	4	77	0.0519481
NODE_300696_length_223_cov_35.814516	30	107	18	11	77	0.1428571
NODE_300696_length_223_cov_35.814516	30	107	20	16	77	0.2077922
NODE_300696_length_223_cov_35.814516	30	107	22	20	77	0.2597403
NODE_300768_length_221_cov_71.319672	14	94	29	4	80	0.0500000
NODE_300768_length_221_cov_71.319672	14	94	31	2	80	0.0250000
NODE_300768_length_221_cov_71.319672	14	94	39	1	80	0.0125000
NODE_300768_length_221_cov_71.319672	14	94	40	1	80	0.0125000
NODE_300768_length_221_cov_71.319672	14	94	44	1	80	0.0125000
NODE_300768_length_221_cov_71.319672	14	94	45	3	80	0.0375000
NODE_300768_length_221_cov_71.319672	14	94	54	1	80	0.0125000
NODE_300768_length_221_cov_71.319672	14	94	55	2	80	0.0250000
NODE_300768_length_221_cov_71.319672	14	94	58	1	80	0.0125000
NODE_300768_length_221_cov_71.319672	14	94	69	1	80	0.0125000
NODE_300768_length_221_cov_71.319672	14	94	72	1	80	0.0125000
NODE_300768_length_221_cov_71.319672	14	94	74	1	80	0.0125000
NODE_300768_length_221_cov_71.319672	14	94	86	2	80	0.0250000
NODE_300768_length_221_cov_71.319672	14	94	89	7	80	0.0875000
NODE_300768_length_221_cov_71.319672	14	94	95	1	80	0.0125000
NODE_300768_length_221_cov_71.319672	14	94	97	1	80	0.0125000
NODE_300768_length_221_cov_71.319672	14	94	98	2	80	0.0250000
NODE_300768_length_221_cov_71.319672	14	94	103	1	80	0.0125000
NODE_300768_length_221_cov_71.319672	14	94	108	1	80	0.0125000
NODE_300768_length_221_cov_71.319672	14	94	112	2	80	0.0250000
NODE_300768_length_221_cov_71.319672	14	94	118	2	80	0.0250000
NODE_300768_length_221_cov_71.319672	14	94	120	3	80	0.0375000
NODE_300768_length_221_cov_71.319672	14	94	124	2	80	0.0250000
NODE_300768_length_221_cov_71.319672	14	94	131	2	80	0.0250000
NODE_300768_length_221_cov_71.319672	14	94	132	3	80	0.0375000
NODE_300768_length_221_cov_71.319672	14	94	134	3	80	0.0375000
NODE_300768_length_221_cov_71.319672	14	94	136	2	80	0.0250000
NODE_300768_length_221_cov_71.319672	14	94	137	25	80	0.3125000
NODE_300768_length_221_cov_71.319672	14	94	138	2	80	0.0250000
NODE_300800_length_220_cov_42.206612	3	74	5	6	71	0.0845070
NODE_300800_length_220_cov_42.206612	3	74	6	24	71	0.3380282
NODE_300800_length_220_cov_42.206612	3	74	7	3	71	0.0422535
NODE_300800_length_220_cov_42.206612	3	74	8	5	71	0.0704225
NODE_300800_length_220_cov_42.206612	3	74	10	1	71	0.0140845
NODE_300800_length_220_cov_42.206612	3	74	12	11	71	0.1549296
NODE_300800_length_220_cov_42.206612	3	74	13	2	71	0.0281690
NODE_300800_length_220_cov_42.206612	3	74	14	19	71	0.2676056
NODE_300800_length_220_cov_42.206612	8	74	5	1	66	0.0151515
NODE_300800_length_220_cov_42.206612	8	74	6	24	66	0.3636364
NODE_300800_length_220_cov_42.206612	8	74	7	3	66	0.0454545
NODE_300800_length_220_cov_42.206612	8	74	8	5	66	0.0757576
NODE_300800_length_220_cov_42.206612	8	74	10	1	66	0.0151515
NODE_300800_length_220_cov_42.206612	8	74	12	11	66	0.1666667
NODE_300800_length_220_cov_42.206612	8	74	13	2	66	0.0303030
NODE_300800_length_220_cov_42.206612	8	74	14	19	66	0.2878788
NODE_300800_length_220_cov_42.206612	47	98	12	6	51	0.1176471
NODE_300800_length_220_cov_42.206612	47	98	13	2	51	0.0392157
NODE_300800_length_220_cov_42.206612	47	98	14	43	51	0.8431373
NODE_300800_length_220_cov_42.206612	47	98	12	6	51	0.1176471
NODE_300800_length_220_cov_42.206612	47	98	13	2	51	0.0392157
NODE_300800_length_220_cov_42.206612	47	98	14	43	51	0.8431373
NODE_300800_length_220_cov_42.206612	47	98	12	6	51	0.1176471
NODE_300800_length_220_cov_42.206612	47	98	13	2	51	0.0392157
NODE_300800_length_220_cov_42.206612	47	98	14	43	51	0.8431373
NODE_300874_length_218_cov_244.773109	128	203	6	13	75	0.1733333
NODE_300874_length_218_cov_244.773109	128	203	10	7	75	0.0933333
NODE_300874_length_218_cov_244.773109	128	203	14	11	75	0.1466667
NODE_300874_length_218_cov_244.773109	128	203	15	8	75	0.1066667
NODE_300874_length_218_cov_244.773109	128	203	20	6	75	0.0800000
NODE_300874_length_218_cov_244.773109	128	203	22	11	75	0.1466667
NODE_300874_length_218_cov_244.773109	128	203	24	2	75	0.0266667
NODE_300874_length_218_cov_244.773109	128	203	26	6	75	0.0800000
NODE_300874_length_218_cov_244.773109	128	203	28	9	75	0.1200000
NODE_300874_length_218_cov_244.773109	128	203	30	2	75	0.0266667
NODE_300874_length_218_cov_244.773109	176	218	4	3	42	0.0714286
NODE_300874_length_218_cov_244.773109	176	218	6	25	42	0.5952381
NODE_300874_length_218_cov_244.773109	176	218	10	7	42	0.1666667
NODE_300874_length_218_cov_244.773109	176	218	14	7	42	0.1666667
NODE_300915_length_217_cov_2.144068	14	49	0	35	35	1.0000000
NODE_300915_length_217_cov_2.144068	132	167	0	5	35	0.1428571
NODE_300915_length_217_cov_2.144068	132	167	1	1	35	0.0285714
NODE_300915_length_217_cov_2.144068	132	167	2	29	35	0.8285714
NODE_300924_length_216_cov_215.410256	0	63	2	17	63	0.2698413
NODE_300924_length_216_cov_215.410256	0	63	4	1	63	0.0158730
NODE_300924_length_216_cov_215.410256	0	63	8	6	63	0.0952381
NODE_300924_length_216_cov_215.410256	0	63	10	6	63	0.0952381
NODE_300924_length_216_cov_215.410256	0	63	12	1	63	0.0158730
NODE_300924_length_216_cov_215.410256	0	63	14	17	63	0.2698413
NODE_300924_length_216_cov_215.410256	0	63	18	11	63	0.1746032
NODE_300924_length_216_cov_215.410256	0	63	20	4	63	0.0634921
NODE_300924_length_216_cov_215.410256	36	102	14	12	66	0.1818182
NODE_300924_length_216_cov_215.410256	36	102	18	11	66	0.1666667
NODE_300924_length_216_cov_215.410256	36	102	20	4	66	0.0606061
NODE_300924_length_216_cov_215.410256	36	102	22	2	66	0.0303030
NODE_300924_length_216_cov_215.410256	36	102	24	37	66	0.5606061
NODE_300925_length_216_cov_51.940171	164	216	0	52	52	1.0000000
NODE_300953_length_215_cov_14.784483	0	50	0	50	50	1.0000000
NODE_300953_length_215_cov_14.784483	23	103	0	80	80	1.0000000
NODE_300984_length_214_cov_144.165217	0	62	0	62	62	1.0000000
NODE_300984_length_214_cov_144.165217	0	62	0	62	62	1.0000000
NODE_300984_length_214_cov_144.165217	35	115	0	80	80	1.0000000
NODE_300984_length_214_cov_144.165217	35	115	0	80	80	1.0000000
NODE_300984_length_214_cov_144.165217	35	115	0	80	80	1.0000000
NODE_300984_length_214_cov_144.165217	111	191	0	80	80	1.0000000
NODE_300984_length_214_cov_144.165217	111	191	0	80	80	1.0000000
NODE_300984_length_214_cov_144.165217	111	191	0	80	80	1.0000000
NODE_300984_length_214_cov_144.165217	164	214	0	50	50	1.0000000
NODE_300984_length_214_cov_144.165217	164	214	0	50	50	1.0000000
NODE_300984_length_214_cov_144.165217	164	214	0	50	50	1.0000000
NODE_301068_length_211_cov_39.571429	4	84	0	80	80	1.0000000
NODE_301169_length_208_cov_45.238532	3	59	0	56	56	1.0000000
NODE_301169_length_208_cov_45.238532	35	112	0	77	77	1.0000000
NODE_301170_length_208_cov_35.229358	76	156	0	80	80	1.0000000
NODE_301179_length_207_cov_341.324074	33	113	0	80	80	1.0000000
NODE_301179_length_207_cov_341.324074	86	166	0	80	80	1.0000000
NODE_301248_length_205_cov_64.179245	6	77	0	56	71	0.7887324
NODE_301248_length_205_cov_64.179245	6	77	3	1	71	0.0140845
NODE_301248_length_205_cov_64.179245	6	77	4	14	71	0.1971831
NODE_301248_length_205_cov_64.179245	11	77	0	51	66	0.7727273
NODE_301248_length_205_cov_64.179245	11	77	3	1	66	0.0151515
NODE_301248_length_205_cov_64.179245	11	77	4	14	66	0.2121212
NODE_301248_length_205_cov_64.179245	50	98	0	12	48	0.2500000
NODE_301248_length_205_cov_64.179245	50	98	3	1	48	0.0208333
NODE_301248_length_205_cov_64.179245	50	98	4	14	48	0.2916667
NODE_301248_length_205_cov_64.179245	50	98	8	21	48	0.4375000
NODE_301248_length_205_cov_64.179245	50	98	0	12	48	0.2500000
NODE_301248_length_205_cov_64.179245	50	98	3	1	48	0.0208333
NODE_301248_length_205_cov_64.179245	50	98	4	14	48	0.2916667
NODE_301248_length_205_cov_64.179245	50	98	8	21	48	0.4375000
NODE_301248_length_205_cov_64.179245	50	98	0	12	48	0.2500000
NODE_301248_length_205_cov_64.179245	50	98	3	1	48	0.0208333
NODE_301248_length_205_cov_64.179245	50	98	4	14	48	0.2916667
NODE_301248_length_205_cov_64.179245	50	98	8	21	48	0.4375000
NODE_301281_length_204_cov_183.390476	119	199	27	1	80	0.0125000
NODE_301281_length_204_cov_183.390476	119	199	29	3	80	0.0375000
NODE_301281_length_204_cov_183.390476	119	199	30	2	80	0.0250000
NODE_301281_length_204_cov_183.390476	119	199	32	4	80	0.0500000
NODE_301281_length_204_cov_183.390476	119	199	33	2	80	0.0250000
NODE_301281_length_204_cov_183.390476	119	199	35	1	80	0.0125000
NODE_301281_length_204_cov_183.390476	119	199	41	1	80	0.0125000
NODE_301281_length_204_cov_183.390476	119	199	47	2	80	0.0250000
NODE_301281_length_204_cov_183.390476	119	199	54	7	80	0.0875000
NODE_301281_length_204_cov_183.390476	119	199	58	3	80	0.0375000
NODE_301281_length_204_cov_183.390476	119	199	60	5	80	0.0625000
NODE_301281_length_204_cov_183.390476	119	199	62	3	80	0.0375000
NODE_301281_length_204_cov_183.390476	119	199	63	2	80	0.0250000
NODE_301281_length_204_cov_183.390476	119	199	65	2	80	0.0250000
NODE_301281_length_204_cov_183.390476	119	199	66	4	80	0.0500000
NODE_301281_length_204_cov_183.390476	119	199	68	2	80	0.0250000
NODE_301281_length_204_cov_183.390476	119	199	70	2	80	0.0250000
NODE_301281_length_204_cov_183.390476	119	199	72	1	80	0.0125000
NODE_301281_length_204_cov_183.390476	119	199	74	1	80	0.0125000
NODE_301281_length_204_cov_183.390476	119	199	76	5	80	0.0625000
NODE_301281_length_204_cov_183.390476	119	199	78	4	80	0.0500000
NODE_301281_length_204_cov_183.390476	119	199	79	3	80	0.0375000
NODE_301281_length_204_cov_183.390476	119	199	80	3	80	0.0375000
NODE_301281_length_204_cov_183.390476	119	199	81	7	80	0.0875000
NODE_301281_length_204_cov_183.390476	119	199	82	2	80	0.0250000
NODE_301281_length_204_cov_183.390476	119	199	84	5	80	0.0625000
NODE_301281_length_204_cov_183.390476	119	199	86	1	80	0.0125000
NODE_301281_length_204_cov_183.390476	119	199	88	1	80	0.0125000
NODE_301281_length_204_cov_183.390476	119	199	90	1	80	0.0125000
NODE_301281_length_204_cov_183.390476	172	194	30	1	22	0.0454545
NODE_301281_length_204_cov_183.390476	172	194	32	4	22	0.1818182
NODE_301281_length_204_cov_183.390476	172	194	33	2	22	0.0909091
NODE_301281_length_204_cov_183.390476	172	194	35	1	22	0.0454545
NODE_301281_length_204_cov_183.390476	172	194	41	1	22	0.0454545
NODE_301281_length_204_cov_183.390476	172	194	47	2	22	0.0909091
NODE_301281_length_204_cov_183.390476	172	194	54	7	22	0.3181818
NODE_301281_length_204_cov_183.390476	172	194	58	3	22	0.1363636
NODE_301281_length_204_cov_183.390476	172	194	60	1	22	0.0454545
NODE_301283_length_204_cov_80.095238	10	90	0	80	80	1.0000000
NODE_301283_length_204_cov_80.095238	63	143	0	80	80	1.0000000
NODE_301345_length_202_cov_123.184466	0	64	14	1	64	0.0156250
NODE_301345_length_202_cov_123.184466	0	64	30	3	64	0.0468750
NODE_301345_length_202_cov_123.184466	0	64	31	1	64	0.0156250
NODE_301345_length_202_cov_123.184466	0	64	35	1	64	0.0156250
NODE_301345_length_202_cov_123.184466	0	64	37	2	64	0.0312500
NODE_301345_length_202_cov_123.184466	0	64	42	2	64	0.0312500
NODE_301345_length_202_cov_123.184466	0	64	45	1	64	0.0156250
NODE_301345_length_202_cov_123.184466	0	64	50	1	64	0.0156250
NODE_301345_length_202_cov_123.184466	0	64	54	2	64	0.0312500
NODE_301345_length_202_cov_123.184466	0	64	72	2	64	0.0312500
NODE_301345_length_202_cov_123.184466	0	64	75	2	64	0.0312500
NODE_301345_length_202_cov_123.184466	0	64	83	1	64	0.0156250
NODE_301345_length_202_cov_123.184466	0	64	87	2	64	0.0312500
NODE_301345_length_202_cov_123.184466	0	64	93	1	64	0.0156250
NODE_301345_length_202_cov_123.184466	0	64	94	1	64	0.0156250
NODE_301345_length_202_cov_123.184466	0	64	98	1	64	0.0156250
NODE_301345_length_202_cov_123.184466	0	64	104	1	64	0.0156250
NODE_301345_length_202_cov_123.184466	0	64	106	1	64	0.0156250
NODE_301345_length_202_cov_123.184466	0	64	108	1	64	0.0156250
NODE_301345_length_202_cov_123.184466	0	64	111	2	64	0.0312500
NODE_301345_length_202_cov_123.184466	0	64	112	1	64	0.0156250
NODE_301345_length_202_cov_123.184466	0	64	118	1	64	0.0156250
NODE_301345_length_202_cov_123.184466	0	64	126	1	64	0.0156250
NODE_301345_length_202_cov_123.184466	0	64	128	1	64	0.0156250
NODE_301345_length_202_cov_123.184466	0	64	132	1	64	0.0156250
NODE_301345_length_202_cov_123.184466	0	64	137	1	64	0.0156250
NODE_301345_length_202_cov_123.184466	0	64	140	1	64	0.0156250
NODE_301345_length_202_cov_123.184466	0	64	144	1	64	0.0156250
NODE_301345_length_202_cov_123.184466	0	64	150	1	64	0.0156250
NODE_301345_length_202_cov_123.184466	0	64	151	2	64	0.0312500
NODE_301345_length_202_cov_123.184466	0	64	156	1	64	0.0156250
NODE_301345_length_202_cov_123.184466	0	64	168	1	64	0.0156250
NODE_301345_length_202_cov_123.184466	0	64	171	1	64	0.0156250
NODE_301345_length_202_cov_123.184466	0	64	177	1	64	0.0156250
NODE_301345_length_202_cov_123.184466	0	64	203	1	64	0.0156250
NODE_301345_length_202_cov_123.184466	0	64	206	1	64	0.0156250
NODE_301345_length_202_cov_123.184466	0	64	209	1	64	0.0156250
NODE_301345_length_202_cov_123.184466	0	64	216	1	64	0.0156250
NODE_301345_length_202_cov_123.184466	0	64	226	1	64	0.0156250
NODE_301345_length_202_cov_123.184466	0	64	235	1	64	0.0156250
NODE_301345_length_202_cov_123.184466	0	64	249	1	64	0.0156250
NODE_301345_length_202_cov_123.184466	0	64	254	1	64	0.0156250
NODE_301345_length_202_cov_123.184466	0	64	262	1	64	0.0156250
NODE_301345_length_202_cov_123.184466	0	64	265	2	64	0.0312500
NODE_301345_length_202_cov_123.184466	0	64	266	1	64	0.0156250
NODE_301345_length_202_cov_123.184466	0	64	267	1	64	0.0156250
NODE_301345_length_202_cov_123.184466	0	64	276	1	64	0.0156250
NODE_301345_length_202_cov_123.184466	0	64	283	1	64	0.0156250
NODE_301345_length_202_cov_123.184466	0	64	295	1	64	0.0156250
NODE_301345_length_202_cov_123.184466	0	64	299	1	64	0.0156250
NODE_301345_length_202_cov_123.184466	0	64	301	1	64	0.0156250
NODE_301345_length_202_cov_123.184466	0	64	303	1	64	0.0156250
NODE_301345_length_202_cov_123.184466	0	64	306	1	64	0.0156250
NODE_301345_length_202_cov_123.184466	31	72	126	1	41	0.0243902
NODE_301345_length_202_cov_123.184466	31	72	128	1	41	0.0243902
NODE_301345_length_202_cov_123.184466	31	72	132	1	41	0.0243902
NODE_301345_length_202_cov_123.184466	31	72	137	1	41	0.0243902
NODE_301345_length_202_cov_123.184466	31	72	140	1	41	0.0243902
NODE_301345_length_202_cov_123.184466	31	72	144	1	41	0.0243902
NODE_301345_length_202_cov_123.184466	31	72	150	1	41	0.0243902
NODE_301345_length_202_cov_123.184466	31	72	151	2	41	0.0487805
NODE_301345_length_202_cov_123.184466	31	72	156	1	41	0.0243902
NODE_301345_length_202_cov_123.184466	31	72	168	1	41	0.0243902
NODE_301345_length_202_cov_123.184466	31	72	171	1	41	0.0243902
NODE_301345_length_202_cov_123.184466	31	72	177	1	41	0.0243902
NODE_301345_length_202_cov_123.184466	31	72	203	1	41	0.0243902
NODE_301345_length_202_cov_123.184466	31	72	206	1	41	0.0243902
NODE_301345_length_202_cov_123.184466	31	72	209	1	41	0.0243902
NODE_301345_length_202_cov_123.184466	31	72	216	1	41	0.0243902
NODE_301345_length_202_cov_123.184466	31	72	226	1	41	0.0243902
NODE_301345_length_202_cov_123.184466	31	72	235	1	41	0.0243902
NODE_301345_length_202_cov_123.184466	31	72	249	1	41	0.0243902
NODE_301345_length_202_cov_123.184466	31	72	254	1	41	0.0243902
NODE_301345_length_202_cov_123.184466	31	72	262	1	41	0.0243902
NODE_301345_length_202_cov_123.184466	31	72	265	2	41	0.0487805
NODE_301345_length_202_cov_123.184466	31	72	266	1	41	0.0243902
NODE_301345_length_202_cov_123.184466	31	72	267	1	41	0.0243902
NODE_301345_length_202_cov_123.184466	31	72	276	1	41	0.0243902
NODE_301345_length_202_cov_123.184466	31	72	283	1	41	0.0243902
NODE_301345_length_202_cov_123.184466	31	72	295	1	41	0.0243902
NODE_301345_length_202_cov_123.184466	31	72	299	1	41	0.0243902
NODE_301345_length_202_cov_123.184466	31	72	301	1	41	0.0243902
NODE_301345_length_202_cov_123.184466	31	72	303	1	41	0.0243902
NODE_301345_length_202_cov_123.184466	31	72	306	1	41	0.0243902
NODE_301345_length_202_cov_123.184466	31	72	318	1	41	0.0243902
NODE_301345_length_202_cov_123.184466	31	72	322	1	41	0.0243902
NODE_301345_length_202_cov_123.184466	31	72	328	1	41	0.0243902
NODE_301345_length_202_cov_123.184466	31	72	348	1	41	0.0243902
NODE_301345_length_202_cov_123.184466	31	72	359	1	41	0.0243902
NODE_301345_length_202_cov_123.184466	31	72	365	1	41	0.0243902
NODE_301345_length_202_cov_123.184466	31	72	375	1	41	0.0243902
NODE_301345_length_202_cov_123.184466	31	72	387	1	41	0.0243902
NODE_301370_length_201_cov_56.323529	133	201	0	3	68	0.0441176
NODE_301370_length_201_cov_56.323529	133	201	2	27	68	0.3970588
NODE_301370_length_201_cov_56.323529	133	201	3	38	68	0.5588235
NODE_301371_length_201_cov_50.647059	44	99	15	4	55	0.0727273
NODE_301371_length_201_cov_50.647059	44	99	17	6	55	0.1090909
NODE_301371_length_201_cov_50.647059	44	99	19	2	55	0.0363636
NODE_301371_length_201_cov_50.647059	44	99	21	2	55	0.0363636
NODE_301371_length_201_cov_50.647059	44	99	24	1	55	0.0181818
NODE_301371_length_201_cov_50.647059	44	99	26	6	55	0.1090909
NODE_301371_length_201_cov_50.647059	44	99	30	9	55	0.1636364
NODE_301371_length_201_cov_50.647059	44	99	32	10	55	0.1818182
NODE_301371_length_201_cov_50.647059	44	99	34	7	55	0.1272727
NODE_301371_length_201_cov_50.647059	44	99	36	1	55	0.0181818
NODE_301371_length_201_cov_50.647059	44	99	38	7	55	0.1272727
NODE_301371_length_201_cov_50.647059	136	201	4	4	65	0.0615385
NODE_301371_length_201_cov_50.647059	136	201	6	1	65	0.0153846
NODE_301371_length_201_cov_50.647059	136	201	8	7	65	0.1076923
NODE_301371_length_201_cov_50.647059	136	201	10	2	65	0.0307692
NODE_301371_length_201_cov_50.647059	136	201	12	5	65	0.0769231
NODE_301371_length_201_cov_50.647059	136	201	14	5	65	0.0769231
NODE_301371_length_201_cov_50.647059	136	201	16	3	65	0.0461538
NODE_301371_length_201_cov_50.647059	136	201	18	2	65	0.0307692
NODE_301371_length_201_cov_50.647059	136	201	19	23	65	0.3538462
NODE_301371_length_201_cov_50.647059	136	201	22	9	65	0.1384615
NODE_301371_length_201_cov_50.647059	136	201	24	4	65	0.0615385
NODE_301371_length_201_cov_50.647059	136	201	4	4	65	0.0615385
NODE_301371_length_201_cov_50.647059	136	201	6	1	65	0.0153846
NODE_301371_length_201_cov_50.647059	136	201	8	7	65	0.1076923
NODE_301371_length_201_cov_50.647059	136	201	10	2	65	0.0307692
NODE_301371_length_201_cov_50.647059	136	201	12	5	65	0.0769231
NODE_301371_length_201_cov_50.647059	136	201	14	5	65	0.0769231
NODE_301371_length_201_cov_50.647059	136	201	16	3	65	0.0461538
NODE_301371_length_201_cov_50.647059	136	201	18	2	65	0.0307692
NODE_301371_length_201_cov_50.647059	136	201	19	23	65	0.3538462
NODE_301371_length_201_cov_50.647059	136	201	22	9	65	0.1384615
NODE_301371_length_201_cov_50.647059	136	201	24	4	65	0.0615385
NODE_301371_length_201_cov_50.647059	136	201	4	4	65	0.0615385
NODE_301371_length_201_cov_50.647059	136	201	6	1	65	0.0153846
NODE_301371_length_201_cov_50.647059	136	201	8	7	65	0.1076923
NODE_301371_length_201_cov_50.647059	136	201	10	2	65	0.0307692
NODE_301371_length_201_cov_50.647059	136	201	12	5	65	0.0769231
NODE_301371_length_201_cov_50.647059	136	201	14	5	65	0.0769231
NODE_301371_length_201_cov_50.647059	136	201	16	3	65	0.0461538
NODE_301371_length_201_cov_50.647059	136	201	18	2	65	0.0307692
NODE_301371_length_201_cov_50.647059	136	201	19	23	65	0.3538462
NODE_301371_length_201_cov_50.647059	136	201	22	9	65	0.1384615
NODE_301371_length_201_cov_50.647059	136	201	24	4	65	0.0615385
NODE_301371_length_201_cov_50.647059	136	201	4	4	65	0.0615385
NODE_301371_length_201_cov_50.647059	136	201	6	1	65	0.0153846
NODE_301371_length_201_cov_50.647059	136	201	8	7	65	0.1076923
NODE_301371_length_201_cov_50.647059	136	201	10	2	65	0.0307692
NODE_301371_length_201_cov_50.647059	136	201	12	5	65	0.0769231
NODE_301371_length_201_cov_50.647059	136	201	14	5	65	0.0769231
NODE_301371_length_201_cov_50.647059	136	201	16	3	65	0.0461538
NODE_301371_length_201_cov_50.647059	136	201	18	2	65	0.0307692
NODE_301371_length_201_cov_50.647059	136	201	19	23	65	0.3538462
NODE_301371_length_201_cov_50.647059	136	201	22	9	65	0.1384615
NODE_301371_length_201_cov_50.647059	136	201	24	4	65	0.0615385
NODE_301405_length_200_cov_29.118812	0	73	5	2	73	0.0273973
NODE_301405_length_200_cov_29.118812	0	73	7	1	73	0.0136986
NODE_301405_length_200_cov_29.118812	0	73	11	1	73	0.0136986
NODE_301405_length_200_cov_29.118812	0	73	15	4	73	0.0547945
NODE_301405_length_200_cov_29.118812	0	73	17	2	73	0.0273973
NODE_301405_length_200_cov_29.118812	0	73	19	2	73	0.0273973
NODE_301405_length_200_cov_29.118812	0	73	21	2	73	0.0273973
NODE_301405_length_200_cov_29.118812	0	73	22	2	73	0.0273973
NODE_301405_length_200_cov_29.118812	0	73	24	1	73	0.0136986
NODE_301405_length_200_cov_29.118812	0	73	26	23	73	0.3150685
NODE_301405_length_200_cov_29.118812	0	73	28	5	73	0.0684932
NODE_301405_length_200_cov_29.118812	0	73	30	2	73	0.0273973
NODE_301405_length_200_cov_29.118812	0	73	34	26	73	0.3561644
NODE_301419_length_199_cov_768.700000	94	142	397	1	48	0.0208333
NODE_301419_length_199_cov_768.700000	94	142	399	1	48	0.0208333
NODE_301419_length_199_cov_768.700000	94	142	403	5	48	0.1041667
NODE_301419_length_199_cov_768.700000	94	142	404	1	48	0.0208333
NODE_301419_length_199_cov_768.700000	94	142	405	1	48	0.0208333
NODE_301419_length_199_cov_768.700000	94	142	407	1	48	0.0208333
NODE_301419_length_199_cov_768.700000	94	142	411	3	48	0.0625000
NODE_301419_length_199_cov_768.700000	94	142	415	1	48	0.0208333
NODE_301419_length_199_cov_768.700000	94	142	417	3	48	0.0625000
NODE_301419_length_199_cov_768.700000	94	142	419	1	48	0.0208333
NODE_301419_length_199_cov_768.700000	94	142	422	1	48	0.0208333
NODE_301419_length_199_cov_768.700000	94	142	424	2	48	0.0416667
NODE_301419_length_199_cov_768.700000	94	142	426	1	48	0.0208333
NODE_301419_length_199_cov_768.700000	94	142	428	2	48	0.0416667
NODE_301419_length_199_cov_768.700000	94	142	429	1	48	0.0208333
NODE_301419_length_199_cov_768.700000	94	142	432	5	48	0.1041667
NODE_301419_length_199_cov_768.700000	94	142	434	3	48	0.0625000
NODE_301419_length_199_cov_768.700000	94	142	435	1	48	0.0208333
NODE_301419_length_199_cov_768.700000	94	142	436	2	48	0.0416667
NODE_301419_length_199_cov_768.700000	94	142	438	1	48	0.0208333
NODE_301419_length_199_cov_768.700000	94	142	439	2	48	0.0416667
NODE_301419_length_199_cov_768.700000	94	142	440	9	48	0.1875000
NODE_301419_length_199_cov_768.700000	115	186	114	1	71	0.0140845
NODE_301419_length_199_cov_768.700000	115	186	122	2	71	0.0281690
NODE_301419_length_199_cov_768.700000	115	186	126	1	71	0.0140845
NODE_301419_length_199_cov_768.700000	115	186	132	1	71	0.0140845
NODE_301419_length_199_cov_768.700000	115	186	146	1	71	0.0140845
NODE_301419_length_199_cov_768.700000	115	186	154	1	71	0.0140845
NODE_301419_length_199_cov_768.700000	115	186	167	1	71	0.0140845
NODE_301419_length_199_cov_768.700000	115	186	184	1	71	0.0140845
NODE_301419_length_199_cov_768.700000	115	186	197	1	71	0.0140845
NODE_301419_length_199_cov_768.700000	115	186	200	1	71	0.0140845
NODE_301419_length_199_cov_768.700000	115	186	202	1	71	0.0140845
NODE_301419_length_199_cov_768.700000	115	186	204	1	71	0.0140845
NODE_301419_length_199_cov_768.700000	115	186	216	1	71	0.0140845
NODE_301419_length_199_cov_768.700000	115	186	218	1	71	0.0140845
NODE_301419_length_199_cov_768.700000	115	186	222	2	71	0.0281690
NODE_301419_length_199_cov_768.700000	115	186	224	1	71	0.0140845
NODE_301419_length_199_cov_768.700000	115	186	230	1	71	0.0140845
NODE_301419_length_199_cov_768.700000	115	186	242	2	71	0.0281690
NODE_301419_length_199_cov_768.700000	115	186	250	1	71	0.0140845
NODE_301419_length_199_cov_768.700000	115	186	256	1	71	0.0140845
NODE_301419_length_199_cov_768.700000	115	186	271	1	71	0.0140845
NODE_301419_length_199_cov_768.700000	115	186	275	1	71	0.0140845
NODE_301419_length_199_cov_768.700000	115	186	292	1	71	0.0140845
NODE_301419_length_199_cov_768.700000	115	186	296	1	71	0.0140845
NODE_301419_length_199_cov_768.700000	115	186	305	1	71	0.0140845
NODE_301419_length_199_cov_768.700000	115	186	315	1	71	0.0140845
NODE_301419_length_199_cov_768.700000	115	186	317	1	71	0.0140845
NODE_301419_length_199_cov_768.700000	115	186	321	1	71	0.0140845
NODE_301419_length_199_cov_768.700000	115	186	334	1	71	0.0140845
NODE_301419_length_199_cov_768.700000	115	186	339	1	71	0.0140845
NODE_301419_length_199_cov_768.700000	115	186	341	1	71	0.0140845
NODE_301419_length_199_cov_768.700000	115	186	345	1	71	0.0140845
NODE_301419_length_199_cov_768.700000	115	186	347	1	71	0.0140845
NODE_301419_length_199_cov_768.700000	115	186	360	1	71	0.0140845
NODE_301419_length_199_cov_768.700000	115	186	366	1	71	0.0140845
NODE_301419_length_199_cov_768.700000	115	186	371	1	71	0.0140845
NODE_301419_length_199_cov_768.700000	115	186	381	1	71	0.0140845
NODE_301419_length_199_cov_768.700000	115	186	383	1	71	0.0140845
NODE_301419_length_199_cov_768.700000	115	186	385	1	71	0.0140845
NODE_301419_length_199_cov_768.700000	115	186	387	1	71	0.0140845
NODE_301419_length_199_cov_768.700000	115	186	395	1	71	0.0140845
NODE_301419_length_199_cov_768.700000	115	186	397	1	71	0.0140845
NODE_301419_length_199_cov_768.700000	115	186	399	1	71	0.0140845
NODE_301419_length_199_cov_768.700000	115	186	403	5	71	0.0704225
NODE_301419_length_199_cov_768.700000	115	186	404	1	71	0.0140845
NODE_301419_length_199_cov_768.700000	115	186	405	1	71	0.0140845
NODE_301419_length_199_cov_768.700000	115	186	407	1	71	0.0140845
NODE_301419_length_199_cov_768.700000	115	186	411	3	71	0.0422535
NODE_301419_length_199_cov_768.700000	115	186	415	1	71	0.0140845
NODE_301419_length_199_cov_768.700000	115	186	417	3	71	0.0422535
NODE_301419_length_199_cov_768.700000	115	186	419	1	71	0.0140845
NODE_301419_length_199_cov_768.700000	115	186	422	1	71	0.0140845
NODE_301419_length_199_cov_768.700000	115	186	424	2	71	0.0281690
NODE_301419_length_199_cov_768.700000	115	186	426	1	71	0.0140845
NODE_301419_length_199_cov_768.700000	115	186	428	2	71	0.0281690
NODE_301419_length_199_cov_768.700000	115	186	432	3	71	0.0422535
NODE_301420_length_199_cov_702.860000	3	78	22	1	75	0.0133333
NODE_301420_length_199_cov_702.860000	3	78	29	1	75	0.0133333
NODE_301420_length_199_cov_702.860000	3	78	31	1	75	0.0133333
NODE_301420_length_199_cov_702.860000	3	78	39	1	75	0.0133333
NODE_301420_length_199_cov_702.860000	3	78	43	1	75	0.0133333
NODE_301420_length_199_cov_702.860000	3	78	49	2	75	0.0266667
NODE_301420_length_199_cov_702.860000	3	78	53	1	75	0.0133333
NODE_301420_length_199_cov_702.860000	3	78	54	2	75	0.0266667
NODE_301420_length_199_cov_702.860000	3	78	58	1	75	0.0133333
NODE_301420_length_199_cov_702.860000	3	78	65	1	75	0.0133333
NODE_301420_length_199_cov_702.860000	3	78	70	2	75	0.0266667
NODE_301420_length_199_cov_702.860000	3	78	82	2	75	0.0266667
NODE_301420_length_199_cov_702.860000	3	78	86	2	75	0.0266667
NODE_301420_length_199_cov_702.860000	3	78	94	1	75	0.0133333
NODE_301420_length_199_cov_702.860000	3	78	102	1	75	0.0133333
NODE_301420_length_199_cov_702.860000	3	78	116	1	75	0.0133333
NODE_301420_length_199_cov_702.860000	3	78	128	1	75	0.0133333
NODE_301420_length_199_cov_702.860000	3	78	135	1	75	0.0133333
NODE_301420_length_199_cov_702.860000	3	78	160	1	75	0.0133333
NODE_301420_length_199_cov_702.860000	3	78	174	1	75	0.0133333
NODE_301420_length_199_cov_702.860000	3	78	178	1	75	0.0133333
NODE_301420_length_199_cov_702.860000	3	78	180	1	75	0.0133333
NODE_301420_length_199_cov_702.860000	3	78	194	1	75	0.0133333
NODE_301420_length_199_cov_702.860000	3	78	198	1	75	0.0133333
NODE_301420_length_199_cov_702.860000	3	78	202	1	75	0.0133333
NODE_301420_length_199_cov_702.860000	3	78	206	1	75	0.0133333
NODE_301420_length_199_cov_702.860000	3	78	209	1	75	0.0133333
NODE_301420_length_199_cov_702.860000	3	78	213	1	75	0.0133333
NODE_301420_length_199_cov_702.860000	3	78	225	1	75	0.0133333
NODE_301420_length_199_cov_702.860000	3	78	229	1	75	0.0133333
NODE_301420_length_199_cov_702.860000	3	78	231	1	75	0.0133333
NODE_301420_length_199_cov_702.860000	3	78	239	1	75	0.0133333
NODE_301420_length_199_cov_702.860000	3	78	245	1	75	0.0133333
NODE_301420_length_199_cov_702.860000	3	78	249	1	75	0.0133333
NODE_301420_length_199_cov_702.860000	3	78	254	1	75	0.0133333
NODE_301420_length_199_cov_702.860000	3	78	263	2	75	0.0266667
NODE_301420_length_199_cov_702.860000	3	78	289	1	75	0.0133333
NODE_301420_length_199_cov_702.860000	3	78	293	1	75	0.0133333
NODE_301420_length_199_cov_702.860000	3	78	303	1	75	0.0133333
NODE_301420_length_199_cov_702.860000	3	78	304	1	75	0.0133333
NODE_301420_length_199_cov_702.860000	3	78	321	1	75	0.0133333
NODE_301420_length_199_cov_702.860000	3	78	332	1	75	0.0133333
NODE_301420_length_199_cov_702.860000	3	78	334	1	75	0.0133333
NODE_301420_length_199_cov_702.860000	3	78	358	1	75	0.0133333
NODE_301420_length_199_cov_702.860000	3	78	368	1	75	0.0133333
NODE_301420_length_199_cov_702.860000	3	78	397	1	75	0.0133333
NODE_301420_length_199_cov_702.860000	3	78	403	1	75	0.0133333
NODE_301420_length_199_cov_702.860000	3	78	407	1	75	0.0133333
NODE_301420_length_199_cov_702.860000	3	78	408	1	75	0.0133333
NODE_301420_length_199_cov_702.860000	3	78	423	1	75	0.0133333
NODE_301420_length_199_cov_702.860000	3	78	429	1	75	0.0133333
NODE_301420_length_199_cov_702.860000	3	78	441	2	75	0.0266667
NODE_301420_length_199_cov_702.860000	3	78	450	1	75	0.0133333
NODE_301420_length_199_cov_702.860000	3	78	462	1	75	0.0133333
NODE_301420_length_199_cov_702.860000	3	78	464	1	75	0.0133333
NODE_301420_length_199_cov_702.860000	3	78	466	1	75	0.0133333
NODE_301420_length_199_cov_702.860000	3	78	471	1	75	0.0133333
NODE_301420_length_199_cov_702.860000	3	78	514	1	75	0.0133333
NODE_301420_length_199_cov_702.860000	3	78	516	2	75	0.0266667
NODE_301420_length_199_cov_702.860000	3	78	524	2	75	0.0266667
NODE_301420_length_199_cov_702.860000	3	78	527	1	75	0.0133333
NODE_301420_length_199_cov_702.860000	3	78	535	1	75	0.0133333
NODE_301420_length_199_cov_702.860000	3	78	537	1	75	0.0133333
NODE_301420_length_199_cov_702.860000	3	78	543	3	75	0.0400000
NODE_301420_length_199_cov_702.860000	51	131	334	1	80	0.0125000
NODE_301420_length_199_cov_702.860000	51	131	358	1	80	0.0125000
NODE_301420_length_199_cov_702.860000	51	131	368	1	80	0.0125000
NODE_301420_length_199_cov_702.860000	51	131	397	1	80	0.0125000
NODE_301420_length_199_cov_702.860000	51	131	403	1	80	0.0125000
NODE_301420_length_199_cov_702.860000	51	131	407	1	80	0.0125000
NODE_301420_length_199_cov_702.860000	51	131	408	1	80	0.0125000
NODE_301420_length_199_cov_702.860000	51	131	409	1	80	0.0125000
NODE_301420_length_199_cov_702.860000	51	131	410	1	80	0.0125000
NODE_301420_length_199_cov_702.860000	51	131	423	1	80	0.0125000
NODE_301420_length_199_cov_702.860000	51	131	429	1	80	0.0125000
NODE_301420_length_199_cov_702.860000	51	131	432	1	80	0.0125000
NODE_301420_length_199_cov_702.860000	51	131	439	1	80	0.0125000
NODE_301420_length_199_cov_702.860000	51	131	441	2	80	0.0250000
NODE_301420_length_199_cov_702.860000	51	131	443	1	80	0.0125000
NODE_301420_length_199_cov_702.860000	51	131	445	1	80	0.0125000
NODE_301420_length_199_cov_702.860000	51	131	450	1	80	0.0125000
NODE_301420_length_199_cov_702.860000	51	131	451	1	80	0.0125000
NODE_301420_length_199_cov_702.860000	51	131	462	1	80	0.0125000
NODE_301420_length_199_cov_702.860000	51	131	464	1	80	0.0125000
NODE_301420_length_199_cov_702.860000	51	131	466	2	80	0.0250000
NODE_301420_length_199_cov_702.860000	51	131	467	1	80	0.0125000
NODE_301420_length_199_cov_702.860000	51	131	471	1	80	0.0125000
NODE_301420_length_199_cov_702.860000	51	131	486	1	80	0.0125000
NODE_301420_length_199_cov_702.860000	51	131	498	1	80	0.0125000
NODE_301420_length_199_cov_702.860000	51	131	501	1	80	0.0125000
NODE_301420_length_199_cov_702.860000	51	131	514	1	80	0.0125000
NODE_301420_length_199_cov_702.860000	51	131	515	1	80	0.0125000
NODE_301420_length_199_cov_702.860000	51	131	516	2	80	0.0250000
NODE_301420_length_199_cov_702.860000	51	131	517	1	80	0.0125000
NODE_301420_length_199_cov_702.860000	51	131	524	2	80	0.0250000
NODE_301420_length_199_cov_702.860000	51	131	527	1	80	0.0125000
NODE_301420_length_199_cov_702.860000	51	131	533	1	80	0.0125000
NODE_301420_length_199_cov_702.860000	51	131	535	1	80	0.0125000
NODE_301420_length_199_cov_702.860000	51	131	537	1	80	0.0125000
NODE_301420_length_199_cov_702.860000	51	131	543	4	80	0.0500000
NODE_301420_length_199_cov_702.860000	51	131	556	1	80	0.0125000
NODE_301420_length_199_cov_702.860000	51	131	557	1	80	0.0125000
NODE_301420_length_199_cov_702.860000	51	131	561	2	80	0.0250000
NODE_301420_length_199_cov_702.860000	51	131	562	1	80	0.0125000
NODE_301420_length_199_cov_702.860000	51	131	563	2	80	0.0250000
NODE_301420_length_199_cov_702.860000	51	131	569	1	80	0.0125000
NODE_301420_length_199_cov_702.860000	51	131	570	4	80	0.0500000
NODE_301420_length_199_cov_702.860000	51	131	574	1	80	0.0125000
NODE_301420_length_199_cov_702.860000	51	131	575	1	80	0.0125000
NODE_301420_length_199_cov_702.860000	51	131	576	1	80	0.0125000
NODE_301420_length_199_cov_702.860000	51	131	580	1	80	0.0125000
NODE_301420_length_199_cov_702.860000	51	131	584	2	80	0.0250000
NODE_301420_length_199_cov_702.860000	51	131	585	3	80	0.0375000
NODE_301420_length_199_cov_702.860000	51	131	587	4	80	0.0500000
NODE_301420_length_199_cov_702.860000	51	131	588	9	80	0.1125000
NODE_301420_length_199_cov_702.860000	51	131	589	3	80	0.0375000
NODE_301421_length_199_cov_670.570000	22	52	788	1	30	0.0333333
NODE_301421_length_199_cov_670.570000	22	52	817	1	30	0.0333333
NODE_301421_length_199_cov_670.570000	22	52	850	1	30	0.0333333
NODE_301421_length_199_cov_670.570000	22	52	896	1	30	0.0333333
NODE_301421_length_199_cov_670.570000	22	52	982	1	30	0.0333333
NODE_301421_length_199_cov_670.570000	22	52	1005	1	30	0.0333333
NODE_301421_length_199_cov_670.570000	22	52	1045	1	30	0.0333333
NODE_301421_length_199_cov_670.570000	22	52	1059	1	30	0.0333333
NODE_301421_length_199_cov_670.570000	22	52	1073	1	30	0.0333333
NODE_301421_length_199_cov_670.570000	22	52	1082	1	30	0.0333333
NODE_301421_length_199_cov_670.570000	22	52	1088	1	30	0.0333333
NODE_301421_length_199_cov_670.570000	22	52	1122	1	30	0.0333333
NODE_301421_length_199_cov_670.570000	22	52	1138	1	30	0.0333333
NODE_301421_length_199_cov_670.570000	22	52	1173	1	30	0.0333333
NODE_301421_length_199_cov_670.570000	22	52	1223	1	30	0.0333333
NODE_301421_length_199_cov_670.570000	22	52	1246	1	30	0.0333333
NODE_301421_length_199_cov_670.570000	22	52	1291	1	30	0.0333333
NODE_301421_length_199_cov_670.570000	22	52	1323	1	30	0.0333333
NODE_301421_length_199_cov_670.570000	22	52	1365	1	30	0.0333333
NODE_301421_length_199_cov_670.570000	22	52	1397	1	30	0.0333333
NODE_301421_length_199_cov_670.570000	22	52	1423	1	30	0.0333333
NODE_301421_length_199_cov_670.570000	22	52	1426	1	30	0.0333333
NODE_301421_length_199_cov_670.570000	22	52	1436	1	30	0.0333333
NODE_301421_length_199_cov_670.570000	22	52	1450	1	30	0.0333333
NODE_301421_length_199_cov_670.570000	22	52	1453	1	30	0.0333333
NODE_301421_length_199_cov_670.570000	22	52	1494	1	30	0.0333333
NODE_301421_length_199_cov_670.570000	22	52	1502	1	30	0.0333333
NODE_301421_length_199_cov_670.570000	22	52	1530	1	30	0.0333333
NODE_301421_length_199_cov_670.570000	22	52	1564	1	30	0.0333333
NODE_301421_length_199_cov_670.570000	22	52	1574	1	30	0.0333333
NODE_301421_length_199_cov_670.570000	25	105	896	1	80	0.0125000
NODE_301421_length_199_cov_670.570000	25	105	982	1	80	0.0125000
NODE_301421_length_199_cov_670.570000	25	105	1005	1	80	0.0125000
NODE_301421_length_199_cov_670.570000	25	105	1045	1	80	0.0125000
NODE_301421_length_199_cov_670.570000	25	105	1059	1	80	0.0125000
NODE_301421_length_199_cov_670.570000	25	105	1073	1	80	0.0125000
NODE_301421_length_199_cov_670.570000	25	105	1082	1	80	0.0125000
NODE_301421_length_199_cov_670.570000	25	105	1088	1	80	0.0125000
NODE_301421_length_199_cov_670.570000	25	105	1122	1	80	0.0125000
NODE_301421_length_199_cov_670.570000	25	105	1138	1	80	0.0125000
NODE_301421_length_199_cov_670.570000	25	105	1173	1	80	0.0125000
NODE_301421_length_199_cov_670.570000	25	105	1223	1	80	0.0125000
NODE_301421_length_199_cov_670.570000	25	105	1246	1	80	0.0125000
NODE_301421_length_199_cov_670.570000	25	105	1291	1	80	0.0125000
NODE_301421_length_199_cov_670.570000	25	105	1323	1	80	0.0125000
NODE_301421_length_199_cov_670.570000	25	105	1365	1	80	0.0125000
NODE_301421_length_199_cov_670.570000	25	105	1397	1	80	0.0125000
NODE_301421_length_199_cov_670.570000	25	105	1423	1	80	0.0125000
NODE_301421_length_199_cov_670.570000	25	105	1426	1	80	0.0125000
NODE_301421_length_199_cov_670.570000	25	105	1436	1	80	0.0125000
NODE_301421_length_199_cov_670.570000	25	105	1450	1	80	0.0125000
NODE_301421_length_199_cov_670.570000	25	105	1453	1	80	0.0125000
NODE_301421_length_199_cov_670.570000	25	105	1494	1	80	0.0125000
NODE_301421_length_199_cov_670.570000	25	105	1502	1	80	0.0125000
NODE_301421_length_199_cov_670.570000	25	105	1530	1	80	0.0125000
NODE_301421_length_199_cov_670.570000	25	105	1564	1	80	0.0125000
NODE_301421_length_199_cov_670.570000	25	105	1574	1	80	0.0125000
NODE_301421_length_199_cov_670.570000	25	105	1598	1	80	0.0125000
NODE_301421_length_199_cov_670.570000	25	105	1602	1	80	0.0125000
NODE_301421_length_199_cov_670.570000	25	105	1631	1	80	0.0125000
NODE_301421_length_199_cov_670.570000	25	105	1652	1	80	0.0125000
NODE_301421_length_199_cov_670.570000	25	105	1664	1	80	0.0125000
NODE_301421_length_199_cov_670.570000	25	105	1672	1	80	0.0125000
NODE_301421_length_199_cov_670.570000	25	105	1688	1	80	0.0125000
NODE_301421_length_199_cov_670.570000	25	105	1692	1	80	0.0125000
NODE_301421_length_199_cov_670.570000	25	105	1706	1	80	0.0125000
NODE_301421_length_199_cov_670.570000	25	105	1708	1	80	0.0125000
NODE_301421_length_199_cov_670.570000	25	105	1710	1	80	0.0125000
NODE_301421_length_199_cov_670.570000	25	105	1718	1	80	0.0125000
NODE_301421_length_199_cov_670.570000	25	105	1723	1	80	0.0125000
NODE_301421_length_199_cov_670.570000	25	105	1727	1	80	0.0125000
NODE_301421_length_199_cov_670.570000	25	105	1732	1	80	0.0125000
NODE_301421_length_199_cov_670.570000	25	105	1736	1	80	0.0125000
NODE_301421_length_199_cov_670.570000	25	105	1746	1	80	0.0125000
NODE_301421_length_199_cov_670.570000	25	105	1752	1	80	0.0125000
NODE_301421_length_199_cov_670.570000	25	105	1764	1	80	0.0125000
NODE_301421_length_199_cov_670.570000	25	105	1772	1	80	0.0125000
NODE_301421_length_199_cov_670.570000	25	105	1780	1	80	0.0125000
NODE_301421_length_199_cov_670.570000	25	105	1788	1	80	0.0125000
NODE_301421_length_199_cov_670.570000	25	105	1805	1	80	0.0125000
NODE_301421_length_199_cov_670.570000	25	105	1814	2	80	0.0250000
NODE_301421_length_199_cov_670.570000	25	105	1816	1	80	0.0125000
NODE_301421_length_199_cov_670.570000	25	105	1831	1	80	0.0125000
NODE_301421_length_199_cov_670.570000	25	105	1832	1	80	0.0125000
NODE_301421_length_199_cov_670.570000	25	105	1837	1	80	0.0125000
NODE_301421_length_199_cov_670.570000	25	105	1846	1	80	0.0125000
NODE_301421_length_199_cov_670.570000	25	105	1851	2	80	0.0250000
NODE_301421_length_199_cov_670.570000	25	105	1853	1	80	0.0125000
NODE_301421_length_199_cov_670.570000	25	105	1856	1	80	0.0125000
NODE_301421_length_199_cov_670.570000	25	105	1857	1	80	0.0125000
NODE_301421_length_199_cov_670.570000	25	105	1867	1	80	0.0125000
NODE_301421_length_199_cov_670.570000	25	105	1871	2	80	0.0250000
NODE_301421_length_199_cov_670.570000	25	105	1881	1	80	0.0125000
NODE_301421_length_199_cov_670.570000	25	105	1883	1	80	0.0125000
NODE_301421_length_199_cov_670.570000	25	105	1885	1	80	0.0125000
NODE_301421_length_199_cov_670.570000	25	105	1886	1	80	0.0125000
NODE_301421_length_199_cov_670.570000	25	105	1888	3	80	0.0375000
NODE_301421_length_199_cov_670.570000	25	105	1890	1	80	0.0125000
NODE_301421_length_199_cov_670.570000	25	105	1891	1	80	0.0125000
NODE_301421_length_199_cov_670.570000	25	105	1893	5	80	0.0625000
NODE_301421_length_199_cov_670.570000	25	105	1894	1	80	0.0125000
NODE_301430_length_199_cov_215.860000	3	75	4	4	72	0.0555556
NODE_301430_length_199_cov_215.860000	3	75	6	5	72	0.0694444
NODE_301430_length_199_cov_215.860000	3	75	14	1	72	0.0138889
NODE_301430_length_199_cov_215.860000	3	75	16	1	72	0.0138889
NODE_301430_length_199_cov_215.860000	3	75	18	2	72	0.0277778
NODE_301430_length_199_cov_215.860000	3	75	22	6	72	0.0833333
NODE_301430_length_199_cov_215.860000	3	75	24	2	72	0.0277778
NODE_301430_length_199_cov_215.860000	3	75	34	3	72	0.0416667
NODE_301430_length_199_cov_215.860000	3	75	36	1	72	0.0138889
NODE_301430_length_199_cov_215.860000	3	75	40	1	72	0.0138889
NODE_301430_length_199_cov_215.860000	3	75	42	3	72	0.0416667
NODE_301430_length_199_cov_215.860000	3	75	44	1	72	0.0138889
NODE_301430_length_199_cov_215.860000	3	75	50	1	72	0.0138889
NODE_301430_length_199_cov_215.860000	3	75	64	1	72	0.0138889
NODE_301430_length_199_cov_215.860000	3	75	66	2	72	0.0277778
NODE_301430_length_199_cov_215.860000	3	75	68	1	72	0.0138889
NODE_301430_length_199_cov_215.860000	3	75	83	1	72	0.0138889
NODE_301430_length_199_cov_215.860000	3	75	89	2	72	0.0277778
NODE_301430_length_199_cov_215.860000	3	75	91	1	72	0.0138889
NODE_301430_length_199_cov_215.860000	3	75	92	4	72	0.0555556
NODE_301430_length_199_cov_215.860000	3	75	96	4	72	0.0555556
NODE_301430_length_199_cov_215.860000	3	75	98	1	72	0.0138889
NODE_301430_length_199_cov_215.860000	3	75	99	1	72	0.0138889
NODE_301430_length_199_cov_215.860000	3	75	102	3	72	0.0416667
NODE_301430_length_199_cov_215.860000	3	75	106	1	72	0.0138889
NODE_301430_length_199_cov_215.860000	3	75	108	1	72	0.0138889
NODE_301430_length_199_cov_215.860000	3	75	117	7	72	0.0972222
NODE_301430_length_199_cov_215.860000	3	75	119	1	72	0.0138889
NODE_301430_length_199_cov_215.860000	3	75	123	7	72	0.0972222
NODE_301430_length_199_cov_215.860000	3	75	125	3	72	0.0416667
NODE_301430_length_199_cov_215.860000	48	128	96	2	80	0.0250000
NODE_301430_length_199_cov_215.860000	48	128	98	1	80	0.0125000
NODE_301430_length_199_cov_215.860000	48	128	99	1	80	0.0125000
NODE_301430_length_199_cov_215.860000	48	128	102	3	80	0.0375000
NODE_301430_length_199_cov_215.860000	48	128	103	2	80	0.0250000
NODE_301430_length_199_cov_215.860000	48	128	105	5	80	0.0625000
NODE_301430_length_199_cov_215.860000	48	128	106	1	80	0.0125000
NODE_301430_length_199_cov_215.860000	48	128	108	1	80	0.0125000
NODE_301430_length_199_cov_215.860000	48	128	109	4	80	0.0500000
NODE_301430_length_199_cov_215.860000	48	128	111	2	80	0.0250000
NODE_301430_length_199_cov_215.860000	48	128	117	9	80	0.1125000
NODE_301430_length_199_cov_215.860000	48	128	119	1	80	0.0125000
NODE_301430_length_199_cov_215.860000	48	128	123	9	80	0.1125000
NODE_301430_length_199_cov_215.860000	48	128	125	4	80	0.0500000
NODE_301430_length_199_cov_215.860000	48	128	126	3	80	0.0375000
NODE_301430_length_199_cov_215.860000	48	128	129	6	80	0.0750000
NODE_301430_length_199_cov_215.860000	48	128	130	6	80	0.0750000
NODE_301430_length_199_cov_215.860000	48	128	131	2	80	0.0250000
NODE_301430_length_199_cov_215.860000	48	128	132	5	80	0.0625000
NODE_301430_length_199_cov_215.860000	48	128	133	2	80	0.0250000
NODE_301430_length_199_cov_215.860000	48	128	134	11	80	0.1375000
NODE_301432_length_199_cov_206.800000	120	199	1	38	79	0.4810127
NODE_301432_length_199_cov_206.800000	120	199	2	41	79	0.5189874
NODE_301441_length_199_cov_131.120000	97	177	0	80	80	1.0000000
NODE_301448_length_199_cov_97.490000	4	77	7	3	73	0.0410959
NODE_301448_length_199_cov_97.490000	4	77	8	4	73	0.0547945
NODE_301448_length_199_cov_97.490000	4	77	10	13	73	0.1780822
NODE_301448_length_199_cov_97.490000	4	77	12	8	73	0.1095890
NODE_301448_length_199_cov_97.490000	4	77	14	4	73	0.0547945
NODE_301448_length_199_cov_97.490000	4	77	16	4	73	0.0547945
NODE_301448_length_199_cov_97.490000	4	77	18	2	73	0.0273973
NODE_301448_length_199_cov_97.490000	4	77	20	12	73	0.1643836
NODE_301448_length_199_cov_97.490000	4	77	24	3	73	0.0410959
NODE_301448_length_199_cov_97.490000	4	77	25	10	73	0.1369863
NODE_301448_length_199_cov_97.490000	4	77	26	2	73	0.0273973
NODE_301448_length_199_cov_97.490000	4	77	28	4	73	0.0547945
NODE_301448_length_199_cov_97.490000	4	77	30	4	73	0.0547945
NODE_301449_length_199_cov_96.090000	91	171	45	1	80	0.0125000
NODE_301449_length_199_cov_96.090000	91	171	53	1	80	0.0125000
NODE_301449_length_199_cov_96.090000	91	171	58	1	80	0.0125000
NODE_301449_length_199_cov_96.090000	91	171	60	1	80	0.0125000
NODE_301449_length_199_cov_96.090000	91	171	64	1	80	0.0125000
NODE_301449_length_199_cov_96.090000	91	171	66	1	80	0.0125000
NODE_301449_length_199_cov_96.090000	91	171	70	1	80	0.0125000
NODE_301449_length_199_cov_96.090000	91	171	84	1	80	0.0125000
NODE_301449_length_199_cov_96.090000	91	171	86	1	80	0.0125000
NODE_301449_length_199_cov_96.090000	91	171	92	1	80	0.0125000
NODE_301449_length_199_cov_96.090000	91	171	96	1	80	0.0125000
NODE_301449_length_199_cov_96.090000	91	171	106	1	80	0.0125000
NODE_301449_length_199_cov_96.090000	91	171	108	1	80	0.0125000
NODE_301449_length_199_cov_96.090000	91	171	112	1	80	0.0125000
NODE_301449_length_199_cov_96.090000	91	171	116	3	80	0.0375000
NODE_301449_length_199_cov_96.090000	91	171	122	2	80	0.0250000
NODE_301449_length_199_cov_96.090000	91	171	130	2	80	0.0250000
NODE_301449_length_199_cov_96.090000	91	171	133	2	80	0.0250000
NODE_301449_length_199_cov_96.090000	91	171	135	2	80	0.0250000
NODE_301449_length_199_cov_96.090000	91	171	137	1	80	0.0125000
NODE_301449_length_199_cov_96.090000	91	171	139	2	80	0.0250000
NODE_301449_length_199_cov_96.090000	91	171	141	2	80	0.0250000
NODE_301449_length_199_cov_96.090000	91	171	143	1	80	0.0125000
NODE_301449_length_199_cov_96.090000	91	171	153	2	80	0.0250000
NODE_301449_length_199_cov_96.090000	91	171	159	2	80	0.0250000
NODE_301449_length_199_cov_96.090000	91	171	166	1	80	0.0125000
NODE_301449_length_199_cov_96.090000	91	171	172	1	80	0.0125000
NODE_301449_length_199_cov_96.090000	91	171	173	2	80	0.0250000
NODE_301449_length_199_cov_96.090000	91	171	175	1	80	0.0125000
NODE_301449_length_199_cov_96.090000	91	171	177	1	80	0.0125000
NODE_301449_length_199_cov_96.090000	91	171	181	6	80	0.0750000
NODE_301449_length_199_cov_96.090000	91	171	185	1	80	0.0125000
NODE_301449_length_199_cov_96.090000	91	171	187	2	80	0.0250000
NODE_301449_length_199_cov_96.090000	91	171	191	3	80	0.0375000
NODE_301449_length_199_cov_96.090000	91	171	193	1	80	0.0125000
NODE_301449_length_199_cov_96.090000	91	171	195	1	80	0.0125000
NODE_301449_length_199_cov_96.090000	91	171	197	3	80	0.0375000
NODE_301449_length_199_cov_96.090000	91	171	199	3	80	0.0375000
NODE_301449_length_199_cov_96.090000	91	171	201	3	80	0.0375000
NODE_301449_length_199_cov_96.090000	91	171	203	16	80	0.2000000
NODE_301455_length_199_cov_84.060000	44	75	16	12	31	0.3870968
NODE_301455_length_199_cov_84.060000	44	75	18	13	31	0.4193548
NODE_301455_length_199_cov_84.060000	44	75	22	6	31	0.1935484
NODE_301456_length_199_cov_83.220000	0	64	0	64	64	1.0000000
NODE_301459_length_199_cov_80.390000	15	98	0	83	83	1.0000000
NODE_301469_length_199_cov_63.420000	128	194	2	1	66	0.0151515
NODE_301469_length_199_cov_63.420000	128	194	8	1	66	0.0151515
NODE_301469_length_199_cov_63.420000	128	194	12	1	66	0.0151515
NODE_301469_length_199_cov_63.420000	128	194	14	1	66	0.0151515
NODE_301469_length_199_cov_63.420000	128	194	16	1	66	0.0151515
NODE_301469_length_199_cov_63.420000	128	194	18	3	66	0.0454545
NODE_301469_length_199_cov_63.420000	128	194	24	1	66	0.0151515
NODE_301469_length_199_cov_63.420000	128	194	28	2	66	0.0303030
NODE_301469_length_199_cov_63.420000	128	194	32	1	66	0.0151515
NODE_301469_length_199_cov_63.420000	128	194	34	14	66	0.2121212
NODE_301469_length_199_cov_63.420000	128	194	36	2	66	0.0303030
NODE_301469_length_199_cov_63.420000	128	194	43	3	66	0.0454545
NODE_301469_length_199_cov_63.420000	128	194	47	2	66	0.0303030
NODE_301469_length_199_cov_63.420000	128	194	49	1	66	0.0151515
NODE_301469_length_199_cov_63.420000	128	194	51	1	66	0.0151515
NODE_301469_length_199_cov_63.420000	128	194	53	1	66	0.0151515
NODE_301469_length_199_cov_63.420000	128	194	61	2	66	0.0303030
NODE_301469_length_199_cov_63.420000	128	194	65	1	66	0.0151515
NODE_301469_length_199_cov_63.420000	128	194	67	1	66	0.0151515
NODE_301469_length_199_cov_63.420000	128	194	71	3	66	0.0454545
NODE_301469_length_199_cov_63.420000	128	194	75	2	66	0.0303030
NODE_301469_length_199_cov_63.420000	128	194	79	1	66	0.0151515
NODE_301469_length_199_cov_63.420000	128	194	87	1	66	0.0151515
NODE_301469_length_199_cov_63.420000	128	194	91	3	66	0.0454545
NODE_301469_length_199_cov_63.420000	128	194	97	1	66	0.0151515
NODE_301469_length_199_cov_63.420000	128	194	101	3	66	0.0454545
NODE_301469_length_199_cov_63.420000	128	194	103	2	66	0.0303030
NODE_301469_length_199_cov_63.420000	128	194	111	1	66	0.0151515
NODE_301469_length_199_cov_63.420000	128	194	112	4	66	0.0606061
NODE_301469_length_199_cov_63.420000	128	194	114	1	66	0.0151515
NODE_301469_length_199_cov_63.420000	128	194	115	2	66	0.0303030
NODE_301469_length_199_cov_63.420000	128	194	119	1	66	0.0151515
NODE_301469_length_199_cov_63.420000	128	194	123	1	66	0.0151515
NODE_301477_length_199_cov_58.660000	18	85	0	37	67	0.5522388
NODE_301477_length_199_cov_58.660000	18	85	6	14	67	0.2089552
NODE_301477_length_199_cov_58.660000	18	85	11	4	67	0.0597015
NODE_301477_length_199_cov_58.660000	18	85	19	4	67	0.0597015
NODE_301477_length_199_cov_58.660000	18	85	25	8	67	0.1194030
NODE_301484_length_199_cov_50.350000	102	183	0	81	81	1.0000000
NODE_301485_length_199_cov_49.630000	5	47	0	42	42	1.0000000
NODE_301485_length_199_cov_49.630000	100	163	0	26	63	0.4126984
NODE_301485_length_199_cov_49.630000	100	163	2	37	63	0.5873016
NODE_301485_length_199_cov_49.630000	100	163	0	26	63	0.4126984
NODE_301485_length_199_cov_49.630000	100	163	2	37	63	0.5873016
NODE_301485_length_199_cov_49.630000	100	163	0	26	63	0.4126984
NODE_301485_length_199_cov_49.630000	100	163	2	37	63	0.5873016
NODE_301485_length_199_cov_49.630000	136	185	0	48	49	0.9795918
NODE_301485_length_199_cov_49.630000	136	185	2	1	49	0.0204082
NODE_301485_length_199_cov_49.630000	153	199	0	46	46	1.0000000
NODE_301491_length_199_cov_40.000000	0	66	0	3	66	0.0454545
NODE_301491_length_199_cov_40.000000	0	66	2	12	66	0.1818182
NODE_301491_length_199_cov_40.000000	0	66	4	3	66	0.0454545
NODE_301491_length_199_cov_40.000000	0	66	6	3	66	0.0454545
NODE_301491_length_199_cov_40.000000	0	66	7	1	66	0.0151515
NODE_301491_length_199_cov_40.000000	0	66	8	3	66	0.0454545
NODE_301491_length_199_cov_40.000000	0	66	12	1	66	0.0151515
NODE_301491_length_199_cov_40.000000	0	66	14	9	66	0.1363636
NODE_301491_length_199_cov_40.000000	0	66	16	7	66	0.1060606
NODE_301491_length_199_cov_40.000000	0	66	20	1	66	0.0151515
NODE_301491_length_199_cov_40.000000	0	66	22	3	66	0.0454545
NODE_301491_length_199_cov_40.000000	0	66	26	5	66	0.0757576
NODE_301491_length_199_cov_40.000000	0	66	27	1	66	0.0151515
NODE_301491_length_199_cov_40.000000	0	66	28	10	66	0.1515152
NODE_301491_length_199_cov_40.000000	0	66	29	4	66	0.0606061
NODE_301491_length_199_cov_40.000000	34	114	14	1	80	0.0125000
NODE_301491_length_199_cov_40.000000	34	114	16	7	80	0.0875000
NODE_301491_length_199_cov_40.000000	34	114	20	1	80	0.0125000
NODE_301491_length_199_cov_40.000000	34	114	22	3	80	0.0375000
NODE_301491_length_199_cov_40.000000	34	114	26	5	80	0.0625000
NODE_301491_length_199_cov_40.000000	34	114	27	1	80	0.0125000
NODE_301491_length_199_cov_40.000000	34	114	28	18	80	0.2250000
NODE_301491_length_199_cov_40.000000	34	114	29	9	80	0.1125000
NODE_301491_length_199_cov_40.000000	34	114	30	35	80	0.4375000
NODE_301491_length_199_cov_40.000000	39	61	16	3	22	0.1363636
NODE_301491_length_199_cov_40.000000	39	61	20	1	22	0.0454545
NODE_301491_length_199_cov_40.000000	39	61	22	3	22	0.1363636
NODE_301491_length_199_cov_40.000000	39	61	26	5	22	0.2272727
NODE_301491_length_199_cov_40.000000	39	61	27	1	22	0.0454545
NODE_301491_length_199_cov_40.000000	39	61	28	9	22	0.4090909
NODE_301498_length_199_cov_31.400000	3	77	2	9	74	0.1216216
NODE_301498_length_199_cov_31.400000	3	77	3	2	74	0.0270270
NODE_301498_length_199_cov_31.400000	3	77	4	9	74	0.1216216
NODE_301498_length_199_cov_31.400000	3	77	5	2	74	0.0270270
NODE_301498_length_199_cov_31.400000	3	77	6	51	74	0.6891892
NODE_301498_length_199_cov_31.400000	3	77	8	1	74	0.0135135
NODE_301498_length_199_cov_31.400000	76	153	6	8	77	0.1038961
NODE_301498_length_199_cov_31.400000	76	153	8	20	77	0.2597403
NODE_301498_length_199_cov_31.400000	76	153	10	49	77	0.6363636
NODE_301498_length_199_cov_31.400000	76	153	6	8	77	0.1038961
NODE_301498_length_199_cov_31.400000	76	153	8	20	77	0.2597403
NODE_301498_length_199_cov_31.400000	76	153	10	49	77	0.6363636
NODE_301498_length_199_cov_31.400000	76	153	6	8	77	0.1038961
NODE_301498_length_199_cov_31.400000	76	153	8	20	77	0.2597403
NODE_301498_length_199_cov_31.400000	76	153	10	49	77	0.6363636
NODE_301498_length_199_cov_31.400000	126	192	0	21	66	0.3181818
NODE_301498_length_199_cov_31.400000	126	192	2	7	66	0.1060606
NODE_301498_length_199_cov_31.400000	126	192	3	2	66	0.0303030
NODE_301498_length_199_cov_31.400000	126	192	4	3	66	0.0454545
NODE_301498_length_199_cov_31.400000	126	192	6	14	66	0.2121212
NODE_301498_length_199_cov_31.400000	126	192	8	6	66	0.0909091
NODE_301498_length_199_cov_31.400000	126	192	10	13	66	0.1969697
NODE_301498_length_199_cov_31.400000	129	199	0	28	70	0.4000000
NODE_301498_length_199_cov_31.400000	129	199	2	7	70	0.1000000
NODE_301498_length_199_cov_31.400000	129	199	3	2	70	0.0285714
NODE_301498_length_199_cov_31.400000	129	199	4	3	70	0.0428571
NODE_301498_length_199_cov_31.400000	129	199	6	14	70	0.2000000
NODE_301498_length_199_cov_31.400000	129	199	8	6	70	0.0857143
NODE_301498_length_199_cov_31.400000	129	199	10	10	70	0.1428571
NODE_301498_length_199_cov_31.400000	131	199	0	28	68	0.4117647
NODE_301498_length_199_cov_31.400000	131	199	2	7	68	0.1029412
NODE_301498_length_199_cov_31.400000	131	199	3	2	68	0.0294118
NODE_301498_length_199_cov_31.400000	131	199	4	3	68	0.0441176
NODE_301498_length_199_cov_31.400000	131	199	6	14	68	0.2058824
NODE_301498_length_199_cov_31.400000	131	199	8	6	68	0.0882353
NODE_301498_length_199_cov_31.400000	131	199	10	8	68	0.1176471
NODE_301500_length_199_cov_30.140000	118	198	0	19	80	0.2375000
NODE_301500_length_199_cov_30.140000	118	198	1	26	80	0.3250000
NODE_301500_length_199_cov_30.140000	118	198	3	35	80	0.4375000
NODE_301500_length_199_cov_30.140000	118	198	0	19	80	0.2375000
NODE_301500_length_199_cov_30.140000	118	198	1	26	80	0.3250000
NODE_301500_length_199_cov_30.140000	118	198	3	35	80	0.4375000
NODE_301500_length_199_cov_30.140000	118	198	0	19	80	0.2375000
NODE_301500_length_199_cov_30.140000	118	198	1	26	80	0.3250000
NODE_301500_length_199_cov_30.140000	118	198	3	35	80	0.4375000
NODE_301500_length_199_cov_30.140000	118	198	0	19	80	0.2375000
NODE_301500_length_199_cov_30.140000	118	198	1	26	80	0.3250000
NODE_301500_length_199_cov_30.140000	118	198	3	35	80	0.4375000
NODE_301500_length_199_cov_30.140000	118	198	0	19	80	0.2375000
NODE_301500_length_199_cov_30.140000	118	198	1	26	80	0.3250000
NODE_301500_length_199_cov_30.140000	118	198	3	35	80	0.4375000
NODE_301500_length_199_cov_30.140000	127	198	0	19	71	0.2676056
NODE_301500_length_199_cov_30.140000	127	198	1	26	71	0.3661972
NODE_301500_length_199_cov_30.140000	127	198	3	26	71	0.3661972
NODE_301581_length_197_cov_41.265306	0	70	0	70	70	1.0000000
NODE_301611_length_196_cov_101.855670	72	136	44	17	64	0.2656250
NODE_301611_length_196_cov_101.855670	72	136	46	1	64	0.0156250
NODE_301611_length_196_cov_101.855670	72	136	48	16	64	0.2500000
NODE_301611_length_196_cov_101.855670	72	136	50	30	64	0.4687500
NODE_301611_length_196_cov_101.855670	72	136	44	17	64	0.2656250
NODE_301611_length_196_cov_101.855670	72	136	46	1	64	0.0156250
NODE_301611_length_196_cov_101.855670	72	136	48	16	64	0.2500000
NODE_301611_length_196_cov_101.855670	72	136	50	30	64	0.4687500
NODE_301611_length_196_cov_101.855670	109	169	6	4	60	0.0666667
NODE_301611_length_196_cov_101.855670	109	169	10	8	60	0.1333333
NODE_301611_length_196_cov_101.855670	109	169	12	2	60	0.0333333
NODE_301611_length_196_cov_101.855670	109	169	14	1	60	0.0166667
NODE_301611_length_196_cov_101.855670	109	169	24	1	60	0.0166667
NODE_301611_length_196_cov_101.855670	109	169	28	2	60	0.0333333
NODE_301611_length_196_cov_101.855670	109	169	32	1	60	0.0166667
NODE_301611_length_196_cov_101.855670	109	169	34	1	60	0.0166667
NODE_301611_length_196_cov_101.855670	109	169	36	1	60	0.0166667
NODE_301611_length_196_cov_101.855670	109	169	38	8	60	0.1333333
NODE_301611_length_196_cov_101.855670	109	169	40	3	60	0.0500000
NODE_301611_length_196_cov_101.855670	109	169	44	6	60	0.1000000
NODE_301611_length_196_cov_101.855670	109	169	46	1	60	0.0166667
NODE_301611_length_196_cov_101.855670	109	169	48	11	60	0.1833333
NODE_301611_length_196_cov_101.855670	109	169	50	10	60	0.1666667
NODE_301613_length_196_cov_100.618557	129	196	2	4	67	0.0597015
NODE_301613_length_196_cov_100.618557	129	196	4	2	67	0.0298507
NODE_301613_length_196_cov_100.618557	129	196	6	7	67	0.1044776
NODE_301613_length_196_cov_100.618557	129	196	8	3	67	0.0447761
NODE_301613_length_196_cov_100.618557	129	196	17	1	67	0.0149254
NODE_301613_length_196_cov_100.618557	129	196	19	1	67	0.0149254
NODE_301613_length_196_cov_100.618557	129	196	24	4	67	0.0597015
NODE_301613_length_196_cov_100.618557	129	196	28	7	67	0.1044776
NODE_301613_length_196_cov_100.618557	129	196	32	1	67	0.0149254
NODE_301613_length_196_cov_100.618557	129	196	34	4	67	0.0597015
NODE_301613_length_196_cov_100.618557	129	196	36	2	67	0.0298507
NODE_301613_length_196_cov_100.618557	129	196	38	1	67	0.0149254
NODE_301613_length_196_cov_100.618557	129	196	40	3	67	0.0447761
NODE_301613_length_196_cov_100.618557	129	196	42	1	67	0.0149254
NODE_301613_length_196_cov_100.618557	129	196	50	5	67	0.0746269
NODE_301613_length_196_cov_100.618557	129	196	52	1	67	0.0149254
NODE_301613_length_196_cov_100.618557	129	196	54	3	67	0.0447761
NODE_301613_length_196_cov_100.618557	129	196	56	5	67	0.0746269
NODE_301613_length_196_cov_100.618557	129	196	58	4	67	0.0597015
NODE_301613_length_196_cov_100.618557	129	196	60	1	67	0.0149254
NODE_301613_length_196_cov_100.618557	129	196	62	1	67	0.0149254
NODE_301613_length_196_cov_100.618557	129	196	64	2	67	0.0298507
NODE_301613_length_196_cov_100.618557	129	196	66	4	67	0.0597015
NODE_301618_length_196_cov_67.268041	8	88	2	36	80	0.4500000
NODE_301618_length_196_cov_67.268041	8	88	10	12	80	0.1500000
NODE_301618_length_196_cov_67.268041	8	88	12	32	80	0.4000000
NODE_301618_length_196_cov_67.268041	61	124	12	63	63	1.0000000
NODE_301629_length_196_cov_40.195876	101	184	0	1	83	0.0120482
NODE_301629_length_196_cov_40.195876	101	184	6	27	83	0.3253012
NODE_301629_length_196_cov_40.195876	101	184	7	3	83	0.0361446
NODE_301629_length_196_cov_40.195876	101	184	8	12	83	0.1445783
NODE_301629_length_196_cov_40.195876	101	184	10	40	83	0.4819277
NODE_301704_length_194_cov_63.252632	12	78	2	4	66	0.0606061
NODE_301704_length_194_cov_63.252632	12	78	3	11	66	0.1666667
NODE_301704_length_194_cov_63.252632	12	78	5	2	66	0.0303030
NODE_301704_length_194_cov_63.252632	12	78	6	1	66	0.0151515
NODE_301704_length_194_cov_63.252632	12	78	7	1	66	0.0151515
NODE_301704_length_194_cov_63.252632	12	78	11	2	66	0.0303030
NODE_301704_length_194_cov_63.252632	12	78	12	2	66	0.0303030
NODE_301704_length_194_cov_63.252632	12	78	17	1	66	0.0151515
NODE_301704_length_194_cov_63.252632	12	78	19	2	66	0.0303030
NODE_301704_length_194_cov_63.252632	12	78	20	1	66	0.0151515
NODE_301704_length_194_cov_63.252632	12	78	22	1	66	0.0151515
NODE_301704_length_194_cov_63.252632	12	78	27	1	66	0.0151515
NODE_301704_length_194_cov_63.252632	12	78	29	4	66	0.0606061
NODE_301704_length_194_cov_63.252632	12	78	32	2	66	0.0303030
NODE_301704_length_194_cov_63.252632	12	78	34	2	66	0.0303030
NODE_301704_length_194_cov_63.252632	12	78	36	1	66	0.0151515
NODE_301704_length_194_cov_63.252632	12	78	37	1	66	0.0151515
NODE_301704_length_194_cov_63.252632	12	78	44	1	66	0.0151515
NODE_301704_length_194_cov_63.252632	12	78	45	8	66	0.1212121
NODE_301704_length_194_cov_63.252632	12	78	47	5	66	0.0757576
NODE_301704_length_194_cov_63.252632	12	78	53	8	66	0.1212121
NODE_301704_length_194_cov_63.252632	12	78	55	1	66	0.0151515
NODE_301704_length_194_cov_63.252632	12	78	56	3	66	0.0454545
NODE_301704_length_194_cov_63.252632	12	78	58	1	66	0.0151515
NODE_301704_length_194_cov_63.252632	51	112	44	1	61	0.0163934
NODE_301704_length_194_cov_63.252632	51	112	45	8	61	0.1311475
NODE_301704_length_194_cov_63.252632	51	112	47	5	61	0.0819672
NODE_301704_length_194_cov_63.252632	51	112	53	8	61	0.1311475
NODE_301704_length_194_cov_63.252632	51	112	55	1	61	0.0163934
NODE_301704_length_194_cov_63.252632	51	112	56	3	61	0.0491803
NODE_301704_length_194_cov_63.252632	51	112	58	2	61	0.0327869
NODE_301704_length_194_cov_63.252632	51	112	60	10	61	0.1639344
NODE_301704_length_194_cov_63.252632	51	112	62	2	61	0.0327869
NODE_301704_length_194_cov_63.252632	51	112	64	21	61	0.3442623
NODE_301704_length_194_cov_63.252632	51	99	44	1	48	0.0208333
NODE_301704_length_194_cov_63.252632	51	99	45	8	48	0.1666667
NODE_301704_length_194_cov_63.252632	51	99	47	5	48	0.1041667
NODE_301704_length_194_cov_63.252632	51	99	53	8	48	0.1666667
NODE_301704_length_194_cov_63.252632	51	99	55	1	48	0.0208333
NODE_301704_length_194_cov_63.252632	51	99	56	3	48	0.0625000
NODE_301704_length_194_cov_63.252632	51	99	58	2	48	0.0416667
NODE_301704_length_194_cov_63.252632	51	99	60	10	48	0.2083333
NODE_301704_length_194_cov_63.252632	51	99	62	1	48	0.0208333
NODE_301704_length_194_cov_63.252632	51	99	64	9	48	0.1875000
NODE_301704_length_194_cov_63.252632	51	112	44	1	61	0.0163934
NODE_301704_length_194_cov_63.252632	51	112	45	8	61	0.1311475
NODE_301704_length_194_cov_63.252632	51	112	47	5	61	0.0819672
NODE_301704_length_194_cov_63.252632	51	112	53	8	61	0.1311475
NODE_301704_length_194_cov_63.252632	51	112	55	1	61	0.0163934
NODE_301704_length_194_cov_63.252632	51	112	56	3	61	0.0491803
NODE_301704_length_194_cov_63.252632	51	112	58	2	61	0.0327869
NODE_301704_length_194_cov_63.252632	51	112	60	10	61	0.1639344
NODE_301704_length_194_cov_63.252632	51	112	62	2	61	0.0327869
NODE_301704_length_194_cov_63.252632	51	112	64	21	61	0.3442623
NODE_301708_length_194_cov_35.010526	95	162	0	23	67	0.3432836
NODE_301708_length_194_cov_35.010526	95	162	1	1	67	0.0149254
NODE_301708_length_194_cov_35.010526	95	162	2	43	67	0.6417910
NODE_301708_length_194_cov_35.010526	95	162	0	23	67	0.3432836
NODE_301708_length_194_cov_35.010526	95	162	1	1	67	0.0149254
NODE_301708_length_194_cov_35.010526	95	162	2	43	67	0.6417910
NODE_301708_length_194_cov_35.010526	135	184	0	45	49	0.9183673
NODE_301708_length_194_cov_35.010526	135	184	1	1	49	0.0204082
NODE_301708_length_194_cov_35.010526	135	184	2	3	49	0.0612245
NODE_301714_length_194_cov_9.978947	153	194	0	41	41	1.0000000
NODE_301727_length_193_cov_117.170213	21	93	44	1	72	0.0138889
NODE_301727_length_193_cov_117.170213	21	93	48	1	72	0.0138889
NODE_301727_length_193_cov_117.170213	21	93	51	1	72	0.0138889
NODE_301727_length_193_cov_117.170213	21	93	54	1	72	0.0138889
NODE_301727_length_193_cov_117.170213	21	93	60	1	72	0.0138889
NODE_301727_length_193_cov_117.170213	21	93	63	2	72	0.0277778
NODE_301727_length_193_cov_117.170213	21	93	64	2	72	0.0277778
NODE_301727_length_193_cov_117.170213	21	93	68	1	72	0.0138889
NODE_301727_length_193_cov_117.170213	21	93	70	2	72	0.0277778
NODE_301727_length_193_cov_117.170213	21	93	76	3	72	0.0416667
NODE_301727_length_193_cov_117.170213	21	93	80	2	72	0.0277778
NODE_301727_length_193_cov_117.170213	21	93	84	1	72	0.0138889
NODE_301727_length_193_cov_117.170213	21	93	86	1	72	0.0138889
NODE_301727_length_193_cov_117.170213	21	93	88	1	72	0.0138889
NODE_301727_length_193_cov_117.170213	21	93	94	1	72	0.0138889
NODE_301727_length_193_cov_117.170213	21	93	95	3	72	0.0416667
NODE_301727_length_193_cov_117.170213	21	93	99	2	72	0.0277778
NODE_301727_length_193_cov_117.170213	21	93	101	1	72	0.0138889
NODE_301727_length_193_cov_117.170213	21	93	107	1	72	0.0138889
NODE_301727_length_193_cov_117.170213	21	93	109	1	72	0.0138889
NODE_301727_length_193_cov_117.170213	21	93	111	2	72	0.0277778
NODE_301727_length_193_cov_117.170213	21	93	115	1	72	0.0138889
NODE_301727_length_193_cov_117.170213	21	93	118	3	72	0.0416667
NODE_301727_length_193_cov_117.170213	21	93	122	1	72	0.0138889
NODE_301727_length_193_cov_117.170213	21	93	126	3	72	0.0416667
NODE_301727_length_193_cov_117.170213	21	93	131	1	72	0.0138889
NODE_301727_length_193_cov_117.170213	21	93	132	1	72	0.0138889
NODE_301727_length_193_cov_117.170213	21	93	134	2	72	0.0277778
NODE_301727_length_193_cov_117.170213	21	93	136	7	72	0.0972222
NODE_301727_length_193_cov_117.170213	21	93	138	1	72	0.0138889
NODE_301727_length_193_cov_117.170213	21	93	140	3	72	0.0416667
NODE_301727_length_193_cov_117.170213	21	93	144	2	72	0.0277778
NODE_301727_length_193_cov_117.170213	21	93	148	2	72	0.0277778
NODE_301727_length_193_cov_117.170213	21	93	150	4	72	0.0555556
NODE_301727_length_193_cov_117.170213	21	93	152	8	72	0.1111111
NODE_301727_length_193_cov_117.170213	21	93	154	2	72	0.0277778
NODE_301727_length_193_cov_117.170213	41	121	94	1	80	0.0125000
NODE_301727_length_193_cov_117.170213	41	121	95	3	80	0.0375000
NODE_301727_length_193_cov_117.170213	41	121	99	2	80	0.0250000
NODE_301727_length_193_cov_117.170213	41	121	101	1	80	0.0125000
NODE_301727_length_193_cov_117.170213	41	121	107	1	80	0.0125000
NODE_301727_length_193_cov_117.170213	41	121	109	1	80	0.0125000
NODE_301727_length_193_cov_117.170213	41	121	111	2	80	0.0250000
NODE_301727_length_193_cov_117.170213	41	121	115	1	80	0.0125000
NODE_301727_length_193_cov_117.170213	41	121	118	3	80	0.0375000
NODE_301727_length_193_cov_117.170213	41	121	122	1	80	0.0125000
NODE_301727_length_193_cov_117.170213	41	121	126	3	80	0.0375000
NODE_301727_length_193_cov_117.170213	41	121	129	1	80	0.0125000
NODE_301727_length_193_cov_117.170213	41	121	131	1	80	0.0125000
NODE_301727_length_193_cov_117.170213	41	121	132	1	80	0.0125000
NODE_301727_length_193_cov_117.170213	41	121	134	4	80	0.0500000
NODE_301727_length_193_cov_117.170213	41	121	136	7	80	0.0875000
NODE_301727_length_193_cov_117.170213	41	121	138	1	80	0.0125000
NODE_301727_length_193_cov_117.170213	41	121	140	3	80	0.0375000
NODE_301727_length_193_cov_117.170213	41	121	144	2	80	0.0250000
NODE_301727_length_193_cov_117.170213	41	121	146	2	80	0.0250000
NODE_301727_length_193_cov_117.170213	41	121	148	2	80	0.0250000
NODE_301727_length_193_cov_117.170213	41	121	150	6	80	0.0750000
NODE_301727_length_193_cov_117.170213	41	121	152	12	80	0.1500000
NODE_301727_length_193_cov_117.170213	41	121	154	19	80	0.2375000
NODE_301729_length_193_cov_54.734043	108	188	29	1	80	0.0125000
NODE_301729_length_193_cov_54.734043	108	188	32	1	80	0.0125000
NODE_301729_length_193_cov_54.734043	108	188	35	1	80	0.0125000
NODE_301729_length_193_cov_54.734043	108	188	39	1	80	0.0125000
NODE_301729_length_193_cov_54.734043	108	188	51	7	80	0.0875000
NODE_301729_length_193_cov_54.734043	108	188	52	1	80	0.0125000
NODE_301729_length_193_cov_54.734043	108	188	56	3	80	0.0375000
NODE_301729_length_193_cov_54.734043	108	188	68	7	80	0.0875000
NODE_301729_length_193_cov_54.734043	108	188	69	1	80	0.0125000
NODE_301729_length_193_cov_54.734043	108	188	72	4	80	0.0500000
NODE_301729_length_193_cov_54.734043	108	188	76	13	80	0.1625000
NODE_301729_length_193_cov_54.734043	108	188	77	5	80	0.0625000
NODE_301729_length_193_cov_54.734043	108	188	79	3	80	0.0375000
NODE_301729_length_193_cov_54.734043	108	188	80	1	80	0.0125000
NODE_301729_length_193_cov_54.734043	108	188	81	7	80	0.0875000
NODE_301729_length_193_cov_54.734043	108	188	83	1	80	0.0125000
NODE_301729_length_193_cov_54.734043	108	188	85	5	80	0.0625000
NODE_301729_length_193_cov_54.734043	108	188	87	8	80	0.1000000
NODE_301729_length_193_cov_54.734043	108	188	88	2	80	0.0250000
NODE_301729_length_193_cov_54.734043	108	188	90	1	80	0.0125000
NODE_301729_length_193_cov_54.734043	108	188	92	7	80	0.0875000
NODE_301729_length_193_cov_54.734043	161	183	51	6	22	0.2727273
NODE_301729_length_193_cov_54.734043	161	183	52	1	22	0.0454545
NODE_301729_length_193_cov_54.734043	161	183	56	3	22	0.1363636
NODE_301729_length_193_cov_54.734043	161	183	68	7	22	0.3181818
NODE_301729_length_193_cov_54.734043	161	183	69	1	22	0.0454545
NODE_301729_length_193_cov_54.734043	161	183	72	4	22	0.1818182
NODE_301735_length_193_cov_30.638298	108	188	0	80	80	1.0000000
NODE_301735_length_193_cov_30.638298	161	183	0	22	22	1.0000000
NODE_301737_length_193_cov_29.968085	0	45	1	3	45	0.0666667
NODE_301737_length_193_cov_29.968085	0	45	5	2	45	0.0444444
NODE_301737_length_193_cov_29.968085	0	45	9	10	45	0.2222222
NODE_301737_length_193_cov_29.968085	0	45	10	1	45	0.0222222
NODE_301737_length_193_cov_29.968085	0	45	11	3	45	0.0666667
NODE_301737_length_193_cov_29.968085	0	45	20	1	45	0.0222222
NODE_301737_length_193_cov_29.968085	0	45	27	1	45	0.0222222
NODE_301737_length_193_cov_29.968085	0	45	28	6	45	0.1333333
NODE_301737_length_193_cov_29.968085	0	45	30	9	45	0.2000000
NODE_301737_length_193_cov_29.968085	0	45	32	2	45	0.0444444
NODE_301737_length_193_cov_29.968085	0	45	43	1	45	0.0222222
NODE_301737_length_193_cov_29.968085	0	45	44	3	45	0.0666667
NODE_301737_length_193_cov_29.968085	0	45	46	1	45	0.0222222
NODE_301737_length_193_cov_29.968085	0	45	48	2	45	0.0444444
NODE_301737_length_193_cov_29.968085	8	57	9	7	49	0.1428571
NODE_301737_length_193_cov_29.968085	8	57	10	1	49	0.0204082
NODE_301737_length_193_cov_29.968085	8	57	11	3	49	0.0612245
NODE_301737_length_193_cov_29.968085	8	57	20	1	49	0.0204082
NODE_301737_length_193_cov_29.968085	8	57	27	1	49	0.0204082
NODE_301737_length_193_cov_29.968085	8	57	28	6	49	0.1224490
NODE_301737_length_193_cov_29.968085	8	57	30	9	49	0.1836735
NODE_301737_length_193_cov_29.968085	8	57	32	2	49	0.0408163
NODE_301737_length_193_cov_29.968085	8	57	43	1	49	0.0204082
NODE_301737_length_193_cov_29.968085	8	57	44	3	49	0.0612245
NODE_301737_length_193_cov_29.968085	8	57	46	1	49	0.0204082
NODE_301737_length_193_cov_29.968085	8	57	48	2	49	0.0408163
NODE_301737_length_193_cov_29.968085	8	57	54	3	49	0.0612245
NODE_301737_length_193_cov_29.968085	8	57	61	1	49	0.0204082
NODE_301737_length_193_cov_29.968085	8	57	62	8	49	0.1632653
NODE_301737_length_193_cov_29.968085	30	98	30	6	68	0.0882353
NODE_301737_length_193_cov_29.968085	30	98	32	2	68	0.0294118
NODE_301737_length_193_cov_29.968085	30	98	43	1	68	0.0147059
NODE_301737_length_193_cov_29.968085	30	98	44	3	68	0.0441176
NODE_301737_length_193_cov_29.968085	30	98	46	1	68	0.0147059
NODE_301737_length_193_cov_29.968085	30	98	48	2	68	0.0294118
NODE_301737_length_193_cov_29.968085	30	98	54	3	68	0.0441176
NODE_301737_length_193_cov_29.968085	30	98	61	1	68	0.0147059
NODE_301737_length_193_cov_29.968085	30	98	62	9	68	0.1323529
NODE_301737_length_193_cov_29.968085	30	98	64	40	68	0.5882353
NODE_301737_length_193_cov_29.968085	30	98	30	6	68	0.0882353
NODE_301737_length_193_cov_29.968085	30	98	32	2	68	0.0294118
NODE_301737_length_193_cov_29.968085	30	98	43	1	68	0.0147059
NODE_301737_length_193_cov_29.968085	30	98	44	3	68	0.0441176
NODE_301737_length_193_cov_29.968085	30	98	46	1	68	0.0147059
NODE_301737_length_193_cov_29.968085	30	98	48	2	68	0.0294118
NODE_301737_length_193_cov_29.968085	30	98	54	3	68	0.0441176
NODE_301737_length_193_cov_29.968085	30	98	61	1	68	0.0147059
NODE_301737_length_193_cov_29.968085	30	98	62	9	68	0.1323529
NODE_301737_length_193_cov_29.968085	30	98	64	40	68	0.5882353
NODE_301737_length_193_cov_29.968085	30	98	30	6	68	0.0882353
NODE_301737_length_193_cov_29.968085	30	98	32	2	68	0.0294118
NODE_301737_length_193_cov_29.968085	30	98	43	1	68	0.0147059
NODE_301737_length_193_cov_29.968085	30	98	44	3	68	0.0441176
NODE_301737_length_193_cov_29.968085	30	98	46	1	68	0.0147059
NODE_301737_length_193_cov_29.968085	30	98	48	2	68	0.0294118
NODE_301737_length_193_cov_29.968085	30	98	54	3	68	0.0441176
NODE_301737_length_193_cov_29.968085	30	98	61	1	68	0.0147059
NODE_301737_length_193_cov_29.968085	30	98	62	9	68	0.1323529
NODE_301737_length_193_cov_29.968085	30	98	64	40	68	0.5882353
NODE_301737_length_193_cov_29.968085	146	188	6	17	42	0.4047619
NODE_301737_length_193_cov_29.968085	146	188	12	1	42	0.0238095
NODE_301737_length_193_cov_29.968085	146	188	14	1	42	0.0238095
NODE_301737_length_193_cov_29.968085	146	188	15	1	42	0.0238095
NODE_301737_length_193_cov_29.968085	146	188	24	2	42	0.0476190
NODE_301737_length_193_cov_29.968085	146	188	25	1	42	0.0238095
NODE_301737_length_193_cov_29.968085	146	188	26	13	42	0.3095238
NODE_301737_length_193_cov_29.968085	146	188	32	2	42	0.0476190
NODE_301737_length_193_cov_29.968085	146	188	34	1	42	0.0238095
NODE_301737_length_193_cov_29.968085	146	188	35	3	42	0.0714286
NODE_301776_length_192_cov_160.258065	0	76	14	5	76	0.0657895
NODE_301776_length_192_cov_160.258065	0	76	19	1	76	0.0131579
NODE_301776_length_192_cov_160.258065	0	76	22	1	76	0.0131579
NODE_301776_length_192_cov_160.258065	0	76	27	1	76	0.0131579
NODE_301776_length_192_cov_160.258065	0	76	29	1	76	0.0131579
NODE_301776_length_192_cov_160.258065	0	76	75	1	76	0.0131579
NODE_301776_length_192_cov_160.258065	0	76	83	1	76	0.0131579
NODE_301776_length_192_cov_160.258065	0	76	91	1	76	0.0131579
NODE_301776_length_192_cov_160.258065	0	76	103	2	76	0.0263158
NODE_301776_length_192_cov_160.258065	0	76	106	1	76	0.0131579
NODE_301776_length_192_cov_160.258065	0	76	109	1	76	0.0131579
NODE_301776_length_192_cov_160.258065	0	76	113	1	76	0.0131579
NODE_301776_length_192_cov_160.258065	0	76	116	1	76	0.0131579
NODE_301776_length_192_cov_160.258065	0	76	120	1	76	0.0131579
NODE_301776_length_192_cov_160.258065	0	76	122	1	76	0.0131579
NODE_301776_length_192_cov_160.258065	0	76	125	1	76	0.0131579
NODE_301776_length_192_cov_160.258065	0	76	132	1	76	0.0131579
NODE_301776_length_192_cov_160.258065	0	76	156	1	76	0.0131579
NODE_301776_length_192_cov_160.258065	0	76	159	1	76	0.0131579
NODE_301776_length_192_cov_160.258065	0	76	164	1	76	0.0131579
NODE_301776_length_192_cov_160.258065	0	76	177	3	76	0.0394737
NODE_301776_length_192_cov_160.258065	0	76	191	2	76	0.0263158
NODE_301776_length_192_cov_160.258065	0	76	195	1	76	0.0131579
NODE_301776_length_192_cov_160.258065	0	76	205	1	76	0.0131579
NODE_301776_length_192_cov_160.258065	0	76	207	2	76	0.0263158
NODE_301776_length_192_cov_160.258065	0	76	213	1	76	0.0131579
NODE_301776_length_192_cov_160.258065	0	76	215	1	76	0.0131579
NODE_301776_length_192_cov_160.258065	0	76	219	1	76	0.0131579
NODE_301776_length_192_cov_160.258065	0	76	223	1	76	0.0131579
NODE_301776_length_192_cov_160.258065	0	76	230	1	76	0.0131579
NODE_301776_length_192_cov_160.258065	0	76	238	1	76	0.0131579
NODE_301776_length_192_cov_160.258065	0	76	251	3	76	0.0394737
NODE_301776_length_192_cov_160.258065	0	76	256	1	76	0.0131579
NODE_301776_length_192_cov_160.258065	0	76	271	1	76	0.0131579
NODE_301776_length_192_cov_160.258065	0	76	273	1	76	0.0131579
NODE_301776_length_192_cov_160.258065	0	76	301	1	76	0.0131579
NODE_301776_length_192_cov_160.258065	0	76	308	1	76	0.0131579
NODE_301776_length_192_cov_160.258065	0	76	311	1	76	0.0131579
NODE_301776_length_192_cov_160.258065	0	76	313	2	76	0.0263158
NODE_301776_length_192_cov_160.258065	0	76	319	1	76	0.0131579
NODE_301776_length_192_cov_160.258065	0	76	324	1	76	0.0131579
NODE_301776_length_192_cov_160.258065	0	76	333	1	76	0.0131579
NODE_301776_length_192_cov_160.258065	0	76	334	1	76	0.0131579
NODE_301776_length_192_cov_160.258065	0	76	340	2	76	0.0263158
NODE_301776_length_192_cov_160.258065	0	76	342	1	76	0.0131579
NODE_301776_length_192_cov_160.258065	0	76	349	1	76	0.0131579
NODE_301776_length_192_cov_160.258065	0	76	364	1	76	0.0131579
NODE_301776_length_192_cov_160.258065	0	76	365	1	76	0.0131579
NODE_301776_length_192_cov_160.258065	0	76	391	1	76	0.0131579
NODE_301776_length_192_cov_160.258065	0	76	396	1	76	0.0131579
NODE_301776_length_192_cov_160.258065	0	76	413	1	76	0.0131579
NODE_301776_length_192_cov_160.258065	0	76	417	1	76	0.0131579
NODE_301776_length_192_cov_160.258065	0	76	421	1	76	0.0131579
NODE_301776_length_192_cov_160.258065	0	76	426	1	76	0.0131579
NODE_301776_length_192_cov_160.258065	0	76	432	1	76	0.0131579
NODE_301776_length_192_cov_160.258065	0	76	440	1	76	0.0131579
NODE_301776_length_192_cov_160.258065	0	76	452	1	76	0.0131579
NODE_301776_length_192_cov_160.258065	0	76	462	1	76	0.0131579
NODE_301776_length_192_cov_160.258065	0	76	486	1	76	0.0131579
NODE_301776_length_192_cov_160.258065	0	76	490	1	76	0.0131579
NODE_301776_length_192_cov_160.258065	0	76	504	1	76	0.0131579
NODE_301776_length_192_cov_160.258065	0	76	506	1	76	0.0131579
NODE_301776_length_192_cov_160.258065	0	76	512	1	76	0.0131579
NODE_301825_length_191_cov_92.913043	81	144	0	63	63	1.0000000
NODE_301855_length_190_cov_112.285714	8	91	0	83	83	1.0000000
NODE_301859_length_190_cov_41.373626	92	172	2	12	80	0.1500000
NODE_301859_length_190_cov_41.373626	92	172	4	5	80	0.0625000
NODE_301859_length_190_cov_41.373626	92	172	6	2	80	0.0250000
NODE_301859_length_190_cov_41.373626	92	172	8	3	80	0.0375000
NODE_301859_length_190_cov_41.373626	92	172	10	1	80	0.0125000
NODE_301859_length_190_cov_41.373626	92	172	12	3	80	0.0375000
NODE_301859_length_190_cov_41.373626	92	172	14	3	80	0.0375000
NODE_301859_length_190_cov_41.373626	92	172	18	1	80	0.0125000
NODE_301859_length_190_cov_41.373626	92	172	22	1	80	0.0125000
NODE_301859_length_190_cov_41.373626	92	172	24	1	80	0.0125000
NODE_301859_length_190_cov_41.373626	92	172	26	1	80	0.0125000
NODE_301859_length_190_cov_41.373626	92	172	28	11	80	0.1375000
NODE_301859_length_190_cov_41.373626	92	172	30	18	80	0.2250000
NODE_301859_length_190_cov_41.373626	92	172	32	18	80	0.2250000
NODE_301859_length_190_cov_41.373626	145	190	0	14	45	0.3111111
NODE_301859_length_190_cov_41.373626	145	190	1	1	45	0.0222222
NODE_301859_length_190_cov_41.373626	145	190	2	15	45	0.3333333
NODE_301859_length_190_cov_41.373626	145	190	4	5	45	0.1111111
NODE_301859_length_190_cov_41.373626	145	190	6	2	45	0.0444444
NODE_301859_length_190_cov_41.373626	145	190	8	3	45	0.0666667
NODE_301859_length_190_cov_41.373626	145	190	10	1	45	0.0222222
NODE_301859_length_190_cov_41.373626	145	190	12	3	45	0.0666667
NODE_301859_length_190_cov_41.373626	145	190	14	1	45	0.0222222
NODE_301880_length_189_cov_234.500000	19	88	0	69	69	1.0000000
NODE_301882_length_189_cov_192.211111	134	186	0	49	52	0.9423077
NODE_301882_length_189_cov_192.211111	134	186	2	3	52	0.0576923
NODE_301885_length_189_cov_70.600000	19	88	0	50	69	0.7246377
NODE_301885_length_189_cov_70.600000	19	88	2	19	69	0.2753623
NODE_301885_length_189_cov_70.600000	72	156	2	84	84	1.0000000
NODE_301886_length_189_cov_63.455556	70	150	102	6	80	0.0750000
NODE_301886_length_189_cov_63.455556	70	150	103	1	80	0.0125000
NODE_301886_length_189_cov_63.455556	70	150	113	1	80	0.0125000
NODE_301886_length_189_cov_63.455556	70	150	114	11	80	0.1375000
NODE_301886_length_189_cov_63.455556	70	150	116	3	80	0.0375000
NODE_301886_length_189_cov_63.455556	70	150	117	1	80	0.0125000
NODE_301886_length_189_cov_63.455556	70	150	119	2	80	0.0250000
NODE_301886_length_189_cov_63.455556	70	150	120	2	80	0.0250000
NODE_301886_length_189_cov_63.455556	70	150	122	3	80	0.0375000
NODE_301886_length_189_cov_63.455556	70	150	123	2	80	0.0250000
NODE_301886_length_189_cov_63.455556	70	150	124	6	80	0.0750000
NODE_301886_length_189_cov_63.455556	70	150	126	1	80	0.0125000
NODE_301886_length_189_cov_63.455556	70	150	128	1	80	0.0125000
NODE_301886_length_189_cov_63.455556	70	150	130	2	80	0.0250000
NODE_301886_length_189_cov_63.455556	70	150	133	3	80	0.0375000
NODE_301886_length_189_cov_63.455556	70	150	134	4	80	0.0500000
NODE_301886_length_189_cov_63.455556	70	150	135	1	80	0.0125000
NODE_301886_length_189_cov_63.455556	70	150	137	5	80	0.0625000
NODE_301886_length_189_cov_63.455556	70	150	139	25	80	0.3125000
NODE_301886_length_189_cov_63.455556	70	141	103	1	71	0.0140845
NODE_301886_length_189_cov_63.455556	70	141	114	9	71	0.1267606
NODE_301886_length_189_cov_63.455556	70	141	116	3	71	0.0422535
NODE_301886_length_189_cov_63.455556	70	141	117	1	71	0.0140845
NODE_301886_length_189_cov_63.455556	70	141	119	2	71	0.0281690
NODE_301886_length_189_cov_63.455556	70	141	120	2	71	0.0281690
NODE_301886_length_189_cov_63.455556	70	141	122	3	71	0.0422535
NODE_301886_length_189_cov_63.455556	70	141	123	2	71	0.0281690
NODE_301886_length_189_cov_63.455556	70	141	124	6	71	0.0845070
NODE_301886_length_189_cov_63.455556	70	141	126	1	71	0.0140845
NODE_301886_length_189_cov_63.455556	70	141	128	1	71	0.0140845
NODE_301886_length_189_cov_63.455556	70	141	130	2	71	0.0281690
NODE_301886_length_189_cov_63.455556	70	141	133	3	71	0.0422535
NODE_301886_length_189_cov_63.455556	70	141	134	4	71	0.0563380
NODE_301886_length_189_cov_63.455556	70	141	135	1	71	0.0140845
NODE_301886_length_189_cov_63.455556	70	141	137	5	71	0.0704225
NODE_301886_length_189_cov_63.455556	70	141	139	25	71	0.3521127
NODE_301891_length_189_cov_43.600000	0	73	9	2	73	0.0273973
NODE_301891_length_189_cov_43.600000	0	73	13	1	73	0.0136986
NODE_301891_length_189_cov_43.600000	0	73	18	1	73	0.0136986
NODE_301891_length_189_cov_43.600000	0	73	20	1	73	0.0136986
NODE_301891_length_189_cov_43.600000	0	73	23	2	73	0.0273973
NODE_301891_length_189_cov_43.600000	0	73	27	1	73	0.0136986
NODE_301891_length_189_cov_43.600000	0	73	28	3	73	0.0410959
NODE_301891_length_189_cov_43.600000	0	73	32	1	73	0.0136986
NODE_301891_length_189_cov_43.600000	0	73	36	2	73	0.0273973
NODE_301891_length_189_cov_43.600000	0	73	37	1	73	0.0136986
NODE_301891_length_189_cov_43.600000	0	73	52	1	73	0.0136986
NODE_301891_length_189_cov_43.600000	0	73	55	1	73	0.0136986
NODE_301891_length_189_cov_43.600000	0	73	59	1	73	0.0136986
NODE_301891_length_189_cov_43.600000	0	73	63	1	73	0.0136986
NODE_301891_length_189_cov_43.600000	0	73	64	1	73	0.0136986
NODE_301891_length_189_cov_43.600000	0	73	76	1	73	0.0136986
NODE_301891_length_189_cov_43.600000	0	73	79	1	73	0.0136986
NODE_301891_length_189_cov_43.600000	0	73	84	1	73	0.0136986
NODE_301891_length_189_cov_43.600000	0	73	88	2	73	0.0273973
NODE_301891_length_189_cov_43.600000	0	73	92	2	73	0.0273973
NODE_301891_length_189_cov_43.600000	0	73	96	1	73	0.0136986
NODE_301891_length_189_cov_43.600000	0	73	101	1	73	0.0136986
NODE_301891_length_189_cov_43.600000	0	73	103	1	73	0.0136986
NODE_301891_length_189_cov_43.600000	0	73	107	1	73	0.0136986
NODE_301891_length_189_cov_43.600000	0	73	109	2	73	0.0273973
NODE_301891_length_189_cov_43.600000	0	73	110	2	73	0.0273973
NODE_301891_length_189_cov_43.600000	0	73	124	4	73	0.0547945
NODE_301891_length_189_cov_43.600000	0	73	126	2	73	0.0273973
NODE_301891_length_189_cov_43.600000	0	73	128	2	73	0.0273973
NODE_301891_length_189_cov_43.600000	0	73	132	1	73	0.0136986
NODE_301891_length_189_cov_43.600000	0	73	136	2	73	0.0273973
NODE_301891_length_189_cov_43.600000	0	73	137	1	73	0.0136986
NODE_301891_length_189_cov_43.600000	0	73	139	1	73	0.0136986
NODE_301891_length_189_cov_43.600000	0	73	142	1	73	0.0136986
NODE_301891_length_189_cov_43.600000	0	73	144	3	73	0.0410959
NODE_301891_length_189_cov_43.600000	0	73	146	3	73	0.0410959
NODE_301891_length_189_cov_43.600000	0	73	148	8	73	0.1095890
NODE_301891_length_189_cov_43.600000	0	73	150	6	73	0.0821918
NODE_301891_length_189_cov_43.600000	0	73	152	4	73	0.0547945
NODE_301940_length_188_cov_2021.561798	108	188	41	1	80	0.0125000
NODE_301940_length_188_cov_2021.561798	108	188	59	1	80	0.0125000
NODE_301940_length_188_cov_2021.561798	108	188	73	1	80	0.0125000
NODE_301940_length_188_cov_2021.561798	108	188	105	1	80	0.0125000
NODE_301940_length_188_cov_2021.561798	108	188	142	1	80	0.0125000
NODE_301940_length_188_cov_2021.561798	108	188	153	1	80	0.0125000
NODE_301940_length_188_cov_2021.561798	108	188	211	1	80	0.0125000
NODE_301940_length_188_cov_2021.561798	108	188	220	2	80	0.0250000
NODE_301940_length_188_cov_2021.561798	108	188	232	1	80	0.0125000
NODE_301940_length_188_cov_2021.561798	108	188	249	1	80	0.0125000
NODE_301940_length_188_cov_2021.561798	108	188	277	1	80	0.0125000
NODE_301940_length_188_cov_2021.561798	108	188	312	1	80	0.0125000
NODE_301940_length_188_cov_2021.561798	108	188	324	1	80	0.0125000
NODE_301940_length_188_cov_2021.561798	108	188	348	1	80	0.0125000
NODE_301940_length_188_cov_2021.561798	108	188	355	1	80	0.0125000
NODE_301940_length_188_cov_2021.561798	108	188	363	1	80	0.0125000
NODE_301940_length_188_cov_2021.561798	108	188	367	1	80	0.0125000
NODE_301940_length_188_cov_2021.561798	108	188	370	1	80	0.0125000
NODE_301940_length_188_cov_2021.561798	108	188	371	1	80	0.0125000
NODE_301940_length_188_cov_2021.561798	108	188	377	2	80	0.0250000
NODE_301940_length_188_cov_2021.561798	108	188	401	1	80	0.0125000
NODE_301940_length_188_cov_2021.561798	108	188	406	1	80	0.0125000
NODE_301940_length_188_cov_2021.561798	108	188	436	1	80	0.0125000
NODE_301940_length_188_cov_2021.561798	108	188	446	1	80	0.0125000
NODE_301940_length_188_cov_2021.561798	108	188	462	1	80	0.0125000
NODE_301940_length_188_cov_2021.561798	108	188	476	1	80	0.0125000
NODE_301940_length_188_cov_2021.561798	108	188	502	1	80	0.0125000
NODE_301940_length_188_cov_2021.561798	108	188	510	1	80	0.0125000
NODE_301940_length_188_cov_2021.561798	108	188	515	1	80	0.0125000
NODE_301940_length_188_cov_2021.561798	108	188	516	2	80	0.0250000
NODE_301940_length_188_cov_2021.561798	108	188	528	2	80	0.0250000
NODE_301940_length_188_cov_2021.561798	108	188	531	1	80	0.0125000
NODE_301940_length_188_cov_2021.561798	108	188	539	1	80	0.0125000
NODE_301940_length_188_cov_2021.561798	108	188	543	2	80	0.0250000
NODE_301940_length_188_cov_2021.561798	108	188	558	1	80	0.0125000
NODE_301940_length_188_cov_2021.561798	108	188	563	1	80	0.0125000
NODE_301940_length_188_cov_2021.561798	108	188	571	1	80	0.0125000
NODE_301940_length_188_cov_2021.561798	108	188	574	1	80	0.0125000
NODE_301940_length_188_cov_2021.561798	108	188	576	1	80	0.0125000
NODE_301940_length_188_cov_2021.561798	108	188	584	1	80	0.0125000
NODE_301940_length_188_cov_2021.561798	108	188	587	1	80	0.0125000
NODE_301940_length_188_cov_2021.561798	108	188	597	1	80	0.0125000
NODE_301940_length_188_cov_2021.561798	108	188	600	1	80	0.0125000
NODE_301940_length_188_cov_2021.561798	108	188	603	1	80	0.0125000
NODE_301940_length_188_cov_2021.561798	108	188	608	1	80	0.0125000
NODE_301940_length_188_cov_2021.561798	108	188	612	1	80	0.0125000
NODE_301940_length_188_cov_2021.561798	108	188	614	1	80	0.0125000
NODE_301940_length_188_cov_2021.561798	108	188	622	1	80	0.0125000
NODE_301940_length_188_cov_2021.561798	108	188	623	1	80	0.0125000
NODE_301940_length_188_cov_2021.561798	108	188	626	1	80	0.0125000
NODE_301940_length_188_cov_2021.561798	108	188	627	1	80	0.0125000
NODE_301940_length_188_cov_2021.561798	108	188	628	1	80	0.0125000
NODE_301940_length_188_cov_2021.561798	108	188	632	1	80	0.0125000
NODE_301940_length_188_cov_2021.561798	108	188	634	2	80	0.0250000
NODE_301940_length_188_cov_2021.561798	108	188	636	1	80	0.0125000
NODE_301940_length_188_cov_2021.561798	108	188	639	2	80	0.0250000
NODE_301940_length_188_cov_2021.561798	108	188	642	1	80	0.0125000
NODE_301940_length_188_cov_2021.561798	108	188	646	1	80	0.0125000
NODE_301940_length_188_cov_2021.561798	108	188	647	1	80	0.0125000
NODE_301940_length_188_cov_2021.561798	108	188	651	1	80	0.0125000
NODE_301940_length_188_cov_2021.561798	108	188	653	1	80	0.0125000
NODE_301940_length_188_cov_2021.561798	108	188	656	1	80	0.0125000
NODE_301940_length_188_cov_2021.561798	108	188	658	1	80	0.0125000
NODE_301940_length_188_cov_2021.561798	108	188	666	2	80	0.0250000
NODE_301940_length_188_cov_2021.561798	108	188	668	1	80	0.0125000
NODE_301940_length_188_cov_2021.561798	108	188	670	4	80	0.0500000
NODE_301940_length_188_cov_2021.561798	108	188	672	3	80	0.0375000
NODE_301940_length_188_cov_2021.561798	161	183	153	1	22	0.0454545
NODE_301940_length_188_cov_2021.561798	161	183	211	1	22	0.0454545
NODE_301940_length_188_cov_2021.561798	161	183	220	2	22	0.0909091
NODE_301940_length_188_cov_2021.561798	161	183	232	1	22	0.0454545
NODE_301940_length_188_cov_2021.561798	161	183	249	1	22	0.0454545
NODE_301940_length_188_cov_2021.561798	161	183	277	1	22	0.0454545
NODE_301940_length_188_cov_2021.561798	161	183	312	1	22	0.0454545
NODE_301940_length_188_cov_2021.561798	161	183	324	1	22	0.0454545
NODE_301940_length_188_cov_2021.561798	161	183	348	1	22	0.0454545
NODE_301940_length_188_cov_2021.561798	161	183	355	1	22	0.0454545
NODE_301940_length_188_cov_2021.561798	161	183	363	1	22	0.0454545
NODE_301940_length_188_cov_2021.561798	161	183	367	1	22	0.0454545
NODE_301940_length_188_cov_2021.561798	161	183	370	1	22	0.0454545
NODE_301940_length_188_cov_2021.561798	161	183	371	1	22	0.0454545
NODE_301940_length_188_cov_2021.561798	161	183	377	2	22	0.0909091
NODE_301940_length_188_cov_2021.561798	161	183	401	1	22	0.0454545
NODE_301940_length_188_cov_2021.561798	161	183	406	1	22	0.0454545
NODE_301940_length_188_cov_2021.561798	161	183	436	1	22	0.0454545
NODE_301940_length_188_cov_2021.561798	161	183	446	1	22	0.0454545
NODE_301940_length_188_cov_2021.561798	161	183	462	1	22	0.0454545
NODE_301952_length_188_cov_37.988764	0	50	2	11	50	0.2200000
NODE_301952_length_188_cov_37.988764	0	50	4	24	50	0.4800000
NODE_301952_length_188_cov_37.988764	0	50	7	1	50	0.0200000
NODE_301952_length_188_cov_37.988764	0	50	8	14	50	0.2800000
NODE_301980_length_187_cov_71.170455	124	155	2	6	31	0.1935484
NODE_301980_length_187_cov_71.170455	124	155	4	13	31	0.4193548
NODE_301980_length_187_cov_71.170455	124	155	6	3	31	0.0967742
NODE_301980_length_187_cov_71.170455	124	155	8	9	31	0.2903226
NODE_301981_length_187_cov_56.000000	72	136	88	1	64	0.0156250
NODE_301981_length_187_cov_56.000000	72	136	90	4	64	0.0625000
NODE_301981_length_187_cov_56.000000	72	136	91	2	64	0.0312500
NODE_301981_length_187_cov_56.000000	72	136	92	1	64	0.0156250
NODE_301981_length_187_cov_56.000000	72	136	103	1	64	0.0156250
NODE_301981_length_187_cov_56.000000	72	136	105	1	64	0.0156250
NODE_301981_length_187_cov_56.000000	72	136	107	1	64	0.0156250
NODE_301981_length_187_cov_56.000000	72	136	109	1	64	0.0156250
NODE_301981_length_187_cov_56.000000	72	136	115	2	64	0.0312500
NODE_301981_length_187_cov_56.000000	72	136	121	2	64	0.0312500
NODE_301981_length_187_cov_56.000000	72	136	123	2	64	0.0312500
NODE_301981_length_187_cov_56.000000	72	136	127	3	64	0.0468750
NODE_301981_length_187_cov_56.000000	72	136	130	1	64	0.0156250
NODE_301981_length_187_cov_56.000000	72	136	131	5	64	0.0781250
NODE_301981_length_187_cov_56.000000	72	136	133	1	64	0.0156250
NODE_301981_length_187_cov_56.000000	72	136	135	9	64	0.1406250
NODE_301981_length_187_cov_56.000000	72	136	137	27	64	0.4218750
NODE_301981_length_187_cov_56.000000	72	136	88	1	64	0.0156250
NODE_301981_length_187_cov_56.000000	72	136	90	4	64	0.0625000
NODE_301981_length_187_cov_56.000000	72	136	91	2	64	0.0312500
NODE_301981_length_187_cov_56.000000	72	136	92	1	64	0.0156250
NODE_301981_length_187_cov_56.000000	72	136	103	1	64	0.0156250
NODE_301981_length_187_cov_56.000000	72	136	105	1	64	0.0156250
NODE_301981_length_187_cov_56.000000	72	136	107	1	64	0.0156250
NODE_301981_length_187_cov_56.000000	72	136	109	1	64	0.0156250
NODE_301981_length_187_cov_56.000000	72	136	115	2	64	0.0312500
NODE_301981_length_187_cov_56.000000	72	136	121	2	64	0.0312500
NODE_301981_length_187_cov_56.000000	72	136	123	2	64	0.0312500
NODE_301981_length_187_cov_56.000000	72	136	127	3	64	0.0468750
NODE_301981_length_187_cov_56.000000	72	136	130	1	64	0.0156250
NODE_301981_length_187_cov_56.000000	72	136	131	5	64	0.0781250
NODE_301981_length_187_cov_56.000000	72	136	133	1	64	0.0156250
NODE_301981_length_187_cov_56.000000	72	136	135	9	64	0.1406250
NODE_301981_length_187_cov_56.000000	72	136	137	27	64	0.4218750
NODE_301981_length_187_cov_56.000000	109	175	24	1	66	0.0151515
NODE_301981_length_187_cov_56.000000	109	175	25	2	66	0.0303030
NODE_301981_length_187_cov_56.000000	109	175	26	4	66	0.0606061
NODE_301981_length_187_cov_56.000000	109	175	30	2	66	0.0303030
NODE_301981_length_187_cov_56.000000	109	175	32	8	66	0.1212121
NODE_301981_length_187_cov_56.000000	109	175	33	3	66	0.0454545
NODE_301981_length_187_cov_56.000000	109	175	34	3	66	0.0454545
NODE_301981_length_187_cov_56.000000	109	175	38	1	66	0.0151515
NODE_301981_length_187_cov_56.000000	109	175	45	1	66	0.0151515
NODE_301981_length_187_cov_56.000000	109	175	48	1	66	0.0151515
NODE_301981_length_187_cov_56.000000	109	175	53	1	66	0.0151515
NODE_301981_length_187_cov_56.000000	109	175	54	1	66	0.0151515
NODE_301981_length_187_cov_56.000000	109	175	64	2	66	0.0303030
NODE_301981_length_187_cov_56.000000	109	175	75	1	66	0.0151515
NODE_301981_length_187_cov_56.000000	109	175	76	3	66	0.0454545
NODE_301981_length_187_cov_56.000000	109	175	78	2	66	0.0303030
NODE_301981_length_187_cov_56.000000	109	175	84	1	66	0.0151515
NODE_301981_length_187_cov_56.000000	109	175	86	1	66	0.0151515
NODE_301981_length_187_cov_56.000000	109	175	88	2	66	0.0303030
NODE_301981_length_187_cov_56.000000	109	175	90	4	66	0.0606061
NODE_301981_length_187_cov_56.000000	109	175	91	2	66	0.0303030
NODE_301981_length_187_cov_56.000000	109	175	92	1	66	0.0151515
NODE_301981_length_187_cov_56.000000	109	175	103	1	66	0.0151515
NODE_301981_length_187_cov_56.000000	109	175	105	1	66	0.0151515
NODE_301981_length_187_cov_56.000000	109	175	107	1	66	0.0151515
NODE_301981_length_187_cov_56.000000	109	175	109	1	66	0.0151515
NODE_301981_length_187_cov_56.000000	109	175	115	2	66	0.0303030
NODE_301981_length_187_cov_56.000000	109	175	121	2	66	0.0303030
NODE_301981_length_187_cov_56.000000	109	175	123	1	66	0.0151515
NODE_301981_length_187_cov_56.000000	109	175	127	3	66	0.0454545
NODE_301981_length_187_cov_56.000000	109	175	131	1	66	0.0151515
NODE_301981_length_187_cov_56.000000	109	175	133	1	66	0.0151515
NODE_301981_length_187_cov_56.000000	109	175	135	5	66	0.0757576
NODE_301981_length_187_cov_56.000000	109	180	22	2	71	0.0281690
NODE_301981_length_187_cov_56.000000	109	180	23	2	71	0.0281690
NODE_301981_length_187_cov_56.000000	109	180	24	2	71	0.0281690
NODE_301981_length_187_cov_56.000000	109	180	25	2	71	0.0281690
NODE_301981_length_187_cov_56.000000	109	180	26	4	71	0.0563380
NODE_301981_length_187_cov_56.000000	109	180	30	2	71	0.0281690
NODE_301981_length_187_cov_56.000000	109	180	32	8	71	0.1126761
NODE_301981_length_187_cov_56.000000	109	180	33	3	71	0.0422535
NODE_301981_length_187_cov_56.000000	109	180	34	3	71	0.0422535
NODE_301981_length_187_cov_56.000000	109	180	38	1	71	0.0140845
NODE_301981_length_187_cov_56.000000	109	180	45	1	71	0.0140845
NODE_301981_length_187_cov_56.000000	109	180	48	1	71	0.0140845
NODE_301981_length_187_cov_56.000000	109	180	53	1	71	0.0140845
NODE_301981_length_187_cov_56.000000	109	180	54	1	71	0.0140845
NODE_301981_length_187_cov_56.000000	109	180	64	2	71	0.0281690
NODE_301981_length_187_cov_56.000000	109	180	75	1	71	0.0140845
NODE_301981_length_187_cov_56.000000	109	180	76	3	71	0.0422535
NODE_301981_length_187_cov_56.000000	109	180	78	2	71	0.0281690
NODE_301981_length_187_cov_56.000000	109	180	84	1	71	0.0140845
NODE_301981_length_187_cov_56.000000	109	180	86	1	71	0.0140845
NODE_301981_length_187_cov_56.000000	109	180	88	2	71	0.0281690
NODE_301981_length_187_cov_56.000000	109	180	90	4	71	0.0563380
NODE_301981_length_187_cov_56.000000	109	180	91	2	71	0.0281690
NODE_301981_length_187_cov_56.000000	109	180	92	1	71	0.0140845
NODE_301981_length_187_cov_56.000000	109	180	103	1	71	0.0140845
NODE_301981_length_187_cov_56.000000	109	180	105	1	71	0.0140845
NODE_301981_length_187_cov_56.000000	109	180	107	1	71	0.0140845
NODE_301981_length_187_cov_56.000000	109	180	109	1	71	0.0140845
NODE_301981_length_187_cov_56.000000	109	180	115	2	71	0.0281690
NODE_301981_length_187_cov_56.000000	109	180	121	2	71	0.0281690
NODE_301981_length_187_cov_56.000000	109	180	123	1	71	0.0140845
NODE_301981_length_187_cov_56.000000	109	180	127	3	71	0.0422535
NODE_301981_length_187_cov_56.000000	109	180	131	1	71	0.0140845
NODE_301981_length_187_cov_56.000000	109	180	133	1	71	0.0140845
NODE_301981_length_187_cov_56.000000	109	180	135	5	71	0.0704225
NODE_301986_length_187_cov_37.397727	4	57	4	20	53	0.3773585
NODE_301986_length_187_cov_37.397727	4	57	6	1	53	0.0188679
NODE_301986_length_187_cov_37.397727	4	57	17	1	53	0.0188679
NODE_301986_length_187_cov_37.397727	4	57	18	1	53	0.0188679
NODE_301986_length_187_cov_37.397727	4	57	22	3	53	0.0566038
NODE_301986_length_187_cov_37.397727	4	57	25	3	53	0.0566038
NODE_301986_length_187_cov_37.397727	4	57	42	1	53	0.0188679
NODE_301986_length_187_cov_37.397727	4	57	46	3	53	0.0566038
NODE_301986_length_187_cov_37.397727	4	57	57	1	53	0.0188679
NODE_301986_length_187_cov_37.397727	4	57	58	4	53	0.0754717
NODE_301986_length_187_cov_37.397727	4	57	60	1	53	0.0188679
NODE_301986_length_187_cov_37.397727	4	57	62	1	53	0.0188679
NODE_301986_length_187_cov_37.397727	4	57	65	1	53	0.0188679
NODE_301986_length_187_cov_37.397727	4	57	67	1	53	0.0188679
NODE_301986_length_187_cov_37.397727	4	57	70	1	53	0.0188679
NODE_301986_length_187_cov_37.397727	4	57	72	2	53	0.0377358
NODE_301986_length_187_cov_37.397727	4	57	76	2	53	0.0377358
NODE_301986_length_187_cov_37.397727	4	57	82	4	53	0.0754717
NODE_301986_length_187_cov_37.397727	4	57	84	2	53	0.0377358
NODE_301986_length_187_cov_37.397727	12	78	4	12	66	0.1818182
NODE_301986_length_187_cov_37.397727	12	78	6	1	66	0.0151515
NODE_301986_length_187_cov_37.397727	12	78	17	1	66	0.0151515
NODE_301986_length_187_cov_37.397727	12	78	18	1	66	0.0151515
NODE_301986_length_187_cov_37.397727	12	78	22	3	66	0.0454545
NODE_301986_length_187_cov_37.397727	12	78	25	3	66	0.0454545
NODE_301986_length_187_cov_37.397727	12	78	42	1	66	0.0151515
NODE_301986_length_187_cov_37.397727	12	78	46	3	66	0.0454545
NODE_301986_length_187_cov_37.397727	12	78	57	1	66	0.0151515
NODE_301986_length_187_cov_37.397727	12	78	58	4	66	0.0606061
NODE_301986_length_187_cov_37.397727	12	78	60	1	66	0.0151515
NODE_301986_length_187_cov_37.397727	12	78	62	1	66	0.0151515
NODE_301986_length_187_cov_37.397727	12	78	65	1	66	0.0151515
NODE_301986_length_187_cov_37.397727	12	78	67	1	66	0.0151515
NODE_301986_length_187_cov_37.397727	12	78	70	1	66	0.0151515
NODE_301986_length_187_cov_37.397727	12	78	72	2	66	0.0303030
NODE_301986_length_187_cov_37.397727	12	78	76	2	66	0.0303030
NODE_301986_length_187_cov_37.397727	12	78	82	4	66	0.0606061
NODE_301986_length_187_cov_37.397727	12	78	84	2	66	0.0303030
NODE_301986_length_187_cov_37.397727	12	78	94	2	66	0.0303030
NODE_301986_length_187_cov_37.397727	12	78	100	2	66	0.0303030
NODE_301986_length_187_cov_37.397727	12	78	110	3	66	0.0454545
NODE_301986_length_187_cov_37.397727	12	78	112	2	66	0.0303030
NODE_301986_length_187_cov_37.397727	12	78	114	1	66	0.0151515
NODE_301986_length_187_cov_37.397727	12	78	120	1	66	0.0151515
NODE_301986_length_187_cov_37.397727	12	78	122	2	66	0.0303030
NODE_301986_length_187_cov_37.397727	12	78	126	1	66	0.0151515
NODE_301986_length_187_cov_37.397727	12	78	128	1	66	0.0151515
NODE_301986_length_187_cov_37.397727	12	78	134	1	66	0.0151515
NODE_301986_length_187_cov_37.397727	12	78	138	5	66	0.0757576
NODE_301986_length_187_cov_37.397727	51	112	82	4	61	0.0655738
NODE_301986_length_187_cov_37.397727	51	112	84	2	61	0.0327869
NODE_301986_length_187_cov_37.397727	51	112	94	2	61	0.0327869
NODE_301986_length_187_cov_37.397727	51	112	100	2	61	0.0327869
NODE_301986_length_187_cov_37.397727	51	112	110	3	61	0.0491803
NODE_301986_length_187_cov_37.397727	51	112	112	2	61	0.0327869
NODE_301986_length_187_cov_37.397727	51	112	114	1	61	0.0163934
NODE_301986_length_187_cov_37.397727	51	112	120	1	61	0.0163934
NODE_301986_length_187_cov_37.397727	51	112	122	2	61	0.0327869
NODE_301986_length_187_cov_37.397727	51	112	126	1	61	0.0163934
NODE_301986_length_187_cov_37.397727	51	112	128	1	61	0.0163934
NODE_301986_length_187_cov_37.397727	51	112	134	5	61	0.0819672
NODE_301986_length_187_cov_37.397727	51	112	137	1	61	0.0163934
NODE_301986_length_187_cov_37.397727	51	112	138	34	61	0.5573770
NODE_301986_length_187_cov_37.397727	51	114	82	4	63	0.0634921
NODE_301986_length_187_cov_37.397727	51	114	84	2	63	0.0317460
NODE_301986_length_187_cov_37.397727	51	114	94	2	63	0.0317460
NODE_301986_length_187_cov_37.397727	51	114	100	2	63	0.0317460
NODE_301986_length_187_cov_37.397727	51	114	110	3	63	0.0476190
NODE_301986_length_187_cov_37.397727	51	114	112	2	63	0.0317460
NODE_301986_length_187_cov_37.397727	51	114	114	1	63	0.0158730
NODE_301986_length_187_cov_37.397727	51	114	120	1	63	0.0158730
NODE_301986_length_187_cov_37.397727	51	114	122	2	63	0.0317460
NODE_301986_length_187_cov_37.397727	51	114	126	1	63	0.0158730
NODE_301986_length_187_cov_37.397727	51	114	128	1	63	0.0158730
NODE_301986_length_187_cov_37.397727	51	114	134	7	63	0.1111111
NODE_301986_length_187_cov_37.397727	51	114	137	1	63	0.0158730
NODE_301986_length_187_cov_37.397727	51	114	138	34	63	0.5396826
NODE_302020_length_186_cov_309.620690	20	104	0	84	84	1.0000000
NODE_302021_length_186_cov_295.505747	57	115	161	4	58	0.0689655
NODE_302021_length_186_cov_295.505747	57	115	163	3	58	0.0517241
NODE_302021_length_186_cov_295.505747	57	115	167	1	58	0.0172414
NODE_302021_length_186_cov_295.505747	57	115	169	2	58	0.0344828
NODE_302021_length_186_cov_295.505747	57	115	171	2	58	0.0344828
NODE_302021_length_186_cov_295.505747	57	115	173	1	58	0.0172414
NODE_302021_length_186_cov_295.505747	57	115	175	1	58	0.0172414
NODE_302021_length_186_cov_295.505747	57	115	176	1	58	0.0172414
NODE_302021_length_186_cov_295.505747	57	115	184	1	58	0.0172414
NODE_302021_length_186_cov_295.505747	57	115	187	4	58	0.0689655
NODE_302021_length_186_cov_295.505747	57	115	188	1	58	0.0172414
NODE_302021_length_186_cov_295.505747	57	115	189	1	58	0.0172414
NODE_302021_length_186_cov_295.505747	57	115	191	3	58	0.0517241
NODE_302021_length_186_cov_295.505747	57	115	192	10	58	0.1724138
NODE_302021_length_186_cov_295.505747	57	115	193	17	58	0.2931035
NODE_302021_length_186_cov_295.505747	57	115	194	6	58	0.1034483
NODE_302021_length_186_cov_295.505747	101	168	35	1	67	0.0149254
NODE_302021_length_186_cov_295.505747	101	168	39	1	67	0.0149254
NODE_302021_length_186_cov_295.505747	101	168	41	2	67	0.0298507
NODE_302021_length_186_cov_295.505747	101	168	52	1	67	0.0149254
NODE_302021_length_186_cov_295.505747	101	168	55	5	67	0.0746269
NODE_302021_length_186_cov_295.505747	101	168	59	4	67	0.0597015
NODE_302021_length_186_cov_295.505747	101	168	60	1	67	0.0149254
NODE_302021_length_186_cov_295.505747	101	168	64	1	67	0.0149254
NODE_302021_length_186_cov_295.505747	101	168	76	1	67	0.0149254
NODE_302021_length_186_cov_295.505747	101	168	78	3	67	0.0447761
NODE_302021_length_186_cov_295.505747	101	168	80	2	67	0.0298507
NODE_302021_length_186_cov_295.505747	101	168	82	1	67	0.0149254
NODE_302021_length_186_cov_295.505747	101	168	86	1	67	0.0149254
NODE_302021_length_186_cov_295.505747	101	168	90	2	67	0.0298507
NODE_302021_length_186_cov_295.505747	101	168	100	1	67	0.0149254
NODE_302021_length_186_cov_295.505747	101	168	105	2	67	0.0298507
NODE_302021_length_186_cov_295.505747	101	168	107	4	67	0.0597015
NODE_302021_length_186_cov_295.505747	101	168	109	1	67	0.0149254
NODE_302021_length_186_cov_295.505747	101	168	127	2	67	0.0298507
NODE_302021_length_186_cov_295.505747	101	168	129	5	67	0.0746269
NODE_302021_length_186_cov_295.505747	101	168	130	2	67	0.0298507
NODE_302021_length_186_cov_295.505747	101	168	132	1	67	0.0149254
NODE_302021_length_186_cov_295.505747	101	168	137	1	67	0.0149254
NODE_302021_length_186_cov_295.505747	101	168	143	2	67	0.0298507
NODE_302021_length_186_cov_295.505747	101	168	144	1	67	0.0149254
NODE_302021_length_186_cov_295.505747	101	168	155	1	67	0.0149254
NODE_302021_length_186_cov_295.505747	101	168	159	1	67	0.0149254
NODE_302021_length_186_cov_295.505747	101	168	161	7	67	0.1044776
NODE_302021_length_186_cov_295.505747	101	168	163	2	67	0.0298507
NODE_302021_length_186_cov_295.505747	101	168	169	1	67	0.0149254
NODE_302021_length_186_cov_295.505747	101	168	171	1	67	0.0149254
NODE_302021_length_186_cov_295.505747	101	168	175	1	67	0.0149254
NODE_302021_length_186_cov_295.505747	101	168	188	1	67	0.0149254
NODE_302021_length_186_cov_295.505747	101	168	189	1	67	0.0149254
NODE_302021_length_186_cov_295.505747	101	168	193	3	67	0.0447761
NODE_302025_length_186_cov_61.344828	38	118	28	1	80	0.0125000
NODE_302025_length_186_cov_61.344828	38	118	35	1	80	0.0125000
NODE_302025_length_186_cov_61.344828	38	118	40	1	80	0.0125000
NODE_302025_length_186_cov_61.344828	38	118	49	1	80	0.0125000
NODE_302025_length_186_cov_61.344828	38	118	52	2	80	0.0250000
NODE_302025_length_186_cov_61.344828	38	118	56	3	80	0.0375000
NODE_302025_length_186_cov_61.344828	38	118	59	1	80	0.0125000
NODE_302025_length_186_cov_61.344828	38	118	60	1	80	0.0125000
NODE_302025_length_186_cov_61.344828	38	118	62	3	80	0.0375000
NODE_302025_length_186_cov_61.344828	38	118	66	3	80	0.0375000
NODE_302025_length_186_cov_61.344828	38	118	68	14	80	0.1750000
NODE_302025_length_186_cov_61.344828	38	118	70	3	80	0.0375000
NODE_302025_length_186_cov_61.344828	38	118	71	1	80	0.0125000
NODE_302025_length_186_cov_61.344828	38	118	76	3	80	0.0375000
NODE_302025_length_186_cov_61.344828	38	118	78	1	80	0.0125000
NODE_302025_length_186_cov_61.344828	38	118	84	1	80	0.0125000
NODE_302025_length_186_cov_61.344828	38	118	86	5	80	0.0625000
NODE_302025_length_186_cov_61.344828	38	118	88	35	80	0.4375000
NODE_302025_length_186_cov_61.344828	91	171	27	1	80	0.0125000
NODE_302025_length_186_cov_61.344828	91	171	29	1	80	0.0125000
NODE_302025_length_186_cov_61.344828	91	171	31	2	80	0.0250000
NODE_302025_length_186_cov_61.344828	91	171	34	3	80	0.0375000
NODE_302025_length_186_cov_61.344828	91	171	40	1	80	0.0125000
NODE_302025_length_186_cov_61.344828	91	171	42	5	80	0.0625000
NODE_302025_length_186_cov_61.344828	91	171	46	1	80	0.0125000
NODE_302025_length_186_cov_61.344828	91	171	48	11	80	0.1375000
NODE_302025_length_186_cov_61.344828	91	171	56	1	80	0.0125000
NODE_302025_length_186_cov_61.344828	91	171	58	1	80	0.0125000
NODE_302025_length_186_cov_61.344828	91	171	59	1	80	0.0125000
NODE_302025_length_186_cov_61.344828	91	171	66	1	80	0.0125000
NODE_302025_length_186_cov_61.344828	91	171	70	2	80	0.0250000
NODE_302025_length_186_cov_61.344828	91	171	72	4	80	0.0500000
NODE_302025_length_186_cov_61.344828	91	171	74	7	80	0.0875000
NODE_302025_length_186_cov_61.344828	91	171	78	1	80	0.0125000
NODE_302025_length_186_cov_61.344828	91	171	82	6	80	0.0750000
NODE_302025_length_186_cov_61.344828	91	171	84	3	80	0.0375000
NODE_302025_length_186_cov_61.344828	91	171	88	28	80	0.3500000
NODE_302201_length_182_cov_127.759036	6	52	40	5	46	0.1086956
NODE_302201_length_182_cov_127.759036	6	52	42	2	46	0.0434783
NODE_302201_length_182_cov_127.759036	6	52	44	7	46	0.1521739
NODE_302201_length_182_cov_127.759036	6	52	48	1	46	0.0217391
NODE_302201_length_182_cov_127.759036	6	52	49	2	46	0.0434783
NODE_302201_length_182_cov_127.759036	6	52	53	2	46	0.0434783
NODE_302201_length_182_cov_127.759036	6	52	56	1	46	0.0217391
NODE_302201_length_182_cov_127.759036	6	52	58	1	46	0.0217391
NODE_302201_length_182_cov_127.759036	6	52	60	1	46	0.0217391
NODE_302201_length_182_cov_127.759036	6	52	62	1	46	0.0217391
NODE_302201_length_182_cov_127.759036	6	52	66	1	46	0.0217391
NODE_302201_length_182_cov_127.759036	6	52	72	1	46	0.0217391
NODE_302201_length_182_cov_127.759036	6	52	74	1	46	0.0217391
NODE_302201_length_182_cov_127.759036	6	52	75	1	46	0.0217391
NODE_302201_length_182_cov_127.759036	6	52	77	1	46	0.0217391
NODE_302201_length_182_cov_127.759036	6	52	79	1	46	0.0217391
NODE_302201_length_182_cov_127.759036	6	52	83	1	46	0.0217391
NODE_302201_length_182_cov_127.759036	6	52	88	1	46	0.0217391
NODE_302201_length_182_cov_127.759036	6	52	90	7	46	0.1521739
NODE_302201_length_182_cov_127.759036	6	52	92	2	46	0.0434783
NODE_302201_length_182_cov_127.759036	6	52	94	5	46	0.1086956
NODE_302201_length_182_cov_127.759036	6	52	96	1	46	0.0217391
NODE_302201_length_182_cov_127.759036	59	105	117	1	46	0.0217391
NODE_302201_length_182_cov_127.759036	59	105	120	1	46	0.0217391
NODE_302201_length_182_cov_127.759036	59	105	123	1	46	0.0217391
NODE_302201_length_182_cov_127.759036	59	105	132	1	46	0.0217391
NODE_302201_length_182_cov_127.759036	59	105	134	1	46	0.0217391
NODE_302201_length_182_cov_127.759036	59	105	138	1	46	0.0217391
NODE_302201_length_182_cov_127.759036	59	105	139	4	46	0.0869565
NODE_302201_length_182_cov_127.759036	59	105	143	4	46	0.0869565
NODE_302201_length_182_cov_127.759036	59	105	145	3	46	0.0652174
NODE_302201_length_182_cov_127.759036	59	105	146	1	46	0.0217391
NODE_302201_length_182_cov_127.759036	59	105	147	1	46	0.0217391
NODE_302201_length_182_cov_127.759036	59	105	149	4	46	0.0869565
NODE_302201_length_182_cov_127.759036	59	105	151	23	46	0.5000000
NODE_302214_length_182_cov_29.421687	5	35	0	9	30	0.3000000
NODE_302214_length_182_cov_29.421687	5	35	3	19	30	0.6333333
NODE_302214_length_182_cov_29.421687	5	35	6	2	30	0.0666667
NODE_302214_length_182_cov_29.421687	8	88	0	6	80	0.0750000
NODE_302214_length_182_cov_29.421687	8	88	3	19	80	0.2375000
NODE_302214_length_182_cov_29.421687	8	88	6	55	80	0.6875000
NODE_302236_length_181_cov_141.195122	1	60	0	59	59	1.0000000
NODE_302236_length_181_cov_141.195122	34	60	0	26	26	1.0000000
NODE_302236_length_181_cov_141.195122	114	145	0	31	31	1.0000000
NODE_302285_length_180_cov_102.567901	6	75	14	1	69	0.0144928
NODE_302285_length_180_cov_102.567901	6	75	16	3	69	0.0434783
NODE_302285_length_180_cov_102.567901	6	75	18	7	69	0.1014493
NODE_302285_length_180_cov_102.567901	6	75	33	2	69	0.0289855
NODE_302285_length_180_cov_102.567901	6	75	35	6	69	0.0869565
NODE_302285_length_180_cov_102.567901	6	75	37	1	69	0.0144928
NODE_302285_length_180_cov_102.567901	6	75	38	2	69	0.0289855
NODE_302285_length_180_cov_102.567901	6	75	42	1	69	0.0144928
NODE_302285_length_180_cov_102.567901	6	75	46	2	69	0.0289855
NODE_302285_length_180_cov_102.567901	6	75	53	1	69	0.0144928
NODE_302285_length_180_cov_102.567901	6	75	55	2	69	0.0289855
NODE_302285_length_180_cov_102.567901	6	75	61	1	69	0.0144928
NODE_302285_length_180_cov_102.567901	6	75	79	4	69	0.0579710
NODE_302285_length_180_cov_102.567901	6	75	88	1	69	0.0144928
NODE_302285_length_180_cov_102.567901	6	75	99	1	69	0.0144928
NODE_302285_length_180_cov_102.567901	6	75	103	2	69	0.0289855
NODE_302285_length_180_cov_102.567901	6	75	105	1	69	0.0144928
NODE_302285_length_180_cov_102.567901	6	75	111	1	69	0.0144928
NODE_302285_length_180_cov_102.567901	6	75	114	2	69	0.0289855
NODE_302285_length_180_cov_102.567901	6	75	126	1	69	0.0144928
NODE_302285_length_180_cov_102.567901	6	75	128	1	69	0.0144928
NODE_302285_length_180_cov_102.567901	6	75	140	1	69	0.0144928
NODE_302285_length_180_cov_102.567901	6	75	146	1	69	0.0144928
NODE_302285_length_180_cov_102.567901	6	75	150	3	69	0.0434783
NODE_302285_length_180_cov_102.567901	6	75	158	1	69	0.0144928
NODE_302285_length_180_cov_102.567901	6	75	164	1	69	0.0144928
NODE_302285_length_180_cov_102.567901	6	75	166	4	69	0.0579710
NODE_302285_length_180_cov_102.567901	6	75	168	3	69	0.0434783
NODE_302285_length_180_cov_102.567901	6	75	170	1	69	0.0144928
NODE_302285_length_180_cov_102.567901	6	75	172	3	69	0.0434783
NODE_302285_length_180_cov_102.567901	6	75	174	8	69	0.1159420
NODE_302363_length_178_cov_93.620253	81	112	6	31	31	1.0000000
NODE_302365_length_178_cov_62.696203	0	78	3	1	78	0.0128205
NODE_302365_length_178_cov_62.696203	0	78	11	5	78	0.0641026
NODE_302365_length_178_cov_62.696203	0	78	12	3	78	0.0384615
NODE_302365_length_178_cov_62.696203	0	78	14	1	78	0.0128205
NODE_302365_length_178_cov_62.696203	0	78	16	3	78	0.0384615
NODE_302365_length_178_cov_62.696203	0	78	26	2	78	0.0256410
NODE_302365_length_178_cov_62.696203	0	78	31	1	78	0.0128205
NODE_302365_length_178_cov_62.696203	0	78	33	2	78	0.0256410
NODE_302365_length_178_cov_62.696203	0	78	38	1	78	0.0128205
NODE_302365_length_178_cov_62.696203	0	78	39	5	78	0.0641026
NODE_302365_length_178_cov_62.696203	0	78	40	8	78	0.1025641
NODE_302365_length_178_cov_62.696203	0	78	42	6	78	0.0769231
NODE_302365_length_178_cov_62.696203	0	78	48	9	78	0.1153846
NODE_302365_length_178_cov_62.696203	0	78	52	11	78	0.1410256
NODE_302365_length_178_cov_62.696203	0	78	54	2	78	0.0256410
NODE_302365_length_178_cov_62.696203	0	78	56	7	78	0.0897436
NODE_302365_length_178_cov_62.696203	0	78	58	11	78	0.1410256
NODE_302365_length_178_cov_62.696203	51	131	30	3	80	0.0375000
NODE_302365_length_178_cov_62.696203	51	131	40	2	80	0.0250000
NODE_302365_length_178_cov_62.696203	51	131	46	3	80	0.0375000
NODE_302365_length_178_cov_62.696203	51	131	48	3	80	0.0375000
NODE_302365_length_178_cov_62.696203	51	131	50	7	80	0.0875000
NODE_302365_length_178_cov_62.696203	51	131	52	7	80	0.0875000
NODE_302365_length_178_cov_62.696203	51	131	54	2	80	0.0250000
NODE_302365_length_178_cov_62.696203	51	131	56	7	80	0.0875000
NODE_302365_length_178_cov_62.696203	51	131	58	46	80	0.5750000
NODE_302477_length_175_cov_116.684211	42	122	0	80	80	1.0000000
NODE_302477_length_175_cov_116.684211	95	175	0	80	80	1.0000000
NODE_302482_length_175_cov_61.000000	81	121	257	1	40	0.0250000
NODE_302482_length_175_cov_61.000000	81	121	259	1	40	0.0250000
NODE_302482_length_175_cov_61.000000	81	121	265	1	40	0.0250000
NODE_302482_length_175_cov_61.000000	81	121	267	2	40	0.0500000
NODE_302482_length_175_cov_61.000000	81	121	269	3	40	0.0750000
NODE_302482_length_175_cov_61.000000	81	121	273	1	40	0.0250000
NODE_302482_length_175_cov_61.000000	81	121	275	1	40	0.0250000
NODE_302482_length_175_cov_61.000000	81	121	279	6	40	0.1500000
NODE_302482_length_175_cov_61.000000	81	121	283	2	40	0.0500000
NODE_302482_length_175_cov_61.000000	81	121	287	22	40	0.5500000
NODE_302538_length_174_cov_173.893333	53	93	494	1	40	0.0250000
NODE_302538_length_174_cov_173.893333	53	93	498	1	40	0.0250000
NODE_302538_length_174_cov_173.893333	53	93	511	1	40	0.0250000
NODE_302538_length_174_cov_173.893333	53	93	515	2	40	0.0500000
NODE_302538_length_174_cov_173.893333	53	93	519	1	40	0.0250000
NODE_302538_length_174_cov_173.893333	53	93	521	1	40	0.0250000
NODE_302538_length_174_cov_173.893333	53	93	537	1	40	0.0250000
NODE_302538_length_174_cov_173.893333	53	93	541	1	40	0.0250000
NODE_302538_length_174_cov_173.893333	53	93	562	1	40	0.0250000
NODE_302538_length_174_cov_173.893333	53	93	563	1	40	0.0250000
NODE_302538_length_174_cov_173.893333	53	93	565	1	40	0.0250000
NODE_302538_length_174_cov_173.893333	53	93	569	1	40	0.0250000
NODE_302538_length_174_cov_173.893333	53	93	573	2	40	0.0500000
NODE_302538_length_174_cov_173.893333	53	93	575	1	40	0.0250000
NODE_302538_length_174_cov_173.893333	53	93	576	1	40	0.0250000
NODE_302538_length_174_cov_173.893333	53	93	586	1	40	0.0250000
NODE_302538_length_174_cov_173.893333	53	93	588	1	40	0.0250000
NODE_302538_length_174_cov_173.893333	53	93	595	1	40	0.0250000
NODE_302538_length_174_cov_173.893333	53	93	596	20	40	0.5000000
NODE_302543_length_174_cov_50.346667	91	161	14	2	70	0.0285714
NODE_302543_length_174_cov_50.346667	91	161	16	1	70	0.0142857
NODE_302543_length_174_cov_50.346667	91	161	18	6	70	0.0857143
NODE_302543_length_174_cov_50.346667	91	161	19	1	70	0.0142857
NODE_302543_length_174_cov_50.346667	91	161	22	4	70	0.0571429
NODE_302543_length_174_cov_50.346667	91	161	26	3	70	0.0428571
NODE_302543_length_174_cov_50.346667	91	161	36	1	70	0.0142857
NODE_302543_length_174_cov_50.346667	91	161	38	1	70	0.0142857
NODE_302543_length_174_cov_50.346667	91	161	44	3	70	0.0428571
NODE_302543_length_174_cov_50.346667	91	161	46	1	70	0.0142857
NODE_302543_length_174_cov_50.346667	91	161	53	3	70	0.0428571
NODE_302543_length_174_cov_50.346667	91	161	55	2	70	0.0285714
NODE_302543_length_174_cov_50.346667	91	161	57	1	70	0.0142857
NODE_302543_length_174_cov_50.346667	91	161	59	5	70	0.0714286
NODE_302543_length_174_cov_50.346667	91	161	61	4	70	0.0571429
NODE_302543_length_174_cov_50.346667	91	161	63	6	70	0.0857143
NODE_302543_length_174_cov_50.346667	91	161	69	4	70	0.0571429
NODE_302543_length_174_cov_50.346667	91	161	71	1	70	0.0142857
NODE_302543_length_174_cov_50.346667	91	161	73	3	70	0.0428571
NODE_302543_length_174_cov_50.346667	91	161	75	18	70	0.2571429
NODE_302590_length_173_cov_184.351351	62	126	210	1	64	0.0156250
NODE_302590_length_173_cov_184.351351	62	126	212	3	64	0.0468750
NODE_302590_length_173_cov_184.351351	62	126	216	2	64	0.0312500
NODE_302590_length_173_cov_184.351351	62	126	228	2	64	0.0312500
NODE_302590_length_173_cov_184.351351	62	126	232	1	64	0.0156250
NODE_302590_length_173_cov_184.351351	62	126	233	1	64	0.0156250
NODE_302590_length_173_cov_184.351351	62	126	235	2	64	0.0312500
NODE_302590_length_173_cov_184.351351	62	126	237	1	64	0.0156250
NODE_302590_length_173_cov_184.351351	62	126	240	1	64	0.0156250
NODE_302590_length_173_cov_184.351351	62	126	246	1	64	0.0156250
NODE_302590_length_173_cov_184.351351	62	126	248	1	64	0.0156250
NODE_302590_length_173_cov_184.351351	62	126	251	1	64	0.0156250
NODE_302590_length_173_cov_184.351351	62	126	253	1	64	0.0156250
NODE_302590_length_173_cov_184.351351	62	126	254	20	64	0.3125000
NODE_302590_length_173_cov_184.351351	62	126	255	2	64	0.0312500
NODE_302590_length_173_cov_184.351351	62	126	256	3	64	0.0468750
NODE_302590_length_173_cov_184.351351	62	126	257	21	64	0.3281250
NODE_302590_length_173_cov_184.351351	62	126	210	1	64	0.0156250
NODE_302590_length_173_cov_184.351351	62	126	212	3	64	0.0468750
NODE_302590_length_173_cov_184.351351	62	126	216	2	64	0.0312500
NODE_302590_length_173_cov_184.351351	62	126	228	2	64	0.0312500
NODE_302590_length_173_cov_184.351351	62	126	232	1	64	0.0156250
NODE_302590_length_173_cov_184.351351	62	126	233	1	64	0.0156250
NODE_302590_length_173_cov_184.351351	62	126	235	2	64	0.0312500
NODE_302590_length_173_cov_184.351351	62	126	237	1	64	0.0156250
NODE_302590_length_173_cov_184.351351	62	126	240	1	64	0.0156250
NODE_302590_length_173_cov_184.351351	62	126	246	1	64	0.0156250
NODE_302590_length_173_cov_184.351351	62	126	248	1	64	0.0156250
NODE_302590_length_173_cov_184.351351	62	126	251	1	64	0.0156250
NODE_302590_length_173_cov_184.351351	62	126	253	1	64	0.0156250
NODE_302590_length_173_cov_184.351351	62	126	254	20	64	0.3125000
NODE_302590_length_173_cov_184.351351	62	126	255	2	64	0.0312500
NODE_302590_length_173_cov_184.351351	62	126	256	3	64	0.0468750
NODE_302590_length_173_cov_184.351351	62	126	257	21	64	0.3281250
NODE_302590_length_173_cov_184.351351	62	126	210	1	64	0.0156250
NODE_302590_length_173_cov_184.351351	62	126	212	3	64	0.0468750
NODE_302590_length_173_cov_184.351351	62	126	216	2	64	0.0312500
NODE_302590_length_173_cov_184.351351	62	126	228	2	64	0.0312500
NODE_302590_length_173_cov_184.351351	62	126	232	1	64	0.0156250
NODE_302590_length_173_cov_184.351351	62	126	233	1	64	0.0156250
NODE_302590_length_173_cov_184.351351	62	126	235	2	64	0.0312500
NODE_302590_length_173_cov_184.351351	62	126	237	1	64	0.0156250
NODE_302590_length_173_cov_184.351351	62	126	240	1	64	0.0156250
NODE_302590_length_173_cov_184.351351	62	126	246	1	64	0.0156250
NODE_302590_length_173_cov_184.351351	62	126	248	1	64	0.0156250
NODE_302590_length_173_cov_184.351351	62	126	251	1	64	0.0156250
NODE_302590_length_173_cov_184.351351	62	126	253	1	64	0.0156250
NODE_302590_length_173_cov_184.351351	62	126	254	20	64	0.3125000
NODE_302590_length_173_cov_184.351351	62	126	255	2	64	0.0312500
NODE_302590_length_173_cov_184.351351	62	126	256	3	64	0.0468750
NODE_302590_length_173_cov_184.351351	62	126	257	21	64	0.3281250
NODE_302590_length_173_cov_184.351351	62	126	210	1	64	0.0156250
NODE_302590_length_173_cov_184.351351	62	126	212	3	64	0.0468750
NODE_302590_length_173_cov_184.351351	62	126	216	2	64	0.0312500
NODE_302590_length_173_cov_184.351351	62	126	228	2	64	0.0312500
NODE_302590_length_173_cov_184.351351	62	126	232	1	64	0.0156250
NODE_302590_length_173_cov_184.351351	62	126	233	1	64	0.0156250
NODE_302590_length_173_cov_184.351351	62	126	235	2	64	0.0312500
NODE_302590_length_173_cov_184.351351	62	126	237	1	64	0.0156250
NODE_302590_length_173_cov_184.351351	62	126	240	1	64	0.0156250
NODE_302590_length_173_cov_184.351351	62	126	246	1	64	0.0156250
NODE_302590_length_173_cov_184.351351	62	126	248	1	64	0.0156250
NODE_302590_length_173_cov_184.351351	62	126	251	1	64	0.0156250
NODE_302590_length_173_cov_184.351351	62	126	253	1	64	0.0156250
NODE_302590_length_173_cov_184.351351	62	126	254	20	64	0.3125000
NODE_302590_length_173_cov_184.351351	62	126	255	2	64	0.0312500
NODE_302590_length_173_cov_184.351351	62	126	256	3	64	0.0468750
NODE_302590_length_173_cov_184.351351	62	126	257	21	64	0.3281250
NODE_302590_length_173_cov_184.351351	99	165	53	1	66	0.0151515
NODE_302590_length_173_cov_184.351351	99	165	55	1	66	0.0151515
NODE_302590_length_173_cov_184.351351	99	165	57	2	66	0.0303030
NODE_302590_length_173_cov_184.351351	99	165	58	1	66	0.0151515
NODE_302590_length_173_cov_184.351351	99	165	60	1	66	0.0151515
NODE_302590_length_173_cov_184.351351	99	165	64	1	66	0.0151515
NODE_302590_length_173_cov_184.351351	99	165	66	1	66	0.0151515
NODE_302590_length_173_cov_184.351351	99	165	89	1	66	0.0151515
NODE_302590_length_173_cov_184.351351	99	165	95	1	66	0.0151515
NODE_302590_length_173_cov_184.351351	99	165	96	1	66	0.0151515
NODE_302590_length_173_cov_184.351351	99	165	99	1	66	0.0151515
NODE_302590_length_173_cov_184.351351	99	165	108	1	66	0.0151515
NODE_302590_length_173_cov_184.351351	99	165	111	1	66	0.0151515
NODE_302590_length_173_cov_184.351351	99	165	112	3	66	0.0454545
NODE_302590_length_173_cov_184.351351	99	165	114	1	66	0.0151515
NODE_302590_length_173_cov_184.351351	99	165	120	2	66	0.0303030
NODE_302590_length_173_cov_184.351351	99	165	122	1	66	0.0151515
NODE_302590_length_173_cov_184.351351	99	165	125	1	66	0.0151515
NODE_302590_length_173_cov_184.351351	99	165	129	2	66	0.0303030
NODE_302590_length_173_cov_184.351351	99	165	139	1	66	0.0151515
NODE_302590_length_173_cov_184.351351	99	165	146	1	66	0.0151515
NODE_302590_length_173_cov_184.351351	99	165	155	1	66	0.0151515
NODE_302590_length_173_cov_184.351351	99	165	156	1	66	0.0151515
NODE_302590_length_173_cov_184.351351	99	165	164	1	66	0.0151515
NODE_302590_length_173_cov_184.351351	99	165	166	1	66	0.0151515
NODE_302590_length_173_cov_184.351351	99	165	171	1	66	0.0151515
NODE_302590_length_173_cov_184.351351	99	165	174	2	66	0.0303030
NODE_302590_length_173_cov_184.351351	99	165	175	2	66	0.0303030
NODE_302590_length_173_cov_184.351351	99	165	182	1	66	0.0151515
NODE_302590_length_173_cov_184.351351	99	165	189	1	66	0.0151515
NODE_302590_length_173_cov_184.351351	99	165	198	1	66	0.0151515
NODE_302590_length_173_cov_184.351351	99	165	204	1	66	0.0151515
NODE_302590_length_173_cov_184.351351	99	165	210	1	66	0.0151515
NODE_302590_length_173_cov_184.351351	99	165	212	3	66	0.0454545
NODE_302590_length_173_cov_184.351351	99	165	216	2	66	0.0303030
NODE_302590_length_173_cov_184.351351	99	165	228	2	66	0.0303030
NODE_302590_length_173_cov_184.351351	99	165	232	1	66	0.0151515
NODE_302590_length_173_cov_184.351351	99	165	233	1	66	0.0151515
NODE_302590_length_173_cov_184.351351	99	165	235	2	66	0.0303030
NODE_302590_length_173_cov_184.351351	99	165	237	1	66	0.0151515
NODE_302590_length_173_cov_184.351351	99	165	240	1	66	0.0151515
NODE_302590_length_173_cov_184.351351	99	165	246	1	66	0.0151515
NODE_302590_length_173_cov_184.351351	99	165	248	1	66	0.0151515
NODE_302590_length_173_cov_184.351351	99	165	251	1	66	0.0151515
NODE_302590_length_173_cov_184.351351	99	165	253	1	66	0.0151515
NODE_302590_length_173_cov_184.351351	99	165	254	9	66	0.1363636
NODE_302590_length_173_cov_184.351351	99	170	45	3	71	0.0422535
NODE_302590_length_173_cov_184.351351	99	170	46	1	71	0.0140845
NODE_302590_length_173_cov_184.351351	99	170	51	1	71	0.0140845
NODE_302590_length_173_cov_184.351351	99	170	53	1	71	0.0140845
NODE_302590_length_173_cov_184.351351	99	170	55	1	71	0.0140845
NODE_302590_length_173_cov_184.351351	99	170	57	2	71	0.0281690
NODE_302590_length_173_cov_184.351351	99	170	58	1	71	0.0140845
NODE_302590_length_173_cov_184.351351	99	170	60	1	71	0.0140845
NODE_302590_length_173_cov_184.351351	99	170	64	1	71	0.0140845
NODE_302590_length_173_cov_184.351351	99	170	66	1	71	0.0140845
NODE_302590_length_173_cov_184.351351	99	170	89	1	71	0.0140845
NODE_302590_length_173_cov_184.351351	99	170	95	1	71	0.0140845
NODE_302590_length_173_cov_184.351351	99	170	96	1	71	0.0140845
NODE_302590_length_173_cov_184.351351	99	170	99	1	71	0.0140845
NODE_302590_length_173_cov_184.351351	99	170	108	1	71	0.0140845
NODE_302590_length_173_cov_184.351351	99	170	111	1	71	0.0140845
NODE_302590_length_173_cov_184.351351	99	170	112	3	71	0.0422535
NODE_302590_length_173_cov_184.351351	99	170	114	1	71	0.0140845
NODE_302590_length_173_cov_184.351351	99	170	120	2	71	0.0281690
NODE_302590_length_173_cov_184.351351	99	170	122	1	71	0.0140845
NODE_302590_length_173_cov_184.351351	99	170	125	1	71	0.0140845
NODE_302590_length_173_cov_184.351351	99	170	129	2	71	0.0281690
NODE_302590_length_173_cov_184.351351	99	170	139	1	71	0.0140845
NODE_302590_length_173_cov_184.351351	99	170	146	1	71	0.0140845
NODE_302590_length_173_cov_184.351351	99	170	155	1	71	0.0140845
NODE_302590_length_173_cov_184.351351	99	170	156	1	71	0.0140845
NODE_302590_length_173_cov_184.351351	99	170	164	1	71	0.0140845
NODE_302590_length_173_cov_184.351351	99	170	166	1	71	0.0140845
NODE_302590_length_173_cov_184.351351	99	170	171	1	71	0.0140845
NODE_302590_length_173_cov_184.351351	99	170	174	2	71	0.0281690
NODE_302590_length_173_cov_184.351351	99	170	175	2	71	0.0281690
NODE_302590_length_173_cov_184.351351	99	170	182	1	71	0.0140845
NODE_302590_length_173_cov_184.351351	99	170	189	1	71	0.0140845
NODE_302590_length_173_cov_184.351351	99	170	198	1	71	0.0140845
NODE_302590_length_173_cov_184.351351	99	170	204	1	71	0.0140845
NODE_302590_length_173_cov_184.351351	99	170	210	1	71	0.0140845
NODE_302590_length_173_cov_184.351351	99	170	212	3	71	0.0422535
NODE_302590_length_173_cov_184.351351	99	170	216	2	71	0.0281690
NODE_302590_length_173_cov_184.351351	99	170	228	2	71	0.0281690
NODE_302590_length_173_cov_184.351351	99	170	232	1	71	0.0140845
NODE_302590_length_173_cov_184.351351	99	170	233	1	71	0.0140845
NODE_302590_length_173_cov_184.351351	99	170	235	2	71	0.0281690
NODE_302590_length_173_cov_184.351351	99	170	237	1	71	0.0140845
NODE_302590_length_173_cov_184.351351	99	170	240	1	71	0.0140845
NODE_302590_length_173_cov_184.351351	99	170	246	1	71	0.0140845
NODE_302590_length_173_cov_184.351351	99	170	248	1	71	0.0140845
NODE_302590_length_173_cov_184.351351	99	170	251	1	71	0.0140845
NODE_302590_length_173_cov_184.351351	99	170	253	1	71	0.0140845
NODE_302590_length_173_cov_184.351351	99	170	254	9	71	0.1267606
NODE_302590_length_173_cov_184.351351	115	173	35	1	58	0.0172414
NODE_302590_length_173_cov_184.351351	115	173	39	1	58	0.0172414
NODE_302590_length_173_cov_184.351351	115	173	45	4	58	0.0689655
NODE_302590_length_173_cov_184.351351	115	173	46	1	58	0.0172414
NODE_302590_length_173_cov_184.351351	115	173	51	1	58	0.0172414
NODE_302590_length_173_cov_184.351351	115	173	53	1	58	0.0172414
NODE_302590_length_173_cov_184.351351	115	173	55	1	58	0.0172414
NODE_302590_length_173_cov_184.351351	115	173	57	2	58	0.0344828
NODE_302590_length_173_cov_184.351351	115	173	58	1	58	0.0172414
NODE_302590_length_173_cov_184.351351	115	173	60	1	58	0.0172414
NODE_302590_length_173_cov_184.351351	115	173	64	1	58	0.0172414
NODE_302590_length_173_cov_184.351351	115	173	66	1	58	0.0172414
NODE_302590_length_173_cov_184.351351	115	173	89	1	58	0.0172414
NODE_302590_length_173_cov_184.351351	115	173	95	1	58	0.0172414
NODE_302590_length_173_cov_184.351351	115	173	96	1	58	0.0172414
NODE_302590_length_173_cov_184.351351	115	173	99	1	58	0.0172414
NODE_302590_length_173_cov_184.351351	115	173	108	1	58	0.0172414
NODE_302590_length_173_cov_184.351351	115	173	111	1	58	0.0172414
NODE_302590_length_173_cov_184.351351	115	173	112	3	58	0.0517241
NODE_302590_length_173_cov_184.351351	115	173	114	1	58	0.0172414
NODE_302590_length_173_cov_184.351351	115	173	120	2	58	0.0344828
NODE_302590_length_173_cov_184.351351	115	173	122	1	58	0.0172414
NODE_302590_length_173_cov_184.351351	115	173	125	1	58	0.0172414
NODE_302590_length_173_cov_184.351351	115	173	129	2	58	0.0344828
NODE_302590_length_173_cov_184.351351	115	173	139	1	58	0.0172414
NODE_302590_length_173_cov_184.351351	115	173	146	1	58	0.0172414
NODE_302590_length_173_cov_184.351351	115	173	155	1	58	0.0172414
NODE_302590_length_173_cov_184.351351	115	173	156	1	58	0.0172414
NODE_302590_length_173_cov_184.351351	115	173	164	1	58	0.0172414
NODE_302590_length_173_cov_184.351351	115	173	166	1	58	0.0172414
NODE_302590_length_173_cov_184.351351	115	173	171	1	58	0.0172414
NODE_302590_length_173_cov_184.351351	115	173	174	2	58	0.0344828
NODE_302590_length_173_cov_184.351351	115	173	175	2	58	0.0344828
NODE_302590_length_173_cov_184.351351	115	173	182	1	58	0.0172414
NODE_302590_length_173_cov_184.351351	115	173	189	1	58	0.0172414
NODE_302590_length_173_cov_184.351351	115	173	198	1	58	0.0172414
NODE_302590_length_173_cov_184.351351	115	173	204	1	58	0.0172414
NODE_302590_length_173_cov_184.351351	115	173	210	1	58	0.0172414
NODE_302590_length_173_cov_184.351351	115	173	212	3	58	0.0517241
NODE_302590_length_173_cov_184.351351	115	173	216	2	58	0.0344828
NODE_302590_length_173_cov_184.351351	115	173	228	2	58	0.0344828
NODE_302590_length_173_cov_184.351351	115	173	232	1	58	0.0172414
NODE_302590_length_173_cov_184.351351	115	173	233	1	58	0.0172414
NODE_302590_length_173_cov_184.351351	115	173	235	1	58	0.0172414
NODE_302596_length_173_cov_58.472973	0	78	8	1	78	0.0128205
NODE_302596_length_173_cov_58.472973	0	78	10	2	78	0.0256410
NODE_302596_length_173_cov_58.472973	0	78	12	8	78	0.1025641
NODE_302596_length_173_cov_58.472973	0	78	22	1	78	0.0128205
NODE_302596_length_173_cov_58.472973	0	78	24	1	78	0.0128205
NODE_302596_length_173_cov_58.472973	0	78	27	2	78	0.0256410
NODE_302596_length_173_cov_58.472973	0	78	30	2	78	0.0256410
NODE_302596_length_173_cov_58.472973	0	78	31	1	78	0.0128205
NODE_302596_length_173_cov_58.472973	0	78	33	3	78	0.0384615
NODE_302596_length_173_cov_58.472973	0	78	34	1	78	0.0128205
NODE_302596_length_173_cov_58.472973	0	78	36	1	78	0.0128205
NODE_302596_length_173_cov_58.472973	0	78	38	1	78	0.0128205
NODE_302596_length_173_cov_58.472973	0	78	42	2	78	0.0256410
NODE_302596_length_173_cov_58.472973	0	78	46	1	78	0.0128205
NODE_302596_length_173_cov_58.472973	0	78	50	1	78	0.0128205
NODE_302596_length_173_cov_58.472973	0	78	52	3	78	0.0384615
NODE_302596_length_173_cov_58.472973	0	78	54	1	78	0.0128205
NODE_302596_length_173_cov_58.472973	0	78	56	1	78	0.0128205
NODE_302596_length_173_cov_58.472973	0	78	58	8	78	0.1025641
NODE_302596_length_173_cov_58.472973	0	78	62	5	78	0.0641026
NODE_302596_length_173_cov_58.472973	0	78	68	1	78	0.0128205
NODE_302596_length_173_cov_58.472973	0	78	70	2	78	0.0256410
NODE_302596_length_173_cov_58.472973	0	78	72	2	78	0.0256410
NODE_302596_length_173_cov_58.472973	0	78	74	1	78	0.0128205
NODE_302596_length_173_cov_58.472973	0	78	78	2	78	0.0256410
NODE_302596_length_173_cov_58.472973	0	78	80	1	78	0.0128205
NODE_302596_length_173_cov_58.472973	0	78	90	2	78	0.0256410
NODE_302596_length_173_cov_58.472973	0	78	94	3	78	0.0384615
NODE_302596_length_173_cov_58.472973	0	78	98	2	78	0.0256410
NODE_302596_length_173_cov_58.472973	0	78	100	1	78	0.0128205
NODE_302596_length_173_cov_58.472973	0	78	102	1	78	0.0128205
NODE_302596_length_173_cov_58.472973	0	78	106	1	78	0.0128205
NODE_302596_length_173_cov_58.472973	0	78	108	3	78	0.0384615
NODE_302596_length_173_cov_58.472973	0	78	110	10	78	0.1282051
NODE_302597_length_173_cov_57.148649	101	142	62	4	41	0.0975610
NODE_302597_length_173_cov_57.148649	101	142	64	1	41	0.0243902
NODE_302597_length_173_cov_57.148649	101	142	72	1	41	0.0243902
NODE_302597_length_173_cov_57.148649	101	142	78	2	41	0.0487805
NODE_302597_length_173_cov_57.148649	101	142	82	1	41	0.0243902
NODE_302597_length_173_cov_57.148649	101	142	84	4	41	0.0975610
NODE_302597_length_173_cov_57.148649	101	142	88	3	41	0.0731707
NODE_302597_length_173_cov_57.148649	101	142	92	1	41	0.0243902
NODE_302597_length_173_cov_57.148649	101	142	96	2	41	0.0487805
NODE_302597_length_173_cov_57.148649	101	142	98	1	41	0.0243902
NODE_302597_length_173_cov_57.148649	101	142	100	2	41	0.0487805
NODE_302597_length_173_cov_57.148649	101	142	104	1	41	0.0243902
NODE_302597_length_173_cov_57.148649	101	142	106	2	41	0.0487805
NODE_302597_length_173_cov_57.148649	101	142	110	9	41	0.2195122
NODE_302597_length_173_cov_57.148649	101	142	112	1	41	0.0243902
NODE_302597_length_173_cov_57.148649	101	142	120	2	41	0.0487805
NODE_302597_length_173_cov_57.148649	101	142	122	2	41	0.0487805
NODE_302597_length_173_cov_57.148649	101	142	124	2	41	0.0487805
NODE_302597_length_173_cov_57.148649	109	173	2	1	64	0.0156250
NODE_302597_length_173_cov_57.148649	109	173	4	6	64	0.0937500
NODE_302597_length_173_cov_57.148649	109	173	6	1	64	0.0156250
NODE_302597_length_173_cov_57.148649	109	173	8	2	64	0.0312500
NODE_302597_length_173_cov_57.148649	109	173	10	1	64	0.0156250
NODE_302597_length_173_cov_57.148649	109	173	14	1	64	0.0156250
NODE_302597_length_173_cov_57.148649	109	173	24	1	64	0.0156250
NODE_302597_length_173_cov_57.148649	109	173	33	1	64	0.0156250
NODE_302597_length_173_cov_57.148649	109	173	35	2	64	0.0312500
NODE_302597_length_173_cov_57.148649	109	173	37	2	64	0.0312500
NODE_302597_length_173_cov_57.148649	109	173	40	1	64	0.0156250
NODE_302597_length_173_cov_57.148649	109	173	42	2	64	0.0312500
NODE_302597_length_173_cov_57.148649	109	173	44	1	64	0.0156250
NODE_302597_length_173_cov_57.148649	109	173	48	1	64	0.0156250
NODE_302597_length_173_cov_57.148649	109	173	50	1	64	0.0156250
NODE_302597_length_173_cov_57.148649	109	173	52	1	64	0.0156250
NODE_302597_length_173_cov_57.148649	109	173	56	1	64	0.0156250
NODE_302597_length_173_cov_57.148649	109	173	58	2	64	0.0312500
NODE_302597_length_173_cov_57.148649	109	173	60	3	64	0.0468750
NODE_302597_length_173_cov_57.148649	109	173	62	4	64	0.0625000
NODE_302597_length_173_cov_57.148649	109	173	64	1	64	0.0156250
NODE_302597_length_173_cov_57.148649	109	173	72	1	64	0.0156250
NODE_302597_length_173_cov_57.148649	109	173	78	2	64	0.0312500
NODE_302597_length_173_cov_57.148649	109	173	82	1	64	0.0156250
NODE_302597_length_173_cov_57.148649	109	173	84	4	64	0.0625000
NODE_302597_length_173_cov_57.148649	109	173	88	3	64	0.0468750
NODE_302597_length_173_cov_57.148649	109	173	92	1	64	0.0156250
NODE_302597_length_173_cov_57.148649	109	173	96	2	64	0.0312500
NODE_302597_length_173_cov_57.148649	109	173	98	1	64	0.0156250
NODE_302597_length_173_cov_57.148649	109	173	100	2	64	0.0312500
NODE_302597_length_173_cov_57.148649	109	173	104	1	64	0.0156250
NODE_302597_length_173_cov_57.148649	109	173	106	2	64	0.0312500
NODE_302597_length_173_cov_57.148649	109	173	110	8	64	0.1250000
NODE_302686_length_171_cov_218.666667	12	90	11	6	78	0.0769231
NODE_302686_length_171_cov_218.666667	12	90	13	1	78	0.0128205
NODE_302686_length_171_cov_218.666667	12	90	14	1	78	0.0128205
NODE_302686_length_171_cov_218.666667	12	90	23	2	78	0.0256410
NODE_302686_length_171_cov_218.666667	12	90	24	5	78	0.0641026
NODE_302686_length_171_cov_218.666667	12	90	32	6	78	0.0769231
NODE_302686_length_171_cov_218.666667	12	90	40	5	78	0.0641026
NODE_302686_length_171_cov_218.666667	12	90	44	8	78	0.1025641
NODE_302686_length_171_cov_218.666667	12	90	46	10	78	0.1282051
NODE_302686_length_171_cov_218.666667	12	90	47	1	78	0.0128205
NODE_302686_length_171_cov_218.666667	12	90	48	8	78	0.1025641
NODE_302686_length_171_cov_218.666667	12	90	53	1	78	0.0128205
NODE_302686_length_171_cov_218.666667	12	90	54	24	78	0.3076923
NODE_302686_length_171_cov_218.666667	12	90	11	6	78	0.0769231
NODE_302686_length_171_cov_218.666667	12	90	13	1	78	0.0128205
NODE_302686_length_171_cov_218.666667	12	90	14	1	78	0.0128205
NODE_302686_length_171_cov_218.666667	12	90	23	2	78	0.0256410
NODE_302686_length_171_cov_218.666667	12	90	24	5	78	0.0641026
NODE_302686_length_171_cov_218.666667	12	90	32	6	78	0.0769231
NODE_302686_length_171_cov_218.666667	12	90	40	5	78	0.0641026
NODE_302686_length_171_cov_218.666667	12	90	44	8	78	0.1025641
NODE_302686_length_171_cov_218.666667	12	90	46	10	78	0.1282051
NODE_302686_length_171_cov_218.666667	12	90	47	1	78	0.0128205
NODE_302686_length_171_cov_218.666667	12	90	48	8	78	0.1025641
NODE_302686_length_171_cov_218.666667	12	90	53	1	78	0.0128205
NODE_302686_length_171_cov_218.666667	12	90	54	24	78	0.3076923
NODE_302686_length_171_cov_218.666667	21	90	23	1	69	0.0144928
NODE_302686_length_171_cov_218.666667	21	90	24	5	69	0.0724638
NODE_302686_length_171_cov_218.666667	21	90	32	6	69	0.0869565
NODE_302686_length_171_cov_218.666667	21	90	40	5	69	0.0724638
NODE_302686_length_171_cov_218.666667	21	90	44	8	69	0.1159420
NODE_302686_length_171_cov_218.666667	21	90	46	10	69	0.1449275
NODE_302686_length_171_cov_218.666667	21	90	47	1	69	0.0144928
NODE_302686_length_171_cov_218.666667	21	90	48	8	69	0.1159420
NODE_302686_length_171_cov_218.666667	21	90	53	1	69	0.0144928
NODE_302686_length_171_cov_218.666667	21	90	54	24	69	0.3478261
NODE_302689_length_171_cov_110.194444	81	161	0	3	80	0.0375000
NODE_302689_length_171_cov_110.194444	81	161	2	2	80	0.0250000
NODE_302689_length_171_cov_110.194444	81	161	4	75	80	0.9375000
NODE_302689_length_171_cov_110.194444	81	152	4	71	71	1.0000000
NODE_302691_length_171_cov_86.013889	106	171	0	8	65	0.1230769
NODE_302691_length_171_cov_86.013889	106	171	2	23	65	0.3538462
NODE_302691_length_171_cov_86.013889	106	171	4	34	65	0.5230770
NODE_302697_length_171_cov_46.430556	0	59	8	1	59	0.0169492
NODE_302697_length_171_cov_46.430556	0	59	10	1	59	0.0169492
NODE_302697_length_171_cov_46.430556	0	59	14	1	59	0.0169492
NODE_302697_length_171_cov_46.430556	0	59	18	1	59	0.0169492
NODE_302697_length_171_cov_46.430556	0	59	20	1	59	0.0169492
NODE_302697_length_171_cov_46.430556	0	59	22	1	59	0.0169492
NODE_302697_length_171_cov_46.430556	0	59	35	1	59	0.0169492
NODE_302697_length_171_cov_46.430556	0	59	49	2	59	0.0338983
NODE_302697_length_171_cov_46.430556	0	59	57	1	59	0.0169492
NODE_302697_length_171_cov_46.430556	0	59	61	1	59	0.0169492
NODE_302697_length_171_cov_46.430556	0	59	63	1	59	0.0169492
NODE_302697_length_171_cov_46.430556	0	59	64	1	59	0.0169492
NODE_302697_length_171_cov_46.430556	0	59	66	2	59	0.0338983
NODE_302697_length_171_cov_46.430556	0	59	68	1	59	0.0169492
NODE_302697_length_171_cov_46.430556	0	59	72	6	59	0.1016949
NODE_302697_length_171_cov_46.430556	0	59	78	1	59	0.0169492
NODE_302697_length_171_cov_46.430556	0	59	92	1	59	0.0169492
NODE_302697_length_171_cov_46.430556	0	59	94	1	59	0.0169492
NODE_302697_length_171_cov_46.430556	0	59	98	1	59	0.0169492
NODE_302697_length_171_cov_46.430556	0	59	100	1	59	0.0169492
NODE_302697_length_171_cov_46.430556	0	59	104	1	59	0.0169492
NODE_302697_length_171_cov_46.430556	0	59	114	1	59	0.0169492
NODE_302697_length_171_cov_46.430556	0	59	116	1	59	0.0169492
NODE_302697_length_171_cov_46.430556	0	59	128	3	59	0.0508475
NODE_302697_length_171_cov_46.430556	0	59	132	1	59	0.0169492
NODE_302697_length_171_cov_46.430556	0	59	136	1	59	0.0169492
NODE_302697_length_171_cov_46.430556	0	59	146	1	59	0.0169492
NODE_302697_length_171_cov_46.430556	0	59	150	1	59	0.0169492
NODE_302697_length_171_cov_46.430556	0	59	154	1	59	0.0169492
NODE_302697_length_171_cov_46.430556	0	59	160	2	59	0.0338983
NODE_302697_length_171_cov_46.430556	0	59	164	4	59	0.0677966
NODE_302697_length_171_cov_46.430556	0	59	166	4	59	0.0677966
NODE_302697_length_171_cov_46.430556	0	59	172	2	59	0.0338983
NODE_302697_length_171_cov_46.430556	0	59	176	1	59	0.0169492
NODE_302697_length_171_cov_46.430556	0	59	180	5	59	0.0847458
NODE_302697_length_171_cov_46.430556	0	59	186	1	59	0.0169492
NODE_302697_length_171_cov_46.430556	0	59	188	1	59	0.0169492
NODE_302697_length_171_cov_46.430556	0	59	192	1	59	0.0169492
NODE_302697_length_171_cov_46.430556	32	98	128	1	66	0.0151515
NODE_302697_length_171_cov_46.430556	32	98	132	1	66	0.0151515
NODE_302697_length_171_cov_46.430556	32	98	136	1	66	0.0151515
NODE_302697_length_171_cov_46.430556	32	98	146	1	66	0.0151515
NODE_302697_length_171_cov_46.430556	32	98	150	1	66	0.0151515
NODE_302697_length_171_cov_46.430556	32	98	154	1	66	0.0151515
NODE_302697_length_171_cov_46.430556	32	98	160	2	66	0.0303030
NODE_302697_length_171_cov_46.430556	32	98	164	4	66	0.0606061
NODE_302697_length_171_cov_46.430556	32	98	166	4	66	0.0606061
NODE_302697_length_171_cov_46.430556	32	98	172	2	66	0.0303030
NODE_302697_length_171_cov_46.430556	32	98	176	1	66	0.0151515
NODE_302697_length_171_cov_46.430556	32	98	180	5	66	0.0757576
NODE_302697_length_171_cov_46.430556	32	98	186	1	66	0.0151515
NODE_302697_length_171_cov_46.430556	32	98	188	1	66	0.0151515
NODE_302697_length_171_cov_46.430556	32	98	192	1	66	0.0151515
NODE_302697_length_171_cov_46.430556	32	98	194	1	66	0.0151515
NODE_302697_length_171_cov_46.430556	32	98	198	1	66	0.0151515
NODE_302697_length_171_cov_46.430556	32	98	200	6	66	0.0909091
NODE_302697_length_171_cov_46.430556	32	98	202	31	66	0.4696970
NODE_302700_length_171_cov_40.069444	13	87	0	22	74	0.2972973
NODE_302700_length_171_cov_40.069444	13	87	1	52	74	0.7027027
NODE_302702_length_171_cov_33.319444	84	158	21	4	74	0.0540541
NODE_302702_length_171_cov_33.319444	84	158	25	5	74	0.0675676
NODE_302702_length_171_cov_33.319444	84	158	29	3	74	0.0405405
NODE_302702_length_171_cov_33.319444	84	158	31	3	74	0.0405405
NODE_302702_length_171_cov_33.319444	84	158	35	16	74	0.2162162
NODE_302702_length_171_cov_33.319444	84	158	36	10	74	0.1351351
NODE_302702_length_171_cov_33.319444	84	158	38	33	74	0.4459459
NODE_302764_length_170_cov_217.422535	10	90	19	1	80	0.0125000
NODE_302764_length_170_cov_217.422535	10	90	42	1	80	0.0125000
NODE_302764_length_170_cov_217.422535	10	90	48	1	80	0.0125000
NODE_302764_length_170_cov_217.422535	10	90	50	1	80	0.0125000
NODE_302764_length_170_cov_217.422535	10	90	82	2	80	0.0250000
NODE_302764_length_170_cov_217.422535	10	90	96	1	80	0.0125000
NODE_302764_length_170_cov_217.422535	10	90	104	2	80	0.0250000
NODE_302764_length_170_cov_217.422535	10	90	107	2	80	0.0250000
NODE_302764_length_170_cov_217.422535	10	90	116	1	80	0.0125000
NODE_302764_length_170_cov_217.422535	10	90	117	2	80	0.0250000
NODE_302764_length_170_cov_217.422535	10	90	122	3	80	0.0375000
NODE_302764_length_170_cov_217.422535	10	90	126	1	80	0.0125000
NODE_302764_length_170_cov_217.422535	10	90	131	3	80	0.0375000
NODE_302764_length_170_cov_217.422535	10	90	138	1	80	0.0125000
NODE_302764_length_170_cov_217.422535	10	90	140	2	80	0.0250000
NODE_302764_length_170_cov_217.422535	10	90	144	2	80	0.0250000
NODE_302764_length_170_cov_217.422535	10	90	150	1	80	0.0125000
NODE_302764_length_170_cov_217.422535	10	90	151	1	80	0.0125000
NODE_302764_length_170_cov_217.422535	10	90	153	2	80	0.0250000
NODE_302764_length_170_cov_217.422535	10	90	154	1	80	0.0125000
NODE_302764_length_170_cov_217.422535	10	90	161	1	80	0.0125000
NODE_302764_length_170_cov_217.422535	10	90	169	1	80	0.0125000
NODE_302764_length_170_cov_217.422535	10	90	179	1	80	0.0125000
NODE_302764_length_170_cov_217.422535	10	90	181	1	80	0.0125000
NODE_302764_length_170_cov_217.422535	10	90	182	1	80	0.0125000
NODE_302764_length_170_cov_217.422535	10	90	186	1	80	0.0125000
NODE_302764_length_170_cov_217.422535	10	90	190	1	80	0.0125000
NODE_302764_length_170_cov_217.422535	10	90	192	1	80	0.0125000
NODE_302764_length_170_cov_217.422535	10	90	197	1	80	0.0125000
NODE_302764_length_170_cov_217.422535	10	90	199	1	80	0.0125000
NODE_302764_length_170_cov_217.422535	10	90	201	2	80	0.0250000
NODE_302764_length_170_cov_217.422535	10	90	207	1	80	0.0125000
NODE_302764_length_170_cov_217.422535	10	90	219	1	80	0.0125000
NODE_302764_length_170_cov_217.422535	10	90	221	1	80	0.0125000
NODE_302764_length_170_cov_217.422535	10	90	223	1	80	0.0125000
NODE_302764_length_170_cov_217.422535	10	90	224	1	80	0.0125000
NODE_302764_length_170_cov_217.422535	10	90	229	1	80	0.0125000
NODE_302764_length_170_cov_217.422535	10	90	233	4	80	0.0500000
NODE_302764_length_170_cov_217.422535	10	90	237	13	80	0.1625000
NODE_302764_length_170_cov_217.422535	10	90	238	14	80	0.1750000
NODE_302764_length_170_cov_217.422535	10	90	19	1	80	0.0125000
NODE_302764_length_170_cov_217.422535	10	90	42	1	80	0.0125000
NODE_302764_length_170_cov_217.422535	10	90	48	1	80	0.0125000
NODE_302764_length_170_cov_217.422535	10	90	50	1	80	0.0125000
NODE_302764_length_170_cov_217.422535	10	90	82	2	80	0.0250000
NODE_302764_length_170_cov_217.422535	10	90	96	1	80	0.0125000
NODE_302764_length_170_cov_217.422535	10	90	104	2	80	0.0250000
NODE_302764_length_170_cov_217.422535	10	90	107	2	80	0.0250000
NODE_302764_length_170_cov_217.422535	10	90	116	1	80	0.0125000
NODE_302764_length_170_cov_217.422535	10	90	117	2	80	0.0250000
NODE_302764_length_170_cov_217.422535	10	90	122	3	80	0.0375000
NODE_302764_length_170_cov_217.422535	10	90	126	1	80	0.0125000
NODE_302764_length_170_cov_217.422535	10	90	131	3	80	0.0375000
NODE_302764_length_170_cov_217.422535	10	90	138	1	80	0.0125000
NODE_302764_length_170_cov_217.422535	10	90	140	2	80	0.0250000
NODE_302764_length_170_cov_217.422535	10	90	144	2	80	0.0250000
NODE_302764_length_170_cov_217.422535	10	90	150	1	80	0.0125000
NODE_302764_length_170_cov_217.422535	10	90	151	1	80	0.0125000
NODE_302764_length_170_cov_217.422535	10	90	153	2	80	0.0250000
NODE_302764_length_170_cov_217.422535	10	90	154	1	80	0.0125000
NODE_302764_length_170_cov_217.422535	10	90	161	1	80	0.0125000
NODE_302764_length_170_cov_217.422535	10	90	169	1	80	0.0125000
NODE_302764_length_170_cov_217.422535	10	90	179	1	80	0.0125000
NODE_302764_length_170_cov_217.422535	10	90	181	1	80	0.0125000
NODE_302764_length_170_cov_217.422535	10	90	182	1	80	0.0125000
NODE_302764_length_170_cov_217.422535	10	90	186	1	80	0.0125000
NODE_302764_length_170_cov_217.422535	10	90	190	1	80	0.0125000
NODE_302764_length_170_cov_217.422535	10	90	192	1	80	0.0125000
NODE_302764_length_170_cov_217.422535	10	90	197	1	80	0.0125000
NODE_302764_length_170_cov_217.422535	10	90	199	1	80	0.0125000
NODE_302764_length_170_cov_217.422535	10	90	201	2	80	0.0250000
NODE_302764_length_170_cov_217.422535	10	90	207	1	80	0.0125000
NODE_302764_length_170_cov_217.422535	10	90	219	1	80	0.0125000
NODE_302764_length_170_cov_217.422535	10	90	221	1	80	0.0125000
NODE_302764_length_170_cov_217.422535	10	90	223	1	80	0.0125000
NODE_302764_length_170_cov_217.422535	10	90	224	1	80	0.0125000
NODE_302764_length_170_cov_217.422535	10	90	229	1	80	0.0125000
NODE_302764_length_170_cov_217.422535	10	90	233	4	80	0.0500000
NODE_302764_length_170_cov_217.422535	10	90	237	13	80	0.1625000
NODE_302764_length_170_cov_217.422535	10	90	238	14	80	0.1750000
NODE_302764_length_170_cov_217.422535	10	90	19	1	80	0.0125000
NODE_302764_length_170_cov_217.422535	10	90	42	1	80	0.0125000
NODE_302764_length_170_cov_217.422535	10	90	48	1	80	0.0125000
NODE_302764_length_170_cov_217.422535	10	90	50	1	80	0.0125000
NODE_302764_length_170_cov_217.422535	10	90	82	2	80	0.0250000
NODE_302764_length_170_cov_217.422535	10	90	96	1	80	0.0125000
NODE_302764_length_170_cov_217.422535	10	90	104	2	80	0.0250000
NODE_302764_length_170_cov_217.422535	10	90	107	2	80	0.0250000
NODE_302764_length_170_cov_217.422535	10	90	116	1	80	0.0125000
NODE_302764_length_170_cov_217.422535	10	90	117	2	80	0.0250000
NODE_302764_length_170_cov_217.422535	10	90	122	3	80	0.0375000
NODE_302764_length_170_cov_217.422535	10	90	126	1	80	0.0125000
NODE_302764_length_170_cov_217.422535	10	90	131	3	80	0.0375000
NODE_302764_length_170_cov_217.422535	10	90	138	1	80	0.0125000
NODE_302764_length_170_cov_217.422535	10	90	140	2	80	0.0250000
NODE_302764_length_170_cov_217.422535	10	90	144	2	80	0.0250000
NODE_302764_length_170_cov_217.422535	10	90	150	1	80	0.0125000
NODE_302764_length_170_cov_217.422535	10	90	151	1	80	0.0125000
NODE_302764_length_170_cov_217.422535	10	90	153	2	80	0.0250000
NODE_302764_length_170_cov_217.422535	10	90	154	1	80	0.0125000
NODE_302764_length_170_cov_217.422535	10	90	161	1	80	0.0125000
NODE_302764_length_170_cov_217.422535	10	90	169	1	80	0.0125000
NODE_302764_length_170_cov_217.422535	10	90	179	1	80	0.0125000
NODE_302764_length_170_cov_217.422535	10	90	181	1	80	0.0125000
NODE_302764_length_170_cov_217.422535	10	90	182	1	80	0.0125000
NODE_302764_length_170_cov_217.422535	10	90	186	1	80	0.0125000
NODE_302764_length_170_cov_217.422535	10	90	190	1	80	0.0125000
NODE_302764_length_170_cov_217.422535	10	90	192	1	80	0.0125000
NODE_302764_length_170_cov_217.422535	10	90	197	1	80	0.0125000
NODE_302764_length_170_cov_217.422535	10	90	199	1	80	0.0125000
NODE_302764_length_170_cov_217.422535	10	90	201	2	80	0.0250000
NODE_302764_length_170_cov_217.422535	10	90	207	1	80	0.0125000
NODE_302764_length_170_cov_217.422535	10	90	219	1	80	0.0125000
NODE_302764_length_170_cov_217.422535	10	90	221	1	80	0.0125000
NODE_302764_length_170_cov_217.422535	10	90	223	1	80	0.0125000
NODE_302764_length_170_cov_217.422535	10	90	224	1	80	0.0125000
NODE_302764_length_170_cov_217.422535	10	90	229	1	80	0.0125000
NODE_302764_length_170_cov_217.422535	10	90	233	4	80	0.0500000
NODE_302764_length_170_cov_217.422535	10	90	237	13	80	0.1625000
NODE_302764_length_170_cov_217.422535	10	90	238	14	80	0.1750000
NODE_302764_length_170_cov_217.422535	10	90	19	1	80	0.0125000
NODE_302764_length_170_cov_217.422535	10	90	42	1	80	0.0125000
NODE_302764_length_170_cov_217.422535	10	90	48	1	80	0.0125000
NODE_302764_length_170_cov_217.422535	10	90	50	1	80	0.0125000
NODE_302764_length_170_cov_217.422535	10	90	82	2	80	0.0250000
NODE_302764_length_170_cov_217.422535	10	90	96	1	80	0.0125000
NODE_302764_length_170_cov_217.422535	10	90	104	2	80	0.0250000
NODE_302764_length_170_cov_217.422535	10	90	107	2	80	0.0250000
NODE_302764_length_170_cov_217.422535	10	90	116	1	80	0.0125000
NODE_302764_length_170_cov_217.422535	10	90	117	2	80	0.0250000
NODE_302764_length_170_cov_217.422535	10	90	122	3	80	0.0375000
NODE_302764_length_170_cov_217.422535	10	90	126	1	80	0.0125000
NODE_302764_length_170_cov_217.422535	10	90	131	3	80	0.0375000
NODE_302764_length_170_cov_217.422535	10	90	138	1	80	0.0125000
NODE_302764_length_170_cov_217.422535	10	90	140	2	80	0.0250000
NODE_302764_length_170_cov_217.422535	10	90	144	2	80	0.0250000
NODE_302764_length_170_cov_217.422535	10	90	150	1	80	0.0125000
NODE_302764_length_170_cov_217.422535	10	90	151	1	80	0.0125000
NODE_302764_length_170_cov_217.422535	10	90	153	2	80	0.0250000
NODE_302764_length_170_cov_217.422535	10	90	154	1	80	0.0125000
NODE_302764_length_170_cov_217.422535	10	90	161	1	80	0.0125000
NODE_302764_length_170_cov_217.422535	10	90	169	1	80	0.0125000
NODE_302764_length_170_cov_217.422535	10	90	179	1	80	0.0125000
NODE_302764_length_170_cov_217.422535	10	90	181	1	80	0.0125000
NODE_302764_length_170_cov_217.422535	10	90	182	1	80	0.0125000
NODE_302764_length_170_cov_217.422535	10	90	186	1	80	0.0125000
NODE_302764_length_170_cov_217.422535	10	90	190	1	80	0.0125000
NODE_302764_length_170_cov_217.422535	10	90	192	1	80	0.0125000
NODE_302764_length_170_cov_217.422535	10	90	197	1	80	0.0125000
NODE_302764_length_170_cov_217.422535	10	90	199	1	80	0.0125000
NODE_302764_length_170_cov_217.422535	10	90	201	2	80	0.0250000
NODE_302764_length_170_cov_217.422535	10	90	207	1	80	0.0125000
NODE_302764_length_170_cov_217.422535	10	90	219	1	80	0.0125000
NODE_302764_length_170_cov_217.422535	10	90	221	1	80	0.0125000
NODE_302764_length_170_cov_217.422535	10	90	223	1	80	0.0125000
NODE_302764_length_170_cov_217.422535	10	90	224	1	80	0.0125000
NODE_302764_length_170_cov_217.422535	10	90	229	1	80	0.0125000
NODE_302764_length_170_cov_217.422535	10	90	233	4	80	0.0500000
NODE_302764_length_170_cov_217.422535	10	90	237	13	80	0.1625000
NODE_302764_length_170_cov_217.422535	10	90	238	14	80	0.1750000
NODE_302764_length_170_cov_217.422535	10	90	19	1	80	0.0125000
NODE_302764_length_170_cov_217.422535	10	90	42	1	80	0.0125000
NODE_302764_length_170_cov_217.422535	10	90	48	1	80	0.0125000
NODE_302764_length_170_cov_217.422535	10	90	50	1	80	0.0125000
NODE_302764_length_170_cov_217.422535	10	90	82	2	80	0.0250000
NODE_302764_length_170_cov_217.422535	10	90	96	1	80	0.0125000
NODE_302764_length_170_cov_217.422535	10	90	104	2	80	0.0250000
NODE_302764_length_170_cov_217.422535	10	90	107	2	80	0.0250000
NODE_302764_length_170_cov_217.422535	10	90	116	1	80	0.0125000
NODE_302764_length_170_cov_217.422535	10	90	117	2	80	0.0250000
NODE_302764_length_170_cov_217.422535	10	90	122	3	80	0.0375000
NODE_302764_length_170_cov_217.422535	10	90	126	1	80	0.0125000
NODE_302764_length_170_cov_217.422535	10	90	131	3	80	0.0375000
NODE_302764_length_170_cov_217.422535	10	90	138	1	80	0.0125000
NODE_302764_length_170_cov_217.422535	10	90	140	2	80	0.0250000
NODE_302764_length_170_cov_217.422535	10	90	144	2	80	0.0250000
NODE_302764_length_170_cov_217.422535	10	90	150	1	80	0.0125000
NODE_302764_length_170_cov_217.422535	10	90	151	1	80	0.0125000
NODE_302764_length_170_cov_217.422535	10	90	153	2	80	0.0250000
NODE_302764_length_170_cov_217.422535	10	90	154	1	80	0.0125000
NODE_302764_length_170_cov_217.422535	10	90	161	1	80	0.0125000
NODE_302764_length_170_cov_217.422535	10	90	169	1	80	0.0125000
NODE_302764_length_170_cov_217.422535	10	90	179	1	80	0.0125000
NODE_302764_length_170_cov_217.422535	10	90	181	1	80	0.0125000
NODE_302764_length_170_cov_217.422535	10	90	182	1	80	0.0125000
NODE_302764_length_170_cov_217.422535	10	90	186	1	80	0.0125000
NODE_302764_length_170_cov_217.422535	10	90	190	1	80	0.0125000
NODE_302764_length_170_cov_217.422535	10	90	192	1	80	0.0125000
NODE_302764_length_170_cov_217.422535	10	90	197	1	80	0.0125000
NODE_302764_length_170_cov_217.422535	10	90	199	1	80	0.0125000
NODE_302764_length_170_cov_217.422535	10	90	201	2	80	0.0250000
NODE_302764_length_170_cov_217.422535	10	90	207	1	80	0.0125000
NODE_302764_length_170_cov_217.422535	10	90	219	1	80	0.0125000
NODE_302764_length_170_cov_217.422535	10	90	221	1	80	0.0125000
NODE_302764_length_170_cov_217.422535	10	90	223	1	80	0.0125000
NODE_302764_length_170_cov_217.422535	10	90	224	1	80	0.0125000
NODE_302764_length_170_cov_217.422535	10	90	229	1	80	0.0125000
NODE_302764_length_170_cov_217.422535	10	90	233	4	80	0.0500000
NODE_302764_length_170_cov_217.422535	10	90	237	13	80	0.1625000
NODE_302764_length_170_cov_217.422535	10	90	238	14	80	0.1750000
NODE_302764_length_170_cov_217.422535	19	90	107	2	71	0.0281690
NODE_302764_length_170_cov_217.422535	19	90	116	1	71	0.0140845
NODE_302764_length_170_cov_217.422535	19	90	117	2	71	0.0281690
NODE_302764_length_170_cov_217.422535	19	90	122	3	71	0.0422535
NODE_302764_length_170_cov_217.422535	19	90	126	1	71	0.0140845
NODE_302764_length_170_cov_217.422535	19	90	131	3	71	0.0422535
NODE_302764_length_170_cov_217.422535	19	90	138	1	71	0.0140845
NODE_302764_length_170_cov_217.422535	19	90	140	2	71	0.0281690
NODE_302764_length_170_cov_217.422535	19	90	144	2	71	0.0281690
NODE_302764_length_170_cov_217.422535	19	90	150	1	71	0.0140845
NODE_302764_length_170_cov_217.422535	19	90	151	1	71	0.0140845
NODE_302764_length_170_cov_217.422535	19	90	153	2	71	0.0281690
NODE_302764_length_170_cov_217.422535	19	90	154	1	71	0.0140845
NODE_302764_length_170_cov_217.422535	19	90	161	1	71	0.0140845
NODE_302764_length_170_cov_217.422535	19	90	169	1	71	0.0140845
NODE_302764_length_170_cov_217.422535	19	90	179	1	71	0.0140845
NODE_302764_length_170_cov_217.422535	19	90	181	1	71	0.0140845
NODE_302764_length_170_cov_217.422535	19	90	182	1	71	0.0140845
NODE_302764_length_170_cov_217.422535	19	90	186	1	71	0.0140845
NODE_302764_length_170_cov_217.422535	19	90	190	1	71	0.0140845
NODE_302764_length_170_cov_217.422535	19	90	192	1	71	0.0140845
NODE_302764_length_170_cov_217.422535	19	90	197	1	71	0.0140845
NODE_302764_length_170_cov_217.422535	19	90	199	1	71	0.0140845
NODE_302764_length_170_cov_217.422535	19	90	201	2	71	0.0281690
NODE_302764_length_170_cov_217.422535	19	90	207	1	71	0.0140845
NODE_302764_length_170_cov_217.422535	19	90	219	1	71	0.0140845
NODE_302764_length_170_cov_217.422535	19	90	221	1	71	0.0140845
NODE_302764_length_170_cov_217.422535	19	90	223	1	71	0.0140845
NODE_302764_length_170_cov_217.422535	19	90	224	1	71	0.0140845
NODE_302764_length_170_cov_217.422535	19	90	229	1	71	0.0140845
NODE_302764_length_170_cov_217.422535	19	90	233	4	71	0.0563380
NODE_302764_length_170_cov_217.422535	19	90	237	13	71	0.1830986
NODE_302764_length_170_cov_217.422535	19	90	238	14	71	0.1971831
NODE_302764_length_170_cov_217.422535	63	126	157	1	63	0.0158730
NODE_302764_length_170_cov_217.422535	63	126	173	1	63	0.0158730
NODE_302764_length_170_cov_217.422535	63	126	175	1	63	0.0158730
NODE_302764_length_170_cov_217.422535	63	126	179	4	63	0.0634921
NODE_302764_length_170_cov_217.422535	63	126	208	2	63	0.0317460
NODE_302764_length_170_cov_217.422535	63	126	209	5	63	0.0793651
NODE_302764_length_170_cov_217.422535	63	126	224	1	63	0.0158730
NODE_302764_length_170_cov_217.422535	63	126	228	1	63	0.0158730
NODE_302764_length_170_cov_217.422535	63	126	231	2	63	0.0317460
NODE_302764_length_170_cov_217.422535	63	126	237	31	63	0.4920635
NODE_302764_length_170_cov_217.422535	63	126	238	14	63	0.2222222
NODE_302764_length_170_cov_217.422535	63	126	157	1	63	0.0158730
NODE_302764_length_170_cov_217.422535	63	126	173	1	63	0.0158730
NODE_302764_length_170_cov_217.422535	63	126	175	1	63	0.0158730
NODE_302764_length_170_cov_217.422535	63	126	179	4	63	0.0634921
NODE_302764_length_170_cov_217.422535	63	126	208	2	63	0.0317460
NODE_302764_length_170_cov_217.422535	63	126	209	5	63	0.0793651
NODE_302764_length_170_cov_217.422535	63	126	224	1	63	0.0158730
NODE_302764_length_170_cov_217.422535	63	126	228	1	63	0.0158730
NODE_302764_length_170_cov_217.422535	63	126	231	2	63	0.0317460
NODE_302764_length_170_cov_217.422535	63	126	237	31	63	0.4920635
NODE_302764_length_170_cov_217.422535	63	126	238	14	63	0.2222222
NODE_302768_length_170_cov_102.816901	23	86	68	1	63	0.0158730
NODE_302768_length_170_cov_102.816901	23	86	73	1	63	0.0158730
NODE_302768_length_170_cov_102.816901	23	86	79	6	63	0.0952381
NODE_302768_length_170_cov_102.816901	23	86	81	15	63	0.2380952
NODE_302768_length_170_cov_102.816901	23	86	82	14	63	0.2222222
NODE_302768_length_170_cov_102.816901	23	86	83	6	63	0.0952381
NODE_302768_length_170_cov_102.816901	23	86	87	1	63	0.0158730
NODE_302768_length_170_cov_102.816901	23	86	89	19	63	0.3015873
NODE_302806_length_169_cov_47.757143	70	150	46	2	80	0.0250000
NODE_302806_length_169_cov_47.757143	70	150	50	4	80	0.0500000
NODE_302806_length_169_cov_47.757143	70	150	62	3	80	0.0375000
NODE_302806_length_169_cov_47.757143	70	150	72	3	80	0.0375000
NODE_302806_length_169_cov_47.757143	70	150	77	3	80	0.0375000
NODE_302806_length_169_cov_47.757143	70	150	89	8	80	0.1000000
NODE_302806_length_169_cov_47.757143	70	150	93	2	80	0.0250000
NODE_302806_length_169_cov_47.757143	70	150	95	1	80	0.0125000
NODE_302806_length_169_cov_47.757143	70	150	104	1	80	0.0125000
NODE_302806_length_169_cov_47.757143	70	150	105	2	80	0.0250000
NODE_302806_length_169_cov_47.757143	70	150	106	1	80	0.0125000
NODE_302806_length_169_cov_47.757143	70	150	107	12	80	0.1500000
NODE_302806_length_169_cov_47.757143	70	150	109	1	80	0.0125000
NODE_302806_length_169_cov_47.757143	70	150	115	1	80	0.0125000
NODE_302806_length_169_cov_47.757143	70	150	116	36	80	0.4500000
NODE_302869_length_168_cov_10.391304	66	99	0	33	33	1.0000000
NODE_302869_length_168_cov_10.391304	135	168	0	33	33	1.0000000
NODE_302966_length_166_cov_401.149254	31	109	39	2	78	0.0256410
NODE_302966_length_166_cov_401.149254	31	109	47	1	78	0.0128205
NODE_302966_length_166_cov_401.149254	31	109	49	1	78	0.0128205
NODE_302966_length_166_cov_401.149254	31	109	53	2	78	0.0256410
NODE_302966_length_166_cov_401.149254	31	109	63	1	78	0.0128205
NODE_302966_length_166_cov_401.149254	31	109	67	1	78	0.0128205
NODE_302966_length_166_cov_401.149254	31	109	77	1	78	0.0128205
NODE_302966_length_166_cov_401.149254	31	109	81	3	78	0.0384615
NODE_302966_length_166_cov_401.149254	31	109	93	3	78	0.0384615
NODE_302966_length_166_cov_401.149254	31	109	97	1	78	0.0128205
NODE_302966_length_166_cov_401.149254	31	109	98	4	78	0.0512821
NODE_302966_length_166_cov_401.149254	31	109	100	2	78	0.0256410
NODE_302966_length_166_cov_401.149254	31	109	106	1	78	0.0128205
NODE_302966_length_166_cov_401.149254	31	109	110	2	78	0.0256410
NODE_302966_length_166_cov_401.149254	31	109	111	3	78	0.0384615
NODE_302966_length_166_cov_401.149254	31	109	116	1	78	0.0128205
NODE_302966_length_166_cov_401.149254	31	109	117	4	78	0.0512821
NODE_302966_length_166_cov_401.149254	31	109	119	41	78	0.5256410
NODE_302966_length_166_cov_401.149254	31	109	120	4	78	0.0512821
NODE_302966_length_166_cov_401.149254	82	157	8	1	75	0.0133333
NODE_302966_length_166_cov_401.149254	82	157	12	1	75	0.0133333
NODE_302966_length_166_cov_401.149254	82	157	18	6	75	0.0800000
NODE_302966_length_166_cov_401.149254	82	157	24	2	75	0.0266667
NODE_302966_length_166_cov_401.149254	82	157	37	1	75	0.0133333
NODE_302966_length_166_cov_401.149254	82	157	38	1	75	0.0133333
NODE_302966_length_166_cov_401.149254	82	157	42	1	75	0.0133333
NODE_302966_length_166_cov_401.149254	82	157	44	1	75	0.0133333
NODE_302966_length_166_cov_401.149254	82	157	46	2	75	0.0266667
NODE_302966_length_166_cov_401.149254	82	157	52	4	75	0.0533333
NODE_302966_length_166_cov_401.149254	82	157	58	1	75	0.0133333
NODE_302966_length_166_cov_401.149254	82	157	74	2	75	0.0266667
NODE_302966_length_166_cov_401.149254	82	157	76	1	75	0.0133333
NODE_302966_length_166_cov_401.149254	82	157	80	1	75	0.0133333
NODE_302966_length_166_cov_401.149254	82	157	84	3	75	0.0400000
NODE_302966_length_166_cov_401.149254	82	157	86	4	75	0.0533333
NODE_302966_length_166_cov_401.149254	82	157	88	4	75	0.0533333
NODE_302966_length_166_cov_401.149254	82	157	90	2	75	0.0266667
NODE_302966_length_166_cov_401.149254	82	157	98	4	75	0.0533333
NODE_302966_length_166_cov_401.149254	82	157	100	1	75	0.0133333
NODE_302966_length_166_cov_401.149254	82	157	102	1	75	0.0133333
NODE_302966_length_166_cov_401.149254	82	157	112	1	75	0.0133333
NODE_302966_length_166_cov_401.149254	82	157	114	1	75	0.0133333
NODE_302966_length_166_cov_401.149254	82	157	116	1	75	0.0133333
NODE_302966_length_166_cov_401.149254	82	157	118	1	75	0.0133333
NODE_302966_length_166_cov_401.149254	82	157	119	23	75	0.3066667
NODE_302966_length_166_cov_401.149254	82	157	120	4	75	0.0533333
NODE_302974_length_166_cov_123.223881	46	97	16	10	51	0.1960784
NODE_302974_length_166_cov_123.223881	46	97	22	41	51	0.8039216
NODE_303071_length_164_cov_154.076923	0	75	0	40	75	0.5333334
NODE_303071_length_164_cov_154.076923	0	75	4	35	75	0.4666667
NODE_303071_length_164_cov_154.076923	48	128	4	80	80	1.0000000
NODE_303074_length_164_cov_69.369231	0	64	0	64	64	1.0000000
NODE_303079_length_164_cov_43.923077	36	100	70	12	64	0.1875000
NODE_303079_length_164_cov_43.923077	36	100	72	4	64	0.0625000
NODE_303079_length_164_cov_43.923077	36	100	73	1	64	0.0156250
NODE_303079_length_164_cov_43.923077	36	100	74	5	64	0.0781250
NODE_303079_length_164_cov_43.923077	36	100	78	42	64	0.6562500
NODE_303079_length_164_cov_43.923077	36	100	70	12	64	0.1875000
NODE_303079_length_164_cov_43.923077	36	100	72	4	64	0.0625000
NODE_303079_length_164_cov_43.923077	36	100	73	1	64	0.0156250
NODE_303079_length_164_cov_43.923077	36	100	74	5	64	0.0781250
NODE_303079_length_164_cov_43.923077	36	100	78	42	64	0.6562500
NODE_303079_length_164_cov_43.923077	73	153	37	1	80	0.0125000
NODE_303079_length_164_cov_43.923077	73	153	45	7	80	0.0875000
NODE_303079_length_164_cov_43.923077	73	153	46	3	80	0.0375000
NODE_303079_length_164_cov_43.923077	73	153	47	9	80	0.1125000
NODE_303079_length_164_cov_43.923077	73	153	49	1	80	0.0125000
NODE_303079_length_164_cov_43.923077	73	153	51	5	80	0.0625000
NODE_303079_length_164_cov_43.923077	73	153	53	1	80	0.0125000
NODE_303079_length_164_cov_43.923077	73	153	58	4	80	0.0500000
NODE_303079_length_164_cov_43.923077	73	153	60	1	80	0.0125000
NODE_303079_length_164_cov_43.923077	73	153	64	1	80	0.0125000
NODE_303079_length_164_cov_43.923077	73	153	72	9	80	0.1125000
NODE_303079_length_164_cov_43.923077	73	153	76	9	80	0.1125000
NODE_303079_length_164_cov_43.923077	73	153	78	29	80	0.3625000
NODE_303079_length_164_cov_43.923077	73	153	37	1	80	0.0125000
NODE_303079_length_164_cov_43.923077	73	153	45	7	80	0.0875000
NODE_303079_length_164_cov_43.923077	73	153	46	3	80	0.0375000
NODE_303079_length_164_cov_43.923077	73	153	47	9	80	0.1125000
NODE_303079_length_164_cov_43.923077	73	153	49	1	80	0.0125000
NODE_303079_length_164_cov_43.923077	73	153	51	5	80	0.0625000
NODE_303079_length_164_cov_43.923077	73	153	53	1	80	0.0125000
NODE_303079_length_164_cov_43.923077	73	153	58	4	80	0.0500000
NODE_303079_length_164_cov_43.923077	73	153	60	1	80	0.0125000
NODE_303079_length_164_cov_43.923077	73	153	64	1	80	0.0125000
NODE_303079_length_164_cov_43.923077	73	153	72	9	80	0.1125000
NODE_303079_length_164_cov_43.923077	73	153	76	9	80	0.1125000
NODE_303079_length_164_cov_43.923077	73	153	78	29	80	0.3625000
NODE_303079_length_164_cov_43.923077	73	153	37	1	80	0.0125000
NODE_303079_length_164_cov_43.923077	73	153	45	7	80	0.0875000
NODE_303079_length_164_cov_43.923077	73	153	46	3	80	0.0375000
NODE_303079_length_164_cov_43.923077	73	153	47	9	80	0.1125000
NODE_303079_length_164_cov_43.923077	73	153	49	1	80	0.0125000
NODE_303079_length_164_cov_43.923077	73	153	51	5	80	0.0625000
NODE_303079_length_164_cov_43.923077	73	153	53	1	80	0.0125000
NODE_303079_length_164_cov_43.923077	73	153	58	4	80	0.0500000
NODE_303079_length_164_cov_43.923077	73	153	60	1	80	0.0125000
NODE_303079_length_164_cov_43.923077	73	153	64	1	80	0.0125000
NODE_303079_length_164_cov_43.923077	73	153	72	9	80	0.1125000
NODE_303079_length_164_cov_43.923077	73	153	76	9	80	0.1125000
NODE_303079_length_164_cov_43.923077	73	153	78	29	80	0.3625000
NODE_303079_length_164_cov_43.923077	73	153	37	1	80	0.0125000
NODE_303079_length_164_cov_43.923077	73	153	45	7	80	0.0875000
NODE_303079_length_164_cov_43.923077	73	153	46	3	80	0.0375000
NODE_303079_length_164_cov_43.923077	73	153	47	9	80	0.1125000
NODE_303079_length_164_cov_43.923077	73	153	49	1	80	0.0125000
NODE_303079_length_164_cov_43.923077	73	153	51	5	80	0.0625000
NODE_303079_length_164_cov_43.923077	73	153	53	1	80	0.0125000
NODE_303079_length_164_cov_43.923077	73	153	58	4	80	0.0500000
NODE_303079_length_164_cov_43.923077	73	153	60	1	80	0.0125000
NODE_303079_length_164_cov_43.923077	73	153	64	1	80	0.0125000
NODE_303079_length_164_cov_43.923077	73	153	72	9	80	0.1125000
NODE_303079_length_164_cov_43.923077	73	153	76	9	80	0.1125000
NODE_303079_length_164_cov_43.923077	73	153	78	29	80	0.3625000
NODE_303079_length_164_cov_43.923077	73	153	37	1	80	0.0125000
NODE_303079_length_164_cov_43.923077	73	153	45	7	80	0.0875000
NODE_303079_length_164_cov_43.923077	73	153	46	3	80	0.0375000
NODE_303079_length_164_cov_43.923077	73	153	47	9	80	0.1125000
NODE_303079_length_164_cov_43.923077	73	153	49	1	80	0.0125000
NODE_303079_length_164_cov_43.923077	73	153	51	5	80	0.0625000
NODE_303079_length_164_cov_43.923077	73	153	53	1	80	0.0125000
NODE_303079_length_164_cov_43.923077	73	153	58	4	80	0.0500000
NODE_303079_length_164_cov_43.923077	73	153	60	1	80	0.0125000
NODE_303079_length_164_cov_43.923077	73	153	64	1	80	0.0125000
NODE_303079_length_164_cov_43.923077	73	153	72	9	80	0.1125000
NODE_303079_length_164_cov_43.923077	73	153	76	9	80	0.1125000
NODE_303079_length_164_cov_43.923077	73	153	78	29	80	0.3625000
NODE_303079_length_164_cov_43.923077	73	144	46	2	71	0.0281690
NODE_303079_length_164_cov_43.923077	73	144	47	9	71	0.1267606
NODE_303079_length_164_cov_43.923077	73	144	49	1	71	0.0140845
NODE_303079_length_164_cov_43.923077	73	144	51	5	71	0.0704225
NODE_303079_length_164_cov_43.923077	73	144	53	1	71	0.0140845
NODE_303079_length_164_cov_43.923077	73	144	58	4	71	0.0563380
NODE_303079_length_164_cov_43.923077	73	144	60	1	71	0.0140845
NODE_303079_length_164_cov_43.923077	73	144	64	1	71	0.0140845
NODE_303079_length_164_cov_43.923077	73	144	72	9	71	0.1267606
NODE_303079_length_164_cov_43.923077	73	144	76	9	71	0.1267606
NODE_303079_length_164_cov_43.923077	73	144	78	29	71	0.4084507
NODE_303135_length_163_cov_480.593750	0	40	2	3	40	0.0750000
NODE_303135_length_163_cov_480.593750	0	40	4	4	40	0.1000000
NODE_303135_length_163_cov_480.593750	0	40	8	4	40	0.1000000
NODE_303135_length_163_cov_480.593750	0	40	10	2	40	0.0500000
NODE_303135_length_163_cov_480.593750	0	40	14	5	40	0.1250000
NODE_303135_length_163_cov_480.593750	0	40	16	1	40	0.0250000
NODE_303135_length_163_cov_480.593750	0	40	18	1	40	0.0250000
NODE_303135_length_163_cov_480.593750	0	40	20	1	40	0.0250000
NODE_303135_length_163_cov_480.593750	0	40	24	5	40	0.1250000
NODE_303135_length_163_cov_480.593750	0	40	28	5	40	0.1250000
NODE_303135_length_163_cov_480.593750	0	40	36	2	40	0.0500000
NODE_303135_length_163_cov_480.593750	0	40	40	1	40	0.0250000
NODE_303135_length_163_cov_480.593750	0	40	42	2	40	0.0500000
NODE_303135_length_163_cov_480.593750	0	40	44	1	40	0.0250000
NODE_303135_length_163_cov_480.593750	0	40	46	3	40	0.0750000
NODE_303136_length_163_cov_368.000000	24	96	106	1	72	0.0138889
NODE_303136_length_163_cov_368.000000	24	96	110	1	72	0.0138889
NODE_303136_length_163_cov_368.000000	24	96	111	1	72	0.0138889
NODE_303136_length_163_cov_368.000000	24	96	117	1	72	0.0138889
NODE_303136_length_163_cov_368.000000	24	96	119	1	72	0.0138889
NODE_303136_length_163_cov_368.000000	24	96	123	2	72	0.0277778
NODE_303136_length_163_cov_368.000000	24	96	128	1	72	0.0138889
NODE_303136_length_163_cov_368.000000	24	96	129	1	72	0.0138889
NODE_303136_length_163_cov_368.000000	24	96	136	2	72	0.0277778
NODE_303136_length_163_cov_368.000000	24	96	139	1	72	0.0138889
NODE_303136_length_163_cov_368.000000	24	96	143	1	72	0.0138889
NODE_303136_length_163_cov_368.000000	24	96	149	5	72	0.0694444
NODE_303136_length_163_cov_368.000000	24	96	153	1	72	0.0138889
NODE_303136_length_163_cov_368.000000	24	96	157	1	72	0.0138889
NODE_303136_length_163_cov_368.000000	24	96	159	2	72	0.0277778
NODE_303136_length_163_cov_368.000000	24	96	162	2	72	0.0277778
NODE_303136_length_163_cov_368.000000	24	96	166	1	72	0.0138889
NODE_303136_length_163_cov_368.000000	24	96	170	1	72	0.0138889
NODE_303136_length_163_cov_368.000000	24	96	174	1	72	0.0138889
NODE_303136_length_163_cov_368.000000	24	96	176	1	72	0.0138889
NODE_303136_length_163_cov_368.000000	24	96	182	1	72	0.0138889
NODE_303136_length_163_cov_368.000000	24	96	184	2	72	0.0277778
NODE_303136_length_163_cov_368.000000	24	96	186	4	72	0.0555556
NODE_303136_length_163_cov_368.000000	24	96	188	37	72	0.5138889
NODE_303138_length_163_cov_319.843750	0	68	13	1	68	0.0147059
NODE_303138_length_163_cov_319.843750	0	68	15	4	68	0.0588235
NODE_303138_length_163_cov_319.843750	0	68	17	3	68	0.0441176
NODE_303138_length_163_cov_319.843750	0	68	19	2	68	0.0294118
NODE_303138_length_163_cov_319.843750	0	68	21	1	68	0.0147059
NODE_303138_length_163_cov_319.843750	0	68	23	1	68	0.0147059
NODE_303138_length_163_cov_319.843750	0	68	25	3	68	0.0441176
NODE_303138_length_163_cov_319.843750	0	68	27	1	68	0.0147059
NODE_303138_length_163_cov_319.843750	0	68	28	1	68	0.0147059
NODE_303138_length_163_cov_319.843750	0	68	30	1	68	0.0147059
NODE_303138_length_163_cov_319.843750	0	68	32	3	68	0.0441176
NODE_303138_length_163_cov_319.843750	0	68	34	2	68	0.0294118
NODE_303138_length_163_cov_319.843750	0	68	36	1	68	0.0147059
NODE_303138_length_163_cov_319.843750	0	68	38	2	68	0.0294118
NODE_303138_length_163_cov_319.843750	0	68	42	1	68	0.0147059
NODE_303138_length_163_cov_319.843750	0	68	44	5	68	0.0735294
NODE_303138_length_163_cov_319.843750	0	68	48	1	68	0.0147059
NODE_303138_length_163_cov_319.843750	0	68	52	3	68	0.0441176
NODE_303138_length_163_cov_319.843750	0	68	56	1	68	0.0147059
NODE_303138_length_163_cov_319.843750	0	68	57	1	68	0.0147059
NODE_303138_length_163_cov_319.843750	0	68	60	10	68	0.1470588
NODE_303138_length_163_cov_319.843750	0	68	62	7	68	0.1029412
NODE_303138_length_163_cov_319.843750	0	68	66	13	68	0.1911765
NODE_303139_length_163_cov_198.078125	34	109	18	1	75	0.0133333
NODE_303139_length_163_cov_198.078125	34	109	20	5	75	0.0666667
NODE_303139_length_163_cov_198.078125	34	109	22	69	75	0.9200000
NODE_303139_length_163_cov_198.078125	34	114	18	1	80	0.0125000
NODE_303139_length_163_cov_198.078125	34	114	20	10	80	0.1250000
NODE_303139_length_163_cov_198.078125	34	114	22	69	80	0.8625000
NODE_303139_length_163_cov_198.078125	35	110	20	6	75	0.0800000
NODE_303139_length_163_cov_198.078125	35	110	22	69	75	0.9200000
NODE_303139_length_163_cov_198.078125	87	163	0	10	76	0.1315790
NODE_303139_length_163_cov_198.078125	87	163	2	7	76	0.0921053
NODE_303139_length_163_cov_198.078125	87	163	8	11	76	0.1447368
NODE_303139_length_163_cov_198.078125	87	163	12	4	76	0.0526316
NODE_303139_length_163_cov_198.078125	87	163	14	5	76	0.0657895
NODE_303139_length_163_cov_198.078125	87	163	18	6	76	0.0789474
NODE_303139_length_163_cov_198.078125	87	163	20	16	76	0.2105263
NODE_303139_length_163_cov_198.078125	87	163	22	17	76	0.2236842
NODE_303139_length_163_cov_198.078125	87	163	0	10	76	0.1315790
NODE_303139_length_163_cov_198.078125	87	163	2	7	76	0.0921053
NODE_303139_length_163_cov_198.078125	87	163	8	11	76	0.1447368
NODE_303139_length_163_cov_198.078125	87	163	12	4	76	0.0526316
NODE_303139_length_163_cov_198.078125	87	163	14	5	76	0.0657895
NODE_303139_length_163_cov_198.078125	87	163	18	6	76	0.0789474
NODE_303139_length_163_cov_198.078125	87	163	20	16	76	0.2105263
NODE_303139_length_163_cov_198.078125	87	163	22	17	76	0.2236842
NODE_303139_length_163_cov_198.078125	87	163	0	10	76	0.1315790
NODE_303139_length_163_cov_198.078125	87	163	2	7	76	0.0921053
NODE_303139_length_163_cov_198.078125	87	163	8	11	76	0.1447368
NODE_303139_length_163_cov_198.078125	87	163	12	4	76	0.0526316
NODE_303139_length_163_cov_198.078125	87	163	14	5	76	0.0657895
NODE_303139_length_163_cov_198.078125	87	163	18	6	76	0.0789474
NODE_303139_length_163_cov_198.078125	87	163	20	16	76	0.2105263
NODE_303139_length_163_cov_198.078125	87	163	22	17	76	0.2236842
NODE_303231_length_162_cov_421.047619	7	56	25	1	49	0.0204082
NODE_303231_length_162_cov_421.047619	7	56	26	1	49	0.0204082
NODE_303231_length_162_cov_421.047619	7	56	31	2	49	0.0408163
NODE_303231_length_162_cov_421.047619	7	56	37	1	49	0.0204082
NODE_303231_length_162_cov_421.047619	7	56	47	2	49	0.0408163
NODE_303231_length_162_cov_421.047619	7	56	49	1	49	0.0204082
NODE_303231_length_162_cov_421.047619	7	56	61	1	49	0.0204082
NODE_303231_length_162_cov_421.047619	7	56	63	1	49	0.0204082
NODE_303231_length_162_cov_421.047619	7	56	72	1	49	0.0204082
NODE_303231_length_162_cov_421.047619	7	56	79	2	49	0.0408163
NODE_303231_length_162_cov_421.047619	7	56	81	1	49	0.0204082
NODE_303231_length_162_cov_421.047619	7	56	82	2	49	0.0408163
NODE_303231_length_162_cov_421.047619	7	56	84	1	49	0.0204082
NODE_303231_length_162_cov_421.047619	7	56	87	3	49	0.0612245
NODE_303231_length_162_cov_421.047619	7	56	89	1	49	0.0204082
NODE_303231_length_162_cov_421.047619	7	56	95	1	49	0.0204082
NODE_303231_length_162_cov_421.047619	7	56	105	2	49	0.0408163
NODE_303231_length_162_cov_421.047619	7	56	107	2	49	0.0408163
NODE_303231_length_162_cov_421.047619	7	56	112	2	49	0.0408163
NODE_303231_length_162_cov_421.047619	7	56	116	1	49	0.0204082
NODE_303231_length_162_cov_421.047619	7	56	121	1	49	0.0204082
NODE_303231_length_162_cov_421.047619	7	56	124	2	49	0.0408163
NODE_303231_length_162_cov_421.047619	7	56	126	1	49	0.0204082
NODE_303231_length_162_cov_421.047619	7	56	128	1	49	0.0204082
NODE_303231_length_162_cov_421.047619	7	56	134	1	49	0.0204082
NODE_303231_length_162_cov_421.047619	7	56	140	1	49	0.0204082
NODE_303231_length_162_cov_421.047619	7	56	144	1	49	0.0204082
NODE_303231_length_162_cov_421.047619	7	56	148	1	49	0.0204082
NODE_303231_length_162_cov_421.047619	7	56	151	1	49	0.0204082
NODE_303231_length_162_cov_421.047619	7	56	157	2	49	0.0408163
NODE_303231_length_162_cov_421.047619	7	56	169	1	49	0.0204082
NODE_303231_length_162_cov_421.047619	7	56	171	1	49	0.0204082
NODE_303231_length_162_cov_421.047619	7	56	177	2	49	0.0408163
NODE_303231_length_162_cov_421.047619	7	56	183	1	49	0.0204082
NODE_303231_length_162_cov_421.047619	7	56	184	2	49	0.0408163
NODE_303231_length_162_cov_421.047619	7	56	186	1	49	0.0204082
NODE_303231_length_162_cov_421.047619	29	90	105	2	61	0.0327869
NODE_303231_length_162_cov_421.047619	29	90	107	2	61	0.0327869
NODE_303231_length_162_cov_421.047619	29	90	112	2	61	0.0327869
NODE_303231_length_162_cov_421.047619	29	90	116	1	61	0.0163934
NODE_303231_length_162_cov_421.047619	29	90	121	1	61	0.0163934
NODE_303231_length_162_cov_421.047619	29	90	124	2	61	0.0327869
NODE_303231_length_162_cov_421.047619	29	90	126	1	61	0.0163934
NODE_303231_length_162_cov_421.047619	29	90	128	1	61	0.0163934
NODE_303231_length_162_cov_421.047619	29	90	134	1	61	0.0163934
NODE_303231_length_162_cov_421.047619	29	90	140	1	61	0.0163934
NODE_303231_length_162_cov_421.047619	29	90	144	1	61	0.0163934
NODE_303231_length_162_cov_421.047619	29	90	148	1	61	0.0163934
NODE_303231_length_162_cov_421.047619	29	90	151	1	61	0.0163934
NODE_303231_length_162_cov_421.047619	29	90	157	2	61	0.0327869
NODE_303231_length_162_cov_421.047619	29	90	169	1	61	0.0163934
NODE_303231_length_162_cov_421.047619	29	90	171	1	61	0.0163934
NODE_303231_length_162_cov_421.047619	29	90	177	2	61	0.0327869
NODE_303231_length_162_cov_421.047619	29	90	183	1	61	0.0163934
NODE_303231_length_162_cov_421.047619	29	90	184	2	61	0.0327869
NODE_303231_length_162_cov_421.047619	29	90	186	2	61	0.0327869
NODE_303231_length_162_cov_421.047619	29	90	188	33	61	0.5409836
NODE_303231_length_162_cov_421.047619	29	92	105	2	63	0.0317460
NODE_303231_length_162_cov_421.047619	29	92	107	2	63	0.0317460
NODE_303231_length_162_cov_421.047619	29	92	112	2	63	0.0317460
NODE_303231_length_162_cov_421.047619	29	92	116	1	63	0.0158730
NODE_303231_length_162_cov_421.047619	29	92	121	1	63	0.0158730
NODE_303231_length_162_cov_421.047619	29	92	124	2	63	0.0317460
NODE_303231_length_162_cov_421.047619	29	92	126	1	63	0.0158730
NODE_303231_length_162_cov_421.047619	29	92	128	1	63	0.0158730
NODE_303231_length_162_cov_421.047619	29	92	134	1	63	0.0158730
NODE_303231_length_162_cov_421.047619	29	92	140	1	63	0.0158730
NODE_303231_length_162_cov_421.047619	29	92	144	1	63	0.0158730
NODE_303231_length_162_cov_421.047619	29	92	148	1	63	0.0158730
NODE_303231_length_162_cov_421.047619	29	92	151	1	63	0.0158730
NODE_303231_length_162_cov_421.047619	29	92	157	2	63	0.0317460
NODE_303231_length_162_cov_421.047619	29	92	169	1	63	0.0158730
NODE_303231_length_162_cov_421.047619	29	92	171	1	63	0.0158730
NODE_303231_length_162_cov_421.047619	29	92	177	2	63	0.0317460
NODE_303231_length_162_cov_421.047619	29	92	183	1	63	0.0158730
NODE_303231_length_162_cov_421.047619	29	92	184	2	63	0.0317460
NODE_303231_length_162_cov_421.047619	29	92	186	2	63	0.0317460
NODE_303231_length_162_cov_421.047619	29	92	188	35	63	0.5555556
NODE_303231_length_162_cov_421.047619	29	92	105	2	63	0.0317460
NODE_303231_length_162_cov_421.047619	29	92	107	2	63	0.0317460
NODE_303231_length_162_cov_421.047619	29	92	112	2	63	0.0317460
NODE_303231_length_162_cov_421.047619	29	92	116	1	63	0.0158730
NODE_303231_length_162_cov_421.047619	29	92	121	1	63	0.0158730
NODE_303231_length_162_cov_421.047619	29	92	124	2	63	0.0317460
NODE_303231_length_162_cov_421.047619	29	92	126	1	63	0.0158730
NODE_303231_length_162_cov_421.047619	29	92	128	1	63	0.0158730
NODE_303231_length_162_cov_421.047619	29	92	134	1	63	0.0158730
NODE_303231_length_162_cov_421.047619	29	92	140	1	63	0.0158730
NODE_303231_length_162_cov_421.047619	29	92	144	1	63	0.0158730
NODE_303231_length_162_cov_421.047619	29	92	148	1	63	0.0158730
NODE_303231_length_162_cov_421.047619	29	92	151	1	63	0.0158730
NODE_303231_length_162_cov_421.047619	29	92	157	2	63	0.0317460
NODE_303231_length_162_cov_421.047619	29	92	169	1	63	0.0158730
NODE_303231_length_162_cov_421.047619	29	92	171	1	63	0.0158730
NODE_303231_length_162_cov_421.047619	29	92	177	2	63	0.0317460
NODE_303231_length_162_cov_421.047619	29	92	183	1	63	0.0158730
NODE_303231_length_162_cov_421.047619	29	92	184	2	63	0.0317460
NODE_303231_length_162_cov_421.047619	29	92	186	2	63	0.0317460
NODE_303231_length_162_cov_421.047619	29	92	188	35	63	0.5555556
NODE_303231_length_162_cov_421.047619	29	92	105	2	63	0.0317460
NODE_303231_length_162_cov_421.047619	29	92	107	2	63	0.0317460
NODE_303231_length_162_cov_421.047619	29	92	112	2	63	0.0317460
NODE_303231_length_162_cov_421.047619	29	92	116	1	63	0.0158730
NODE_303231_length_162_cov_421.047619	29	92	121	1	63	0.0158730
NODE_303231_length_162_cov_421.047619	29	92	124	2	63	0.0317460
NODE_303231_length_162_cov_421.047619	29	92	126	1	63	0.0158730
NODE_303231_length_162_cov_421.047619	29	92	128	1	63	0.0158730
NODE_303231_length_162_cov_421.047619	29	92	134	1	63	0.0158730
NODE_303231_length_162_cov_421.047619	29	92	140	1	63	0.0158730
NODE_303231_length_162_cov_421.047619	29	92	144	1	63	0.0158730
NODE_303231_length_162_cov_421.047619	29	92	148	1	63	0.0158730
NODE_303231_length_162_cov_421.047619	29	92	151	1	63	0.0158730
NODE_303231_length_162_cov_421.047619	29	92	157	2	63	0.0317460
NODE_303231_length_162_cov_421.047619	29	92	169	1	63	0.0158730
NODE_303231_length_162_cov_421.047619	29	92	171	1	63	0.0158730
NODE_303231_length_162_cov_421.047619	29	92	177	2	63	0.0317460
NODE_303231_length_162_cov_421.047619	29	92	183	1	63	0.0158730
NODE_303231_length_162_cov_421.047619	29	92	184	2	63	0.0317460
NODE_303231_length_162_cov_421.047619	29	92	186	2	63	0.0317460
NODE_303231_length_162_cov_421.047619	29	92	188	35	63	0.5555556
NODE_303250_length_162_cov_45.380952	63	127	12	6	64	0.0937500
NODE_303250_length_162_cov_45.380952	63	127	14	4	64	0.0625000
NODE_303250_length_162_cov_45.380952	63	127	16	2	64	0.0312500
NODE_303250_length_162_cov_45.380952	63	127	18	52	64	0.8125000
NODE_303250_length_162_cov_45.380952	63	127	12	6	64	0.0937500
NODE_303250_length_162_cov_45.380952	63	127	14	4	64	0.0625000
NODE_303250_length_162_cov_45.380952	63	127	16	2	64	0.0312500
NODE_303250_length_162_cov_45.380952	63	127	18	52	64	0.8125000
NODE_303250_length_162_cov_45.380952	100	162	4	10	62	0.1612903
NODE_303250_length_162_cov_45.380952	100	162	5	7	62	0.1129032
NODE_303250_length_162_cov_45.380952	100	162	6	7	62	0.1129032
NODE_303250_length_162_cov_45.380952	100	162	12	17	62	0.2741936
NODE_303250_length_162_cov_45.380952	100	162	14	4	62	0.0645161
NODE_303250_length_162_cov_45.380952	100	162	16	2	62	0.0322581
NODE_303250_length_162_cov_45.380952	100	162	18	15	62	0.2419355
NODE_303301_length_161_cov_1483.177419	51	131	116	1	80	0.0125000
NODE_303301_length_161_cov_1483.177419	51	131	118	1	80	0.0125000
NODE_303301_length_161_cov_1483.177419	51	131	126	1	80	0.0125000
NODE_303301_length_161_cov_1483.177419	51	131	129	8	80	0.1000000
NODE_303301_length_161_cov_1483.177419	51	131	132	1	80	0.0125000
NODE_303301_length_161_cov_1483.177419	51	131	133	1	80	0.0125000
NODE_303301_length_161_cov_1483.177419	51	131	135	1	80	0.0125000
NODE_303301_length_161_cov_1483.177419	51	131	139	1	80	0.0125000
NODE_303301_length_161_cov_1483.177419	51	131	141	3	80	0.0375000
NODE_303301_length_161_cov_1483.177419	51	131	142	1	80	0.0125000
NODE_303301_length_161_cov_1483.177419	51	131	145	3	80	0.0375000
NODE_303301_length_161_cov_1483.177419	51	131	146	1	80	0.0125000
NODE_303301_length_161_cov_1483.177419	51	131	147	1	80	0.0125000
NODE_303301_length_161_cov_1483.177419	51	131	151	1	80	0.0125000
NODE_303301_length_161_cov_1483.177419	51	131	153	1	80	0.0125000
NODE_303301_length_161_cov_1483.177419	51	131	155	3	80	0.0375000
NODE_303301_length_161_cov_1483.177419	51	131	156	2	80	0.0250000
NODE_303301_length_161_cov_1483.177419	51	131	158	3	80	0.0375000
NODE_303301_length_161_cov_1483.177419	51	131	160	2	80	0.0250000
NODE_303301_length_161_cov_1483.177419	51	131	162	44	80	0.5500000
NODE_303301_length_161_cov_1483.177419	104	161	10	1	57	0.0175439
NODE_303301_length_161_cov_1483.177419	104	161	14	1	57	0.0175439
NODE_303301_length_161_cov_1483.177419	104	161	24	2	57	0.0350877
NODE_303301_length_161_cov_1483.177419	104	161	28	2	57	0.0350877
NODE_303301_length_161_cov_1483.177419	104	161	34	2	57	0.0350877
NODE_303301_length_161_cov_1483.177419	104	161	38	1	57	0.0175439
NODE_303301_length_161_cov_1483.177419	104	161	48	1	57	0.0175439
NODE_303301_length_161_cov_1483.177419	104	161	61	1	57	0.0175439
NODE_303301_length_161_cov_1483.177419	104	161	69	1	57	0.0175439
NODE_303301_length_161_cov_1483.177419	104	161	75	1	57	0.0175439
NODE_303301_length_161_cov_1483.177419	104	161	81	1	57	0.0175439
NODE_303301_length_161_cov_1483.177419	104	161	87	5	57	0.0877193
NODE_303301_length_161_cov_1483.177419	104	161	89	2	57	0.0350877
NODE_303301_length_161_cov_1483.177419	104	161	93	1	57	0.0175439
NODE_303301_length_161_cov_1483.177419	104	161	101	1	57	0.0175439
NODE_303301_length_161_cov_1483.177419	104	161	104	1	57	0.0175439
NODE_303301_length_161_cov_1483.177419	104	161	107	1	57	0.0175439
NODE_303301_length_161_cov_1483.177419	104	161	113	1	57	0.0175439
NODE_303301_length_161_cov_1483.177419	104	161	117	1	57	0.0175439
NODE_303301_length_161_cov_1483.177419	104	161	125	2	57	0.0350877
NODE_303301_length_161_cov_1483.177419	104	161	127	1	57	0.0175439
NODE_303301_length_161_cov_1483.177419	104	161	129	8	57	0.1403509
NODE_303301_length_161_cov_1483.177419	104	161	133	1	57	0.0175439
NODE_303301_length_161_cov_1483.177419	104	161	135	1	57	0.0175439
NODE_303301_length_161_cov_1483.177419	104	161	139	1	57	0.0175439
NODE_303301_length_161_cov_1483.177419	104	161	141	3	57	0.0526316
NODE_303301_length_161_cov_1483.177419	104	161	145	3	57	0.0526316
NODE_303301_length_161_cov_1483.177419	104	161	147	1	57	0.0175439
NODE_303301_length_161_cov_1483.177419	104	161	151	1	57	0.0175439
NODE_303301_length_161_cov_1483.177419	104	161	153	1	57	0.0175439
NODE_303301_length_161_cov_1483.177419	104	161	155	3	57	0.0526316
NODE_303301_length_161_cov_1483.177419	104	161	158	3	57	0.0526316
NODE_303301_length_161_cov_1483.177419	104	161	160	1	57	0.0175439
NODE_303312_length_161_cov_71.500000	33	110	35	8	77	0.1038961
NODE_303312_length_161_cov_71.500000	33	110	47	15	77	0.1948052
NODE_303312_length_161_cov_71.500000	33	110	48	3	77	0.0389610
NODE_303312_length_161_cov_71.500000	33	110	49	51	77	0.6623377
NODE_303312_length_161_cov_71.500000	33	110	35	8	77	0.1038961
NODE_303312_length_161_cov_71.500000	33	110	47	15	77	0.1948052
NODE_303312_length_161_cov_71.500000	33	110	48	3	77	0.0389610
NODE_303312_length_161_cov_71.500000	33	110	49	51	77	0.6623377
NODE_303312_length_161_cov_71.500000	33	110	35	8	77	0.1038961
NODE_303312_length_161_cov_71.500000	33	110	47	15	77	0.1948052
NODE_303312_length_161_cov_71.500000	33	110	48	3	77	0.0389610
NODE_303312_length_161_cov_71.500000	33	110	49	51	77	0.6623377
NODE_303312_length_161_cov_71.500000	33	110	35	8	77	0.1038961
NODE_303312_length_161_cov_71.500000	33	110	47	15	77	0.1948052
NODE_303312_length_161_cov_71.500000	33	110	48	3	77	0.0389610
NODE_303312_length_161_cov_71.500000	33	110	49	51	77	0.6623377
NODE_303312_length_161_cov_71.500000	83	149	36	25	66	0.3787879
NODE_303312_length_161_cov_71.500000	83	149	47	26	66	0.3939394
NODE_303312_length_161_cov_71.500000	83	149	48	3	66	0.0454545
NODE_303312_length_161_cov_71.500000	83	149	49	12	66	0.1818182
NODE_303312_length_161_cov_71.500000	83	161	33	10	78	0.1282051
NODE_303312_length_161_cov_71.500000	83	161	36	27	78	0.3461539
NODE_303312_length_161_cov_71.500000	83	161	47	26	78	0.3333333
NODE_303312_length_161_cov_71.500000	83	161	48	3	78	0.0384615
NODE_303312_length_161_cov_71.500000	83	161	49	12	78	0.1538462
NODE_303312_length_161_cov_71.500000	86	161	33	10	75	0.1333333
NODE_303312_length_161_cov_71.500000	86	161	36	27	75	0.3600000
NODE_303312_length_161_cov_71.500000	86	161	47	26	75	0.3466667
NODE_303312_length_161_cov_71.500000	86	161	48	3	75	0.0400000
NODE_303312_length_161_cov_71.500000	86	161	49	9	75	0.1200000
NODE_303312_length_161_cov_71.500000	86	161	33	10	75	0.1333333
NODE_303312_length_161_cov_71.500000	86	161	36	27	75	0.3600000
NODE_303312_length_161_cov_71.500000	86	161	47	26	75	0.3466667
NODE_303312_length_161_cov_71.500000	86	161	48	3	75	0.0400000
NODE_303312_length_161_cov_71.500000	86	161	49	9	75	0.1200000
NODE_303312_length_161_cov_71.500000	88	161	33	10	73	0.1369863
NODE_303312_length_161_cov_71.500000	88	161	36	27	73	0.3698630
NODE_303312_length_161_cov_71.500000	88	161	47	26	73	0.3561644
NODE_303312_length_161_cov_71.500000	88	161	48	3	73	0.0410959
NODE_303312_length_161_cov_71.500000	88	161	49	7	73	0.0958904
NODE_303321_length_161_cov_29.758065	0	80	2	8	80	0.1000000
NODE_303321_length_161_cov_29.758065	0	80	4	4	80	0.0500000
NODE_303321_length_161_cov_29.758065	0	80	6	2	80	0.0250000
NODE_303321_length_161_cov_29.758065	0	80	8	7	80	0.0875000
NODE_303321_length_161_cov_29.758065	0	80	10	13	80	0.1625000
NODE_303321_length_161_cov_29.758065	0	80	12	46	80	0.5750000
NODE_303381_length_160_cov_143.573770	45	125	24	4	80	0.0500000
NODE_303381_length_160_cov_143.573770	45	125	26	2	80	0.0250000
NODE_303381_length_160_cov_143.573770	45	125	27	2	80	0.0250000
NODE_303381_length_160_cov_143.573770	45	125	31	6	80	0.0750000
NODE_303381_length_160_cov_143.573770	45	125	32	3	80	0.0375000
NODE_303381_length_160_cov_143.573770	45	125	33	1	80	0.0125000
NODE_303381_length_160_cov_143.573770	45	125	34	6	80	0.0750000
NODE_303381_length_160_cov_143.573770	45	125	35	2	80	0.0250000
NODE_303381_length_160_cov_143.573770	45	125	36	54	80	0.6750000
NODE_303381_length_160_cov_143.573770	93	160	0	3	67	0.0447761
NODE_303381_length_160_cov_143.573770	93	160	2	4	67	0.0597015
NODE_303381_length_160_cov_143.573770	93	160	4	5	67	0.0746269
NODE_303381_length_160_cov_143.573770	93	160	6	4	67	0.0597015
NODE_303381_length_160_cov_143.573770	93	160	10	1	67	0.0149254
NODE_303381_length_160_cov_143.573770	93	160	12	5	67	0.0746269
NODE_303381_length_160_cov_143.573770	93	160	14	3	67	0.0447761
NODE_303381_length_160_cov_143.573770	93	160	18	6	67	0.0895522
NODE_303381_length_160_cov_143.573770	93	160	20	1	67	0.0149254
NODE_303381_length_160_cov_143.573770	93	160	24	7	67	0.1044776
NODE_303381_length_160_cov_143.573770	93	160	26	2	67	0.0298507
NODE_303381_length_160_cov_143.573770	93	160	33	1	67	0.0149254
NODE_303381_length_160_cov_143.573770	93	160	34	4	67	0.0597015
NODE_303381_length_160_cov_143.573770	93	160	35	2	67	0.0298507
NODE_303381_length_160_cov_143.573770	93	160	36	19	67	0.2835821
NODE_303381_length_160_cov_143.573770	98	120	26	1	22	0.0454545
NODE_303381_length_160_cov_143.573770	98	120	33	1	22	0.0454545
NODE_303381_length_160_cov_143.573770	98	120	34	4	22	0.1818182
NODE_303381_length_160_cov_143.573770	98	120	35	2	22	0.0909091
NODE_303381_length_160_cov_143.573770	98	120	36	14	22	0.6363636
NODE_303388_length_160_cov_58.245902	0	45	0	21	45	0.4666667
NODE_303388_length_160_cov_58.245902	0	45	2	6	45	0.1333333
NODE_303388_length_160_cov_58.245902	0	45	6	1	45	0.0222222
NODE_303388_length_160_cov_58.245902	0	45	8	11	45	0.2444444
NODE_303388_length_160_cov_58.245902	0	45	10	3	45	0.0666667
NODE_303388_length_160_cov_58.245902	0	45	12	3	45	0.0666667
NODE_303431_length_159_cov_182.016667	71	156	4	20	85	0.2352941
NODE_303431_length_159_cov_182.016667	71	156	6	5	85	0.0588235
NODE_303431_length_159_cov_182.016667	71	156	8	60	85	0.7058824
NODE_303431_length_159_cov_182.016667	71	156	4	20	85	0.2352941
NODE_303431_length_159_cov_182.016667	71	156	6	5	85	0.0588235
NODE_303431_length_159_cov_182.016667	71	156	8	60	85	0.7058824
NODE_303431_length_159_cov_182.016667	71	156	4	20	85	0.2352941
NODE_303431_length_159_cov_182.016667	71	156	6	5	85	0.0588235
NODE_303431_length_159_cov_182.016667	71	156	8	60	85	0.7058824
NODE_303440_length_159_cov_85.750000	0	43	0	12	43	0.2790698
NODE_303440_length_159_cov_85.750000	0	43	2	2	43	0.0465116
NODE_303440_length_159_cov_85.750000	0	43	10	3	43	0.0697674
NODE_303440_length_159_cov_85.750000	0	43	28	1	43	0.0232558
NODE_303440_length_159_cov_85.750000	0	43	29	4	43	0.0930233
NODE_303440_length_159_cov_85.750000	0	43	31	3	43	0.0697674
NODE_303440_length_159_cov_85.750000	0	43	35	2	43	0.0465116
NODE_303440_length_159_cov_85.750000	0	43	37	1	43	0.0232558
NODE_303440_length_159_cov_85.750000	0	43	41	3	43	0.0697674
NODE_303440_length_159_cov_85.750000	0	43	47	2	43	0.0465116
NODE_303440_length_159_cov_85.750000	0	43	49	4	43	0.0930233
NODE_303440_length_159_cov_85.750000	0	43	51	1	43	0.0232558
NODE_303440_length_159_cov_85.750000	0	43	53	5	43	0.1162791
NODE_303440_length_159_cov_85.750000	16	97	10	1	81	0.0123457
NODE_303440_length_159_cov_85.750000	16	97	28	1	81	0.0123457
NODE_303440_length_159_cov_85.750000	16	97	29	4	81	0.0493827
NODE_303440_length_159_cov_85.750000	16	97	31	3	81	0.0370370
NODE_303440_length_159_cov_85.750000	16	97	35	2	81	0.0246914
NODE_303440_length_159_cov_85.750000	16	97	37	1	81	0.0123457
NODE_303440_length_159_cov_85.750000	16	97	41	3	81	0.0370370
NODE_303440_length_159_cov_85.750000	16	97	47	2	81	0.0246914
NODE_303440_length_159_cov_85.750000	16	97	49	4	81	0.0493827
NODE_303440_length_159_cov_85.750000	16	97	51	1	81	0.0123457
NODE_303440_length_159_cov_85.750000	16	97	53	8	81	0.0987654
NODE_303440_length_159_cov_85.750000	16	97	55	5	81	0.0617284
NODE_303440_length_159_cov_85.750000	16	97	57	1	81	0.0123457
NODE_303440_length_159_cov_85.750000	16	97	61	3	81	0.0370370
NODE_303440_length_159_cov_85.750000	16	97	71	21	81	0.2592593
NODE_303440_length_159_cov_85.750000	16	97	73	21	81	0.2592593
NODE_303440_length_159_cov_85.750000	65	145	40	3	80	0.0375000
NODE_303440_length_159_cov_85.750000	65	145	50	3	80	0.0375000
NODE_303440_length_159_cov_85.750000	65	145	52	2	80	0.0250000
NODE_303440_length_159_cov_85.750000	65	145	54	4	80	0.0500000
NODE_303440_length_159_cov_85.750000	65	145	58	1	80	0.0125000
NODE_303440_length_159_cov_85.750000	65	145	60	10	80	0.1250000
NODE_303440_length_159_cov_85.750000	65	145	62	1	80	0.0125000
NODE_303440_length_159_cov_85.750000	65	145	66	3	80	0.0375000
NODE_303440_length_159_cov_85.750000	65	145	68	4	80	0.0500000
NODE_303440_length_159_cov_85.750000	65	145	70	5	80	0.0625000
NODE_303440_length_159_cov_85.750000	65	145	71	11	80	0.1375000
NODE_303440_length_159_cov_85.750000	65	145	72	1	80	0.0125000
NODE_303440_length_159_cov_85.750000	65	145	73	30	80	0.3750000
NODE_303440_length_159_cov_85.750000	65	145	74	2	80	0.0250000
NODE_303440_length_159_cov_85.750000	70	92	71	6	22	0.2727273
NODE_303440_length_159_cov_85.750000	70	92	73	16	22	0.7272727
NODE_303546_length_158_cov_119.813559	34	77	18	14	43	0.3255814
NODE_303546_length_158_cov_119.813559	34	77	20	3	43	0.0697674
NODE_303546_length_158_cov_119.813559	34	77	22	26	43	0.6046512
NODE_303546_length_158_cov_119.813559	78	113	20	11	35	0.3142857
NODE_303546_length_158_cov_119.813559	78	113	22	24	35	0.6857143
NODE_303546_length_158_cov_119.813559	123	158	2	9	35	0.2571429
NODE_303546_length_158_cov_119.813559	123	158	3	2	35	0.0571429
NODE_303546_length_158_cov_119.813559	123	158	4	8	35	0.2285714
NODE_303546_length_158_cov_119.813559	123	158	8	1	35	0.0285714
NODE_303546_length_158_cov_119.813559	123	158	10	3	35	0.0857143
NODE_303546_length_158_cov_119.813559	123	158	12	1	35	0.0285714
NODE_303546_length_158_cov_119.813559	123	158	14	4	35	0.1142857
NODE_303546_length_158_cov_119.813559	123	158	16	1	35	0.0285714
NODE_303546_length_158_cov_119.813559	123	158	18	6	35	0.1714286
NODE_303552_length_158_cov_70.135593	5	82	1	27	77	0.3506494
NODE_303552_length_158_cov_70.135593	5	82	2	12	77	0.1558442
NODE_303552_length_158_cov_70.135593	5	82	6	5	77	0.0649351
NODE_303552_length_158_cov_70.135593	5	82	9	1	77	0.0129870
NODE_303552_length_158_cov_70.135593	5	82	10	32	77	0.4155844
NODE_303552_length_158_cov_70.135593	5	82	1	27	77	0.3506494
NODE_303552_length_158_cov_70.135593	5	82	2	12	77	0.1558442
NODE_303552_length_158_cov_70.135593	5	82	6	5	77	0.0649351
NODE_303552_length_158_cov_70.135593	5	82	9	1	77	0.0129870
NODE_303552_length_158_cov_70.135593	5	82	10	32	77	0.4155844
NODE_303552_length_158_cov_70.135593	81	155	4	7	74	0.0945946
NODE_303552_length_158_cov_70.135593	81	155	8	8	74	0.1081081
NODE_303552_length_158_cov_70.135593	81	155	10	59	74	0.7972973
NODE_303555_length_158_cov_63.559322	80	151	12	13	71	0.1830986
NODE_303555_length_158_cov_63.559322	80	151	14	10	71	0.1408451
NODE_303555_length_158_cov_63.559322	80	151	18	2	71	0.0281690
NODE_303555_length_158_cov_63.559322	80	151	22	1	71	0.0140845
NODE_303555_length_158_cov_63.559322	80	151	24	5	71	0.0704225
NODE_303555_length_158_cov_63.559322	80	151	25	1	71	0.0140845
NODE_303555_length_158_cov_63.559322	80	151	26	2	71	0.0281690
NODE_303555_length_158_cov_63.559322	80	151	32	1	71	0.0140845
NODE_303555_length_158_cov_63.559322	80	151	38	4	71	0.0563380
NODE_303555_length_158_cov_63.559322	80	151	40	3	71	0.0422535
NODE_303555_length_158_cov_63.559322	80	151	48	2	71	0.0281690
NODE_303555_length_158_cov_63.559322	80	151	54	27	71	0.3802817
NODE_303556_length_158_cov_61.203390	2	66	51	1	64	0.0156250
NODE_303556_length_158_cov_61.203390	2	66	52	1	64	0.0156250
NODE_303556_length_158_cov_61.203390	2	66	70	3	64	0.0468750
NODE_303556_length_158_cov_61.203390	2	66	78	2	64	0.0312500
NODE_303556_length_158_cov_61.203390	2	66	92	4	64	0.0625000
NODE_303556_length_158_cov_61.203390	2	66	102	1	64	0.0156250
NODE_303556_length_158_cov_61.203390	2	66	109	3	64	0.0468750
NODE_303556_length_158_cov_61.203390	2	66	115	1	64	0.0156250
NODE_303556_length_158_cov_61.203390	2	66	134	1	64	0.0156250
NODE_303556_length_158_cov_61.203390	2	66	142	1	64	0.0156250
NODE_303556_length_158_cov_61.203390	2	66	146	1	64	0.0156250
NODE_303556_length_158_cov_61.203390	2	66	160	1	64	0.0156250
NODE_303556_length_158_cov_61.203390	2	66	162	1	64	0.0156250
NODE_303556_length_158_cov_61.203390	2	66	166	1	64	0.0156250
NODE_303556_length_158_cov_61.203390	2	66	174	1	64	0.0156250
NODE_303556_length_158_cov_61.203390	2	66	176	1	64	0.0156250
NODE_303556_length_158_cov_61.203390	2	66	186	1	64	0.0156250
NODE_303556_length_158_cov_61.203390	2	66	211	1	64	0.0156250
NODE_303556_length_158_cov_61.203390	2	66	216	1	64	0.0156250
NODE_303556_length_158_cov_61.203390	2	66	218	1	64	0.0156250
NODE_303556_length_158_cov_61.203390	2	66	234	1	64	0.0156250
NODE_303556_length_158_cov_61.203390	2	66	238	1	64	0.0156250
NODE_303556_length_158_cov_61.203390	2	66	244	1	64	0.0156250
NODE_303556_length_158_cov_61.203390	2	66	246	2	64	0.0312500
NODE_303556_length_158_cov_61.203390	2	66	247	1	64	0.0156250
NODE_303556_length_158_cov_61.203390	2	66	249	2	64	0.0312500
NODE_303556_length_158_cov_61.203390	2	66	251	1	64	0.0156250
NODE_303556_length_158_cov_61.203390	2	66	255	1	64	0.0156250
NODE_303556_length_158_cov_61.203390	2	66	261	1	64	0.0156250
NODE_303556_length_158_cov_61.203390	2	66	265	1	64	0.0156250
NODE_303556_length_158_cov_61.203390	2	66	271	1	64	0.0156250
NODE_303556_length_158_cov_61.203390	2	66	287	1	64	0.0156250
NODE_303556_length_158_cov_61.203390	2	66	300	1	64	0.0156250
NODE_303556_length_158_cov_61.203390	2	66	306	1	64	0.0156250
NODE_303556_length_158_cov_61.203390	2	66	313	1	64	0.0156250
NODE_303556_length_158_cov_61.203390	2	66	317	2	64	0.0312500
NODE_303556_length_158_cov_61.203390	2	66	318	2	64	0.0312500
NODE_303556_length_158_cov_61.203390	2	66	319	1	64	0.0156250
NODE_303556_length_158_cov_61.203390	2	66	323	1	64	0.0156250
NODE_303556_length_158_cov_61.203390	2	66	326	2	64	0.0312500
NODE_303556_length_158_cov_61.203390	2	66	328	1	64	0.0156250
NODE_303556_length_158_cov_61.203390	2	66	330	10	64	0.1562500
NODE_303556_length_158_cov_61.203390	2	66	51	1	64	0.0156250
NODE_303556_length_158_cov_61.203390	2	66	52	1	64	0.0156250
NODE_303556_length_158_cov_61.203390	2	66	70	3	64	0.0468750
NODE_303556_length_158_cov_61.203390	2	66	78	2	64	0.0312500
NODE_303556_length_158_cov_61.203390	2	66	92	4	64	0.0625000
NODE_303556_length_158_cov_61.203390	2	66	102	1	64	0.0156250
NODE_303556_length_158_cov_61.203390	2	66	109	3	64	0.0468750
NODE_303556_length_158_cov_61.203390	2	66	115	1	64	0.0156250
NODE_303556_length_158_cov_61.203390	2	66	134	1	64	0.0156250
NODE_303556_length_158_cov_61.203390	2	66	142	1	64	0.0156250
NODE_303556_length_158_cov_61.203390	2	66	146	1	64	0.0156250
NODE_303556_length_158_cov_61.203390	2	66	160	1	64	0.0156250
NODE_303556_length_158_cov_61.203390	2	66	162	1	64	0.0156250
NODE_303556_length_158_cov_61.203390	2	66	166	1	64	0.0156250
NODE_303556_length_158_cov_61.203390	2	66	174	1	64	0.0156250
NODE_303556_length_158_cov_61.203390	2	66	176	1	64	0.0156250
NODE_303556_length_158_cov_61.203390	2	66	186	1	64	0.0156250
NODE_303556_length_158_cov_61.203390	2	66	211	1	64	0.0156250
NODE_303556_length_158_cov_61.203390	2	66	216	1	64	0.0156250
NODE_303556_length_158_cov_61.203390	2	66	218	1	64	0.0156250
NODE_303556_length_158_cov_61.203390	2	66	234	1	64	0.0156250
NODE_303556_length_158_cov_61.203390	2	66	238	1	64	0.0156250
NODE_303556_length_158_cov_61.203390	2	66	244	1	64	0.0156250
NODE_303556_length_158_cov_61.203390	2	66	246	2	64	0.0312500
NODE_303556_length_158_cov_61.203390	2	66	247	1	64	0.0156250
NODE_303556_length_158_cov_61.203390	2	66	249	2	64	0.0312500
NODE_303556_length_158_cov_61.203390	2	66	251	1	64	0.0156250
NODE_303556_length_158_cov_61.203390	2	66	255	1	64	0.0156250
NODE_303556_length_158_cov_61.203390	2	66	261	1	64	0.0156250
NODE_303556_length_158_cov_61.203390	2	66	265	1	64	0.0156250
NODE_303556_length_158_cov_61.203390	2	66	271	1	64	0.0156250
NODE_303556_length_158_cov_61.203390	2	66	287	1	64	0.0156250
NODE_303556_length_158_cov_61.203390	2	66	300	1	64	0.0156250
NODE_303556_length_158_cov_61.203390	2	66	306	1	64	0.0156250
NODE_303556_length_158_cov_61.203390	2	66	313	1	64	0.0156250
NODE_303556_length_158_cov_61.203390	2	66	317	2	64	0.0312500
NODE_303556_length_158_cov_61.203390	2	66	318	2	64	0.0312500
NODE_303556_length_158_cov_61.203390	2	66	319	1	64	0.0156250
NODE_303556_length_158_cov_61.203390	2	66	323	1	64	0.0156250
NODE_303556_length_158_cov_61.203390	2	66	326	2	64	0.0312500
NODE_303556_length_158_cov_61.203390	2	66	328	1	64	0.0156250
NODE_303556_length_158_cov_61.203390	2	66	330	10	64	0.1562500
NODE_303556_length_158_cov_61.203390	2	66	51	1	64	0.0156250
NODE_303556_length_158_cov_61.203390	2	66	52	1	64	0.0156250
NODE_303556_length_158_cov_61.203390	2	66	70	3	64	0.0468750
NODE_303556_length_158_cov_61.203390	2	66	78	2	64	0.0312500
NODE_303556_length_158_cov_61.203390	2	66	92	4	64	0.0625000
NODE_303556_length_158_cov_61.203390	2	66	102	1	64	0.0156250
NODE_303556_length_158_cov_61.203390	2	66	109	3	64	0.0468750
NODE_303556_length_158_cov_61.203390	2	66	115	1	64	0.0156250
NODE_303556_length_158_cov_61.203390	2	66	134	1	64	0.0156250
NODE_303556_length_158_cov_61.203390	2	66	142	1	64	0.0156250
NODE_303556_length_158_cov_61.203390	2	66	146	1	64	0.0156250
NODE_303556_length_158_cov_61.203390	2	66	160	1	64	0.0156250
NODE_303556_length_158_cov_61.203390	2	66	162	1	64	0.0156250
NODE_303556_length_158_cov_61.203390	2	66	166	1	64	0.0156250
NODE_303556_length_158_cov_61.203390	2	66	174	1	64	0.0156250
NODE_303556_length_158_cov_61.203390	2	66	176	1	64	0.0156250
NODE_303556_length_158_cov_61.203390	2	66	186	1	64	0.0156250
NODE_303556_length_158_cov_61.203390	2	66	211	1	64	0.0156250
NODE_303556_length_158_cov_61.203390	2	66	216	1	64	0.0156250
NODE_303556_length_158_cov_61.203390	2	66	218	1	64	0.0156250
NODE_303556_length_158_cov_61.203390	2	66	234	1	64	0.0156250
NODE_303556_length_158_cov_61.203390	2	66	238	1	64	0.0156250
NODE_303556_length_158_cov_61.203390	2	66	244	1	64	0.0156250
NODE_303556_length_158_cov_61.203390	2	66	246	2	64	0.0312500
NODE_303556_length_158_cov_61.203390	2	66	247	1	64	0.0156250
NODE_303556_length_158_cov_61.203390	2	66	249	2	64	0.0312500
NODE_303556_length_158_cov_61.203390	2	66	251	1	64	0.0156250
NODE_303556_length_158_cov_61.203390	2	66	255	1	64	0.0156250
NODE_303556_length_158_cov_61.203390	2	66	261	1	64	0.0156250
NODE_303556_length_158_cov_61.203390	2	66	265	1	64	0.0156250
NODE_303556_length_158_cov_61.203390	2	66	271	1	64	0.0156250
NODE_303556_length_158_cov_61.203390	2	66	287	1	64	0.0156250
NODE_303556_length_158_cov_61.203390	2	66	300	1	64	0.0156250
NODE_303556_length_158_cov_61.203390	2	66	306	1	64	0.0156250
NODE_303556_length_158_cov_61.203390	2	66	313	1	64	0.0156250
NODE_303556_length_158_cov_61.203390	2	66	317	2	64	0.0312500
NODE_303556_length_158_cov_61.203390	2	66	318	2	64	0.0312500
NODE_303556_length_158_cov_61.203390	2	66	319	1	64	0.0156250
NODE_303556_length_158_cov_61.203390	2	66	323	1	64	0.0156250
NODE_303556_length_158_cov_61.203390	2	66	326	2	64	0.0312500
NODE_303556_length_158_cov_61.203390	2	66	328	1	64	0.0156250
NODE_303556_length_158_cov_61.203390	2	66	330	10	64	0.1562500
NODE_303556_length_158_cov_61.203390	39	119	229	1	80	0.0125000
NODE_303556_length_158_cov_61.203390	39	119	239	2	80	0.0250000
NODE_303556_length_158_cov_61.203390	39	119	243	1	80	0.0125000
NODE_303556_length_158_cov_61.203390	39	119	255	1	80	0.0125000
NODE_303556_length_158_cov_61.203390	39	119	261	1	80	0.0125000
NODE_303556_length_158_cov_61.203390	39	119	263	1	80	0.0125000
NODE_303556_length_158_cov_61.203390	39	119	265	1	80	0.0125000
NODE_303556_length_158_cov_61.203390	39	119	271	1	80	0.0125000
NODE_303556_length_158_cov_61.203390	39	119	282	3	80	0.0375000
NODE_303556_length_158_cov_61.203390	39	119	287	1	80	0.0125000
NODE_303556_length_158_cov_61.203390	39	119	295	1	80	0.0125000
NODE_303556_length_158_cov_61.203390	39	119	300	1	80	0.0125000
NODE_303556_length_158_cov_61.203390	39	119	306	1	80	0.0125000
NODE_303556_length_158_cov_61.203390	39	119	308	1	80	0.0125000
NODE_303556_length_158_cov_61.203390	39	119	312	1	80	0.0125000
NODE_303556_length_158_cov_61.203390	39	119	313	1	80	0.0125000
NODE_303556_length_158_cov_61.203390	39	119	317	2	80	0.0250000
NODE_303556_length_158_cov_61.203390	39	119	318	2	80	0.0250000
NODE_303556_length_158_cov_61.203390	39	119	319	1	80	0.0125000
NODE_303556_length_158_cov_61.203390	39	119	320	1	80	0.0125000
NODE_303556_length_158_cov_61.203390	39	119	321	1	80	0.0125000
NODE_303556_length_158_cov_61.203390	39	119	323	2	80	0.0250000
NODE_303556_length_158_cov_61.203390	39	119	325	2	80	0.0250000
NODE_303556_length_158_cov_61.203390	39	119	326	4	80	0.0500000
NODE_303556_length_158_cov_61.203390	39	119	327	1	80	0.0125000
NODE_303556_length_158_cov_61.203390	39	119	328	16	80	0.2000000
NODE_303556_length_158_cov_61.203390	39	119	329	5	80	0.0625000
NODE_303556_length_158_cov_61.203390	39	119	330	24	80	0.3000000
NODE_303563_length_158_cov_40.271186	43	107	46	1	64	0.0156250
NODE_303563_length_158_cov_40.271186	43	107	48	63	64	0.9843750
NODE_303563_length_158_cov_40.271186	80	151	30	5	71	0.0704225
NODE_303563_length_158_cov_40.271186	80	151	32	4	71	0.0563380
NODE_303563_length_158_cov_40.271186	80	151	34	8	71	0.1126761
NODE_303563_length_158_cov_40.271186	80	151	38	5	71	0.0704225
NODE_303563_length_158_cov_40.271186	80	151	40	8	71	0.1126761
NODE_303563_length_158_cov_40.271186	80	151	41	9	71	0.1267606
NODE_303563_length_158_cov_40.271186	80	151	42	2	71	0.0281690
NODE_303563_length_158_cov_40.271186	80	151	46	2	71	0.0281690
NODE_303563_length_158_cov_40.271186	80	151	48	28	71	0.3943662
NODE_303566_length_158_cov_29.661017	0	61	0	61	61	1.0000000
NODE_303566_length_158_cov_29.661017	34	64	0	30	30	1.0000000
NODE_303605_length_157_cov_1488.586207	57	138	299	1	81	0.0123457
NODE_303605_length_157_cov_1488.586207	57	138	311	1	81	0.0123457
NODE_303605_length_157_cov_1488.586207	57	138	315	1	81	0.0123457
NODE_303605_length_157_cov_1488.586207	57	138	329	1	81	0.0123457
NODE_303605_length_157_cov_1488.586207	57	138	349	1	81	0.0123457
NODE_303605_length_157_cov_1488.586207	57	138	375	1	81	0.0123457
NODE_303605_length_157_cov_1488.586207	57	138	404	1	81	0.0123457
NODE_303605_length_157_cov_1488.586207	57	138	434	1	81	0.0123457
NODE_303605_length_157_cov_1488.586207	57	138	479	1	81	0.0123457
NODE_303605_length_157_cov_1488.586207	57	138	485	1	81	0.0123457
NODE_303605_length_157_cov_1488.586207	57	138	489	1	81	0.0123457
NODE_303605_length_157_cov_1488.586207	57	138	496	1	81	0.0123457
NODE_303605_length_157_cov_1488.586207	57	138	505	1	81	0.0123457
NODE_303605_length_157_cov_1488.586207	57	138	531	1	81	0.0123457
NODE_303605_length_157_cov_1488.586207	57	138	533	1	81	0.0123457
NODE_303605_length_157_cov_1488.586207	57	138	536	1	81	0.0123457
NODE_303605_length_157_cov_1488.586207	57	138	540	1	81	0.0123457
NODE_303605_length_157_cov_1488.586207	57	138	550	1	81	0.0123457
NODE_303605_length_157_cov_1488.586207	57	138	560	1	81	0.0123457
NODE_303605_length_157_cov_1488.586207	57	138	563	1	81	0.0123457
NODE_303605_length_157_cov_1488.586207	57	138	570	1	81	0.0123457
NODE_303605_length_157_cov_1488.586207	57	138	572	1	81	0.0123457
NODE_303605_length_157_cov_1488.586207	57	138	574	1	81	0.0123457
NODE_303605_length_157_cov_1488.586207	57	138	581	1	81	0.0123457
NODE_303605_length_157_cov_1488.586207	57	138	587	1	81	0.0123457
NODE_303605_length_157_cov_1488.586207	57	138	588	1	81	0.0123457
NODE_303605_length_157_cov_1488.586207	57	138	595	1	81	0.0123457
NODE_303605_length_157_cov_1488.586207	57	138	601	1	81	0.0123457
NODE_303605_length_157_cov_1488.586207	57	138	603	1	81	0.0123457
NODE_303605_length_157_cov_1488.586207	57	138	607	1	81	0.0123457
NODE_303605_length_157_cov_1488.586207	57	138	613	1	81	0.0123457
NODE_303605_length_157_cov_1488.586207	57	138	617	1	81	0.0123457
NODE_303605_length_157_cov_1488.586207	57	138	623	1	81	0.0123457
NODE_303605_length_157_cov_1488.586207	57	138	625	1	81	0.0123457
NODE_303605_length_157_cov_1488.586207	57	138	628	12	81	0.1481481
NODE_303605_length_157_cov_1488.586207	57	138	629	16	81	0.1975309
NODE_303605_length_157_cov_1488.586207	57	138	630	9	81	0.1111111
NODE_303605_length_157_cov_1488.586207	57	138	631	10	81	0.1234568
NODE_303605_length_157_cov_1488.586207	111	157	21	1	46	0.0217391
NODE_303605_length_157_cov_1488.586207	111	157	30	1	46	0.0217391
NODE_303605_length_157_cov_1488.586207	111	157	34	1	46	0.0217391
NODE_303605_length_157_cov_1488.586207	111	157	36	1	46	0.0217391
NODE_303605_length_157_cov_1488.586207	111	157	47	1	46	0.0217391
NODE_303605_length_157_cov_1488.586207	111	157	53	1	46	0.0217391
NODE_303605_length_157_cov_1488.586207	111	157	64	1	46	0.0217391
NODE_303605_length_157_cov_1488.586207	111	157	85	1	46	0.0217391
NODE_303605_length_157_cov_1488.586207	111	157	92	1	46	0.0217391
NODE_303605_length_157_cov_1488.586207	111	157	107	1	46	0.0217391
NODE_303605_length_157_cov_1488.586207	111	157	129	1	46	0.0217391
NODE_303605_length_157_cov_1488.586207	111	157	150	1	46	0.0217391
NODE_303605_length_157_cov_1488.586207	111	157	170	1	46	0.0217391
NODE_303605_length_157_cov_1488.586207	111	157	189	1	46	0.0217391
NODE_303605_length_157_cov_1488.586207	111	157	191	1	46	0.0217391
NODE_303605_length_157_cov_1488.586207	111	157	200	1	46	0.0217391
NODE_303605_length_157_cov_1488.586207	111	157	217	1	46	0.0217391
NODE_303605_length_157_cov_1488.586207	111	157	239	1	46	0.0217391
NODE_303605_length_157_cov_1488.586207	111	157	286	1	46	0.0217391
NODE_303605_length_157_cov_1488.586207	111	157	299	1	46	0.0217391
NODE_303605_length_157_cov_1488.586207	111	157	311	1	46	0.0217391
NODE_303605_length_157_cov_1488.586207	111	157	315	1	46	0.0217391
NODE_303605_length_157_cov_1488.586207	111	157	329	1	46	0.0217391
NODE_303605_length_157_cov_1488.586207	111	157	349	1	46	0.0217391
NODE_303605_length_157_cov_1488.586207	111	157	375	1	46	0.0217391
NODE_303605_length_157_cov_1488.586207	111	157	404	1	46	0.0217391
NODE_303605_length_157_cov_1488.586207	111	157	434	1	46	0.0217391
NODE_303605_length_157_cov_1488.586207	111	157	479	1	46	0.0217391
NODE_303605_length_157_cov_1488.586207	111	157	485	1	46	0.0217391
NODE_303605_length_157_cov_1488.586207	111	157	489	1	46	0.0217391
NODE_303605_length_157_cov_1488.586207	111	157	496	1	46	0.0217391
NODE_303605_length_157_cov_1488.586207	111	157	505	1	46	0.0217391
NODE_303605_length_157_cov_1488.586207	111	157	531	1	46	0.0217391
NODE_303605_length_157_cov_1488.586207	111	157	533	1	46	0.0217391
NODE_303605_length_157_cov_1488.586207	111	157	536	1	46	0.0217391
NODE_303605_length_157_cov_1488.586207	111	157	540	1	46	0.0217391
NODE_303605_length_157_cov_1488.586207	111	157	550	1	46	0.0217391
NODE_303605_length_157_cov_1488.586207	111	157	560	1	46	0.0217391
NODE_303605_length_157_cov_1488.586207	111	157	563	1	46	0.0217391
NODE_303605_length_157_cov_1488.586207	111	157	570	1	46	0.0217391
NODE_303605_length_157_cov_1488.586207	111	157	572	1	46	0.0217391
NODE_303605_length_157_cov_1488.586207	111	157	574	1	46	0.0217391
NODE_303605_length_157_cov_1488.586207	111	157	581	1	46	0.0217391
NODE_303605_length_157_cov_1488.586207	111	157	587	1	46	0.0217391
NODE_303605_length_157_cov_1488.586207	111	157	588	1	46	0.0217391
NODE_303605_length_157_cov_1488.586207	111	157	595	1	46	0.0217391
NODE_303606_length_157_cov_295.896552	32	78	22	1	46	0.0217391
NODE_303606_length_157_cov_295.896552	32	78	24	1	46	0.0217391
NODE_303606_length_157_cov_295.896552	32	78	26	1	46	0.0217391
NODE_303606_length_157_cov_295.896552	32	78	28	2	46	0.0434783
NODE_303606_length_157_cov_295.896552	32	78	30	4	46	0.0869565
NODE_303606_length_157_cov_295.896552	32	78	34	1	46	0.0217391
NODE_303606_length_157_cov_295.896552	32	78	36	2	46	0.0434783
NODE_303606_length_157_cov_295.896552	32	78	42	2	46	0.0434783
NODE_303606_length_157_cov_295.896552	32	78	48	6	46	0.1304348
NODE_303606_length_157_cov_295.896552	32	78	50	26	46	0.5652174
NODE_303608_length_157_cov_161.689655	0	59	0	36	59	0.6101695
NODE_303608_length_157_cov_161.689655	0	59	8	1	59	0.0169492
NODE_303608_length_157_cov_161.689655	0	59	9	1	59	0.0169492
NODE_303608_length_157_cov_161.689655	0	59	17	15	59	0.2542373
NODE_303608_length_157_cov_161.689655	0	59	19	6	59	0.1016949
NODE_303608_length_157_cov_161.689655	0	59	0	36	59	0.6101695
NODE_303608_length_157_cov_161.689655	0	59	8	1	59	0.0169492
NODE_303608_length_157_cov_161.689655	0	59	9	1	59	0.0169492
NODE_303608_length_157_cov_161.689655	0	59	17	15	59	0.2542373
NODE_303608_length_157_cov_161.689655	0	59	19	6	59	0.1016949
NODE_303608_length_157_cov_161.689655	55	135	0	5	80	0.0625000
NODE_303608_length_157_cov_161.689655	55	135	4	1	80	0.0125000
NODE_303608_length_157_cov_161.689655	55	135	6	2	80	0.0250000
NODE_303608_length_157_cov_161.689655	55	135	15	8	80	0.1000000
NODE_303608_length_157_cov_161.689655	55	135	17	4	80	0.0500000
NODE_303608_length_157_cov_161.689655	55	135	19	60	80	0.7500000
NODE_303608_length_157_cov_161.689655	55	135	0	5	80	0.0625000
NODE_303608_length_157_cov_161.689655	55	135	4	1	80	0.0125000
NODE_303608_length_157_cov_161.689655	55	135	6	2	80	0.0250000
NODE_303608_length_157_cov_161.689655	55	135	15	8	80	0.1000000
NODE_303608_length_157_cov_161.689655	55	135	17	4	80	0.0500000
NODE_303608_length_157_cov_161.689655	55	135	19	60	80	0.7500000
NODE_303608_length_157_cov_161.689655	108	157	0	27	49	0.5510204
NODE_303608_length_157_cov_161.689655	108	157	4	1	49	0.0204082
NODE_303608_length_157_cov_161.689655	108	157	6	2	49	0.0408163
NODE_303608_length_157_cov_161.689655	108	157	15	8	49	0.1632653
NODE_303608_length_157_cov_161.689655	108	157	17	4	49	0.0816327
NODE_303608_length_157_cov_161.689655	108	157	19	7	49	0.1428571
NODE_303608_length_157_cov_161.689655	113	157	0	27	44	0.6136364
NODE_303608_length_157_cov_161.689655	113	157	4	1	44	0.0227273
NODE_303608_length_157_cov_161.689655	113	157	6	2	44	0.0454545
NODE_303608_length_157_cov_161.689655	113	157	15	8	44	0.1818182
NODE_303608_length_157_cov_161.689655	113	157	17	4	44	0.0909091
NODE_303608_length_157_cov_161.689655	113	157	19	2	44	0.0454545
NODE_303677_length_156_cov_100.491228	0	41	8	18	41	0.4390244
NODE_303677_length_156_cov_100.491228	0	41	14	20	41	0.4878049
NODE_303677_length_156_cov_100.491228	0	41	16	3	41	0.0731707
NODE_303677_length_156_cov_100.491228	21	94	14	17	73	0.2328767
NODE_303677_length_156_cov_100.491228	21	94	15	2	73	0.0273973
NODE_303677_length_156_cov_100.491228	21	94	16	54	73	0.7397260
NODE_303688_length_156_cov_37.368421	24	81	0	1	57	0.0175439
NODE_303688_length_156_cov_37.368421	24	81	2	1	57	0.0175439
NODE_303688_length_156_cov_37.368421	24	81	4	3	57	0.0526316
NODE_303688_length_156_cov_37.368421	24	81	22	2	57	0.0350877
NODE_303688_length_156_cov_37.368421	24	81	24	6	57	0.1052632
NODE_303688_length_156_cov_37.368421	24	81	27	10	57	0.1754386
NODE_303688_length_156_cov_37.368421	24	81	29	1	57	0.0175439
NODE_303688_length_156_cov_37.368421	24	81	33	1	57	0.0175439
NODE_303688_length_156_cov_37.368421	24	81	39	2	57	0.0350877
NODE_303688_length_156_cov_37.368421	24	81	43	2	57	0.0350877
NODE_303688_length_156_cov_37.368421	24	81	45	16	57	0.2807018
NODE_303688_length_156_cov_37.368421	24	81	46	12	57	0.2105263
NODE_303688_length_156_cov_37.368421	54	134	43	3	80	0.0375000
NODE_303688_length_156_cov_37.368421	54	134	45	35	80	0.4375000
NODE_303688_length_156_cov_37.368421	54	134	46	42	80	0.5250000
NODE_303700_length_156_cov_9.543860	2	48	0	46	46	1.0000000
NODE_303700_length_156_cov_9.543860	59	105	0	46	46	1.0000000
NODE_303752_length_155_cov_56.750000	27	102	0	75	75	1.0000000
NODE_303752_length_155_cov_56.750000	80	155	0	75	75	1.0000000
NODE_304022_length_153_cov_0.944444	5	48	0	43	43	1.0000000
NODE_304022_length_153_cov_0.944444	37	86	0	49	49	1.0000000
NODE_304022_length_153_cov_0.944444	59	102	0	43	43	1.0000000
NODE_304022_length_153_cov_0.944444	91	140	0	49	49	1.0000000
NODE_304022_length_153_cov_0.944444	113	153	0	40	40	1.0000000
NODE_304027_length_152_cov_195.396226	9	89	0	6	80	0.0750000
NODE_304027_length_152_cov_195.396226	9	89	6	8	80	0.1000000
NODE_304027_length_152_cov_195.396226	9	89	22	66	80	0.8250000
NODE_304027_length_152_cov_195.396226	9	89	0	6	80	0.0750000
NODE_304027_length_152_cov_195.396226	9	89	6	8	80	0.1000000
NODE_304027_length_152_cov_195.396226	9	89	22	66	80	0.8250000
NODE_304027_length_152_cov_195.396226	85	149	16	18	64	0.2812500
NODE_304027_length_152_cov_195.396226	85	149	22	46	64	0.7187500
NODE_304027_length_152_cov_195.396226	85	152	0	1	67	0.0149254
NODE_304027_length_152_cov_195.396226	85	152	15	2	67	0.0298507
NODE_304027_length_152_cov_195.396226	85	152	16	18	67	0.2686567
NODE_304027_length_152_cov_195.396226	85	152	22	46	67	0.6865672
NODE_304027_length_152_cov_195.396226	85	152	0	1	67	0.0149254
NODE_304027_length_152_cov_195.396226	85	152	15	2	67	0.0298507
NODE_304027_length_152_cov_195.396226	85	152	16	18	67	0.2686567
NODE_304027_length_152_cov_195.396226	85	152	22	46	67	0.6865672
NODE_304027_length_152_cov_195.396226	85	152	0	1	67	0.0149254
NODE_304027_length_152_cov_195.396226	85	152	15	2	67	0.0298507
NODE_304027_length_152_cov_195.396226	85	152	16	18	67	0.2686567
NODE_304027_length_152_cov_195.396226	85	152	22	46	67	0.6865672
NODE_304030_length_152_cov_68.094340	99	150	0	16	51	0.3137255
NODE_304030_length_152_cov_68.094340	99	150	2	1	51	0.0196078
NODE_304030_length_152_cov_68.094340	99	150	4	34	51	0.6666667
NODE_304112_length_151_cov_541.615385	19	88	32	5	69	0.0724638
NODE_304112_length_151_cov_541.615385	19	88	40	12	69	0.1739130
NODE_304112_length_151_cov_541.615385	19	88	42	2	69	0.0289855
NODE_304112_length_151_cov_541.615385	19	88	44	1	69	0.0144928
NODE_304112_length_151_cov_541.615385	19	88	48	3	69	0.0434783
NODE_304112_length_151_cov_541.615385	19	88	52	2	69	0.0289855
NODE_304112_length_151_cov_541.615385	19	88	58	44	69	0.6376812
NODE_304112_length_151_cov_541.615385	72	149	11	6	77	0.0779221
NODE_304112_length_151_cov_541.615385	72	149	13	2	77	0.0259740
NODE_304112_length_151_cov_541.615385	72	149	15	2	77	0.0259740
NODE_304112_length_151_cov_541.615385	72	149	19	2	77	0.0259740
NODE_304112_length_151_cov_541.615385	72	149	27	1	77	0.0129870
NODE_304112_length_151_cov_541.615385	72	149	28	4	77	0.0519481
NODE_304112_length_151_cov_541.615385	72	149	34	4	77	0.0519481
NODE_304112_length_151_cov_541.615385	72	149	36	7	77	0.0909091
NODE_304112_length_151_cov_541.615385	72	149	40	5	77	0.0649351
NODE_304112_length_151_cov_541.615385	72	149	44	2	77	0.0259740
NODE_304112_length_151_cov_541.615385	72	149	46	1	77	0.0129870
NODE_304112_length_151_cov_541.615385	72	149	52	5	77	0.0649351
NODE_304112_length_151_cov_541.615385	72	149	54	1	77	0.0129870
NODE_304112_length_151_cov_541.615385	72	149	56	4	77	0.0519481
NODE_304112_length_151_cov_541.615385	72	149	58	31	77	0.4025974
NODE_304229_length_150_cov_88.647059	51	102	0	51	51	1.0000000
NODE_304472_length_148_cov_34.183673	23	99	78	1	76	0.0131579
NODE_304472_length_148_cov_34.183673	23	99	81	1	76	0.0131579
NODE_304472_length_148_cov_34.183673	23	99	87	1	76	0.0131579
NODE_304472_length_148_cov_34.183673	23	99	99	1	76	0.0131579
NODE_304472_length_148_cov_34.183673	23	99	103	1	76	0.0131579
NODE_304472_length_148_cov_34.183673	23	99	108	1	76	0.0131579
NODE_304472_length_148_cov_34.183673	23	99	121	1	76	0.0131579
NODE_304472_length_148_cov_34.183673	23	99	124	1	76	0.0131579
NODE_304472_length_148_cov_34.183673	23	99	128	1	76	0.0131579
NODE_304472_length_148_cov_34.183673	23	99	138	1	76	0.0131579
NODE_304472_length_148_cov_34.183673	23	99	146	1	76	0.0131579
NODE_304472_length_148_cov_34.183673	23	99	156	2	76	0.0263158
NODE_304472_length_148_cov_34.183673	23	99	160	2	76	0.0263158
NODE_304472_length_148_cov_34.183673	23	99	168	2	76	0.0263158
NODE_304472_length_148_cov_34.183673	23	99	170	3	76	0.0394737
NODE_304472_length_148_cov_34.183673	23	99	172	1	76	0.0131579
NODE_304472_length_148_cov_34.183673	23	99	174	54	76	0.7105263
NODE_304472_length_148_cov_34.183673	23	99	176	1	76	0.0131579
NODE_304570_length_147_cov_472.354167	0	55	2	1	55	0.0181818
NODE_304570_length_147_cov_472.354167	0	55	6	2	55	0.0363636
NODE_304570_length_147_cov_472.354167	0	55	8	1	55	0.0181818
NODE_304570_length_147_cov_472.354167	0	55	9	1	55	0.0181818
NODE_304570_length_147_cov_472.354167	0	55	10	1	55	0.0181818
NODE_304570_length_147_cov_472.354167	0	55	12	1	55	0.0181818
NODE_304570_length_147_cov_472.354167	0	55	16	4	55	0.0727273
NODE_304570_length_147_cov_472.354167	0	55	18	2	55	0.0363636
NODE_304570_length_147_cov_472.354167	0	55	24	1	55	0.0181818
NODE_304570_length_147_cov_472.354167	0	55	26	1	55	0.0181818
NODE_304570_length_147_cov_472.354167	0	55	30	2	55	0.0363636
NODE_304570_length_147_cov_472.354167	0	55	37	3	55	0.0545455
NODE_304570_length_147_cov_472.354167	0	55	38	2	55	0.0363636
NODE_304570_length_147_cov_472.354167	0	55	40	17	55	0.3090909
NODE_304570_length_147_cov_472.354167	0	55	42	3	55	0.0545455
NODE_304570_length_147_cov_472.354167	0	55	44	1	55	0.0181818
NODE_304570_length_147_cov_472.354167	0	55	46	12	55	0.2181818
NODE_304570_length_147_cov_472.354167	12	89	18	1	77	0.0129870
NODE_304570_length_147_cov_472.354167	12	89	24	1	77	0.0129870
NODE_304570_length_147_cov_472.354167	12	89	26	1	77	0.0129870
NODE_304570_length_147_cov_472.354167	12	89	30	2	77	0.0259740
NODE_304570_length_147_cov_472.354167	12	89	37	3	77	0.0389610
NODE_304570_length_147_cov_472.354167	12	89	38	2	77	0.0259740
NODE_304570_length_147_cov_472.354167	12	89	40	17	77	0.2207792
NODE_304570_length_147_cov_472.354167	12	89	42	3	77	0.0389610
NODE_304570_length_147_cov_472.354167	12	89	44	1	77	0.0129870
NODE_304570_length_147_cov_472.354167	12	89	46	46	77	0.5974026
NODE_304570_length_147_cov_472.354167	65	137	20	3	72	0.0416667
NODE_304570_length_147_cov_472.354167	65	137	22	8	72	0.1111111
NODE_304570_length_147_cov_472.354167	65	137	26	1	72	0.0138889
NODE_304570_length_147_cov_472.354167	65	137	28	2	72	0.0277778
NODE_304570_length_147_cov_472.354167	65	137	30	1	72	0.0138889
NODE_304570_length_147_cov_472.354167	65	137	32	1	72	0.0138889
NODE_304570_length_147_cov_472.354167	65	137	34	6	72	0.0833333
NODE_304570_length_147_cov_472.354167	65	137	38	1	72	0.0138889
NODE_304570_length_147_cov_472.354167	65	137	40	1	72	0.0138889
NODE_304570_length_147_cov_472.354167	65	137	42	5	72	0.0694444
NODE_304570_length_147_cov_472.354167	65	137	44	4	72	0.0555556
NODE_304570_length_147_cov_472.354167	65	137	46	39	72	0.5416667
NODE_304572_length_147_cov_229.729167	7	56	14	1	49	0.0204082
NODE_304572_length_147_cov_229.729167	7	56	17	3	49	0.0612245
NODE_304572_length_147_cov_229.729167	7	56	19	2	49	0.0408163
NODE_304572_length_147_cov_229.729167	7	56	20	1	49	0.0204082
NODE_304572_length_147_cov_229.729167	7	56	28	1	49	0.0204082
NODE_304572_length_147_cov_229.729167	7	56	29	3	49	0.0612245
NODE_304572_length_147_cov_229.729167	7	56	31	1	49	0.0204082
NODE_304572_length_147_cov_229.729167	7	56	33	4	49	0.0816327
NODE_304572_length_147_cov_229.729167	7	56	41	1	49	0.0204082
NODE_304572_length_147_cov_229.729167	7	56	45	3	49	0.0612245
NODE_304572_length_147_cov_229.729167	7	56	49	2	49	0.0408163
NODE_304572_length_147_cov_229.729167	7	56	53	2	49	0.0408163
NODE_304572_length_147_cov_229.729167	7	56	55	2	49	0.0408163
NODE_304572_length_147_cov_229.729167	7	56	57	1	49	0.0204082
NODE_304572_length_147_cov_229.729167	7	56	59	1	49	0.0204082
NODE_304572_length_147_cov_229.729167	7	56	61	1	49	0.0204082
NODE_304572_length_147_cov_229.729167	7	56	63	1	49	0.0204082
NODE_304572_length_147_cov_229.729167	7	56	65	5	49	0.1020408
NODE_304572_length_147_cov_229.729167	7	56	66	14	49	0.2857143
NODE_304572_length_147_cov_229.729167	29	93	53	2	64	0.0312500
NODE_304572_length_147_cov_229.729167	29	93	55	2	64	0.0312500
NODE_304572_length_147_cov_229.729167	29	93	57	1	64	0.0156250
NODE_304572_length_147_cov_229.729167	29	93	59	1	64	0.0156250
NODE_304572_length_147_cov_229.729167	29	93	61	1	64	0.0156250
NODE_304572_length_147_cov_229.729167	29	93	63	1	64	0.0156250
NODE_304572_length_147_cov_229.729167	29	93	65	5	64	0.0781250
NODE_304572_length_147_cov_229.729167	29	93	66	51	64	0.7968750
NODE_304572_length_147_cov_229.729167	29	93	53	2	64	0.0312500
NODE_304572_length_147_cov_229.729167	29	93	55	2	64	0.0312500
NODE_304572_length_147_cov_229.729167	29	93	57	1	64	0.0156250
NODE_304572_length_147_cov_229.729167	29	93	59	1	64	0.0156250
NODE_304572_length_147_cov_229.729167	29	93	61	1	64	0.0156250
NODE_304572_length_147_cov_229.729167	29	93	63	1	64	0.0156250
NODE_304572_length_147_cov_229.729167	29	93	65	5	64	0.0781250
NODE_304572_length_147_cov_229.729167	29	93	66	51	64	0.7968750
NODE_304572_length_147_cov_229.729167	29	93	53	2	64	0.0312500
NODE_304572_length_147_cov_229.729167	29	93	55	2	64	0.0312500
NODE_304572_length_147_cov_229.729167	29	93	57	1	64	0.0156250
NODE_304572_length_147_cov_229.729167	29	93	59	1	64	0.0156250
NODE_304572_length_147_cov_229.729167	29	93	61	1	64	0.0156250
NODE_304572_length_147_cov_229.729167	29	93	63	1	64	0.0156250
NODE_304572_length_147_cov_229.729167	29	93	65	5	64	0.0781250
NODE_304572_length_147_cov_229.729167	29	93	66	51	64	0.7968750
NODE_304573_length_147_cov_213.770833	37	117	0	80	80	1.0000000
NODE_304573_length_147_cov_213.770833	90	146	0	56	56	1.0000000
NODE_304697_length_146_cov_182.893617	1	60	0	21	59	0.3559322
NODE_304697_length_146_cov_182.893617	1	60	2	38	59	0.6440678
NODE_304697_length_146_cov_182.893617	34	60	2	26	26	1.0000000
NODE_304697_length_146_cov_182.893617	113	144	0	31	31	1.0000000
NODE_304698_length_146_cov_152.808511	0	69	0	69	69	1.0000000
NODE_304698_length_146_cov_152.808511	42	122	0	80	80	1.0000000
NODE_304703_length_146_cov_89.808511	0	53	0	2	53	0.0377358
NODE_304703_length_146_cov_89.808511	0	53	4	13	53	0.2452830
NODE_304703_length_146_cov_89.808511	0	53	6	17	53	0.3207547
NODE_304703_length_146_cov_89.808511	0	53	8	21	53	0.3962264
NODE_304703_length_146_cov_89.808511	26	106	6	6	80	0.0750000
NODE_304703_length_146_cov_89.808511	26	106	8	74	80	0.9250000
NODE_304703_length_146_cov_89.808511	74	146	2	19	72	0.2638889
NODE_304703_length_146_cov_89.808511	74	146	4	14	72	0.1944444
NODE_304703_length_146_cov_89.808511	74	146	8	39	72	0.5416667
NODE_304703_length_146_cov_89.808511	79	101	8	22	22	1.0000000
NODE_304707_length_146_cov_57.446809	44	124	0	7	80	0.0875000
NODE_304707_length_146_cov_57.446809	44	124	2	73	80	0.9125000
NODE_304708_length_146_cov_54.106383	0	69	0	69	69	1.0000000
NODE_304708_length_146_cov_54.106383	42	122	0	80	80	1.0000000
NODE_304710_length_146_cov_46.765957	3	83	0	13	80	0.1625000
NODE_304710_length_146_cov_46.765957	3	83	6	67	80	0.8375000
NODE_304710_length_146_cov_46.765957	3	83	0	13	80	0.1625000
NODE_304710_length_146_cov_46.765957	3	83	6	67	80	0.8375000
NODE_304710_length_146_cov_46.765957	3	83	0	13	80	0.1625000
NODE_304710_length_146_cov_46.765957	3	83	6	67	80	0.8375000
NODE_304710_length_146_cov_46.765957	3	83	0	13	80	0.1625000
NODE_304710_length_146_cov_46.765957	3	83	6	67	80	0.8375000
NODE_304710_length_146_cov_46.765957	3	83	0	13	80	0.1625000
NODE_304710_length_146_cov_46.765957	3	83	6	67	80	0.8375000
NODE_304710_length_146_cov_46.765957	12	83	0	4	71	0.0563380
NODE_304710_length_146_cov_46.765957	12	83	6	67	71	0.9436620
NODE_304710_length_146_cov_46.765957	56	136	0	17	80	0.2125000
NODE_304710_length_146_cov_46.765957	56	136	6	63	80	0.7875000
NODE_304710_length_146_cov_46.765957	56	136	0	17	80	0.2125000
NODE_304710_length_146_cov_46.765957	56	136	6	63	80	0.7875000
NODE_304711_length_146_cov_44.021277	0	69	0	69	69	1.0000000
NODE_304711_length_146_cov_44.021277	42	122	0	80	80	1.0000000
NODE_304798_length_145_cov_1385.413043	0	69	81	1	69	0.0144928
NODE_304798_length_145_cov_1385.413043	0	69	107	1	69	0.0144928
NODE_304798_length_145_cov_1385.413043	0	69	110	1	69	0.0144928
NODE_304798_length_145_cov_1385.413043	0	69	133	1	69	0.0144928
NODE_304798_length_145_cov_1385.413043	0	69	145	1	69	0.0144928
NODE_304798_length_145_cov_1385.413043	0	69	146	1	69	0.0144928
NODE_304798_length_145_cov_1385.413043	0	69	159	1	69	0.0144928
NODE_304798_length_145_cov_1385.413043	0	69	166	1	69	0.0144928
NODE_304798_length_145_cov_1385.413043	0	69	177	1	69	0.0144928
NODE_304798_length_145_cov_1385.413043	0	69	181	1	69	0.0144928
NODE_304798_length_145_cov_1385.413043	0	69	223	1	69	0.0144928
NODE_304798_length_145_cov_1385.413043	0	69	227	1	69	0.0144928
NODE_304798_length_145_cov_1385.413043	0	69	240	2	69	0.0289855
NODE_304798_length_145_cov_1385.413043	0	69	266	1	69	0.0144928
NODE_304798_length_145_cov_1385.413043	0	69	285	1	69	0.0144928
NODE_304798_length_145_cov_1385.413043	0	69	296	1	69	0.0144928
NODE_304798_length_145_cov_1385.413043	0	69	312	1	69	0.0144928
NODE_304798_length_145_cov_1385.413043	0	69	318	1	69	0.0144928
NODE_304798_length_145_cov_1385.413043	0	69	332	1	69	0.0144928
NODE_304798_length_145_cov_1385.413043	0	69	336	1	69	0.0144928
NODE_304798_length_145_cov_1385.413043	0	69	340	1	69	0.0144928
NODE_304798_length_145_cov_1385.413043	0	69	349	1	69	0.0144928
NODE_304798_length_145_cov_1385.413043	0	69	350	1	69	0.0144928
NODE_304798_length_145_cov_1385.413043	0	69	352	1	69	0.0144928
NODE_304798_length_145_cov_1385.413043	0	69	356	2	69	0.0289855
NODE_304798_length_145_cov_1385.413043	0	69	368	1	69	0.0144928
NODE_304798_length_145_cov_1385.413043	0	69	374	1	69	0.0144928
NODE_304798_length_145_cov_1385.413043	0	69	391	1	69	0.0144928
NODE_304798_length_145_cov_1385.413043	0	69	393	1	69	0.0144928
NODE_304798_length_145_cov_1385.413043	0	69	421	1	69	0.0144928
NODE_304798_length_145_cov_1385.413043	0	69	423	1	69	0.0144928
NODE_304798_length_145_cov_1385.413043	0	69	436	1	69	0.0144928
NODE_304798_length_145_cov_1385.413043	0	69	442	2	69	0.0289855
NODE_304798_length_145_cov_1385.413043	0	69	450	1	69	0.0144928
NODE_304798_length_145_cov_1385.413043	0	69	454	1	69	0.0144928
NODE_304798_length_145_cov_1385.413043	0	69	456	1	69	0.0144928
NODE_304798_length_145_cov_1385.413043	0	69	468	1	69	0.0144928
NODE_304798_length_145_cov_1385.413043	0	69	509	1	69	0.0144928
NODE_304798_length_145_cov_1385.413043	0	69	523	1	69	0.0144928
NODE_304798_length_145_cov_1385.413043	0	69	531	1	69	0.0144928
NODE_304798_length_145_cov_1385.413043	0	69	535	21	69	0.3043478
NODE_304798_length_145_cov_1385.413043	0	69	536	3	69	0.0434783
NODE_304798_length_145_cov_1385.413043	0	69	537	2	69	0.0289855
NODE_304798_length_145_cov_1385.413043	42	122	388	1	80	0.0125000
NODE_304798_length_145_cov_1385.413043	42	122	397	1	80	0.0125000
NODE_304798_length_145_cov_1385.413043	42	122	413	1	80	0.0125000
NODE_304798_length_145_cov_1385.413043	42	122	416	1	80	0.0125000
NODE_304798_length_145_cov_1385.413043	42	122	420	1	80	0.0125000
NODE_304798_length_145_cov_1385.413043	42	122	421	1	80	0.0125000
NODE_304798_length_145_cov_1385.413043	42	122	435	1	80	0.0125000
NODE_304798_length_145_cov_1385.413043	42	122	447	2	80	0.0250000
NODE_304798_length_145_cov_1385.413043	42	122	455	1	80	0.0125000
NODE_304798_length_145_cov_1385.413043	42	122	456	1	80	0.0125000
NODE_304798_length_145_cov_1385.413043	42	122	476	1	80	0.0125000
NODE_304798_length_145_cov_1385.413043	42	122	480	1	80	0.0125000
NODE_304798_length_145_cov_1385.413043	42	122	487	1	80	0.0125000
NODE_304798_length_145_cov_1385.413043	42	122	504	1	80	0.0125000
NODE_304798_length_145_cov_1385.413043	42	122	508	1	80	0.0125000
NODE_304798_length_145_cov_1385.413043	42	122	514	1	80	0.0125000
NODE_304798_length_145_cov_1385.413043	42	122	523	1	80	0.0125000
NODE_304798_length_145_cov_1385.413043	42	122	527	1	80	0.0125000
NODE_304798_length_145_cov_1385.413043	42	122	529	1	80	0.0125000
NODE_304798_length_145_cov_1385.413043	42	122	531	1	80	0.0125000
NODE_304798_length_145_cov_1385.413043	42	122	533	1	80	0.0125000
NODE_304798_length_145_cov_1385.413043	42	122	534	14	80	0.1750000
NODE_304798_length_145_cov_1385.413043	42	122	535	29	80	0.3625000
NODE_304798_length_145_cov_1385.413043	42	122	536	8	80	0.1000000
NODE_304798_length_145_cov_1385.413043	42	122	537	7	80	0.0875000
NODE_304799_length_145_cov_880.369565	56	120	126	1	64	0.0156250
NODE_304799_length_145_cov_880.369565	56	120	127	2	64	0.0312500
NODE_304799_length_145_cov_880.369565	56	120	129	1	64	0.0156250
NODE_304799_length_145_cov_880.369565	56	120	139	1	64	0.0156250
NODE_304799_length_145_cov_880.369565	56	120	143	1	64	0.0156250
NODE_304799_length_145_cov_880.369565	56	120	154	2	64	0.0312500
NODE_304799_length_145_cov_880.369565	56	120	166	2	64	0.0312500
NODE_304799_length_145_cov_880.369565	56	120	180	2	64	0.0312500
NODE_304799_length_145_cov_880.369565	56	120	194	2	64	0.0312500
NODE_304799_length_145_cov_880.369565	56	120	202	2	64	0.0312500
NODE_304799_length_145_cov_880.369565	56	120	210	1	64	0.0156250
NODE_304799_length_145_cov_880.369565	56	120	214	47	64	0.7343750
NODE_304799_length_145_cov_880.369565	56	120	126	1	64	0.0156250
NODE_304799_length_145_cov_880.369565	56	120	127	2	64	0.0312500
NODE_304799_length_145_cov_880.369565	56	120	129	1	64	0.0156250
NODE_304799_length_145_cov_880.369565	56	120	139	1	64	0.0156250
NODE_304799_length_145_cov_880.369565	56	120	143	1	64	0.0156250
NODE_304799_length_145_cov_880.369565	56	120	154	2	64	0.0312500
NODE_304799_length_145_cov_880.369565	56	120	166	2	64	0.0312500
NODE_304799_length_145_cov_880.369565	56	120	180	2	64	0.0312500
NODE_304799_length_145_cov_880.369565	56	120	194	2	64	0.0312500
NODE_304799_length_145_cov_880.369565	56	120	202	2	64	0.0312500
NODE_304799_length_145_cov_880.369565	56	120	210	1	64	0.0156250
NODE_304799_length_145_cov_880.369565	56	120	214	47	64	0.7343750
NODE_304799_length_145_cov_880.369565	56	120	126	1	64	0.0156250
NODE_304799_length_145_cov_880.369565	56	120	127	2	64	0.0312500
NODE_304799_length_145_cov_880.369565	56	120	129	1	64	0.0156250
NODE_304799_length_145_cov_880.369565	56	120	139	1	64	0.0156250
NODE_304799_length_145_cov_880.369565	56	120	143	1	64	0.0156250
NODE_304799_length_145_cov_880.369565	56	120	154	2	64	0.0312500
NODE_304799_length_145_cov_880.369565	56	120	166	2	64	0.0312500
NODE_304799_length_145_cov_880.369565	56	120	180	2	64	0.0312500
NODE_304799_length_145_cov_880.369565	56	120	194	2	64	0.0312500
NODE_304799_length_145_cov_880.369565	56	120	202	2	64	0.0312500
NODE_304799_length_145_cov_880.369565	56	120	210	1	64	0.0156250
NODE_304799_length_145_cov_880.369565	56	120	214	47	64	0.7343750
NODE_304799_length_145_cov_880.369565	93	142	25	1	49	0.0204082
NODE_304799_length_145_cov_880.369565	93	142	35	1	49	0.0204082
NODE_304799_length_145_cov_880.369565	93	142	39	1	49	0.0204082
NODE_304799_length_145_cov_880.369565	93	142	41	2	49	0.0408163
NODE_304799_length_145_cov_880.369565	93	142	43	1	49	0.0204082
NODE_304799_length_145_cov_880.369565	93	142	45	1	49	0.0204082
NODE_304799_length_145_cov_880.369565	93	142	51	1	49	0.0204082
NODE_304799_length_145_cov_880.369565	93	142	53	3	49	0.0612245
NODE_304799_length_145_cov_880.369565	93	142	55	1	49	0.0204082
NODE_304799_length_145_cov_880.369565	93	142	77	1	49	0.0204082
NODE_304799_length_145_cov_880.369565	93	142	85	1	49	0.0204082
NODE_304799_length_145_cov_880.369565	93	142	86	1	49	0.0204082
NODE_304799_length_145_cov_880.369565	93	142	88	1	49	0.0204082
NODE_304799_length_145_cov_880.369565	93	142	90	1	49	0.0204082
NODE_304799_length_145_cov_880.369565	93	142	96	2	49	0.0408163
NODE_304799_length_145_cov_880.369565	93	142	106	1	49	0.0204082
NODE_304799_length_145_cov_880.369565	93	142	110	1	49	0.0204082
NODE_304799_length_145_cov_880.369565	93	142	119	1	49	0.0204082
NODE_304799_length_145_cov_880.369565	93	142	126	1	49	0.0204082
NODE_304799_length_145_cov_880.369565	93	142	127	2	49	0.0408163
NODE_304799_length_145_cov_880.369565	93	142	129	1	49	0.0204082
NODE_304799_length_145_cov_880.369565	93	142	139	1	49	0.0204082
NODE_304799_length_145_cov_880.369565	93	142	143	1	49	0.0204082
NODE_304799_length_145_cov_880.369565	93	142	154	2	49	0.0408163
NODE_304799_length_145_cov_880.369565	93	142	166	2	49	0.0408163
NODE_304799_length_145_cov_880.369565	93	142	180	2	49	0.0408163
NODE_304799_length_145_cov_880.369565	93	142	194	2	49	0.0408163
NODE_304799_length_145_cov_880.369565	93	142	202	2	49	0.0408163
NODE_304799_length_145_cov_880.369565	93	142	210	1	49	0.0204082
NODE_304799_length_145_cov_880.369565	93	142	214	10	49	0.2040816
NODE_304923_length_144_cov_46.155556	1	81	12	4	80	0.0500000
NODE_304923_length_144_cov_46.155556	1	81	14	2	80	0.0250000
NODE_304923_length_144_cov_46.155556	1	81	20	3	80	0.0375000
NODE_304923_length_144_cov_46.155556	1	81	22	4	80	0.0500000
NODE_304923_length_144_cov_46.155556	1	81	24	3	80	0.0375000
NODE_304923_length_144_cov_46.155556	1	81	28	1	80	0.0125000
NODE_304923_length_144_cov_46.155556	1	81	31	4	80	0.0500000
NODE_304923_length_144_cov_46.155556	1	81	33	3	80	0.0375000
NODE_304923_length_144_cov_46.155556	1	81	35	1	80	0.0125000
NODE_304923_length_144_cov_46.155556	1	81	36	1	80	0.0125000
NODE_304923_length_144_cov_46.155556	1	81	38	2	80	0.0250000
NODE_304923_length_144_cov_46.155556	1	81	40	1	80	0.0125000
NODE_304923_length_144_cov_46.155556	1	81	42	1	80	0.0125000
NODE_304923_length_144_cov_46.155556	1	81	46	4	80	0.0500000
NODE_304923_length_144_cov_46.155556	1	81	52	1	80	0.0125000
NODE_304923_length_144_cov_46.155556	1	81	56	45	80	0.5625000
NODE_305208_length_142_cov_244.488372	0	52	3	1	52	0.0192308
NODE_305208_length_142_cov_244.488372	0	52	6	1	52	0.0192308
NODE_305208_length_142_cov_244.488372	0	52	9	1	52	0.0192308
NODE_305208_length_142_cov_244.488372	0	52	25	1	52	0.0192308
NODE_305208_length_142_cov_244.488372	0	52	33	2	52	0.0384615
NODE_305208_length_142_cov_244.488372	0	52	39	1	52	0.0192308
NODE_305208_length_142_cov_244.488372	0	52	49	1	52	0.0192308
NODE_305208_length_142_cov_244.488372	0	52	61	1	52	0.0192308
NODE_305208_length_142_cov_244.488372	0	52	63	1	52	0.0192308
NODE_305208_length_142_cov_244.488372	0	52	74	1	52	0.0192308
NODE_305208_length_142_cov_244.488372	0	52	79	1	52	0.0192308
NODE_305208_length_142_cov_244.488372	0	52	85	1	52	0.0192308
NODE_305208_length_142_cov_244.488372	0	52	93	1	52	0.0192308
NODE_305208_length_142_cov_244.488372	0	52	97	1	52	0.0192308
NODE_305208_length_142_cov_244.488372	0	52	101	1	52	0.0192308
NODE_305208_length_142_cov_244.488372	0	52	103	1	52	0.0192308
NODE_305208_length_142_cov_244.488372	0	52	122	1	52	0.0192308
NODE_305208_length_142_cov_244.488372	0	52	129	1	52	0.0192308
NODE_305208_length_142_cov_244.488372	0	52	131	1	52	0.0192308
NODE_305208_length_142_cov_244.488372	0	52	134	2	52	0.0384615
NODE_305208_length_142_cov_244.488372	0	52	138	1	52	0.0192308
NODE_305208_length_142_cov_244.488372	0	52	139	1	52	0.0192308
NODE_305208_length_142_cov_244.488372	0	52	140	1	52	0.0192308
NODE_305208_length_142_cov_244.488372	0	52	152	1	52	0.0192308
NODE_305208_length_142_cov_244.488372	0	52	154	1	52	0.0192308
NODE_305208_length_142_cov_244.488372	0	52	164	1	52	0.0192308
NODE_305208_length_142_cov_244.488372	0	52	166	1	52	0.0192308
NODE_305208_length_142_cov_244.488372	0	52	168	5	52	0.0961538
NODE_305208_length_142_cov_244.488372	0	52	180	1	52	0.0192308
NODE_305208_length_142_cov_244.488372	0	52	198	1	52	0.0192308
NODE_305208_length_142_cov_244.488372	0	52	202	1	52	0.0192308
NODE_305208_length_142_cov_244.488372	0	52	206	2	52	0.0384615
NODE_305208_length_142_cov_244.488372	0	52	212	1	52	0.0192308
NODE_305208_length_142_cov_244.488372	0	52	216	12	52	0.2307692
NODE_305229_length_142_cov_46.976744	1	65	10	4	64	0.0625000
NODE_305229_length_142_cov_46.976744	1	65	14	2	64	0.0312500
NODE_305229_length_142_cov_46.976744	1	65	15	2	64	0.0312500
NODE_305229_length_142_cov_46.976744	1	65	16	1	64	0.0156250
NODE_305229_length_142_cov_46.976744	1	65	18	1	64	0.0156250
NODE_305229_length_142_cov_46.976744	1	65	20	1	64	0.0156250
NODE_305229_length_142_cov_46.976744	1	65	22	2	64	0.0312500
NODE_305229_length_142_cov_46.976744	1	65	26	1	64	0.0156250
NODE_305229_length_142_cov_46.976744	1	65	28	1	64	0.0156250
NODE_305229_length_142_cov_46.976744	1	65	30	1	64	0.0156250
NODE_305229_length_142_cov_46.976744	1	65	32	1	64	0.0156250
NODE_305229_length_142_cov_46.976744	1	65	40	3	64	0.0468750
NODE_305229_length_142_cov_46.976744	1	65	50	4	64	0.0625000
NODE_305229_length_142_cov_46.976744	1	65	52	1	64	0.0156250
NODE_305229_length_142_cov_46.976744	1	65	56	39	64	0.6093750
NODE_305229_length_142_cov_46.976744	1	65	10	4	64	0.0625000
NODE_305229_length_142_cov_46.976744	1	65	14	2	64	0.0312500
NODE_305229_length_142_cov_46.976744	1	65	15	2	64	0.0312500
NODE_305229_length_142_cov_46.976744	1	65	16	1	64	0.0156250
NODE_305229_length_142_cov_46.976744	1	65	18	1	64	0.0156250
NODE_305229_length_142_cov_46.976744	1	65	20	1	64	0.0156250
NODE_305229_length_142_cov_46.976744	1	65	22	2	64	0.0312500
NODE_305229_length_142_cov_46.976744	1	65	26	1	64	0.0156250
NODE_305229_length_142_cov_46.976744	1	65	28	1	64	0.0156250
NODE_305229_length_142_cov_46.976744	1	65	30	1	64	0.0156250
NODE_305229_length_142_cov_46.976744	1	65	32	1	64	0.0156250
NODE_305229_length_142_cov_46.976744	1	65	40	3	64	0.0468750
NODE_305229_length_142_cov_46.976744	1	65	50	4	64	0.0625000
NODE_305229_length_142_cov_46.976744	1	65	52	1	64	0.0156250
NODE_305229_length_142_cov_46.976744	1	65	56	39	64	0.6093750
NODE_305229_length_142_cov_46.976744	1	65	10	4	64	0.0625000
NODE_305229_length_142_cov_46.976744	1	65	14	2	64	0.0312500
NODE_305229_length_142_cov_46.976744	1	65	15	2	64	0.0312500
NODE_305229_length_142_cov_46.976744	1	65	16	1	64	0.0156250
NODE_305229_length_142_cov_46.976744	1	65	18	1	64	0.0156250
NODE_305229_length_142_cov_46.976744	1	65	20	1	64	0.0156250
NODE_305229_length_142_cov_46.976744	1	65	22	2	64	0.0312500
NODE_305229_length_142_cov_46.976744	1	65	26	1	64	0.0156250
NODE_305229_length_142_cov_46.976744	1	65	28	1	64	0.0156250
NODE_305229_length_142_cov_46.976744	1	65	30	1	64	0.0156250
NODE_305229_length_142_cov_46.976744	1	65	32	1	64	0.0156250
NODE_305229_length_142_cov_46.976744	1	65	40	3	64	0.0468750
NODE_305229_length_142_cov_46.976744	1	65	50	4	64	0.0625000
NODE_305229_length_142_cov_46.976744	1	65	52	1	64	0.0156250
NODE_305229_length_142_cov_46.976744	1	65	56	39	64	0.6093750
NODE_305230_length_142_cov_45.000000	0	69	8	9	69	0.1304348
NODE_305230_length_142_cov_45.000000	0	69	10	8	69	0.1159420
NODE_305230_length_142_cov_45.000000	0	69	12	12	69	0.1739130
NODE_305230_length_142_cov_45.000000	0	69	14	4	69	0.0579710
NODE_305230_length_142_cov_45.000000	0	69	16	36	69	0.5217391
NODE_305385_length_141_cov_178.785714	58	118	115	1	60	0.0166667
NODE_305385_length_141_cov_178.785714	58	118	117	1	60	0.0166667
NODE_305385_length_141_cov_178.785714	58	118	121	1	60	0.0166667
NODE_305385_length_141_cov_178.785714	58	118	125	1	60	0.0166667
NODE_305385_length_141_cov_178.785714	58	118	133	1	60	0.0166667
NODE_305385_length_141_cov_178.785714	58	118	135	3	60	0.0500000
NODE_305385_length_141_cov_178.785714	58	118	137	4	60	0.0666667
NODE_305385_length_141_cov_178.785714	58	118	139	3	60	0.0500000
NODE_305385_length_141_cov_178.785714	58	118	143	45	60	0.7500000
NODE_305398_length_141_cov_62.285714	26	106	0	80	80	1.0000000
NODE_305398_length_141_cov_62.285714	26	106	0	80	80	1.0000000
NODE_305398_length_141_cov_62.285714	26	97	0	71	71	1.0000000
NODE_305402_length_141_cov_41.142857	26	97	0	71	71	1.0000000
NODE_305600_length_140_cov_60.439024	8	88	8	3	80	0.0375000
NODE_305600_length_140_cov_60.439024	8	88	14	22	80	0.2750000
NODE_305600_length_140_cov_60.439024	8	88	16	55	80	0.6875000
NODE_305600_length_140_cov_60.439024	8	88	8	3	80	0.0375000
NODE_305600_length_140_cov_60.439024	8	88	14	22	80	0.2750000
NODE_305600_length_140_cov_60.439024	8	88	16	55	80	0.6875000
NODE_305600_length_140_cov_60.439024	8	88	8	3	80	0.0375000
NODE_305600_length_140_cov_60.439024	8	88	14	22	80	0.2750000
NODE_305600_length_140_cov_60.439024	8	88	16	55	80	0.6875000
NODE_305600_length_140_cov_60.439024	8	88	8	3	80	0.0375000
NODE_305600_length_140_cov_60.439024	8	88	14	22	80	0.2750000
NODE_305600_length_140_cov_60.439024	8	88	16	55	80	0.6875000
NODE_305600_length_140_cov_60.439024	8	88	8	3	80	0.0375000
NODE_305600_length_140_cov_60.439024	8	88	14	22	80	0.2750000
NODE_305600_length_140_cov_60.439024	8	88	16	55	80	0.6875000
NODE_305616_length_140_cov_35.146341	22	102	0	80	80	1.0000000
NODE_305616_length_140_cov_35.146341	75	105	0	30	30	1.0000000
NODE_305618_length_140_cov_34.048780	0	77	2	4	77	0.0519481
NODE_305618_length_140_cov_34.048780	0	77	4	24	77	0.3116883
NODE_305618_length_140_cov_34.048780	0	77	6	49	77	0.6363636
NODE_305618_length_140_cov_34.048780	0	77	2	4	77	0.0519481
NODE_305618_length_140_cov_34.048780	0	77	4	24	77	0.3116883
NODE_305618_length_140_cov_34.048780	0	77	6	49	77	0.6363636
NODE_305618_length_140_cov_34.048780	50	130	2	3	80	0.0375000
NODE_305618_length_140_cov_34.048780	50	130	4	2	80	0.0250000
NODE_305618_length_140_cov_34.048780	50	130	6	75	80	0.9375000
NODE_305618_length_140_cov_34.048780	50	130	2	3	80	0.0375000
NODE_305618_length_140_cov_34.048780	50	130	4	2	80	0.0250000
NODE_305618_length_140_cov_34.048780	50	130	6	75	80	0.9375000
NODE_305618_length_140_cov_34.048780	55	130	2	3	75	0.0400000
NODE_305618_length_140_cov_34.048780	55	130	4	2	75	0.0266667
NODE_305618_length_140_cov_34.048780	55	130	6	70	75	0.9333333
NODE_305619_length_140_cov_19.926829	44	118	2	74	74	1.0000000
NODE_305783_length_139_cov_29.700000	0	40	0	1	40	0.0250000
NODE_305783_length_139_cov_29.700000	0	40	6	7	40	0.1750000
NODE_305783_length_139_cov_29.700000	0	40	7	1	40	0.0250000
NODE_305783_length_139_cov_29.700000	0	40	8	25	40	0.6250000
NODE_305783_length_139_cov_29.700000	0	40	10	6	40	0.1500000
NODE_305783_length_139_cov_29.700000	0	40	0	1	40	0.0250000
NODE_305783_length_139_cov_29.700000	0	40	6	7	40	0.1750000
NODE_305783_length_139_cov_29.700000	0	40	7	1	40	0.0250000
NODE_305783_length_139_cov_29.700000	0	40	8	25	40	0.6250000
NODE_305783_length_139_cov_29.700000	0	40	10	6	40	0.1500000
NODE_305783_length_139_cov_29.700000	13	93	8	21	80	0.2625000
NODE_305783_length_139_cov_29.700000	13	93	10	59	80	0.7375000
NODE_305783_length_139_cov_29.700000	13	93	8	21	80	0.2625000
NODE_305783_length_139_cov_29.700000	13	93	10	59	80	0.7375000
NODE_305783_length_139_cov_29.700000	13	93	8	21	80	0.2625000
NODE_305783_length_139_cov_29.700000	13	93	10	59	80	0.7375000
NODE_305783_length_139_cov_29.700000	13	93	8	21	80	0.2625000
NODE_305783_length_139_cov_29.700000	13	93	10	59	80	0.7375000
NODE_305783_length_139_cov_29.700000	13	93	8	21	80	0.2625000
NODE_305783_length_139_cov_29.700000	13	93	10	59	80	0.7375000
NODE_305783_length_139_cov_29.700000	13	84	8	21	71	0.2957746
NODE_305783_length_139_cov_29.700000	13	84	10	50	71	0.7042254
NODE_305936_length_138_cov_1475.615385	30	97	87	1	67	0.0149254
NODE_305936_length_138_cov_1475.615385	30	97	93	4	67	0.0597015
NODE_305936_length_138_cov_1475.615385	30	97	101	62	67	0.9253731
NODE_305936_length_138_cov_1475.615385	70	138	16	1	68	0.0147059
NODE_305936_length_138_cov_1475.615385	70	138	20	1	68	0.0147059
NODE_305936_length_138_cov_1475.615385	70	138	28	2	68	0.0294118
NODE_305936_length_138_cov_1475.615385	70	138	39	1	68	0.0147059
NODE_305936_length_138_cov_1475.615385	70	138	40	1	68	0.0147059
NODE_305936_length_138_cov_1475.615385	70	138	41	3	68	0.0441176
NODE_305936_length_138_cov_1475.615385	70	138	45	1	68	0.0147059
NODE_305936_length_138_cov_1475.615385	70	138	53	1	68	0.0147059
NODE_305936_length_138_cov_1475.615385	70	138	57	1	68	0.0147059
NODE_305936_length_138_cov_1475.615385	70	138	59	1	68	0.0147059
NODE_305936_length_138_cov_1475.615385	70	138	63	5	68	0.0735294
NODE_305936_length_138_cov_1475.615385	70	138	67	2	68	0.0294118
NODE_305936_length_138_cov_1475.615385	70	138	69	2	68	0.0294118
NODE_305936_length_138_cov_1475.615385	70	138	72	1	68	0.0147059
NODE_305936_length_138_cov_1475.615385	70	138	73	1	68	0.0147059
NODE_305936_length_138_cov_1475.615385	70	138	75	2	68	0.0294118
NODE_305936_length_138_cov_1475.615385	70	138	77	1	68	0.0147059
NODE_305936_length_138_cov_1475.615385	70	138	83	1	68	0.0147059
NODE_305936_length_138_cov_1475.615385	70	138	85	1	68	0.0147059
NODE_305936_length_138_cov_1475.615385	70	138	87	1	68	0.0147059
NODE_305936_length_138_cov_1475.615385	70	138	95	2	68	0.0294118
NODE_305936_length_138_cov_1475.615385	70	138	97	1	68	0.0147059
NODE_305936_length_138_cov_1475.615385	70	138	101	35	68	0.5147059
NODE_305963_length_138_cov_29.564103	11	91	0	9	80	0.1125000
NODE_305963_length_138_cov_29.564103	11	91	4	71	80	0.8875000
NODE_305963_length_138_cov_29.564103	11	91	0	9	80	0.1125000
NODE_305963_length_138_cov_29.564103	11	91	4	71	80	0.8875000
NODE_305963_length_138_cov_29.564103	64	128	0	22	64	0.3437500
NODE_305963_length_138_cov_29.564103	64	128	4	42	64	0.6562500
NODE_305963_length_138_cov_29.564103	64	128	0	22	64	0.3437500
NODE_305963_length_138_cov_29.564103	64	128	4	42	64	0.6562500
NODE_306081_length_137_cov_185.684211	20	104	28	4	84	0.0476190
NODE_306081_length_137_cov_185.684211	20	104	30	9	84	0.1071429
NODE_306081_length_137_cov_185.684211	20	104	34	1	84	0.0119048
NODE_306081_length_137_cov_185.684211	20	104	36	70	84	0.8333333
NODE_306092_length_137_cov_58.289474	76	106	35	5	30	0.1666667
NODE_306092_length_137_cov_58.289474	76	106	36	25	30	0.8333333
NODE_306099_length_137_cov_36.473684	31	111	18	38	80	0.4750000
NODE_306099_length_137_cov_36.473684	31	111	19	9	80	0.1125000
NODE_306099_length_137_cov_36.473684	31	111	20	33	80	0.4125000
NODE_306208_length_136_cov_1257.621622	27	107	80	2	80	0.0250000
NODE_306208_length_136_cov_1257.621622	27	107	88	4	80	0.0500000
NODE_306208_length_136_cov_1257.621622	27	107	90	74	80	0.9250000
NODE_306209_length_136_cov_769.594595	0	69	0	26	69	0.3768116
NODE_306209_length_136_cov_769.594595	0	69	6	43	69	0.6231884
NODE_306222_length_136_cov_128.324324	39	119	4	12	80	0.1500000
NODE_306222_length_136_cov_128.324324	39	119	6	68	80	0.8500000
NODE_306227_length_136_cov_90.783784	10	86	0	76	76	1.0000000
NODE_306227_length_136_cov_90.783784	59	136	0	77	77	1.0000000
NODE_306368_length_135_cov_2144.166667	0	73	8	2	73	0.0273973
NODE_306368_length_135_cov_2144.166667	0	73	13	1	73	0.0136986
NODE_306368_length_135_cov_2144.166667	0	73	18	1	73	0.0136986
NODE_306368_length_135_cov_2144.166667	0	73	20	2	73	0.0273973
NODE_306368_length_135_cov_2144.166667	0	73	26	1	73	0.0136986
NODE_306368_length_135_cov_2144.166667	0	73	32	1	73	0.0136986
NODE_306368_length_135_cov_2144.166667	0	73	35	1	73	0.0136986
NODE_306368_length_135_cov_2144.166667	0	73	39	2	73	0.0273973
NODE_306368_length_135_cov_2144.166667	0	73	46	1	73	0.0136986
NODE_306368_length_135_cov_2144.166667	0	73	48	1	73	0.0136986
NODE_306368_length_135_cov_2144.166667	0	73	53	1	73	0.0136986
NODE_306368_length_135_cov_2144.166667	0	73	54	1	73	0.0136986
NODE_306368_length_135_cov_2144.166667	0	73	58	1	73	0.0136986
NODE_306368_length_135_cov_2144.166667	0	73	68	1	73	0.0136986
NODE_306368_length_135_cov_2144.166667	0	73	72	1	73	0.0136986
NODE_306368_length_135_cov_2144.166667	0	73	74	1	73	0.0136986
NODE_306368_length_135_cov_2144.166667	0	73	78	1	73	0.0136986
NODE_306368_length_135_cov_2144.166667	0	73	80	2	73	0.0273973
NODE_306368_length_135_cov_2144.166667	0	73	89	2	73	0.0273973
NODE_306368_length_135_cov_2144.166667	0	73	91	1	73	0.0136986
NODE_306368_length_135_cov_2144.166667	0	73	93	1	73	0.0136986
NODE_306368_length_135_cov_2144.166667	0	73	99	2	73	0.0273973
NODE_306368_length_135_cov_2144.166667	0	73	101	1	73	0.0136986
NODE_306368_length_135_cov_2144.166667	0	73	113	1	73	0.0136986
NODE_306368_length_135_cov_2144.166667	0	73	117	1	73	0.0136986
NODE_306368_length_135_cov_2144.166667	0	73	121	1	73	0.0136986
NODE_306368_length_135_cov_2144.166667	0	73	125	1	73	0.0136986
NODE_306368_length_135_cov_2144.166667	0	73	128	40	73	0.5479452
NODE_306368_length_135_cov_2144.166667	46	126	24	2	80	0.0250000
NODE_306368_length_135_cov_2144.166667	46	126	30	2	80	0.0250000
NODE_306368_length_135_cov_2144.166667	46	126	39	1	80	0.0125000
NODE_306368_length_135_cov_2144.166667	46	126	40	1	80	0.0125000
NODE_306368_length_135_cov_2144.166667	46	126	52	1	80	0.0125000
NODE_306368_length_135_cov_2144.166667	46	126	60	1	80	0.0125000
NODE_306368_length_135_cov_2144.166667	46	126	74	1	80	0.0125000
NODE_306368_length_135_cov_2144.166667	46	126	81	1	80	0.0125000
NODE_306368_length_135_cov_2144.166667	46	126	86	1	80	0.0125000
NODE_306368_length_135_cov_2144.166667	46	126	88	1	80	0.0125000
NODE_306368_length_135_cov_2144.166667	46	126	90	1	80	0.0125000
NODE_306368_length_135_cov_2144.166667	46	126	94	2	80	0.0250000
NODE_306368_length_135_cov_2144.166667	46	126	102	1	80	0.0125000
NODE_306368_length_135_cov_2144.166667	46	126	104	1	80	0.0125000
NODE_306368_length_135_cov_2144.166667	46	126	108	1	80	0.0125000
NODE_306368_length_135_cov_2144.166667	46	126	113	1	80	0.0125000
NODE_306368_length_135_cov_2144.166667	46	126	114	1	80	0.0125000
NODE_306368_length_135_cov_2144.166667	46	126	118	3	80	0.0375000
NODE_306368_length_135_cov_2144.166667	46	126	128	57	80	0.7125000
NODE_306368_length_135_cov_2144.166667	83	135	2	2	52	0.0384615
NODE_306368_length_135_cov_2144.166667	83	135	4	2	52	0.0384615
NODE_306368_length_135_cov_2144.166667	83	135	12	1	52	0.0192308
NODE_306368_length_135_cov_2144.166667	83	135	18	1	52	0.0192308
NODE_306368_length_135_cov_2144.166667	83	135	20	3	52	0.0576923
NODE_306368_length_135_cov_2144.166667	83	135	24	2	52	0.0384615
NODE_306368_length_135_cov_2144.166667	83	135	30	2	52	0.0384615
NODE_306368_length_135_cov_2144.166667	83	135	39	1	52	0.0192308
NODE_306368_length_135_cov_2144.166667	83	135	40	1	52	0.0192308
NODE_306368_length_135_cov_2144.166667	83	135	52	1	52	0.0192308
NODE_306368_length_135_cov_2144.166667	83	135	60	1	52	0.0192308
NODE_306368_length_135_cov_2144.166667	83	135	74	1	52	0.0192308
NODE_306368_length_135_cov_2144.166667	83	135	81	1	52	0.0192308
NODE_306368_length_135_cov_2144.166667	83	135	86	1	52	0.0192308
NODE_306368_length_135_cov_2144.166667	83	135	88	1	52	0.0192308
NODE_306368_length_135_cov_2144.166667	83	135	90	1	52	0.0192308
NODE_306368_length_135_cov_2144.166667	83	135	94	2	52	0.0384615
NODE_306368_length_135_cov_2144.166667	83	135	102	1	52	0.0192308
NODE_306368_length_135_cov_2144.166667	83	135	104	1	52	0.0192308
NODE_306368_length_135_cov_2144.166667	83	135	108	1	52	0.0192308
NODE_306368_length_135_cov_2144.166667	83	135	113	1	52	0.0192308
NODE_306368_length_135_cov_2144.166667	83	135	114	1	52	0.0192308
NODE_306368_length_135_cov_2144.166667	83	135	118	3	52	0.0576923
NODE_306368_length_135_cov_2144.166667	83	135	128	20	52	0.3846154
NODE_306370_length_135_cov_630.194444	0	76	6	8	76	0.1052632
NODE_306370_length_135_cov_630.194444	0	76	8	1	76	0.0131579
NODE_306370_length_135_cov_630.194444	0	76	10	2	76	0.0263158
NODE_306370_length_135_cov_630.194444	0	76	18	6	76	0.0789474
NODE_306370_length_135_cov_630.194444	0	76	20	3	76	0.0394737
NODE_306370_length_135_cov_630.194444	0	76	22	5	76	0.0657895
NODE_306370_length_135_cov_630.194444	0	76	24	1	76	0.0131579
NODE_306370_length_135_cov_630.194444	0	76	26	50	76	0.6578947
NODE_306371_length_135_cov_540.611111	0	76	15	1	76	0.0131579
NODE_306371_length_135_cov_540.611111	0	76	17	1	76	0.0131579
NODE_306371_length_135_cov_540.611111	0	76	21	1	76	0.0131579
NODE_306371_length_135_cov_540.611111	0	76	29	1	76	0.0131579
NODE_306371_length_135_cov_540.611111	0	76	43	2	76	0.0263158
NODE_306371_length_135_cov_540.611111	0	76	56	1	76	0.0131579
NODE_306371_length_135_cov_540.611111	0	76	58	1	76	0.0131579
NODE_306371_length_135_cov_540.611111	0	76	60	1	76	0.0131579
NODE_306371_length_135_cov_540.611111	0	76	67	1	76	0.0131579
NODE_306371_length_135_cov_540.611111	0	76	77	1	76	0.0131579
NODE_306371_length_135_cov_540.611111	0	76	82	1	76	0.0131579
NODE_306371_length_135_cov_540.611111	0	76	86	1	76	0.0131579
NODE_306371_length_135_cov_540.611111	0	76	101	1	76	0.0131579
NODE_306371_length_135_cov_540.611111	0	76	106	1	76	0.0131579
NODE_306371_length_135_cov_540.611111	0	76	111	1	76	0.0131579
NODE_306371_length_135_cov_540.611111	0	76	117	1	76	0.0131579
NODE_306371_length_135_cov_540.611111	0	76	119	1	76	0.0131579
NODE_306371_length_135_cov_540.611111	0	76	133	1	76	0.0131579
NODE_306371_length_135_cov_540.611111	0	76	137	2	76	0.0263158
NODE_306371_length_135_cov_540.611111	0	76	139	1	76	0.0131579
NODE_306371_length_135_cov_540.611111	0	76	145	2	76	0.0263158
NODE_306371_length_135_cov_540.611111	0	76	149	2	76	0.0263158
NODE_306371_length_135_cov_540.611111	0	76	159	1	76	0.0131579
NODE_306371_length_135_cov_540.611111	0	76	161	1	76	0.0131579
NODE_306371_length_135_cov_540.611111	0	76	163	1	76	0.0131579
NODE_306371_length_135_cov_540.611111	0	76	166	47	76	0.6184211
NODE_306373_length_135_cov_257.416667	36	88	180	4	52	0.0769231
NODE_306373_length_135_cov_257.416667	36	88	181	48	52	0.9230769
NODE_306374_length_135_cov_239.638889	97	135	23	1	38	0.0263158
NODE_306374_length_135_cov_239.638889	97	135	27	4	38	0.1052632
NODE_306374_length_135_cov_239.638889	97	135	33	1	38	0.0263158
NODE_306374_length_135_cov_239.638889	97	135	35	1	38	0.0263158
NODE_306374_length_135_cov_239.638889	97	135	45	1	38	0.0263158
NODE_306374_length_135_cov_239.638889	97	135	47	1	38	0.0263158
NODE_306374_length_135_cov_239.638889	97	135	54	1	38	0.0263158
NODE_306374_length_135_cov_239.638889	97	135	57	1	38	0.0263158
NODE_306374_length_135_cov_239.638889	97	135	59	1	38	0.0263158
NODE_306374_length_135_cov_239.638889	97	135	63	1	38	0.0263158
NODE_306374_length_135_cov_239.638889	97	135	71	1	38	0.0263158
NODE_306374_length_135_cov_239.638889	97	135	73	1	38	0.0263158
NODE_306374_length_135_cov_239.638889	97	135	77	1	38	0.0263158
NODE_306374_length_135_cov_239.638889	97	135	79	1	38	0.0263158
NODE_306374_length_135_cov_239.638889	97	135	83	1	38	0.0263158
NODE_306374_length_135_cov_239.638889	97	135	89	1	38	0.0263158
NODE_306374_length_135_cov_239.638889	97	135	100	3	38	0.0789474
NODE_306374_length_135_cov_239.638889	97	135	102	1	38	0.0263158
NODE_306374_length_135_cov_239.638889	97	135	110	1	38	0.0263158
NODE_306374_length_135_cov_239.638889	97	135	115	3	38	0.0789474
NODE_306374_length_135_cov_239.638889	97	135	121	1	38	0.0263158
NODE_306374_length_135_cov_239.638889	97	135	129	5	38	0.1315790
NODE_306374_length_135_cov_239.638889	97	135	131	5	38	0.1315790
NODE_306400_length_135_cov_35.055556	8	88	17	20	80	0.2500000
NODE_306400_length_135_cov_35.055556	8	88	21	3	80	0.0375000
NODE_306400_length_135_cov_35.055556	8	88	22	57	80	0.7125000
NODE_306400_length_135_cov_35.055556	61	125	2	5	64	0.0781250
NODE_306400_length_135_cov_35.055556	61	125	5	1	64	0.0156250
NODE_306400_length_135_cov_35.055556	61	125	6	6	64	0.0937500
NODE_306400_length_135_cov_35.055556	61	125	12	4	64	0.0625000
NODE_306400_length_135_cov_35.055556	61	125	22	48	64	0.7500000
NODE_306400_length_135_cov_35.055556	61	125	2	5	64	0.0781250
NODE_306400_length_135_cov_35.055556	61	125	5	1	64	0.0156250
NODE_306400_length_135_cov_35.055556	61	125	6	6	64	0.0937500
NODE_306400_length_135_cov_35.055556	61	125	12	4	64	0.0625000
NODE_306400_length_135_cov_35.055556	61	125	22	48	64	0.7500000
NODE_306402_length_135_cov_31.805556	0	76	0	76	76	1.0000000
NODE_306658_length_133_cov_140.411765	8	43	0	11	35	0.3142857
NODE_306658_length_133_cov_140.411765	8	43	2	9	35	0.2571429
NODE_306658_length_133_cov_140.411765	8	43	4	2	35	0.0571429
NODE_306658_length_133_cov_140.411765	8	43	6	13	35	0.3714286
NODE_306658_length_133_cov_140.411765	53	88	6	35	35	1.0000000
NODE_306658_length_133_cov_140.411765	98	133	2	13	35	0.3714286
NODE_306658_length_133_cov_140.411765	98	133	4	8	35	0.2285714
NODE_306658_length_133_cov_140.411765	98	133	6	14	35	0.4000000
NODE_306661_length_133_cov_109.441176	63	129	2	2	66	0.0303030
NODE_306661_length_133_cov_109.441176	63	129	16	5	66	0.0757576
NODE_306661_length_133_cov_109.441176	63	129	18	3	66	0.0454545
NODE_306661_length_133_cov_109.441176	63	129	20	1	66	0.0151515
NODE_306661_length_133_cov_109.441176	63	129	24	55	66	0.8333333
NODE_306812_length_132_cov_114.151515	2	44	2	2	42	0.0476190
NODE_306812_length_132_cov_114.151515	2	44	4	10	42	0.2380952
NODE_306812_length_132_cov_114.151515	2	44	7	1	42	0.0238095
NODE_306812_length_132_cov_114.151515	2	44	8	6	42	0.1428571
NODE_306812_length_132_cov_114.151515	2	44	14	23	42	0.5476190
NODE_306812_length_132_cov_114.151515	4	44	4	10	40	0.2500000
NODE_306812_length_132_cov_114.151515	4	44	7	1	40	0.0250000
NODE_306812_length_132_cov_114.151515	4	44	8	6	40	0.1500000
NODE_306812_length_132_cov_114.151515	4	44	14	23	40	0.5750000
NODE_306812_length_132_cov_114.151515	17	83	8	4	66	0.0606061
NODE_306812_length_132_cov_114.151515	17	83	14	62	66	0.9393939
NODE_306812_length_132_cov_114.151515	17	88	8	4	71	0.0563380
NODE_306812_length_132_cov_114.151515	17	88	14	67	71	0.9436620
NODE_306824_length_132_cov_61.636364	3	76	4	3	73	0.0410959
NODE_306824_length_132_cov_61.636364	3	76	5	1	73	0.0136986
NODE_306824_length_132_cov_61.636364	3	76	6	10	73	0.1369863
NODE_306824_length_132_cov_61.636364	3	76	10	8	73	0.1095890
NODE_306824_length_132_cov_61.636364	3	76	16	3	73	0.0410959
NODE_306824_length_132_cov_61.636364	3	76	18	4	73	0.0547945
NODE_306824_length_132_cov_61.636364	3	76	20	44	73	0.6027398
NODE_306824_length_132_cov_61.636364	49	130	3	2	81	0.0246914
NODE_306824_length_132_cov_61.636364	49	130	7	1	81	0.0123457
NODE_306824_length_132_cov_61.636364	49	130	9	6	81	0.0740741
NODE_306824_length_132_cov_61.636364	49	130	11	9	81	0.1111111
NODE_306824_length_132_cov_61.636364	49	130	13	1	81	0.0123457
NODE_306824_length_132_cov_61.636364	49	130	17	7	81	0.0864198
NODE_306824_length_132_cov_61.636364	49	130	19	2	81	0.0246914
NODE_306824_length_132_cov_61.636364	49	130	20	53	81	0.6543210
NODE_306824_length_132_cov_61.636364	103	125	9	4	22	0.1818182
NODE_306824_length_132_cov_61.636364	103	125	11	9	22	0.4090909
NODE_306824_length_132_cov_61.636364	103	125	13	1	22	0.0454545
NODE_306824_length_132_cov_61.636364	103	125	17	7	22	0.3181818
NODE_306824_length_132_cov_61.636364	103	125	19	1	22	0.0454545
NODE_306834_length_132_cov_33.393939	2	83	0	81	81	1.0000000
NODE_306834_length_132_cov_33.393939	7	29	0	22	22	1.0000000
NODE_306834_length_132_cov_33.393939	56	129	0	73	73	1.0000000
NODE_306965_length_131_cov_810.000000	0	60	16	1	60	0.0166667
NODE_306965_length_131_cov_810.000000	0	60	18	1	60	0.0166667
NODE_306965_length_131_cov_810.000000	0	60	33	1	60	0.0166667
NODE_306965_length_131_cov_810.000000	0	60	34	1	60	0.0166667
NODE_306965_length_131_cov_810.000000	0	60	37	1	60	0.0166667
NODE_306965_length_131_cov_810.000000	0	60	55	2	60	0.0333333
NODE_306965_length_131_cov_810.000000	0	60	59	1	60	0.0166667
NODE_306965_length_131_cov_810.000000	0	60	71	3	60	0.0500000
NODE_306965_length_131_cov_810.000000	0	60	81	1	60	0.0166667
NODE_306965_length_131_cov_810.000000	0	60	95	1	60	0.0166667
NODE_306965_length_131_cov_810.000000	0	60	96	1	60	0.0166667
NODE_306965_length_131_cov_810.000000	0	60	100	1	60	0.0166667
NODE_306965_length_131_cov_810.000000	0	60	110	1	60	0.0166667
NODE_306965_length_131_cov_810.000000	0	60	113	1	60	0.0166667
NODE_306965_length_131_cov_810.000000	0	60	119	1	60	0.0166667
NODE_306965_length_131_cov_810.000000	0	60	124	1	60	0.0166667
NODE_306965_length_131_cov_810.000000	0	60	140	1	60	0.0166667
NODE_306965_length_131_cov_810.000000	0	60	142	1	60	0.0166667
NODE_306965_length_131_cov_810.000000	0	60	143	1	60	0.0166667
NODE_306965_length_131_cov_810.000000	0	60	156	1	60	0.0166667
NODE_306965_length_131_cov_810.000000	0	60	167	1	60	0.0166667
NODE_306965_length_131_cov_810.000000	0	60	176	2	60	0.0333333
NODE_306965_length_131_cov_810.000000	0	60	182	1	60	0.0166667
NODE_306965_length_131_cov_810.000000	0	60	183	1	60	0.0166667
NODE_306965_length_131_cov_810.000000	0	60	186	1	60	0.0166667
NODE_306965_length_131_cov_810.000000	0	60	190	20	60	0.3333333
NODE_306965_length_131_cov_810.000000	0	60	191	11	60	0.1833333
NODE_306965_length_131_cov_810.000000	33	97	190	53	64	0.8281250
NODE_306965_length_131_cov_810.000000	33	97	191	11	64	0.1718750
NODE_306965_length_131_cov_810.000000	33	97	190	53	64	0.8281250
NODE_306965_length_131_cov_810.000000	33	97	191	11	64	0.1718750
NODE_306965_length_131_cov_810.000000	33	97	190	53	64	0.8281250
NODE_306965_length_131_cov_810.000000	33	97	191	11	64	0.1718750
NODE_306985_length_131_cov_149.187500	25	105	75	4	80	0.0500000
NODE_306985_length_131_cov_149.187500	25	105	76	76	80	0.9500000
NODE_306985_length_131_cov_149.187500	78	131	18	3	53	0.0566038
NODE_306985_length_131_cov_149.187500	78	131	22	4	53	0.0754717
NODE_306985_length_131_cov_149.187500	78	131	27	1	53	0.0188679
NODE_306985_length_131_cov_149.187500	78	131	28	1	53	0.0188679
NODE_306985_length_131_cov_149.187500	78	131	35	1	53	0.0188679
NODE_306985_length_131_cov_149.187500	78	131	40	1	53	0.0188679
NODE_306985_length_131_cov_149.187500	78	131	44	1	53	0.0188679
NODE_306985_length_131_cov_149.187500	78	131	46	1	53	0.0188679
NODE_306985_length_131_cov_149.187500	78	131	52	1	53	0.0188679
NODE_306985_length_131_cov_149.187500	78	131	62	5	53	0.0943396
NODE_306985_length_131_cov_149.187500	78	131	74	3	53	0.0566038
NODE_306985_length_131_cov_149.187500	78	131	76	31	53	0.5849057
NODE_307121_length_130_cov_319.806452	54	126	22	4	72	0.0555556
NODE_307121_length_130_cov_319.806452	54	126	24	3	72	0.0416667
NODE_307121_length_130_cov_319.806452	54	126	28	2	72	0.0277778
NODE_307121_length_130_cov_319.806452	54	126	32	2	72	0.0277778
NODE_307121_length_130_cov_319.806452	54	126	36	8	72	0.1111111
NODE_307121_length_130_cov_319.806452	54	126	38	53	72	0.7361111
NODE_307132_length_130_cov_153.516129	82	113	0	31	31	1.0000000
NODE_307140_length_130_cov_79.064516	0	53	0	4	53	0.0754717
NODE_307140_length_130_cov_79.064516	0	53	2	3	53	0.0566038
NODE_307140_length_130_cov_79.064516	0	53	4	1	53	0.0188679
NODE_307140_length_130_cov_79.064516	0	53	6	2	53	0.0377358
NODE_307140_length_130_cov_79.064516	0	53	8	3	53	0.0566038
NODE_307140_length_130_cov_79.064516	0	53	12	2	53	0.0377358
NODE_307140_length_130_cov_79.064516	0	53	14	3	53	0.0566038
NODE_307140_length_130_cov_79.064516	0	53	17	1	53	0.0188679
NODE_307140_length_130_cov_79.064516	0	53	19	1	53	0.0188679
NODE_307140_length_130_cov_79.064516	0	53	22	2	53	0.0377358
NODE_307140_length_130_cov_79.064516	0	53	24	1	53	0.0188679
NODE_307140_length_130_cov_79.064516	0	53	26	2	53	0.0377358
NODE_307140_length_130_cov_79.064516	0	53	30	1	53	0.0188679
NODE_307140_length_130_cov_79.064516	0	53	34	2	53	0.0377358
NODE_307140_length_130_cov_79.064516	0	53	36	25	53	0.4716981
NODE_307140_length_130_cov_79.064516	26	56	34	2	30	0.0666667
NODE_307140_length_130_cov_79.064516	26	56	36	28	30	0.9333333
NODE_307270_length_129_cov_1851.133333	0	45	0	3	45	0.0666667
NODE_307270_length_129_cov_1851.133333	0	45	4	1	45	0.0222222
NODE_307270_length_129_cov_1851.133333	0	45	8	1	45	0.0222222
NODE_307270_length_129_cov_1851.133333	0	45	10	1	45	0.0222222
NODE_307270_length_129_cov_1851.133333	0	45	18	1	45	0.0222222
NODE_307270_length_129_cov_1851.133333	0	45	21	1	45	0.0222222
NODE_307270_length_129_cov_1851.133333	0	45	26	1	45	0.0222222
NODE_307270_length_129_cov_1851.133333	0	45	37	3	45	0.0666667
NODE_307270_length_129_cov_1851.133333	0	45	41	1	45	0.0222222
NODE_307270_length_129_cov_1851.133333	0	45	44	2	45	0.0444444
NODE_307270_length_129_cov_1851.133333	0	45	50	1	45	0.0222222
NODE_307270_length_129_cov_1851.133333	0	45	52	1	45	0.0222222
NODE_307270_length_129_cov_1851.133333	0	45	58	1	45	0.0222222
NODE_307270_length_129_cov_1851.133333	0	45	64	3	45	0.0666667
NODE_307270_length_129_cov_1851.133333	0	45	66	1	45	0.0222222
NODE_307270_length_129_cov_1851.133333	0	45	68	1	45	0.0222222
NODE_307270_length_129_cov_1851.133333	0	45	72	1	45	0.0222222
NODE_307270_length_129_cov_1851.133333	0	45	76	21	45	0.4666667
NODE_307270_length_129_cov_1851.133333	18	98	64	3	80	0.0375000
NODE_307270_length_129_cov_1851.133333	18	98	66	1	80	0.0125000
NODE_307270_length_129_cov_1851.133333	18	98	68	1	80	0.0125000
NODE_307270_length_129_cov_1851.133333	18	98	72	1	80	0.0125000
NODE_307270_length_129_cov_1851.133333	18	98	76	74	80	0.9250000
NODE_307285_length_129_cov_186.500000	0	78	4	10	78	0.1282051
NODE_307285_length_129_cov_186.500000	0	78	8	8	78	0.1025641
NODE_307285_length_129_cov_186.500000	0	78	12	5	78	0.0641026
NODE_307285_length_129_cov_186.500000	0	78	14	55	78	0.7051282
NODE_307285_length_129_cov_186.500000	53	129	4	1	76	0.0131579
NODE_307285_length_129_cov_186.500000	53	129	8	1	76	0.0131579
NODE_307285_length_129_cov_186.500000	53	129	10	16	76	0.2105263
NODE_307285_length_129_cov_186.500000	53	129	14	58	76	0.7631579
NODE_307287_length_129_cov_165.466667	36	111	32	3	75	0.0400000
NODE_307287_length_129_cov_165.466667	36	111	40	1	75	0.0133333
NODE_307287_length_129_cov_165.466667	36	111	42	2	75	0.0266667
NODE_307287_length_129_cov_165.466667	36	111	46	69	75	0.9200000
NODE_307287_length_129_cov_165.466667	84	113	24	2	29	0.0689655
NODE_307287_length_129_cov_165.466667	84	113	32	3	29	0.1034483
NODE_307287_length_129_cov_165.466667	84	113	40	1	29	0.0344828
NODE_307287_length_129_cov_165.466667	84	113	42	2	29	0.0689655
NODE_307287_length_129_cov_165.466667	84	113	46	21	29	0.7241379
NODE_307292_length_129_cov_90.366667	0	48	2	14	48	0.2916667
NODE_307292_length_129_cov_90.366667	0	48	4	34	48	0.7083333
NODE_307292_length_129_cov_90.366667	0	48	2	14	48	0.2916667
NODE_307292_length_129_cov_90.366667	0	48	4	34	48	0.7083333
NODE_307292_length_129_cov_90.366667	0	48	2	14	48	0.2916667
NODE_307292_length_129_cov_90.366667	0	48	4	34	48	0.7083333
NODE_307292_length_129_cov_90.366667	21	101	4	80	80	1.0000000
NODE_307442_length_128_cov_2621.517241	3	83	61	1	80	0.0125000
NODE_307442_length_128_cov_2621.517241	3	83	77	1	80	0.0125000
NODE_307442_length_128_cov_2621.517241	3	83	82	1	80	0.0125000
NODE_307442_length_128_cov_2621.517241	3	83	94	1	80	0.0125000
NODE_307442_length_128_cov_2621.517241	3	83	98	2	80	0.0250000
NODE_307442_length_128_cov_2621.517241	3	83	110	1	80	0.0125000
NODE_307442_length_128_cov_2621.517241	3	83	116	1	80	0.0125000
NODE_307442_length_128_cov_2621.517241	3	83	143	1	80	0.0125000
NODE_307442_length_128_cov_2621.517241	3	83	148	2	80	0.0250000
NODE_307442_length_128_cov_2621.517241	3	83	158	1	80	0.0125000
NODE_307442_length_128_cov_2621.517241	3	83	164	1	80	0.0125000
NODE_307442_length_128_cov_2621.517241	3	83	168	4	80	0.0500000
NODE_307442_length_128_cov_2621.517241	3	83	170	1	80	0.0125000
NODE_307442_length_128_cov_2621.517241	3	83	176	2	80	0.0250000
NODE_307442_length_128_cov_2621.517241	3	83	180	1	80	0.0125000
NODE_307442_length_128_cov_2621.517241	3	83	190	1	80	0.0125000
NODE_307442_length_128_cov_2621.517241	3	83	195	1	80	0.0125000
NODE_307442_length_128_cov_2621.517241	3	83	196	57	80	0.7125000
NODE_307442_length_128_cov_2621.517241	8	30	98	1	22	0.0454545
NODE_307442_length_128_cov_2621.517241	8	30	110	1	22	0.0454545
NODE_307442_length_128_cov_2621.517241	8	30	116	1	22	0.0454545
NODE_307442_length_128_cov_2621.517241	8	30	143	1	22	0.0454545
NODE_307442_length_128_cov_2621.517241	8	30	148	2	22	0.0909091
NODE_307442_length_128_cov_2621.517241	8	30	158	1	22	0.0454545
NODE_307442_length_128_cov_2621.517241	8	30	164	1	22	0.0454545
NODE_307442_length_128_cov_2621.517241	8	30	168	4	22	0.1818182
NODE_307442_length_128_cov_2621.517241	8	30	170	1	22	0.0454545
NODE_307442_length_128_cov_2621.517241	8	30	176	2	22	0.0909091
NODE_307442_length_128_cov_2621.517241	8	30	180	1	22	0.0454545
NODE_307442_length_128_cov_2621.517241	8	30	190	1	22	0.0454545
NODE_307442_length_128_cov_2621.517241	8	30	195	1	22	0.0454545
NODE_307442_length_128_cov_2621.517241	8	30	196	4	22	0.1818182
NODE_307442_length_128_cov_2621.517241	56	128	22	1	72	0.0138889
NODE_307442_length_128_cov_2621.517241	56	128	32	1	72	0.0138889
NODE_307442_length_128_cov_2621.517241	56	128	40	1	72	0.0138889
NODE_307442_length_128_cov_2621.517241	56	128	42	1	72	0.0138889
NODE_307442_length_128_cov_2621.517241	56	128	46	1	72	0.0138889
NODE_307442_length_128_cov_2621.517241	56	128	56	2	72	0.0277778
NODE_307442_length_128_cov_2621.517241	56	128	58	2	72	0.0277778
NODE_307442_length_128_cov_2621.517241	56	128	64	1	72	0.0138889
NODE_307442_length_128_cov_2621.517241	56	128	72	1	72	0.0138889
NODE_307442_length_128_cov_2621.517241	56	128	84	2	72	0.0277778
NODE_307442_length_128_cov_2621.517241	56	128	96	1	72	0.0138889
NODE_307442_length_128_cov_2621.517241	56	128	100	1	72	0.0138889
NODE_307442_length_128_cov_2621.517241	56	128	114	1	72	0.0138889
NODE_307442_length_128_cov_2621.517241	56	128	138	1	72	0.0138889
NODE_307442_length_128_cov_2621.517241	56	128	142	1	72	0.0138889
NODE_307442_length_128_cov_2621.517241	56	128	146	1	72	0.0138889
NODE_307442_length_128_cov_2621.517241	56	128	161	1	72	0.0138889
NODE_307442_length_128_cov_2621.517241	56	128	168	1	72	0.0138889
NODE_307442_length_128_cov_2621.517241	56	128	180	1	72	0.0138889
NODE_307442_length_128_cov_2621.517241	56	128	183	1	72	0.0138889
NODE_307442_length_128_cov_2621.517241	56	128	190	1	72	0.0138889
NODE_307442_length_128_cov_2621.517241	56	128	196	48	72	0.6666667
NODE_307443_length_128_cov_1604.275862	58	127	2	3	69	0.0434783
NODE_307443_length_128_cov_1604.275862	58	127	4	3	69	0.0434783
NODE_307443_length_128_cov_1604.275862	58	127	6	4	69	0.0579710
NODE_307443_length_128_cov_1604.275862	58	127	10	1	69	0.0144928
NODE_307443_length_128_cov_1604.275862	58	127	16	58	69	0.8405797
NODE_307458_length_128_cov_79.034483	43	123	6	4	80	0.0500000
NODE_307458_length_128_cov_79.034483	43	123	12	7	80	0.0875000
NODE_307458_length_128_cov_79.034483	43	123	14	11	80	0.1375000
NODE_307458_length_128_cov_79.034483	43	123	22	58	80	0.7250000
NODE_307464_length_128_cov_61.793103	5	85	4	80	80	1.0000000
NODE_307549_length_127_cov_1879.785714	21	101	102	2	80	0.0250000
NODE_307549_length_127_cov_1879.785714	21	101	118	1	80	0.0125000
NODE_307549_length_127_cov_1879.785714	21	101	134	77	80	0.9625000
NODE_307549_length_127_cov_1879.785714	74	127	18	1	53	0.0188679
NODE_307549_length_127_cov_1879.785714	74	127	20	1	53	0.0188679
NODE_307549_length_127_cov_1879.785714	74	127	26	1	53	0.0188679
NODE_307549_length_127_cov_1879.785714	74	127	30	1	53	0.0188679
NODE_307549_length_127_cov_1879.785714	74	127	38	1	53	0.0188679
NODE_307549_length_127_cov_1879.785714	74	127	44	2	53	0.0377358
NODE_307549_length_127_cov_1879.785714	74	127	51	1	53	0.0188679
NODE_307549_length_127_cov_1879.785714	74	127	52	1	53	0.0188679
NODE_307549_length_127_cov_1879.785714	74	127	54	2	53	0.0377358
NODE_307549_length_127_cov_1879.785714	74	127	64	1	53	0.0188679
NODE_307549_length_127_cov_1879.785714	74	127	72	1	53	0.0188679
NODE_307549_length_127_cov_1879.785714	74	127	90	2	53	0.0377358
NODE_307549_length_127_cov_1879.785714	74	127	92	1	53	0.0188679
NODE_307549_length_127_cov_1879.785714	74	127	93	2	53	0.0377358
NODE_307549_length_127_cov_1879.785714	74	127	107	1	53	0.0188679
NODE_307549_length_127_cov_1879.785714	74	127	124	1	53	0.0188679
NODE_307549_length_127_cov_1879.785714	74	127	127	2	53	0.0377358
NODE_307549_length_127_cov_1879.785714	74	127	129	1	53	0.0188679
NODE_307549_length_127_cov_1879.785714	74	127	130	1	53	0.0188679
NODE_307549_length_127_cov_1879.785714	74	127	134	29	53	0.5471698
NODE_307583_length_127_cov_66.142857	38	118	0	80	80	1.0000000
NODE_307583_length_127_cov_66.142857	47	118	0	71	71	1.0000000
NODE_307590_length_127_cov_38.285714	12	86	0	74	74	1.0000000
NODE_307596_length_127_cov_30.607143	21	93	0	72	72	1.0000000
NODE_307662_length_126_cov_936.777778	24	96	26	72	72	1.0000000
NODE_307675_length_126_cov_147.185185	2	66	4	9	64	0.1406250
NODE_307675_length_126_cov_147.185185	2	66	6	6	64	0.0937500
NODE_307675_length_126_cov_147.185185	2	66	14	49	64	0.7656250
NODE_307675_length_126_cov_147.185185	2	66	4	9	64	0.1406250
NODE_307675_length_126_cov_147.185185	2	66	6	6	64	0.0937500
NODE_307675_length_126_cov_147.185185	2	66	14	49	64	0.7656250
NODE_307675_length_126_cov_147.185185	2	66	4	9	64	0.1406250
NODE_307675_length_126_cov_147.185185	2	66	6	6	64	0.0937500
NODE_307675_length_126_cov_147.185185	2	66	14	49	64	0.7656250
NODE_307675_length_126_cov_147.185185	39	99	14	60	60	1.0000000
NODE_307675_length_126_cov_147.185185	55	99	14	44	44	1.0000000
NODE_307684_length_126_cov_82.518519	44	75	0	31	31	1.0000000
NODE_307793_length_125_cov_656.807692	19	99	64	2	80	0.0250000
NODE_307793_length_125_cov_656.807692	19	99	66	1	80	0.0125000
NODE_307793_length_125_cov_656.807692	19	99	72	77	80	0.9625000
NODE_307806_length_125_cov_143.615385	52	125	6	2	73	0.0273973
NODE_307806_length_125_cov_143.615385	52	125	10	8	73	0.1095890
NODE_307806_length_125_cov_143.615385	52	125	12	4	73	0.0547945
NODE_307806_length_125_cov_143.615385	52	125	18	2	73	0.0273973
NODE_307806_length_125_cov_143.615385	52	125	20	5	73	0.0684932
NODE_307806_length_125_cov_143.615385	52	125	24	52	73	0.7123288
NODE_307810_length_125_cov_131.923077	3	52	8	2	49	0.0408163
NODE_307810_length_125_cov_131.923077	3	52	14	5	49	0.1020408
NODE_307810_length_125_cov_131.923077	3	52	18	4	49	0.0816327
NODE_307810_length_125_cov_131.923077	3	52	20	1	49	0.0204082
NODE_307810_length_125_cov_131.923077	3	52	22	1	49	0.0204082
NODE_307810_length_125_cov_131.923077	3	52	25	1	49	0.0204082
NODE_307810_length_125_cov_131.923077	3	52	26	4	49	0.0816327
NODE_307810_length_125_cov_131.923077	3	52	28	31	49	0.6326531
NODE_307810_length_125_cov_131.923077	25	89	28	64	64	1.0000000
NODE_307810_length_125_cov_131.923077	25	89	28	64	64	1.0000000
NODE_307816_length_125_cov_102.500000	0	56	0	56	56	1.0000000
NODE_307816_length_125_cov_102.500000	7	56	0	49	49	1.0000000
NODE_307816_length_125_cov_102.500000	29	114	0	85	85	1.0000000
NODE_307816_length_125_cov_102.500000	29	114	0	85	85	1.0000000
NODE_307816_length_125_cov_102.500000	29	114	0	85	85	1.0000000
NODE_307839_length_125_cov_28.115385	17	90	46	1	73	0.0136986
NODE_307839_length_125_cov_28.115385	17	90	49	5	73	0.0684932
NODE_307839_length_125_cov_28.115385	17	90	51	67	73	0.9178082
NODE_307839_length_125_cov_28.115385	57	98	51	41	41	1.0000000
NODE_307906_length_124_cov_945.680000	0	73	15	1	73	0.0136986
NODE_307906_length_124_cov_945.680000	0	73	17	4	73	0.0547945
NODE_307906_length_124_cov_945.680000	0	73	19	1	73	0.0136986
NODE_307906_length_124_cov_945.680000	0	73	28	1	73	0.0136986
NODE_307906_length_124_cov_945.680000	0	73	29	3	73	0.0410959
NODE_307906_length_124_cov_945.680000	0	73	31	3	73	0.0410959
NODE_307906_length_124_cov_945.680000	0	73	38	1	73	0.0136986
NODE_307906_length_124_cov_945.680000	0	73	42	59	73	0.8082192
NODE_307906_length_124_cov_945.680000	53	124	0	1	71	0.0140845
NODE_307906_length_124_cov_945.680000	53	124	2	2	71	0.0281690
NODE_307906_length_124_cov_945.680000	53	124	8	1	71	0.0140845
NODE_307906_length_124_cov_945.680000	53	124	10	2	71	0.0281690
NODE_307906_length_124_cov_945.680000	53	124	18	2	71	0.0281690
NODE_307906_length_124_cov_945.680000	53	124	22	1	71	0.0140845
NODE_307906_length_124_cov_945.680000	53	124	24	3	71	0.0422535
NODE_307906_length_124_cov_945.680000	53	124	28	1	71	0.0140845
NODE_307906_length_124_cov_945.680000	53	124	32	5	71	0.0704225
NODE_307906_length_124_cov_945.680000	53	124	34	3	71	0.0422535
NODE_307906_length_124_cov_945.680000	53	124	42	50	71	0.7042254
NODE_308023_length_123_cov_1186.083333	0	76	8	10	76	0.1315790
NODE_308023_length_123_cov_1186.083333	0	76	14	2	76	0.0263158
NODE_308023_length_123_cov_1186.083333	0	76	16	1	76	0.0131579
NODE_308023_length_123_cov_1186.083333	0	76	19	3	76	0.0394737
NODE_308023_length_123_cov_1186.083333	0	76	20	60	76	0.7894737
NODE_308023_length_123_cov_1186.083333	0	76	8	10	76	0.1315790
NODE_308023_length_123_cov_1186.083333	0	76	14	2	76	0.0263158
NODE_308023_length_123_cov_1186.083333	0	76	16	1	76	0.0131579
NODE_308023_length_123_cov_1186.083333	0	76	19	3	76	0.0394737
NODE_308023_length_123_cov_1186.083333	0	76	20	60	76	0.7894737
NODE_308023_length_123_cov_1186.083333	0	76	8	10	76	0.1315790
NODE_308023_length_123_cov_1186.083333	0	76	14	2	76	0.0263158
NODE_308023_length_123_cov_1186.083333	0	76	16	1	76	0.0131579
NODE_308023_length_123_cov_1186.083333	0	76	19	3	76	0.0394737
NODE_308023_length_123_cov_1186.083333	0	76	20	60	76	0.7894737
NODE_308023_length_123_cov_1186.083333	0	76	8	10	76	0.1315790
NODE_308023_length_123_cov_1186.083333	0	76	14	2	76	0.0263158
NODE_308023_length_123_cov_1186.083333	0	76	16	1	76	0.0131579
NODE_308023_length_123_cov_1186.083333	0	76	19	3	76	0.0394737
NODE_308023_length_123_cov_1186.083333	0	76	20	60	76	0.7894737
NODE_308023_length_123_cov_1186.083333	49	123	14	14	74	0.1891892
NODE_308023_length_123_cov_1186.083333	49	123	20	60	74	0.8108108
NODE_308023_length_123_cov_1186.083333	49	123	14	14	74	0.1891892
NODE_308023_length_123_cov_1186.083333	49	123	20	60	74	0.8108108
NODE_308023_length_123_cov_1186.083333	49	123	14	14	74	0.1891892
NODE_308023_length_123_cov_1186.083333	49	123	20	60	74	0.8108108
NODE_308024_length_123_cov_963.500000	19	88	28	2	69	0.0289855
NODE_308024_length_123_cov_963.500000	19	88	30	67	69	0.9710145
NODE_308037_length_123_cov_181.291667	0	47	0	47	47	1.0000000
NODE_308037_length_123_cov_181.291667	24	100	0	76	76	1.0000000
NODE_308057_length_123_cov_55.375000	52	123	4	17	71	0.2394366
NODE_308057_length_123_cov_55.375000	52	123	6	54	71	0.7605634
NODE_308057_length_123_cov_55.375000	52	123	4	17	71	0.2394366
NODE_308057_length_123_cov_55.375000	52	123	6	54	71	0.7605634
NODE_308057_length_123_cov_55.375000	61	123	4	17	62	0.2741936
NODE_308057_length_123_cov_55.375000	61	123	6	45	62	0.7258065
NODE_308068_length_123_cov_40.958333	9	89	7	61	80	0.7625000
NODE_308068_length_123_cov_40.958333	9	89	8	19	80	0.2375000
NODE_308068_length_123_cov_40.958333	9	89	7	61	80	0.7625000
NODE_308068_length_123_cov_40.958333	9	89	8	19	80	0.2375000
NODE_308068_length_123_cov_40.958333	9	89	7	61	80	0.7625000
NODE_308068_length_123_cov_40.958333	9	89	8	19	80	0.2375000
NODE_308068_length_123_cov_40.958333	9	89	7	61	80	0.7625000
NODE_308068_length_123_cov_40.958333	9	89	8	19	80	0.2375000
NODE_308068_length_123_cov_40.958333	9	89	7	61	80	0.7625000
NODE_308068_length_123_cov_40.958333	9	89	8	19	80	0.2375000
NODE_308068_length_123_cov_40.958333	9	80	7	52	71	0.7323943
NODE_308068_length_123_cov_40.958333	9	80	8	19	71	0.2676056
NODE_308180_length_122_cov_111.043478	8	88	0	4	80	0.0500000
NODE_308180_length_122_cov_111.043478	8	88	2	1	80	0.0125000
NODE_308180_length_122_cov_111.043478	8	88	4	75	80	0.9375000
NODE_308180_length_122_cov_111.043478	8	88	0	4	80	0.0500000
NODE_308180_length_122_cov_111.043478	8	88	2	1	80	0.0125000
NODE_308180_length_122_cov_111.043478	8	88	4	75	80	0.9375000
NODE_308184_length_122_cov_67.565217	0	50	0	10	50	0.2000000
NODE_308184_length_122_cov_67.565217	0	50	2	1	50	0.0200000
NODE_308184_length_122_cov_67.565217	0	50	7	1	50	0.0200000
NODE_308184_length_122_cov_67.565217	0	50	8	7	50	0.1400000
NODE_308184_length_122_cov_67.565217	0	50	12	31	50	0.6200000
NODE_308184_length_122_cov_67.565217	0	50	0	10	50	0.2000000
NODE_308184_length_122_cov_67.565217	0	50	2	1	50	0.0200000
NODE_308184_length_122_cov_67.565217	0	50	7	1	50	0.0200000
NODE_308184_length_122_cov_67.565217	0	50	8	7	50	0.1400000
NODE_308184_length_122_cov_67.565217	0	50	12	31	50	0.6200000
NODE_308184_length_122_cov_67.565217	23	103	12	80	80	1.0000000
NODE_308184_length_122_cov_67.565217	23	103	12	80	80	1.0000000
NODE_308184_length_122_cov_67.565217	23	103	12	80	80	1.0000000
NODE_308184_length_122_cov_67.565217	23	103	12	80	80	1.0000000
NODE_308184_length_122_cov_67.565217	23	103	12	80	80	1.0000000
NODE_308184_length_122_cov_67.565217	23	94	12	71	71	1.0000000
NODE_308188_length_122_cov_58.826087	28	99	0	71	71	1.0000000
NODE_308188_length_122_cov_58.826087	33	99	0	66	66	1.0000000
NODE_308188_length_122_cov_58.826087	72	122	0	50	50	1.0000000
NODE_308188_length_122_cov_58.826087	72	122	0	50	50	1.0000000
NODE_308198_length_122_cov_38.173913	12	93	12	4	81	0.0493827
NODE_308198_length_122_cov_38.173913	12	93	16	77	81	0.9506173
NODE_308257_length_121_cov_159.318182	24	55	0	31	31	1.0000000
NODE_308260_length_121_cov_120.181818	20	100	0	80	80	1.0000000
NODE_308260_length_121_cov_120.181818	20	95	0	75	75	1.0000000
NODE_308260_length_121_cov_120.181818	20	100	0	80	80	1.0000000
NODE_308260_length_121_cov_120.181818	29	100	0	71	71	1.0000000
NODE_308273_length_121_cov_54.181818	7	70	0	63	63	1.0000000
NODE_308273_length_121_cov_54.181818	7	70	0	63	63	1.0000000
NODE_308273_length_121_cov_54.181818	7	70	0	63	63	1.0000000
NODE_308273_length_121_cov_54.181818	9	70	0	61	61	1.0000000
NODE_308273_length_121_cov_54.181818	43	109	0	66	66	1.0000000
NODE_308273_length_121_cov_54.181818	43	121	0	78	78	1.0000000
NODE_308273_length_121_cov_54.181818	64	117	0	53	53	1.0000000
NODE_308317_length_120_cov_1404.619048	0	64	26	1	64	0.0156250
NODE_308317_length_120_cov_1404.619048	0	64	32	1	64	0.0156250
NODE_308317_length_120_cov_1404.619048	0	64	34	1	64	0.0156250
NODE_308317_length_120_cov_1404.619048	0	64	40	1	64	0.0156250
NODE_308317_length_120_cov_1404.619048	0	64	46	1	64	0.0156250
NODE_308317_length_120_cov_1404.619048	0	64	55	1	64	0.0156250
NODE_308317_length_120_cov_1404.619048	0	64	61	1	64	0.0156250
NODE_308317_length_120_cov_1404.619048	0	64	69	1	64	0.0156250
NODE_308317_length_120_cov_1404.619048	0	64	71	1	64	0.0156250
NODE_308317_length_120_cov_1404.619048	0	64	75	2	64	0.0312500
NODE_308317_length_120_cov_1404.619048	0	64	79	1	64	0.0156250
NODE_308317_length_120_cov_1404.619048	0	64	85	1	64	0.0156250
NODE_308317_length_120_cov_1404.619048	0	64	89	3	64	0.0468750
NODE_308317_length_120_cov_1404.619048	0	64	91	1	64	0.0156250
NODE_308317_length_120_cov_1404.619048	0	64	93	6	64	0.0937500
NODE_308317_length_120_cov_1404.619048	0	64	94	41	64	0.6406250
NODE_308317_length_120_cov_1404.619048	45	117	24	1	72	0.0138889
NODE_308317_length_120_cov_1404.619048	45	117	34	1	72	0.0138889
NODE_308317_length_120_cov_1404.619048	45	117	46	1	72	0.0138889
NODE_308317_length_120_cov_1404.619048	45	117	53	1	72	0.0138889
NODE_308317_length_120_cov_1404.619048	45	117	58	1	72	0.0138889
NODE_308317_length_120_cov_1404.619048	45	117	68	1	72	0.0138889
NODE_308317_length_120_cov_1404.619048	45	117	72	1	72	0.0138889
NODE_308317_length_120_cov_1404.619048	45	117	74	1	72	0.0138889
NODE_308317_length_120_cov_1404.619048	45	117	84	1	72	0.0138889
NODE_308317_length_120_cov_1404.619048	45	117	88	3	72	0.0416667
NODE_308317_length_120_cov_1404.619048	45	117	90	1	72	0.0138889
NODE_308317_length_120_cov_1404.619048	45	117	92	2	72	0.0277778
NODE_308317_length_120_cov_1404.619048	45	117	94	57	72	0.7916667
NODE_308318_length_120_cov_1138.428571	19	99	22	80	80	1.0000000
NODE_308318_length_120_cov_1138.428571	72	120	6	1	48	0.0208333
NODE_308318_length_120_cov_1138.428571	72	120	10	1	48	0.0208333
NODE_308318_length_120_cov_1138.428571	72	120	12	1	48	0.0208333
NODE_308318_length_120_cov_1138.428571	72	120	16	1	48	0.0208333
NODE_308318_length_120_cov_1138.428571	72	120	18	10	48	0.2083333
NODE_308318_length_120_cov_1138.428571	72	120	20	1	48	0.0208333
NODE_308318_length_120_cov_1138.428571	72	120	22	33	48	0.6875000
NODE_308357_length_120_cov_54.666667	0	69	0	2	69	0.0289855
NODE_308357_length_120_cov_54.666667	0	69	2	5	69	0.0724638
NODE_308357_length_120_cov_54.666667	0	69	6	62	69	0.8985507
NODE_308357_length_120_cov_54.666667	0	69	0	2	69	0.0289855
NODE_308357_length_120_cov_54.666667	0	69	2	5	69	0.0724638
NODE_308357_length_120_cov_54.666667	0	69	6	62	69	0.8985507
NODE_308357_length_120_cov_54.666667	0	69	0	2	69	0.0289855
NODE_308357_length_120_cov_54.666667	0	69	2	5	69	0.0724638
NODE_308357_length_120_cov_54.666667	0	69	6	62	69	0.8985507
NODE_308357_length_120_cov_54.666667	42	108	4	6	66	0.0909091
NODE_308357_length_120_cov_54.666667	42	108	6	60	66	0.9090909
NODE_308357_length_120_cov_54.666667	53	120	0	10	67	0.1492537
NODE_308357_length_120_cov_54.666667	53	120	4	8	67	0.1194030
NODE_308357_length_120_cov_54.666667	53	120	6	49	67	0.7313433
NODE_308357_length_120_cov_54.666667	53	120	0	10	67	0.1492537
NODE_308357_length_120_cov_54.666667	53	120	4	8	67	0.1194030
NODE_308357_length_120_cov_54.666667	53	120	6	49	67	0.7313433
NODE_308487_length_118_cov_1211.578947	49	116	0	1	67	0.0149254
NODE_308487_length_118_cov_1211.578947	49	116	2	4	67	0.0597015
NODE_308487_length_118_cov_1211.578947	49	116	8	1	67	0.0149254
NODE_308487_length_118_cov_1211.578947	49	116	12	4	67	0.0597015
NODE_308487_length_118_cov_1211.578947	49	116	14	57	67	0.8507463
NODE_308488_length_118_cov_1157.157895	4	70	0	10	66	0.1515152
NODE_308488_length_118_cov_1157.157895	4	70	4	56	66	0.8484849
NODE_308500_length_118_cov_218.210526	0	63	0	9	63	0.1428571
NODE_308500_length_118_cov_218.210526	0	63	2	1	63	0.0158730
NODE_308500_length_118_cov_218.210526	0	63	4	2	63	0.0317460
NODE_308500_length_118_cov_218.210526	0	63	6	51	63	0.8095238
NODE_308500_length_118_cov_218.210526	35	115	2	2	80	0.0250000
NODE_308500_length_118_cov_218.210526	35	115	5	1	80	0.0125000
NODE_308500_length_118_cov_218.210526	35	115	6	77	80	0.9625000
NODE_308504_length_118_cov_161.052632	4	70	0	66	66	1.0000000
NODE_308572_length_117_cov_338.555556	7	70	8	5	63	0.0793651
NODE_308572_length_117_cov_338.555556	7	70	10	58	63	0.9206349
NODE_308572_length_117_cov_338.555556	7	70	8	5	63	0.0793651
NODE_308572_length_117_cov_338.555556	7	70	10	58	63	0.9206349
NODE_308572_length_117_cov_338.555556	7	70	8	5	63	0.0793651
NODE_308572_length_117_cov_338.555556	7	70	10	58	63	0.9206349
NODE_308572_length_117_cov_338.555556	9	70	8	3	61	0.0491803
NODE_308572_length_117_cov_338.555556	9	70	10	58	61	0.9508197
NODE_308572_length_117_cov_338.555556	43	109	8	7	66	0.1060606
NODE_308572_length_117_cov_338.555556	43	109	10	59	66	0.8939394
NODE_308572_length_117_cov_338.555556	43	114	2	1	71	0.0140845
NODE_308572_length_117_cov_338.555556	43	114	6	3	71	0.0422535
NODE_308572_length_117_cov_338.555556	43	114	8	8	71	0.1126761
NODE_308572_length_117_cov_338.555556	43	114	10	59	71	0.8309859
NODE_308572_length_117_cov_338.555556	64	117	0	2	53	0.0377358
NODE_308572_length_117_cov_338.555556	64	117	2	2	53	0.0377358
NODE_308572_length_117_cov_338.555556	64	117	6	3	53	0.0566038
NODE_308572_length_117_cov_338.555556	64	117	8	8	53	0.1509434
NODE_308572_length_117_cov_338.555556	64	117	10	38	53	0.7169811
NODE_308654_length_116_cov_1897.470588	0	77	0	1	77	0.0129870
NODE_308654_length_116_cov_1897.470588	0	77	2	3	77	0.0389610
NODE_308654_length_116_cov_1897.470588	0	77	4	5	77	0.0649351
NODE_308654_length_116_cov_1897.470588	0	77	8	68	77	0.8831169
NODE_308654_length_116_cov_1897.470588	34	111	8	77	77	1.0000000
NODE_308668_length_116_cov_438.529412	15	95	2	80	80	1.0000000
NODE_308668_length_116_cov_438.529412	68	116	0	5	48	0.1041667
NODE_308668_length_116_cov_438.529412	68	116	2	43	48	0.8958333
NODE_308701_length_116_cov_93.235294	52	116	0	8	64	0.1250000
NODE_308701_length_116_cov_93.235294	52	116	6	56	64	0.8750000
NODE_308722_length_116_cov_46.882353	6	66	6	2	60	0.0333333
NODE_308722_length_116_cov_46.882353	6	66	12	3	60	0.0500000
NODE_308722_length_116_cov_46.882353	6	66	18	2	60	0.0333333
NODE_308722_length_116_cov_46.882353	6	66	24	53	60	0.8833333
NODE_308727_length_116_cov_38.352941	20	100	0	80	80	1.0000000
NODE_308746_length_115_cov_1012.625000	31	114	13	2	83	0.0240964
NODE_308746_length_115_cov_1012.625000	31	114	19	2	83	0.0240964
NODE_308746_length_115_cov_1012.625000	31	114	31	2	83	0.0240964
NODE_308746_length_115_cov_1012.625000	31	114	33	27	83	0.3253012
NODE_308746_length_115_cov_1012.625000	31	114	34	50	83	0.6024097
NODE_308750_length_115_cov_776.625000	9	92	2	83	83	1.0000000
NODE_308752_length_115_cov_623.937500	0	74	0	3	74	0.0405405
NODE_308752_length_115_cov_623.937500	0	74	6	8	74	0.1081081
NODE_308752_length_115_cov_623.937500	0	74	8	63	74	0.8513514
NODE_308782_length_115_cov_144.812500	4	73	2	69	69	1.0000000
NODE_308806_length_115_cov_65.187500	16	76	12	60	60	1.0000000
NODE_308846_length_114_cov_819.466667	40	114	3	9	74	0.1216216
NODE_308846_length_114_cov_819.466667	40	114	4	65	74	0.8783784
NODE_308846_length_114_cov_819.466667	40	114	3	9	74	0.1216216
NODE_308846_length_114_cov_819.466667	40	114	4	65	74	0.8783784
NODE_308846_length_114_cov_819.466667	49	114	3	9	65	0.1384615
NODE_308846_length_114_cov_819.466667	49	114	4	56	65	0.8615385
NODE_308866_length_114_cov_285.666667	0	78	0	1	78	0.0128205
NODE_308866_length_114_cov_285.666667	0	78	4	77	78	0.9871795
NODE_308866_length_114_cov_285.666667	51	114	4	63	63	1.0000000
NODE_308886_length_114_cov_83.600000	51	82	0	31	31	1.0000000
NODE_308891_length_114_cov_67.666667	40	90	0	50	50	1.0000000
NODE_308939_length_113_cov_446.214286	5	82	0	5	77	0.0649351
NODE_308939_length_113_cov_446.214286	5	82	4	72	77	0.9350649
NODE_308939_length_113_cov_446.214286	5	82	0	5	77	0.0649351
NODE_308939_length_113_cov_446.214286	5	82	4	72	77	0.9350649
NODE_308967_length_113_cov_160.071429	0	64	0	6	64	0.0937500
NODE_308967_length_113_cov_160.071429	0	64	4	5	64	0.0781250
NODE_308967_length_113_cov_160.071429	0	64	10	53	64	0.8281250
NODE_308967_length_113_cov_160.071429	0	64	0	6	64	0.0937500
NODE_308967_length_113_cov_160.071429	0	64	4	5	64	0.0781250
NODE_308967_length_113_cov_160.071429	0	64	10	53	64	0.8281250
NODE_308967_length_113_cov_160.071429	37	103	10	66	66	1.0000000
NODE_308967_length_113_cov_160.071429	37	108	6	2	71	0.0281690
NODE_308967_length_113_cov_160.071429	37	108	10	69	71	0.9718310
NODE_309037_length_112_cov_963.384615	43	112	0	3	69	0.0434783
NODE_309037_length_112_cov_963.384615	43	112	2	1	69	0.0144928
NODE_309037_length_112_cov_963.384615	43	112	6	65	69	0.9420290
NODE_309044_length_112_cov_653.615385	7	78	0	71	71	1.0000000
NODE_309044_length_112_cov_653.615385	12	78	0	66	66	1.0000000
NODE_309044_length_112_cov_653.615385	51	112	0	61	61	1.0000000
NODE_309044_length_112_cov_653.615385	51	112	0	61	61	1.0000000
NODE_309067_length_112_cov_219.538462	0	62	0	4	62	0.0645161
NODE_309067_length_112_cov_219.538462	0	62	7	2	62	0.0322581
NODE_309067_length_112_cov_219.538462	0	62	8	56	62	0.9032258
NODE_309067_length_112_cov_219.538462	0	57	0	4	57	0.0701754
NODE_309067_length_112_cov_219.538462	0	57	7	2	57	0.0350877
NODE_309067_length_112_cov_219.538462	0	57	8	51	57	0.8947368
NODE_309067_length_112_cov_219.538462	0	62	0	4	62	0.0645161
NODE_309067_length_112_cov_219.538462	0	62	7	2	62	0.0322581
NODE_309067_length_112_cov_219.538462	0	62	8	56	62	0.9032258
NODE_309067_length_112_cov_219.538462	0	59	0	4	59	0.0677966
NODE_309067_length_112_cov_219.538462	0	59	7	2	59	0.0338983
NODE_309067_length_112_cov_219.538462	0	59	8	53	59	0.8983051
NODE_309067_length_112_cov_219.538462	35	112	0	1	77	0.0129870
NODE_309067_length_112_cov_219.538462	35	112	6	1	77	0.0129870
NODE_309067_length_112_cov_219.538462	35	112	7	1	77	0.0129870
NODE_309067_length_112_cov_219.538462	35	112	8	74	77	0.9610389
NODE_309067_length_112_cov_219.538462	35	112	0	1	77	0.0129870
NODE_309067_length_112_cov_219.538462	35	112	6	1	77	0.0129870
NODE_309067_length_112_cov_219.538462	35	112	7	1	77	0.0129870
NODE_309067_length_112_cov_219.538462	35	112	8	74	77	0.9610389
NODE_309067_length_112_cov_219.538462	35	112	0	1	77	0.0129870
NODE_309067_length_112_cov_219.538462	35	112	6	1	77	0.0129870
NODE_309067_length_112_cov_219.538462	35	112	7	1	77	0.0129870
NODE_309067_length_112_cov_219.538462	35	112	8	74	77	0.9610389
NODE_309078_length_112_cov_160.307692	0	69	0	69	69	1.0000000
NODE_309079_length_112_cov_134.846154	11	91	6	80	80	1.0000000
NODE_309079_length_112_cov_134.846154	11	91	6	80	80	1.0000000
NODE_309079_length_112_cov_134.846154	64	112	3	1	48	0.0208333
NODE_309079_length_112_cov_134.846154	64	112	4	5	48	0.1041667
NODE_309079_length_112_cov_134.846154	64	112	6	42	48	0.8750000
NODE_309079_length_112_cov_134.846154	64	112	3	1	48	0.0208333
NODE_309079_length_112_cov_134.846154	64	112	4	5	48	0.1041667
NODE_309079_length_112_cov_134.846154	64	112	6	42	48	0.8750000
NODE_309079_length_112_cov_134.846154	64	112	3	1	48	0.0208333
NODE_309079_length_112_cov_134.846154	64	112	4	5	48	0.1041667
NODE_309079_length_112_cov_134.846154	64	112	6	42	48	0.8750000
NODE_309092_length_112_cov_84.384615	10	90	4	80	80	1.0000000
NODE_309097_length_112_cov_72.769231	36	100	0	64	64	1.0000000
NODE_309106_length_112_cov_35.307692	13	76	4	63	63	1.0000000
NODE_309123_length_111_cov_1107.833333	0	52	0	4	52	0.0769231
NODE_309123_length_111_cov_1107.833333	0	52	2	2	52	0.0384615
NODE_309123_length_111_cov_1107.833333	0	52	4	46	52	0.8846154
NODE_309123_length_111_cov_1107.833333	0	52	0	4	52	0.0769231
NODE_309123_length_111_cov_1107.833333	0	52	2	2	52	0.0384615
NODE_309123_length_111_cov_1107.833333	0	52	4	46	52	0.8846154
NODE_309123_length_111_cov_1107.833333	0	52	0	4	52	0.0769231
NODE_309123_length_111_cov_1107.833333	0	52	2	2	52	0.0384615
NODE_309123_length_111_cov_1107.833333	0	52	4	46	52	0.8846154
NODE_309123_length_111_cov_1107.833333	0	52	0	4	52	0.0769231
NODE_309123_length_111_cov_1107.833333	0	52	2	2	52	0.0384615
NODE_309123_length_111_cov_1107.833333	0	52	4	46	52	0.8846154
NODE_309123_length_111_cov_1107.833333	25	105	0	1	80	0.0125000
NODE_309123_length_111_cov_1107.833333	25	105	2	1	80	0.0125000
NODE_309123_length_111_cov_1107.833333	25	105	4	78	80	0.9750000
NODE_309123_length_111_cov_1107.833333	25	105	0	1	80	0.0125000
NODE_309123_length_111_cov_1107.833333	25	105	2	1	80	0.0125000
NODE_309123_length_111_cov_1107.833333	25	105	4	78	80	0.9750000
NODE_309123_length_111_cov_1107.833333	25	105	0	1	80	0.0125000
NODE_309123_length_111_cov_1107.833333	25	105	2	1	80	0.0125000
NODE_309123_length_111_cov_1107.833333	25	105	4	78	80	0.9750000
NODE_309123_length_111_cov_1107.833333	25	105	0	1	80	0.0125000
NODE_309123_length_111_cov_1107.833333	25	105	2	1	80	0.0125000
NODE_309123_length_111_cov_1107.833333	25	105	4	78	80	0.9750000
NODE_309123_length_111_cov_1107.833333	25	105	0	1	80	0.0125000
NODE_309123_length_111_cov_1107.833333	25	105	2	1	80	0.0125000
NODE_309123_length_111_cov_1107.833333	25	105	4	78	80	0.9750000
NODE_309123_length_111_cov_1107.833333	25	105	0	1	80	0.0125000
NODE_309123_length_111_cov_1107.833333	25	105	2	1	80	0.0125000
NODE_309123_length_111_cov_1107.833333	25	105	4	78	80	0.9750000
NODE_309126_length_111_cov_827.500000	3	74	12	1	71	0.0140845
NODE_309126_length_111_cov_827.500000	3	74	16	4	71	0.0563380
NODE_309126_length_111_cov_827.500000	3	74	20	1	71	0.0140845
NODE_309126_length_111_cov_827.500000	3	74	22	1	71	0.0140845
NODE_309126_length_111_cov_827.500000	3	74	24	64	71	0.9014084
NODE_309126_length_111_cov_827.500000	8	74	20	1	66	0.0151515
NODE_309126_length_111_cov_827.500000	8	74	22	1	66	0.0151515
NODE_309126_length_111_cov_827.500000	8	74	24	64	66	0.9696970
NODE_309126_length_111_cov_827.500000	47	111	14	5	64	0.0781250
NODE_309126_length_111_cov_827.500000	47	111	20	1	64	0.0156250
NODE_309126_length_111_cov_827.500000	47	111	24	58	64	0.9062500
NODE_309126_length_111_cov_827.500000	47	111	14	5	64	0.0781250
NODE_309126_length_111_cov_827.500000	47	111	20	1	64	0.0156250
NODE_309126_length_111_cov_827.500000	47	111	24	58	64	0.9062500
NODE_309126_length_111_cov_827.500000	47	111	14	5	64	0.0781250
NODE_309126_length_111_cov_827.500000	47	111	20	1	64	0.0156250
NODE_309126_length_111_cov_827.500000	47	111	24	58	64	0.9062500
NODE_309129_length_111_cov_726.833333	12	89	0	77	77	1.0000000
NODE_309129_length_111_cov_726.833333	12	89	0	77	77	1.0000000
NODE_309129_length_111_cov_726.833333	62	111	0	49	49	1.0000000
NODE_309129_length_111_cov_726.833333	67	111	0	44	44	1.0000000
NODE_309131_length_111_cov_692.416667	31	111	0	4	80	0.0500000
NODE_309131_length_111_cov_692.416667	31	111	2	76	80	0.9500000
NODE_309149_length_111_cov_241.750000	30	97	0	67	67	1.0000000
NODE_309160_length_111_cov_169.416667	21	102	0	81	81	1.0000000
NODE_309200_length_110_cov_554.909091	1	28	16	1	27	0.0370370
NODE_309200_length_110_cov_554.909091	1	28	24	5	27	0.1851852
NODE_309200_length_110_cov_554.909091	1	28	26	1	27	0.0370370
NODE_309200_length_110_cov_554.909091	1	28	28	20	27	0.7407407
NODE_309200_length_110_cov_554.909091	1	81	16	1	80	0.0125000
NODE_309200_length_110_cov_554.909091	1	81	24	5	80	0.0625000
NODE_309200_length_110_cov_554.909091	1	81	26	1	80	0.0125000
NODE_309200_length_110_cov_554.909091	1	81	28	73	80	0.9125000
NODE_309202_length_110_cov_537.545455	0	75	0	75	75	1.0000000
NODE_309202_length_110_cov_537.545455	53	107	0	54	54	1.0000000
NODE_309235_length_110_cov_91.636364	19	54	0	35	35	1.0000000
NODE_309235_length_110_cov_91.636364	64	107	0	43	43	1.0000000
NODE_309239_length_110_cov_80.272727	19	54	0	35	35	1.0000000
NODE_309239_length_110_cov_80.272727	64	99	0	35	35	1.0000000
NODE_309241_length_110_cov_78.363636	19	54	0	35	35	1.0000000
NODE_309241_length_110_cov_78.363636	64	107	0	43	43	1.0000000
NODE_309245_length_110_cov_68.727273	11	46	0	35	35	1.0000000
NODE_309245_length_110_cov_68.727273	56	91	0	35	35	1.0000000
NODE_309252_length_110_cov_44.545455	5	57	0	52	52	1.0000000
NODE_309263_length_109_cov_1364.100000	29	98	0	69	69	1.0000000
NODE_309275_length_109_cov_689.800000	12	86	0	74	74	1.0000000
NODE_309309_length_109_cov_250.800000	4	66	0	62	62	1.0000000
NODE_309311_length_109_cov_242.000000	29	98	0	69	69	1.0000000
NODE_309326_length_109_cov_139.000000	26	106	4	1	80	0.0125000
NODE_309326_length_109_cov_139.000000	26	106	6	79	80	0.9875000
NODE_309345_length_109_cov_84.500000	33	93	2	60	60	1.0000000
NODE_309349_length_109_cov_75.300000	0	65	0	4	65	0.0615385
NODE_309349_length_109_cov_75.300000	0	65	4	61	65	0.9384615
NODE_309384_length_108_cov_1542.666667	28	108	0	80	80	1.0000000
NODE_309391_length_108_cov_987.666667	5	85	2	80	80	1.0000000
NODE_309391_length_108_cov_987.666667	5	85	2	80	80	1.0000000
NODE_309391_length_108_cov_987.666667	5	85	2	80	80	1.0000000
NODE_309391_length_108_cov_987.666667	5	85	2	80	80	1.0000000
NODE_309391_length_108_cov_987.666667	5	85	2	80	80	1.0000000
NODE_309391_length_108_cov_987.666667	58	108	0	5	50	0.1000000
NODE_309391_length_108_cov_987.666667	58	108	2	45	50	0.9000000
NODE_309391_length_108_cov_987.666667	58	108	0	5	50	0.1000000
NODE_309391_length_108_cov_987.666667	58	108	2	45	50	0.9000000
NODE_309395_length_108_cov_841.666667	1	65	0	64	64	1.0000000
NODE_309395_length_108_cov_841.666667	1	65	0	64	64	1.0000000
NODE_309395_length_108_cov_841.666667	1	65	0	64	64	1.0000000
NODE_309433_length_108_cov_213.333333	22	81	0	59	59	1.0000000
NODE_309433_length_108_cov_213.333333	55	81	0	26	26	1.0000000
NODE_309464_length_108_cov_107.888889	11	82	0	71	71	1.0000000
NODE_309464_length_108_cov_107.888889	16	82	0	66	66	1.0000000
NODE_309464_length_108_cov_107.888889	55	108	0	53	53	1.0000000
NODE_309464_length_108_cov_107.888889	55	108	0	53	53	1.0000000
NODE_309464_length_108_cov_107.888889	55	108	0	53	53	1.0000000
NODE_309472_length_108_cov_76.444444	13	76	0	63	63	1.0000000
NODE_309479_length_108_cov_51.000000	0	53	0	53	53	1.0000000
NODE_309479_length_108_cov_51.000000	0	53	0	53	53	1.0000000
NODE_309479_length_108_cov_51.000000	0	53	0	53	53	1.0000000
NODE_309479_length_108_cov_51.000000	26	106	0	80	80	1.0000000
NODE_309479_length_108_cov_51.000000	26	106	0	80	80	1.0000000
NODE_309479_length_108_cov_51.000000	26	106	0	80	80	1.0000000
NODE_309479_length_108_cov_51.000000	26	106	0	80	80	1.0000000
NODE_309479_length_108_cov_51.000000	26	106	0	80	80	1.0000000
NODE_309479_length_108_cov_51.000000	26	97	0	71	71	1.0000000
NODE_309490_length_108_cov_31.111111	11	82	0	71	71	1.0000000
NODE_309490_length_108_cov_31.111111	16	82	0	66	66	1.0000000
NODE_309490_length_108_cov_31.111111	55	108	0	53	53	1.0000000
NODE_309490_length_108_cov_31.111111	55	108	0	53	53	1.0000000
NODE_309490_length_108_cov_31.111111	55	108	0	53	53	1.0000000
NODE_309530_length_107_cov_608.250000	0	64	0	64	64	1.0000000
NODE_309530_length_107_cov_608.250000	53	103	0	50	50	1.0000000
NODE_309551_length_107_cov_303.250000	0	56	2	56	56	1.0000000
NODE_309551_length_107_cov_303.250000	29	99	2	70	70	1.0000000
NODE_309657_length_106_cov_522.571429	10	90	0	80	80	1.0000000
NODE_309657_length_106_cov_522.571429	10	90	0	80	80	1.0000000
NODE_309657_length_106_cov_522.571429	10	90	0	80	80	1.0000000
NODE_309657_length_106_cov_522.571429	10	90	0	80	80	1.0000000
NODE_309657_length_106_cov_522.571429	10	90	0	80	80	1.0000000
NODE_309657_length_106_cov_522.571429	19	90	0	71	71	1.0000000
NODE_309696_length_106_cov_161.857143	7	78	0	71	71	1.0000000
NODE_309696_length_106_cov_161.857143	51	106	0	55	55	1.0000000
NODE_309707_length_106_cov_130.714286	0	76	0	76	76	1.0000000
NODE_309714_length_106_cov_108.000000	0	76	0	76	76	1.0000000
NODE_309717_length_106_cov_102.142857	0	62	0	62	62	1.0000000
NODE_309717_length_106_cov_102.142857	35	106	0	71	71	1.0000000
NODE_309717_length_106_cov_102.142857	35	106	0	71	71	1.0000000
NODE_309747_length_106_cov_39.428571	0	76	0	76	76	1.0000000
NODE_309761_length_106_cov_30.857143	0	70	0	2	70	0.0285714
NODE_309761_length_106_cov_30.857143	0	70	2	68	70	0.9714286
NODE_309761_length_106_cov_30.857143	0	70	0	2	70	0.0285714
NODE_309761_length_106_cov_30.857143	0	70	2	68	70	0.9714286
NODE_309761_length_106_cov_30.857143	0	70	0	2	70	0.0285714
NODE_309761_length_106_cov_30.857143	0	70	2	68	70	0.9714286
NODE_309761_length_106_cov_30.857143	43	92	2	49	49	1.0000000
NODE_309761_length_106_cov_30.857143	53	106	0	1	53	0.0188679
NODE_309761_length_106_cov_30.857143	53	106	2	52	53	0.9811321
NODE_309761_length_106_cov_30.857143	53	106	0	1	53	0.0188679
NODE_309761_length_106_cov_30.857143	53	106	2	52	53	0.9811321
NODE_309775_length_105_cov_2054.666667	31	105	0	74	74	1.0000000
NODE_309775_length_105_cov_2054.666667	31	105	0	74	74	1.0000000
NODE_309775_length_105_cov_2054.666667	31	105	0	74	74	1.0000000
NODE_309775_length_105_cov_2054.666667	31	105	0	74	74	1.0000000
NODE_309788_length_105_cov_830.833333	30	105	0	75	75	1.0000000
NODE_309789_length_105_cov_825.500000	0	77	0	77	77	1.0000000
NODE_309789_length_105_cov_825.500000	0	77	0	77	77	1.0000000
NODE_309789_length_105_cov_825.500000	50	99	0	49	49	1.0000000
NODE_309789_length_105_cov_825.500000	55	105	0	50	50	1.0000000
NODE_309815_length_105_cov_231.333333	0	54	0	54	54	1.0000000
NODE_309815_length_105_cov_231.333333	27	99	0	72	72	1.0000000
NODE_309842_length_105_cov_85.333333	14	94	0	80	80	1.0000000
NODE_309842_length_105_cov_85.333333	67	89	0	22	22	1.0000000
NODE_309855_length_105_cov_61.833333	23	103	0	80	80	1.0000000
NODE_309867_length_105_cov_40.666667	6	66	0	60	60	1.0000000
NODE_309925_length_104_cov_1016.000000	0	78	0	78	78	1.0000000
NODE_309925_length_104_cov_1016.000000	53	99	0	46	46	1.0000000
NODE_309935_length_104_cov_791.200000	0	67	0	67	67	1.0000000
NODE_309935_length_104_cov_791.200000	0	67	0	67	67	1.0000000
NODE_309935_length_104_cov_791.200000	40	104	0	64	64	1.0000000
NODE_309938_length_104_cov_574.200000	21	101	0	80	80	1.0000000
NODE_309938_length_104_cov_574.200000	21	101	0	80	80	1.0000000
NODE_309938_length_104_cov_574.200000	21	101	0	80	80	1.0000000
NODE_309938_length_104_cov_574.200000	21	101	0	80	80	1.0000000
NODE_309938_length_104_cov_574.200000	21	101	0	80	80	1.0000000
NODE_309938_length_104_cov_574.200000	21	92	0	71	71	1.0000000
NODE_309940_length_104_cov_547.400000	10	87	0	77	77	1.0000000
NODE_309940_length_104_cov_547.400000	10	87	0	77	77	1.0000000
NODE_310020_length_104_cov_46.800000	42	104	0	62	62	1.0000000
NODE_310054_length_103_cov_2267.000000	0	54	0	54	54	1.0000000
NODE_310054_length_103_cov_2267.000000	27	100	0	73	73	1.0000000
NODE_310082_length_103_cov_890.000000	6	70	0	64	64	1.0000000
NODE_310082_length_103_cov_890.000000	6	70	0	64	64	1.0000000
NODE_310082_length_103_cov_890.000000	6	70	0	64	64	1.0000000
NODE_310082_length_103_cov_890.000000	43	103	0	60	60	1.0000000
NODE_310082_length_103_cov_890.000000	59	103	0	44	44	1.0000000
NODE_310090_length_103_cov_768.500000	7	78	0	71	71	1.0000000
NODE_310090_length_103_cov_768.500000	12	78	0	66	66	1.0000000
NODE_310090_length_103_cov_768.500000	51	99	0	48	48	1.0000000
NODE_310090_length_103_cov_768.500000	51	99	0	48	48	1.0000000
NODE_310090_length_103_cov_768.500000	51	99	0	48	48	1.0000000
NODE_310091_length_103_cov_751.000000	0	71	0	71	71	1.0000000
NODE_310091_length_103_cov_751.000000	0	71	0	71	71	1.0000000
NODE_310091_length_103_cov_751.000000	44	93	0	49	49	1.0000000
NODE_310094_length_103_cov_678.000000	10	74	0	64	64	1.0000000
NODE_310094_length_103_cov_678.000000	10	74	0	64	64	1.0000000
NODE_310094_length_103_cov_678.000000	10	74	0	64	64	1.0000000
NODE_310094_length_103_cov_678.000000	47	96	0	49	49	1.0000000
NODE_310103_length_103_cov_462.750000	19	99	0	80	80	1.0000000
NODE_310116_length_103_cov_300.250000	0	63	0	63	63	1.0000000
NODE_310147_length_103_cov_103.250000	4	47	0	43	43	1.0000000
NODE_310152_length_103_cov_80.250000	36	99	0	63	63	1.0000000
NODE_310153_length_103_cov_76.500000	4	63	0	59	59	1.0000000
NODE_310160_length_103_cov_42.000000	0	78	0	78	78	1.0000000
NODE_310160_length_103_cov_42.000000	7	78	0	71	71	1.0000000
NODE_310160_length_103_cov_42.000000	12	78	0	66	66	1.0000000
NODE_310160_length_103_cov_42.000000	51	99	0	48	48	1.0000000
NODE_310160_length_103_cov_42.000000	51	99	0	48	48	1.0000000
NODE_310160_length_103_cov_42.000000	51	99	0	48	48	1.0000000
NODE_310211_length_102_cov_2033.666667	0	48	0	48	48	1.0000000
NODE_310211_length_102_cov_2033.666667	21	101	0	80	80	1.0000000
NODE_310227_length_102_cov_1028.333333	52	102	0	50	50	1.0000000
NODE_310230_length_102_cov_987.666667	15	98	0	83	83	1.0000000
NODE_310231_length_102_cov_934.000000	12	95	0	83	83	1.0000000
NODE_310246_length_102_cov_685.666667	0	73	0	73	73	1.0000000
NODE_310247_length_102_cov_646.666667	15	89	0	74	74	1.0000000
NODE_310269_length_102_cov_250.000000	12	72	0	60	60	1.0000000
NODE_310273_length_102_cov_216.333333	4	70	0	66	66	1.0000000
NODE_310273_length_102_cov_216.333333	4	70	0	66	66	1.0000000
NODE_310273_length_102_cov_216.333333	4	70	0	66	66	1.0000000
NODE_310273_length_102_cov_216.333333	43	92	0	49	49	1.0000000
NODE_310273_length_102_cov_216.333333	57	102	0	45	45	1.0000000
NODE_310287_length_102_cov_152.333333	0	63	0	63	63	1.0000000
NODE_310295_length_102_cov_124.333333	0	70	0	70	70	1.0000000
NODE_310302_length_102_cov_106.333333	0	78	0	78	78	1.0000000
NODE_310302_length_102_cov_106.333333	7	78	0	71	71	1.0000000
NODE_310302_length_102_cov_106.333333	12	78	0	66	66	1.0000000
NODE_310302_length_102_cov_106.333333	51	102	0	51	51	1.0000000
NODE_310302_length_102_cov_106.333333	51	102	0	51	51	1.0000000
NODE_310302_length_102_cov_106.333333	51	102	0	51	51	1.0000000
NODE_310316_length_102_cov_74.333333	31	99	0	68	68	1.0000000
NODE_310321_length_102_cov_71.000000	11	91	0	80	80	1.0000000
NODE_310336_length_102_cov_32.666667	0	65	0	65	65	1.0000000
NODE_310336_length_102_cov_32.666667	38	99	0	61	61	1.0000000
NODE_310405_length_101_cov_2217.000000	0	43	0	43	43	1.0000000
NODE_310405_length_101_cov_2217.000000	23	96	0	73	73	1.0000000
NODE_310464_length_101_cov_740.500000	2	66	0	64	64	1.0000000
NODE_310464_length_101_cov_740.500000	2	66	0	64	64	1.0000000
NODE_310464_length_101_cov_740.500000	2	66	0	64	64	1.0000000
NODE_310464_length_101_cov_740.500000	39	101	0	62	62	1.0000000
NODE_310464_length_101_cov_740.500000	55	101	0	46	46	1.0000000
NODE_310469_length_101_cov_701.000000	0	62	0	62	62	1.0000000
NODE_310469_length_101_cov_701.000000	35	99	0	64	64	1.0000000
NODE_310469_length_101_cov_701.000000	35	99	0	64	64	1.0000000
NODE_310469_length_101_cov_701.000000	35	99	0	64	64	1.0000000
NODE_310471_length_101_cov_679.000000	2	76	0	74	74	1.0000000
NODE_310500_length_101_cov_374.500000	2	50	0	48	48	1.0000000
NODE_310500_length_101_cov_374.500000	2	50	0	48	48	1.0000000
NODE_310500_length_101_cov_374.500000	2	50	0	48	48	1.0000000
NODE_310500_length_101_cov_374.500000	23	89	0	66	66	1.0000000
NODE_310500_length_101_cov_374.500000	23	94	0	71	71	1.0000000
NODE_310516_length_101_cov_294.000000	4	52	0	48	48	1.0000000
NODE_310516_length_101_cov_294.000000	4	52	0	48	48	1.0000000
NODE_310516_length_101_cov_294.000000	4	52	0	48	48	1.0000000
NODE_310516_length_101_cov_294.000000	25	91	0	66	66	1.0000000
NODE_310516_length_101_cov_294.000000	25	96	0	71	71	1.0000000
NODE_310529_length_101_cov_230.500000	2	76	0	74	74	1.0000000
NODE_310529_length_101_cov_230.500000	2	76	0	74	74	1.0000000
NODE_310529_length_101_cov_230.500000	2	76	0	74	74	1.0000000
NODE_310529_length_101_cov_230.500000	49	101	0	52	52	1.0000000
NODE_310529_length_101_cov_230.500000	55	101	0	46	46	1.0000000
NODE_310550_length_101_cov_157.000000	13	72	0	59	59	1.0000000
NODE_310550_length_101_cov_157.000000	46	72	0	26	26	1.0000000
NODE_310565_length_101_cov_134.500000	2	37	0	35	35	1.0000000
NODE_310685_length_100_cov_1883.000000	32	100	0	68	68	1.0000000
NODE_310685_length_100_cov_1883.000000	32	100	0	68	68	1.0000000
NODE_310685_length_100_cov_1883.000000	32	99	0	67	67	1.0000000
NODE_310685_length_100_cov_1883.000000	32	100	0	68	68	1.0000000
NODE_310704_length_100_cov_1310.000000	0	42	0	42	42	1.0000000
NODE_310704_length_100_cov_1310.000000	1	42	0	41	41	1.0000000
NODE_310704_length_100_cov_1310.000000	38	100	0	62	62	1.0000000
NODE_310704_length_100_cov_1310.000000	38	95	0	57	57	1.0000000
NODE_310704_length_100_cov_1310.000000	38	100	0	62	62	1.0000000
NODE_310704_length_100_cov_1310.000000	38	100	0	62	62	1.0000000
NODE_310708_length_100_cov_1239.000000	1	48	0	47	47	1.0000000
NODE_310740_length_100_cov_694.000000	0	62	0	62	62	1.0000000
NODE_310740_length_100_cov_694.000000	0	62	0	62	62	1.0000000
NODE_310740_length_100_cov_694.000000	35	100	0	65	65	1.0000000
NODE_310748_length_100_cov_602.000000	0	57	0	57	57	1.0000000
NODE_310750_length_100_cov_590.000000	0	58	0	58	58	1.0000000
NODE_310798_length_100_cov_274.000000	1	67	0	66	66	1.0000000
NODE_310798_length_100_cov_274.000000	1	67	0	66	66	1.0000000
NODE_310798_length_100_cov_274.000000	1	67	0	66	66	1.0000000
NODE_310798_length_100_cov_274.000000	40	100	0	60	60	1.0000000
NODE_310798_length_100_cov_274.000000	54	100	0	46	46	1.0000000
NODE_310808_length_100_cov_217.000000	4	75	0	71	71	1.0000000
NODE_310808_length_100_cov_217.000000	9	75	0	66	66	1.0000000
NODE_310808_length_100_cov_217.000000	48	99	0	51	51	1.0000000
NODE_310808_length_100_cov_217.000000	48	99	0	51	51	1.0000000
NODE_310808_length_100_cov_217.000000	48	99	0	51	51	1.0000000
NODE_310810_length_100_cov_209.000000	1	44	0	43	43	1.0000000
NODE_310810_length_100_cov_209.000000	40	100	0	60	60	1.0000000
NODE_310810_length_100_cov_209.000000	40	100	0	60	60	1.0000000
NODE_310819_length_100_cov_185.000000	0	46	0	46	46	1.0000000
NODE_310819_length_100_cov_185.000000	9	58	0	49	49	1.0000000
NODE_310819_length_100_cov_185.000000	31	99	0	68	68	1.0000000
NODE_310819_length_100_cov_185.000000	31	99	0	68	68	1.0000000
NODE_310819_length_100_cov_185.000000	31	99	0	68	68	1.0000000
NODE_310828_length_100_cov_164.000000	9	92	0	83	83	1.0000000
NODE_310837_length_100_cov_152.000000	11	91	0	80	80	1.0000000
NODE_310837_length_100_cov_152.000000	11	91	0	80	80	1.0000000
NODE_310837_length_100_cov_152.000000	11	91	0	80	80	1.0000000
NODE_310837_length_100_cov_152.000000	11	91	0	80	80	1.0000000
NODE_310837_length_100_cov_152.000000	11	91	0	80	80	1.0000000
NODE_310839_length_100_cov_150.000000	0	54	0	54	54	1.0000000
NODE_310839_length_100_cov_150.000000	0	54	0	54	54	1.0000000
NODE_310839_length_100_cov_150.000000	27	100	0	73	73	1.0000000
NODE_310839_length_100_cov_150.000000	27	100	0	73	73	1.0000000
NODE_310840_length_100_cov_148.000000	2	82	0	80	80	1.0000000
NODE_310841_length_100_cov_148.000000	0	71	0	71	71	1.0000000
NODE_310841_length_100_cov_148.000000	0	71	0	71	71	1.0000000
NODE_310841_length_100_cov_148.000000	0	62	0	62	62	1.0000000
NODE_310876_length_100_cov_71.000000	0	75	0	75	75	1.0000000
NODE_310876_length_100_cov_71.000000	4	75	0	71	71	1.0000000
NODE_310876_length_100_cov_71.000000	9	75	0	66	66	1.0000000
NODE_310876_length_100_cov_71.000000	48	100	0	52	52	1.0000000
NODE_310876_length_100_cov_71.000000	48	100	0	52	52	1.0000000
NODE_310876_length_100_cov_71.000000	48	100	0	52	52	1.0000000
NODE_310896_length_100_cov_41.000000	0	75	0	75	75	1.0000000
NODE_310896_length_100_cov_41.000000	4	75	0	71	71	1.0000000
NODE_310896_length_100_cov_41.000000	9	75	0	66	66	1.0000000
NODE_310896_length_100_cov_41.000000	48	99	0	51	51	1.0000000
NODE_310896_length_100_cov_41.000000	48	99	0	51	51	1.0000000
NODE_310896_length_100_cov_41.000000	48	99	0	51	51	1.0000000
NODE_310904_length_100_cov_30.000000	1	42	0	41	41	1.0000000
